Date,Time,MNQ Price,Operation type,Contracts,Trade duration,Close Reason,Net P&L,Daily P&L,Balance,Day,Daily P&L Total
2024-01-02,12:01:00,16874.25,SELL,3,0.02h,Stop Loss,$12.00,$12.00,$50012.00,1,$12.00
2024-01-02,13:30:00,16828.25,BUY,3,0.02h,Stop Loss,$-9.00,$3.00,$50003.00,1,$3.00
2024-01-02,14:07:00,16841.5,SELL,3,0.02h,Stop Loss,$-9.00,$-6.00,$49994.00,1,$-6.00
2024-01-02,14:08:00,16851.75,BUY,3,0.02h,Break Even,$-1.50,$-7.50,$49992.50,1,$-7.50
2024-01-02,14:35:00,16832.0,SELL,3,0.02h,Stop Loss,$13.50,$6.00,$50006.00,1,$6.00
2024-01-02,16:02:00,16715.5,BUY,3,0.02h,Stop Loss,$24.00,$30.00,$50030.00,1,$30.00
2024-01-02,17:17:00,16772.5,SELL,3,0.02h,Stop Loss,$96.00,$126.00,$50126.00,1,$126.00
2024-01-02,17:37:00,16772.25,BUY,3,0.02h,Stop Loss,$-9.00,$117.00,$50117.00,1,$117.00
2024-01-02,17:48:00,16758.25,SELL,3,0.02h,Stop Loss,$63.00,$180.00,$50180.00,1,$180.00
2024-01-02,18:22:00,16730.5,BUY,3,0.02h,Stop Loss,$-9.00,$171.00,$50171.00,1,$171.00
2024-01-02,18:49:00,16729.75,SELL,3,0.02h,Stop Loss,$15.00,$186.00,$50186.00,1,$186.00
2024-01-02,19:29:00,16695.5,BUY,3,0.02h,Stop Loss,$15.00,$201.00,$50201.00,1,$201.00
2024-01-02,19:40:00,16684.75,SELL,3,0.02h,Stop Loss,$6.00,$207.00,$50207.00,1,$207.00
2024-01-02,20:31:00,16651.25,BUY,3,0.02h,Stop Loss,$22.50,$229.50,$50229.50,1,$229.50
2024-01-02,20:40:00,16640.25,SELL,3,0.02h,Break Even,$-1.50,$228.00,$50228.00,1,$228.00
2024-01-02,20:44:00,16649.0,BUY,3,0.02h,Stop Loss,$15.00,$243.00,$50243.00,1,$243.00
,,,,,,,,,,,
2024-01-03,12:00:00,16648.5,SELL,3,0.02h,Break Even,$-1.50,$-1.50,$50241.50,2,$-1.50
2024-01-03,13:12:00,16614.25,BUY,3,0.02h,Stop Loss,$-9.00,$-10.50,$50232.50,2,$-10.50
2024-01-03,13:50:00,16631.5,SELL,3,0.02h,Stop Loss,$-9.00,$-19.50,$50223.50,2,$-19.50
2024-01-03,13:52:00,16640.25,BUY,3,0.02h,Stop Loss,$-9.00,$-28.50,$50214.50,2,$-28.50
2024-01-03,13:54:00,16631.5,SELL,3,0.02h,Stop Loss,$-9.00,$-37.50,$50205.50,2,$-37.50
2024-01-03,14:32:00,16617.25,BUY,3,0.02h,Break Even,$-1.50,$-39.00,$50204.00,2,$-39.00
2024-01-03,14:33:00,16593.0,SELL,3,0.02h,Stop Loss,$48.00,$9.00,$50252.00,2,$9.00
2024-01-03,14:36:00,16630.5,BUY,3,0.02h,Break Even,$-1.50,$7.50,$50250.50,2,$7.50
2024-01-03,14:57:00,16607.0,SELL,3,0.02h,Stop Loss,$60.00,$67.50,$50310.50,2,$67.50
2024-01-03,15:04:00,16640.0,BUY,3,0.02h,Stop Loss,$19.50,$87.00,$50330.00,2,$87.00
2024-01-03,15:10:00,16608.0,SELL,3,0.02h,Stop Loss,$91.50,$178.50,$50421.50,2,$178.50
2024-01-03,15:53:00,16577.75,BUY,3,0.02h,Break Even,$-1.50,$177.00,$50420.00,2,$177.00
2024-01-03,16:23:00,16585.5,SELL,3,0.02h,Stop Loss,$-9.00,$168.00,$50411.00,2,$168.00
2024-01-03,16:34:00,16600.25,BUY,3,0.02h,Stop Loss,$-9.00,$159.00,$50402.00,2,$159.00
2024-01-03,16:36:00,16589.25,SELL,3,0.02h,Stop Loss,$21.00,$180.00,$50423.00,2,$180.00
2024-01-03,17:28:00,16571.0,BUY,3,0.02h,Stop Loss,$15.00,$195.00,$50438.00,2,$195.00
2024-01-03,18:21:00,16590.5,SELL,3,0.02h,Break Even,$-1.50,$193.50,$50436.50,2,$193.50
2024-01-03,19:26:00,16590.75,BUY,3,0.02h,Stop Loss,$96.00,$289.50,$50532.50,2,$289.50
2024-01-03,19:53:00,16596.25,SELL,3,0.02h,Stop Loss,$-9.00,$280.50,$50523.50,2,$280.50
2024-01-03,20:34:00,16572.5,BUY,3,0.02h,Stop Loss,$24.00,$304.50,$50547.50,2,$304.50
2024-01-03,20:44:00,16555.25,SELL,3,0.02h,Stop Loss,$42.00,$346.50,$50589.50,2,$346.50
2024-01-03,21:32:00,16536.25,BUY,3,0.02h,Stop Loss,$-9.00,$337.50,$50580.50,2,$337.50
2024-01-03,21:33:00,16535.0,SELL,3,0.03h,Stop Loss,$-9.00,$328.50,$50571.50,2,$328.50
2024-01-03,21:36:00,16536.75,BUY,3,0.02h,Stop Loss,$-9.00,$319.50,$50562.50,2,$319.50
2024-01-03,21:37:00,16535.0,SELL,3,0.03h,Stop Loss,$-9.00,$310.50,$50553.50,2,$310.50
2024-01-03,21:39:00,16536.5,BUY,3,0.03h,Stop Loss,$-9.00,$301.50,$50544.50,2,$301.50
,,,,,,,,,,,
2024-01-04,12:00:00,16529.25,SELL,3,0.02h,Stop Loss,$-9.00,$-9.00,$50535.50,3,$-9.00
2024-01-04,12:29:00,16525.25,BUY,3,0.02h,Break Even,$-1.50,$-10.50,$50534.00,3,$-10.50
2024-01-04,12:42:00,16521.75,SELL,3,0.02h,Break Even,$-1.50,$-12.00,$50532.50,3,$-12.00
2024-01-04,12:43:00,16527.75,BUY,3,0.02h,Stop Loss,$-9.00,$-21.00,$50523.50,3,$-21.00
2024-01-04,12:54:00,16523.75,SELL,3,0.02h,Break Even,$-1.50,$-22.50,$50522.00,3,$-22.50
2024-01-04,14:14:00,16466.75,BUY,3,0.02h,Stop Loss,$4.50,$-18.00,$50526.50,3,$-18.00
2024-01-04,14:23:00,16461.25,SELL,3,0.02h,Break Even,$-1.50,$-19.50,$50525.00,3,$-19.50
2024-01-04,14:33:00,16488.25,BUY,3,0.02h,Stop Loss,$-9.00,$-28.50,$50516.00,3,$-28.50
2024-01-04,14:49:00,16460.25,SELL,3,0.02h,Stop Loss,$28.50,$0.00,$50544.50,3,$0.00
2024-01-04,14:53:00,16485.75,BUY,3,0.02h,Stop Loss,$4.50,$4.50,$50549.00,3,$4.50
2024-01-04,14:59:00,16458.5,SELL,3,0.02h,Stop Loss,$19.50,$24.00,$50568.50,3,$24.00
2024-01-04,15:02:00,16491.25,BUY,3,0.02h,Stop Loss,$-9.00,$15.00,$50559.50,3,$15.00
2024-01-04,16:33:00,16551.75,SELL,3,0.02h,Stop Loss,$-9.00,$6.00,$50550.50,3,$6.00
2024-01-04,16:38:00,16571.25,BUY,3,0.02h,Stop Loss,$-9.00,$-3.00,$50541.50,3,$-3.00
2024-01-04,16:40:00,16558.5,SELL,3,0.02h,Stop Loss,$3.00,$0.00,$50544.50,3,$0.00
2024-01-04,17:30:00,16523.75,BUY,3,0.02h,Break Even,$-1.50,$-1.50,$50543.00,3,$-1.50
2024-01-04,17:32:00,16516.5,SELL,3,0.02h,Stop Loss,$22.50,$21.00,$50565.50,3,$21.00
2024-01-04,17:42:00,16520.5,BUY,3,0.02h,Stop Loss,$-9.00,$12.00,$50556.50,3,$12.00
2024-01-04,17:44:00,16510.25,SELL,3,0.02h,Stop Loss,$61.50,$73.50,$50618.00,3,$73.50
2024-01-04,18:05:00,16509.5,BUY,3,0.02h,Break Even,$-1.50,$72.00,$50616.50,3,$72.00
2024-01-04,18:13:00,16495.75,SELL,3,0.02h,Break Even,$-1.50,$70.50,$50615.00,3,$70.50
2024-01-04,18:15:00,16506.75,BUY,3,0.02h,Stop Loss,$-9.00,$61.50,$50606.00,3,$61.50
2024-01-04,18:16:00,16501.0,SELL,3,0.02h,Stop Loss,$15.00,$76.50,$50621.00,3,$76.50
2024-01-04,18:18:00,16509.5,BUY,3,0.02h,Break Even,$-1.50,$75.00,$50619.50,3,$75.00
2024-01-04,18:54:00,16514.75,SELL,3,0.02h,Stop Loss,$21.00,$96.00,$50640.50,3,$96.00
2024-01-04,19:52:00,16492.25,BUY,3,0.02h,Stop Loss,$9.00,$105.00,$50649.50,3,$105.00
2024-01-04,20:17:00,16478.5,SELL,3,0.02h,Break Even,$-1.50,$103.50,$50648.00,3,$103.50
2024-01-04,20:33:00,16494.0,BUY,3,0.02h,Stop Loss,$12.00,$115.50,$50660.00,3,$115.50
2024-01-04,20:44:00,16482.25,SELL,3,0.02h,Stop Loss,$-9.00,$106.50,$50651.00,3,$106.50
2024-01-04,21:28:00,16450.5,BUY,3,0.02h,Break Even,$-1.50,$105.00,$50649.50,3,$105.00
2024-01-04,21:54:00,16449.25,SELL,3,0.02h,Break Even,$-1.50,$103.50,$50648.00,3,$103.50
,,,,,,,,,,,
2024-01-05,12:37:00,16399.0,BUY,3,0.02h,Break Even,$-1.50,$-1.50,$50646.50,4,$-1.50
2024-01-05,12:49:00,16395.5,SELL,3,0.02h,Break Even,$-1.50,$-3.00,$50645.00,4,$-3.00
2024-01-05,13:15:00,16399.25,BUY,3,0.02h,Break Even,$-1.50,$-4.50,$50643.50,4,$-4.50
2024-01-05,13:31:00,16362.75,SELL,3,0.02h,Stop Loss,$150.00,$145.50,$50793.50,4,$145.50
2024-01-05,13:52:00,16388.75,BUY,3,0.02h,Break Even,$-1.50,$144.00,$50792.00,4,$144.00
2024-01-05,16:19:00,16541.25,SELL,3,0.02h,Stop Loss,$10.50,$154.50,$50802.50,4,$154.50
2024-01-05,17:42:00,16476.5,BUY,3,0.02h,Break Even,$-1.50,$153.00,$50801.00,4,$153.00
2024-01-05,18:01:00,16468.0,SELL,3,0.02h,Stop Loss,$34.50,$187.50,$50835.50,4,$187.50
2024-01-05,18:28:00,16457.25,BUY,3,0.02h,Stop Loss,$39.00,$226.50,$50874.50,4,$226.50
2024-01-05,19:17:00,16486.5,SELL,3,0.02h,Stop Loss,$4.50,$231.00,$50879.00,4,$231.00
2024-01-05,20:39:00,16430.25,BUY,3,0.02h,Stop Loss,$-9.00,$222.00,$50870.00,4,$222.00
2024-01-05,21:31:00,16461.25,SELL,3,0.02h,Stop Loss,$-9.00,$213.00,$50861.00,4,$213.00
2024-01-05,21:51:00,16463.5,BUY,3,0.03h,Stop Loss,$-9.00,$204.00,$50852.00,4,$204.00
,,,,,,,,,,,
2024-01-08,12:01:00,16453.75,SELL,3,0.02h,Stop Loss,$-9.00,$-9.00,$50843.00,5,$-9.00
2024-01-08,12:08:00,16468.25,BUY,3,0.02h,Break Even,$-1.50,$-10.50,$50841.50,5,$-10.50
2024-01-08,12:32:00,16463.75,SELL,3,0.02h,Break Even,$-1.50,$-12.00,$50840.00,5,$-12.00
2024-01-08,12:57:00,16462.0,BUY,3,0.02h,Stop Loss,$63.00,$51.00,$50903.00,5,$51.00
2024-01-08,13:48:00,16486.25,SELL,3,0.02h,Break Even,$-1.50,$49.50,$50901.50,5,$49.50
2024-01-08,14:12:00,16490.25,BUY,3,0.02h,Stop Loss,$6.00,$55.50,$50907.50,5,$55.50
2024-01-08,16:12:00,16645.5,SELL,3,0.02h,Stop Loss,$9.00,$64.50,$50916.50,5,$64.50
2024-01-08,16:22:00,16661.75,BUY,3,0.02h,Break Even,$-1.50,$63.00,$50915.00,5,$63.00
2024-01-08,16:24:00,16650.0,SELL,3,0.02h,Break Even,$-1.50,$61.50,$50913.50,5,$61.50
2024-01-08,16:34:00,16658.5,BUY,3,0.02h,Stop Loss,$12.00,$73.50,$50925.50,5,$73.50
2024-01-08,16:49:00,16655.5,SELL,3,0.02h,Break Even,$-1.50,$72.00,$50924.00,5,$72.00
2024-01-08,16:53:00,16658.75,BUY,3,0.02h,Break Even,$-1.50,$70.50,$50922.50,5,$70.50
2024-01-08,17:26:00,16682.25,SELL,3,0.02h,Break Even,$-1.50,$69.00,$50921.00,5,$69.00
2024-01-08,17:32:00,16685.75,BUY,3,0.02h,Break Even,$-1.50,$67.50,$50919.50,5,$67.50
2024-01-08,18:33:00,16714.25,SELL,3,0.02h,Break Even,$-1.50,$66.00,$50918.00,5,$66.00
2024-01-08,18:34:00,16715.75,BUY,3,0.02h,Break Even,$-1.50,$64.50,$50916.50,5,$64.50
2024-01-08,20:15:00,16776.25,SELL,3,0.02h,Break Even,$-1.50,$63.00,$50915.00,5,$63.00
2024-01-08,20:16:00,16779.75,BUY,3,0.02h,Break Even,$-1.50,$61.50,$50913.50,5,$61.50
2024-01-08,20:17:00,16777.0,SELL,3,0.02h,Stop Loss,$-9.00,$52.50,$50904.50,5,$52.50
2024-01-08,20:18:00,16784.25,BUY,3,0.02h,Stop Loss,$16.50,$69.00,$50921.00,5,$69.00
2024-01-08,20:30:00,16778.0,SELL,3,0.02h,Stop Loss,$6.00,$75.00,$50927.00,5,$75.00
2024-01-08,20:35:00,16786.0,BUY,3,0.02h,Stop Loss,$-9.00,$66.00,$50918.00,5,$66.00
2024-01-08,20:48:00,16777.0,SELL,3,0.02h,Break Even,$-1.50,$64.50,$50916.50,5,$64.50
2024-01-08,20:52:00,16801.0,BUY,3,0.02h,Stop Loss,$12.00,$76.50,$50928.50,5,$76.50
2024-01-08,21:11:00,16792.5,SELL,3,0.02h,Break Even,$-1.50,$75.00,$50927.00,5,$75.00
,,,,,,,,,,,
2024-01-09,12:38:00,16716.0,BUY,3,0.02h,Break Even,$-1.50,$-1.50,$50925.50,6,$-1.50
2024-01-09,13:04:00,16711.0,SELL,3,0.02h,Stop Loss,$9.00,$7.50,$50934.50,6,$7.50
2024-01-09,14:11:00,16677.5,BUY,3,0.02h,Break Even,$-1.50,$6.00,$50933.00,6,$6.00
2024-01-09,14:22:00,16670.0,SELL,3,0.02h,Stop Loss,$-9.00,$-3.00,$50924.00,6,$-3.00
2024-01-09,14:24:00,16674.25,BUY,3,0.02h,Stop Loss,$-9.00,$-12.00,$50915.00,6,$-12.00
2024-01-09,14:25:00,16667.75,SELL,3,0.02h,Stop Loss,$-9.00,$-21.00,$50906.00,6,$-21.00
2024-01-09,14:27:00,16676.0,BUY,3,0.02h,Stop Loss,$4.50,$-16.50,$50910.50,6,$-16.50
2024-01-09,14:46:00,16676.0,SELL,3,0.02h,Stop Loss,$4.50,$-12.00,$50915.00,6,$-12.00
2024-01-09,14:57:00,16687.5,BUY,3,0.02h,Stop Loss,$33.00,$21.00,$50948.00,6,$21.00
2024-01-09,15:33:00,16713.0,SELL,3,0.02h,Stop Loss,$-9.00,$12.00,$50939.00,6,$12.00
2024-01-09,15:36:00,16731.25,BUY,3,0.02h,Stop Loss,$15.00,$27.00,$50954.00,6,$27.00
2024-01-09,15:59:00,16729.5,SELL,3,0.02h,Stop Loss,$-9.00,$18.00,$50945.00,6,$18.00
2024-01-09,16:02:00,16750.0,BUY,3,0.02h,Stop Loss,$27.00,$45.00,$50972.00,6,$45.00
2024-01-09,17:34:00,16816.25,SELL,3,0.02h,Break Even,$-1.50,$43.50,$50970.50,6,$43.50
2024-01-09,17:41:00,16828.75,BUY,3,0.02h,Break Even,$-1.50,$42.00,$50969.00,6,$42.00
2024-01-09,18:25:00,16837.0,SELL,3,0.02h,Stop Loss,$34.50,$76.50,$51003.50,6,$76.50
2024-01-09,18:50:00,16830.5,BUY,3,0.02h,Stop Loss,$46.50,$123.00,$51050.00,6,$123.00
2024-01-09,19:15:00,16832.25,SELL,3,0.02h,Stop Loss,$52.50,$175.50,$51102.50,6,$175.50
2024-01-09,19:55:00,16826.75,BUY,3,0.02h,Stop Loss,$-9.00,$166.50,$51093.50,6,$166.50
2024-01-09,19:56:00,16819.75,SELL,3,0.02h,Break Even,$-1.50,$165.00,$51092.00,6,$165.00
2024-01-09,19:57:00,16822.0,BUY,3,0.02h,Break Even,$-1.50,$163.50,$51090.50,6,$163.50
2024-01-09,20:08:00,16814.0,SELL,3,0.02h,Stop Loss,$58.50,$222.00,$51149.00,6,$222.00
2024-01-09,20:18:00,16829.5,BUY,3,0.02h,Stop Loss,$-9.00,$213.00,$51140.00,6,$213.00
2024-01-09,20:19:00,16821.25,SELL,3,0.02h,Break Even,$-1.50,$211.50,$51138.50,6,$211.50
2024-01-09,20:20:00,16825.5,BUY,3,0.02h,Stop Loss,$13.50,$225.00,$51152.00,6,$225.00
2024-01-09,20:32:00,16820.75,SELL,3,0.02h,Stop Loss,$3.00,$228.00,$51155.00,6,$228.00
2024-01-09,20:55:00,16829.5,BUY,3,0.02h,Stop Loss,$51.00,$279.00,$51206.00,6,$279.00
2024-01-09,21:29:00,16828.75,SELL,3,0.07h,Break Even,$-1.50,$277.50,$51204.50,6,$277.50
2024-01-09,21:42:00,16831.25,BUY,3,0.02h,Stop Loss,$-9.00,$268.50,$51195.50,6,$268.50
2024-01-09,21:57:00,16828.75,SELL,3,0.02h,Break Even,$-1.50,$267.00,$51194.00,6,$267.00
,,,,,,,,,,,
2024-01-10,12:00:00,16847.5,BUY,3,0.02h,Stop Loss,$24.00,$24.00,$51218.00,7,$24.00
2024-01-10,12:38:00,16856.5,SELL,3,0.02h,Break Even,$-1.50,$22.50,$51216.50,7,$22.50
2024-01-10,13:16:00,16845.25,BUY,3,0.02h,Stop Loss,$-9.00,$13.50,$51207.50,7,$13.50
2024-01-10,13:19:00,16840.25,SELL,3,0.02h,Break Even,$-1.50,$12.00,$51206.00,7,$12.00
2024-01-10,13:29:00,16847.5,BUY,3,0.02h,Break Even,$-1.50,$10.50,$51204.50,7,$10.50
2024-01-10,13:30:00,16839.0,SELL,3,0.02h,Stop Loss,$21.00,$31.50,$51225.50,7,$31.50
2024-01-10,14:13:00,16825.5,BUY,3,0.02h,Break Even,$-1.50,$30.00,$51224.00,7,$30.00
2024-01-10,14:51:00,16831.75,SELL,3,0.02h,Stop Loss,$75.00,$105.00,$51299.00,7,$105.00
2024-01-10,15:13:00,16843.0,BUY,3,0.02h,Stop Loss,$45.00,$150.00,$51344.00,7,$150.00
2024-01-10,16:12:00,16876.5,SELL,3,0.02h,Stop Loss,$36.00,$186.00,$51380.00,7,$186.00
2024-01-10,16:42:00,16878.75,BUY,3,0.02h,Break Even,$-1.50,$184.50,$51378.50,7,$184.50
2024-01-10,16:53:00,16863.75,SELL,3,0.02h,Break Even,$-1.50,$183.00,$51377.00,7,$183.00
2024-01-10,16:57:00,16878.75,BUY,3,0.02h,Stop Loss,$3.00,$186.00,$51380.00,7,$186.00
2024-01-10,18:12:00,16893.0,SELL,3,0.02h,Stop Loss,$13.50,$199.50,$51393.50,7,$199.50
2024-01-10,18:19:00,16909.5,BUY,3,0.02h,Stop Loss,$-9.00,$190.50,$51384.50,7,$190.50
2024-01-10,18:22:00,16899.0,SELL,3,0.02h,Stop Loss,$9.00,$199.50,$51393.50,7,$199.50
2024-01-10,18:26:00,16910.25,BUY,3,0.02h,Break Even,$-1.50,$198.00,$51392.00,7,$198.00
2024-01-10,19:39:00,16944.25,SELL,3,0.02h,Stop Loss,$-9.00,$189.00,$51383.00,7,$189.00
2024-01-10,19:42:00,16952.0,BUY,3,0.02h,Break Even,$-1.50,$187.50,$51381.50,7,$187.50
2024-01-10,20:16:00,16962.5,SELL,3,0.02h,Break Even,$-1.50,$186.00,$51380.00,7,$186.00
2024-01-10,20:59:00,16946.0,BUY,3,0.02h,Stop Loss,$13.50,$199.50,$51393.50,7,$199.50
2024-01-10,21:42:00,16951.75,SELL,3,0.02h,Stop Loss,$-9.00,$190.50,$51384.50,7,$190.50
2024-01-10,21:43:00,16952.75,BUY,3,0.03h,Break Even,$-1.50,$189.00,$51383.00,7,$189.00
,,,,,,,,,,,
2024-01-11,12:56:00,17007.25,SELL,3,0.02h,Stop Loss,$-9.00,$-9.00,$51374.00,8,$-9.00
2024-01-11,13:17:00,17008.25,BUY,3,0.02h,Break Even,$-1.50,$-10.50,$51372.50,8,$-10.50
2024-01-11,13:31:00,16956.25,SELL,3,0.02h,Stop Loss,$300.00,$289.50,$51672.50,8,$289.50
2024-01-11,14:10:00,16943.0,BUY,3,0.02h,Stop Loss,$10.50,$300.00,$51683.00,8,$300.00
2024-01-11,14:47:00,16972.5,SELL,3,0.02h,Stop Loss,$54.00,$354.00,$51737.00,8,$354.00
2024-01-11,15:29:00,16890.0,BUY,3,0.02h,Break Even,$-1.50,$352.50,$51735.50,8,$352.50
2024-01-11,15:50:00,16874.75,SELL,3,0.02h,Stop Loss,$72.00,$424.50,$51807.50,8,$424.50
2024-01-11,17:05:00,16794.25,BUY,3,0.02h,Stop Loss,$27.00,$451.50,$51834.50,8,$451.50
2024-01-11,17:29:00,16793.0,SELL,3,0.02h,Stop Loss,$54.00,$505.50,$51888.50,8,$505.50
2024-01-11,17:41:00,16811.0,BUY,3,0.02h,Stop Loss,$63.00,$568.50,$51951.50,8,$568.50
2024-01-11,19:25:00,16924.0,SELL,3,0.02h,Stop Loss,$-9.00,$559.50,$51942.50,8,$559.50
2024-01-11,19:26:00,16931.25,BUY,3,0.02h,Stop Loss,$10.50,$570.00,$51953.00,8,$570.00
2024-01-11,20:06:00,16949.75,SELL,3,0.02h,Stop Loss,$-9.00,$561.00,$51944.00,8,$561.00
2024-01-11,20:26:00,16957.25,BUY,3,0.02h,Stop Loss,$3.00,$564.00,$51947.00,8,$564.00
2024-01-11,20:38:00,16944.5,SELL,3,0.02h,Break Even,$-1.50,$562.50,$51945.50,8,$562.50
2024-01-11,20:50:00,16953.5,BUY,3,0.02h,Stop Loss,$3.00,$565.50,$51948.50,8,$565.50
2024-01-11,20:52:00,16941.75,SELL,3,0.02h,Stop Loss,$52.50,$618.00,$52001.00,8,$618.00
2024-01-11,20:55:00,16955.25,BUY,3,0.02h,Stop Loss,$19.50,$637.50,$52020.50,8,$637.50
2024-01-11,21:28:00,16961.5,SELL,3,0.02h,Stop Loss,$-9.00,$628.50,$52011.50,8,$628.50
,,,,,,,,,,,
2024-01-12,12:31:00,16912.0,BUY,3,0.02h,Break Even,$-1.50,$-1.50,$52010.00,9,$-1.50
2024-01-12,12:53:00,16909.25,SELL,3,0.02h,Break Even,$-1.50,$-3.00,$52008.50,9,$-3.00
2024-01-12,12:55:00,16917.5,BUY,3,0.02h,Break Even,$-1.50,$-4.50,$52007.00,9,$-4.50
2024-01-12,12:57:00,16911.0,SELL,3,0.02h,Stop Loss,$3.00,$-1.50,$52010.00,9,$-1.50
2024-01-12,13:04:00,16925.0,BUY,3,0.02h,Break Even,$-1.50,$-3.00,$52008.50,9,$-3.00
2024-01-12,13:10:00,16909.0,SELL,3,0.02h,Break Even,$-1.50,$-4.50,$52007.00,9,$-4.50
2024-01-12,13:31:00,16952.5,BUY,3,0.02h,Stop Loss,$94.50,$90.00,$52101.50,9,$90.00
2024-01-12,15:00:00,16986.25,SELL,3,0.02h,Stop Loss,$193.50,$283.50,$52295.00,9,$283.50
2024-01-12,15:32:00,16984.0,BUY,3,0.02h,Stop Loss,$13.50,$297.00,$52308.50,9,$297.00
2024-01-12,15:40:00,16956.25,SELL,3,0.02h,Break Even,$-1.50,$295.50,$52307.00,9,$295.50
2024-01-12,16:07:00,16958.0,BUY,3,0.02h,Stop Loss,$40.50,$336.00,$52347.50,9,$336.00
2024-01-12,16:37:00,16963.5,SELL,3,0.02h,Stop Loss,$150.00,$486.00,$52497.50,9,$486.00
2024-01-12,17:15:00,16940.0,BUY,3,0.02h,Stop Loss,$7.50,$493.50,$52505.00,9,$493.50
2024-01-12,17:28:00,16936.0,SELL,3,0.02h,Stop Loss,$18.00,$511.50,$52523.00,9,$511.50
2024-01-12,17:31:00,16949.75,BUY,3,0.02h,Stop Loss,$9.00,$520.50,$52532.00,9,$520.50
2024-01-12,17:38:00,16935.25,SELL,3,0.02h,Stop Loss,$-9.00,$511.50,$52523.00,9,$511.50
2024-01-12,17:54:00,16957.5,BUY,3,0.02h,Stop Loss,$9.00,$520.50,$52532.00,9,$520.50
2024-01-12,19:23:00,16969.25,SELL,3,0.02h,Stop Loss,$-9.00,$511.50,$52523.00,9,$511.50
2024-01-12,20:30:00,16953.75,BUY,3,0.02h,Stop Loss,$9.00,$520.50,$52532.00,9,$520.50
2024-01-12,21:05:00,16959.75,SELL,3,0.02h,Stop Loss,$-9.00,$511.50,$52523.00,9,$511.50
2024-01-12,21:58:00,16955.25,BUY,3,0.02h,Break Even,$-1.50,$510.00,$52521.50,9,$510.00
,,,,,,,,,,,
2024-01-15,12:36:00,16971.5,SELL,3,0.02h,Break Even,$-1.50,$-1.50,$52520.00,10,$-1.50
2024-01-15,13:22:00,16964.25,BUY,3,0.02h,Stop Loss,$-9.00,$-10.50,$52511.00,10,$-10.50
2024-01-15,13:41:00,16959.0,SELL,3,0.02h,Break Even,$-1.50,$-12.00,$52509.50,10,$-12.00
2024-01-15,14:27:00,16954.75,BUY,3,0.03h,Stop Loss,$10.50,$-1.50,$52520.00,10,$-1.50
2024-01-15,14:47:00,16951.25,SELL,3,0.02h,Break Even,$-1.50,$-3.00,$52518.50,10,$-3.00
2024-01-15,15:03:00,16956.25,BUY,3,0.02h,Stop Loss,$-9.00,$-12.00,$52509.50,10,$-12.00
2024-01-15,15:05:00,16949.0,SELL,3,0.02h,Stop Loss,$-9.00,$-21.00,$52500.50,10,$-21.00
2024-01-15,15:26:00,16954.25,BUY,3,0.02h,Stop Loss,$-9.00,$-30.00,$52491.50,10,$-30.00
2024-01-15,16:11:00,16968.5,SELL,3,0.02h,Stop Loss,$-9.00,$-39.00,$52482.50,10,$-39.00
2024-01-15,16:28:00,16972.25,BUY,3,0.03h,Break Even,$-1.50,$-40.50,$52481.00,10,$-40.50
2024-01-15,16:47:00,16970.5,SELL,3,0.03h,Stop Loss,$-9.00,$-49.50,$52472.00,10,$-49.50
2024-01-15,17:09:00,16970.25,BUY,3,0.02h,Break Even,$-1.50,$-51.00,$52470.50,10,$-51.00
2024-01-15,17:22:00,16965.25,SELL,3,0.02h,Stop Loss,$-9.00,$-60.00,$52461.50,10,$-60.00
2024-01-15,17:27:00,16971.0,BUY,3,0.02h,Break Even,$-1.50,$-61.50,$52460.00,10,$-61.50
2024-01-15,17:39:00,16965.5,SELL,3,0.03h,Break Even,$-1.50,$-63.00,$52458.50,10,$-63.00
2024-01-15,17:50:00,16969.5,BUY,3,0.02h,Stop Loss,$-9.00,$-72.00,$52449.50,10,$-72.00
2024-01-15,17:52:00,16966.5,SELL,3,0.02h,Stop Loss,$-9.00,$-81.00,$52440.50,10,$-81.00
2024-01-15,17:56:00,16969.0,BUY,3,0.03h,Stop Loss,$-9.00,$-90.00,$52431.50,10,$-90.00
,,,,,,,,,,,
2024-01-16,12:00:00,16881.25,SELL,3,0.02h,Stop Loss,$-9.00,$-9.00,$52422.50,11,$-9.00
2024-01-16,12:34:00,16894.5,BUY,3,0.02h,Stop Loss,$-9.00,$-18.00,$52413.50,11,$-18.00
2024-01-16,12:36:00,16889.0,SELL,3,0.02h,Stop Loss,$-9.00,$-27.00,$52404.50,11,$-27.00
2024-01-16,12:37:00,16894.75,BUY,3,0.02h,Stop Loss,$3.00,$-24.00,$52407.50,11,$-24.00
2024-01-16,13:07:00,16905.5,SELL,3,0.02h,Stop Loss,$4.50,$-19.50,$52412.00,11,$-19.50
2024-01-16,13:34:00,16909.0,BUY,3,0.02h,Stop Loss,$61.50,$42.00,$52473.50,11,$42.00
2024-01-16,13:52:00,16901.25,SELL,3,0.02h,Stop Loss,$13.50,$55.50,$52487.00,11,$55.50
2024-01-16,14:27:00,16905.75,BUY,3,0.02h,Break Even,$-1.50,$54.00,$52485.50,11,$54.00
2024-01-16,14:42:00,16884.0,SELL,3,0.02h,Stop Loss,$61.50,$115.50,$52547.00,11,$115.50
2024-01-16,14:59:00,16903.75,BUY,3,0.02h,Stop Loss,$75.00,$190.50,$52622.00,11,$190.50
2024-01-16,16:01:00,16977.75,SELL,3,0.02h,Stop Loss,$240.00,$430.50,$52862.00,11,$430.50
2024-01-16,16:20:00,16989.75,BUY,3,0.02h,Stop Loss,$27.00,$457.50,$52889.00,11,$457.50
2024-01-16,16:43:00,16997.0,SELL,3,0.02h,Stop Loss,$78.00,$535.50,$52967.00,11,$535.50
2024-01-16,18:12:00,16911.5,BUY,3,0.02h,Stop Loss,$-9.00,$526.50,$52958.00,11,$526.50
2024-01-16,18:43:00,16921.0,SELL,3,0.02h,Stop Loss,$15.00,$541.50,$52973.00,11,$541.50
2024-01-16,19:29:00,16894.75,BUY,3,0.02h,Break Even,$-1.50,$540.00,$52971.50,11,$540.00
2024-01-16,19:32:00,16882.0,SELL,3,0.02h,Break Even,$-1.50,$538.50,$52970.00,11,$538.50
2024-01-16,19:35:00,16898.0,BUY,3,0.02h,Break Even,$-1.50,$537.00,$52968.50,11,$537.00
2024-01-16,20:32:00,16929.0,SELL,3,0.02h,Break Even,$-1.50,$535.50,$52967.00,11,$535.50
2024-01-16,20:41:00,16936.0,BUY,3,0.02h,Break Even,$-1.50,$534.00,$52965.50,11,$534.00
,,,,,,,,,,,
2024-01-17,12:00:00,16891.75,SELL,3,0.02h,Stop Loss,$-9.00,$-9.00,$52956.50,12,$-9.00
2024-01-17,12:56:00,16899.25,BUY,3,0.02h,Break Even,$-1.50,$-10.50,$52955.00,12,$-10.50
2024-01-17,13:01:00,16882.5,SELL,3,0.02h,Break Even,$-1.50,$-12.00,$52953.50,12,$-12.00
2024-01-17,14:11:00,16834.0,BUY,3,0.02h,Break Even,$-1.50,$-13.50,$52952.00,12,$-13.50
2024-01-17,14:25:00,16821.5,SELL,3,0.02h,Stop Loss,$3.00,$-10.50,$52955.00,12,$-10.50
2024-01-17,15:10:00,16735.5,BUY,3,0.02h,Stop Loss,$-9.00,$-19.50,$52946.00,12,$-19.50
2024-01-17,15:22:00,16722.75,SELL,3,0.02h,Stop Loss,$16.50,$-3.00,$52962.50,12,$-3.00
2024-01-17,15:26:00,16745.75,BUY,3,0.02h,Stop Loss,$37.50,$34.50,$53000.00,12,$34.50
2024-01-17,15:58:00,16757.25,SELL,3,0.02h,Stop Loss,$9.00,$43.50,$53009.00,12,$43.50
2024-01-17,16:00:00,16769.25,BUY,3,0.02h,Stop Loss,$42.00,$85.50,$53051.00,12,$85.50
2024-01-17,16:52:00,16803.0,SELL,3,0.02h,Stop Loss,$-9.00,$76.50,$53042.00,12,$76.50
2024-01-17,17:15:00,16817.0,BUY,3,0.02h,Stop Loss,$13.50,$90.00,$53055.50,12,$90.00
2024-01-17,17:22:00,16806.5,SELL,3,0.02h,Stop Loss,$28.50,$118.50,$53084.00,12,$118.50
2024-01-17,17:52:00,16800.0,BUY,3,0.02h,Stop Loss,$13.50,$132.00,$53097.50,12,$132.00
2024-01-17,18:12:00,16792.75,SELL,3,0.02h,Break Even,$-1.50,$130.50,$53096.00,12,$130.50
2024-01-17,18:59:00,16763.25,BUY,3,0.02h,Stop Loss,$-9.00,$121.50,$53087.00,12,$121.50
2024-01-17,20:04:00,16811.25,SELL,3,0.02h,Break Even,$-1.50,$120.00,$53085.50,12,$120.00
2024-01-17,20:34:00,16818.75,BUY,3,0.02h,Stop Loss,$28.50,$148.50,$53114.00,12,$148.50
2024-01-17,21:13:00,16857.75,SELL,3,0.02h,Stop Loss,$-9.00,$139.50,$53105.00,12,$139.50
2024-01-17,21:16:00,16861.75,BUY,3,0.02h,Stop Loss,$-9.00,$130.50,$53096.00,12,$130.50
2024-01-17,21:58:00,16860.25,SELL,3,0.02h,Stop Loss,$-9.00,$121.50,$53087.00,12,$121.50
,,,,,,,,,,,
2024-01-18,12:00:00,16992.75,BUY,3,0.02h,Break Even,$-1.50,$-1.50,$53085.50,13,$-1.50
2024-01-18,13:00:00,17006.5,SELL,3,0.02h,Stop Loss,$-9.00,$-10.50,$53076.50,13,$-10.50
2024-01-18,13:07:00,17014.5,BUY,3,0.02h,Stop Loss,$3.00,$-7.50,$53079.50,13,$-7.50
2024-01-18,13:31:00,17000.75,SELL,3,0.02h,Stop Loss,$-9.00,$-16.50,$53070.50,13,$-16.50
2024-01-18,13:36:00,17038.25,BUY,3,0.02h,Stop Loss,$18.00,$1.50,$53088.50,13,$1.50
2024-01-18,13:41:00,17006.5,SELL,3,0.02h,Stop Loss,$61.50,$63.00,$53150.00,13,$63.00
2024-01-18,14:07:00,17001.75,BUY,3,0.02h,Stop Loss,$-9.00,$54.00,$53141.00,13,$54.00
2024-01-18,14:24:00,16997.0,SELL,3,0.02h,Stop Loss,$-9.00,$45.00,$53132.00,13,$45.00
2024-01-18,14:31:00,17029.75,BUY,3,0.02h,Stop Loss,$85.50,$130.50,$53217.50,13,$130.50
2024-01-18,14:53:00,17016.0,SELL,3,0.02h,Stop Loss,$36.00,$166.50,$53253.50,13,$166.50
2024-01-18,14:59:00,17029.25,BUY,3,0.02h,Stop Loss,$12.00,$178.50,$53265.50,13,$178.50
2024-01-18,15:03:00,17000.25,SELL,3,0.02h,Stop Loss,$57.00,$235.50,$53322.50,13,$235.50
2024-01-18,15:17:00,17020.75,BUY,3,0.02h,Stop Loss,$72.00,$307.50,$53394.50,13,$307.50
2024-01-18,15:22:00,17007.75,SELL,3,0.02h,Stop Loss,$-9.00,$298.50,$53385.50,13,$298.50
2024-01-18,15:23:00,17027.5,BUY,3,0.02h,Stop Loss,$3.00,$301.50,$53388.50,13,$301.50
2024-01-18,16:01:00,17041.5,SELL,3,0.02h,Stop Loss,$22.50,$324.00,$53411.00,13,$324.00
2024-01-18,16:14:00,17063.0,BUY,3,0.02h,Break Even,$-1.50,$322.50,$53409.50,13,$322.50
2024-01-18,16:46:00,17076.75,SELL,3,0.02h,Stop Loss,$18.00,$340.50,$53427.50,13,$340.50
2024-01-18,16:54:00,17088.25,BUY,3,0.02h,Stop Loss,$-9.00,$331.50,$53418.50,13,$331.50
2024-01-18,16:58:00,17079.25,SELL,3,0.02h,Stop Loss,$-9.00,$322.50,$53409.50,13,$322.50
2024-01-18,17:45:00,17020.25,BUY,3,0.02h,Stop Loss,$22.50,$345.00,$53432.00,13,$345.00
2024-01-18,17:53:00,17005.75,SELL,3,0.02h,Stop Loss,$45.00,$390.00,$53477.00,13,$390.00
2024-01-18,18:34:00,16982.75,BUY,3,0.02h,Break Even,$-1.50,$388.50,$53475.50,13,$388.50
2024-01-18,19:48:00,17071.0,SELL,3,0.02h,Stop Loss,$-9.00,$379.50,$53466.50,13,$379.50
2024-01-18,19:50:00,17094.5,BUY,3,0.02h,Stop Loss,$13.50,$393.00,$53480.00,13,$393.00
2024-01-18,20:40:00,17093.0,SELL,3,0.02h,Stop Loss,$22.50,$415.50,$53502.50,13,$415.50
2024-01-18,20:47:00,17107.5,BUY,3,0.02h,Stop Loss,$7.50,$423.00,$53510.00,13,$423.00
2024-01-18,21:01:00,17095.5,SELL,3,0.02h,Break Even,$-1.50,$421.50,$53508.50,13,$421.50
2024-01-18,21:16:00,17107.25,BUY,3,0.02h,Stop Loss,$16.50,$438.00,$53525.00,13,$438.00
2024-01-18,21:47:00,17114.75,SELL,3,0.02h,Stop Loss,$-9.00,$429.00,$53516.00,13,$429.00
2024-01-18,21:53:00,17119.5,BUY,3,0.02h,Stop Loss,$-9.00,$420.00,$53507.00,13,$420.00
2024-01-18,21:57:00,17115.5,SELL,3,0.02h,Stop Loss,$-9.00,$411.00,$53498.00,13,$411.00
,,,,,,,,,,,
2024-01-19,12:00:00,17247.0,BUY,3,0.02h,Stop Loss,$-9.00,$-9.00,$53489.00,14,$-9.00
2024-01-19,12:41:00,17218.75,SELL,3,0.02h,Break Even,$-1.50,$-10.50,$53487.50,14,$-10.50
2024-01-19,12:52:00,17226.0,BUY,3,0.02h,Stop Loss,$10.50,$0.00,$53498.00,14,$0.00
2024-01-19,13:27:00,17234.75,SELL,3,0.02h,Break Even,$-1.50,$-1.50,$53496.50,14,$-1.50
2024-01-19,14:25:00,17221.5,BUY,3,0.02h,Stop Loss,$-9.00,$-10.50,$53487.50,14,$-10.50
2024-01-19,14:26:00,17207.0,SELL,3,0.02h,Stop Loss,$-9.00,$-19.50,$53478.50,14,$-19.50
2024-01-19,14:54:00,17207.0,BUY,3,0.02h,Stop Loss,$15.00,$-4.50,$53493.50,14,$-4.50
2024-01-19,15:08:00,17182.0,SELL,3,0.02h,Stop Loss,$58.50,$54.00,$53552.00,14,$54.00
2024-01-19,15:19:00,17209.5,BUY,3,0.02h,Stop Loss,$22.50,$76.50,$53574.50,14,$76.50
2024-01-19,16:36:00,17245.25,SELL,3,0.02h,Stop Loss,$31.50,$108.00,$53606.00,14,$108.00
2024-01-19,16:53:00,17250.0,BUY,3,0.02h,Stop Loss,$10.50,$118.50,$53616.50,14,$118.50
2024-01-19,17:12:00,17241.25,SELL,3,0.02h,Stop Loss,$-9.00,$109.50,$53607.50,14,$109.50
2024-01-19,17:15:00,17258.75,BUY,3,0.02h,Stop Loss,$12.00,$121.50,$53619.50,14,$121.50
2024-01-19,19:34:00,17406.25,SELL,3,0.02h,Stop Loss,$57.00,$178.50,$53676.50,14,$178.50
2024-01-19,19:42:00,17420.75,BUY,3,0.02h,Stop Loss,$-9.00,$169.50,$53667.50,14,$169.50
2024-01-19,20:22:00,17423.0,SELL,3,0.02h,Break Even,$-1.50,$168.00,$53666.00,14,$168.00
2024-01-19,20:35:00,17435.5,BUY,3,0.02h,Stop Loss,$7.50,$175.50,$53673.50,14,$175.50
2024-01-19,20:41:00,17427.5,SELL,3,0.02h,Stop Loss,$-9.00,$166.50,$53664.50,14,$166.50
2024-01-19,20:42:00,17433.0,BUY,3,0.02h,Stop Loss,$3.00,$169.50,$53667.50,14,$169.50
2024-01-19,20:45:00,17426.0,SELL,3,0.02h,Break Even,$-1.50,$168.00,$53666.00,14,$168.00
2024-01-19,20:46:00,17435.25,BUY,3,0.02h,Stop Loss,$6.00,$174.00,$53672.00,14,$174.00
2024-01-19,22:00:00,17463.25,SELL,3,62.00h,Stop Loss,$-9.00,$165.00,$53663.00,14,$165.00
,,,,,,,,,,,
2024-01-22,12:00:00,17535.75,BUY,3,0.02h,Break Even,$-1.50,$-1.50,$53661.50,15,$-1.50
2024-01-22,13:02:00,17567.0,SELL,3,0.02h,Stop Loss,$24.00,$22.50,$53685.50,15,$22.50
2024-01-22,13:30:00,17560.0,BUY,3,0.02h,Stop Loss,$-9.00,$13.50,$53676.50,15,$13.50
2024-01-22,13:31:00,17551.75,SELL,3,0.02h,Stop Loss,$16.50,$30.00,$53693.00,15,$30.00
2024-01-22,14:24:00,17530.75,BUY,3,0.02h,Stop Loss,$-9.00,$21.00,$53684.00,15,$21.00
2024-01-22,14:43:00,17514.0,SELL,3,0.02h,Stop Loss,$105.00,$126.00,$53789.00,15,$126.00
2024-01-22,14:54:00,17541.0,BUY,3,0.02h,Stop Loss,$7.50,$133.50,$53796.50,15,$133.50
2024-01-22,15:04:00,17522.0,SELL,3,0.02h,Stop Loss,$106.50,$240.00,$53903.00,15,$240.00
2024-01-22,15:15:00,17538.25,BUY,3,0.02h,Stop Loss,$10.50,$250.50,$53913.50,15,$250.50
2024-01-22,15:20:00,17514.5,SELL,3,0.02h,Stop Loss,$21.00,$271.50,$53934.50,15,$271.50
2024-01-22,16:11:00,17472.5,BUY,3,0.02h,Break Even,$-1.50,$270.00,$53933.00,15,$270.00
2024-01-22,17:07:00,17479.75,SELL,3,0.02h,Stop Loss,$78.00,$348.00,$54011.00,15,$348.00
2024-01-22,17:23:00,17493.75,BUY,3,0.02h,Stop Loss,$7.50,$355.50,$54018.50,15,$355.50
2024-01-22,17:35:00,17477.0,SELL,3,0.02h,Stop Loss,$24.00,$379.50,$54042.50,15,$379.50
2024-01-22,17:54:00,17490.75,BUY,3,0.02h,Break Even,$-1.50,$378.00,$54041.00,15,$378.00
2024-01-22,18:01:00,17470.75,SELL,3,0.02h,Stop Loss,$12.00,$390.00,$54053.00,15,$390.00
2024-01-22,18:39:00,17466.0,BUY,3,0.02h,Break Even,$-1.50,$388.50,$54051.50,15,$388.50
2024-01-22,19:14:00,17473.0,SELL,3,0.02h,Stop Loss,$13.50,$402.00,$54065.00,15,$402.00
2024-01-22,19:38:00,17466.0,BUY,3,0.02h,Stop Loss,$12.00,$414.00,$54077.00,15,$414.00
2024-01-22,19:49:00,17458.5,SELL,3,0.02h,Stop Loss,$-9.00,$405.00,$54068.00,15,$405.00
2024-01-22,19:57:00,17466.0,BUY,3,0.02h,Stop Loss,$-9.00,$396.00,$54059.00,15,$396.00
2024-01-22,20:03:00,17459.25,SELL,3,0.02h,Break Even,$-1.50,$394.50,$54057.50,15,$394.50
2024-01-22,20:11:00,17473.25,BUY,3,0.02h,Stop Loss,$4.50,$399.00,$54062.00,15,$399.00
2024-01-22,20:43:00,17470.75,SELL,3,0.02h,Break Even,$-1.50,$397.50,$54060.50,15,$397.50
2024-01-22,21:30:00,17454.5,BUY,3,0.02h,Stop Loss,$-9.00,$388.50,$54051.50,15,$388.50
2024-01-22,21:57:00,17456.25,SELL,3,0.03h,Stop Loss,$-9.00,$379.50,$54042.50,15,$379.50
,,,,,,,,,,,
2024-01-23,12:00:00,17474.25,BUY,3,0.02h,Break Even,$-1.50,$-1.50,$54041.00,16,$-1.50
2024-01-23,12:28:00,17469.0,SELL,3,0.03h,Break Even,$-1.50,$-3.00,$54039.50,16,$-3.00
2024-01-23,12:37:00,17473.75,BUY,3,0.02h,Break Even,$-1.50,$-4.50,$54038.00,16,$-4.50
2024-01-23,12:49:00,17470.25,SELL,3,0.02h,Break Even,$-1.50,$-6.00,$54036.50,16,$-6.00
2024-01-23,12:57:00,17479.5,BUY,3,0.02h,Break Even,$-1.50,$-7.50,$54035.00,16,$-7.50
2024-01-23,13:52:00,17503.25,SELL,3,0.02h,Stop Loss,$-9.00,$-16.50,$54026.00,16,$-16.50
2024-01-23,14:51:00,17476.0,BUY,3,0.02h,Stop Loss,$7.50,$-9.00,$54033.50,16,$-9.00
2024-01-23,15:07:00,17467.5,SELL,3,0.02h,Break Even,$-1.50,$-10.50,$54032.00,16,$-10.50
2024-01-23,15:08:00,17473.25,BUY,3,0.02h,Stop Loss,$16.50,$6.00,$54048.50,16,$6.00
2024-01-23,15:10:00,17466.75,SELL,3,0.02h,Stop Loss,$13.50,$19.50,$54062.00,16,$19.50
2024-01-23,15:12:00,17479.5,BUY,3,0.02h,Stop Loss,$10.50,$30.00,$54072.50,16,$30.00
2024-01-23,15:19:00,17455.75,SELL,3,0.02h,Stop Loss,$9.00,$39.00,$54081.50,16,$39.00
2024-01-23,15:39:00,17466.75,BUY,3,0.02h,Stop Loss,$22.50,$61.50,$54104.00,16,$61.50
2024-01-23,15:51:00,17457.75,SELL,3,0.02h,Stop Loss,$19.50,$81.00,$54123.50,16,$81.00
2024-01-23,16:04:00,17466.0,BUY,3,0.02h,Stop Loss,$16.50,$97.50,$54140.00,16,$97.50
2024-01-23,16:17:00,17448.75,SELL,3,0.02h,Stop Loss,$30.00,$127.50,$54170.00,16,$127.50
2024-01-23,16:46:00,17450.75,BUY,3,0.02h,Stop Loss,$21.00,$148.50,$54191.00,16,$148.50
2024-01-23,17:17:00,17453.25,SELL,3,0.02h,Break Even,$-1.50,$147.00,$54189.50,16,$147.00
2024-01-23,17:43:00,17454.75,BUY,3,0.02h,Stop Loss,$-9.00,$138.00,$54180.50,16,$138.00
2024-01-23,18:30:00,17476.5,SELL,3,0.02h,Stop Loss,$-9.00,$129.00,$54171.50,16,$129.00
2024-01-23,18:49:00,17480.25,BUY,3,0.02h,Break Even,$-1.50,$127.50,$54170.00,16,$127.50
2024-01-23,19:07:00,17473.75,SELL,3,0.02h,Stop Loss,$12.00,$139.50,$54182.00,16,$139.50
2024-01-23,19:39:00,17478.0,BUY,3,0.02h,Stop Loss,$-9.00,$130.50,$54173.00,16,$130.50
2024-01-23,20:36:00,17503.25,SELL,3,0.02h,Break Even,$-1.50,$129.00,$54171.50,16,$129.00
2024-01-23,20:47:00,17513.0,BUY,3,0.02h,Stop Loss,$-9.00,$120.00,$54162.50,16,$120.00
2024-01-23,20:50:00,17503.5,SELL,3,0.02h,Break Even,$-1.50,$118.50,$54161.00,16,$118.50
2024-01-23,20:51:00,17519.0,BUY,3,0.02h,Stop Loss,$10.50,$129.00,$54171.50,16,$129.00
2024-01-23,21:11:00,17520.25,SELL,3,0.02h,Break Even,$-1.50,$127.50,$54170.00,16,$127.50
2024-01-23,21:15:00,17531.5,BUY,3,0.02h,Break Even,$-1.50,$126.00,$54168.50,16,$126.00
,,,,,,,,,,,
2024-01-24,13:40:00,17678.75,SELL,3,0.02h,Break Even,$-1.50,$-1.50,$54167.00,17,$-1.50
2024-01-24,14:15:00,17670.5,BUY,3,0.02h,Break Even,$-1.50,$-3.00,$54165.50,17,$-3.00
2024-01-24,14:33:00,17667.75,SELL,3,0.02h,Stop Loss,$-9.00,$-12.00,$54156.50,17,$-12.00
2024-01-24,14:54:00,17668.25,BUY,3,0.02h,Break Even,$-1.50,$-13.50,$54155.00,17,$-13.50
2024-01-24,15:02:00,17648.25,SELL,3,0.02h,Break Even,$-1.50,$-15.00,$54153.50,17,$-15.00
2024-01-24,15:09:00,17681.25,BUY,3,0.02h,Stop Loss,$-9.00,$-24.00,$54144.50,17,$-24.00
2024-01-24,15:57:00,17732.25,SELL,3,0.02h,Break Even,$-1.50,$-25.50,$54143.00,17,$-25.50
2024-01-24,16:01:00,17740.5,BUY,3,0.02h,Stop Loss,$-9.00,$-34.50,$54134.00,17,$-34.50
2024-01-24,16:07:00,17717.75,SELL,3,0.02h,Stop Loss,$93.00,$58.50,$54227.00,17,$58.50
2024-01-24,16:38:00,17718.0,BUY,3,0.02h,Stop Loss,$-9.00,$49.50,$54218.00,17,$49.50
2024-01-24,16:46:00,17708.75,SELL,3,0.02h,Break Even,$-1.50,$48.00,$54216.50,17,$48.00
2024-01-24,16:49:00,17722.25,BUY,3,0.02h,Stop Loss,$16.50,$64.50,$54233.00,17,$64.50
2024-01-24,17:20:00,17740.75,SELL,3,0.02h,Stop Loss,$13.50,$78.00,$54246.50,17,$78.00
2024-01-24,17:23:00,17748.75,BUY,3,0.02h,Stop Loss,$6.00,$84.00,$54252.50,17,$84.00
2024-01-24,18:02:00,17758.5,SELL,3,0.02h,Stop Loss,$45.00,$129.00,$54297.50,17,$129.00
2024-01-24,18:29:00,17763.75,BUY,3,0.02h,Stop Loss,$-9.00,$120.00,$54288.50,17,$120.00
2024-01-24,18:34:00,17739.75,SELL,3,0.02h,Stop Loss,$-9.00,$111.00,$54279.50,17,$111.00
2024-01-24,19:44:00,17675.25,BUY,3,0.02h,Stop Loss,$19.50,$130.50,$54299.00,17,$130.50
2024-01-24,19:58:00,17662.0,SELL,3,0.02h,Break Even,$-1.50,$129.00,$54297.50,17,$129.00
2024-01-24,20:07:00,17679.25,BUY,3,0.02h,Stop Loss,$3.00,$132.00,$54300.50,17,$132.00
2024-01-24,20:12:00,17660.0,SELL,3,0.02h,Break Even,$-1.50,$130.50,$54299.00,17,$130.50
2024-01-24,20:39:00,17649.5,BUY,3,0.02h,Break Even,$-1.50,$129.00,$54297.50,17,$129.00
2024-01-24,20:51:00,17621.0,SELL,3,0.02h,Break Even,$-1.50,$127.50,$54296.00,17,$127.50
2024-01-24,21:33:00,17604.75,BUY,3,0.02h,Stop Loss,$-9.00,$118.50,$54287.00,17,$118.50
,,,,,,,,,,,
2024-01-25,12:24:00,17640.5,SELL,3,0.02h,Break Even,$-1.50,$-1.50,$54285.50,18,$-1.50
2024-01-25,12:34:00,17648.5,BUY,3,0.02h,Stop Loss,$-9.00,$-10.50,$54276.50,18,$-10.50
2024-01-25,12:36:00,17642.5,SELL,3,0.02h,Stop Loss,$-9.00,$-19.50,$54267.50,18,$-19.50
2024-01-25,12:37:00,17646.75,BUY,3,0.02h,Break Even,$-1.50,$-21.00,$54266.00,18,$-21.00
2024-01-25,12:56:00,17643.75,SELL,3,0.02h,Stop Loss,$6.00,$-15.00,$54272.00,18,$-15.00
2024-01-25,13:17:00,17649.0,BUY,3,0.02h,Stop Loss,$6.00,$-9.00,$54278.00,18,$-9.00
2024-01-25,14:31:00,17687.75,SELL,3,0.02h,Stop Loss,$22.50,$13.50,$54300.50,18,$13.50
2024-01-25,15:10:00,17698.25,BUY,3,0.02h,Stop Loss,$36.00,$49.50,$54336.50,18,$49.50
2024-01-25,15:37:00,17694.5,SELL,3,0.02h,Stop Loss,$6.00,$55.50,$54342.50,18,$55.50
2024-01-25,15:45:00,17720.75,BUY,3,0.02h,Break Even,$-1.50,$54.00,$54341.00,18,$54.00
2024-01-25,15:50:00,17697.75,SELL,3,0.02h,Stop Loss,$24.00,$78.00,$54365.00,18,$78.00
2024-01-25,16:13:00,17709.75,BUY,3,0.02h,Stop Loss,$40.50,$118.50,$54405.50,18,$118.50
2024-01-25,16:43:00,17705.0,SELL,3,0.02h,Stop Loss,$-9.00,$109.50,$54396.50,18,$109.50
2024-01-25,16:48:00,17722.5,BUY,3,0.02h,Stop Loss,$58.50,$168.00,$54455.00,18,$168.00
2024-01-25,17:02:00,17720.0,SELL,3,0.02h,Stop Loss,$27.00,$195.00,$54482.00,18,$195.00
2024-01-25,18:03:00,17670.75,BUY,3,0.02h,Stop Loss,$19.50,$214.50,$54501.50,18,$214.50
2024-01-25,18:16:00,17646.5,SELL,3,0.02h,Stop Loss,$57.00,$271.50,$54558.50,18,$271.50
2024-01-25,18:45:00,17634.75,BUY,3,0.02h,Stop Loss,$6.00,$277.50,$54564.50,18,$277.50
2024-01-25,18:54:00,17620.75,SELL,3,0.02h,Stop Loss,$42.00,$319.50,$54606.50,18,$319.50
2024-01-25,19:31:00,17576.0,BUY,3,0.02h,Stop Loss,$16.50,$336.00,$54623.00,18,$336.00
2024-01-25,19:39:00,17565.5,SELL,3,0.02h,Stop Loss,$-9.00,$327.00,$54614.00,18,$327.00
2024-01-25,19:43:00,17574.5,BUY,3,0.02h,Stop Loss,$3.00,$330.00,$54617.00,18,$330.00
2024-01-25,20:25:00,17590.5,SELL,3,0.02h,Stop Loss,$-9.00,$321.00,$54608.00,18,$321.00
2024-01-25,20:33:00,17614.25,BUY,3,0.02h,Stop Loss,$55.50,$376.50,$54663.50,18,$376.50
2024-01-25,20:45:00,17604.25,SELL,3,0.02h,Break Even,$-1.50,$375.00,$54662.00,18,$375.00
2024-01-25,20:48:00,17610.0,BUY,3,0.02h,Break Even,$-1.50,$373.50,$54660.50,18,$373.50
2024-01-25,21:08:00,17606.5,SELL,3,0.02h,Break Even,$-1.50,$372.00,$54659.00,18,$372.00
2024-01-25,21:33:00,17606.25,BUY,3,0.02h,Stop Loss,$-9.00,$363.00,$54650.00,18,$363.00
2024-01-25,21:39:00,17598.25,SELL,3,0.02h,Break Even,$-1.50,$361.50,$54648.50,18,$361.50
2024-01-25,21:41:00,17605.0,BUY,3,0.02h,Stop Loss,$12.00,$373.50,$54660.50,18,$373.50
2024-01-25,21:47:00,17596.25,SELL,3,0.02h,Break Even,$-1.50,$372.00,$54659.00,18,$372.00
,,,,,,,,,,,
2024-01-26,12:19:00,17577.25,BUY,3,0.02h,Break Even,$-1.50,$-1.50,$54657.50,19,$-1.50
2024-01-26,12:52:00,17573.0,SELL,3,0.02h,Stop Loss,$-9.00,$-10.50,$54648.50,19,$-10.50
2024-01-26,13:08:00,17580.75,BUY,3,0.02h,Stop Loss,$3.00,$-7.50,$54651.50,19,$-7.50
2024-01-26,13:20:00,17573.25,SELL,3,0.02h,Stop Loss,$-9.00,$-16.50,$54642.50,19,$-16.50
2024-01-26,13:21:00,17580.75,BUY,3,0.02h,Break Even,$-1.50,$-18.00,$54641.00,19,$-18.00
2024-01-26,13:24:00,17575.5,SELL,3,0.02h,Break Even,$-1.50,$-19.50,$54639.50,19,$-19.50
2024-01-26,13:43:00,17586.25,BUY,3,0.02h,Stop Loss,$-9.00,$-28.50,$54630.50,19,$-28.50
2024-01-26,14:04:00,17578.0,SELL,3,0.02h,Stop Loss,$52.50,$24.00,$54683.00,19,$24.00
2024-01-26,14:34:00,17567.25,BUY,3,0.02h,Stop Loss,$4.50,$28.50,$54687.50,19,$28.50
2024-01-26,14:36:00,17549.25,SELL,3,0.02h,Stop Loss,$85.50,$114.00,$54773.00,19,$114.00
2024-01-26,15:15:00,17541.5,BUY,3,0.02h,Stop Loss,$-9.00,$105.00,$54764.00,19,$105.00
2024-01-26,15:17:00,17528.5,SELL,3,0.02h,Stop Loss,$49.50,$154.50,$54813.50,19,$154.50
2024-01-26,15:22:00,17553.25,BUY,3,0.02h,Stop Loss,$31.50,$186.00,$54845.00,19,$186.00
2024-01-26,16:15:00,17595.0,SELL,3,0.02h,Stop Loss,$-9.00,$177.00,$54836.00,19,$177.00
2024-01-26,16:24:00,17612.75,BUY,3,0.02h,Stop Loss,$-9.00,$168.00,$54827.00,19,$168.00
2024-01-26,16:38:00,17595.75,SELL,3,0.02h,Stop Loss,$55.50,$223.50,$54882.50,19,$223.50
2024-01-26,16:53:00,17602.25,BUY,3,0.02h,Break Even,$-1.50,$222.00,$54881.00,19,$222.00
2024-01-26,17:26:00,17604.5,SELL,3,0.02h,Stop Loss,$37.50,$259.50,$54918.50,19,$259.50
2024-01-26,18:13:00,17540.25,BUY,3,0.02h,Stop Loss,$-9.00,$250.50,$54909.50,19,$250.50
2024-01-26,18:16:00,17528.0,SELL,3,0.02h,Stop Loss,$10.50,$261.00,$54920.00,19,$261.00
2024-01-26,18:24:00,17541.0,BUY,3,0.02h,Stop Loss,$-9.00,$252.00,$54911.00,19,$252.00
2024-01-26,18:42:00,17521.25,SELL,3,0.02h,Stop Loss,$36.00,$288.00,$54947.00,19,$288.00
2024-01-26,19:03:00,17530.75,BUY,3,0.02h,Stop Loss,$16.50,$304.50,$54963.50,19,$304.50
2024-01-26,19:24:00,17527.75,SELL,3,0.02h,Stop Loss,$9.00,$313.50,$54972.50,19,$313.50
2024-01-26,19:38:00,17539.75,BUY,3,0.02h,Break Even,$-1.50,$312.00,$54971.00,19,$312.00
2024-01-26,20:10:00,17551.5,SELL,3,0.02h,Stop Loss,$-9.00,$303.00,$54962.00,19,$303.00
2024-01-26,20:11:00,17557.25,BUY,3,0.02h,Stop Loss,$-9.00,$294.00,$54953.00,19,$294.00
2024-01-26,20:12:00,17552.0,SELL,3,0.02h,Break Even,$-1.50,$292.50,$54951.50,19,$292.50
2024-01-26,20:14:00,17558.25,BUY,3,0.02h,Stop Loss,$9.00,$301.50,$54960.50,19,$301.50
2024-01-26,20:22:00,17547.75,SELL,3,0.02h,Stop Loss,$24.00,$325.50,$54984.50,19,$325.50
2024-01-26,22:00:00,17504.75,BUY,3,62.00h,Stop Loss,$369.00,$694.50,$55353.50,19,$694.50
,,,,,,,,,,,
2024-01-29,12:37:00,17561.25,SELL,3,0.02h,Stop Loss,$19.50,$19.50,$55373.00,20,$19.50
2024-01-29,13:09:00,17564.0,BUY,3,0.02h,Stop Loss,$-9.00,$10.50,$55364.00,20,$10.50
2024-01-29,13:20:00,17552.0,SELL,3,0.02h,Break Even,$-1.50,$9.00,$55362.50,20,$9.00
2024-01-29,13:55:00,17548.75,BUY,3,0.02h,Stop Loss,$-9.00,$0.00,$55353.50,20,$0.00
2024-01-29,14:02:00,17541.25,SELL,3,0.02h,Break Even,$-1.50,$-1.50,$55352.00,20,$-1.50
2024-01-29,14:07:00,17548.25,BUY,3,0.02h,Break Even,$-1.50,$-3.00,$55350.50,20,$-3.00
2024-01-29,14:16:00,17543.25,SELL,3,0.02h,Stop Loss,$6.00,$3.00,$55356.50,20,$3.00
2024-01-29,14:23:00,17551.25,BUY,3,0.02h,Break Even,$-1.50,$1.50,$55355.00,20,$1.50
2024-01-29,14:31:00,17537.5,SELL,3,0.02h,Stop Loss,$25.50,$27.00,$55380.50,20,$27.00
2024-01-29,14:35:00,17553.25,BUY,3,0.02h,Stop Loss,$31.50,$58.50,$55412.00,20,$58.50
2024-01-29,14:58:00,17557.25,SELL,3,0.02h,Stop Loss,$13.50,$72.00,$55425.50,20,$72.00
2024-01-29,15:15:00,17560.25,BUY,3,0.02h,Stop Loss,$28.50,$100.50,$55454.00,20,$100.50
2024-01-29,15:23:00,17538.75,SELL,3,0.02h,Stop Loss,$7.50,$108.00,$55461.50,20,$108.00
2024-01-29,15:32:00,17560.5,BUY,3,0.02h,Break Even,$-1.50,$106.50,$55460.00,20,$106.50
2024-01-29,15:33:00,17550.25,SELL,3,0.02h,Stop Loss,$97.50,$204.00,$55557.50,20,$204.00
2024-01-29,16:12:00,17543.0,BUY,3,0.02h,Break Even,$-1.50,$202.50,$55556.00,20,$202.50
2024-01-29,17:47:00,17583.75,SELL,3,0.02h,Stop Loss,$-9.00,$193.50,$55547.00,20,$193.50
2024-01-29,17:57:00,17603.5,BUY,3,0.02h,Break Even,$-1.50,$192.00,$55545.50,20,$192.00
2024-01-29,18:02:00,17585.25,SELL,3,0.02h,Break Even,$-1.50,$190.50,$55544.00,20,$190.50
2024-01-29,18:22:00,17592.75,BUY,3,0.02h,Stop Loss,$-9.00,$181.50,$55535.00,20,$181.50
2024-01-29,18:23:00,17587.75,SELL,3,0.02h,Stop Loss,$-9.00,$172.50,$55526.00,20,$172.50
2024-01-29,18:26:00,17597.25,BUY,3,0.02h,Break Even,$-1.50,$171.00,$55524.50,20,$171.00
2024-01-29,18:53:00,17592.5,SELL,3,0.02h,Break Even,$-1.50,$169.50,$55523.00,20,$169.50
2024-01-29,19:08:00,17596.75,BUY,3,0.02h,Break Even,$-1.50,$168.00,$55521.50,20,$168.00
2024-01-29,19:54:00,17621.25,SELL,3,0.02h,Break Even,$-1.50,$166.50,$55520.00,20,$166.50
2024-01-29,19:56:00,17626.75,BUY,3,0.02h,Break Even,$-1.50,$165.00,$55518.50,20,$165.00
2024-01-29,20:45:00,17692.75,SELL,3,0.02h,Stop Loss,$43.50,$208.50,$55562.00,20,$208.50
2024-01-29,20:58:00,17698.5,BUY,3,0.02h,Stop Loss,$22.50,$231.00,$55584.50,20,$231.00
2024-01-29,21:07:00,17689.75,SELL,3,0.02h,Stop Loss,$-9.00,$222.00,$55575.50,20,$222.00
2024-01-29,21:16:00,17703.25,BUY,3,0.02h,Stop Loss,$7.50,$229.50,$55583.00,20,$229.50
2024-01-29,21:46:00,17701.5,SELL,3,0.02h,Stop Loss,$-9.00,$220.50,$55574.00,20,$220.50
,,,,,,,,,,,
2024-01-30,12:23:00,17698.75,BUY,3,0.02h,Stop Loss,$-9.00,$-9.00,$55565.00,21,$-9.00
2024-01-30,12:27:00,17693.0,SELL,3,0.02h,Stop Loss,$3.00,$-6.00,$55568.00,21,$-6.00
2024-01-30,13:31:00,17668.5,BUY,3,0.02h,Break Even,$-1.50,$-7.50,$55566.50,21,$-7.50
2024-01-30,13:37:00,17660.0,SELL,3,0.02h,Stop Loss,$-9.00,$-16.50,$55557.50,21,$-16.50
2024-01-30,14:02:00,17664.0,BUY,3,0.02h,Break Even,$-1.50,$-18.00,$55556.00,21,$-18.00
2024-01-30,14:15:00,17657.75,SELL,3,0.02h,Break Even,$-1.50,$-19.50,$55554.50,21,$-19.50
2024-01-30,14:27:00,17664.75,BUY,3,0.02h,Stop Loss,$4.50,$-15.00,$55559.00,21,$-15.00
2024-01-30,14:56:00,17668.25,SELL,3,0.02h,Stop Loss,$22.50,$7.50,$55581.50,21,$7.50
2024-01-30,15:21:00,17657.0,BUY,3,0.02h,Break Even,$-1.50,$6.00,$55580.00,21,$6.00
2024-01-30,15:22:00,17651.25,SELL,3,0.02h,Stop Loss,$15.00,$21.00,$55595.00,21,$21.00
2024-01-30,15:24:00,17657.0,BUY,3,0.02h,Stop Loss,$-9.00,$12.00,$55586.00,21,$12.00
2024-01-30,15:26:00,17644.75,SELL,3,0.02h,Stop Loss,$61.50,$73.50,$55647.50,21,$73.50
2024-01-30,15:32:00,17658.25,BUY,3,0.02h,Stop Loss,$25.50,$99.00,$55673.00,21,$99.00
2024-01-30,15:43:00,17650.0,SELL,3,0.02h,Stop Loss,$49.50,$148.50,$55722.50,21,$148.50
2024-01-30,16:24:00,17639.0,BUY,3,0.02h,Stop Loss,$10.50,$159.00,$55733.00,21,$159.00
2024-01-30,16:55:00,17636.5,SELL,3,0.02h,Stop Loss,$10.50,$169.50,$55743.50,21,$169.50
2024-01-30,18:14:00,17575.5,BUY,3,0.02h,Stop Loss,$6.00,$175.50,$55749.50,21,$175.50
2024-01-30,18:45:00,17583.5,SELL,3,0.02h,Stop Loss,$25.50,$201.00,$55775.00,21,$201.00
2024-01-30,19:24:00,17577.5,BUY,3,0.02h,Break Even,$-1.50,$199.50,$55773.50,21,$199.50
2024-01-30,20:06:00,17579.75,SELL,3,0.02h,Break Even,$-1.50,$198.00,$55772.00,21,$198.00
2024-01-30,20:21:00,17590.5,BUY,3,0.02h,Stop Loss,$3.00,$201.00,$55775.00,21,$201.00
2024-01-30,20:35:00,17580.5,SELL,3,0.02h,Break Even,$-1.50,$199.50,$55773.50,21,$199.50
2024-01-30,20:48:00,17593.5,BUY,3,0.02h,Stop Loss,$3.00,$202.50,$55776.50,21,$202.50
2024-01-30,20:55:00,17582.0,SELL,3,0.02h,Stop Loss,$-9.00,$193.50,$55767.50,21,$193.50
2024-01-30,21:01:00,17594.75,BUY,3,0.02h,Stop Loss,$52.50,$246.00,$55820.00,21,$246.00
2024-01-30,21:02:00,17578.75,SELL,3,0.02h,Stop Loss,$271.50,$517.50,$56091.50,21,$517.50
,,,,,,,,,,,
2024-01-31,12:47:00,17404.0,BUY,3,0.02h,Stop Loss,$4.50,$4.50,$56096.00,22,$4.50
2024-01-31,13:28:00,17425.25,SELL,3,0.02h,Stop Loss,$-9.00,$-4.50,$56087.00,22,$-4.50
2024-01-31,13:31:00,17435.75,BUY,3,0.02h,Stop Loss,$-9.00,$-13.50,$56078.00,22,$-13.50
2024-01-31,13:36:00,17422.0,SELL,3,0.02h,Stop Loss,$52.50,$39.00,$56130.50,22,$39.00
2024-01-31,14:34:00,17408.0,BUY,3,0.02h,Stop Loss,$88.50,$127.50,$56219.00,22,$127.50
2024-01-31,14:40:00,17389.5,SELL,3,0.02h,Stop Loss,$109.50,$237.00,$56328.50,22,$237.00
2024-01-31,16:02:00,17319.75,BUY,3,0.02h,Stop Loss,$16.50,$253.50,$56345.00,22,$253.50
2024-01-31,16:34:00,17327.0,SELL,3,0.02h,Stop Loss,$6.00,$259.50,$56351.00,22,$259.50
2024-01-31,16:38:00,17337.0,BUY,3,0.02h,Break Even,$-1.50,$258.00,$56349.50,22,$258.00
2024-01-31,16:42:00,17329.75,SELL,3,0.02h,Break Even,$-1.50,$256.50,$56348.00,22,$256.50
2024-01-31,16:45:00,17336.0,BUY,3,0.02h,Stop Loss,$30.00,$286.50,$56378.00,22,$286.50
2024-01-31,16:54:00,17321.25,SELL,3,0.02h,Stop Loss,$-9.00,$277.50,$56369.00,22,$277.50
2024-01-31,16:57:00,17340.75,BUY,3,0.02h,Stop Loss,$3.00,$280.50,$56372.00,22,$280.50
2024-01-31,17:24:00,17347.5,SELL,3,0.02h,Stop Loss,$-9.00,$271.50,$56363.00,22,$271.50
2024-01-31,17:27:00,17359.0,BUY,3,0.02h,Break Even,$-1.50,$270.00,$56361.50,22,$270.00
2024-01-31,17:36:00,17349.0,SELL,3,0.02h,Stop Loss,$27.00,$297.00,$56388.50,22,$297.00
2024-01-31,17:52:00,17360.75,BUY,3,0.02h,Stop Loss,$-9.00,$288.00,$56379.50,22,$288.00
2024-01-31,18:29:00,17375.5,SELL,3,0.02h,Stop Loss,$3.00,$291.00,$56382.50,22,$291.00
2024-01-31,18:47:00,17391.25,BUY,3,0.02h,Break Even,$-1.50,$289.50,$56381.00,22,$289.50
2024-01-31,19:00:00,17381.0,SELL,3,0.02h,Stop Loss,$282.00,$571.50,$56663.00,22,$571.50
2024-01-31,19:33:00,17363.5,BUY,3,0.02h,Stop Loss,$27.00,$598.50,$56690.00,22,$598.50
2024-01-31,20:00:00,17379.0,SELL,3,0.02h,Stop Loss,$109.50,$708.00,$56799.50,22,$708.00
2024-01-31,21:11:00,17263.0,BUY,3,0.02h,Stop Loss,$12.00,$720.00,$56811.50,22,$720.00
2024-01-31,21:25:00,17255.25,SELL,3,0.02h,Break Even,$-1.50,$718.50,$56810.00,22,$718.50
2024-01-31,21:38:00,17262.75,BUY,3,0.02h,Break Even,$-1.50,$717.00,$56808.50,22,$717.00
2024-01-31,21:41:00,17249.75,SELL,3,0.02h,Break Even,$-1.50,$715.50,$56807.00,22,$715.50
2024-01-31,21:51:00,17259.0,BUY,3,0.02h,Stop Loss,$10.50,$726.00,$56817.50,22,$726.00
,,,,,,,,,,,
2024-02-01,12:59:00,17344.25,SELL,3,0.02h,Stop Loss,$-9.00,$-9.00,$56808.50,23,$-9.00
2024-02-01,13:31:00,17343.75,BUY,3,0.02h,Break Even,$-1.50,$-10.50,$56807.00,23,$-10.50
2024-02-01,14:01:00,17339.25,SELL,3,0.02h,Stop Loss,$-9.00,$-19.50,$56798.00,23,$-19.50
2024-02-01,14:02:00,17347.25,BUY,3,0.02h,Break Even,$-1.50,$-21.00,$56796.50,23,$-21.00
2024-02-01,14:05:00,17326.25,SELL,3,0.02h,Stop Loss,$4.50,$-16.50,$56801.00,23,$-16.50
2024-02-01,14:43:00,17332.25,BUY,3,0.02h,Break Even,$-1.50,$-18.00,$56799.50,23,$-18.00
2024-02-01,14:49:00,17310.25,SELL,3,0.02h,Stop Loss,$21.00,$3.00,$56820.50,23,$3.00
2024-02-01,15:08:00,17327.25,BUY,3,0.02h,Stop Loss,$91.50,$94.50,$56912.00,23,$94.50
2024-02-01,15:45:00,17343.25,SELL,3,0.02h,Break Even,$-1.50,$93.00,$56910.50,23,$93.00
2024-02-01,16:24:00,17295.0,BUY,3,0.02h,Stop Loss,$4.50,$97.50,$56915.00,23,$97.50
2024-02-01,16:26:00,17283.25,SELL,3,0.02h,Break Even,$-1.50,$96.00,$56913.50,23,$96.00
2024-02-01,16:33:00,17296.25,BUY,3,0.02h,Stop Loss,$60.00,$156.00,$56973.50,23,$156.00
2024-02-01,17:28:00,17353.0,SELL,3,0.02h,Stop Loss,$19.50,$175.50,$56993.00,23,$175.50
2024-02-01,17:47:00,17367.5,BUY,3,0.02h,Break Even,$-1.50,$174.00,$56991.50,23,$174.00
2024-02-01,18:04:00,17354.75,SELL,3,0.02h,Stop Loss,$76.50,$250.50,$57068.00,23,$250.50
2024-02-01,18:17:00,17369.5,BUY,3,0.02h,Stop Loss,$3.00,$253.50,$57071.00,23,$253.50
2024-02-01,18:39:00,17355.75,SELL,3,0.02h,Stop Loss,$28.50,$282.00,$57099.50,23,$282.00
2024-02-01,18:50:00,17374.75,BUY,3,0.02h,Stop Loss,$31.50,$313.50,$57131.00,23,$313.50
2024-02-01,19:35:00,17383.25,SELL,3,0.02h,Stop Loss,$-9.00,$304.50,$57122.00,23,$304.50
2024-02-01,19:40:00,17397.25,BUY,3,0.02h,Stop Loss,$39.00,$343.50,$57161.00,23,$343.50
2024-02-01,20:48:00,17434.0,SELL,3,0.02h,Stop Loss,$42.00,$385.50,$57203.00,23,$385.50
2024-02-01,21:02:00,17462.0,BUY,3,0.02h,Stop Loss,$45.00,$430.50,$57248.00,23,$430.50
,,,,,,,,,,,
2024-02-02,12:09:00,17607.75,SELL,3,0.02h,Stop Loss,$-9.00,$-9.00,$57239.00,24,$-9.00
2024-02-02,12:17:00,17617.75,BUY,3,0.02h,Break Even,$-1.50,$-10.50,$57237.50,24,$-10.50
2024-02-02,12:51:00,17626.0,SELL,3,0.02h,Break Even,$-1.50,$-12.00,$57236.00,24,$-12.00
2024-02-02,13:05:00,17631.25,BUY,3,0.02h,Break Even,$-1.50,$-13.50,$57234.50,24,$-13.50
2024-02-02,13:10:00,17623.75,SELL,3,0.02h,Break Even,$-1.50,$-15.00,$57233.00,24,$-15.00
2024-02-02,14:36:00,17524.75,BUY,3,0.02h,Stop Loss,$28.50,$13.50,$57261.50,24,$13.50
2024-02-02,15:13:00,17571.0,SELL,3,0.02h,Stop Loss,$3.00,$16.50,$57264.50,24,$16.50
2024-02-02,15:15:00,17592.0,BUY,3,0.02h,Stop Loss,$31.50,$48.00,$57296.00,24,$48.00
2024-02-02,15:30:00,17584.75,SELL,3,0.02h,Stop Loss,$15.00,$63.00,$57311.00,24,$63.00
2024-02-02,15:40:00,17616.5,BUY,3,0.02h,Stop Loss,$73.50,$136.50,$57384.50,24,$136.50
2024-02-02,16:04:00,17613.75,SELL,3,0.02h,Stop Loss,$25.50,$162.00,$57410.00,24,$162.00
2024-02-02,16:11:00,17643.25,BUY,3,0.02h,Break Even,$-1.50,$160.50,$57408.50,24,$160.50
2024-02-02,17:45:00,17682.5,SELL,3,0.02h,Stop Loss,$42.00,$202.50,$57450.50,24,$202.50
2024-02-02,18:02:00,17721.5,BUY,3,0.02h,Break Even,$-1.50,$201.00,$57449.00,24,$201.00
2024-02-02,18:27:00,17696.5,SELL,3,0.02h,Stop Loss,$3.00,$204.00,$57452.00,24,$204.00
2024-02-02,18:45:00,17719.0,BUY,3,0.02h,Stop Loss,$42.00,$246.00,$57494.00,24,$246.00
2024-02-02,19:54:00,17752.75,SELL,3,0.02h,Stop Loss,$-9.00,$237.00,$57485.00,24,$237.00
2024-02-02,20:08:00,17762.75,BUY,3,0.02h,Break Even,$-1.50,$235.50,$57483.50,24,$235.50
2024-02-02,20:19:00,17756.25,SELL,3,0.02h,Stop Loss,$-9.00,$226.50,$57474.50,24,$226.50
2024-02-02,20:20:00,17762.75,BUY,3,0.02h,Break Even,$-1.50,$225.00,$57473.00,24,$225.00
2024-02-02,20:23:00,17754.25,SELL,3,0.02h,Stop Loss,$94.50,$319.50,$57567.50,24,$319.50
2024-02-02,20:30:00,17766.25,BUY,3,0.02h,Stop Loss,$-9.00,$310.50,$57558.50,24,$310.50
2024-02-02,20:33:00,17751.75,SELL,3,0.02h,Stop Loss,$10.50,$321.00,$57569.00,24,$321.00
2024-02-02,20:51:00,17760.75,BUY,3,0.02h,Stop Loss,$25.50,$346.50,$57594.50,24,$346.50
2024-02-02,20:58:00,17746.75,SELL,3,0.02h,Stop Loss,$25.50,$372.00,$57620.00,24,$372.00
,,,,,,,,,,,
2024-02-05,12:04:00,17706.5,BUY,3,0.02h,Stop Loss,$4.50,$4.50,$57624.50,25,$4.50
2024-02-05,12:49:00,17721.25,SELL,3,0.02h,Stop Loss,$-9.00,$-4.50,$57615.50,25,$-4.50
2024-02-05,12:52:00,17728.0,BUY,3,0.02h,Break Even,$-1.50,$-6.00,$57614.00,25,$-6.00
2024-02-05,13:11:00,17727.5,SELL,3,0.02h,Stop Loss,$-9.00,$-15.00,$57605.00,25,$-15.00
2024-02-05,13:15:00,17732.5,BUY,3,0.02h,Stop Loss,$-9.00,$-24.00,$57596.00,25,$-24.00
2024-02-05,13:17:00,17726.75,SELL,3,0.02h,Break Even,$-1.50,$-25.50,$57594.50,25,$-25.50
2024-02-05,14:12:00,17707.5,BUY,3,0.02h,Break Even,$-1.50,$-27.00,$57593.00,25,$-27.00
2024-02-05,14:41:00,17699.25,SELL,3,0.02h,Break Even,$-1.50,$-28.50,$57591.50,25,$-28.50
2024-02-05,16:02:00,17595.75,BUY,3,0.02h,Stop Loss,$3.00,$-25.50,$57594.50,25,$-25.50
2024-02-05,17:54:00,17693.25,SELL,3,0.02h,Stop Loss,$-9.00,$-34.50,$57585.50,25,$-34.50
2024-02-05,18:08:00,17702.0,BUY,3,0.02h,Stop Loss,$22.50,$-12.00,$57608.00,25,$-12.00
2024-02-05,18:23:00,17696.5,SELL,3,0.02h,Break Even,$-1.50,$-13.50,$57606.50,25,$-13.50
2024-02-05,18:48:00,17695.75,BUY,3,0.02h,Break Even,$-1.50,$-15.00,$57605.00,25,$-15.00
2024-02-05,18:54:00,17688.75,SELL,3,0.02h,Break Even,$-1.50,$-16.50,$57603.50,25,$-16.50
2024-02-05,18:59:00,17695.75,BUY,3,0.02h,Stop Loss,$19.50,$3.00,$57623.00,25,$3.00
2024-02-05,19:02:00,17688.0,SELL,3,0.02h,Break Even,$-1.50,$1.50,$57621.50,25,$1.50
2024-02-05,19:08:00,17700.75,BUY,3,0.02h,Stop Loss,$22.50,$24.00,$57644.00,25,$24.00
2024-02-05,20:03:00,17720.25,SELL,3,0.02h,Stop Loss,$25.50,$49.50,$57669.50,25,$49.50
2024-02-05,20:29:00,17715.5,BUY,3,0.02h,Break Even,$-1.50,$48.00,$57668.00,25,$48.00
2024-02-05,20:41:00,17703.0,SELL,3,0.02h,Break Even,$-1.50,$46.50,$57666.50,25,$46.50
2024-02-05,20:48:00,17709.25,BUY,3,0.02h,Stop Loss,$3.00,$49.50,$57669.50,25,$49.50
2024-02-05,20:50:00,17702.25,SELL,3,0.02h,Break Even,$-1.50,$48.00,$57668.00,25,$48.00
2024-02-05,20:51:00,17722.75,BUY,3,0.02h,Break Even,$-1.50,$46.50,$57666.50,25,$46.50
2024-02-05,21:01:00,17685.0,SELL,3,0.02h,Break Even,$-1.50,$45.00,$57665.00,25,$45.00
2024-02-05,21:52:00,17698.0,BUY,3,0.02h,Break Even,$-1.50,$43.50,$57663.50,25,$43.50
,,,,,,,,,,,
2024-02-06,12:01:00,17693.5,SELL,3,0.02h,Stop Loss,$-9.00,$-9.00,$57654.50,26,$-9.00
2024-02-06,12:40:00,17690.5,BUY,3,0.02h,Stop Loss,$9.00,$0.00,$57663.50,26,$0.00
2024-02-06,14:30:00,17741.25,SELL,3,0.02h,Break Even,$-1.50,$-1.50,$57662.00,26,$-1.50
2024-02-06,14:31:00,17764.25,BUY,3,0.02h,Break Even,$-1.50,$-3.00,$57660.50,26,$-3.00
2024-02-06,14:35:00,17729.25,SELL,3,0.02h,Stop Loss,$102.00,$99.00,$57762.50,26,$99.00
2024-02-06,15:36:00,17655.25,BUY,3,0.02h,Stop Loss,$-9.00,$90.00,$57753.50,26,$90.00
2024-02-06,15:43:00,17627.5,SELL,3,0.02h,Stop Loss,$22.50,$112.50,$57776.00,26,$112.50
2024-02-06,15:48:00,17643.5,BUY,3,0.02h,Break Even,$-1.50,$111.00,$57774.50,26,$111.00
2024-02-06,15:50:00,17626.0,SELL,3,0.02h,Stop Loss,$24.00,$135.00,$57798.50,26,$135.00
2024-02-06,15:58:00,17637.75,BUY,3,0.02h,Stop Loss,$15.00,$150.00,$57813.50,26,$150.00
2024-02-06,16:15:00,17627.5,SELL,3,0.02h,Break Even,$-1.50,$148.50,$57812.00,26,$148.50
2024-02-06,16:21:00,17647.75,BUY,3,0.02h,Stop Loss,$-9.00,$139.50,$57803.00,26,$139.50
2024-02-06,16:40:00,17644.0,SELL,3,0.02h,Stop Loss,$72.00,$211.50,$57875.00,26,$211.50
2024-02-06,17:29:00,17599.0,BUY,3,0.02h,Stop Loss,$15.00,$226.50,$57890.00,26,$226.50
2024-02-06,17:54:00,17594.25,SELL,3,0.02h,Stop Loss,$18.00,$244.50,$57908.00,26,$244.50
2024-02-06,18:03:00,17604.25,BUY,3,0.02h,Stop Loss,$-9.00,$235.50,$57899.00,26,$235.50
2024-02-06,18:15:00,17595.75,SELL,3,0.02h,Break Even,$-1.50,$234.00,$57897.50,26,$234.00
2024-02-06,18:17:00,17607.25,BUY,3,0.02h,Stop Loss,$18.00,$252.00,$57915.50,26,$252.00
2024-02-06,18:20:00,17595.0,SELL,3,0.02h,Stop Loss,$6.00,$258.00,$57921.50,26,$258.00
2024-02-06,18:30:00,17608.75,BUY,3,0.02h,Stop Loss,$15.00,$273.00,$57936.50,26,$273.00
2024-02-06,19:06:00,17610.0,SELL,3,0.02h,Stop Loss,$57.00,$330.00,$57993.50,26,$330.00
2024-02-06,19:30:00,17594.25,BUY,3,0.02h,Stop Loss,$19.50,$349.50,$58013.00,26,$349.50
2024-02-06,20:30:00,17635.5,SELL,3,0.02h,Stop Loss,$16.50,$366.00,$58029.50,26,$366.00
2024-02-06,20:51:00,17626.5,BUY,3,0.02h,Stop Loss,$30.00,$396.00,$58059.50,26,$396.00
2024-02-06,21:20:00,17642.25,SELL,3,0.02h,Stop Loss,$-9.00,$387.00,$58050.50,26,$387.00
2024-02-06,21:23:00,17646.75,BUY,3,0.02h,Stop Loss,$4.50,$391.50,$58055.00,26,$391.50
2024-02-06,21:44:00,17647.0,SELL,3,0.03h,Break Even,$-1.50,$390.00,$58053.50,26,$390.00
2024-02-06,22:00:00,17649.5,BUY,3,14.00h,Stop Loss,$172.50,$562.50,$58226.00,26,$562.50
,,,,,,,,,,,
2024-02-07,12:23:00,17658.75,SELL,3,0.02h,Stop Loss,$3.00,$3.00,$58229.00,27,$3.00
2024-02-07,12:29:00,17674.25,BUY,3,0.02h,Break Even,$-1.50,$1.50,$58227.50,27,$1.50
2024-02-07,13:56:00,17733.25,SELL,3,0.02h,Stop Loss,$-9.00,$-7.50,$58218.50,27,$-7.50
2024-02-07,13:59:00,17738.5,BUY,3,0.02h,Stop Loss,$-9.00,$-16.50,$58209.50,27,$-16.50
2024-02-07,14:35:00,17750.5,SELL,3,0.02h,Break Even,$-1.50,$-18.00,$58208.00,27,$-18.00
2024-02-07,14:52:00,17760.75,BUY,3,0.02h,Stop Loss,$22.50,$4.50,$58230.50,27,$4.50
2024-02-07,14:56:00,17724.75,SELL,3,0.02h,Stop Loss,$18.00,$22.50,$58248.50,27,$22.50
2024-02-07,15:10:00,17757.75,BUY,3,0.02h,Stop Loss,$33.00,$55.50,$58281.50,27,$55.50
2024-02-07,15:59:00,17839.75,SELL,3,0.02h,Stop Loss,$33.00,$88.50,$58314.50,27,$88.50
2024-02-07,16:12:00,17850.5,BUY,3,0.02h,Break Even,$-1.50,$87.00,$58313.00,27,$87.00
2024-02-07,16:18:00,17834.75,SELL,3,0.02h,Stop Loss,$22.50,$109.50,$58335.50,27,$109.50
2024-02-07,16:46:00,17828.5,BUY,3,0.02h,Stop Loss,$9.00,$118.50,$58344.50,27,$118.50
2024-02-07,17:13:00,17827.5,SELL,3,0.02h,Stop Loss,$-9.00,$109.50,$58335.50,27,$109.50
2024-02-07,17:18:00,17849.75,BUY,3,0.02h,Stop Loss,$-9.00,$100.50,$58326.50,27,$100.50
2024-02-07,17:23:00,17833.5,SELL,3,0.02h,Stop Loss,$6.00,$106.50,$58332.50,27,$106.50
2024-02-07,17:55:00,17813.75,BUY,3,0.02h,Stop Loss,$3.00,$109.50,$58335.50,27,$109.50
2024-02-07,18:06:00,17801.75,SELL,3,0.02h,Stop Loss,$-9.00,$100.50,$58326.50,27,$100.50
2024-02-07,18:11:00,17822.0,BUY,3,0.02h,Stop Loss,$15.00,$115.50,$58341.50,27,$115.50
2024-02-07,19:11:00,17846.0,SELL,3,0.02h,Break Even,$-1.50,$114.00,$58340.00,27,$114.00
2024-02-07,19:12:00,17849.0,BUY,3,0.02h,Break Even,$-1.50,$112.50,$58338.50,27,$112.50
2024-02-07,19:14:00,17843.75,SELL,3,0.02h,Break Even,$-1.50,$111.00,$58337.00,27,$111.00
2024-02-07,19:16:00,17854.25,BUY,3,0.02h,Stop Loss,$-9.00,$102.00,$58328.00,27,$102.00
2024-02-07,19:18:00,17846.0,SELL,3,0.02h,Break Even,$-1.50,$100.50,$58326.50,27,$100.50
2024-02-07,19:25:00,17851.75,BUY,3,0.02h,Stop Loss,$-9.00,$91.50,$58317.50,27,$91.50
2024-02-07,19:27:00,17845.25,SELL,3,0.02h,Break Even,$-1.50,$90.00,$58316.00,27,$90.00
2024-02-07,19:43:00,17844.5,BUY,3,0.02h,Stop Loss,$-9.00,$81.00,$58307.00,27,$81.00
2024-02-07,19:44:00,17839.0,SELL,3,0.02h,Break Even,$-1.50,$79.50,$58305.50,27,$79.50
2024-02-07,19:48:00,17852.75,BUY,3,0.02h,Break Even,$-1.50,$78.00,$58304.00,27,$78.00
2024-02-07,20:24:00,17852.0,SELL,3,0.02h,Break Even,$-1.50,$76.50,$58302.50,27,$76.50
2024-02-07,20:26:00,17857.75,BUY,3,0.02h,Break Even,$-1.50,$75.00,$58301.00,27,$75.00
2024-02-07,20:28:00,17854.0,SELL,3,0.02h,Break Even,$-1.50,$73.50,$58299.50,27,$73.50
2024-02-07,21:13:00,17851.0,BUY,3,0.02h,Break Even,$-1.50,$72.00,$58298.00,27,$72.00
,,,,,,,,,,,
2024-02-08,12:00:00,17811.5,SELL,3,0.02h,Break Even,$-1.50,$-1.50,$58296.50,28,$-1.50
2024-02-08,12:46:00,17820.0,BUY,3,0.02h,Stop Loss,$-9.00,$-10.50,$58287.50,28,$-10.50
2024-02-08,12:47:00,17814.25,SELL,3,0.02h,Stop Loss,$-9.00,$-19.50,$58278.50,28,$-19.50
2024-02-08,12:48:00,17819.75,BUY,3,0.02h,Break Even,$-1.50,$-21.00,$58277.00,28,$-21.00
2024-02-08,12:56:00,17809.0,SELL,3,0.02h,Stop Loss,$3.00,$-18.00,$58280.00,28,$-18.00
2024-02-08,13:07:00,17815.25,BUY,3,0.02h,Stop Loss,$-9.00,$-27.00,$58271.00,28,$-27.00
2024-02-08,13:09:00,17809.5,SELL,3,0.02h,Stop Loss,$-9.00,$-36.00,$58262.00,28,$-36.00
2024-02-08,13:34:00,17812.5,BUY,3,0.02h,Stop Loss,$-9.00,$-45.00,$58253.00,28,$-45.00
2024-02-08,14:43:00,17812.25,SELL,3,0.02h,Stop Loss,$7.50,$-37.50,$58260.50,28,$-37.50
2024-02-08,14:51:00,17835.5,BUY,3,0.02h,Stop Loss,$13.50,$-24.00,$58274.00,28,$-24.00
2024-02-08,15:26:00,17837.5,SELL,3,0.02h,Break Even,$-1.50,$-25.50,$58272.50,28,$-25.50
2024-02-08,15:36:00,17857.5,BUY,3,0.02h,Break Even,$-1.50,$-27.00,$58271.00,28,$-27.00
2024-02-08,16:27:00,17867.5,SELL,3,0.02h,Break Even,$-1.50,$-28.50,$58269.50,28,$-28.50
2024-02-08,16:38:00,17881.5,BUY,3,0.02h,Break Even,$-1.50,$-30.00,$58268.00,28,$-30.00
2024-02-08,16:45:00,17867.5,SELL,3,0.02h,Break Even,$-1.50,$-31.50,$58266.50,28,$-31.50
2024-02-08,16:54:00,17880.0,BUY,3,0.02h,Break Even,$-1.50,$-33.00,$58265.00,28,$-33.00
2024-02-08,17:07:00,17872.25,SELL,3,0.02h,Stop Loss,$18.00,$-15.00,$58283.00,28,$-15.00
2024-02-08,17:15:00,17884.0,BUY,3,0.02h,Break Even,$-1.50,$-16.50,$58281.50,28,$-16.50
2024-02-08,17:40:00,17882.5,SELL,3,0.02h,Stop Loss,$6.00,$-10.50,$58287.50,28,$-10.50
2024-02-08,18:03:00,17877.75,BUY,3,0.02h,Stop Loss,$7.50,$-3.00,$58295.00,28,$-3.00
2024-02-08,18:17:00,17862.5,SELL,3,0.02h,Break Even,$-1.50,$-4.50,$58293.50,28,$-4.50
2024-02-08,18:26:00,17877.75,BUY,3,0.02h,Break Even,$-1.50,$-6.00,$58292.00,28,$-6.00
2024-02-08,18:47:00,17878.0,SELL,3,0.02h,Break Even,$-1.50,$-7.50,$58290.50,28,$-7.50
2024-02-08,19:46:00,17851.25,BUY,3,0.02h,Stop Loss,$-9.00,$-16.50,$58281.50,28,$-16.50
2024-02-08,20:37:00,17866.25,SELL,3,0.02h,Stop Loss,$-9.00,$-25.50,$58272.50,28,$-25.50
2024-02-08,21:18:00,17861.5,BUY,3,0.02h,Break Even,$-1.50,$-27.00,$58271.00,28,$-27.00
2024-02-08,22:00:00,17861.0,SELL,3,14.00h,Stop Loss,$-9.00,$-36.00,$58262.00,28,$-36.00
,,,,,,,,,,,
2024-02-09,12:00:00,17918.5,BUY,3,0.02h,Break Even,$-1.50,$-1.50,$58260.50,29,$-1.50
2024-02-09,12:42:00,17925.5,SELL,3,0.02h,Stop Loss,$-9.00,$-10.50,$58251.50,29,$-10.50
2024-02-09,12:46:00,17929.25,BUY,3,0.02h,Stop Loss,$-9.00,$-19.50,$58242.50,29,$-19.50
2024-02-09,12:47:00,17927.5,SELL,3,0.02h,Break Even,$-1.50,$-21.00,$58241.00,29,$-21.00
2024-02-09,12:48:00,17928.25,BUY,3,0.02h,Stop Loss,$-9.00,$-30.00,$58232.00,29,$-30.00
2024-02-09,12:49:00,17926.25,SELL,3,0.02h,Stop Loss,$-9.00,$-39.00,$58223.00,29,$-39.00
2024-02-09,13:27:00,17916.25,BUY,3,0.02h,Stop Loss,$-9.00,$-48.00,$58214.00,29,$-48.00
2024-02-09,13:30:00,17912.5,SELL,3,0.02h,Stop Loss,$40.50,$-7.50,$58254.50,29,$-7.50
2024-02-09,13:31:00,17918.25,BUY,3,0.02h,Stop Loss,$186.00,$178.50,$58440.50,29,$178.50
2024-02-09,14:01:00,17925.5,SELL,3,0.02h,Break Even,$-1.50,$177.00,$58439.00,29,$177.00
2024-02-09,14:14:00,17931.0,BUY,3,0.02h,Break Even,$-1.50,$175.50,$58437.50,29,$175.50
2024-02-09,14:21:00,17923.5,SELL,3,0.02h,Break Even,$-1.50,$174.00,$58436.00,29,$174.00
2024-02-09,14:49:00,17908.75,BUY,3,0.02h,Break Even,$-1.50,$172.50,$58434.50,29,$172.50
2024-02-09,16:19:00,17989.75,SELL,3,0.02h,Stop Loss,$-9.00,$163.50,$58425.50,29,$163.50
2024-02-09,16:22:00,17999.5,BUY,3,0.02h,Break Even,$-1.50,$162.00,$58424.00,29,$162.00
2024-02-09,16:25:00,17990.5,SELL,3,0.02h,Break Even,$-1.50,$160.50,$58422.50,29,$160.50
2024-02-09,16:43:00,17993.25,BUY,3,0.02h,Break Even,$-1.50,$159.00,$58421.00,29,$159.00
2024-02-09,17:02:00,17987.25,SELL,3,0.02h,Stop Loss,$-9.00,$150.00,$58412.00,29,$150.00
2024-02-09,17:26:00,17993.25,BUY,3,0.02h,Break Even,$-1.50,$148.50,$58410.50,29,$148.50
2024-02-09,18:49:00,18032.25,SELL,3,0.02h,Stop Loss,$-9.00,$139.50,$58401.50,29,$139.50
2024-02-09,18:57:00,18038.25,BUY,3,0.02h,Stop Loss,$3.00,$142.50,$58404.50,29,$142.50
2024-02-09,19:10:00,18032.0,SELL,3,0.02h,Stop Loss,$-9.00,$133.50,$58395.50,29,$133.50
2024-02-09,19:15:00,18037.5,BUY,3,0.02h,Stop Loss,$-9.00,$124.50,$58386.50,29,$124.50
2024-02-09,19:16:00,18035.5,SELL,3,0.02h,Stop Loss,$-9.00,$115.50,$58377.50,29,$115.50
2024-02-09,19:17:00,18036.75,BUY,3,0.02h,Break Even,$-1.50,$114.00,$58376.00,29,$114.00
2024-02-09,19:18:00,18035.25,SELL,3,0.02h,Stop Loss,$-9.00,$105.00,$58367.00,29,$105.00
2024-02-09,19:19:00,18038.25,BUY,3,0.02h,Break Even,$-1.50,$103.50,$58365.50,29,$103.50
2024-02-09,20:01:00,18051.75,SELL,3,0.02h,Stop Loss,$43.50,$147.00,$58409.00,29,$147.00
2024-02-09,20:19:00,18052.75,BUY,3,0.02h,Stop Loss,$-9.00,$138.00,$58400.00,29,$138.00
2024-02-09,20:24:00,18043.25,SELL,3,0.02h,Break Even,$-1.50,$136.50,$58398.50,29,$136.50
2024-02-09,20:56:00,18046.25,BUY,3,0.02h,Stop Loss,$-9.00,$127.50,$58389.50,29,$127.50
2024-02-09,20:58:00,18037.0,SELL,3,0.02h,Break Even,$-1.50,$126.00,$58388.00,29,$126.00
2024-02-09,21:36:00,18034.25,BUY,3,0.07h,Stop Loss,$-9.00,$117.00,$58379.00,29,$117.00
2024-02-09,21:44:00,18032.75,SELL,3,0.02h,Stop Loss,$-9.00,$108.00,$58370.00,29,$108.00
2024-02-09,21:46:00,18033.5,BUY,3,0.02h,Break Even,$-1.50,$106.50,$58368.50,29,$106.50
,,,,,,,,,,,
2024-02-12,12:27:00,18041.5,SELL,3,0.02h,Stop Loss,$-9.00,$-9.00,$58359.50,30,$-9.00
2024-02-12,12:48:00,18039.5,BUY,3,0.02h,Stop Loss,$-9.00,$-18.00,$58350.50,30,$-18.00
2024-02-12,12:51:00,18036.0,SELL,3,0.02h,Stop Loss,$-9.00,$-27.00,$58341.50,30,$-27.00
2024-02-12,13:01:00,18038.25,BUY,3,0.02h,Stop Loss,$-9.00,$-36.00,$58332.50,30,$-36.00
2024-02-12,13:02:00,18035.75,SELL,3,0.02h,Break Even,$-1.50,$-37.50,$58331.00,30,$-37.50
2024-02-12,13:05:00,18039.25,BUY,3,0.02h,Stop Loss,$-9.00,$-46.50,$58322.00,30,$-46.50
2024-02-12,13:32:00,18037.0,SELL,3,0.02h,Stop Loss,$7.50,$-39.00,$58329.50,30,$-39.00
2024-02-12,14:07:00,18034.25,BUY,3,0.02h,Stop Loss,$-9.00,$-48.00,$58320.50,30,$-48.00
2024-02-12,14:15:00,18023.25,SELL,3,0.02h,Stop Loss,$-9.00,$-57.00,$58311.50,30,$-57.00
2024-02-12,14:35:00,18045.25,BUY,3,0.02h,Stop Loss,$12.00,$-45.00,$58323.50,30,$-45.00
2024-02-12,14:48:00,18028.75,SELL,3,0.02h,Stop Loss,$46.50,$1.50,$58370.00,30,$1.50
2024-02-12,14:57:00,18035.5,BUY,3,0.02h,Break Even,$-1.50,$0.00,$58368.50,30,$0.00
2024-02-12,15:04:00,18027.5,SELL,3,0.02h,Stop Loss,$-9.00,$-9.00,$58359.50,30,$-9.00
2024-02-12,15:27:00,18032.25,BUY,3,0.02h,Stop Loss,$12.00,$3.00,$58371.50,30,$3.00
2024-02-12,16:50:00,18084.25,SELL,3,0.02h,Stop Loss,$-9.00,$-6.00,$58362.50,30,$-6.00
2024-02-12,16:56:00,18105.5,BUY,3,0.02h,Break Even,$-1.50,$-7.50,$58361.00,30,$-7.50
2024-02-12,17:02:00,18092.75,SELL,3,0.02h,Stop Loss,$7.50,$0.00,$58368.50,30,$0.00
2024-02-12,17:06:00,18104.25,BUY,3,0.02h,Break Even,$-1.50,$-1.50,$58367.00,30,$-1.50
2024-02-12,17:17:00,18095.75,SELL,3,0.02h,Break Even,$-1.50,$-3.00,$58365.50,30,$-3.00
2024-02-12,17:50:00,18093.0,BUY,3,0.02h,Stop Loss,$-9.00,$-12.00,$58356.50,30,$-12.00
2024-02-12,18:23:00,18084.5,SELL,3,0.02h,Stop Loss,$49.50,$37.50,$58406.00,30,$37.50
2024-02-12,19:43:00,17984.0,BUY,3,0.02h,Stop Loss,$-9.00,$28.50,$58397.00,30,$28.50
2024-02-12,19:46:00,17976.25,SELL,3,0.02h,Stop Loss,$21.00,$49.50,$58418.00,30,$49.50
2024-02-12,20:08:00,17973.25,BUY,3,0.02h,Break Even,$-1.50,$48.00,$58416.50,30,$48.00
2024-02-12,20:34:00,17972.5,SELL,3,0.02h,Stop Loss,$4.50,$52.50,$58421.00,30,$52.50
2024-02-12,20:53:00,17978.75,BUY,3,0.02h,Break Even,$-1.50,$51.00,$58419.50,30,$51.00
2024-02-12,20:56:00,17953.0,SELL,3,0.02h,Stop Loss,$-9.00,$42.00,$58410.50,30,$42.00
2024-02-12,21:56:00,17923.5,BUY,3,0.03h,Stop Loss,$15.00,$57.00,$58425.50,30,$57.00
,,,,,,,,,,,
2024-02-13,12:00:00,17841.25,SELL,3,0.02h,Stop Loss,$9.00,$9.00,$58434.50,31,$9.00
2024-02-13,12:58:00,17835.5,BUY,3,0.02h,Break Even,$-1.50,$7.50,$58433.00,31,$7.50
2024-02-13,13:31:00,17731.5,SELL,3,0.02h,Stop Loss,$78.00,$85.50,$58511.00,31,$85.50
2024-02-13,14:37:00,17654.25,BUY,3,0.02h,Break Even,$-1.50,$84.00,$58509.50,31,$84.00
2024-02-13,14:53:00,17634.5,SELL,3,0.02h,Stop Loss,$7.50,$91.50,$58517.00,31,$91.50
2024-02-13,14:54:00,17659.75,BUY,3,0.02h,Stop Loss,$121.50,$213.00,$58638.50,31,$213.00
2024-02-13,15:15:00,17649.75,SELL,3,0.02h,Stop Loss,$61.50,$274.50,$58700.00,31,$274.50
2024-02-13,15:21:00,17689.0,BUY,3,0.02h,Stop Loss,$22.50,$297.00,$58722.50,31,$297.00
2024-02-13,15:58:00,17735.75,SELL,3,0.02h,Stop Loss,$18.00,$315.00,$58740.50,31,$315.00
2024-02-13,16:07:00,17761.0,BUY,3,0.02h,Stop Loss,$15.00,$330.00,$58755.50,31,$330.00
2024-02-13,16:18:00,17744.25,SELL,3,0.02h,Stop Loss,$28.50,$358.50,$58784.00,31,$358.50
2024-02-13,16:38:00,17757.0,BUY,3,0.02h,Break Even,$-1.50,$357.00,$58782.50,31,$357.00
2024-02-13,16:54:00,17725.25,SELL,3,0.02h,Break Even,$-1.50,$355.50,$58781.00,31,$355.50
2024-02-13,17:34:00,17721.25,BUY,3,0.02h,Stop Loss,$-9.00,$346.50,$58772.00,31,$346.50
2024-02-13,17:50:00,17700.5,SELL,3,0.02h,Break Even,$-1.50,$345.00,$58770.50,31,$345.00
2024-02-13,18:16:00,17696.5,BUY,3,0.02h,Stop Loss,$-9.00,$336.00,$58761.50,31,$336.00
2024-02-13,18:21:00,17673.0,SELL,3,0.02h,Break Even,$-1.50,$334.50,$58760.00,31,$334.50
2024-02-13,18:26:00,17685.0,BUY,3,0.02h,Stop Loss,$16.50,$351.00,$58776.50,31,$351.00
2024-02-13,18:33:00,17680.25,SELL,3,0.02h,Break Even,$-1.50,$349.50,$58775.00,31,$349.50
2024-02-13,19:33:00,17626.25,BUY,3,0.02h,Stop Loss,$-9.00,$340.50,$58766.00,31,$340.50
2024-02-13,19:49:00,17608.25,SELL,3,0.02h,Break Even,$-1.50,$339.00,$58764.50,31,$339.00
2024-02-13,20:33:00,17571.0,BUY,3,0.02h,Stop Loss,$48.00,$387.00,$58812.50,31,$387.00
,,,,,,,,,,,
2024-02-14,12:39:00,17784.25,SELL,3,0.02h,Stop Loss,$-9.00,$-9.00,$58803.50,32,$-9.00
2024-02-14,12:47:00,17793.0,BUY,3,0.02h,Stop Loss,$-9.00,$-18.00,$58794.50,32,$-18.00
2024-02-14,12:58:00,17787.25,SELL,3,0.02h,Stop Loss,$-9.00,$-27.00,$58785.50,32,$-27.00
2024-02-14,13:02:00,17796.75,BUY,3,0.02h,Stop Loss,$7.50,$-19.50,$58793.00,32,$-19.50
2024-02-14,13:19:00,17793.75,SELL,3,0.02h,Break Even,$-1.50,$-21.00,$58791.50,32,$-21.00
2024-02-14,13:43:00,17794.5,BUY,3,0.02h,Break Even,$-1.50,$-22.50,$58790.00,32,$-22.50
2024-02-14,13:50:00,17783.5,SELL,3,0.02h,Stop Loss,$7.50,$-15.00,$58797.50,32,$-15.00
2024-02-14,14:26:00,17785.75,BUY,3,0.02h,Break Even,$-1.50,$-16.50,$58796.00,32,$-16.50
2024-02-14,14:39:00,17767.0,SELL,3,0.02h,Stop Loss,$75.00,$58.50,$58871.00,32,$58.50
2024-02-14,14:48:00,17790.0,BUY,3,0.02h,Break Even,$-1.50,$57.00,$58869.50,32,$57.00
2024-02-14,14:51:00,17761.5,SELL,3,0.02h,Stop Loss,$43.50,$100.50,$58913.00,32,$100.50
2024-02-14,15:00:00,17789.25,BUY,3,0.02h,Stop Loss,$48.00,$148.50,$58961.00,32,$148.50
2024-02-14,15:40:00,17810.0,SELL,3,0.02h,Stop Loss,$55.50,$204.00,$59016.50,32,$204.00
2024-02-14,16:26:00,17755.0,BUY,3,0.02h,Break Even,$-1.50,$202.50,$59015.00,32,$202.50
2024-02-14,16:45:00,17728.75,SELL,3,0.02h,Stop Loss,$6.00,$208.50,$59021.00,32,$208.50
2024-02-14,17:15:00,17732.0,BUY,3,0.02h,Break Even,$-1.50,$207.00,$59019.50,32,$207.00
2024-02-14,18:11:00,17755.75,SELL,3,0.02h,Break Even,$-1.50,$205.50,$59018.00,32,$205.50
2024-02-14,18:33:00,17774.25,BUY,3,0.02h,Break Even,$-1.50,$204.00,$59016.50,32,$204.00
2024-02-14,18:58:00,17781.25,SELL,3,0.02h,Break Even,$-1.50,$202.50,$59015.00,32,$202.50
2024-02-14,19:26:00,17772.25,BUY,3,0.02h,Break Even,$-1.50,$201.00,$59013.50,32,$201.00
2024-02-14,21:46:00,17872.25,SELL,3,0.03h,Stop Loss,$-9.00,$192.00,$59004.50,32,$192.00
,,,,,,,,,,,
2024-02-15,12:00:00,17901.0,BUY,3,0.02h,Stop Loss,$-9.00,$-9.00,$58995.50,33,$-9.00
2024-02-15,12:54:00,17908.5,SELL,3,0.02h,Stop Loss,$3.00,$-6.00,$58998.50,33,$-6.00
2024-02-15,13:32:00,17904.5,BUY,3,0.02h,Stop Loss,$84.00,$78.00,$59082.50,33,$78.00
2024-02-15,13:49:00,17894.75,SELL,3,0.02h,Stop Loss,$55.50,$133.50,$59138.00,33,$133.50
2024-02-15,14:23:00,17897.25,BUY,3,0.02h,Break Even,$-1.50,$132.00,$59136.50,33,$132.00
2024-02-15,14:29:00,17883.0,SELL,3,0.02h,Break Even,$-1.50,$130.50,$59135.00,33,$130.50
2024-02-15,15:13:00,17850.25,BUY,3,0.02h,Stop Loss,$21.00,$151.50,$59156.00,33,$151.50
2024-02-15,15:29:00,17813.0,SELL,3,0.02h,Stop Loss,$-9.00,$142.50,$59147.00,33,$142.50
2024-02-15,15:46:00,17840.5,BUY,3,0.02h,Break Even,$-1.50,$141.00,$59145.50,33,$141.00
2024-02-15,16:03:00,17826.75,SELL,3,0.02h,Break Even,$-1.50,$139.50,$59144.00,33,$139.50
2024-02-15,16:25:00,17816.5,BUY,3,0.02h,Stop Loss,$9.00,$148.50,$59153.00,33,$148.50
2024-02-15,16:53:00,17822.5,SELL,3,0.02h,Break Even,$-1.50,$147.00,$59151.50,33,$147.00
2024-02-15,17:02:00,17837.25,BUY,3,0.02h,Stop Loss,$-9.00,$138.00,$59142.50,33,$138.00
2024-02-15,17:03:00,17825.0,SELL,3,0.02h,Break Even,$-1.50,$136.50,$59141.00,33,$136.50
2024-02-15,17:11:00,17840.75,BUY,3,0.02h,Stop Loss,$4.50,$141.00,$59145.50,33,$141.00
2024-02-15,17:55:00,17866.5,SELL,3,0.02h,Stop Loss,$7.50,$148.50,$59153.00,33,$148.50
2024-02-15,18:08:00,17874.75,BUY,3,0.02h,Stop Loss,$64.50,$213.00,$59217.50,33,$213.00
2024-02-15,18:45:00,17905.25,SELL,3,0.02h,Stop Loss,$4.50,$217.50,$59222.00,33,$217.50
2024-02-15,19:05:00,17913.0,BUY,3,0.02h,Stop Loss,$-9.00,$208.50,$59213.00,33,$208.50
2024-02-15,19:06:00,17906.0,SELL,3,0.02h,Break Even,$-1.50,$207.00,$59211.50,33,$207.00
2024-02-15,19:07:00,17914.75,BUY,3,0.02h,Stop Loss,$15.00,$222.00,$59226.50,33,$222.00
2024-02-15,19:12:00,17896.75,SELL,3,0.02h,Stop Loss,$70.50,$292.50,$59297.00,33,$292.50
2024-02-15,19:23:00,17906.5,BUY,3,0.02h,Stop Loss,$15.00,$307.50,$59312.00,33,$307.50
2024-02-15,20:00:00,17906.75,SELL,3,0.02h,Stop Loss,$40.50,$348.00,$59352.50,33,$348.00
2024-02-15,20:52:00,17908.5,BUY,3,0.02h,Break Even,$-1.50,$346.50,$59351.00,33,$346.50
2024-02-15,21:44:00,17950.0,SELL,3,0.02h,Break Even,$-1.50,$345.00,$59349.50,33,$345.00
2024-02-15,21:53:00,17958.5,BUY,3,0.02h,Stop Loss,$-9.00,$336.00,$59340.50,33,$336.00
,,,,,,,,,,,
2024-02-16,12:55:00,17997.5,SELL,3,0.02h,Break Even,$-1.50,$-1.50,$59339.00,34,$-1.50
2024-02-16,13:03:00,18006.25,BUY,3,0.02h,Break Even,$-1.50,$-3.00,$59337.50,34,$-3.00
2024-02-16,13:06:00,17996.25,SELL,3,0.02h,Break Even,$-1.50,$-4.50,$59336.00,34,$-4.50
2024-02-16,13:11:00,18003.5,BUY,3,0.02h,Break Even,$-1.50,$-6.00,$59334.50,34,$-6.00
2024-02-16,13:22:00,17997.5,SELL,3,0.02h,Break Even,$-1.50,$-7.50,$59333.00,34,$-7.50
2024-02-16,14:01:00,17944.75,BUY,3,0.02h,Stop Loss,$-9.00,$-16.50,$59324.00,34,$-16.50
2024-02-16,14:19:00,17933.25,SELL,3,0.02h,Break Even,$-1.50,$-18.00,$59322.50,34,$-18.00
2024-02-16,15:39:00,17789.5,BUY,3,0.02h,Stop Loss,$87.00,$69.00,$59409.50,34,$69.00
2024-02-16,16:50:00,17852.25,SELL,3,0.02h,Stop Loss,$30.00,$99.00,$59439.50,34,$99.00
2024-02-16,16:55:00,17866.25,BUY,3,0.02h,Stop Loss,$7.50,$106.50,$59447.00,34,$106.50
2024-02-16,17:11:00,17856.0,SELL,3,0.02h,Break Even,$-1.50,$105.00,$59445.50,34,$105.00
2024-02-16,17:26:00,17872.0,BUY,3,0.02h,Break Even,$-1.50,$103.50,$59444.00,34,$103.50
2024-02-16,17:39:00,17861.5,SELL,3,0.02h,Stop Loss,$-9.00,$94.50,$59435.00,34,$94.50
2024-02-16,18:26:00,17839.5,BUY,3,0.02h,Break Even,$-1.50,$93.00,$59433.50,34,$93.00
2024-02-16,19:29:00,17885.25,SELL,3,0.02h,Stop Loss,$-9.00,$84.00,$59424.50,34,$84.00
2024-02-16,20:25:00,17791.25,BUY,3,0.02h,Break Even,$-1.50,$82.50,$59423.00,34,$82.50
2024-02-16,20:34:00,17783.5,SELL,3,0.02h,Break Even,$-1.50,$81.00,$59421.50,34,$81.00
2024-02-16,20:35:00,17786.5,BUY,3,0.02h,Break Even,$-1.50,$79.50,$59420.00,34,$79.50
2024-02-16,20:36:00,17784.0,SELL,3,0.02h,Stop Loss,$9.00,$88.50,$59429.00,34,$88.50
,,,,,,,,,,,
2024-02-19,12:00:00,17763.5,BUY,3,0.02h,Stop Loss,$3.00,$3.00,$59432.00,35,$3.00
2024-02-19,13:04:00,17759.5,SELL,3,0.02h,Stop Loss,$-9.00,$-6.00,$59423.00,35,$-6.00
2024-02-19,13:12:00,17766.25,BUY,3,0.02h,Break Even,$-1.50,$-7.50,$59421.50,35,$-7.50
2024-02-19,13:45:00,17775.75,SELL,3,0.02h,Break Even,$-1.50,$-9.00,$59420.00,35,$-9.00
2024-02-19,14:00:00,17778.25,BUY,3,0.02h,Break Even,$-1.50,$-10.50,$59418.50,35,$-10.50
2024-02-19,14:07:00,17776.25,SELL,3,0.03h,Break Even,$-1.50,$-12.00,$59417.00,35,$-12.00
2024-02-19,14:12:00,17780.25,BUY,3,0.02h,Stop Loss,$-9.00,$-21.00,$59408.00,35,$-21.00
2024-02-19,14:58:00,17793.25,SELL,3,0.02h,Break Even,$-1.50,$-22.50,$59406.50,35,$-22.50
2024-02-19,15:07:00,17798.25,BUY,3,0.02h,Stop Loss,$-9.00,$-31.50,$59397.50,35,$-31.50
2024-02-19,15:08:00,17792.25,SELL,3,0.02h,Break Even,$-1.50,$-33.00,$59396.00,35,$-33.00
2024-02-19,15:40:00,17785.5,BUY,3,0.02h,Stop Loss,$-9.00,$-42.00,$59387.00,35,$-42.00
2024-02-19,15:41:00,17783.25,SELL,3,0.02h,Break Even,$-1.50,$-43.50,$59385.50,35,$-43.50
2024-02-19,16:04:00,17783.5,BUY,3,0.02h,Stop Loss,$-9.00,$-52.50,$59376.50,35,$-52.50
2024-02-19,16:10:00,17775.25,SELL,3,0.02h,Break Even,$-1.50,$-54.00,$59375.00,35,$-54.00
2024-02-19,16:19:00,17783.75,BUY,3,0.03h,Break Even,$-1.50,$-55.50,$59373.50,35,$-55.50
2024-02-19,16:43:00,17780.25,SELL,3,0.02h,Break Even,$-1.50,$-57.00,$59372.00,35,$-57.00
2024-02-19,16:58:00,17784.25,BUY,3,0.02h,Break Even,$-1.50,$-58.50,$59370.50,35,$-58.50
2024-02-19,17:27:00,17783.25,SELL,3,0.03h,Stop Loss,$-9.00,$-67.50,$59361.50,35,$-67.50
2024-02-19,17:29:00,17784.0,BUY,3,0.02h,Break Even,$-1.50,$-69.00,$59360.00,35,$-69.00
,,,,,,,,,,,
2024-02-20,12:00:00,17654.25,SELL,3,0.02h,Stop Loss,$-9.00,$-9.00,$59351.00,36,$-9.00
2024-02-20,12:39:00,17683.5,BUY,3,0.02h,Stop Loss,$-9.00,$-18.00,$59342.00,36,$-18.00
2024-02-20,12:44:00,17677.25,SELL,3,0.02h,Stop Loss,$10.50,$-7.50,$59352.50,36,$-7.50
2024-02-20,13:01:00,17676.25,BUY,3,0.02h,Break Even,$-1.50,$-9.00,$59351.00,36,$-9.00
2024-02-20,13:06:00,17665.5,SELL,3,0.02h,Stop Loss,$-9.00,$-18.00,$59342.00,36,$-18.00
2024-02-20,13:08:00,17675.5,BUY,3,0.02h,Stop Loss,$-9.00,$-27.00,$59333.00,36,$-27.00
2024-02-20,13:09:00,17669.5,SELL,3,0.02h,Break Even,$-1.50,$-28.50,$59331.50,36,$-28.50
2024-02-20,13:12:00,17677.75,BUY,3,0.02h,Break Even,$-1.50,$-30.00,$59330.00,36,$-30.00
2024-02-20,13:21:00,17667.75,SELL,3,0.02h,Break Even,$-1.50,$-31.50,$59328.50,36,$-31.50
2024-02-20,13:41:00,17688.5,BUY,3,0.02h,Stop Loss,$18.00,$-13.50,$59346.50,36,$-13.50
2024-02-20,13:54:00,17676.0,SELL,3,0.02h,Stop Loss,$-9.00,$-22.50,$59337.50,36,$-22.50
2024-02-20,13:55:00,17682.5,BUY,3,0.02h,Stop Loss,$-9.00,$-31.50,$59328.50,36,$-31.50
2024-02-20,13:57:00,17676.25,SELL,3,0.02h,Stop Loss,$7.50,$-24.00,$59336.00,36,$-24.00
2024-02-20,14:16:00,17677.25,BUY,3,0.02h,Break Even,$-1.50,$-25.50,$59334.50,36,$-25.50
2024-02-20,14:23:00,17666.0,SELL,3,0.02h,Stop Loss,$-9.00,$-34.50,$59325.50,36,$-34.50
2024-02-20,14:32:00,17711.75,BUY,3,0.02h,Stop Loss,$52.50,$18.00,$59378.00,36,$18.00
2024-02-20,14:38:00,17641.0,SELL,3,0.02h,Stop Loss,$112.50,$130.50,$59490.50,36,$130.50
2024-02-20,15:45:00,17525.5,BUY,3,0.02h,Stop Loss,$55.50,$186.00,$59546.00,36,$186.00
2024-02-20,16:23:00,17562.5,SELL,3,0.02h,Stop Loss,$4.50,$190.50,$59550.50,36,$190.50
2024-02-20,16:26:00,17570.75,BUY,3,0.02h,Break Even,$-1.50,$189.00,$59549.00,36,$189.00
2024-02-20,16:27:00,17565.5,SELL,3,0.02h,Break Even,$-1.50,$187.50,$59547.50,36,$187.50
2024-02-20,16:29:00,17574.75,BUY,3,0.02h,Break Even,$-1.50,$186.00,$59546.00,36,$186.00
2024-02-20,16:32:00,17549.0,SELL,3,0.02h,Stop Loss,$16.50,$202.50,$59562.50,36,$202.50
2024-02-20,17:34:00,17489.75,BUY,3,0.02h,Stop Loss,$4.50,$207.00,$59567.00,36,$207.00
2024-02-20,17:39:00,17467.25,SELL,3,0.02h,Stop Loss,$67.50,$274.50,$59634.50,36,$274.50
2024-02-20,17:44:00,17491.25,BUY,3,0.02h,Stop Loss,$40.50,$315.00,$59675.00,36,$315.00
2024-02-20,18:08:00,17492.5,SELL,3,0.02h,Stop Loss,$-9.00,$306.00,$59666.00,36,$306.00
2024-02-20,18:09:00,17498.0,BUY,3,0.02h,Stop Loss,$13.50,$319.50,$59679.50,36,$319.50
2024-02-20,18:12:00,17492.5,SELL,3,0.02h,Break Even,$-1.50,$318.00,$59678.00,36,$318.00
2024-02-20,18:14:00,17502.5,BUY,3,0.02h,Break Even,$-1.50,$316.50,$59676.50,36,$316.50
2024-02-20,18:16:00,17490.5,SELL,3,0.02h,Stop Loss,$40.50,$357.00,$59717.00,36,$357.00
2024-02-20,18:20:00,17510.5,BUY,3,0.02h,Stop Loss,$28.50,$385.50,$59745.50,36,$385.50
2024-02-20,18:30:00,17492.75,SELL,3,0.02h,Stop Loss,$10.50,$396.00,$59756.00,36,$396.00
2024-02-20,18:43:00,17513.25,BUY,3,0.02h,Break Even,$-1.50,$394.50,$59754.50,36,$394.50
2024-02-20,19:18:00,17509.0,SELL,3,0.02h,Break Even,$-1.50,$393.00,$59753.00,36,$393.00
2024-02-20,19:20:00,17543.25,BUY,3,0.02h,Stop Loss,$-9.00,$384.00,$59744.00,36,$384.00
2024-02-20,19:25:00,17519.5,SELL,3,0.02h,Stop Loss,$39.00,$423.00,$59783.00,36,$423.00
2024-02-20,19:28:00,17533.75,BUY,3,0.02h,Stop Loss,$10.50,$433.50,$59793.50,36,$433.50
2024-02-20,20:33:00,17557.0,SELL,3,0.02h,Stop Loss,$130.50,$564.00,$59924.00,36,$564.00
2024-02-20,20:46:00,17584.0,BUY,3,0.02h,Stop Loss,$3.00,$567.00,$59927.00,36,$567.00
2024-02-20,21:12:00,17586.25,SELL,3,0.02h,Break Even,$-1.50,$565.50,$59925.50,36,$565.50
2024-02-20,21:27:00,17587.25,BUY,3,0.02h,Stop Loss,$-9.00,$556.50,$59916.50,36,$556.50
2024-02-20,21:55:00,17588.5,SELL,3,0.02h,Break Even,$-1.50,$555.00,$59915.00,36,$555.00
,,,,,,,,,,,
2024-02-21,13:06:00,17507.5,BUY,3,0.02h,Stop Loss,$-9.00,$-9.00,$59906.00,37,$-9.00
2024-02-21,13:14:00,17496.0,SELL,3,0.02h,Break Even,$-1.50,$-10.50,$59904.50,37,$-10.50
2024-02-21,13:40:00,17500.0,BUY,3,0.02h,Break Even,$-1.50,$-12.00,$59903.00,37,$-12.00
2024-02-21,14:18:00,17498.75,SELL,3,0.02h,Stop Loss,$-9.00,$-21.00,$59894.00,37,$-21.00
2024-02-21,14:40:00,17500.0,BUY,3,0.02h,Stop Loss,$7.50,$-13.50,$59901.50,37,$-13.50
2024-02-21,14:41:00,17494.5,SELL,3,0.02h,Stop Loss,$90.00,$76.50,$59991.50,37,$76.50
2024-02-21,15:04:00,17501.0,BUY,3,0.02h,Stop Loss,$127.50,$204.00,$60119.00,37,$204.00
2024-02-21,15:27:00,17476.75,SELL,3,0.02h,Break Even,$-1.50,$202.50,$60117.50,37,$202.50
2024-02-21,15:59:00,17478.5,BUY,3,0.02h,Break Even,$-1.50,$201.00,$60116.00,37,$201.00
2024-02-21,16:00:00,17469.25,SELL,3,0.02h,Break Even,$-1.50,$199.50,$60114.50,37,$199.50
2024-02-21,16:02:00,17485.5,BUY,3,0.02h,Break Even,$-1.50,$198.00,$60113.00,37,$198.00
2024-02-21,16:30:00,17490.0,SELL,3,0.02h,Stop Loss,$3.00,$201.00,$60116.00,37,$201.00
2024-02-21,16:52:00,17497.0,BUY,3,0.02h,Stop Loss,$6.00,$207.00,$60122.00,37,$207.00
2024-02-21,17:05:00,17483.25,SELL,3,0.02h,Stop Loss,$124.50,$331.50,$60246.50,37,$331.50
2024-02-21,17:41:00,17455.25,BUY,3,0.02h,Stop Loss,$10.50,$342.00,$60257.00,37,$342.00
2024-02-21,17:44:00,17448.0,SELL,3,0.02h,Stop Loss,$55.50,$397.50,$60312.50,37,$397.50
2024-02-21,17:47:00,17459.25,BUY,3,0.02h,Break Even,$-1.50,$396.00,$60311.00,37,$396.00
2024-02-21,18:03:00,17431.0,SELL,3,0.02h,Stop Loss,$-9.00,$387.00,$60302.00,37,$387.00
2024-02-21,18:12:00,17469.0,BUY,3,0.02h,Stop Loss,$24.00,$411.00,$60326.00,37,$411.00
2024-02-21,18:28:00,17460.5,SELL,3,0.02h,Stop Loss,$25.50,$436.50,$60351.50,37,$436.50
2024-02-21,18:46:00,17468.0,BUY,3,0.02h,Stop Loss,$-9.00,$427.50,$60342.50,37,$427.50
2024-02-21,18:48:00,17459.75,SELL,3,0.02h,Stop Loss,$13.50,$441.00,$60356.00,37,$441.00
2024-02-21,18:51:00,17463.5,BUY,3,0.02h,Stop Loss,$-9.00,$432.00,$60347.00,37,$432.00
2024-02-21,18:52:00,17458.5,SELL,3,0.02h,Stop Loss,$3.00,$435.00,$60350.00,37,$435.00
2024-02-21,19:07:00,17462.5,BUY,3,0.02h,Stop Loss,$28.50,$463.50,$60378.50,37,$463.50
2024-02-21,19:17:00,17455.75,SELL,3,0.02h,Stop Loss,$22.50,$486.00,$60401.00,37,$486.00
2024-02-21,19:18:00,17466.75,BUY,3,0.02h,Stop Loss,$3.00,$489.00,$60404.00,37,$489.00
2024-02-21,19:19:00,17455.75,SELL,3,0.02h,Stop Loss,$60.00,$549.00,$60464.00,37,$549.00
2024-02-21,19:57:00,17409.0,BUY,3,0.02h,Stop Loss,$-9.00,$540.00,$60455.00,37,$540.00
2024-02-21,20:08:00,17394.75,SELL,3,0.02h,Break Even,$-1.50,$538.50,$60453.50,37,$538.50
2024-02-21,20:19:00,17408.75,BUY,3,0.02h,Stop Loss,$-9.00,$529.50,$60444.50,37,$529.50
2024-02-21,20:22:00,17388.75,SELL,3,0.02h,Break Even,$-1.50,$528.00,$60443.00,37,$528.00
2024-02-21,20:25:00,17401.5,BUY,3,0.02h,Stop Loss,$48.00,$576.00,$60491.00,37,$576.00
2024-02-21,21:22:00,17426.0,SELL,3,0.02h,Stop Loss,$9.00,$585.00,$60500.00,37,$585.00
2024-02-21,21:27:00,17544.0,BUY,3,0.02h,Stop Loss,$103.50,$688.50,$60603.50,37,$688.50
,,,,,,,,,,,
2024-02-22,12:59:00,17890.0,SELL,3,0.02h,Break Even,$-1.50,$-1.50,$60602.00,38,$-1.50
2024-02-22,13:13:00,17895.0,BUY,3,0.02h,Stop Loss,$25.50,$24.00,$60627.50,38,$24.00
2024-02-22,13:28:00,17891.25,SELL,3,0.02h,Break Even,$-1.50,$22.50,$60626.00,38,$22.50
2024-02-22,13:37:00,17900.25,BUY,3,0.02h,Stop Loss,$-9.00,$13.50,$60617.00,38,$13.50
2024-02-22,13:43:00,17889.25,SELL,3,0.02h,Stop Loss,$-9.00,$4.50,$60608.00,38,$4.50
2024-02-22,13:46:00,17898.75,BUY,3,0.02h,Stop Loss,$-9.00,$-4.50,$60599.00,38,$-4.50
2024-02-22,13:47:00,17893.0,SELL,3,0.02h,Break Even,$-1.50,$-6.00,$60597.50,38,$-6.00
2024-02-22,13:50:00,17897.75,BUY,3,0.02h,Stop Loss,$4.50,$-1.50,$60602.00,38,$-1.50
2024-02-22,14:04:00,17891.25,SELL,3,0.02h,Break Even,$-1.50,$-3.00,$60600.50,38,$-3.00
2024-02-22,14:30:00,17896.0,BUY,3,0.02h,Stop Loss,$120.00,$117.00,$60720.50,38,$117.00
2024-02-22,14:32:00,17870.75,SELL,3,0.02h,Stop Loss,$15.00,$132.00,$60735.50,38,$132.00
2024-02-22,14:33:00,17883.5,BUY,3,0.02h,Stop Loss,$25.50,$157.50,$60761.00,38,$157.50
2024-02-22,14:34:00,17868.5,SELL,3,0.02h,Stop Loss,$6.00,$163.50,$60767.00,38,$163.50
2024-02-22,14:40:00,17892.75,BUY,3,0.02h,Stop Loss,$66.00,$229.50,$60833.00,38,$229.50
2024-02-22,15:44:00,17936.0,SELL,3,0.02h,Stop Loss,$7.50,$237.00,$60840.50,38,$237.00
2024-02-22,16:07:00,17941.0,BUY,3,0.02h,Break Even,$-1.50,$235.50,$60839.00,38,$235.50
2024-02-22,16:49:00,17952.0,SELL,3,0.02h,Break Even,$-1.50,$234.00,$60837.50,38,$234.00
2024-02-22,17:07:00,17968.5,BUY,3,0.02h,Stop Loss,$-9.00,$225.00,$60828.50,38,$225.00
2024-02-22,19:36:00,18068.25,SELL,3,0.02h,Break Even,$-1.50,$223.50,$60827.00,38,$223.50
2024-02-22,20:06:00,18071.5,BUY,3,0.02h,Stop Loss,$19.50,$243.00,$60846.50,38,$243.00
2024-02-22,20:31:00,18058.25,SELL,3,0.02h,Stop Loss,$42.00,$285.00,$60888.50,38,$285.00
2024-02-22,20:40:00,18075.25,BUY,3,0.02h,Break Even,$-1.50,$283.50,$60887.00,38,$283.50
2024-02-22,20:48:00,18061.75,SELL,3,0.02h,Stop Loss,$4.50,$288.00,$60891.50,38,$288.00
2024-02-22,21:41:00,18020.25,BUY,3,0.03h,Break Even,$-1.50,$286.50,$60890.00,38,$286.50
2024-02-22,21:45:00,18018.25,SELL,3,0.02h,Break Even,$-1.50,$285.00,$60888.50,38,$285.00
2024-02-22,21:47:00,18020.75,BUY,3,0.02h,Stop Loss,$-9.00,$276.00,$60879.50,38,$276.00
,,,,,,,,,,,
2024-02-23,12:18:00,18024.5,SELL,3,0.02h,Break Even,$-1.50,$-1.50,$60878.00,39,$-1.50
2024-02-23,12:27:00,18033.5,BUY,3,0.02h,Stop Loss,$10.50,$9.00,$60888.50,39,$9.00
2024-02-23,12:47:00,18035.0,SELL,3,0.02h,Break Even,$-1.50,$7.50,$60887.00,39,$7.50
2024-02-23,12:50:00,18042.5,BUY,3,0.02h,Stop Loss,$-9.00,$-1.50,$60878.00,39,$-1.50
2024-02-23,13:03:00,18036.0,SELL,3,0.02h,Stop Loss,$-9.00,$-10.50,$60869.00,39,$-10.50
2024-02-23,13:06:00,18042.0,BUY,3,0.02h,Stop Loss,$3.00,$-7.50,$60872.00,39,$-7.50
2024-02-23,14:51:00,18110.5,SELL,3,0.02h,Stop Loss,$27.00,$19.50,$60899.00,39,$19.50
2024-02-23,16:26:00,17996.75,BUY,3,0.02h,Stop Loss,$25.50,$45.00,$60924.50,39,$45.00
2024-02-23,17:20:00,18035.75,SELL,3,0.02h,Stop Loss,$-9.00,$36.00,$60915.50,39,$36.00
2024-02-23,17:48:00,18033.0,BUY,3,0.02h,Break Even,$-1.50,$34.50,$60914.00,39,$34.50
2024-02-23,18:39:00,18043.25,SELL,3,0.02h,Stop Loss,$-9.00,$25.50,$60905.00,39,$25.50
2024-02-23,19:37:00,18016.25,BUY,3,0.02h,Stop Loss,$3.00,$28.50,$60908.00,39,$28.50
2024-02-23,19:51:00,18007.0,SELL,3,0.02h,Stop Loss,$6.00,$34.50,$60914.00,39,$34.50
2024-02-23,19:53:00,18018.5,BUY,3,0.02h,Break Even,$-1.50,$33.00,$60912.50,39,$33.00
2024-02-23,20:08:00,18001.0,SELL,3,0.02h,Stop Loss,$39.00,$72.00,$60951.50,39,$72.00
2024-02-23,20:39:00,18001.5,BUY,3,0.02h,Stop Loss,$-9.00,$63.00,$60942.50,39,$63.00
2024-02-23,21:01:00,17977.25,SELL,3,0.02h,Break Even,$-1.50,$61.50,$60941.00,39,$61.50
2024-02-23,21:34:00,17969.75,BUY,3,0.02h,Stop Loss,$-9.00,$52.50,$60932.00,39,$52.50
2024-02-23,21:52:00,17968.25,SELL,3,0.03h,Break Even,$-1.50,$51.00,$60930.50,39,$51.00
,,,,,,,,,,,
2024-02-26,12:00:00,17989.0,BUY,3,0.02h,Break Even,$-1.50,$-1.50,$60929.00,40,$-1.50
2024-02-26,12:43:00,17980.75,SELL,3,0.02h,Break Even,$-1.50,$-3.00,$60927.50,40,$-3.00
2024-02-26,13:08:00,17987.25,BUY,3,0.02h,Break Even,$-1.50,$-4.50,$60926.00,40,$-4.50
2024-02-26,13:56:00,18013.25,SELL,3,0.02h,Break Even,$-1.50,$-6.00,$60924.50,40,$-6.00
2024-02-26,13:59:00,18016.75,BUY,3,0.02h,Stop Loss,$-9.00,$-15.00,$60915.50,40,$-15.00
2024-02-26,14:01:00,18012.75,SELL,3,0.02h,Stop Loss,$-9.00,$-24.00,$60906.50,40,$-24.00
2024-02-26,14:30:00,18017.0,BUY,3,0.02h,Stop Loss,$108.00,$84.00,$61014.50,40,$84.00
2024-02-26,14:45:00,17992.25,SELL,3,0.02h,Stop Loss,$18.00,$102.00,$61032.50,40,$102.00
2024-02-26,15:08:00,18006.75,BUY,3,0.02h,Stop Loss,$30.00,$132.00,$61062.50,40,$132.00
2024-02-26,15:58:00,18019.75,SELL,3,0.02h,Stop Loss,$-9.00,$123.00,$61053.50,40,$123.00
2024-02-26,16:32:00,18025.5,BUY,3,0.02h,Stop Loss,$9.00,$132.00,$61062.50,40,$132.00
2024-02-26,17:03:00,18020.0,SELL,3,0.02h,Stop Loss,$-9.00,$123.00,$61053.50,40,$123.00
2024-02-26,17:16:00,18037.0,BUY,3,0.02h,Break Even,$-1.50,$121.50,$61052.00,40,$121.50
2024-02-26,17:39:00,18037.25,SELL,3,0.02h,Break Even,$-1.50,$120.00,$61050.50,40,$120.00
2024-02-26,18:09:00,18035.5,BUY,3,0.02h,Break Even,$-1.50,$118.50,$61049.00,40,$118.50
2024-02-26,18:20:00,18015.5,SELL,3,0.02h,Stop Loss,$19.50,$138.00,$61068.50,40,$138.00
2024-02-26,18:58:00,18006.25,BUY,3,0.02h,Stop Loss,$15.00,$153.00,$61083.50,40,$153.00
2024-02-26,19:16:00,18009.75,SELL,3,0.02h,Stop Loss,$-9.00,$144.00,$61074.50,40,$144.00
2024-02-26,19:23:00,18025.75,BUY,3,0.02h,Stop Loss,$24.00,$168.00,$61098.50,40,$168.00
2024-02-26,19:43:00,18020.75,SELL,3,0.02h,Stop Loss,$19.50,$187.50,$61118.00,40,$187.50
2024-02-26,20:12:00,18024.75,BUY,3,0.02h,Stop Loss,$3.00,$190.50,$61121.00,40,$190.50
2024-02-26,20:21:00,18010.75,SELL,3,0.02h,Stop Loss,$-9.00,$181.50,$61112.00,40,$181.50
,,,,,,,,,,,
2024-02-27,12:00:00,18004.75,BUY,3,0.02h,Stop Loss,$4.50,$4.50,$61116.50,41,$4.50
2024-02-27,12:55:00,18029.75,SELL,3,0.02h,Break Even,$-1.50,$3.00,$61115.00,41,$3.00
2024-02-27,13:37:00,18014.25,BUY,3,0.02h,Stop Loss,$-9.00,$-6.00,$61106.00,41,$-6.00
2024-02-27,14:10:00,18017.25,SELL,3,0.02h,Break Even,$-1.50,$-7.50,$61104.50,41,$-7.50
2024-02-27,15:00:00,17990.25,BUY,3,0.02h,Stop Loss,$145.50,$138.00,$61250.00,41,$138.00
2024-02-27,15:40:00,17998.25,SELL,3,0.02h,Stop Loss,$19.50,$157.50,$61269.50,41,$157.50
2024-02-27,15:49:00,18023.25,BUY,3,0.02h,Break Even,$-1.50,$156.00,$61268.00,41,$156.00
2024-02-27,16:05:00,18006.25,SELL,3,0.02h,Stop Loss,$57.00,$213.00,$61325.00,41,$213.00
2024-02-27,16:51:00,17992.0,BUY,3,0.02h,Stop Loss,$22.50,$235.50,$61347.50,41,$235.50
2024-02-27,17:18:00,17988.5,SELL,3,0.02h,Break Even,$-1.50,$234.00,$61346.00,41,$234.00
2024-02-27,18:13:00,17951.75,BUY,3,0.02h,Break Even,$-1.50,$232.50,$61344.50,41,$232.50
2024-02-27,18:30:00,17941.25,SELL,3,0.02h,Stop Loss,$7.50,$240.00,$61352.00,41,$240.00
2024-02-27,18:40:00,17952.5,BUY,3,0.02h,Break Even,$-1.50,$238.50,$61350.50,41,$238.50
2024-02-27,20:18:00,18017.5,SELL,3,0.02h,Stop Loss,$13.50,$252.00,$61364.00,41,$252.00
2024-02-27,20:25:00,18023.75,BUY,3,0.02h,Stop Loss,$-9.00,$243.00,$61355.00,41,$243.00
2024-02-27,20:33:00,18010.0,SELL,3,0.02h,Break Even,$-1.50,$241.50,$61353.50,41,$241.50
2024-02-27,20:49:00,18015.5,BUY,3,0.02h,Stop Loss,$4.50,$246.00,$61358.00,41,$246.00
2024-02-27,21:03:00,18010.5,SELL,3,0.02h,Break Even,$-1.50,$244.50,$61356.50,41,$244.50
2024-02-27,21:12:00,18016.25,BUY,3,0.02h,Break Even,$-1.50,$243.00,$61355.00,41,$243.00
2024-02-27,21:50:00,18020.5,SELL,3,0.02h,Stop Loss,$-9.00,$234.00,$61346.00,41,$234.00
,,,,,,,,,,,
2024-02-28,13:10:00,17935.25,BUY,3,0.02h,Stop Loss,$-9.00,$-9.00,$61337.00,42,$-9.00
2024-02-28,13:11:00,17934.0,SELL,3,0.02h,Stop Loss,$3.00,$-6.00,$61340.00,42,$-6.00
2024-02-28,13:20:00,17937.0,BUY,3,0.02h,Stop Loss,$9.00,$3.00,$61349.00,42,$3.00
2024-02-28,13:42:00,17926.25,SELL,3,0.02h,Stop Loss,$25.50,$28.50,$61374.50,42,$28.50
2024-02-28,13:48:00,17944.5,BUY,3,0.02h,Stop Loss,$7.50,$36.00,$61382.00,42,$36.00
2024-02-28,13:54:00,17931.5,SELL,3,0.02h,Break Even,$-1.50,$34.50,$61380.50,42,$34.50
2024-02-28,14:00:00,17944.75,BUY,3,0.02h,Stop Loss,$-9.00,$25.50,$61371.50,42,$25.50
2024-02-28,14:05:00,17933.75,SELL,3,0.02h,Stop Loss,$15.00,$40.50,$61386.50,42,$40.50
2024-02-28,14:31:00,17937.0,BUY,3,0.02h,Stop Loss,$-9.00,$31.50,$61377.50,42,$31.50
2024-02-28,14:32:00,17924.5,SELL,3,0.02h,Stop Loss,$70.50,$102.00,$61448.00,42,$102.00
2024-02-28,14:37:00,17940.25,BUY,3,0.02h,Break Even,$-1.50,$100.50,$61446.50,42,$100.50
2024-02-28,14:46:00,17913.5,SELL,3,0.02h,Stop Loss,$12.00,$112.50,$61458.50,42,$112.50
2024-02-28,15:11:00,17914.75,BUY,3,0.02h,Stop Loss,$30.00,$142.50,$61488.50,42,$142.50
2024-02-28,15:27:00,17904.5,SELL,3,0.02h,Stop Loss,$75.00,$217.50,$61563.50,42,$217.50
2024-02-28,15:33:00,17918.25,BUY,3,0.02h,Break Even,$-1.50,$216.00,$61562.00,42,$216.00
2024-02-28,15:57:00,17916.0,SELL,3,0.02h,Break Even,$-1.50,$214.50,$61560.50,42,$214.50
2024-02-28,15:58:00,17923.0,BUY,3,0.02h,Stop Loss,$27.00,$241.50,$61587.50,42,$241.50
2024-02-28,17:01:00,17955.75,SELL,3,0.02h,Break Even,$-1.50,$240.00,$61586.00,42,$240.00
2024-02-28,17:55:00,17922.0,BUY,3,0.02h,Break Even,$-1.50,$238.50,$61584.50,42,$238.50
2024-02-28,18:01:00,17911.0,SELL,3,0.02h,Stop Loss,$-9.00,$229.50,$61575.50,42,$229.50
2024-02-28,18:17:00,17919.75,BUY,3,0.02h,Stop Loss,$19.50,$249.00,$61595.00,42,$249.00
2024-02-28,18:52:00,17934.5,SELL,3,0.02h,Stop Loss,$-9.00,$240.00,$61586.00,42,$240.00
2024-02-28,18:59:00,17945.75,BUY,3,0.02h,Stop Loss,$3.00,$243.00,$61589.00,42,$243.00
2024-02-28,19:07:00,17935.25,SELL,3,0.02h,Stop Loss,$15.00,$258.00,$61604.00,42,$258.00
2024-02-28,19:57:00,17915.5,BUY,3,0.02h,Stop Loss,$-9.00,$249.00,$61595.00,42,$249.00
2024-02-28,20:11:00,17899.5,SELL,3,0.02h,Break Even,$-1.50,$247.50,$61593.50,42,$247.50
2024-02-28,20:21:00,17909.5,BUY,3,0.02h,Stop Loss,$-9.00,$238.50,$61584.50,42,$238.50
2024-02-28,20:46:00,17906.0,SELL,3,0.02h,Stop Loss,$13.50,$252.00,$61598.00,42,$252.00
2024-02-28,21:01:00,17912.0,BUY,3,0.02h,Break Even,$-1.50,$250.50,$61596.50,42,$250.50
2024-02-28,21:02:00,17909.25,SELL,3,0.02h,Stop Loss,$91.50,$342.00,$61688.00,42,$342.00
2024-02-28,21:58:00,17864.5,BUY,3,0.02h,Stop Loss,$-9.00,$333.00,$61679.00,42,$333.00
,,,,,,,,,,,
2024-02-29,12:21:00,17868.25,SELL,3,0.02h,Stop Loss,$7.50,$7.50,$61686.50,43,$7.50
2024-02-29,12:28:00,17874.5,BUY,3,0.02h,Stop Loss,$-9.00,$-1.50,$61677.50,43,$-1.50
2024-02-29,12:29:00,17869.0,SELL,3,0.02h,Stop Loss,$-9.00,$-10.50,$61668.50,43,$-10.50
2024-02-29,12:33:00,17874.0,BUY,3,0.02h,Break Even,$-1.50,$-12.00,$61667.00,43,$-12.00
2024-02-29,12:40:00,17869.5,SELL,3,0.02h,Break Even,$-1.50,$-13.50,$61665.50,43,$-13.50
2024-02-29,12:57:00,17874.75,BUY,3,0.02h,Stop Loss,$-9.00,$-22.50,$61656.50,43,$-22.50
2024-02-29,13:03:00,17865.25,SELL,3,0.02h,Stop Loss,$-9.00,$-31.50,$61647.50,43,$-31.50
2024-02-29,13:06:00,17874.25,BUY,3,0.02h,Stop Loss,$7.50,$-24.00,$61655.00,43,$-24.00
2024-02-29,13:24:00,17866.0,SELL,3,0.02h,Stop Loss,$-9.00,$-33.00,$61646.00,43,$-33.00
2024-02-29,13:31:00,17936.5,BUY,3,0.02h,Stop Loss,$132.00,$99.00,$61778.00,43,$99.00
2024-02-29,15:11:00,18011.5,SELL,3,0.02h,Stop Loss,$54.00,$153.00,$61832.00,43,$153.00
2024-02-29,15:37:00,18022.5,BUY,3,0.02h,Stop Loss,$-9.00,$144.00,$61823.00,43,$144.00
2024-02-29,15:44:00,18005.25,SELL,3,0.02h,Break Even,$-1.50,$142.50,$61821.50,43,$142.50
2024-02-29,15:51:00,18025.25,BUY,3,0.02h,Stop Loss,$-9.00,$133.50,$61812.50,43,$133.50
2024-02-29,15:53:00,18016.0,SELL,3,0.02h,Stop Loss,$43.50,$177.00,$61856.00,43,$177.00
2024-02-29,16:16:00,18011.25,BUY,3,0.02h,Break Even,$-1.50,$175.50,$61854.50,43,$175.50
2024-02-29,16:23:00,17996.0,SELL,3,0.02h,Stop Loss,$4.50,$180.00,$61859.00,43,$180.00
2024-02-29,16:54:00,17970.25,BUY,3,0.02h,Stop Loss,$13.50,$193.50,$61872.50,43,$193.50
2024-02-29,17:29:00,17983.75,SELL,3,0.02h,Stop Loss,$67.50,$261.00,$61940.00,43,$261.00
2024-02-29,17:43:00,17987.25,BUY,3,0.02h,Break Even,$-1.50,$259.50,$61938.50,43,$259.50
2024-02-29,18:41:00,18031.25,SELL,3,0.02h,Stop Loss,$22.50,$282.00,$61961.00,43,$282.00
2024-02-29,18:53:00,18041.0,BUY,3,0.02h,Stop Loss,$-9.00,$273.00,$61952.00,43,$273.00
2024-02-29,19:06:00,18028.25,SELL,3,0.02h,Break Even,$-1.50,$271.50,$61950.50,43,$271.50
2024-02-29,19:12:00,18041.5,BUY,3,0.02h,Break Even,$-1.50,$270.00,$61949.00,43,$270.00
2024-02-29,19:27:00,18027.75,SELL,3,0.02h,Stop Loss,$10.50,$280.50,$61959.50,43,$280.50
2024-02-29,20:00:00,18037.0,BUY,3,0.02h,Stop Loss,$9.00,$289.50,$61968.50,43,$289.50
2024-02-29,21:05:00,18055.0,SELL,3,0.02h,Stop Loss,$94.50,$384.00,$62063.00,43,$384.00
2024-02-29,21:19:00,18066.25,BUY,3,0.02h,Break Even,$-1.50,$382.50,$62061.50,43,$382.50
2024-02-29,21:46:00,18067.0,SELL,3,0.02h,Stop Loss,$-9.00,$373.50,$62052.50,43,$373.50
,,,,,,,,,,,
2024-03-01,12:00:00,18092.5,BUY,3,0.02h,Break Even,$-1.50,$-1.50,$62051.00,44,$-1.50
2024-03-01,12:25:00,18076.75,SELL,3,0.02h,Stop Loss,$-9.00,$-10.50,$62042.00,44,$-10.50
2024-03-01,12:38:00,18086.5,BUY,3,0.02h,Break Even,$-1.50,$-12.00,$62040.50,44,$-12.00
2024-03-01,13:24:00,18093.25,SELL,3,0.02h,Stop Loss,$15.00,$3.00,$62055.50,44,$3.00
2024-03-01,13:32:00,18102.0,BUY,3,0.02h,Stop Loss,$-9.00,$-6.00,$62046.50,44,$-6.00
2024-03-01,13:33:00,18096.25,SELL,3,0.02h,Stop Loss,$-9.00,$-15.00,$62037.50,44,$-15.00
2024-03-01,13:50:00,18098.75,BUY,3,0.02h,Stop Loss,$-9.00,$-24.00,$62028.50,44,$-24.00
2024-03-01,13:55:00,18084.25,SELL,3,0.02h,Break Even,$-1.50,$-25.50,$62027.00,44,$-25.50
2024-03-01,14:17:00,18091.0,BUY,3,0.02h,Stop Loss,$-9.00,$-34.50,$62018.00,44,$-34.50
2024-03-01,15:33:00,18158.0,SELL,3,0.02h,Stop Loss,$9.00,$-25.50,$62027.00,44,$-25.50
2024-03-01,15:46:00,18182.25,BUY,3,0.02h,Stop Loss,$16.50,$-9.00,$62043.50,44,$-9.00
2024-03-01,16:36:00,18215.0,SELL,3,0.02h,Stop Loss,$-9.00,$-18.00,$62034.50,44,$-18.00
2024-03-01,16:38:00,18230.5,BUY,3,0.02h,Stop Loss,$-9.00,$-27.00,$62025.50,44,$-27.00
2024-03-01,17:04:00,18229.0,SELL,3,0.02h,Break Even,$-1.50,$-28.50,$62024.00,44,$-28.50
2024-03-01,17:13:00,18244.0,BUY,3,0.02h,Break Even,$-1.50,$-30.00,$62022.50,44,$-30.00
2024-03-01,19:35:00,18352.75,SELL,3,0.02h,Stop Loss,$37.50,$7.50,$62060.00,44,$7.50
2024-03-01,19:51:00,18360.75,BUY,3,0.02h,Break Even,$-1.50,$6.00,$62058.50,44,$6.00
2024-03-01,20:04:00,18346.25,SELL,3,0.02h,Break Even,$-1.50,$4.50,$62057.00,44,$4.50
2024-03-01,20:29:00,18346.0,BUY,3,0.02h,Stop Loss,$-9.00,$-4.50,$62048.00,44,$-4.50
2024-03-01,20:33:00,18333.5,SELL,3,0.02h,Stop Loss,$-9.00,$-13.50,$62039.00,44,$-13.50
2024-03-01,20:46:00,18344.5,BUY,3,0.02h,Break Even,$-1.50,$-15.00,$62037.50,44,$-15.00
2024-03-01,21:00:00,18335.0,SELL,3,0.02h,Stop Loss,$55.50,$40.50,$62093.00,44,$40.50
,,,,,,,,,,,
2024-03-04,12:00:00,18334.5,BUY,3,0.03h,Break Even,$-1.50,$-1.50,$62091.50,45,$-1.50
2024-03-04,12:40:00,18339.25,SELL,3,0.02h,Stop Loss,$-9.00,$-10.50,$62082.50,45,$-10.50
2024-03-04,12:43:00,18345.0,BUY,3,0.02h,Break Even,$-1.50,$-12.00,$62081.00,45,$-12.00
2024-03-04,12:53:00,18342.5,SELL,3,0.02h,Break Even,$-1.50,$-13.50,$62079.50,45,$-13.50
2024-03-04,13:13:00,18346.75,BUY,3,0.02h,Stop Loss,$-9.00,$-22.50,$62070.50,45,$-22.50
2024-03-04,13:27:00,18340.0,SELL,3,0.02h,Stop Loss,$21.00,$-1.50,$62091.50,45,$-1.50
2024-03-04,13:43:00,18344.75,BUY,3,0.02h,Stop Loss,$-9.00,$-10.50,$62082.50,45,$-10.50
2024-03-04,13:50:00,18335.0,SELL,3,0.02h,Break Even,$-1.50,$-12.00,$62081.00,45,$-12.00
2024-03-04,15:19:00,18300.25,BUY,3,0.02h,Stop Loss,$-9.00,$-21.00,$62072.00,45,$-21.00
2024-03-04,15:20:00,18298.25,SELL,3,0.02h,Stop Loss,$51.00,$30.00,$62123.00,45,$30.00
2024-03-04,15:34:00,18301.75,BUY,3,0.02h,Stop Loss,$30.00,$60.00,$62153.00,45,$60.00
2024-03-04,16:06:00,18312.0,SELL,3,0.02h,Stop Loss,$40.50,$100.50,$62193.50,45,$100.50
2024-03-04,16:49:00,18307.75,BUY,3,0.02h,Stop Loss,$-9.00,$91.50,$62184.50,45,$91.50
2024-03-04,17:07:00,18306.25,SELL,3,0.02h,Stop Loss,$24.00,$115.50,$62208.50,45,$115.50
2024-03-04,17:14:00,18310.0,BUY,3,0.02h,Stop Loss,$-9.00,$106.50,$62199.50,45,$106.50
2024-03-04,17:36:00,18309.75,SELL,3,0.02h,Stop Loss,$15.00,$121.50,$62214.50,45,$121.50
2024-03-04,18:03:00,18309.25,BUY,3,0.02h,Stop Loss,$-9.00,$112.50,$62205.50,45,$112.50
2024-03-04,18:07:00,18300.75,SELL,3,0.02h,Break Even,$-1.50,$111.00,$62204.00,45,$111.00
2024-03-04,18:39:00,18294.25,BUY,3,0.02h,Stop Loss,$-9.00,$102.00,$62195.00,45,$102.00
2024-03-04,19:08:00,18292.75,SELL,3,0.02h,Stop Loss,$3.00,$105.00,$62198.00,45,$105.00
2024-03-04,19:16:00,18302.0,BUY,3,0.02h,Stop Loss,$-9.00,$96.00,$62189.00,45,$96.00
2024-03-04,19:17:00,18298.0,SELL,3,0.02h,Break Even,$-1.50,$94.50,$62187.50,45,$94.50
2024-03-04,19:18:00,18301.0,BUY,3,0.02h,Stop Loss,$31.50,$126.00,$62219.00,45,$126.00
2024-03-04,19:29:00,18297.75,SELL,3,0.02h,Break Even,$-1.50,$124.50,$62217.50,45,$124.50
2024-03-04,19:34:00,18307.25,BUY,3,0.02h,Stop Loss,$13.50,$138.00,$62231.00,45,$138.00
2024-03-04,20:08:00,18327.75,SELL,3,0.02h,Stop Loss,$-9.00,$129.00,$62222.00,45,$129.00
2024-03-04,20:09:00,18335.25,BUY,3,0.02h,Stop Loss,$4.50,$133.50,$62226.50,45,$133.50
2024-03-04,20:29:00,18334.75,SELL,3,0.02h,Stop Loss,$90.00,$223.50,$62316.50,45,$223.50
2024-03-04,21:59:00,18242.0,BUY,3,0.02h,Stop Loss,$4.50,$228.00,$62321.00,45,$228.00
,,,,,,,,,,,
2024-03-05,12:00:00,18157.75,SELL,3,0.02h,Stop Loss,$-9.00,$-9.00,$62312.00,46,$-9.00
2024-03-05,13:04:00,18161.75,BUY,3,0.02h,Stop Loss,$-9.00,$-18.00,$62303.00,46,$-18.00
2024-03-05,13:23:00,18160.0,SELL,3,0.02h,Stop Loss,$-9.00,$-27.00,$62294.00,46,$-27.00
2024-03-05,15:04:00,18078.75,BUY,3,0.02h,Stop Loss,$10.50,$-16.50,$62304.50,46,$-16.50
2024-03-05,15:07:00,18050.75,SELL,3,0.02h,Stop Loss,$120.00,$103.50,$62424.50,46,$103.50
2024-03-05,16:07:00,17942.75,BUY,3,0.02h,Stop Loss,$6.00,$109.50,$62430.50,46,$109.50
2024-03-05,16:11:00,17931.0,SELL,3,0.02h,Stop Loss,$67.50,$177.00,$62498.00,46,$177.00
2024-03-05,16:19:00,17949.25,BUY,3,0.02h,Break Even,$-1.50,$175.50,$62496.50,46,$175.50
2024-03-05,16:37:00,17937.75,SELL,3,0.02h,Break Even,$-1.50,$174.00,$62495.00,46,$174.00
2024-03-05,17:01:00,17943.25,BUY,3,0.02h,Break Even,$-1.50,$172.50,$62493.50,46,$172.50
2024-03-05,17:40:00,17951.25,SELL,3,0.02h,Stop Loss,$39.00,$211.50,$62532.50,46,$211.50
2024-03-05,17:47:00,17966.25,BUY,3,0.02h,Break Even,$-1.50,$210.00,$62531.00,46,$210.00
2024-03-05,17:52:00,17948.5,SELL,3,0.02h,Break Even,$-1.50,$208.50,$62529.50,46,$208.50
2024-03-05,17:56:00,17965.25,BUY,3,0.02h,Break Even,$-1.50,$207.00,$62528.00,46,$207.00
2024-03-05,18:01:00,17946.25,SELL,3,0.02h,Break Even,$-1.50,$205.50,$62526.50,46,$205.50
2024-03-05,19:11:00,17899.5,BUY,3,0.02h,Break Even,$-1.50,$204.00,$62525.00,46,$204.00
2024-03-05,19:21:00,17881.75,SELL,3,0.02h,Stop Loss,$-9.00,$195.00,$62516.00,46,$195.00
2024-03-05,19:24:00,17898.25,BUY,3,0.02h,Break Even,$-1.50,$193.50,$62514.50,46,$193.50
2024-03-05,19:31:00,17888.75,SELL,3,0.02h,Stop Loss,$49.50,$243.00,$62564.00,46,$243.00
2024-03-05,20:05:00,17872.75,BUY,3,0.02h,Stop Loss,$42.00,$285.00,$62606.00,46,$285.00
2024-03-05,20:09:00,17861.25,SELL,3,0.02h,Stop Loss,$4.50,$289.50,$62610.50,46,$289.50
2024-03-05,20:36:00,17858.25,BUY,3,0.02h,Break Even,$-1.50,$288.00,$62609.00,46,$288.00
,,,,,,,,,,,
2024-03-06,13:32:00,18076.0,SELL,3,0.02h,Stop Loss,$55.50,$55.50,$62664.50,47,$55.50
2024-03-06,13:49:00,18083.0,BUY,3,0.02h,Stop Loss,$19.50,$75.00,$62684.00,47,$75.00
2024-03-06,14:37:00,18074.25,SELL,3,0.02h,Break Even,$-1.50,$73.50,$62682.50,47,$73.50
2024-03-06,14:46:00,18108.75,BUY,3,0.02h,Break Even,$-1.50,$72.00,$62681.00,47,$72.00
2024-03-06,14:47:00,18086.0,SELL,3,0.02h,Stop Loss,$57.00,$129.00,$62738.00,47,$129.00
2024-03-06,15:23:00,18030.0,BUY,3,0.02h,Stop Loss,$9.00,$138.00,$62747.00,47,$138.00
2024-03-06,15:25:00,18013.0,SELL,3,0.02h,Break Even,$-1.50,$136.50,$62745.50,47,$136.50
2024-03-06,15:34:00,18034.75,BUY,3,0.02h,Stop Loss,$64.50,$201.00,$62810.00,47,$201.00
2024-03-06,16:33:00,18078.0,SELL,3,0.02h,Stop Loss,$66.00,$267.00,$62876.00,47,$267.00
2024-03-06,16:41:00,18093.75,BUY,3,0.02h,Break Even,$-1.50,$265.50,$62874.50,47,$265.50
2024-03-06,17:42:00,18146.75,SELL,3,0.02h,Stop Loss,$16.50,$282.00,$62891.00,47,$282.00
2024-03-06,18:16:00,18142.25,BUY,3,0.02h,Stop Loss,$-9.00,$273.00,$62882.00,47,$273.00
2024-03-06,18:34:00,18082.0,SELL,3,0.02h,Stop Loss,$10.50,$283.50,$62892.50,47,$283.50
2024-03-06,19:25:00,18066.25,BUY,3,0.02h,Break Even,$-1.50,$282.00,$62891.00,47,$282.00
2024-03-06,19:35:00,18053.0,SELL,3,0.02h,Stop Loss,$94.50,$376.50,$62985.50,47,$376.50
2024-03-06,20:11:00,18044.75,BUY,3,0.02h,Stop Loss,$6.00,$382.50,$62991.50,47,$382.50
2024-03-06,20:14:00,18021.5,SELL,3,0.02h,Stop Loss,$127.50,$510.00,$63119.00,47,$510.00
2024-03-06,20:41:00,18034.5,BUY,3,0.02h,Stop Loss,$4.50,$514.50,$63123.50,47,$514.50
2024-03-06,21:09:00,18034.0,SELL,3,0.02h,Break Even,$-1.50,$513.00,$63122.00,47,$513.00
2024-03-06,21:14:00,18039.5,BUY,3,0.02h,Stop Loss,$-9.00,$504.00,$63113.00,47,$504.00
2024-03-06,21:51:00,18041.75,SELL,3,0.02h,Stop Loss,$-9.00,$495.00,$63104.00,47,$495.00
,,,,,,,,,,,
2024-03-07,12:00:00,18352.75,BUY,3,0.02h,Stop Loss,$-9.00,$-9.00,$63095.00,48,$-9.00
2024-03-07,12:27:00,18121.5,SELL,3,0.02h,Stop Loss,$-9.00,$-18.00,$63086.00,48,$-18.00
2024-03-07,12:28:00,18370.75,BUY,3,0.02h,Stop Loss,$-9.00,$-27.00,$63077.00,48,$-27.00
2024-03-07,12:32:00,18124.75,SELL,3,0.02h,Break Even,$-1.50,$-28.50,$63075.50,48,$-28.50
2024-03-07,12:50:00,18371.25,BUY,3,0.02h,Stop Loss,$-9.00,$-37.50,$63066.50,48,$-37.50
2024-03-07,12:52:00,18125.25,SELL,3,0.02h,Stop Loss,$-9.00,$-46.50,$63057.50,48,$-46.50
2024-03-07,12:53:00,18362.0,BUY,3,0.03h,Stop Loss,$-9.00,$-55.50,$63048.50,48,$-55.50
2024-03-07,12:58:00,18120.5,SELL,3,0.02h,Break Even,$-1.50,$-57.00,$63047.00,48,$-57.00
2024-03-07,13:03:00,18361.5,BUY,3,0.03h,Stop Loss,$-9.00,$-66.00,$63038.00,48,$-66.00
2024-03-07,13:23:00,18139.25,SELL,3,0.02h,Break Even,$-1.50,$-67.50,$63036.50,48,$-67.50
2024-03-07,13:27:00,18384.5,BUY,3,0.02h,Break Even,$-1.50,$-69.00,$63035.00,48,$-69.00
2024-03-07,13:30:00,18138.75,SELL,3,0.02h,Stop Loss,$7.50,$-61.50,$63042.50,48,$-61.50
2024-03-07,13:36:00,18396.75,BUY,3,0.02h,Break Even,$-1.50,$-63.00,$63041.00,48,$-63.00
2024-03-07,13:39:00,18146.75,SELL,3,0.02h,Stop Loss,$-9.00,$-72.00,$63032.00,48,$-72.00
2024-03-07,13:42:00,18392.75,BUY,3,0.02h,Break Even,$-1.50,$-73.50,$63030.50,48,$-73.50
2024-03-07,13:48:00,18158.0,SELL,3,0.02h,Stop Loss,$4.50,$-69.00,$63035.00,48,$-69.00
2024-03-07,13:59:00,18398.0,BUY,3,0.02h,Stop Loss,$-9.00,$-78.00,$63026.00,48,$-78.00
2024-03-07,14:14:00,18150.5,SELL,3,0.02h,Break Even,$-1.50,$-79.50,$63024.50,48,$-79.50
2024-03-07,14:16:00,18400.0,BUY,3,0.02h,Stop Loss,$-9.00,$-88.50,$63015.50,48,$-88.50
2024-03-07,14:17:00,18153.75,SELL,3,0.02h,Break Even,$-1.50,$-90.00,$63014.00,48,$-90.00
2024-03-07,14:20:00,18420.75,BUY,3,0.02h,Stop Loss,$10.50,$-79.50,$63024.50,48,$-79.50
2024-03-07,14:26:00,18172.25,SELL,3,0.02h,Stop Loss,$-9.00,$-88.50,$63015.50,48,$-88.50
2024-03-07,14:27:00,18417.75,BUY,3,0.02h,Stop Loss,$-9.00,$-97.50,$63006.50,48,$-97.50
2024-03-07,14:28:00,18172.5,SELL,3,0.02h,Stop Loss,$-9.00,$-106.50,$62997.50,48,$-106.50
2024-03-07,14:29:00,18419.25,BUY,3,0.02h,Stop Loss,$61.50,$-45.00,$63059.00,48,$-45.00
2024-03-07,14:43:00,18180.5,SELL,3,0.02h,Stop Loss,$-9.00,$-54.00,$63050.00,48,$-54.00
2024-03-07,14:44:00,18425.0,BUY,3,0.02h,Stop Loss,$-9.00,$-63.00,$63041.00,48,$-63.00
2024-03-07,14:45:00,18163.25,SELL,3,0.02h,Stop Loss,$111.00,$48.00,$63152.00,48,$48.00
2024-03-07,14:54:00,18438.75,BUY,3,0.02h,Stop Loss,$-9.00,$39.00,$63143.00,48,$39.00
2024-03-07,14:55:00,18194.0,SELL,3,0.02h,Break Even,$-1.50,$37.50,$63141.50,48,$37.50
2024-03-07,14:57:00,18453.5,BUY,3,0.02h,Stop Loss,$-9.00,$28.50,$63132.50,48,$28.50
2024-03-07,14:58:00,18184.5,SELL,3,0.02h,Break Even,$-1.50,$27.00,$63131.00,48,$27.00
2024-03-07,15:10:00,18435.5,BUY,3,0.02h,Stop Loss,$73.50,$100.50,$63204.50,48,$100.50
2024-03-07,15:20:00,18216.75,SELL,3,0.02h,Stop Loss,$-9.00,$91.50,$63195.50,48,$91.50
2024-03-07,15:24:00,18460.75,BUY,3,0.02h,Stop Loss,$-9.00,$82.50,$63186.50,48,$82.50
2024-03-07,15:26:00,18229.5,SELL,3,0.02h,Stop Loss,$4.50,$87.00,$63191.00,48,$87.00
2024-03-07,15:36:00,18478.5,BUY,3,0.02h,Stop Loss,$-9.00,$78.00,$63182.00,48,$78.00
2024-03-07,15:55:00,18242.5,SELL,3,0.02h,Stop Loss,$24.00,$102.00,$63206.00,48,$102.00
2024-03-07,16:00:00,18498.5,BUY,3,0.02h,Stop Loss,$-9.00,$93.00,$63197.00,48,$93.00
2024-03-07,16:01:00,18246.25,SELL,3,0.02h,Stop Loss,$7.50,$100.50,$63204.50,48,$100.50
2024-03-07,16:04:00,18496.75,BUY,3,0.02h,Stop Loss,$48.00,$148.50,$63252.50,48,$148.50
2024-03-07,16:08:00,18261.75,SELL,3,0.02h,Stop Loss,$-9.00,$139.50,$63243.50,48,$139.50
2024-03-07,16:09:00,18514.75,BUY,3,0.02h,Stop Loss,$-9.00,$130.50,$63234.50,48,$130.50
2024-03-07,16:22:00,18271.0,SELL,3,0.02h,Stop Loss,$-9.00,$121.50,$63225.50,48,$121.50
2024-03-07,16:30:00,18536.0,BUY,3,0.02h,Stop Loss,$-9.00,$112.50,$63216.50,48,$112.50
2024-03-07,16:32:00,18274.25,SELL,3,0.02h,Stop Loss,$-9.00,$103.50,$63207.50,48,$103.50
2024-03-07,16:33:00,18523.5,BUY,3,0.02h,Stop Loss,$-9.00,$94.50,$63198.50,48,$94.50
2024-03-07,16:34:00,18269.75,SELL,3,0.02h,Stop Loss,$-9.00,$85.50,$63189.50,48,$85.50
2024-03-07,16:35:00,18522.75,BUY,3,0.02h,Stop Loss,$-9.00,$76.50,$63180.50,48,$76.50
2024-03-07,16:37:00,18268.5,SELL,3,0.02h,Stop Loss,$-9.00,$67.50,$63171.50,48,$67.50
2024-03-07,16:38:00,18527.75,BUY,3,0.02h,Stop Loss,$-9.00,$58.50,$63162.50,48,$58.50
2024-03-07,16:40:00,18284.0,SELL,3,0.02h,Break Even,$-1.50,$57.00,$63161.00,48,$57.00
2024-03-07,16:43:00,18540.25,BUY,3,0.02h,Stop Loss,$-9.00,$48.00,$63152.00,48,$48.00
2024-03-07,16:50:00,18282.75,SELL,3,0.02h,Stop Loss,$-9.00,$39.00,$63143.00,48,$39.00
2024-03-07,16:51:00,18536.25,BUY,3,0.02h,Stop Loss,$-9.00,$30.00,$63134.00,48,$30.00
2024-03-07,16:52:00,18283.75,SELL,3,0.02h,Stop Loss,$-9.00,$21.00,$63125.00,48,$21.00
2024-03-07,16:53:00,18534.5,BUY,3,0.02h,Break Even,$-1.50,$19.50,$63123.50,48,$19.50
2024-03-07,17:01:00,18302.0,SELL,3,0.02h,Stop Loss,$6.00,$25.50,$63129.50,48,$25.50
2024-03-07,17:03:00,18546.0,BUY,3,0.02h,Stop Loss,$-9.00,$16.50,$63120.50,48,$16.50
2024-03-07,17:04:00,18298.25,SELL,3,0.02h,Stop Loss,$-9.00,$7.50,$63111.50,48,$7.50
2024-03-07,17:09:00,18551.5,BUY,3,0.02h,Stop Loss,$42.00,$49.50,$63153.50,48,$49.50
2024-03-07,17:18:00,18322.25,SELL,3,0.02h,Stop Loss,$-9.00,$40.50,$63144.50,48,$40.50
2024-03-07,17:19:00,18570.0,BUY,3,0.02h,Stop Loss,$-9.00,$31.50,$63135.50,48,$31.50
2024-03-07,17:20:00,18320.75,SELL,3,0.02h,Stop Loss,$-9.00,$22.50,$63126.50,48,$22.50
2024-03-07,17:21:00,18573.25,BUY,3,0.02h,Stop Loss,$-9.00,$13.50,$63117.50,48,$13.50
2024-03-07,17:24:00,18306.75,SELL,3,0.02h,Stop Loss,$-9.00,$4.50,$63108.50,48,$4.50
2024-03-07,17:28:00,18566.0,BUY,3,0.02h,Stop Loss,$-9.00,$-4.50,$63099.50,48,$-4.50
2024-03-07,17:29:00,18317.75,SELL,3,0.02h,Stop Loss,$43.50,$39.00,$63143.00,48,$39.00
2024-03-07,17:36:00,18559.5,BUY,3,0.02h,Stop Loss,$22.50,$61.50,$63165.50,48,$61.50
2024-03-07,17:52:00,18305.75,SELL,3,0.02h,Stop Loss,$-9.00,$52.50,$63156.50,48,$52.50
2024-03-07,17:53:00,18562.25,BUY,3,0.02h,Stop Loss,$-9.00,$43.50,$63147.50,48,$43.50
2024-03-07,17:59:00,18306.25,SELL,3,0.02h,Stop Loss,$-9.00,$34.50,$63138.50,48,$34.50
2024-03-07,18:04:00,18562.5,BUY,3,0.02h,Stop Loss,$-9.00,$25.50,$63129.50,48,$25.50
2024-03-07,18:05:00,18306.5,SELL,3,0.02h,Stop Loss,$43.50,$69.00,$63173.00,48,$69.00
2024-03-07,18:19:00,18564.0,BUY,3,0.02h,Stop Loss,$7.50,$76.50,$63180.50,48,$76.50
2024-03-07,18:23:00,18312.25,SELL,3,0.02h,Stop Loss,$-9.00,$67.50,$63171.50,48,$67.50
2024-03-07,18:28:00,18570.5,BUY,3,0.02h,Break Even,$-1.50,$66.00,$63170.00,48,$66.00
2024-03-07,18:33:00,18329.75,SELL,3,0.02h,Stop Loss,$4.50,$70.50,$63174.50,48,$70.50
2024-03-07,18:35:00,18585.0,BUY,3,0.02h,Stop Loss,$-9.00,$61.50,$63165.50,48,$61.50
2024-03-07,18:36:00,18336.25,SELL,3,0.02h,Stop Loss,$-9.00,$52.50,$63156.50,48,$52.50
2024-03-07,18:37:00,18589.5,BUY,3,0.02h,Stop Loss,$9.00,$61.50,$63165.50,48,$61.50
2024-03-07,18:44:00,18340.5,SELL,3,0.02h,Stop Loss,$-9.00,$52.50,$63156.50,48,$52.50
2024-03-07,18:45:00,18593.5,BUY,3,0.02h,Stop Loss,$-9.00,$43.50,$63147.50,48,$43.50
2024-03-07,18:52:00,18351.75,SELL,3,0.02h,Stop Loss,$-9.00,$34.50,$63138.50,48,$34.50
2024-03-07,19:07:00,18597.5,BUY,3,0.02h,Stop Loss,$-9.00,$25.50,$63129.50,48,$25.50
2024-03-07,19:08:00,18350.5,SELL,3,0.02h,Stop Loss,$-9.00,$16.50,$63120.50,48,$16.50
2024-03-07,19:09:00,18591.5,BUY,3,0.02h,Stop Loss,$-9.00,$7.50,$63111.50,48,$7.50
2024-03-07,19:10:00,18340.0,SELL,3,0.02h,Stop Loss,$-9.00,$-1.50,$63102.50,48,$-1.50
2024-03-07,19:11:00,18600.0,BUY,3,0.02h,Break Even,$-1.50,$-3.00,$63101.00,48,$-3.00
2024-03-07,19:22:00,18341.25,SELL,3,0.02h,Stop Loss,$-9.00,$-12.00,$63092.00,48,$-12.00
2024-03-07,19:23:00,18593.5,BUY,3,0.02h,Stop Loss,$-9.00,$-21.00,$63083.00,48,$-21.00
2024-03-07,19:24:00,18336.0,SELL,3,0.02h,Stop Loss,$-9.00,$-30.00,$63074.00,48,$-30.00
2024-03-07,19:26:00,18588.5,BUY,3,0.02h,Break Even,$-1.50,$-31.50,$63072.50,48,$-31.50
2024-03-07,19:28:00,18341.75,SELL,3,0.02h,Stop Loss,$16.50,$-15.00,$63089.00,48,$-15.00
2024-03-07,19:49:00,18597.5,BUY,3,0.02h,Stop Loss,$22.50,$7.50,$63111.50,48,$7.50
2024-03-07,19:58:00,18335.75,SELL,3,0.02h,Stop Loss,$-9.00,$-1.50,$63102.50,48,$-1.50
2024-03-07,19:59:00,18578.0,BUY,3,0.02h,Break Even,$-1.50,$-3.00,$63101.00,48,$-3.00
2024-03-07,20:05:00,18313.25,SELL,3,0.02h,Stop Loss,$33.00,$30.00,$63134.00,48,$30.00
2024-03-07,20:07:00,18571.25,BUY,3,0.02h,Stop Loss,$-9.00,$21.00,$63125.00,48,$21.00
2024-03-07,20:16:00,18314.0,SELL,3,0.02h,Break Even,$-1.50,$19.50,$63123.50,48,$19.50
2024-03-07,20:21:00,18554.25,BUY,3,0.02h,Break Even,$-1.50,$18.00,$63122.00,48,$18.00
2024-03-07,20:29:00,18303.25,SELL,3,0.02h,Stop Loss,$-9.00,$9.00,$63113.00,48,$9.00
2024-03-07,20:30:00,18554.0,BUY,3,0.02h,Stop Loss,$-9.00,$0.00,$63104.00,48,$0.00
2024-03-07,20:31:00,18307.5,SELL,3,0.02h,Break Even,$-1.50,$-1.50,$63102.50,48,$-1.50
2024-03-07,20:36:00,18563.75,BUY,3,0.02h,Stop Loss,$-9.00,$-10.50,$63093.50,48,$-10.50
2024-03-07,20:37:00,18314.75,SELL,3,0.02h,Stop Loss,$4.50,$-6.00,$63098.00,48,$-6.00
2024-03-07,20:41:00,18573.75,BUY,3,0.02h,Stop Loss,$6.00,$0.00,$63104.00,48,$0.00
2024-03-07,20:53:00,18321.0,SELL,3,0.02h,Stop Loss,$13.50,$13.50,$63117.50,48,$13.50
2024-03-07,21:04:00,18536.75,BUY,3,0.02h,Stop Loss,$-9.00,$4.50,$63108.50,48,$4.50
2024-03-07,21:05:00,18292.75,SELL,3,0.02h,Stop Loss,$-9.00,$-4.50,$63099.50,48,$-4.50
2024-03-07,21:07:00,18518.0,BUY,3,0.02h,Stop Loss,$-9.00,$-13.50,$63090.50,48,$-13.50
2024-03-07,21:08:00,18268.75,SELL,3,0.02h,Stop Loss,$-9.00,$-22.50,$63081.50,48,$-22.50
2024-03-07,21:20:00,18466.75,BUY,3,0.02h,Stop Loss,$-9.00,$-31.50,$63072.50,48,$-31.50
2024-03-07,21:21:00,18224.0,SELL,3,0.02h,Stop Loss,$10.50,$-21.00,$63083.00,48,$-21.00
2024-03-07,21:28:00,18467.5,BUY,3,0.02h,Stop Loss,$67.50,$46.50,$63150.50,48,$46.50
2024-03-07,21:35:00,18217.25,SELL,3,0.02h,Stop Loss,$46.50,$93.00,$63197.00,48,$93.00
2024-03-07,21:38:00,18491.0,BUY,3,0.02h,Stop Loss,$-9.00,$84.00,$63188.00,48,$84.00
2024-03-07,21:39:00,18240.5,SELL,3,0.02h,Stop Loss,$-9.00,$75.00,$63179.00,48,$75.00
2024-03-07,21:40:00,18496.5,BUY,3,0.02h,Stop Loss,$-9.00,$66.00,$63170.00,48,$66.00
2024-03-07,21:43:00,18244.0,SELL,3,0.02h,Stop Loss,$40.50,$106.50,$63210.50,48,$106.50
2024-03-07,21:54:00,18507.0,BUY,3,0.02h,Break Even,$-1.50,$105.00,$63209.00,48,$105.00
,,,,,,,,,,,
2024-03-08,12:11:00,18293.0,SELL,3,0.02h,Break Even,$-1.50,$-1.50,$63207.50,49,$-1.50
2024-03-08,12:25:00,18530.0,BUY,3,0.02h,Stop Loss,$-9.00,$-10.50,$63198.50,49,$-10.50
2024-03-08,12:27:00,18278.0,SELL,3,0.02h,Break Even,$-1.50,$-12.00,$63197.00,49,$-12.00
2024-03-08,12:36:00,18529.25,BUY,3,0.02h,Stop Loss,$-9.00,$-21.00,$63188.00,49,$-21.00
2024-03-08,12:37:00,18274.5,SELL,3,0.02h,Stop Loss,$-9.00,$-30.00,$63179.00,49,$-30.00
2024-03-08,12:38:00,18522.0,BUY,3,0.02h,Stop Loss,$-9.00,$-39.00,$63170.00,49,$-39.00
2024-03-08,12:47:00,18261.5,SELL,3,0.02h,Stop Loss,$-9.00,$-48.00,$63161.00,49,$-48.00
2024-03-08,12:48:00,18520.25,BUY,3,0.02h,Break Even,$-1.50,$-49.50,$63159.50,49,$-49.50
2024-03-08,12:51:00,18260.75,SELL,3,0.02h,Stop Loss,$-9.00,$-58.50,$63150.50,49,$-58.50
2024-03-08,12:52:00,18510.5,BUY,3,0.02h,Stop Loss,$-9.00,$-67.50,$63141.50,49,$-67.50
2024-03-08,12:53:00,18254.75,SELL,3,0.02h,Stop Loss,$-9.00,$-76.50,$63132.50,49,$-76.50
2024-03-08,12:55:00,18516.25,BUY,3,0.02h,Stop Loss,$-9.00,$-85.50,$63123.50,49,$-85.50
2024-03-08,12:56:00,18262.75,SELL,3,0.02h,Stop Loss,$-9.00,$-94.50,$63114.50,49,$-94.50
2024-03-08,12:57:00,18516.25,BUY,3,0.02h,Stop Loss,$-9.00,$-103.50,$63105.50,49,$-103.50
2024-03-08,12:58:00,18267.75,SELL,3,0.02h,Break Even,$-1.50,$-105.00,$63104.00,49,$-105.00
2024-03-08,13:01:00,18523.25,BUY,3,0.02h,Stop Loss,$24.00,$-81.00,$63128.00,49,$-81.00
2024-03-08,13:18:00,18291.0,SELL,3,0.02h,Stop Loss,$-9.00,$-90.00,$63119.00,49,$-90.00
2024-03-08,13:19:00,18542.5,BUY,3,0.02h,Stop Loss,$-9.00,$-99.00,$63110.00,49,$-99.00
2024-03-08,13:20:00,18287.25,SELL,3,0.02h,Stop Loss,$21.00,$-78.00,$63131.00,49,$-78.00
2024-03-08,13:23:00,18544.5,BUY,3,0.02h,Stop Loss,$19.50,$-58.50,$63150.50,49,$-58.50
2024-03-08,13:29:00,18283.75,SELL,3,0.02h,Stop Loss,$151.50,$93.00,$63302.00,49,$93.00
2024-03-08,13:32:00,18621.0,BUY,3,0.02h,Stop Loss,$-9.00,$84.00,$63293.00,49,$84.00
2024-03-08,13:33:00,18342.25,SELL,3,0.02h,Stop Loss,$-9.00,$75.00,$63284.00,49,$75.00
2024-03-08,13:34:00,18587.5,BUY,3,0.02h,Stop Loss,$-9.00,$66.00,$63275.00,49,$66.00
2024-03-08,13:35:00,18317.75,SELL,3,0.02h,Stop Loss,$-9.00,$57.00,$63266.00,49,$57.00
2024-03-08,13:36:00,18581.25,BUY,3,0.02h,Stop Loss,$10.50,$67.50,$63276.50,49,$67.50
2024-03-08,13:43:00,18348.5,SELL,3,0.02h,Stop Loss,$-9.00,$58.50,$63267.50,49,$58.50
2024-03-08,13:44:00,18599.25,BUY,3,0.02h,Stop Loss,$19.50,$78.00,$63287.00,49,$78.00
2024-03-08,13:47:00,18364.25,SELL,3,0.02h,Stop Loss,$9.00,$87.00,$63296.00,49,$87.00
2024-03-08,13:50:00,18597.75,BUY,3,0.02h,Stop Loss,$-9.00,$78.00,$63287.00,49,$78.00
2024-03-08,13:56:00,18364.5,SELL,3,0.02h,Stop Loss,$16.50,$94.50,$63303.50,49,$94.50
2024-03-08,14:00:00,18604.75,BUY,3,0.02h,Stop Loss,$31.50,$126.00,$63335.00,49,$126.00
2024-03-08,14:09:00,18340.75,SELL,3,0.02h,Stop Loss,$22.50,$148.50,$63357.50,49,$148.50
2024-03-08,14:16:00,18577.25,BUY,3,0.02h,Break Even,$-1.50,$147.00,$63356.00,49,$147.00
2024-03-08,14:18:00,18330.5,SELL,3,0.02h,Stop Loss,$-9.00,$138.00,$63347.00,49,$138.00
2024-03-08,14:19:00,18576.0,BUY,3,0.02h,Stop Loss,$10.50,$148.50,$63357.50,49,$148.50
2024-03-08,14:21:00,18331.5,SELL,3,0.02h,Stop Loss,$-9.00,$139.50,$63348.50,49,$139.50
2024-03-08,14:22:00,18585.25,BUY,3,0.02h,Break Even,$-1.50,$138.00,$63347.00,49,$138.00
2024-03-08,14:31:00,18311.5,SELL,3,0.02h,Stop Loss,$-9.00,$129.00,$63338.00,49,$129.00
2024-03-08,14:32:00,18572.5,BUY,3,0.02h,Stop Loss,$-9.00,$120.00,$63329.00,49,$120.00
2024-03-08,14:33:00,18323.75,SELL,3,0.02h,Stop Loss,$30.00,$150.00,$63359.00,49,$150.00
2024-03-08,14:39:00,18561.25,BUY,3,0.02h,Stop Loss,$-9.00,$141.00,$63350.00,49,$141.00
2024-03-08,14:40:00,18300.0,SELL,3,0.02h,Stop Loss,$-9.00,$132.00,$63341.00,49,$132.00
2024-03-08,14:42:00,18572.25,BUY,3,0.02h,Stop Loss,$-9.00,$123.00,$63332.00,49,$123.00
2024-03-08,14:43:00,18318.75,SELL,3,0.02h,Stop Loss,$-9.00,$114.00,$63323.00,49,$114.00
2024-03-08,14:54:00,18619.0,BUY,3,0.02h,Stop Loss,$30.00,$144.00,$63353.00,49,$144.00
2024-03-08,15:03:00,18386.0,SELL,3,0.02h,Stop Loss,$4.50,$148.50,$63357.50,49,$148.50
2024-03-08,15:08:00,18664.5,BUY,3,0.02h,Stop Loss,$-9.00,$139.50,$63348.50,49,$139.50
2024-03-08,15:09:00,18411.25,SELL,3,0.02h,Stop Loss,$7.50,$147.00,$63356.00,49,$147.00
2024-03-08,15:12:00,18665.0,BUY,3,0.02h,Stop Loss,$-9.00,$138.00,$63347.00,49,$138.00
2024-03-08,15:17:00,18416.5,SELL,3,0.02h,Stop Loss,$-9.00,$129.00,$63338.00,49,$129.00
2024-03-08,15:18:00,18675.25,BUY,3,0.02h,Stop Loss,$-9.00,$120.00,$63329.00,49,$120.00
2024-03-08,15:25:00,18408.25,SELL,3,0.02h,Stop Loss,$-9.00,$111.00,$63320.00,49,$111.00
2024-03-08,15:29:00,18676.5,BUY,3,0.02h,Stop Loss,$54.00,$165.00,$63374.00,49,$165.00
2024-03-08,15:39:00,18383.25,SELL,3,0.02h,Stop Loss,$-9.00,$156.00,$63365.00,49,$156.00
2024-03-08,15:40:00,18633.5,BUY,3,0.02h,Stop Loss,$-9.00,$147.00,$63356.00,49,$147.00
2024-03-08,15:41:00,18380.0,SELL,3,0.02h,Stop Loss,$-9.00,$138.00,$63347.00,49,$138.00
2024-03-08,15:59:00,18649.75,BUY,3,0.02h,Stop Loss,$-9.00,$129.00,$63338.00,49,$129.00
2024-03-08,16:00:00,18380.5,SELL,3,0.02h,Stop Loss,$127.50,$256.50,$63465.50,49,$256.50
2024-03-08,16:02:00,18611.0,BUY,3,0.02h,Stop Loss,$-9.00,$247.50,$63456.50,49,$247.50
2024-03-08,16:03:00,18334.0,SELL,3,0.02h,Stop Loss,$133.50,$381.00,$63590.00,49,$381.00
2024-03-08,16:16:00,18519.5,BUY,3,0.02h,Stop Loss,$46.50,$427.50,$63636.50,49,$427.50
2024-03-08,16:18:00,18244.0,SELL,3,0.02h,Stop Loss,$43.50,$471.00,$63680.00,49,$471.00
2024-03-08,16:30:00,18451.0,BUY,3,0.02h,Stop Loss,$40.50,$511.50,$63720.50,49,$511.50
2024-03-08,16:35:00,18206.25,SELL,3,0.02h,Stop Loss,$6.00,$517.50,$63726.50,49,$517.50
2024-03-08,16:42:00,18461.5,BUY,3,0.02h,Stop Loss,$73.50,$591.00,$63800.00,49,$591.00
2024-03-08,16:48:00,18170.25,SELL,3,0.02h,Stop Loss,$-9.00,$582.00,$63791.00,49,$582.00
2024-03-08,16:49:00,18431.0,BUY,3,0.02h,Stop Loss,$34.50,$616.50,$63825.50,49,$616.50
2024-03-08,16:51:00,18198.75,SELL,3,0.02h,Stop Loss,$15.00,$631.50,$63840.50,49,$631.50
2024-03-08,17:07:00,18443.25,BUY,3,0.02h,Stop Loss,$-9.00,$622.50,$63831.50,49,$622.50
2024-03-08,17:08:00,18193.25,SELL,3,0.02h,Stop Loss,$-9.00,$613.50,$63822.50,49,$613.50
2024-03-08,17:09:00,18420.5,BUY,3,0.02h,Stop Loss,$-9.00,$604.50,$63813.50,49,$604.50
2024-03-08,17:10:00,18151.25,SELL,3,0.02h,Stop Loss,$118.50,$723.00,$63932.00,49,$723.00
2024-03-08,17:13:00,18414.5,BUY,3,0.02h,Stop Loss,$-9.00,$714.00,$63923.00,49,$714.00
2024-03-08,17:14:00,18183.0,SELL,3,0.02h,Stop Loss,$-9.00,$705.00,$63914.00,49,$705.00
2024-03-08,17:15:00,18424.5,BUY,3,0.02h,Stop Loss,$-9.00,$696.00,$63905.00,49,$696.00
2024-03-08,17:16:00,18165.75,SELL,3,0.02h,Stop Loss,$19.50,$715.50,$63924.50,49,$715.50
2024-03-08,17:19:00,18403.75,BUY,3,0.02h,Stop Loss,$-9.00,$706.50,$63915.50,49,$706.50
2024-03-08,17:20:00,18141.5,SELL,3,0.02h,Stop Loss,$-9.00,$697.50,$63906.50,49,$697.50
2024-03-08,17:21:00,18411.75,BUY,3,0.02h,Stop Loss,$3.00,$700.50,$63909.50,49,$700.50
2024-03-08,17:28:00,18180.75,SELL,3,0.02h,Stop Loss,$-9.00,$691.50,$63900.50,49,$691.50
2024-03-08,17:31:00,18437.75,BUY,3,0.02h,Stop Loss,$45.00,$736.50,$63945.50,49,$736.50
2024-03-08,17:40:00,18176.5,SELL,3,0.02h,Stop Loss,$33.00,$769.50,$63978.50,49,$769.50
2024-03-08,18:00:00,18314.5,BUY,3,0.02h,Break Even,$-1.50,$768.00,$63977.00,49,$768.00
2024-03-08,18:03:00,18070.0,SELL,3,0.02h,Stop Loss,$-9.00,$759.00,$63968.00,49,$759.00
2024-03-08,18:20:00,18327.25,BUY,3,0.02h,Stop Loss,$-9.00,$750.00,$63959.00,49,$750.00
2024-03-08,18:21:00,18078.5,SELL,3,0.02h,Stop Loss,$55.50,$805.50,$64014.50,49,$805.50
2024-03-08,18:29:00,18310.5,BUY,3,0.02h,Break Even,$-1.50,$804.00,$64013.00,49,$804.00
2024-03-08,18:35:00,18034.25,SELL,3,0.02h,Break Even,$-1.50,$802.50,$64011.50,49,$802.50
2024-03-08,18:47:00,18285.5,BUY,3,0.02h,Stop Loss,$-9.00,$793.50,$64002.50,49,$793.50
2024-03-08,18:48:00,18036.5,SELL,3,0.02h,Stop Loss,$10.50,$804.00,$64013.00,49,$804.00
2024-03-08,18:52:00,18282.0,BUY,3,0.02h,Stop Loss,$22.50,$826.50,$64035.50,49,$826.50
2024-03-08,19:00:00,18046.0,SELL,3,0.02h,Stop Loss,$18.00,$844.50,$64053.50,49,$844.50
2024-03-08,19:02:00,18311.25,BUY,3,0.02h,Stop Loss,$-9.00,$835.50,$64044.50,49,$835.50
2024-03-08,19:03:00,18074.5,SELL,3,0.02h,Stop Loss,$-9.00,$826.50,$64035.50,49,$826.50
2024-03-08,19:04:00,18337.0,BUY,3,0.02h,Stop Loss,$-9.00,$817.50,$64026.50,49,$817.50
2024-03-08,19:06:00,18077.25,SELL,3,0.02h,Break Even,$-1.50,$816.00,$64025.00,49,$816.00
2024-03-08,19:09:00,18339.25,BUY,3,0.02h,Stop Loss,$24.00,$840.00,$64049.00,49,$840.00
2024-03-08,19:16:00,18085.75,SELL,3,0.02h,Stop Loss,$19.50,$859.50,$64068.50,49,$859.50
2024-03-08,19:19:00,18344.25,BUY,3,0.02h,Stop Loss,$-9.00,$850.50,$64059.50,49,$850.50
2024-03-08,19:20:00,18091.25,SELL,3,0.02h,Stop Loss,$-9.00,$841.50,$64050.50,49,$841.50
2024-03-08,19:21:00,18354.0,BUY,3,0.02h,Stop Loss,$-9.00,$832.50,$64041.50,49,$832.50
2024-03-08,19:23:00,18119.25,SELL,3,0.02h,Stop Loss,$19.50,$852.00,$64061.00,49,$852.00
2024-03-08,19:29:00,18372.0,BUY,3,0.02h,Stop Loss,$6.00,$858.00,$64067.00,49,$858.00
2024-03-08,19:43:00,18161.0,SELL,3,0.02h,Break Even,$-1.50,$856.50,$64065.50,49,$856.50
2024-03-08,19:45:00,18420.75,BUY,3,0.02h,Stop Loss,$4.50,$861.00,$64070.00,49,$861.00
2024-03-08,19:57:00,18140.75,SELL,3,0.02h,Stop Loss,$-9.00,$852.00,$64061.00,49,$852.00
2024-03-08,19:58:00,18387.75,BUY,3,0.02h,Stop Loss,$-9.00,$843.00,$64052.00,49,$843.00
2024-03-08,19:59:00,18146.25,SELL,3,0.02h,Stop Loss,$-9.00,$834.00,$64043.00,49,$834.00
2024-03-08,20:00:00,18393.25,BUY,3,0.02h,Stop Loss,$90.00,$924.00,$64133.00,49,$924.00
2024-03-08,20:04:00,18164.5,SELL,3,0.02h,Stop Loss,$27.00,$951.00,$64160.00,49,$951.00
2024-03-08,20:07:00,18378.25,BUY,3,0.02h,Stop Loss,$-9.00,$942.00,$64151.00,49,$942.00
2024-03-08,20:08:00,18131.75,SELL,3,0.02h,Stop Loss,$-9.00,$933.00,$64142.00,49,$933.00
2024-03-08,20:09:00,18384.0,BUY,3,0.02h,Stop Loss,$-9.00,$924.00,$64133.00,49,$924.00
2024-03-08,20:12:00,18106.75,SELL,3,0.02h,Stop Loss,$-9.00,$915.00,$64124.00,49,$915.00
2024-03-08,20:13:00,18363.5,BUY,3,0.02h,Stop Loss,$-9.00,$906.00,$64115.00,49,$906.00
2024-03-08,20:14:00,18107.25,SELL,3,0.02h,Stop Loss,$6.00,$912.00,$64121.00,49,$912.00
2024-03-08,20:19:00,18345.5,BUY,3,0.02h,Stop Loss,$-9.00,$903.00,$64112.00,49,$903.00
2024-03-08,20:20:00,18094.25,SELL,3,0.02h,Stop Loss,$48.00,$951.00,$64160.00,49,$951.00
2024-03-08,20:25:00,18353.25,BUY,3,0.02h,Stop Loss,$48.00,$999.00,$64208.00,49,$999.00
2024-03-08,20:28:00,18089.5,SELL,3,0.02h,Stop Loss,$169.50,$1168.50,$64377.50,49,$1168.50
2024-03-08,20:34:00,18331.0,BUY,3,0.02h,Stop Loss,$-9.00,$1159.50,$64368.50,49,$1159.50
2024-03-08,20:35:00,18079.25,SELL,3,0.02h,Stop Loss,$40.50,$1200.00,$64409.00,49,$1200.00
2024-03-08,20:42:00,18304.5,BUY,3,0.02h,Stop Loss,$9.00,$1209.00,$64418.00,49,$1209.00
2024-03-08,20:44:00,18064.25,SELL,3,0.02h,Stop Loss,$-9.00,$1200.00,$64409.00,49,$1200.00
2024-03-08,20:45:00,18304.5,BUY,3,0.02h,Stop Loss,$-9.00,$1191.00,$64400.00,49,$1191.00
2024-03-08,20:46:00,18066.5,SELL,3,0.02h,Stop Loss,$13.50,$1204.50,$64413.50,49,$1204.50
2024-03-08,20:50:00,18318.25,BUY,3,0.02h,Stop Loss,$46.50,$1251.00,$64460.00,49,$1251.00
2024-03-08,20:52:00,18060.75,SELL,3,0.02h,Stop Loss,$-9.00,$1242.00,$64451.00,49,$1242.00
2024-03-08,20:53:00,18304.75,BUY,3,0.02h,Stop Loss,$-9.00,$1233.00,$64442.00,49,$1233.00
2024-03-08,20:54:00,18054.25,SELL,3,0.02h,Stop Loss,$-9.00,$1224.00,$64433.00,49,$1224.00
2024-03-08,20:55:00,18316.75,BUY,3,0.02h,Stop Loss,$-9.00,$1215.00,$64424.00,49,$1215.00
2024-03-08,20:56:00,18049.5,SELL,3,0.02h,Stop Loss,$-9.00,$1206.00,$64415.00,49,$1206.00
2024-03-08,21:06:00,18320.25,BUY,3,0.02h,Stop Loss,$-9.00,$1197.00,$64406.00,49,$1197.00
2024-03-08,21:12:00,18065.5,SELL,3,0.02h,Stop Loss,$-9.00,$1188.00,$64397.00,49,$1188.00
2024-03-08,21:13:00,18315.25,BUY,3,0.02h,Stop Loss,$-9.00,$1179.00,$64388.00,49,$1179.00
2024-03-08,21:14:00,18066.5,SELL,3,0.02h,Stop Loss,$63.00,$1242.00,$64451.00,49,$1242.00
2024-03-08,21:37:00,18305.5,BUY,3,0.02h,Stop Loss,$-9.00,$1233.00,$64442.00,49,$1233.00
2024-03-08,21:38:00,18054.0,SELL,3,0.02h,Stop Loss,$-9.00,$1224.00,$64433.00,49,$1224.00
2024-03-08,21:41:00,18304.0,BUY,3,0.02h,Stop Loss,$-9.00,$1215.00,$64424.00,49,$1215.00
2024-03-08,21:43:00,18053.25,SELL,3,0.03h,Stop Loss,$-9.00,$1206.00,$64415.00,49,$1206.00
2024-03-08,21:45:00,18303.0,BUY,3,0.02h,Break Even,$-1.50,$1204.50,$64413.50,49,$1204.50
2024-03-08,21:56:00,18055.5,SELL,3,0.02h,Stop Loss,$-9.00,$1195.50,$64404.50,49,$1195.50
2024-03-08,21:57:00,18304.0,BUY,3,0.02h,Stop Loss,$-9.00,$1186.50,$64395.50,49,$1186.50
2024-03-08,21:58:00,18053.5,SELL,3,0.02h,Stop Loss,$-9.00,$1177.50,$64386.50,49,$1177.50
2024-03-08,21:59:00,18303.75,BUY,3,0.02h,Stop Loss,$-9.00,$1168.50,$64377.50,49,$1168.50
2024-03-08,22:00:00,18055.25,SELL,3,62.00h,Stop Loss,$-9.00,$1159.50,$64368.50,49,$1159.50
,,,,,,,,,,,
2024-03-11,12:00:00,18235.25,BUY,3,0.02h,Stop Loss,$-9.00,$-9.00,$64359.50,50,$-9.00
2024-03-11,12:17:00,18186.5,SELL,3,0.02h,Stop Loss,$13.50,$4.50,$64373.00,50,$4.50
2024-03-11,12:20:00,18201.0,BUY,3,0.02h,Stop Loss,$55.50,$60.00,$64428.50,50,$60.00
2024-03-11,12:44:00,18190.25,SELL,3,0.02h,Stop Loss,$40.50,$100.50,$64469.00,50,$100.50
2024-03-11,12:55:00,18201.0,BUY,3,0.02h,Break Even,$-1.50,$99.00,$64467.50,50,$99.00
2024-03-11,13:32:00,18185.25,SELL,3,0.02h,Stop Loss,$118.50,$217.50,$64586.00,50,$217.50
2024-03-11,13:41:00,18229.0,BUY,3,0.02h,Stop Loss,$90.00,$307.50,$64676.00,50,$307.50
2024-03-11,13:53:00,18202.5,SELL,3,0.02h,Stop Loss,$84.00,$391.50,$64760.00,50,$391.50
2024-03-11,14:21:00,18169.25,BUY,3,0.02h,Break Even,$-1.50,$390.00,$64758.50,50,$390.00
2024-03-11,14:22:00,18162.25,SELL,3,0.02h,Stop Loss,$27.00,$417.00,$64785.50,50,$417.00
2024-03-11,14:30:00,18175.25,BUY,3,0.02h,Stop Loss,$154.50,$571.50,$64940.00,50,$571.50
2024-03-11,15:11:00,18214.0,SELL,3,0.02h,Stop Loss,$144.00,$715.50,$65084.00,50,$715.50
2024-03-11,15:46:00,18200.25,BUY,3,0.02h,Stop Loss,$84.00,$799.50,$65168.00,50,$799.50
2024-03-11,16:10:00,18213.25,SELL,3,0.02h,Stop Loss,$51.00,$850.50,$65219.00,50,$850.50
2024-03-11,16:19:00,18231.5,BUY,3,0.02h,Break Even,$-1.50,$849.00,$65217.50,50,$849.00
2024-03-11,16:47:00,18220.25,SELL,3,0.02h,Stop Loss,$12.00,$861.00,$65229.50,50,$861.00
2024-03-11,16:55:00,18234.0,BUY,3,0.02h,Break Even,$-1.50,$859.50,$65228.00,50,$859.50
2024-03-11,17:05:00,18225.5,SELL,3,0.02h,Stop Loss,$-9.00,$850.50,$65219.00,50,$850.50
2024-03-11,17:24:00,18231.0,BUY,3,0.02h,Break Even,$-1.50,$849.00,$65217.50,50,$849.00
2024-03-11,17:41:00,18223.75,SELL,3,0.02h,Stop Loss,$109.50,$958.50,$65327.00,50,$958.50
2024-03-11,17:59:00,18218.75,BUY,3,0.02h,Stop Loss,$15.00,$973.50,$65342.00,50,$973.50
2024-03-11,18:37:00,18223.75,SELL,3,0.02h,Stop Loss,$-9.00,$964.50,$65333.00,50,$964.50
2024-03-11,18:43:00,18239.5,BUY,3,0.02h,Break Even,$-1.50,$963.00,$65331.50,50,$963.00
2024-03-11,19:02:00,18231.0,SELL,3,0.02h,Break Even,$-1.50,$961.50,$65330.00,50,$961.50
2024-03-11,19:43:00,18223.75,BUY,3,0.02h,Stop Loss,$19.50,$981.00,$65349.50,50,$981.00
2024-03-11,19:51:00,18209.5,SELL,3,0.02h,Stop Loss,$39.00,$1020.00,$65388.50,50,$1020.00
2024-03-11,20:01:00,18225.25,BUY,3,0.02h,Stop Loss,$9.00,$1029.00,$65397.50,50,$1029.00
2024-03-11,22:39:00,18275.0,SELL,3,0.02h,Stop Loss,$-9.00,$1020.00,$65388.50,50,$1020.00
2024-03-11,22:41:00,18281.0,BUY,3,0.02h,Stop Loss,$3.00,$1023.00,$65391.50,50,$1023.00
2024-03-11,22:54:00,18278.25,SELL,3,0.02h,Break Even,$-1.50,$1021.50,$65390.00,50,$1021.50
,,,,,,,,,,,
2024-03-12,12:20:00,18295.5,BUY,3,0.02h,Stop Loss,$30.00,$30.00,$65420.00,51,$30.00
2024-03-12,12:26:00,18051.75,SELL,3,0.02h,Stop Loss,$-9.00,$21.00,$65411.00,51,$21.00
2024-03-12,12:28:00,18300.5,BUY,3,0.02h,Stop Loss,$-9.00,$12.00,$65402.00,51,$12.00
2024-03-12,12:45:00,18109.0,SELL,3,0.02h,Stop Loss,$-9.00,$3.00,$65393.00,51,$3.00
2024-03-12,12:46:00,18375.0,BUY,3,0.02h,Break Even,$-1.50,$1.50,$65391.50,51,$1.50
2024-03-12,12:59:00,18075.75,SELL,3,0.02h,Stop Loss,$49.50,$51.00,$65441.00,51,$51.00
2024-03-12,13:16:00,18280.25,BUY,3,0.02h,Stop Loss,$-9.00,$42.00,$65432.00,51,$42.00
2024-03-12,13:17:00,18045.5,SELL,3,0.02h,Stop Loss,$-9.00,$33.00,$65423.00,51,$33.00
2024-03-12,13:18:00,18292.75,BUY,3,0.02h,Break Even,$-1.50,$31.50,$65421.50,51,$31.50
2024-03-12,13:25:00,18047.0,SELL,3,0.02h,Stop Loss,$-9.00,$22.50,$65412.50,51,$22.50
2024-03-12,13:28:00,18300.5,BUY,3,0.02h,Stop Loss,$-9.00,$13.50,$65403.50,51,$13.50
2024-03-12,13:29:00,18062.5,SELL,3,0.02h,Stop Loss,$-9.00,$4.50,$65394.50,51,$4.50
2024-03-12,13:30:00,18311.5,BUY,3,0.02h,Stop Loss,$144.00,$148.50,$65538.50,51,$148.50
2024-03-12,13:37:00,17997.25,SELL,3,0.02h,Stop Loss,$97.50,$246.00,$65636.00,51,$246.00
2024-03-12,13:57:00,18269.75,BUY,3,0.02h,Break Even,$-1.50,$244.50,$65634.50,51,$244.50
2024-03-12,14:12:00,18069.75,SELL,3,0.02h,Stop Loss,$-9.00,$235.50,$65625.50,51,$235.50
2024-03-12,14:13:00,18314.5,BUY,3,0.02h,Stop Loss,$-9.00,$226.50,$65616.50,51,$226.50
2024-03-12,14:16:00,18075.75,SELL,3,0.02h,Stop Loss,$46.50,$273.00,$65663.00,51,$273.00
2024-03-12,14:24:00,18344.75,BUY,3,0.02h,Stop Loss,$58.50,$331.50,$65721.50,51,$331.50
2024-03-12,14:43:00,18152.5,SELL,3,0.02h,Stop Loss,$10.50,$342.00,$65732.00,51,$342.00
2024-03-12,14:45:00,18407.5,BUY,3,0.02h,Stop Loss,$-9.00,$333.00,$65723.00,51,$333.00
2024-03-12,14:46:00,18159.5,SELL,3,0.02h,Stop Loss,$15.00,$348.00,$65738.00,51,$348.00
2024-03-12,14:51:00,18425.0,BUY,3,0.02h,Stop Loss,$90.00,$438.00,$65828.00,51,$438.00
2024-03-12,15:02:00,18168.5,SELL,3,0.02h,Stop Loss,$16.50,$454.50,$65844.50,51,$454.50
2024-03-12,15:04:00,18422.5,BUY,3,0.02h,Stop Loss,$-9.00,$445.50,$65835.50,51,$445.50
2024-03-12,15:05:00,18157.25,SELL,3,0.02h,Stop Loss,$-9.00,$436.50,$65826.50,51,$436.50
2024-03-12,15:06:00,18405.5,BUY,3,0.02h,Stop Loss,$30.00,$466.50,$65856.50,51,$466.50
2024-03-12,15:08:00,18172.5,SELL,3,0.02h,Stop Loss,$-9.00,$457.50,$65847.50,51,$457.50
2024-03-12,15:09:00,18431.0,BUY,3,0.02h,Stop Loss,$-9.00,$448.50,$65838.50,51,$448.50
2024-03-12,15:10:00,18177.0,SELL,3,0.02h,Stop Loss,$-9.00,$439.50,$65829.50,51,$439.50
2024-03-12,15:12:00,18435.0,BUY,3,0.02h,Break Even,$-1.50,$438.00,$65828.00,51,$438.00
2024-03-12,15:16:00,18190.5,SELL,3,0.02h,Break Even,$-1.50,$436.50,$65826.50,51,$436.50
2024-03-12,15:20:00,18436.75,BUY,3,0.02h,Stop Loss,$-9.00,$427.50,$65817.50,51,$427.50
2024-03-12,15:21:00,18189.0,SELL,3,0.02h,Stop Loss,$30.00,$457.50,$65847.50,51,$457.50
2024-03-12,15:23:00,18437.75,BUY,3,0.02h,Stop Loss,$72.00,$529.50,$65919.50,51,$529.50
2024-03-12,15:26:00,18202.0,SELL,3,0.02h,Break Even,$-1.50,$528.00,$65918.00,51,$528.00
2024-03-12,15:35:00,18447.5,BUY,3,0.02h,Stop Loss,$-9.00,$519.00,$65909.00,51,$519.00
2024-03-12,15:42:00,18159.25,SELL,3,0.02h,Stop Loss,$-9.00,$510.00,$65900.00,51,$510.00
2024-03-12,15:43:00,18405.5,BUY,3,0.02h,Stop Loss,$-9.00,$501.00,$65891.00,51,$501.00
2024-03-12,15:44:00,18161.5,SELL,3,0.02h,Break Even,$-1.50,$499.50,$65889.50,51,$499.50
2024-03-12,15:47:00,18390.0,BUY,3,0.02h,Stop Loss,$105.00,$604.50,$65994.50,51,$604.50
2024-03-12,15:53:00,18175.25,SELL,3,0.02h,Break Even,$-1.50,$603.00,$65993.00,51,$603.00
2024-03-12,16:03:00,18391.75,BUY,3,0.02h,Stop Loss,$-9.00,$594.00,$65984.00,51,$594.00
2024-03-12,16:04:00,18147.25,SELL,3,0.02h,Stop Loss,$28.50,$622.50,$66012.50,51,$622.50
2024-03-12,16:12:00,18396.0,BUY,3,0.02h,Stop Loss,$-9.00,$613.50,$66003.50,51,$613.50
2024-03-12,16:13:00,18157.0,SELL,3,0.02h,Stop Loss,$-9.00,$604.50,$65994.50,51,$604.50
2024-03-12,16:22:00,18392.5,BUY,3,0.02h,Stop Loss,$-9.00,$595.50,$65985.50,51,$595.50
2024-03-12,16:23:00,18140.25,SELL,3,0.02h,Stop Loss,$-9.00,$586.50,$65976.50,51,$586.50
2024-03-12,16:24:00,18382.0,BUY,3,0.02h,Break Even,$-1.50,$585.00,$65975.00,51,$585.00
2024-03-12,16:28:00,18131.75,SELL,3,0.02h,Stop Loss,$-9.00,$576.00,$65966.00,51,$576.00
2024-03-12,16:29:00,18385.5,BUY,3,0.02h,Stop Loss,$-9.00,$567.00,$65957.00,51,$567.00
2024-03-12,16:32:00,18133.0,SELL,3,0.02h,Break Even,$-1.50,$565.50,$65955.50,51,$565.50
2024-03-12,16:45:00,18354.25,BUY,3,0.02h,Stop Loss,$-9.00,$556.50,$65946.50,51,$556.50
2024-03-12,16:49:00,18093.5,SELL,3,0.02h,Break Even,$-1.50,$555.00,$65945.00,51,$555.00
2024-03-12,16:51:00,18347.5,BUY,3,0.02h,Stop Loss,$54.00,$609.00,$65999.00,51,$609.00
2024-03-12,16:54:00,18104.75,SELL,3,0.02h,Stop Loss,$-9.00,$600.00,$65990.00,51,$600.00
2024-03-12,16:55:00,18358.75,BUY,3,0.02h,Stop Loss,$-9.00,$591.00,$65981.00,51,$591.00
2024-03-12,16:56:00,18114.5,SELL,3,0.02h,Stop Loss,$-9.00,$582.00,$65972.00,51,$582.00
2024-03-12,16:57:00,18342.25,BUY,3,0.02h,Stop Loss,$-9.00,$573.00,$65963.00,51,$573.00
2024-03-12,16:58:00,18099.0,SELL,3,0.02h,Stop Loss,$-9.00,$564.00,$65954.00,51,$564.00
2024-03-12,16:59:00,18350.0,BUY,3,0.02h,Stop Loss,$30.00,$594.00,$65984.00,51,$594.00
2024-03-12,17:03:00,18085.0,SELL,3,0.02h,Stop Loss,$-9.00,$585.00,$65975.00,51,$585.00
2024-03-12,17:11:00,18328.75,BUY,3,0.02h,Stop Loss,$30.00,$615.00,$66005.00,51,$615.00
2024-03-12,17:21:00,18142.5,SELL,3,0.02h,Stop Loss,$-9.00,$606.00,$65996.00,51,$606.00
2024-03-12,17:24:00,18396.0,BUY,3,0.02h,Stop Loss,$16.50,$622.50,$66012.50,51,$622.50
2024-03-12,17:29:00,18140.25,SELL,3,0.02h,Stop Loss,$43.50,$666.00,$66056.00,51,$666.00
2024-03-12,17:31:00,18391.25,BUY,3,0.02h,Stop Loss,$-9.00,$657.00,$66047.00,51,$657.00
2024-03-12,17:32:00,18146.75,SELL,3,0.02h,Stop Loss,$-9.00,$648.00,$66038.00,51,$648.00
2024-03-12,17:33:00,18393.0,BUY,3,0.02h,Stop Loss,$-9.00,$639.00,$66029.00,51,$639.00
2024-03-12,17:34:00,18145.5,SELL,3,0.02h,Break Even,$-1.50,$637.50,$66027.50,51,$637.50
2024-03-12,17:38:00,18391.5,BUY,3,0.02h,Stop Loss,$-9.00,$628.50,$66018.50,51,$628.50
2024-03-12,17:39:00,18152.25,SELL,3,0.02h,Stop Loss,$10.50,$639.00,$66029.00,51,$639.00
2024-03-12,17:42:00,18400.5,BUY,3,0.02h,Stop Loss,$-9.00,$630.00,$66020.00,51,$630.00
2024-03-12,17:43:00,18153.25,SELL,3,0.02h,Break Even,$-1.50,$628.50,$66018.50,51,$628.50
2024-03-12,17:49:00,18404.0,BUY,3,0.02h,Break Even,$-1.50,$627.00,$66017.00,51,$627.00
2024-03-12,18:06:00,18175.5,SELL,3,0.02h,Stop Loss,$31.50,$658.50,$66048.50,51,$658.50
2024-03-12,18:08:00,18412.5,BUY,3,0.02h,Stop Loss,$-9.00,$649.50,$66039.50,51,$649.50
2024-03-12,18:09:00,18167.0,SELL,3,0.02h,Stop Loss,$-9.00,$640.50,$66030.50,51,$640.50
2024-03-12,18:18:00,18424.75,BUY,3,0.02h,Stop Loss,$-9.00,$631.50,$66021.50,51,$631.50
2024-03-12,18:19:00,18173.25,SELL,3,0.02h,Break Even,$-1.50,$630.00,$66020.00,51,$630.00
2024-03-12,18:26:00,18432.5,BUY,3,0.02h,Stop Loss,$-9.00,$621.00,$66011.00,51,$621.00
2024-03-12,18:34:00,18201.5,SELL,3,0.02h,Stop Loss,$-9.00,$612.00,$66002.00,51,$612.00
2024-03-12,18:35:00,18452.0,BUY,3,0.02h,Stop Loss,$-9.00,$603.00,$65993.00,51,$603.00
2024-03-12,18:37:00,18206.25,SELL,3,0.02h,Stop Loss,$49.50,$652.50,$66042.50,51,$652.50
2024-03-12,18:40:00,18446.0,BUY,3,0.02h,Break Even,$-1.50,$651.00,$66041.00,51,$651.00
2024-03-12,18:43:00,18178.75,SELL,3,0.02h,Stop Loss,$-9.00,$642.00,$66032.00,51,$642.00
2024-03-12,18:44:00,18411.25,BUY,3,0.02h,Stop Loss,$36.00,$678.00,$66068.00,51,$678.00
2024-03-12,18:53:00,18209.5,SELL,3,0.02h,Stop Loss,$-9.00,$669.00,$66059.00,51,$669.00
2024-03-12,18:54:00,18460.25,BUY,3,0.02h,Break Even,$-1.50,$667.50,$66057.50,51,$667.50
2024-03-12,18:59:00,18213.5,SELL,3,0.02h,Stop Loss,$-9.00,$658.50,$66048.50,51,$658.50
2024-03-12,19:00:00,18454.75,BUY,3,0.02h,Break Even,$-1.50,$657.00,$66047.00,51,$657.00
2024-03-12,19:05:00,18205.75,SELL,3,0.02h,Stop Loss,$4.50,$661.50,$66051.50,51,$661.50
2024-03-12,19:07:00,18450.25,BUY,3,0.02h,Stop Loss,$-9.00,$652.50,$66042.50,51,$652.50
2024-03-12,19:08:00,18204.0,SELL,3,0.02h,Break Even,$-1.50,$651.00,$66041.00,51,$651.00
2024-03-12,19:11:00,18460.25,BUY,3,0.02h,Stop Loss,$-9.00,$642.00,$66032.00,51,$642.00
2024-03-12,19:12:00,18207.0,SELL,3,0.02h,Stop Loss,$-9.00,$633.00,$66023.00,51,$633.00
2024-03-12,19:15:00,18459.25,BUY,3,0.02h,Break Even,$-1.50,$631.50,$66021.50,51,$631.50
2024-03-12,19:29:00,18213.25,SELL,3,0.02h,Break Even,$-1.50,$630.00,$66020.00,51,$630.00
2024-03-12,19:38:00,18469.75,BUY,3,0.02h,Stop Loss,$7.50,$637.50,$66027.50,51,$637.50
2024-03-12,19:43:00,18230.25,SELL,3,0.02h,Stop Loss,$15.00,$652.50,$66042.50,51,$652.50
2024-03-12,19:45:00,18467.0,BUY,3,0.02h,Stop Loss,$-9.00,$643.50,$66033.50,51,$643.50
2024-03-12,19:46:00,18224.25,SELL,3,0.02h,Stop Loss,$3.00,$646.50,$66036.50,51,$646.50
2024-03-12,19:59:00,18480.0,BUY,3,0.02h,Break Even,$-1.50,$645.00,$66035.00,51,$645.00
2024-03-12,20:16:00,18220.0,SELL,3,0.02h,Break Even,$-1.50,$643.50,$66033.50,51,$643.50
2024-03-12,20:24:00,18467.5,BUY,3,0.02h,Stop Loss,$-9.00,$634.50,$66024.50,51,$634.50
2024-03-12,20:25:00,18218.5,SELL,3,0.02h,Stop Loss,$-9.00,$625.50,$66015.50,51,$625.50
2024-03-12,20:26:00,18469.25,BUY,3,0.02h,Break Even,$-1.50,$624.00,$66014.00,51,$624.00
2024-03-12,20:31:00,18226.0,SELL,3,0.02h,Stop Loss,$-9.00,$615.00,$66005.00,51,$615.00
2024-03-12,20:33:00,18475.0,BUY,3,0.02h,Stop Loss,$-9.00,$606.00,$65996.00,51,$606.00
2024-03-12,20:37:00,18226.75,SELL,3,0.02h,Stop Loss,$-9.00,$597.00,$65987.00,51,$597.00
2024-03-12,20:38:00,18474.75,BUY,3,0.02h,Stop Loss,$-9.00,$588.00,$65978.00,51,$588.00
2024-03-12,20:39:00,18226.5,SELL,3,0.02h,Break Even,$-1.50,$586.50,$65976.50,51,$586.50
2024-03-12,20:52:00,18475.75,BUY,3,0.02h,Stop Loss,$-9.00,$577.50,$65967.50,51,$577.50
2024-03-12,20:57:00,18229.25,SELL,3,0.02h,Stop Loss,$-9.00,$568.50,$65958.50,51,$568.50
2024-03-12,20:58:00,18474.5,BUY,3,0.02h,Stop Loss,$-9.00,$559.50,$65949.50,51,$559.50
2024-03-12,22:01:00,18219.75,SELL,3,0.02h,Stop Loss,$-9.00,$550.50,$65940.50,51,$550.50
2024-03-12,22:02:00,18468.75,BUY,3,0.02h,Stop Loss,$-9.00,$541.50,$65931.50,51,$541.50
2024-03-12,22:09:00,18220.25,SELL,3,0.02h,Stop Loss,$-9.00,$532.50,$65922.50,51,$532.50
2024-03-12,22:10:00,18467.5,BUY,3,0.02h,Break Even,$-1.50,$531.00,$65921.00,51,$531.00
2024-03-12,22:12:00,18219.0,SELL,3,0.02h,Stop Loss,$-9.00,$522.00,$65912.00,51,$522.00
2024-03-12,22:14:00,18469.75,BUY,3,0.03h,Break Even,$-1.50,$520.50,$65910.50,51,$520.50
2024-03-12,22:29:00,18223.25,SELL,3,0.03h,Stop Loss,$-9.00,$511.50,$65901.50,51,$511.50
2024-03-12,22:41:00,18474.0,BUY,3,0.02h,Stop Loss,$-9.00,$502.50,$65892.50,51,$502.50
2024-03-12,22:42:00,18223.5,SELL,3,0.03h,Stop Loss,$-9.00,$493.50,$65883.50,51,$493.50
2024-03-12,22:46:00,18474.0,BUY,3,0.02h,Stop Loss,$-9.00,$484.50,$65874.50,51,$484.50
2024-03-12,22:47:00,18225.5,SELL,3,0.02h,Stop Loss,$-9.00,$475.50,$65865.50,51,$475.50
2024-03-12,22:48:00,18475.25,BUY,3,0.03h,Stop Loss,$-9.00,$466.50,$65856.50,51,$466.50
2024-03-12,22:51:00,18227.0,SELL,3,0.02h,Stop Loss,$-9.00,$457.50,$65847.50,51,$457.50
2024-03-12,22:53:00,18479.75,BUY,3,0.02h,Stop Loss,$-9.00,$448.50,$65838.50,51,$448.50
2024-03-12,22:54:00,18229.75,SELL,3,0.02h,Break Even,$-1.50,$447.00,$65837.00,51,$447.00
,,,,,,,,,,,
2024-03-13,12:04:00,18458.0,BUY,3,0.02h,Stop Loss,$-9.00,$-9.00,$65828.00,52,$-9.00
2024-03-13,12:05:00,18201.25,SELL,3,0.02h,Stop Loss,$-9.00,$-18.00,$65819.00,52,$-18.00
2024-03-13,12:07:00,18453.25,BUY,3,0.02h,Stop Loss,$-9.00,$-27.00,$65810.00,52,$-27.00
2024-03-13,12:10:00,18202.5,SELL,3,0.02h,Break Even,$-1.50,$-28.50,$65808.50,52,$-28.50
2024-03-13,12:12:00,18447.0,BUY,3,0.02h,Stop Loss,$22.50,$-6.00,$65831.00,52,$-6.00
2024-03-13,12:18:00,18199.0,SELL,3,0.02h,Stop Loss,$3.00,$-3.00,$65834.00,52,$-3.00
2024-03-13,12:22:00,18443.0,BUY,3,0.02h,Stop Loss,$-9.00,$-12.00,$65825.00,52,$-12.00
2024-03-13,12:26:00,18187.25,SELL,3,0.02h,Break Even,$-1.50,$-13.50,$65823.50,52,$-13.50
2024-03-13,12:30:00,18430.5,BUY,3,0.02h,Stop Loss,$-9.00,$-22.50,$65814.50,52,$-22.50
2024-03-13,12:32:00,18177.75,SELL,3,0.02h,Stop Loss,$-9.00,$-31.50,$65805.50,52,$-31.50
2024-03-13,12:33:00,18426.75,BUY,3,0.02h,Stop Loss,$-9.00,$-40.50,$65796.50,52,$-40.50
2024-03-13,12:34:00,18172.25,SELL,3,0.02h,Stop Loss,$-9.00,$-49.50,$65787.50,52,$-49.50
2024-03-13,12:35:00,18415.0,BUY,3,0.02h,Stop Loss,$28.50,$-21.00,$65816.00,52,$-21.00
2024-03-13,12:37:00,18167.75,SELL,3,0.02h,Stop Loss,$-9.00,$-30.00,$65807.00,52,$-30.00
2024-03-13,12:48:00,18423.0,BUY,3,0.02h,Break Even,$-1.50,$-31.50,$65805.50,52,$-31.50
2024-03-13,12:53:00,18170.25,SELL,3,0.02h,Stop Loss,$-9.00,$-40.50,$65796.50,52,$-40.50
2024-03-13,12:54:00,18414.5,BUY,3,0.02h,Stop Loss,$3.00,$-37.50,$65799.50,52,$-37.50
2024-03-13,13:02:00,18177.0,SELL,3,0.02h,Stop Loss,$-9.00,$-46.50,$65790.50,52,$-46.50
2024-03-13,13:03:00,18427.75,BUY,3,0.02h,Stop Loss,$-9.00,$-55.50,$65781.50,52,$-55.50
2024-03-13,13:04:00,18182.0,SELL,3,0.02h,Stop Loss,$-9.00,$-64.50,$65772.50,52,$-64.50
2024-03-13,13:05:00,18434.0,BUY,3,0.02h,Stop Loss,$-9.00,$-73.50,$65763.50,52,$-73.50
2024-03-13,13:06:00,18184.25,SELL,3,0.02h,Stop Loss,$3.00,$-70.50,$65766.50,52,$-70.50
2024-03-13,13:10:00,18434.0,BUY,3,0.02h,Stop Loss,$-9.00,$-79.50,$65757.50,52,$-79.50
2024-03-13,13:16:00,18189.5,SELL,3,0.02h,Stop Loss,$13.50,$-66.00,$65771.00,52,$-66.00
2024-03-13,13:23:00,18434.5,BUY,3,0.02h,Stop Loss,$-9.00,$-75.00,$65762.00,52,$-75.00
2024-03-13,13:24:00,18184.75,SELL,3,0.02h,Stop Loss,$-9.00,$-84.00,$65753.00,52,$-84.00
2024-03-13,13:25:00,18432.0,BUY,3,0.02h,Stop Loss,$13.50,$-70.50,$65766.50,52,$-70.50
2024-03-13,13:28:00,18184.25,SELL,3,0.02h,Stop Loss,$-9.00,$-79.50,$65757.50,52,$-79.50
2024-03-13,13:29:00,18429.0,BUY,3,0.02h,Stop Loss,$15.00,$-64.50,$65772.50,52,$-64.50
2024-03-13,13:36:00,18155.0,SELL,3,0.02h,Stop Loss,$43.50,$-21.00,$65816.00,52,$-21.00
2024-03-13,13:43:00,18389.75,BUY,3,0.02h,Stop Loss,$-9.00,$-30.00,$65807.00,52,$-30.00
2024-03-13,13:47:00,18107.75,SELL,3,0.02h,Break Even,$-1.50,$-31.50,$65805.50,52,$-31.50
2024-03-13,14:07:00,18335.5,BUY,3,0.02h,Stop Loss,$-9.00,$-40.50,$65796.50,52,$-40.50
2024-03-13,14:11:00,18075.0,SELL,3,0.02h,Stop Loss,$-9.00,$-49.50,$65787.50,52,$-49.50
2024-03-13,14:16:00,18335.0,BUY,3,0.02h,Stop Loss,$-9.00,$-58.50,$65778.50,52,$-58.50
2024-03-13,14:17:00,18081.0,SELL,3,0.02h,Break Even,$-1.50,$-60.00,$65777.00,52,$-60.00
2024-03-13,14:24:00,18343.25,BUY,3,0.02h,Stop Loss,$-9.00,$-69.00,$65768.00,52,$-69.00
2024-03-13,14:25:00,18098.25,SELL,3,0.02h,Stop Loss,$24.00,$-45.00,$65792.00,52,$-45.00
2024-03-13,14:29:00,18341.25,BUY,3,0.02h,Stop Loss,$-9.00,$-54.00,$65783.00,52,$-54.00
2024-03-13,14:30:00,18095.75,SELL,3,0.02h,Stop Loss,$4.50,$-49.50,$65787.50,52,$-49.50
2024-03-13,14:32:00,18344.0,BUY,3,0.02h,Stop Loss,$-9.00,$-58.50,$65778.50,52,$-58.50
2024-03-13,14:33:00,18099.25,SELL,3,0.02h,Stop Loss,$-9.00,$-67.50,$65769.50,52,$-67.50
2024-03-13,14:34:00,18361.5,BUY,3,0.02h,Break Even,$-1.50,$-69.00,$65768.00,52,$-69.00
2024-03-13,14:38:00,18096.5,SELL,3,0.02h,Stop Loss,$-9.00,$-78.00,$65759.00,52,$-78.00
2024-03-13,14:39:00,18354.5,BUY,3,0.02h,Stop Loss,$-9.00,$-87.00,$65750.00,52,$-87.00
2024-03-13,14:50:00,18112.75,SELL,3,0.02h,Stop Loss,$18.00,$-69.00,$65768.00,52,$-69.00
2024-03-13,15:06:00,18356.5,BUY,3,0.02h,Stop Loss,$-9.00,$-78.00,$65759.00,52,$-78.00
2024-03-13,15:08:00,18094.25,SELL,3,0.02h,Break Even,$-1.50,$-79.50,$65757.50,52,$-79.50
2024-03-13,15:13:00,18362.75,BUY,3,0.02h,Stop Loss,$-9.00,$-88.50,$65748.50,52,$-88.50
2024-03-13,15:14:00,18105.5,SELL,3,0.02h,Stop Loss,$42.00,$-46.50,$65790.50,52,$-46.50
2024-03-13,15:17:00,18347.5,BUY,3,0.02h,Stop Loss,$16.50,$-30.00,$65807.00,52,$-30.00
2024-03-13,15:30:00,18073.5,SELL,3,0.02h,Stop Loss,$24.00,$-6.00,$65831.00,52,$-6.00
2024-03-13,15:42:00,18304.25,BUY,3,0.02h,Stop Loss,$-9.00,$-15.00,$65822.00,52,$-15.00
2024-03-13,15:43:00,18044.75,SELL,3,0.02h,Stop Loss,$45.00,$30.00,$65867.00,52,$30.00
2024-03-13,15:48:00,18296.0,BUY,3,0.02h,Stop Loss,$13.50,$43.50,$65880.50,52,$43.50
2024-03-13,15:55:00,18075.75,SELL,3,0.02h,Stop Loss,$-9.00,$34.50,$65871.50,52,$34.50
2024-03-13,15:57:00,18332.5,BUY,3,0.02h,Stop Loss,$-9.00,$25.50,$65862.50,52,$25.50
2024-03-13,15:58:00,18083.75,SELL,3,0.02h,Stop Loss,$-9.00,$16.50,$65853.50,52,$16.50
2024-03-13,15:59:00,18330.25,BUY,3,0.02h,Stop Loss,$22.50,$39.00,$65876.00,52,$39.00
2024-03-13,16:02:00,18078.5,SELL,3,0.02h,Stop Loss,$9.00,$48.00,$65885.00,52,$48.00
2024-03-13,16:06:00,18336.0,BUY,3,0.02h,Stop Loss,$-9.00,$39.00,$65876.00,52,$39.00
2024-03-13,16:10:00,18078.0,SELL,3,0.02h,Stop Loss,$7.50,$46.50,$65883.50,52,$46.50
2024-03-13,16:18:00,18335.5,BUY,3,0.02h,Stop Loss,$9.00,$55.50,$65892.50,52,$55.50
2024-03-13,16:22:00,18089.75,SELL,3,0.02h,Stop Loss,$-9.00,$46.50,$65883.50,52,$46.50
2024-03-13,16:24:00,18338.75,BUY,3,0.02h,Stop Loss,$-9.00,$37.50,$65874.50,52,$37.50
2024-03-13,16:25:00,18092.5,SELL,3,0.02h,Stop Loss,$-9.00,$28.50,$65865.50,52,$28.50
2024-03-13,16:26:00,18344.0,BUY,3,0.02h,Stop Loss,$-9.00,$19.50,$65856.50,52,$19.50
2024-03-13,16:27:00,18091.5,SELL,3,0.02h,Stop Loss,$-9.00,$10.50,$65847.50,52,$10.50
2024-03-13,16:28:00,18342.5,BUY,3,0.02h,Stop Loss,$-9.00,$1.50,$65838.50,52,$1.50
2024-03-13,16:29:00,18083.25,SELL,3,0.02h,Stop Loss,$-9.00,$-7.50,$65829.50,52,$-7.50
2024-03-13,16:31:00,18339.0,BUY,3,0.02h,Stop Loss,$-9.00,$-16.50,$65820.50,52,$-16.50
2024-03-13,16:32:00,18075.75,SELL,3,0.02h,Stop Loss,$12.00,$-4.50,$65832.50,52,$-4.50
2024-03-13,16:35:00,18328.5,BUY,3,0.02h,Stop Loss,$-9.00,$-13.50,$65823.50,52,$-13.50
2024-03-13,16:36:00,18080.75,SELL,3,0.02h,Stop Loss,$-9.00,$-22.50,$65814.50,52,$-22.50
2024-03-13,16:37:00,18327.0,BUY,3,0.02h,Stop Loss,$-9.00,$-31.50,$65805.50,52,$-31.50
2024-03-13,16:38:00,18078.0,SELL,3,0.02h,Stop Loss,$-9.00,$-40.50,$65796.50,52,$-40.50
2024-03-13,16:44:00,18351.5,BUY,3,0.02h,Stop Loss,$-9.00,$-49.50,$65787.50,52,$-49.50
2024-03-13,16:45:00,18100.25,SELL,3,0.02h,Break Even,$-1.50,$-51.00,$65786.00,52,$-51.00
2024-03-13,16:47:00,18350.75,BUY,3,0.02h,Break Even,$-1.50,$-52.50,$65784.50,52,$-52.50
2024-03-13,16:57:00,18102.75,SELL,3,0.02h,Stop Loss,$15.00,$-37.50,$65799.50,52,$-37.50
2024-03-13,17:05:00,18362.75,BUY,3,0.02h,Stop Loss,$25.50,$-12.00,$65825.00,52,$-12.00
2024-03-13,17:17:00,18104.25,SELL,3,0.02h,Stop Loss,$-9.00,$-21.00,$65816.00,52,$-21.00
2024-03-13,17:20:00,18359.0,BUY,3,0.02h,Stop Loss,$-9.00,$-30.00,$65807.00,52,$-30.00
2024-03-13,17:21:00,18111.25,SELL,3,0.02h,Stop Loss,$-9.00,$-39.00,$65798.00,52,$-39.00
2024-03-13,17:22:00,18363.75,BUY,3,0.02h,Stop Loss,$-9.00,$-48.00,$65789.00,52,$-48.00
2024-03-13,17:23:00,18116.0,SELL,3,0.02h,Stop Loss,$-9.00,$-57.00,$65780.00,52,$-57.00
2024-03-13,17:24:00,18365.0,BUY,3,0.02h,Stop Loss,$-9.00,$-66.00,$65771.00,52,$-66.00
2024-03-13,17:25:00,18117.75,SELL,3,0.02h,Stop Loss,$-9.00,$-75.00,$65762.00,52,$-75.00
2024-03-13,17:28:00,18378.5,BUY,3,0.02h,Break Even,$-1.50,$-76.50,$65760.50,52,$-76.50
2024-03-13,17:31:00,18142.5,SELL,3,0.02h,Stop Loss,$55.50,$-21.00,$65816.00,52,$-21.00
2024-03-13,17:35:00,18369.75,BUY,3,0.02h,Stop Loss,$-9.00,$-30.00,$65807.00,52,$-30.00
2024-03-13,17:36:00,18121.75,SELL,3,0.02h,Stop Loss,$-9.00,$-39.00,$65798.00,52,$-39.00
2024-03-13,17:37:00,18383.25,BUY,3,0.02h,Stop Loss,$-9.00,$-48.00,$65789.00,52,$-48.00
2024-03-13,17:38:00,18135.5,SELL,3,0.02h,Stop Loss,$27.00,$-21.00,$65816.00,52,$-21.00
2024-03-13,17:43:00,18372.25,BUY,3,0.02h,Stop Loss,$-9.00,$-30.00,$65807.00,52,$-30.00
2024-03-13,17:44:00,18120.25,SELL,3,0.02h,Stop Loss,$-9.00,$-39.00,$65798.00,52,$-39.00
2024-03-13,17:45:00,18367.25,BUY,3,0.02h,Stop Loss,$46.50,$7.50,$65844.50,52,$7.50
2024-03-13,17:57:00,18135.25,SELL,3,0.02h,Stop Loss,$-9.00,$-1.50,$65835.50,52,$-1.50
2024-03-13,17:58:00,18390.5,BUY,3,0.02h,Stop Loss,$-9.00,$-10.50,$65826.50,52,$-10.50
2024-03-13,17:59:00,18141.0,SELL,3,0.02h,Stop Loss,$-9.00,$-19.50,$65817.50,52,$-19.50
2024-03-13,18:00:00,18388.25,BUY,3,0.02h,Stop Loss,$-9.00,$-28.50,$65808.50,52,$-28.50
2024-03-13,18:01:00,18136.75,SELL,3,0.02h,Stop Loss,$-9.00,$-37.50,$65799.50,52,$-37.50
2024-03-13,18:04:00,18384.25,BUY,3,0.02h,Break Even,$-1.50,$-39.00,$65798.00,52,$-39.00
2024-03-13,18:20:00,18123.25,SELL,3,0.02h,Stop Loss,$-9.00,$-48.00,$65789.00,52,$-48.00
2024-03-13,18:21:00,18380.0,BUY,3,0.02h,Stop Loss,$15.00,$-33.00,$65804.00,52,$-33.00
2024-03-13,18:24:00,18131.75,SELL,3,0.02h,Break Even,$-1.50,$-34.50,$65802.50,52,$-34.50
2024-03-13,18:36:00,18387.75,BUY,3,0.02h,Break Even,$-1.50,$-36.00,$65801.00,52,$-36.00
2024-03-13,18:49:00,18135.5,SELL,3,0.02h,Stop Loss,$-9.00,$-45.00,$65792.00,52,$-45.00
2024-03-13,18:54:00,18397.25,BUY,3,0.02h,Stop Loss,$-9.00,$-54.00,$65783.00,52,$-54.00
2024-03-13,18:57:00,18141.5,SELL,3,0.02h,Stop Loss,$-9.00,$-63.00,$65774.00,52,$-63.00
2024-03-13,18:58:00,18387.0,BUY,3,0.02h,Stop Loss,$-9.00,$-72.00,$65765.00,52,$-72.00
2024-03-13,18:59:00,18131.75,SELL,3,0.02h,Stop Loss,$-9.00,$-81.00,$65756.00,52,$-81.00
2024-03-13,19:01:00,18385.75,BUY,3,0.02h,Stop Loss,$-9.00,$-90.00,$65747.00,52,$-90.00
2024-03-13,19:02:00,18132.75,SELL,3,0.02h,Stop Loss,$12.00,$-78.00,$65759.00,52,$-78.00
2024-03-13,19:05:00,18384.0,BUY,3,0.02h,Stop Loss,$-9.00,$-87.00,$65750.00,52,$-87.00
2024-03-13,19:07:00,18123.5,SELL,3,0.02h,Break Even,$-1.50,$-88.50,$65748.50,52,$-88.50
2024-03-13,19:16:00,18373.5,BUY,3,0.02h,Stop Loss,$-9.00,$-97.50,$65739.50,52,$-97.50
2024-03-13,19:17:00,18123.25,SELL,3,0.02h,Stop Loss,$-9.00,$-106.50,$65730.50,52,$-106.50
2024-03-13,19:21:00,18382.5,BUY,3,0.02h,Stop Loss,$-9.00,$-115.50,$65721.50,52,$-115.50
2024-03-13,19:22:00,18127.75,SELL,3,0.02h,Stop Loss,$-9.00,$-124.50,$65712.50,52,$-124.50
2024-03-13,19:23:00,18372.5,BUY,3,0.02h,Stop Loss,$-9.00,$-133.50,$65703.50,52,$-133.50
2024-03-13,19:31:00,18086.25,SELL,3,0.02h,Stop Loss,$57.00,$-76.50,$65760.50,52,$-76.50
2024-03-13,19:36:00,18321.75,BUY,3,0.02h,Stop Loss,$-9.00,$-85.50,$65751.50,52,$-85.50
2024-03-13,19:37:00,18072.5,SELL,3,0.02h,Stop Loss,$-9.00,$-94.50,$65742.50,52,$-94.50
2024-03-13,19:48:00,18344.0,BUY,3,0.02h,Stop Loss,$7.50,$-87.00,$65750.00,52,$-87.00
2024-03-13,19:51:00,18087.75,SELL,3,0.02h,Stop Loss,$96.00,$9.00,$65846.00,52,$9.00
2024-03-13,20:03:00,18331.5,BUY,3,0.02h,Stop Loss,$-9.00,$0.00,$65837.00,52,$0.00
2024-03-13,20:04:00,18080.25,SELL,3,0.02h,Stop Loss,$-9.00,$-9.00,$65828.00,52,$-9.00
2024-03-13,20:05:00,18333.25,BUY,3,0.02h,Stop Loss,$7.50,$-1.50,$65835.50,52,$-1.50
2024-03-13,20:11:00,18091.0,SELL,3,0.02h,Stop Loss,$-9.00,$-10.50,$65826.50,52,$-10.50
2024-03-13,20:12:00,18341.0,BUY,3,0.02h,Stop Loss,$-9.00,$-19.50,$65817.50,52,$-19.50
2024-03-13,20:13:00,18092.75,SELL,3,0.02h,Stop Loss,$-9.00,$-28.50,$65808.50,52,$-28.50
2024-03-13,20:14:00,18346.0,BUY,3,0.02h,Stop Loss,$-9.00,$-37.50,$65799.50,52,$-37.50
2024-03-13,20:15:00,18094.5,SELL,3,0.02h,Stop Loss,$6.00,$-31.50,$65805.50,52,$-31.50
2024-03-13,20:22:00,18344.0,BUY,3,0.02h,Stop Loss,$-9.00,$-40.50,$65796.50,52,$-40.50
2024-03-13,20:23:00,18093.75,SELL,3,0.02h,Stop Loss,$-9.00,$-49.50,$65787.50,52,$-49.50
2024-03-13,20:24:00,18343.5,BUY,3,0.02h,Break Even,$-1.50,$-51.00,$65786.00,52,$-51.00
2024-03-13,20:34:00,18097.75,SELL,3,0.02h,Break Even,$-1.50,$-52.50,$65784.50,52,$-52.50
2024-03-13,20:36:00,18348.75,BUY,3,0.03h,Stop Loss,$-9.00,$-61.50,$65775.50,52,$-61.50
2024-03-13,20:39:00,18096.75,SELL,3,0.02h,Break Even,$-1.50,$-63.00,$65774.00,52,$-63.00
2024-03-13,20:41:00,18347.5,BUY,3,0.03h,Stop Loss,$-9.00,$-72.00,$65765.00,52,$-72.00
2024-03-13,20:43:00,18096.75,SELL,3,0.02h,Stop Loss,$-9.00,$-81.00,$65756.00,52,$-81.00
2024-03-13,20:53:00,18352.75,BUY,3,0.02h,Break Even,$-1.50,$-82.50,$65754.50,52,$-82.50
2024-03-13,20:58:00,18106.5,SELL,3,0.03h,Break Even,$-1.50,$-84.00,$65753.00,52,$-84.00
2024-03-13,21:00:00,18355.5,BUY,3,1.02h,Stop Loss,$-9.00,$-93.00,$65744.00,52,$-93.00
2024-03-13,22:01:00,18097.5,SELL,3,0.02h,Stop Loss,$-9.00,$-102.00,$65735.00,52,$-102.00
2024-03-13,22:11:00,18355.75,BUY,3,0.02h,Stop Loss,$-9.00,$-111.00,$65726.00,52,$-111.00
2024-03-13,22:13:00,18101.0,SELL,3,0.02h,Stop Loss,$-9.00,$-120.00,$65717.00,52,$-120.00
2024-03-13,22:16:00,18353.0,BUY,3,0.02h,Stop Loss,$-9.00,$-129.00,$65708.00,52,$-129.00
2024-03-13,22:20:00,18104.5,SELL,3,0.03h,Break Even,$-1.50,$-130.50,$65706.50,52,$-130.50
2024-03-13,22:22:00,18351.75,BUY,3,0.02h,Stop Loss,$-9.00,$-139.50,$65697.50,52,$-139.50
2024-03-13,22:31:00,18103.25,SELL,3,0.02h,Break Even,$-1.50,$-141.00,$65696.00,52,$-141.00
2024-03-13,22:40:00,18350.0,BUY,3,0.07h,Break Even,$-1.50,$-142.50,$65694.50,52,$-142.50
2024-03-13,22:46:00,18103.75,SELL,3,0.02h,Stop Loss,$-9.00,$-151.50,$65685.50,52,$-151.50
2024-03-13,22:50:00,18360.25,BUY,3,0.02h,Stop Loss,$-9.00,$-160.50,$65676.50,52,$-160.50
2024-03-13,23:00:00,18108.0,SELL,3,13.00h,Stop Loss,$-9.00,$-169.50,$65667.50,52,$-169.50
,,,,,,,,,,,
2024-03-14,12:00:00,18395.25,BUY,3,0.02h,Stop Loss,$-9.00,$-9.00,$65658.50,53,$-9.00
2024-03-14,12:02:00,18150.75,SELL,3,0.02h,Stop Loss,$-9.00,$-18.00,$65649.50,53,$-18.00
2024-03-14,12:03:00,18405.75,BUY,3,0.02h,Break Even,$-1.50,$-19.50,$65648.00,53,$-19.50
2024-03-14,12:17:00,18156.5,SELL,3,0.02h,Stop Loss,$-9.00,$-28.50,$65639.00,53,$-28.50
2024-03-14,12:18:00,18410.25,BUY,3,0.02h,Break Even,$-1.50,$-30.00,$65637.50,53,$-30.00
2024-03-14,12:22:00,18155.25,SELL,3,0.02h,Stop Loss,$-9.00,$-39.00,$65628.50,53,$-39.00
2024-03-14,12:24:00,18403.75,BUY,3,0.02h,Stop Loss,$-9.00,$-48.00,$65619.50,53,$-48.00
2024-03-14,12:27:00,18155.25,SELL,3,0.02h,Stop Loss,$-9.00,$-57.00,$65610.50,53,$-57.00
2024-03-14,12:28:00,18404.25,BUY,3,0.02h,Stop Loss,$-9.00,$-66.00,$65601.50,53,$-66.00
2024-03-14,12:29:00,18163.0,SELL,3,0.02h,Stop Loss,$-9.00,$-75.00,$65592.50,53,$-75.00
2024-03-14,12:30:00,18407.25,BUY,3,0.02h,Stop Loss,$-9.00,$-84.00,$65583.50,53,$-84.00
2024-03-14,12:31:00,18128.75,SELL,3,0.02h,Stop Loss,$-9.00,$-93.00,$65574.50,53,$-93.00
2024-03-14,12:33:00,18367.0,BUY,3,0.02h,Stop Loss,$43.50,$-49.50,$65618.00,53,$-49.50
2024-03-14,12:38:00,18115.0,SELL,3,0.02h,Stop Loss,$-9.00,$-58.50,$65609.00,53,$-58.50
2024-03-14,12:49:00,18384.0,BUY,3,0.02h,Break Even,$-1.50,$-60.00,$65607.50,53,$-60.00
2024-03-14,12:51:00,18117.5,SELL,3,0.02h,Stop Loss,$31.50,$-28.50,$65639.00,53,$-28.50
2024-03-14,12:56:00,18369.25,BUY,3,0.02h,Stop Loss,$-9.00,$-37.50,$65630.00,53,$-37.50
2024-03-14,12:57:00,18125.5,SELL,3,0.02h,Stop Loss,$-9.00,$-46.50,$65621.00,53,$-46.50
2024-03-14,12:58:00,18374.0,BUY,3,0.02h,Stop Loss,$-9.00,$-55.50,$65612.00,53,$-55.50
2024-03-14,12:59:00,18119.5,SELL,3,0.02h,Stop Loss,$-9.00,$-64.50,$65603.00,53,$-64.50
2024-03-14,13:00:00,18370.5,BUY,3,0.02h,Stop Loss,$24.00,$-40.50,$65627.00,53,$-40.50
2024-03-14,13:09:00,18107.25,SELL,3,0.02h,Stop Loss,$-9.00,$-49.50,$65618.00,53,$-49.50
2024-03-14,13:10:00,18357.75,BUY,3,0.02h,Break Even,$-1.50,$-51.00,$65616.50,53,$-51.00
2024-03-14,13:12:00,18112.25,SELL,3,0.02h,Stop Loss,$22.50,$-28.50,$65639.00,53,$-28.50
2024-03-14,13:16:00,18361.0,BUY,3,0.02h,Stop Loss,$-9.00,$-37.50,$65630.00,53,$-37.50
2024-03-14,13:17:00,18113.5,SELL,3,0.02h,Stop Loss,$-9.00,$-46.50,$65621.00,53,$-46.50
2024-03-14,13:35:00,18374.5,BUY,3,0.02h,Break Even,$-1.50,$-48.00,$65619.50,53,$-48.00
2024-03-14,13:39:00,18142.0,SELL,3,0.02h,Stop Loss,$-9.00,$-57.00,$65610.50,53,$-57.00
2024-03-14,13:40:00,18384.75,BUY,3,0.02h,Stop Loss,$21.00,$-36.00,$65631.50,53,$-36.00
2024-03-14,13:51:00,18247.75,SELL,3,0.02h,Stop Loss,$21.00,$-15.00,$65652.50,53,$-15.00
2024-03-14,14:07:00,18257.5,BUY,3,0.02h,Stop Loss,$16.50,$1.50,$65669.00,53,$1.50
2024-03-14,14:13:00,18051.75,SELL,3,0.02h,Stop Loss,$-9.00,$-7.50,$65660.00,53,$-7.50
2024-03-14,14:14:00,18306.0,BUY,3,0.02h,Stop Loss,$7.50,$0.00,$65667.50,53,$0.00
2024-03-14,14:17:00,18050.25,SELL,3,0.02h,Stop Loss,$-9.00,$-9.00,$65658.50,53,$-9.00
2024-03-14,14:18:00,18294.75,BUY,3,0.02h,Break Even,$-1.50,$-10.50,$65657.00,53,$-10.50
2024-03-14,14:20:00,18037.25,SELL,3,0.02h,Stop Loss,$19.50,$9.00,$65676.50,53,$9.00
2024-03-14,14:29:00,18293.25,BUY,3,0.02h,Stop Loss,$115.50,$124.50,$65792.00,53,$124.50
2024-03-14,14:31:00,18089.25,SELL,3,0.02h,Stop Loss,$-9.00,$115.50,$65783.00,53,$115.50
2024-03-14,14:32:00,18333.75,BUY,3,0.02h,Stop Loss,$10.50,$126.00,$65793.50,53,$126.00
2024-03-14,14:35:00,18088.75,SELL,3,0.02h,Stop Loss,$-9.00,$117.00,$65784.50,53,$117.00
2024-03-14,14:36:00,18337.75,BUY,3,0.02h,Break Even,$-1.50,$115.50,$65783.00,53,$115.50
2024-03-14,14:44:00,18049.75,SELL,3,0.02h,Stop Loss,$27.00,$142.50,$65810.00,53,$142.50
2024-03-14,14:51:00,18295.75,BUY,3,0.02h,Stop Loss,$79.50,$222.00,$65889.50,53,$222.00
2024-03-14,14:53:00,18045.0,SELL,3,0.02h,Stop Loss,$-9.00,$213.00,$65880.50,53,$213.00
2024-03-14,14:54:00,18295.0,BUY,3,0.02h,Stop Loss,$45.00,$258.00,$65925.50,53,$258.00
2024-03-14,14:56:00,18044.5,SELL,3,0.02h,Break Even,$-1.50,$256.50,$65924.00,53,$256.50
2024-03-14,15:04:00,18324.0,BUY,3,0.02h,Break Even,$-1.50,$255.00,$65922.50,53,$255.00
2024-03-14,15:09:00,18060.25,SELL,3,0.02h,Stop Loss,$-9.00,$246.00,$65913.50,53,$246.00
2024-03-14,15:10:00,18307.25,BUY,3,0.02h,Stop Loss,$112.50,$358.50,$66026.00,53,$358.50
2024-03-14,15:13:00,18082.25,SELL,3,0.02h,Break Even,$-1.50,$357.00,$66024.50,53,$357.00
2024-03-14,15:26:00,18277.75,BUY,3,0.02h,Stop Loss,$19.50,$376.50,$66044.00,53,$376.50
2024-03-14,15:30:00,18031.75,SELL,3,0.02h,Stop Loss,$-9.00,$367.50,$66035.00,53,$367.50
2024-03-14,15:31:00,18275.5,BUY,3,0.02h,Break Even,$-1.50,$366.00,$66033.50,53,$366.00
2024-03-14,15:33:00,18025.75,SELL,3,0.02h,Break Even,$-1.50,$364.50,$66032.00,53,$364.50
2024-03-14,15:41:00,18287.5,BUY,3,0.02h,Stop Loss,$-9.00,$355.50,$66023.00,53,$355.50
2024-03-14,15:42:00,18043.0,SELL,3,0.02h,Stop Loss,$9.00,$364.50,$66032.00,53,$364.50
2024-03-14,15:49:00,18280.25,BUY,3,0.02h,Stop Loss,$6.00,$370.50,$66038.00,53,$370.50
2024-03-14,16:06:00,18022.0,SELL,3,0.02h,Stop Loss,$-9.00,$361.50,$66029.00,53,$361.50
2024-03-14,16:08:00,18251.5,BUY,3,0.02h,Stop Loss,$-9.00,$352.50,$66020.00,53,$352.50
2024-03-14,16:09:00,18003.0,SELL,3,0.02h,Stop Loss,$-9.00,$343.50,$66011.00,53,$343.50
2024-03-14,16:16:00,18252.25,BUY,3,0.02h,Stop Loss,$-9.00,$334.50,$66002.00,53,$334.50
2024-03-14,16:17:00,18006.5,SELL,3,0.02h,Stop Loss,$-9.00,$325.50,$65993.00,53,$325.50
2024-03-14,16:21:00,18254.5,BUY,3,0.02h,Stop Loss,$64.50,$390.00,$66057.50,53,$390.00
2024-03-14,16:32:00,18042.75,SELL,3,0.02h,Stop Loss,$49.50,$439.50,$66107.00,53,$439.50
2024-03-14,16:35:00,18283.5,BUY,3,0.02h,Stop Loss,$-9.00,$430.50,$66098.00,53,$430.50
2024-03-14,16:36:00,18050.75,SELL,3,0.02h,Stop Loss,$-9.00,$421.50,$66089.00,53,$421.50
2024-03-14,16:38:00,18291.25,BUY,3,0.02h,Stop Loss,$-9.00,$412.50,$66080.00,53,$412.50
2024-03-14,16:39:00,18036.75,SELL,3,0.02h,Stop Loss,$-9.00,$403.50,$66071.00,53,$403.50
2024-03-14,16:49:00,18268.75,BUY,3,0.02h,Stop Loss,$-9.00,$394.50,$66062.00,53,$394.50
2024-03-14,16:51:00,18022.0,SELL,3,0.02h,Stop Loss,$-9.00,$385.50,$66053.00,53,$385.50
2024-03-14,16:52:00,18275.25,BUY,3,0.02h,Stop Loss,$-9.00,$376.50,$66044.00,53,$376.50
2024-03-14,16:53:00,18027.5,SELL,3,0.02h,Stop Loss,$-9.00,$367.50,$66035.00,53,$367.50
2024-03-14,16:54:00,18271.5,BUY,3,0.02h,Stop Loss,$-9.00,$358.50,$66026.00,53,$358.50
2024-03-14,16:55:00,18020.75,SELL,3,0.02h,Stop Loss,$28.50,$387.00,$66054.50,53,$387.00
2024-03-14,17:04:00,18250.25,BUY,3,0.02h,Break Even,$-1.50,$385.50,$66053.00,53,$385.50
2024-03-14,17:08:00,17998.25,SELL,3,0.02h,Stop Loss,$-9.00,$376.50,$66044.00,53,$376.50
2024-03-14,17:09:00,18241.75,BUY,3,0.02h,Stop Loss,$25.50,$402.00,$66069.50,53,$402.00
2024-03-14,17:12:00,17988.25,SELL,3,0.02h,Stop Loss,$-9.00,$393.00,$66060.50,53,$393.00
2024-03-14,17:13:00,18233.5,BUY,3,0.02h,Stop Loss,$-9.00,$384.00,$66051.50,53,$384.00
2024-03-14,17:14:00,17992.5,SELL,3,0.02h,Stop Loss,$7.50,$391.50,$66059.00,53,$391.50
2024-03-14,17:23:00,18229.5,BUY,3,0.02h,Stop Loss,$-9.00,$382.50,$66050.00,53,$382.50
2024-03-14,17:24:00,17993.25,SELL,3,0.02h,Break Even,$-1.50,$381.00,$66048.50,53,$381.00
2024-03-14,17:33:00,18229.25,BUY,3,0.02h,Stop Loss,$-9.00,$372.00,$66039.50,53,$372.00
2024-03-14,17:34:00,17982.5,SELL,3,0.02h,Stop Loss,$-9.00,$363.00,$66030.50,53,$363.00
2024-03-14,17:37:00,18238.75,BUY,3,0.02h,Stop Loss,$-9.00,$354.00,$66021.50,53,$354.00
2024-03-14,17:38:00,18004.25,SELL,3,0.02h,Stop Loss,$-9.00,$345.00,$66012.50,53,$345.00
2024-03-14,17:39:00,18253.5,BUY,3,0.02h,Stop Loss,$-9.00,$336.00,$66003.50,53,$336.00
2024-03-14,17:50:00,18012.25,SELL,3,0.02h,Stop Loss,$3.00,$339.00,$66006.50,53,$339.00
2024-03-14,17:52:00,18267.0,BUY,3,0.02h,Break Even,$-1.50,$337.50,$66005.00,53,$337.50
2024-03-14,18:02:00,18064.75,SELL,3,0.02h,Stop Loss,$-9.00,$328.50,$65996.00,53,$328.50
2024-03-14,18:07:00,18314.5,BUY,3,0.02h,Stop Loss,$-9.00,$319.50,$65987.00,53,$319.50
2024-03-14,18:08:00,18063.5,SELL,3,0.02h,Stop Loss,$-9.00,$310.50,$65978.00,53,$310.50
2024-03-14,18:10:00,18322.25,BUY,3,0.02h,Stop Loss,$-9.00,$301.50,$65969.00,53,$301.50
2024-03-14,18:12:00,18074.75,SELL,3,0.02h,Stop Loss,$-9.00,$292.50,$65960.00,53,$292.50
2024-03-14,18:14:00,18321.0,BUY,3,0.02h,Stop Loss,$7.50,$300.00,$65967.50,53,$300.00
2024-03-14,18:29:00,18055.0,SELL,3,0.02h,Stop Loss,$-9.00,$291.00,$65958.50,53,$291.00
2024-03-14,18:30:00,18299.75,BUY,3,0.02h,Stop Loss,$28.50,$319.50,$65987.00,53,$319.50
2024-03-14,18:32:00,18040.5,SELL,3,0.02h,Stop Loss,$-9.00,$310.50,$65978.00,53,$310.50
2024-03-14,18:33:00,18289.0,BUY,3,0.02h,Stop Loss,$-9.00,$301.50,$65969.00,53,$301.50
2024-03-14,18:34:00,18042.0,SELL,3,0.02h,Stop Loss,$-9.00,$292.50,$65960.00,53,$292.50
2024-03-14,18:37:00,18286.5,BUY,3,0.02h,Stop Loss,$-9.00,$283.50,$65951.00,53,$283.50
2024-03-14,18:39:00,18036.75,SELL,3,0.02h,Stop Loss,$21.00,$304.50,$65972.00,53,$304.50
2024-03-14,18:49:00,18306.5,BUY,3,0.02h,Break Even,$-1.50,$303.00,$65970.50,53,$303.00
2024-03-14,18:54:00,18022.0,SELL,3,0.02h,Stop Loss,$43.50,$346.50,$66014.00,53,$346.50
2024-03-14,19:08:00,18224.5,BUY,3,0.02h,Stop Loss,$-9.00,$337.50,$66005.00,53,$337.50
2024-03-14,19:09:00,17961.75,SELL,3,0.02h,Stop Loss,$-9.00,$328.50,$65996.00,53,$328.50
2024-03-14,19:10:00,18198.5,BUY,3,0.02h,Stop Loss,$33.00,$361.50,$66029.00,53,$361.50
2024-03-14,19:14:00,17939.0,SELL,3,0.02h,Stop Loss,$-9.00,$352.50,$66020.00,53,$352.50
2024-03-14,19:18:00,18199.0,BUY,3,0.02h,Stop Loss,$-9.00,$343.50,$66011.00,53,$343.50
2024-03-14,19:20:00,17943.5,SELL,3,0.02h,Stop Loss,$-9.00,$334.50,$66002.00,53,$334.50
2024-03-14,19:23:00,18195.5,BUY,3,0.02h,Stop Loss,$-9.00,$325.50,$65993.00,53,$325.50
2024-03-14,19:24:00,17941.25,SELL,3,0.02h,Stop Loss,$9.00,$334.50,$66002.00,53,$334.50
2024-03-14,19:30:00,18192.0,BUY,3,0.02h,Break Even,$-1.50,$333.00,$66000.50,53,$333.00
2024-03-14,19:32:00,17935.5,SELL,3,0.02h,Stop Loss,$55.50,$388.50,$66056.00,53,$388.50
2024-03-14,19:41:00,18201.0,BUY,3,0.02h,Stop Loss,$52.50,$441.00,$66108.50,53,$441.00
2024-03-14,19:48:00,17964.0,SELL,3,0.02h,Stop Loss,$-9.00,$432.00,$66099.50,53,$432.00
2024-03-14,19:50:00,18221.0,BUY,3,0.02h,Stop Loss,$67.50,$499.50,$66167.00,53,$499.50
2024-03-14,19:53:00,17998.5,SELL,3,0.02h,Stop Loss,$-9.00,$490.50,$66158.00,53,$490.50
2024-03-14,19:54:00,18246.75,BUY,3,0.02h,Stop Loss,$-9.00,$481.50,$66149.00,53,$481.50
2024-03-14,19:56:00,18009.5,SELL,3,0.02h,Stop Loss,$60.00,$541.50,$66209.00,53,$541.50
2024-03-14,19:58:00,18253.75,BUY,3,0.02h,Stop Loss,$-9.00,$532.50,$66200.00,53,$532.50
2024-03-14,20:00:00,18030.75,SELL,3,0.02h,Stop Loss,$-9.00,$523.50,$66191.00,53,$523.50
2024-03-14,20:01:00,18279.25,BUY,3,0.02h,Stop Loss,$54.00,$577.50,$66245.00,53,$577.50
2024-03-14,20:14:00,18016.75,SELL,3,0.02h,Stop Loss,$19.50,$597.00,$66264.50,53,$597.00
2024-03-14,20:18:00,18260.5,BUY,3,0.02h,Stop Loss,$7.50,$604.50,$66272.00,53,$604.50
2024-03-14,20:26:00,18017.0,SELL,3,0.02h,Stop Loss,$3.00,$607.50,$66275.00,53,$607.50
2024-03-14,20:33:00,18261.5,BUY,3,0.02h,Stop Loss,$-9.00,$598.50,$66266.00,53,$598.50
2024-03-14,20:34:00,18011.75,SELL,3,0.02h,Stop Loss,$-9.00,$589.50,$66257.00,53,$589.50
2024-03-14,20:41:00,18265.0,BUY,3,0.02h,Stop Loss,$-9.00,$580.50,$66248.00,53,$580.50
2024-03-14,20:42:00,18020.25,SELL,3,0.02h,Stop Loss,$-9.00,$571.50,$66239.00,53,$571.50
2024-03-14,20:46:00,18273.25,BUY,3,0.02h,Stop Loss,$-9.00,$562.50,$66230.00,53,$562.50
2024-03-14,20:53:00,18014.25,SELL,3,0.02h,Stop Loss,$-9.00,$553.50,$66221.00,53,$553.50
2024-03-14,21:00:00,18267.0,BUY,3,1.02h,Stop Loss,$-9.00,$544.50,$66212.00,53,$544.50
2024-03-14,22:01:00,18002.25,SELL,3,0.02h,Stop Loss,$-9.00,$535.50,$66203.00,53,$535.50
2024-03-14,22:05:00,18253.0,BUY,3,0.02h,Stop Loss,$-9.00,$526.50,$66194.00,53,$526.50
2024-03-14,22:09:00,18009.25,SELL,3,0.02h,Stop Loss,$-9.00,$517.50,$66185.00,53,$517.50
2024-03-14,22:17:00,18254.0,BUY,3,0.02h,Stop Loss,$-9.00,$508.50,$66176.00,53,$508.50
2024-03-14,22:18:00,18006.25,SELL,3,0.02h,Stop Loss,$3.00,$511.50,$66179.00,53,$511.50
2024-03-14,22:22:00,18251.75,BUY,3,0.02h,Stop Loss,$-9.00,$502.50,$66170.00,53,$502.50
2024-03-14,22:28:00,18006.75,SELL,3,0.02h,Stop Loss,$-9.00,$493.50,$66161.00,53,$493.50
2024-03-14,22:29:00,18259.0,BUY,3,0.02h,Break Even,$-1.50,$492.00,$66159.50,53,$492.00
2024-03-14,22:32:00,18007.25,SELL,3,0.02h,Stop Loss,$-9.00,$483.00,$66150.50,53,$483.00
2024-03-14,22:38:00,18257.25,BUY,3,0.02h,Break Even,$-1.50,$481.50,$66149.00,53,$481.50
2024-03-14,22:41:00,18005.25,SELL,3,0.02h,Stop Loss,$-9.00,$472.50,$66140.00,53,$472.50
2024-03-14,22:42:00,18254.75,BUY,3,0.02h,Stop Loss,$-9.00,$463.50,$66131.00,53,$463.50
2024-03-14,22:43:00,18004.25,SELL,3,0.02h,Break Even,$-1.50,$462.00,$66129.50,53,$462.00
2024-03-14,22:52:00,18250.0,BUY,3,0.02h,Break Even,$-1.50,$460.50,$66128.00,53,$460.50
2024-03-14,23:00:00,18001.75,SELL,3,13.00h,Stop Loss,$-9.00,$451.50,$66119.00,53,$451.50
,,,,,,,,,,,
2024-03-15,12:02:00,18272.5,BUY,3,0.02h,Stop Loss,$-9.00,$-9.00,$66110.00,54,$-9.00
2024-03-15,12:03:00,18029.75,SELL,3,0.02h,Stop Loss,$-9.00,$-18.00,$66101.00,54,$-18.00
2024-03-15,12:04:00,18276.75,BUY,3,0.02h,Stop Loss,$-9.00,$-27.00,$66092.00,54,$-27.00
2024-03-15,12:17:00,18006.5,SELL,3,0.02h,Stop Loss,$-9.00,$-36.00,$66083.00,54,$-36.00
2024-03-15,12:22:00,18256.25,BUY,3,0.02h,Stop Loss,$-9.00,$-45.00,$66074.00,54,$-45.00
2024-03-15,12:23:00,18008.0,SELL,3,0.02h,Stop Loss,$-9.00,$-54.00,$66065.00,54,$-54.00
2024-03-15,12:24:00,18250.75,BUY,3,0.02h,Stop Loss,$4.50,$-49.50,$66069.50,54,$-49.50
2024-03-15,12:26:00,18009.0,SELL,3,0.02h,Stop Loss,$-9.00,$-58.50,$66060.50,54,$-58.50
2024-03-15,12:39:00,18259.0,BUY,3,0.02h,Break Even,$-1.50,$-60.00,$66059.00,54,$-60.00
2024-03-15,12:45:00,18000.25,SELL,3,0.02h,Stop Loss,$60.00,$0.00,$66119.00,54,$0.00
2024-03-15,12:51:00,18251.25,BUY,3,0.02h,Stop Loss,$-9.00,$-9.00,$66110.00,54,$-9.00
2024-03-15,12:53:00,18004.75,SELL,3,0.02h,Stop Loss,$-9.00,$-18.00,$66101.00,54,$-18.00
2024-03-15,12:56:00,18258.25,BUY,3,0.02h,Stop Loss,$4.50,$-13.50,$66105.50,54,$-13.50
2024-03-15,13:02:00,17998.0,SELL,3,0.02h,Stop Loss,$12.00,$-1.50,$66117.50,54,$-1.50
2024-03-15,13:04:00,18240.75,BUY,3,0.02h,Stop Loss,$-9.00,$-10.50,$66108.50,54,$-10.50
2024-03-15,13:05:00,18000.0,SELL,3,0.02h,Stop Loss,$15.00,$4.50,$66123.50,54,$4.50
2024-03-15,13:07:00,18236.25,BUY,3,0.02h,Stop Loss,$-9.00,$-4.50,$66114.50,54,$-4.50
2024-03-15,13:08:00,17988.75,SELL,3,0.02h,Stop Loss,$-9.00,$-13.50,$66105.50,54,$-13.50
2024-03-15,13:09:00,18228.5,BUY,3,0.02h,Stop Loss,$24.00,$10.50,$66129.50,54,$10.50
2024-03-15,13:24:00,17952.0,SELL,3,0.02h,Stop Loss,$18.00,$28.50,$66147.50,54,$28.50
2024-03-15,13:34:00,18141.25,BUY,3,0.02h,Stop Loss,$115.50,$144.00,$66263.00,54,$144.00
2024-03-15,13:43:00,18099.25,SELL,3,0.02h,Stop Loss,$34.50,$178.50,$66297.50,54,$178.50
2024-03-15,13:56:00,18127.25,BUY,3,0.02h,Stop Loss,$-9.00,$169.50,$66288.50,54,$169.50
2024-03-15,13:57:00,18098.75,SELL,3,0.02h,Stop Loss,$30.00,$199.50,$66318.50,54,$199.50
2024-03-15,14:16:00,18110.75,BUY,3,0.02h,Break Even,$-1.50,$198.00,$66317.00,54,$198.00
2024-03-15,14:59:00,18128.5,SELL,3,0.02h,Stop Loss,$30.00,$228.00,$66347.00,54,$228.00
2024-03-15,16:33:00,18067.75,BUY,3,0.02h,Stop Loss,$-9.00,$219.00,$66338.00,54,$219.00
2024-03-15,16:49:00,18045.0,SELL,3,0.02h,Stop Loss,$27.00,$246.00,$66365.00,54,$246.00
2024-03-15,17:11:00,18035.5,BUY,3,0.02h,Stop Loss,$64.50,$310.50,$66429.50,54,$310.50
2024-03-15,17:49:00,18044.0,SELL,3,0.02h,Stop Loss,$22.50,$333.00,$66452.00,54,$333.00
2024-03-15,17:55:00,18068.5,BUY,3,0.02h,Stop Loss,$51.00,$384.00,$66503.00,54,$384.00
2024-03-15,18:14:00,18059.75,SELL,3,0.02h,Stop Loss,$16.50,$400.50,$66519.50,54,$400.50
2024-03-15,18:34:00,18071.25,BUY,3,0.02h,Break Even,$-1.50,$399.00,$66518.00,54,$399.00
2024-03-15,19:10:00,18071.75,SELL,3,0.02h,Stop Loss,$9.00,$408.00,$66527.00,54,$408.00
2024-03-15,19:27:00,18087.5,BUY,3,0.02h,Stop Loss,$42.00,$450.00,$66569.00,54,$450.00
2024-03-15,19:39:00,18068.75,SELL,3,0.02h,Break Even,$-1.50,$448.50,$66567.50,54,$448.50
2024-03-15,20:05:00,18069.5,BUY,3,0.02h,Break Even,$-1.50,$447.00,$66566.00,54,$447.00
2024-03-15,20:22:00,18066.25,SELL,3,0.02h,Stop Loss,$-9.00,$438.00,$66557.00,54,$438.00
2024-03-15,20:25:00,18073.75,BUY,3,0.03h,Stop Loss,$22.50,$460.50,$66579.50,54,$460.50
2024-03-15,20:38:00,18068.75,SELL,3,0.02h,Break Even,$-1.50,$459.00,$66578.00,54,$459.00
,,,,,,,,,,,
2024-03-18,12:00:00,18262.75,BUY,3,0.02h,Stop Loss,$3.00,$3.00,$66581.00,55,$3.00
2024-03-18,12:54:00,18264.0,SELL,3,0.02h,Stop Loss,$-9.00,$-6.00,$66572.00,55,$-6.00
2024-03-18,12:58:00,18275.0,BUY,3,0.02h,Stop Loss,$-9.00,$-15.00,$66563.00,55,$-15.00
2024-03-18,13:24:00,18277.0,SELL,3,0.02h,Stop Loss,$-9.00,$-24.00,$66554.00,55,$-24.00
2024-03-18,13:31:00,18294.75,BUY,3,0.02h,Stop Loss,$103.50,$79.50,$66657.50,55,$79.50
2024-03-18,13:57:00,18314.25,SELL,3,0.02h,Stop Loss,$126.00,$205.50,$66783.50,55,$205.50
2024-03-18,14:09:00,18333.25,BUY,3,0.02h,Break Even,$-1.50,$204.00,$66782.00,55,$204.00
2024-03-18,14:52:00,18353.75,SELL,3,0.02h,Break Even,$-1.50,$202.50,$66780.50,55,$202.50
2024-03-18,16:11:00,18301.75,BUY,3,0.02h,Break Even,$-1.50,$201.00,$66779.00,55,$201.00
2024-03-18,16:27:00,18291.5,SELL,3,0.02h,Break Even,$-1.50,$199.50,$66777.50,55,$199.50
2024-03-18,16:45:00,18298.5,BUY,3,0.02h,Stop Loss,$-9.00,$190.50,$66768.50,55,$190.50
2024-03-18,16:50:00,18282.5,SELL,3,0.02h,Stop Loss,$123.00,$313.50,$66891.50,55,$313.50
2024-03-18,17:22:00,18274.0,BUY,3,0.02h,Break Even,$-1.50,$312.00,$66890.00,55,$312.00
2024-03-18,17:39:00,18254.25,SELL,3,0.02h,Stop Loss,$12.00,$324.00,$66902.00,55,$324.00
2024-03-18,17:59:00,18274.0,BUY,3,0.02h,Break Even,$-1.50,$322.50,$66900.50,55,$322.50
2024-03-18,18:42:00,18278.5,SELL,3,0.02h,Stop Loss,$123.00,$445.50,$67023.50,55,$445.50
2024-03-18,19:08:00,18289.5,BUY,3,0.02h,Stop Loss,$24.00,$469.50,$67047.50,55,$469.50
2024-03-18,19:26:00,18280.0,SELL,3,0.02h,Break Even,$-1.50,$468.00,$67046.00,55,$468.00
2024-03-18,19:35:00,18286.75,BUY,3,0.02h,Stop Loss,$-9.00,$459.00,$67037.00,55,$459.00
2024-03-18,19:37:00,18277.75,SELL,3,0.02h,Stop Loss,$7.50,$466.50,$67044.50,55,$466.50
2024-03-18,20:29:00,18232.5,BUY,3,0.02h,Stop Loss,$43.50,$510.00,$67088.00,55,$510.00
2024-03-18,20:40:00,18226.0,SELL,3,0.02h,Break Even,$-1.50,$508.50,$67086.50,55,$508.50
,,,,,,,,,,,
2024-03-19,12:38:00,18114.0,BUY,3,0.02h,Stop Loss,$-9.00,$-9.00,$67077.50,56,$-9.00
2024-03-19,13:32:00,18116.5,SELL,3,0.02h,Break Even,$-1.50,$-10.50,$67076.00,56,$-10.50
2024-03-19,14:01:00,18099.0,BUY,3,0.02h,Stop Loss,$39.00,$28.50,$67115.00,56,$28.50
2024-03-19,14:18:00,18093.0,SELL,3,0.02h,Stop Loss,$37.50,$66.00,$67152.50,56,$66.00
2024-03-19,14:36:00,18105.75,BUY,3,0.02h,Break Even,$-1.50,$64.50,$67151.00,56,$64.50
2024-03-19,15:04:00,18117.0,SELL,3,0.02h,Stop Loss,$-9.00,$55.50,$67142.00,56,$55.50
2024-03-19,15:05:00,18129.0,BUY,3,0.02h,Stop Loss,$55.50,$111.00,$67197.50,56,$111.00
2024-03-19,15:21:00,18118.0,SELL,3,0.02h,Break Even,$-1.50,$109.50,$67196.00,56,$109.50
2024-03-19,15:30:00,18131.25,BUY,3,0.02h,Stop Loss,$40.50,$150.00,$67236.50,56,$150.00
2024-03-19,15:55:00,18135.75,SELL,3,0.02h,Break Even,$-1.50,$148.50,$67235.00,56,$148.50
2024-03-19,16:00:00,18158.75,BUY,3,0.02h,Break Even,$-1.50,$147.00,$67233.50,56,$147.00
2024-03-19,17:16:00,18235.5,SELL,3,0.02h,Break Even,$-1.50,$145.50,$67232.00,56,$145.50
2024-03-19,17:28:00,18254.75,BUY,3,0.02h,Break Even,$-1.50,$144.00,$67230.50,56,$144.00
2024-03-19,17:55:00,18253.25,SELL,3,0.02h,Stop Loss,$6.00,$150.00,$67236.50,56,$150.00
2024-03-19,18:16:00,18271.0,BUY,3,0.02h,Stop Loss,$19.50,$169.50,$67256.00,56,$169.50
2024-03-19,18:56:00,18255.5,SELL,3,0.02h,Stop Loss,$-9.00,$160.50,$67247.00,56,$160.50
2024-03-19,19:38:00,18241.0,BUY,3,0.02h,Stop Loss,$15.00,$175.50,$67262.00,56,$175.50
2024-03-19,20:21:00,18269.25,SELL,3,0.02h,Break Even,$-1.50,$174.00,$67260.50,56,$174.00
2024-03-19,20:35:00,18272.25,BUY,3,0.02h,Break Even,$-1.50,$172.50,$67259.00,56,$172.50
2024-03-19,20:56:00,18274.0,SELL,3,0.02h,Break Even,$-1.50,$171.00,$67257.50,56,$171.00
2024-03-19,22:22:00,18275.25,BUY,3,0.02h,Stop Loss,$-9.00,$162.00,$67248.50,56,$162.00
2024-03-19,22:32:00,18269.25,SELL,3,0.02h,Stop Loss,$-9.00,$153.00,$67239.50,56,$153.00
2024-03-19,22:47:00,18275.5,BUY,3,0.02h,Stop Loss,$-9.00,$144.00,$67230.50,56,$144.00
,,,,,,,,,,,
2024-03-20,12:19:00,18297.5,SELL,3,0.02h,Break Even,$-1.50,$-1.50,$67229.00,57,$-1.50
2024-03-20,12:29:00,18310.75,BUY,3,0.02h,Stop Loss,$-9.00,$-10.50,$67220.00,57,$-10.50
2024-03-20,12:41:00,18295.5,SELL,3,0.02h,Stop Loss,$54.00,$43.50,$67274.00,57,$43.50
2024-03-20,13:10:00,18302.5,BUY,3,0.02h,Stop Loss,$-9.00,$34.50,$67265.00,57,$34.50
2024-03-20,13:12:00,18293.75,SELL,3,0.02h,Break Even,$-1.50,$33.00,$67263.50,57,$33.00
2024-03-20,13:19:00,18302.25,BUY,3,0.02h,Stop Loss,$6.00,$39.00,$67269.50,57,$39.00
2024-03-20,13:38:00,18280.5,SELL,3,0.02h,Break Even,$-1.50,$37.50,$67268.00,57,$37.50
2024-03-20,14:24:00,18278.5,BUY,3,0.02h,Stop Loss,$28.50,$66.00,$67296.50,57,$66.00
2024-03-20,14:38:00,18265.0,SELL,3,0.02h,Break Even,$-1.50,$64.50,$67295.00,57,$64.50
2024-03-20,15:03:00,18270.75,BUY,3,0.02h,Stop Loss,$6.00,$70.50,$67301.00,57,$70.50
2024-03-20,15:35:00,18278.5,SELL,3,0.02h,Stop Loss,$-9.00,$61.50,$67292.00,57,$61.50
2024-03-20,15:56:00,18279.75,BUY,3,0.02h,Stop Loss,$9.00,$70.50,$67301.00,57,$70.50
2024-03-20,16:09:00,18268.0,SELL,3,0.02h,Break Even,$-1.50,$69.00,$67299.50,57,$69.00
2024-03-20,16:26:00,18275.25,BUY,3,0.02h,Stop Loss,$21.00,$90.00,$67320.50,57,$90.00
2024-03-20,16:34:00,18262.75,SELL,3,0.02h,Stop Loss,$-9.00,$81.00,$67311.50,57,$81.00
2024-03-20,16:38:00,18273.75,BUY,3,0.02h,Stop Loss,$18.00,$99.00,$67329.50,57,$99.00
2024-03-20,17:10:00,18277.25,SELL,3,0.02h,Break Even,$-1.50,$97.50,$67328.00,57,$97.50
2024-03-20,17:52:00,18269.25,BUY,3,0.02h,Stop Loss,$-9.00,$88.50,$67319.00,57,$88.50
2024-03-20,18:35:00,18297.75,SELL,3,0.02h,Stop Loss,$46.50,$135.00,$67365.50,57,$135.00
2024-03-20,18:40:00,18366.5,BUY,3,0.02h,Stop Loss,$46.50,$181.50,$67412.00,57,$181.50
2024-03-20,19:44:00,18458.75,SELL,3,0.02h,Stop Loss,$39.00,$220.50,$67451.00,57,$220.50
2024-03-20,19:58:00,18474.25,BUY,3,0.02h,Stop Loss,$16.50,$237.00,$67467.50,57,$237.00
2024-03-20,22:01:00,18532.0,SELL,3,0.02h,Stop Loss,$10.50,$247.50,$67478.00,57,$247.50
2024-03-20,22:08:00,18543.25,BUY,3,0.02h,Break Even,$-1.50,$246.00,$67476.50,57,$246.00
2024-03-20,22:25:00,18536.75,SELL,3,0.02h,Stop Loss,$-9.00,$237.00,$67467.50,57,$237.00
2024-03-20,22:38:00,18545.75,BUY,3,0.02h,Stop Loss,$-9.00,$228.00,$67458.50,57,$228.00
,,,,,,,,,,,
2024-03-21,12:39:00,18647.25,SELL,3,0.02h,Stop Loss,$-9.00,$-9.00,$67449.50,58,$-9.00
2024-03-21,12:41:00,18657.0,BUY,3,0.02h,Break Even,$-1.50,$-10.50,$67448.00,58,$-10.50
2024-03-21,12:45:00,18651.25,SELL,3,0.02h,Stop Loss,$-9.00,$-19.50,$67439.00,58,$-19.50
2024-03-21,12:49:00,18654.75,BUY,3,0.02h,Stop Loss,$9.00,$-10.50,$67448.00,58,$-10.50
2024-03-21,13:05:00,18653.25,SELL,3,0.02h,Stop Loss,$-9.00,$-19.50,$67439.00,58,$-19.50
2024-03-21,13:20:00,18657.0,BUY,3,0.02h,Break Even,$-1.50,$-21.00,$67437.50,58,$-21.00
2024-03-21,13:49:00,18644.75,SELL,3,0.02h,Stop Loss,$21.00,$0.00,$67458.50,58,$0.00
2024-03-21,14:11:00,18653.75,BUY,3,0.02h,Stop Loss,$3.00,$3.00,$67461.50,58,$3.00
2024-03-21,14:18:00,18643.75,SELL,3,0.02h,Break Even,$-1.50,$1.50,$67460.00,58,$1.50
2024-03-21,14:20:00,18661.75,BUY,3,0.02h,Stop Loss,$13.50,$15.00,$67473.50,58,$15.00
2024-03-21,14:32:00,18637.5,SELL,3,0.02h,Stop Loss,$30.00,$45.00,$67503.50,58,$45.00
2024-03-21,14:49:00,18664.5,BUY,3,0.02h,Stop Loss,$7.50,$52.50,$67511.00,58,$52.50
2024-03-21,15:00:00,18643.5,SELL,3,0.02h,Stop Loss,$-9.00,$43.50,$67502.00,58,$43.50
2024-03-21,15:02:00,18661.75,BUY,3,0.02h,Break Even,$-1.50,$42.00,$67500.50,58,$42.00
2024-03-21,15:04:00,18641.0,SELL,3,0.02h,Stop Loss,$7.50,$49.50,$67508.00,58,$49.50
2024-03-21,15:22:00,18648.75,BUY,3,0.02h,Stop Loss,$31.50,$81.00,$67539.50,58,$81.00
2024-03-21,16:38:00,18688.5,SELL,3,0.02h,Break Even,$-1.50,$79.50,$67538.00,58,$79.50
2024-03-21,16:57:00,18695.0,BUY,3,0.02h,Stop Loss,$-9.00,$70.50,$67529.00,58,$70.50
2024-03-21,17:00:00,18689.0,SELL,3,0.02h,Stop Loss,$3.00,$73.50,$67532.00,58,$73.50
2024-03-21,18:27:00,18616.0,BUY,3,0.02h,Break Even,$-1.50,$72.00,$67530.50,58,$72.00
2024-03-21,18:35:00,18594.5,SELL,3,0.02h,Stop Loss,$112.50,$184.50,$67643.00,58,$184.50
2024-03-21,19:11:00,18585.0,BUY,3,0.02h,Stop Loss,$10.50,$195.00,$67653.50,58,$195.00
2024-03-21,19:27:00,18579.25,SELL,3,0.02h,Stop Loss,$6.00,$201.00,$67659.50,58,$201.00
2024-03-21,19:30:00,18586.5,BUY,3,0.02h,Stop Loss,$31.50,$232.50,$67691.00,58,$232.50
2024-03-21,19:35:00,18578.5,SELL,3,0.02h,Stop Loss,$22.50,$255.00,$67713.50,58,$255.00
2024-03-21,19:45:00,18590.5,BUY,3,0.02h,Break Even,$-1.50,$253.50,$67712.00,58,$253.50
2024-03-21,19:48:00,18578.75,SELL,3,0.02h,Stop Loss,$43.50,$297.00,$67755.50,58,$297.00
2024-03-21,20:14:00,18576.5,BUY,3,0.02h,Stop Loss,$-9.00,$288.00,$67746.50,58,$288.00
2024-03-21,20:37:00,18575.25,SELL,3,0.02h,Break Even,$-1.50,$286.50,$67745.00,58,$286.50
2024-03-21,20:58:00,18580.25,BUY,3,0.02h,Stop Loss,$-9.00,$277.50,$67736.00,58,$277.50
2024-03-21,22:10:00,18570.0,SELL,3,0.02h,Stop Loss,$-9.00,$268.50,$67727.00,58,$268.50
2024-03-21,22:34:00,18579.25,BUY,3,0.03h,Break Even,$-1.50,$267.00,$67725.50,58,$267.00
,,,,,,,,,,,
2024-03-22,12:00:00,18510.5,SELL,3,0.02h,Break Even,$-1.50,$-1.50,$67724.00,59,$-1.50
2024-03-22,12:44:00,18519.5,BUY,3,0.02h,Stop Loss,$7.50,$6.00,$67731.50,59,$6.00
2024-03-22,13:23:00,18525.0,SELL,3,0.02h,Stop Loss,$-9.00,$-3.00,$67722.50,59,$-3.00
2024-03-22,13:32:00,18544.0,BUY,3,0.02h,Stop Loss,$-9.00,$-12.00,$67713.50,59,$-12.00
2024-03-22,13:33:00,18528.0,SELL,3,0.02h,Stop Loss,$45.00,$33.00,$67758.50,59,$33.00
2024-03-22,13:55:00,18538.0,BUY,3,0.02h,Stop Loss,$10.50,$43.50,$67769.00,59,$43.50
2024-03-22,14:16:00,18529.25,SELL,3,0.02h,Stop Loss,$-9.00,$34.50,$67760.00,59,$34.50
2024-03-22,14:21:00,18544.5,BUY,3,0.02h,Stop Loss,$-9.00,$25.50,$67751.00,59,$25.50
2024-03-22,14:23:00,18525.75,SELL,3,0.02h,Stop Loss,$10.50,$36.00,$67761.50,59,$36.00
2024-03-22,15:03:00,18532.0,BUY,3,0.02h,Stop Loss,$21.00,$57.00,$67782.50,59,$57.00
2024-03-22,15:43:00,18543.25,SELL,3,0.02h,Stop Loss,$-9.00,$48.00,$67773.50,59,$48.00
2024-03-22,15:51:00,18553.5,BUY,3,0.02h,Break Even,$-1.50,$46.50,$67772.00,59,$46.50
2024-03-22,16:09:00,18546.0,SELL,3,0.02h,Stop Loss,$-9.00,$37.50,$67763.00,59,$37.50
2024-03-22,16:12:00,18555.5,BUY,3,0.02h,Stop Loss,$-9.00,$28.50,$67754.00,59,$28.50
2024-03-22,16:13:00,18549.75,SELL,3,0.02h,Stop Loss,$10.50,$39.00,$67764.50,59,$39.00
2024-03-22,16:27:00,18553.0,BUY,3,0.02h,Stop Loss,$-9.00,$30.00,$67755.50,59,$30.00
2024-03-22,16:35:00,18536.0,SELL,3,0.02h,Break Even,$-1.50,$28.50,$67754.00,59,$28.50
2024-03-22,16:44:00,18553.0,BUY,3,0.02h,Break Even,$-1.50,$27.00,$67752.50,59,$27.00
2024-03-22,17:42:00,18591.5,SELL,3,0.02h,Stop Loss,$-9.00,$18.00,$67743.50,59,$18.00
2024-03-22,17:45:00,18602.75,BUY,3,0.02h,Break Even,$-1.50,$16.50,$67742.00,59,$16.50
2024-03-22,18:12:00,18612.0,SELL,3,0.02h,Stop Loss,$-9.00,$7.50,$67733.00,59,$7.50
2024-03-22,18:30:00,18609.5,BUY,3,0.02h,Break Even,$-1.50,$6.00,$67731.50,59,$6.00
2024-03-22,18:34:00,18599.0,SELL,3,0.02h,Stop Loss,$-9.00,$-3.00,$67722.50,59,$-3.00
2024-03-22,18:35:00,18606.75,BUY,3,0.02h,Break Even,$-1.50,$-4.50,$67721.00,59,$-4.50
2024-03-22,18:42:00,18597.75,SELL,3,0.02h,Stop Loss,$-9.00,$-13.50,$67712.00,59,$-13.50
2024-03-22,19:37:00,18580.5,BUY,3,0.02h,Break Even,$-1.50,$-15.00,$67710.50,59,$-15.00
2024-03-22,20:01:00,18569.25,SELL,3,0.02h,Stop Loss,$9.00,$-6.00,$67719.50,59,$-6.00
2024-03-22,20:48:00,18562.75,BUY,3,0.03h,Break Even,$-1.50,$-7.50,$67718.00,59,$-7.50
,,,,,,,,,,,
2024-03-25,12:00:00,18470.25,SELL,3,0.02h,Stop Loss,$25.50,$25.50,$67743.50,60,$25.50
2024-03-25,12:48:00,18482.5,BUY,3,0.02h,Break Even,$-1.50,$24.00,$67742.00,60,$24.00
2024-03-25,12:55:00,18479.0,SELL,3,0.02h,Break Even,$-1.50,$22.50,$67740.50,60,$22.50
2024-03-25,13:18:00,18477.75,BUY,3,0.02h,Break Even,$-1.50,$21.00,$67739.00,60,$21.00
2024-03-25,13:22:00,18474.0,SELL,3,0.02h,Stop Loss,$19.50,$40.50,$67758.50,60,$40.50
2024-03-25,13:52:00,18480.25,BUY,3,0.02h,Stop Loss,$6.00,$46.50,$67764.50,60,$46.50
2024-03-25,14:47:00,18511.25,SELL,3,0.02h,Stop Loss,$24.00,$70.50,$67788.50,60,$70.50
2024-03-25,14:59:00,18519.75,BUY,3,0.02h,Break Even,$-1.50,$69.00,$67787.00,60,$69.00
2024-03-25,15:26:00,18520.0,SELL,3,0.02h,Stop Loss,$12.00,$81.00,$67799.00,60,$81.00
2024-03-25,15:38:00,18531.0,BUY,3,0.02h,Stop Loss,$10.50,$91.50,$67809.50,60,$91.50
2024-03-25,16:03:00,18530.75,SELL,3,0.02h,Stop Loss,$27.00,$118.50,$67836.50,60,$118.50
2024-03-25,16:22:00,18533.5,BUY,3,0.02h,Stop Loss,$-9.00,$109.50,$67827.50,60,$109.50
2024-03-25,16:23:00,18527.25,SELL,3,0.02h,Break Even,$-1.50,$108.00,$67826.00,60,$108.00
2024-03-25,16:47:00,18528.25,BUY,3,0.02h,Break Even,$-1.50,$106.50,$67824.50,60,$106.50
2024-03-25,16:51:00,18519.5,SELL,3,0.02h,Break Even,$-1.50,$105.00,$67823.00,60,$105.00
2024-03-25,16:52:00,18526.0,BUY,3,0.02h,Stop Loss,$12.00,$117.00,$67835.00,60,$117.00
2024-03-25,17:09:00,18524.75,SELL,3,0.02h,Stop Loss,$-9.00,$108.00,$67826.00,60,$108.00
2024-03-25,17:15:00,18534.0,BUY,3,0.02h,Break Even,$-1.50,$106.50,$67824.50,60,$106.50
2024-03-25,18:30:00,18558.75,SELL,3,0.02h,Break Even,$-1.50,$105.00,$67823.00,60,$105.00
2024-03-25,18:41:00,18560.25,BUY,3,0.02h,Break Even,$-1.50,$103.50,$67821.50,60,$103.50
2024-03-25,19:04:00,18558.0,SELL,3,0.02h,Stop Loss,$3.00,$106.50,$67824.50,60,$106.50
2024-03-25,19:41:00,18544.25,BUY,3,0.02h,Stop Loss,$15.00,$121.50,$67839.50,60,$121.50
2024-03-25,19:52:00,18531.25,SELL,3,0.02h,Stop Loss,$18.00,$139.50,$67857.50,60,$139.50
2024-03-25,20:25:00,18520.25,BUY,3,0.05h,Stop Loss,$-9.00,$130.50,$67848.50,60,$130.50
2024-03-25,22:33:00,18535.0,SELL,3,0.02h,Break Even,$-1.50,$129.00,$67847.00,60,$129.00
,,,,,,,,,,,
2024-03-26,12:00:00,18614.0,BUY,3,0.02h,Break Even,$-1.50,$-1.50,$67845.50,61,$-1.50
2024-03-26,12:35:00,18588.25,SELL,3,0.02h,Stop Loss,$39.00,$37.50,$67884.50,61,$37.50
2024-03-26,13:29:00,18569.25,BUY,3,0.02h,Break Even,$-1.50,$36.00,$67883.00,61,$36.00
2024-03-26,14:25:00,18587.75,SELL,3,0.02h,Stop Loss,$36.00,$72.00,$67919.00,61,$72.00
2024-03-26,14:59:00,18558.5,BUY,3,0.02h,Stop Loss,$18.00,$90.00,$67937.00,61,$90.00
2024-03-26,15:41:00,18560.5,SELL,3,0.02h,Stop Loss,$-9.00,$81.00,$67928.00,61,$81.00
2024-03-26,15:53:00,18576.5,BUY,3,0.02h,Stop Loss,$-9.00,$72.00,$67919.00,61,$72.00
2024-03-26,16:14:00,18572.5,SELL,3,0.02h,Break Even,$-1.50,$70.50,$67917.50,61,$70.50
2024-03-26,17:09:00,18549.75,BUY,3,0.02h,Break Even,$-1.50,$69.00,$67916.00,61,$69.00
2024-03-26,17:21:00,18545.25,SELL,3,0.02h,Break Even,$-1.50,$67.50,$67914.50,61,$67.50
2024-03-26,17:31:00,18552.25,BUY,3,0.02h,Break Even,$-1.50,$66.00,$67913.00,61,$66.00
2024-03-26,17:45:00,18541.25,SELL,3,0.02h,Stop Loss,$40.50,$106.50,$67953.50,61,$106.50
2024-03-26,18:03:00,18548.0,BUY,3,0.02h,Stop Loss,$-9.00,$97.50,$67944.50,61,$97.50
2024-03-26,18:42:00,18548.25,SELL,3,0.02h,Stop Loss,$13.50,$111.00,$67958.00,61,$111.00
2024-03-26,18:57:00,18556.25,BUY,3,0.02h,Break Even,$-1.50,$109.50,$67956.50,61,$109.50
2024-03-26,19:04:00,18546.25,SELL,3,0.02h,Break Even,$-1.50,$108.00,$67955.00,61,$108.00
2024-03-26,20:14:00,18470.5,BUY,3,0.02h,Break Even,$-1.50,$106.50,$67953.50,61,$106.50
2024-03-26,20:53:00,18477.25,SELL,3,0.02h,Break Even,$-1.50,$105.00,$67952.00,61,$105.00
2024-03-26,20:57:00,18481.75,BUY,3,0.02h,Stop Loss,$-9.00,$96.00,$67943.00,61,$96.00
2024-03-26,22:01:00,18474.75,SELL,3,0.02h,Break Even,$-1.50,$94.50,$67941.50,61,$94.50
2024-03-26,22:19:00,18477.5,BUY,3,0.02h,Stop Loss,$-9.00,$85.50,$67932.50,61,$85.50
2024-03-26,22:21:00,18476.5,SELL,3,0.02h,Break Even,$-1.50,$84.00,$67931.00,61,$84.00
2024-03-26,22:53:00,18476.5,BUY,3,0.02h,Break Even,$-1.50,$82.50,$67929.50,61,$82.50
,,,,,,,,,,,
2024-03-27,13:33:00,18536.25,SELL,3,0.02h,Stop Loss,$75.00,$75.00,$68004.50,62,$75.00
2024-03-27,14:35:00,18432.25,BUY,3,0.02h,Stop Loss,$-9.00,$66.00,$67995.50,62,$66.00
2024-03-27,14:49:00,18422.0,SELL,3,0.02h,Stop Loss,$88.50,$154.50,$68084.00,62,$154.50
2024-03-27,15:18:00,18428.0,BUY,3,0.02h,Break Even,$-1.50,$153.00,$68082.50,62,$153.00
2024-03-27,15:25:00,18411.5,SELL,3,0.02h,Stop Loss,$3.00,$156.00,$68085.50,62,$156.00
2024-03-27,15:42:00,18421.0,BUY,3,0.02h,Stop Loss,$4.50,$160.50,$68090.00,62,$160.50
2024-03-27,15:54:00,18410.0,SELL,3,0.02h,Stop Loss,$3.00,$163.50,$68093.00,62,$163.50
2024-03-27,16:07:00,18418.75,BUY,3,0.02h,Break Even,$-1.50,$162.00,$68091.50,62,$162.00
2024-03-27,16:13:00,18404.75,SELL,3,0.02h,Stop Loss,$-9.00,$153.00,$68082.50,62,$153.00
2024-03-27,16:18:00,18417.0,BUY,3,0.02h,Stop Loss,$18.00,$171.00,$68100.50,62,$171.00
2024-03-27,17:05:00,18433.25,SELL,3,0.02h,Stop Loss,$16.50,$187.50,$68117.00,62,$187.50
2024-03-27,17:22:00,18432.0,BUY,3,0.02h,Stop Loss,$22.50,$210.00,$68139.50,62,$210.00
2024-03-27,17:29:00,18422.5,SELL,3,0.02h,Stop Loss,$-9.00,$201.00,$68130.50,62,$201.00
2024-03-27,17:32:00,18433.25,BUY,3,0.02h,Break Even,$-1.50,$199.50,$68129.00,62,$199.50
2024-03-27,17:36:00,18423.75,SELL,3,0.02h,Stop Loss,$-9.00,$190.50,$68120.00,62,$190.50
2024-03-27,17:38:00,18430.75,BUY,3,0.02h,Break Even,$-1.50,$189.00,$68118.50,62,$189.00
2024-03-27,17:40:00,18424.75,SELL,3,0.02h,Break Even,$-1.50,$187.50,$68117.00,62,$187.50
2024-03-27,17:46:00,18431.25,BUY,3,0.02h,Break Even,$-1.50,$186.00,$68115.50,62,$186.00
2024-03-27,18:01:00,18428.0,SELL,3,0.02h,Stop Loss,$-9.00,$177.00,$68106.50,62,$177.00
2024-03-27,18:02:00,18434.25,BUY,3,0.02h,Stop Loss,$-9.00,$168.00,$68097.50,62,$168.00
2024-03-27,18:03:00,18427.25,SELL,3,0.02h,Break Even,$-1.50,$166.50,$68096.00,62,$166.50
2024-03-27,18:17:00,18435.5,BUY,3,0.02h,Stop Loss,$36.00,$202.50,$68132.00,62,$202.50
2024-03-27,18:38:00,18434.75,SELL,3,0.02h,Break Even,$-1.50,$201.00,$68130.50,62,$201.00
2024-03-27,19:08:00,18431.5,BUY,3,0.02h,Break Even,$-1.50,$199.50,$68129.00,62,$199.50
2024-03-27,19:10:00,18420.75,SELL,3,0.02h,Stop Loss,$72.00,$271.50,$68201.00,62,$271.50
2024-03-27,19:28:00,18424.75,BUY,3,0.02h,Stop Loss,$96.00,$367.50,$68297.00,62,$367.50
2024-03-27,20:37:00,18513.0,SELL,3,0.07h,Break Even,$-1.50,$366.00,$68295.50,62,$366.00
2024-03-27,22:34:00,18491.0,BUY,3,0.02h,Stop Loss,$-9.00,$357.00,$68286.50,62,$357.00
2024-03-27,22:39:00,18485.75,SELL,3,0.02h,Break Even,$-1.50,$355.50,$68285.00,62,$355.50
,,,,,,,,,,,
2024-03-28,12:01:00,18493.75,BUY,3,0.02h,Stop Loss,$9.00,$9.00,$68294.00,63,$9.00
2024-03-28,12:37:00,18485.0,SELL,3,0.02h,Stop Loss,$-9.00,$0.00,$68285.00,63,$0.00
2024-03-28,12:58:00,18499.25,BUY,3,0.02h,Break Even,$-1.50,$-1.50,$68283.50,63,$-1.50
2024-03-28,13:30:00,18500.0,SELL,3,0.02h,Stop Loss,$96.00,$94.50,$68379.50,63,$94.50
2024-03-28,13:42:00,18501.75,BUY,3,0.02h,Stop Loss,$22.50,$117.00,$68402.00,63,$117.00
2024-03-28,14:09:00,18505.0,SELL,3,0.02h,Stop Loss,$18.00,$135.00,$68420.00,63,$135.00
2024-03-28,14:36:00,18506.25,BUY,3,0.02h,Stop Loss,$31.50,$166.50,$68451.50,63,$166.50
2024-03-28,15:04:00,18498.75,SELL,3,0.02h,Stop Loss,$-9.00,$157.50,$68442.50,63,$157.50
2024-03-28,15:06:00,18514.0,BUY,3,0.02h,Break Even,$-1.50,$156.00,$68441.00,63,$156.00
2024-03-28,15:08:00,18494.25,SELL,3,0.02h,Stop Loss,$3.00,$159.00,$68444.00,63,$159.00
2024-03-28,15:19:00,18503.25,BUY,3,0.02h,Stop Loss,$16.50,$175.50,$68460.50,63,$175.50
2024-03-28,15:37:00,18500.25,SELL,3,0.02h,Stop Loss,$-9.00,$166.50,$68451.50,63,$166.50
2024-03-28,15:51:00,18508.0,BUY,3,0.02h,Stop Loss,$3.00,$169.50,$68454.50,63,$169.50
2024-03-28,16:06:00,18496.75,SELL,3,0.02h,Stop Loss,$79.50,$249.00,$68534.00,63,$249.00
2024-03-28,17:39:00,18470.75,BUY,3,0.02h,Stop Loss,$3.00,$252.00,$68537.00,63,$252.00
2024-03-28,18:01:00,18467.0,SELL,3,0.02h,Stop Loss,$94.50,$346.50,$68631.50,63,$346.50
2024-03-28,18:09:00,18474.0,BUY,3,0.02h,Stop Loss,$-9.00,$337.50,$68622.50,63,$337.50
2024-03-28,18:24:00,18467.5,SELL,3,0.02h,Break Even,$-1.50,$336.00,$68621.00,63,$336.00
2024-03-28,18:29:00,18472.75,BUY,3,0.02h,Break Even,$-1.50,$334.50,$68619.50,63,$334.50
2024-03-28,18:38:00,18468.0,SELL,3,0.02h,Break Even,$-1.50,$333.00,$68618.00,63,$333.00
2024-03-28,18:51:00,18471.25,BUY,3,0.02h,Break Even,$-1.50,$331.50,$68616.50,63,$331.50
2024-03-28,19:37:00,18494.5,SELL,3,0.02h,Stop Loss,$15.00,$346.50,$68631.50,63,$346.50
2024-03-28,20:58:00,18461.25,BUY,3,0.02h,Break Even,$-1.50,$345.00,$68630.00,63,$345.00
,,,,,,,,,,,
2024-04-01,12:34:00,18503.25,SELL,3,0.02h,Stop Loss,$42.00,$42.00,$68672.00,64,$42.00
2024-04-01,12:38:00,18509.0,BUY,3,0.02h,Stop Loss,$-9.00,$33.00,$68663.00,64,$33.00
2024-04-01,13:02:00,18506.25,SELL,3,0.02h,Stop Loss,$-9.00,$24.00,$68654.00,64,$24.00
2024-04-01,13:33:00,18515.5,BUY,3,0.02h,Stop Loss,$123.00,$147.00,$68777.00,64,$147.00
2024-04-01,14:05:00,18550.75,SELL,3,0.02h,Stop Loss,$4.50,$151.50,$68781.50,64,$151.50
2024-04-01,14:14:00,18584.75,BUY,3,0.02h,Break Even,$-1.50,$150.00,$68780.00,64,$150.00
2024-04-01,14:17:00,18574.5,SELL,3,0.02h,Stop Loss,$39.00,$189.00,$68819.00,64,$189.00
2024-04-01,15:30:00,18470.75,BUY,3,0.02h,Stop Loss,$-9.00,$180.00,$68810.00,64,$180.00
2024-04-01,15:40:00,18453.5,SELL,3,0.02h,Break Even,$-1.50,$178.50,$68808.50,64,$178.50
2024-04-01,15:50:00,18468.5,BUY,3,0.02h,Stop Loss,$-9.00,$169.50,$68799.50,64,$169.50
2024-04-01,15:52:00,18448.5,SELL,3,0.02h,Stop Loss,$28.50,$198.00,$68828.00,64,$198.00
2024-04-01,16:07:00,18455.25,BUY,3,0.02h,Stop Loss,$21.00,$219.00,$68849.00,64,$219.00
2024-04-01,16:58:00,18478.0,SELL,3,0.02h,Stop Loss,$15.00,$234.00,$68864.00,64,$234.00
2024-04-01,17:39:00,18452.5,BUY,3,0.02h,Stop Loss,$-9.00,$225.00,$68855.00,64,$225.00
2024-04-01,18:13:00,18454.0,SELL,3,0.02h,Break Even,$-1.50,$223.50,$68853.50,64,$223.50
2024-04-01,18:19:00,18463.0,BUY,3,0.02h,Break Even,$-1.50,$222.00,$68852.00,64,$222.00
2024-04-01,18:58:00,18468.5,SELL,3,0.02h,Stop Loss,$13.50,$235.50,$68865.50,64,$235.50
2024-04-01,19:07:00,18482.5,BUY,3,0.02h,Break Even,$-1.50,$234.00,$68864.00,64,$234.00
2024-04-01,19:27:00,18468.25,SELL,3,0.02h,Break Even,$-1.50,$232.50,$68862.50,64,$232.50
2024-04-01,19:34:00,18479.0,BUY,3,0.02h,Break Even,$-1.50,$231.00,$68861.00,64,$231.00
2024-04-01,19:36:00,18464.75,SELL,3,0.02h,Stop Loss,$21.00,$252.00,$68882.00,64,$252.00
2024-04-01,19:44:00,18478.5,BUY,3,0.02h,Break Even,$-1.50,$250.50,$68880.50,64,$250.50
2024-04-01,20:28:00,18494.75,SELL,3,0.02h,Stop Loss,$-9.00,$241.50,$68871.50,64,$241.50
2024-04-01,20:39:00,18496.75,BUY,3,0.02h,Stop Loss,$-9.00,$232.50,$68862.50,64,$232.50
2024-04-01,22:01:00,18491.5,SELL,3,0.02h,Stop Loss,$24.00,$256.50,$68886.50,64,$256.50
2024-04-01,22:44:00,18483.0,BUY,3,0.02h,Stop Loss,$-9.00,$247.50,$68877.50,64,$247.50
2024-04-01,22:53:00,18478.5,SELL,3,0.02h,Stop Loss,$-9.00,$238.50,$68868.50,64,$238.50
,,,,,,,,,,,
2024-04-02,12:33:00,18410.0,BUY,3,0.02h,Stop Loss,$-9.00,$-9.00,$68859.50,65,$-9.00
2024-04-02,12:34:00,18400.75,SELL,3,0.02h,Stop Loss,$9.00,$0.00,$68868.50,65,$0.00
2024-04-02,14:04:00,18266.0,BUY,3,0.02h,Stop Loss,$37.50,$37.50,$68906.00,65,$37.50
2024-04-02,14:09:00,18243.75,SELL,3,0.02h,Stop Loss,$6.00,$43.50,$68912.00,65,$43.50
2024-04-02,14:26:00,18245.5,BUY,3,0.02h,Break Even,$-1.50,$42.00,$68910.50,65,$42.00
2024-04-02,14:49:00,18225.5,SELL,3,0.02h,Stop Loss,$22.50,$64.50,$68933.00,65,$64.50
2024-04-02,15:09:00,18233.75,BUY,3,0.02h,Stop Loss,$3.00,$67.50,$68936.00,65,$67.50
2024-04-02,15:46:00,18258.75,SELL,3,0.02h,Stop Loss,$12.00,$79.50,$68948.00,65,$79.50
2024-04-02,16:25:00,18241.75,BUY,3,0.02h,Break Even,$-1.50,$78.00,$68946.50,65,$78.00
2024-04-02,17:18:00,18277.25,SELL,3,0.02h,Stop Loss,$-9.00,$69.00,$68937.50,65,$69.00
2024-04-02,17:47:00,18283.5,BUY,3,0.02h,Break Even,$-1.50,$67.50,$68936.00,65,$67.50
2024-04-02,18:00:00,18277.5,SELL,3,0.02h,Stop Loss,$-9.00,$58.50,$68927.00,65,$58.50
2024-04-02,18:09:00,18288.75,BUY,3,0.02h,Break Even,$-1.50,$57.00,$68925.50,65,$57.00
2024-04-02,18:32:00,18285.5,SELL,3,0.02h,Break Even,$-1.50,$55.50,$68924.00,65,$55.50
2024-04-02,18:34:00,18287.5,BUY,3,0.02h,Break Even,$-1.50,$54.00,$68922.50,65,$54.00
2024-04-02,18:36:00,18283.0,SELL,3,0.02h,Stop Loss,$24.00,$78.00,$68946.50,65,$78.00
2024-04-02,18:44:00,18289.25,BUY,3,0.02h,Stop Loss,$-9.00,$69.00,$68937.50,65,$69.00
2024-04-02,18:46:00,18275.5,SELL,3,0.02h,Stop Loss,$25.50,$94.50,$68963.00,65,$94.50
2024-04-02,18:56:00,18285.75,BUY,3,0.02h,Stop Loss,$-9.00,$85.50,$68954.00,65,$85.50
2024-04-02,18:57:00,18280.0,SELL,3,0.02h,Stop Loss,$-9.00,$76.50,$68945.00,65,$76.50
2024-04-02,19:03:00,18286.25,BUY,3,0.02h,Stop Loss,$24.00,$100.50,$68969.00,65,$100.50
2024-04-02,19:18:00,18281.0,SELL,3,0.02h,Break Even,$-1.50,$99.00,$68967.50,65,$99.00
2024-04-02,19:25:00,18301.75,BUY,3,0.02h,Stop Loss,$10.50,$109.50,$68978.00,65,$109.50
2024-04-02,20:56:00,18341.75,SELL,3,0.02h,Stop Loss,$-9.00,$100.50,$68969.00,65,$100.50
2024-04-02,22:37:00,18333.5,BUY,3,0.03h,Stop Loss,$-9.00,$91.50,$68960.00,65,$91.50
2024-04-02,22:45:00,18330.0,SELL,3,0.02h,Stop Loss,$-9.00,$82.50,$68951.00,65,$82.50
,,,,,,,,,,,
2024-04-03,13:04:00,18273.75,BUY,3,0.02h,Stop Loss,$4.50,$4.50,$68955.50,66,$4.50
2024-04-03,13:12:00,18260.25,SELL,3,0.02h,Stop Loss,$13.50,$18.00,$68969.00,66,$18.00
2024-04-03,13:34:00,18264.75,BUY,3,0.02h,Stop Loss,$30.00,$48.00,$68999.00,66,$48.00
2024-04-03,15:41:00,18437.0,SELL,3,0.02h,Stop Loss,$-9.00,$39.00,$68990.00,66,$39.00
2024-04-03,15:43:00,18446.0,BUY,3,0.02h,Break Even,$-1.50,$37.50,$68988.50,66,$37.50
2024-04-03,15:46:00,18433.25,SELL,3,0.02h,Stop Loss,$-9.00,$28.50,$68979.50,66,$28.50
2024-04-03,16:20:00,18415.25,BUY,3,0.02h,Stop Loss,$13.50,$42.00,$68993.00,66,$42.00
2024-04-03,16:39:00,18374.75,SELL,3,0.02h,Break Even,$-1.50,$40.50,$68991.50,66,$40.50
2024-04-03,16:46:00,18419.25,BUY,3,0.02h,Break Even,$-1.50,$39.00,$68990.00,66,$39.00
2024-04-03,17:03:00,18410.0,SELL,3,0.02h,Break Even,$-1.50,$37.50,$68988.50,66,$37.50
2024-04-03,17:23:00,18419.25,BUY,3,0.02h,Stop Loss,$10.50,$48.00,$68999.00,66,$48.00
2024-04-03,17:39:00,18414.5,SELL,3,0.02h,Stop Loss,$19.50,$67.50,$69018.50,66,$67.50
2024-04-03,17:48:00,18421.0,BUY,3,0.02h,Stop Loss,$3.00,$70.50,$69021.50,66,$70.50
2024-04-03,17:59:00,18415.25,SELL,3,0.02h,Stop Loss,$-9.00,$61.50,$69012.50,66,$61.50
2024-04-03,18:08:00,18427.5,BUY,3,0.02h,Break Even,$-1.50,$60.00,$69011.00,66,$60.00
2024-04-03,18:17:00,18415.75,SELL,3,0.02h,Stop Loss,$13.50,$73.50,$69024.50,66,$73.50
2024-04-03,18:39:00,18422.0,BUY,3,0.02h,Stop Loss,$-9.00,$64.50,$69015.50,66,$64.50
2024-04-03,18:47:00,18408.5,SELL,3,0.02h,Stop Loss,$-9.00,$55.50,$69006.50,66,$55.50
2024-04-03,19:39:00,18362.25,BUY,3,0.02h,Break Even,$-1.50,$54.00,$69005.00,66,$54.00
2024-04-03,20:59:00,18390.25,SELL,3,0.02h,Break Even,$-1.50,$52.50,$69003.50,66,$52.50
2024-04-03,22:28:00,18384.75,BUY,3,0.03h,Break Even,$-1.50,$51.00,$69002.00,66,$51.00
2024-04-03,22:32:00,18382.5,SELL,3,0.02h,Stop Loss,$-9.00,$42.00,$68993.00,66,$42.00
2024-04-03,22:33:00,18384.0,BUY,3,0.02h,Stop Loss,$-9.00,$33.00,$68984.00,66,$33.00
2024-04-03,22:34:00,18382.5,SELL,3,0.02h,Stop Loss,$-9.00,$24.00,$68975.00,66,$24.00
2024-04-03,22:35:00,18385.5,BUY,3,0.02h,Stop Loss,$-9.00,$15.00,$68966.00,66,$15.00
,,,,,,,,,,,
2024-04-04,13:44:00,18541.25,SELL,3,0.02h,Stop Loss,$34.50,$34.50,$69000.50,67,$34.50
2024-04-04,15:02:00,18503.75,BUY,3,0.02h,Break Even,$-1.50,$33.00,$68999.00,67,$33.00
2024-04-04,15:13:00,18486.0,SELL,3,0.02h,Break Even,$-1.50,$31.50,$68997.50,67,$31.50
2024-04-04,15:30:00,18501.75,BUY,3,0.02h,Stop Loss,$19.50,$51.00,$69017.00,67,$51.00
2024-04-04,17:02:00,18550.5,SELL,3,0.02h,Stop Loss,$13.50,$64.50,$69030.50,67,$64.50
2024-04-04,20:42:00,18072.0,BUY,3,0.02h,Break Even,$-1.50,$63.00,$69029.00,67,$63.00
2024-04-04,22:24:00,18079.25,SELL,3,0.02h,Stop Loss,$6.00,$69.00,$69035.00,67,$69.00
2024-04-04,22:33:00,18110.25,BUY,3,0.02h,Break Even,$-1.50,$67.50,$69033.50,67,$67.50
2024-04-04,22:51:00,18099.75,SELL,3,0.02h,Break Even,$-1.50,$66.00,$69032.00,67,$66.00
,,,,,,,,,,,
2024-04-05,12:00:00,18144.25,BUY,3,0.02h,Stop Loss,$21.00,$21.00,$69053.00,68,$21.00
2024-04-05,12:31:00,18109.75,SELL,3,0.02h,Stop Loss,$127.50,$148.50,$69180.50,68,$148.50
2024-04-05,12:39:00,18152.5,BUY,3,0.02h,Stop Loss,$30.00,$178.50,$69210.50,68,$178.50
2024-04-05,12:59:00,18144.75,SELL,3,0.02h,Stop Loss,$31.50,$210.00,$69242.00,68,$210.00
2024-04-05,13:01:00,18161.75,BUY,3,0.02h,Stop Loss,$28.50,$238.50,$69270.50,68,$238.50
2024-04-05,13:05:00,18143.25,SELL,3,0.02h,Stop Loss,$30.00,$268.50,$69300.50,68,$268.50
2024-04-05,13:28:00,18143.0,BUY,3,0.02h,Stop Loss,$24.00,$292.50,$69324.50,68,$292.50
2024-04-05,13:37:00,18127.75,SELL,3,0.02h,Stop Loss,$97.50,$390.00,$69422.00,68,$390.00
2024-04-05,13:43:00,18170.5,BUY,3,0.02h,Stop Loss,$49.50,$439.50,$69471.50,68,$439.50
2024-04-05,14:28:00,18187.75,SELL,3,0.02h,Stop Loss,$-9.00,$430.50,$69462.50,68,$430.50
2024-04-05,14:35:00,18218.75,BUY,3,0.02h,Break Even,$-1.50,$429.00,$69461.00,68,$429.00
2024-04-05,14:36:00,18211.75,SELL,3,0.02h,Break Even,$-1.50,$427.50,$69459.50,68,$427.50
2024-04-05,14:37:00,18218.25,BUY,3,0.02h,Stop Loss,$34.50,$462.00,$69494.00,68,$462.00
2024-04-05,15:15:00,18272.0,SELL,3,0.02h,Stop Loss,$105.00,$567.00,$69599.00,68,$567.00
2024-04-05,15:30:00,18282.75,BUY,3,0.02h,Break Even,$-1.50,$565.50,$69597.50,68,$565.50
2024-04-05,16:30:00,18355.75,SELL,3,0.02h,Stop Loss,$3.00,$568.50,$69600.50,68,$568.50
2024-04-05,16:40:00,18371.75,BUY,3,0.02h,Stop Loss,$-9.00,$559.50,$69591.50,68,$559.50
2024-04-05,16:50:00,18356.25,SELL,3,0.02h,Stop Loss,$-9.00,$550.50,$69582.50,68,$550.50
2024-04-05,16:51:00,18364.5,BUY,3,0.02h,Stop Loss,$10.50,$561.00,$69593.00,68,$561.00
2024-04-05,17:09:00,18357.5,SELL,3,0.02h,Break Even,$-1.50,$559.50,$69591.50,68,$559.50
2024-04-05,17:25:00,18369.25,BUY,3,0.02h,Break Even,$-1.50,$558.00,$69590.00,68,$558.00
2024-04-05,17:26:00,18363.0,SELL,3,0.02h,Break Even,$-1.50,$556.50,$69588.50,68,$556.50
2024-04-05,17:30:00,18369.0,BUY,3,0.02h,Stop Loss,$21.00,$577.50,$69609.50,68,$577.50
2024-04-05,17:41:00,18362.0,SELL,3,0.02h,Stop Loss,$60.00,$637.50,$69669.50,68,$637.50
2024-04-05,18:14:00,18318.75,BUY,3,0.02h,Break Even,$-1.50,$636.00,$69668.00,68,$636.00
2024-04-05,18:26:00,18303.25,SELL,3,0.02h,Stop Loss,$-9.00,$627.00,$69659.00,68,$627.00
2024-04-05,18:41:00,18310.5,BUY,3,0.02h,Stop Loss,$-9.00,$618.00,$69650.00,68,$618.00
2024-04-05,18:42:00,18296.25,SELL,3,0.02h,Stop Loss,$13.50,$631.50,$69663.50,68,$631.50
2024-04-05,19:06:00,18293.5,BUY,3,0.02h,Stop Loss,$6.00,$637.50,$69669.50,68,$637.50
2024-04-05,19:28:00,18281.25,SELL,3,0.02h,Stop Loss,$-9.00,$628.50,$69660.50,68,$628.50
2024-04-05,19:29:00,18291.75,BUY,3,0.02h,Stop Loss,$-9.00,$619.50,$69651.50,68,$619.50
2024-04-05,20:01:00,18286.25,SELL,3,0.02h,Break Even,$-1.50,$618.00,$69650.00,68,$618.00
2024-04-05,20:27:00,18296.5,BUY,3,0.02h,Break Even,$-1.50,$616.50,$69648.50,68,$616.50
,,,,,,,,,,,
2024-04-08,12:03:00,18294.5,SELL,3,0.02h,Stop Loss,$-9.00,$-9.00,$69639.50,69,$-9.00
2024-04-08,12:14:00,18306.75,BUY,3,0.02h,Stop Loss,$6.00,$-3.00,$69645.50,69,$-3.00
2024-04-08,13:27:00,18346.0,SELL,3,0.02h,Stop Loss,$7.50,$4.50,$69653.00,69,$4.50
2024-04-08,13:59:00,18300.5,BUY,3,0.02h,Stop Loss,$16.50,$21.00,$69669.50,69,$21.00
2024-04-08,14:08:00,18283.25,SELL,3,0.02h,Stop Loss,$-9.00,$12.00,$69660.50,69,$12.00
2024-04-08,14:09:00,18307.25,BUY,3,0.02h,Stop Loss,$12.00,$24.00,$69672.50,69,$24.00
2024-04-08,15:03:00,18331.5,SELL,3,0.02h,Break Even,$-1.50,$22.50,$69671.00,69,$22.50
2024-04-08,16:32:00,18291.25,BUY,3,0.02h,Stop Loss,$6.00,$28.50,$69677.00,69,$28.50
2024-04-08,17:15:00,18302.0,SELL,3,0.02h,Break Even,$-1.50,$27.00,$69675.50,69,$27.00
2024-04-08,17:30:00,18311.5,BUY,3,0.02h,Stop Loss,$-9.00,$18.00,$69666.50,69,$18.00
2024-04-08,17:37:00,18291.0,SELL,3,0.02h,Stop Loss,$-9.00,$9.00,$69657.50,69,$9.00
2024-04-08,17:58:00,18303.5,BUY,3,0.02h,Stop Loss,$13.50,$22.50,$69671.00,69,$22.50
2024-04-08,18:32:00,18308.0,SELL,3,0.02h,Stop Loss,$-9.00,$13.50,$69662.00,69,$13.50
2024-04-08,18:56:00,18306.5,BUY,3,0.02h,Stop Loss,$12.00,$25.50,$69674.00,69,$25.50
2024-04-08,19:08:00,18292.5,SELL,3,0.02h,Break Even,$-1.50,$24.00,$69672.50,69,$24.00
2024-04-08,19:13:00,18308.25,BUY,3,0.02h,Stop Loss,$4.50,$28.50,$69677.00,69,$28.50
2024-04-08,19:23:00,18301.75,SELL,3,0.02h,Break Even,$-1.50,$27.00,$69675.50,69,$27.00
2024-04-08,19:30:00,18315.5,BUY,3,0.02h,Stop Loss,$3.00,$30.00,$69678.50,69,$30.00
2024-04-08,19:43:00,18302.75,SELL,3,0.02h,Stop Loss,$46.50,$76.50,$69725.00,69,$76.50
2024-04-08,20:04:00,18311.25,BUY,3,0.02h,Stop Loss,$-9.00,$67.50,$69716.00,69,$67.50
2024-04-08,20:30:00,18308.25,SELL,3,0.03h,Stop Loss,$4.50,$72.00,$69720.50,69,$72.00
2024-04-08,20:42:00,18310.25,BUY,3,0.05h,Stop Loss,$-9.00,$63.00,$69711.50,69,$63.00
2024-04-08,22:39:00,18314.5,SELL,3,0.02h,Stop Loss,$-9.00,$54.00,$69702.50,69,$54.00
,,,,,,,,,,,
2024-04-09,12:00:00,18340.75,BUY,3,0.02h,Stop Loss,$21.00,$21.00,$69723.50,70,$21.00
2024-04-09,13:07:00,18356.25,SELL,3,0.02h,Break Even,$-1.50,$19.50,$69722.00,70,$19.50
2024-04-09,13:15:00,18369.75,BUY,3,0.02h,Stop Loss,$4.50,$24.00,$69726.50,70,$24.00
2024-04-09,13:36:00,18368.5,SELL,3,0.02h,Stop Loss,$27.00,$51.00,$69753.50,70,$51.00
2024-04-09,13:40:00,18390.25,BUY,3,0.02h,Stop Loss,$46.50,$97.50,$69800.00,70,$97.50
2024-04-09,13:49:00,18365.5,SELL,3,0.02h,Stop Loss,$94.50,$192.00,$69894.50,70,$192.00
2024-04-09,14:17:00,18362.5,BUY,3,0.02h,Stop Loss,$24.00,$216.00,$69918.50,70,$216.00
2024-04-09,14:21:00,18349.25,SELL,3,0.02h,Stop Loss,$-9.00,$207.00,$69909.50,70,$207.00
2024-04-09,14:23:00,18358.0,BUY,3,0.02h,Stop Loss,$7.50,$214.50,$69917.00,70,$214.50
2024-04-09,14:26:00,18346.5,SELL,3,0.02h,Stop Loss,$66.00,$280.50,$69983.00,70,$280.50
2024-04-09,15:05:00,18215.75,BUY,3,0.02h,Stop Loss,$34.50,$315.00,$70017.50,70,$315.00
2024-04-09,15:33:00,18221.75,SELL,3,0.02h,Stop Loss,$9.00,$324.00,$70026.50,70,$324.00
2024-04-09,15:43:00,18235.25,BUY,3,0.02h,Stop Loss,$94.50,$418.50,$70121.00,70,$418.50
2024-04-09,16:51:00,18288.5,SELL,3,0.02h,Stop Loss,$19.50,$438.00,$70140.50,70,$438.00
2024-04-09,17:08:00,18285.25,BUY,3,0.02h,Break Even,$-1.50,$436.50,$70139.00,70,$436.50
2024-04-09,17:17:00,18270.25,SELL,3,0.02h,Stop Loss,$-9.00,$427.50,$70130.00,70,$427.50
2024-04-09,17:22:00,18289.25,BUY,3,0.02h,Stop Loss,$21.00,$448.50,$70151.00,70,$448.50
2024-04-09,17:29:00,18272.25,SELL,3,0.02h,Stop Loss,$-9.00,$439.50,$70142.00,70,$439.50
2024-04-09,17:40:00,18288.25,BUY,3,0.02h,Stop Loss,$18.00,$457.50,$70160.00,70,$457.50
2024-04-09,17:43:00,18264.5,SELL,3,0.02h,Stop Loss,$-9.00,$448.50,$70151.00,70,$448.50
2024-04-09,18:13:00,18271.75,BUY,3,0.02h,Stop Loss,$-9.00,$439.50,$70142.00,70,$439.50
2024-04-09,18:30:00,18260.5,SELL,3,0.02h,Stop Loss,$58.50,$498.00,$70200.50,70,$498.00
2024-04-09,18:57:00,18259.75,BUY,3,0.02h,Stop Loss,$-9.00,$489.00,$70191.50,70,$489.00
2024-04-09,19:00:00,18252.25,SELL,3,0.02h,Stop Loss,$60.00,$549.00,$70251.50,70,$549.00
2024-04-09,19:20:00,18255.25,BUY,3,0.02h,Stop Loss,$12.00,$561.00,$70263.50,70,$561.00
2024-04-09,20:46:00,18383.25,SELL,3,0.02h,Break Even,$-1.50,$559.50,$70262.00,70,$559.50
2024-04-09,22:40:00,18378.0,BUY,3,0.02h,Stop Loss,$-9.00,$550.50,$70253.00,70,$550.50
2024-04-09,22:41:00,18376.5,SELL,3,0.02h,Break Even,$-1.50,$549.00,$70251.50,70,$549.00
,,,,,,,,,,,
2024-04-10,12:00:00,18381.75,BUY,3,0.02h,Break Even,$-1.50,$-1.50,$70250.00,71,$-1.50
2024-04-10,12:21:00,18381.0,SELL,3,0.02h,Stop Loss,$-9.00,$-10.50,$70241.00,71,$-10.50
2024-04-10,12:30:00,18424.0,BUY,3,0.02h,Stop Loss,$67.50,$57.00,$70308.50,71,$57.00
2024-04-10,12:31:00,18167.25,SELL,3,0.02h,Stop Loss,$285.00,$342.00,$70593.50,71,$342.00
2024-04-10,13:19:00,18129.25,BUY,3,0.02h,Stop Loss,$-9.00,$333.00,$70584.50,71,$333.00
2024-04-10,13:49:00,18139.5,SELL,3,0.02h,Stop Loss,$109.50,$442.50,$70694.00,71,$442.50
2024-04-10,13:52:00,18176.0,BUY,3,0.02h,Break Even,$-1.50,$441.00,$70692.50,71,$441.00
2024-04-10,14:07:00,18152.25,SELL,3,0.02h,Stop Loss,$-9.00,$432.00,$70683.50,71,$432.00
2024-04-10,14:08:00,18167.25,BUY,3,0.02h,Stop Loss,$85.50,$517.50,$70769.00,71,$517.50
2024-04-10,14:16:00,18151.75,SELL,3,0.02h,Break Even,$-1.50,$516.00,$70767.50,71,$516.00
2024-04-10,14:19:00,18184.0,BUY,3,0.02h,Stop Loss,$120.00,$636.00,$70887.50,71,$636.00
2024-04-10,14:50:00,18186.25,SELL,3,0.02h,Break Even,$-1.50,$634.50,$70886.00,71,$634.50
2024-04-10,15:27:00,18158.75,BUY,3,0.02h,Stop Loss,$73.50,$708.00,$70959.50,71,$708.00
2024-04-10,15:38:00,18144.0,SELL,3,0.02h,Stop Loss,$9.00,$717.00,$70968.50,71,$717.00
2024-04-10,16:04:00,18157.5,BUY,3,0.02h,Stop Loss,$18.00,$735.00,$70986.50,71,$735.00
2024-04-10,16:13:00,18136.0,SELL,3,0.02h,Stop Loss,$15.00,$750.00,$71001.50,71,$750.00
2024-04-10,16:27:00,18149.5,BUY,3,0.02h,Stop Loss,$21.00,$771.00,$71022.50,71,$771.00
2024-04-10,17:05:00,18143.75,SELL,3,0.02h,Stop Loss,$52.50,$823.50,$71075.00,71,$823.50
2024-04-10,17:21:00,18179.25,BUY,3,0.02h,Stop Loss,$100.50,$924.00,$71175.50,71,$924.00
2024-04-10,17:34:00,18139.75,SELL,3,0.02h,Stop Loss,$40.50,$964.50,$71216.00,71,$964.50
2024-04-10,17:57:00,18186.75,BUY,3,0.02h,Stop Loss,$99.00,$1063.50,$71315.00,71,$1063.50
2024-04-10,18:20:00,18159.75,SELL,3,0.02h,Stop Loss,$-9.00,$1054.50,$71306.00,71,$1054.50
2024-04-10,18:21:00,18173.75,BUY,3,0.02h,Stop Loss,$15.00,$1069.50,$71321.00,71,$1069.50
2024-04-10,18:23:00,18153.25,SELL,3,0.02h,Stop Loss,$69.00,$1138.50,$71390.00,71,$1138.50
2024-04-10,18:40:00,18171.0,BUY,3,0.02h,Break Even,$-1.50,$1137.00,$71388.50,71,$1137.00
2024-04-10,18:56:00,18142.25,SELL,3,0.02h,Stop Loss,$37.50,$1174.50,$71426.00,71,$1174.50
2024-04-10,19:13:00,18152.0,BUY,3,0.02h,Stop Loss,$94.50,$1269.00,$71520.50,71,$1269.00
2024-04-10,19:34:00,18153.0,SELL,3,0.02h,Stop Loss,$-9.00,$1260.00,$71511.50,71,$1260.00
2024-04-10,19:43:00,18195.0,BUY,3,0.02h,Stop Loss,$30.00,$1290.00,$71541.50,71,$1290.00
2024-04-10,20:02:00,18171.5,SELL,3,0.02h,Stop Loss,$12.00,$1302.00,$71553.50,71,$1302.00
2024-04-10,20:39:00,18173.5,BUY,3,0.03h,Break Even,$-1.50,$1300.50,$71552.00,71,$1300.50
2024-04-10,22:04:00,18169.75,SELL,3,0.02h,Break Even,$-1.50,$1299.00,$71550.50,71,$1299.00
2024-04-10,22:24:00,18173.25,BUY,3,0.02h,Break Even,$-1.50,$1297.50,$71549.00,71,$1297.50
2024-04-10,22:36:00,18170.75,SELL,3,0.02h,Stop Loss,$-9.00,$1288.50,$71540.00,71,$1288.50
2024-04-10,22:44:00,18174.5,BUY,3,0.03h,Break Even,$-1.50,$1287.00,$71538.50,71,$1287.00
2024-04-10,22:55:00,18170.5,SELL,3,0.02h,Break Even,$-1.50,$1285.50,$71537.00,71,$1285.50
,,,,,,,,,,,
2024-04-11,12:31:00,18205.75,BUY,3,0.02h,Stop Loss,$34.50,$34.50,$71571.50,72,$34.50
2024-04-11,13:32:00,18231.75,SELL,3,0.02h,Stop Loss,$19.50,$54.00,$71591.00,72,$54.00
2024-04-11,13:53:00,18270.75,BUY,3,0.02h,Break Even,$-1.50,$52.50,$71589.50,72,$52.50
2024-04-11,14:02:00,18230.0,SELL,3,0.02h,Stop Loss,$7.50,$60.00,$71597.00,72,$60.00
2024-04-11,14:32:00,18238.75,BUY,3,0.02h,Break Even,$-1.50,$58.50,$71595.50,72,$58.50
2024-04-11,15:29:00,18246.75,SELL,3,0.02h,Break Even,$-1.50,$57.00,$71594.00,72,$57.00
2024-04-11,15:36:00,18259.5,BUY,3,0.02h,Break Even,$-1.50,$55.50,$71592.50,72,$55.50
2024-04-11,16:31:00,18295.75,SELL,3,0.02h,Stop Loss,$-9.00,$46.50,$71583.50,72,$46.50
2024-04-11,16:36:00,18307.75,BUY,3,0.02h,Break Even,$-1.50,$45.00,$71582.00,72,$45.00
2024-04-11,16:38:00,18302.5,SELL,3,0.02h,Stop Loss,$-9.00,$36.00,$71573.00,72,$36.00
2024-04-11,16:43:00,18310.0,BUY,3,0.02h,Stop Loss,$7.50,$43.50,$71580.50,72,$43.50
2024-04-11,18:52:00,18493.75,SELL,3,0.02h,Stop Loss,$28.50,$72.00,$71609.00,72,$72.00
2024-04-11,19:06:00,18501.5,BUY,3,0.02h,Break Even,$-1.50,$70.50,$71607.50,72,$70.50
2024-04-11,19:20:00,18488.0,SELL,3,0.02h,Break Even,$-1.50,$69.00,$71606.00,72,$69.00
2024-04-11,19:23:00,18502.25,BUY,3,0.02h,Stop Loss,$-9.00,$60.00,$71597.00,72,$60.00
2024-04-11,19:52:00,18499.0,SELL,3,0.02h,Stop Loss,$9.00,$69.00,$71606.00,72,$69.00
2024-04-11,20:27:00,18493.25,BUY,3,0.02h,Stop Loss,$-9.00,$60.00,$71597.00,72,$60.00
2024-04-11,20:41:00,18489.0,SELL,3,0.02h,Stop Loss,$-9.00,$51.00,$71588.00,72,$51.00
2024-04-11,22:11:00,18492.5,BUY,3,0.02h,Break Even,$-1.50,$49.50,$71586.50,72,$49.50
2024-04-11,22:34:00,18490.0,SELL,3,0.05h,Break Even,$-1.50,$48.00,$71585.00,72,$48.00
2024-04-11,22:45:00,18494.25,BUY,3,0.02h,Stop Loss,$-9.00,$39.00,$71576.00,72,$39.00
,,,,,,,,,,,
2024-04-12,12:00:00,18412.5,SELL,3,0.02h,Stop Loss,$9.00,$9.00,$71585.00,73,$9.00
2024-04-12,13:33:00,18320.5,BUY,3,0.02h,Stop Loss,$18.00,$27.00,$71603.00,73,$27.00
2024-04-12,13:39:00,18296.25,SELL,3,0.02h,Stop Loss,$-9.00,$18.00,$71594.00,73,$18.00
2024-04-12,13:40:00,18306.0,BUY,3,0.02h,Stop Loss,$4.50,$22.50,$71598.50,73,$22.50
2024-04-12,14:04:00,18292.0,SELL,3,0.02h,Break Even,$-1.50,$21.00,$71597.00,73,$21.00
2024-04-12,14:24:00,18303.25,BUY,3,0.02h,Break Even,$-1.50,$19.50,$71595.50,73,$19.50
2024-04-12,14:26:00,18291.0,SELL,3,0.02h,Stop Loss,$30.00,$49.50,$71625.50,73,$49.50
2024-04-12,15:18:00,18230.5,BUY,3,0.02h,Stop Loss,$72.00,$121.50,$71697.50,73,$121.50
2024-04-12,15:57:00,18254.25,SELL,3,0.02h,Stop Loss,$-9.00,$112.50,$71688.50,73,$112.50
2024-04-12,17:14:00,18169.25,BUY,3,0.02h,Stop Loss,$6.00,$118.50,$71694.50,73,$118.50
2024-04-12,17:22:00,18145.5,SELL,3,0.02h,Stop Loss,$30.00,$148.50,$71724.50,73,$148.50
2024-04-12,17:43:00,18160.5,BUY,3,0.02h,Stop Loss,$27.00,$175.50,$71751.50,73,$175.50
2024-04-12,18:02:00,18148.0,SELL,3,0.02h,Stop Loss,$9.00,$184.50,$71760.50,73,$184.50
2024-04-12,18:07:00,18168.5,BUY,3,0.02h,Stop Loss,$45.00,$229.50,$71805.50,73,$229.50
2024-04-12,18:26:00,18162.5,SELL,3,0.02h,Break Even,$-1.50,$228.00,$71804.00,73,$228.00
2024-04-12,19:25:00,18147.75,BUY,3,0.02h,Stop Loss,$28.50,$256.50,$71832.50,73,$256.50
2024-04-12,20:48:00,18185.25,SELL,3,0.02h,Break Even,$-1.50,$255.00,$71831.00,73,$255.00
,,,,,,,,,,,
2024-04-15,12:00:00,18292.25,BUY,3,0.02h,Stop Loss,$-9.00,$-9.00,$71822.00,74,$-9.00
2024-04-15,13:30:00,18335.5,SELL,3,0.02h,Stop Loss,$198.00,$189.00,$72020.00,74,$189.00
2024-04-15,13:54:00,18322.0,BUY,3,0.02h,Break Even,$-1.50,$187.50,$72018.50,74,$187.50
2024-04-15,14:06:00,18297.25,SELL,3,0.02h,Stop Loss,$39.00,$226.50,$72057.50,74,$226.50
2024-04-15,15:29:00,18193.0,BUY,3,0.02h,Break Even,$-1.50,$225.00,$72056.00,74,$225.00
2024-04-15,15:48:00,18185.25,SELL,3,0.02h,Break Even,$-1.50,$223.50,$72054.50,74,$223.50
2024-04-15,15:52:00,18206.0,BUY,3,0.02h,Stop Loss,$34.50,$258.00,$72089.00,74,$258.00
2024-04-15,16:17:00,18204.0,SELL,3,0.02h,Stop Loss,$37.50,$295.50,$72126.50,74,$295.50
2024-04-15,17:05:00,18110.75,BUY,3,0.02h,Stop Loss,$52.50,$348.00,$72179.00,74,$348.00
2024-04-15,17:15:00,18099.25,SELL,3,0.02h,Stop Loss,$15.00,$363.00,$72194.00,74,$363.00
2024-04-15,18:28:00,17905.0,BUY,3,0.02h,Break Even,$-1.50,$361.50,$72192.50,74,$361.50
2024-04-15,18:30:00,17891.75,SELL,3,0.02h,Stop Loss,$18.00,$379.50,$72210.50,74,$379.50
2024-04-15,18:31:00,17902.5,BUY,3,0.02h,Stop Loss,$21.00,$400.50,$72231.50,74,$400.50
2024-04-15,18:46:00,17893.75,SELL,3,0.02h,Stop Loss,$-9.00,$391.50,$72222.50,74,$391.50
2024-04-15,19:25:00,17878.75,BUY,3,0.02h,Stop Loss,$15.00,$406.50,$72237.50,74,$406.50
2024-04-15,19:29:00,17864.25,SELL,3,0.02h,Stop Loss,$22.50,$429.00,$72260.00,74,$429.00
2024-04-15,19:32:00,17883.75,BUY,3,0.02h,Stop Loss,$25.50,$454.50,$72285.50,74,$454.50
2024-04-15,20:01:00,17864.25,SELL,3,0.02h,Stop Loss,$7.50,$462.00,$72293.00,74,$462.00
2024-04-15,20:54:00,17862.5,BUY,3,0.02h,Break Even,$-1.50,$460.50,$72291.50,74,$460.50
2024-04-15,22:41:00,17880.0,SELL,3,0.02h,Break Even,$-1.50,$459.00,$72290.00,74,$459.00
2024-04-15,22:48:00,17884.0,BUY,3,0.02h,Stop Loss,$-9.00,$450.00,$72281.00,74,$450.00
2024-04-15,22:49:00,17881.5,SELL,3,0.02h,Break Even,$-1.50,$448.50,$72279.50,74,$448.50
,,,,,,,,,,,
2024-04-16,12:00:00,17907.75,BUY,3,0.02h,Stop Loss,$-9.00,$-9.00,$72270.50,75,$-9.00
2024-04-16,12:10:00,17885.75,SELL,3,0.02h,Stop Loss,$-9.00,$-18.00,$72261.50,75,$-18.00
2024-04-16,12:11:00,17890.25,BUY,3,0.02h,Stop Loss,$49.50,$31.50,$72311.00,75,$31.50
2024-04-16,12:18:00,17884.0,SELL,3,0.02h,Stop Loss,$3.00,$34.50,$72314.00,75,$34.50
2024-04-16,12:33:00,17896.0,BUY,3,0.02h,Stop Loss,$-9.00,$25.50,$72305.00,75,$25.50
2024-04-16,12:58:00,17894.75,SELL,3,0.02h,Break Even,$-1.50,$24.00,$72303.50,75,$24.00
2024-04-16,13:55:00,17867.25,BUY,3,0.02h,Stop Loss,$39.00,$63.00,$72342.50,75,$63.00
2024-04-16,14:25:00,17887.0,SELL,3,0.02h,Stop Loss,$24.00,$87.00,$72366.50,75,$87.00
2024-04-16,14:51:00,17868.75,BUY,3,0.02h,Break Even,$-1.50,$85.50,$72365.00,75,$85.50
2024-04-16,14:52:00,17864.0,SELL,3,0.02h,Stop Loss,$-9.00,$76.50,$72356.00,75,$76.50
2024-04-16,14:53:00,17872.25,BUY,3,0.02h,Stop Loss,$43.50,$120.00,$72399.50,75,$120.00
2024-04-16,15:01:00,17861.25,SELL,3,0.02h,Stop Loss,$39.00,$159.00,$72438.50,75,$159.00
2024-04-16,15:04:00,17878.25,BUY,3,0.02h,Stop Loss,$7.50,$166.50,$72446.00,75,$166.50
2024-04-16,15:40:00,17884.75,SELL,3,0.02h,Stop Loss,$-9.00,$157.50,$72437.00,75,$157.50
2024-04-16,15:43:00,17904.25,BUY,3,0.02h,Break Even,$-1.50,$156.00,$72435.50,75,$156.00
2024-04-16,16:01:00,17877.0,SELL,3,0.02h,Stop Loss,$60.00,$216.00,$72495.50,75,$216.00
2024-04-16,16:12:00,17906.5,BUY,3,0.02h,Break Even,$-1.50,$214.50,$72494.00,75,$214.50
2024-04-16,16:34:00,17904.75,SELL,3,0.02h,Stop Loss,$19.50,$234.00,$72513.50,75,$234.00
2024-04-16,16:42:00,17917.25,BUY,3,0.02h,Break Even,$-1.50,$232.50,$72512.00,75,$232.50
2024-04-16,16:45:00,17897.5,SELL,3,0.02h,Stop Loss,$-9.00,$223.50,$72503.00,75,$223.50
2024-04-16,16:48:00,17913.75,BUY,3,0.02h,Stop Loss,$33.00,$256.50,$72536.00,75,$256.50
2024-04-16,17:02:00,17902.25,SELL,3,0.02h,Stop Loss,$22.50,$279.00,$72558.50,75,$279.00
2024-04-16,17:10:00,17916.5,BUY,3,0.02h,Stop Loss,$3.00,$282.00,$72561.50,75,$282.00
2024-04-16,17:31:00,17847.25,SELL,3,0.02h,Stop Loss,$73.50,$355.50,$72635.00,75,$355.50
2024-04-16,17:44:00,17905.75,BUY,3,0.02h,Break Even,$-1.50,$354.00,$72633.50,75,$354.00
2024-04-16,17:48:00,17881.25,SELL,3,0.02h,Stop Loss,$42.00,$396.00,$72675.50,75,$396.00
2024-04-16,18:05:00,17904.75,BUY,3,0.02h,Stop Loss,$22.50,$418.50,$72698.00,75,$418.50
2024-04-16,18:19:00,17884.75,SELL,3,0.02h,Break Even,$-1.50,$417.00,$72696.50,75,$417.00
2024-04-16,18:39:00,17891.75,BUY,3,0.02h,Stop Loss,$25.50,$442.50,$72722.00,75,$442.50
2024-04-16,19:17:00,17912.75,SELL,3,0.02h,Break Even,$-1.50,$441.00,$72720.50,75,$441.00
2024-04-16,19:23:00,17933.5,BUY,3,0.02h,Stop Loss,$39.00,$480.00,$72759.50,75,$480.00
2024-04-16,19:34:00,17915.25,SELL,3,0.02h,Stop Loss,$132.00,$612.00,$72891.50,75,$612.00
2024-04-16,20:33:00,17887.25,BUY,3,0.02h,Stop Loss,$-9.00,$603.00,$72882.50,75,$603.00
2024-04-16,22:21:00,17899.5,SELL,3,0.02h,Break Even,$-1.50,$601.50,$72881.00,75,$601.50
2024-04-16,22:31:00,17901.75,BUY,3,0.02h,Stop Loss,$7.50,$609.00,$72888.50,75,$609.00
,,,,,,,,,,,
2024-04-17,12:02:00,17903.5,SELL,3,0.02h,Stop Loss,$16.50,$16.50,$72905.00,76,$16.50
2024-04-17,12:07:00,17912.5,BUY,3,0.02h,Break Even,$-1.50,$15.00,$72903.50,76,$15.00
2024-04-17,12:10:00,17904.5,SELL,3,0.02h,Stop Loss,$27.00,$42.00,$72930.50,76,$42.00
2024-04-17,12:15:00,17913.0,BUY,3,0.02h,Break Even,$-1.50,$40.50,$72929.00,76,$40.50
2024-04-17,12:26:00,17899.25,SELL,3,0.02h,Stop Loss,$-9.00,$31.50,$72920.00,76,$31.50
2024-04-17,12:34:00,17916.5,BUY,3,0.02h,Stop Loss,$-9.00,$22.50,$72911.00,76,$22.50
2024-04-17,13:33:00,17945.75,SELL,3,0.02h,Stop Loss,$39.00,$61.50,$72950.00,76,$61.50
2024-04-17,14:49:00,17858.25,BUY,3,0.02h,Stop Loss,$-9.00,$52.50,$72941.00,76,$52.50
2024-04-17,14:52:00,17811.0,SELL,3,0.02h,Stop Loss,$133.50,$186.00,$73074.50,76,$186.00
2024-04-17,15:04:00,17839.25,BUY,3,0.02h,Stop Loss,$48.00,$234.00,$73122.50,76,$234.00
2024-04-17,15:11:00,17815.75,SELL,3,0.02h,Break Even,$-1.50,$232.50,$73121.00,76,$232.50
2024-04-17,17:04:00,17668.75,BUY,3,0.02h,Break Even,$-1.50,$231.00,$73119.50,76,$231.00
2024-04-17,17:48:00,17704.5,SELL,3,0.02h,Stop Loss,$9.00,$240.00,$73128.50,76,$240.00
2024-04-17,17:49:00,17712.25,BUY,3,0.02h,Stop Loss,$52.50,$292.50,$73181.00,76,$292.50
2024-04-17,18:12:00,17712.75,SELL,3,0.02h,Stop Loss,$-9.00,$283.50,$73172.00,76,$283.50
2024-04-17,18:42:00,17741.25,BUY,3,0.02h,Stop Loss,$178.50,$462.00,$73350.50,76,$462.00
2024-04-17,18:55:00,17706.5,SELL,3,0.02h,Stop Loss,$75.00,$537.00,$73425.50,76,$537.00
2024-04-17,19:45:00,17686.25,BUY,3,0.02h,Stop Loss,$-9.00,$528.00,$73416.50,76,$528.00
2024-04-17,19:59:00,17678.0,SELL,3,0.02h,Stop Loss,$147.00,$675.00,$73563.50,76,$675.00
2024-04-17,20:30:00,17664.25,BUY,3,0.02h,Stop Loss,$-9.00,$666.00,$73554.50,76,$666.00
2024-04-17,20:44:00,17661.0,SELL,3,0.02h,Stop Loss,$-9.00,$657.00,$73545.50,76,$657.00
2024-04-17,20:59:00,17665.0,BUY,3,0.02h,Stop Loss,$-9.00,$648.00,$73536.50,76,$648.00
2024-04-17,22:39:00,17678.5,SELL,3,0.02h,Stop Loss,$-9.00,$639.00,$73527.50,76,$639.00
2024-04-17,22:42:00,17682.75,BUY,3,0.02h,Stop Loss,$-9.00,$630.00,$73518.50,76,$630.00
2024-04-17,22:51:00,17678.25,SELL,3,0.02h,Break Even,$-1.50,$628.50,$73517.00,76,$628.50
,,,,,,,,,,,
2024-04-18,12:00:00,17709.5,BUY,3,0.02h,Break Even,$-1.50,$-1.50,$73515.50,77,$-1.50
2024-04-18,12:18:00,17692.0,SELL,3,0.02h,Break Even,$-1.50,$-3.00,$73514.00,77,$-3.00
2024-04-18,12:38:00,17703.75,BUY,3,0.02h,Break Even,$-1.50,$-4.50,$73512.50,77,$-4.50
2024-04-18,12:44:00,17687.0,SELL,3,0.02h,Stop Loss,$9.00,$4.50,$73521.50,77,$4.50
2024-04-18,13:06:00,17694.5,BUY,3,0.02h,Stop Loss,$-9.00,$-4.50,$73512.50,77,$-4.50
2024-04-18,13:09:00,17685.5,SELL,3,0.02h,Stop Loss,$9.00,$4.50,$73521.50,77,$4.50
2024-04-18,13:12:00,17689.5,BUY,3,0.02h,Break Even,$-1.50,$3.00,$73520.00,77,$3.00
2024-04-18,13:17:00,17679.25,SELL,3,0.02h,Stop Loss,$21.00,$24.00,$73541.00,77,$24.00
2024-04-18,14:10:00,17642.0,BUY,3,0.02h,Stop Loss,$37.50,$61.50,$73578.50,77,$61.50
2024-04-18,15:31:00,17697.5,SELL,3,0.02h,Stop Loss,$-9.00,$52.50,$73569.50,77,$52.50
2024-04-18,16:03:00,17700.0,BUY,3,0.02h,Break Even,$-1.50,$51.00,$73568.00,77,$51.00
2024-04-18,16:04:00,17695.5,SELL,3,0.02h,Stop Loss,$24.00,$75.00,$73592.00,77,$75.00
2024-04-18,17:50:00,17571.25,BUY,3,0.02h,Stop Loss,$-9.00,$66.00,$73583.00,77,$66.00
2024-04-18,17:51:00,17563.75,SELL,3,0.02h,Stop Loss,$22.50,$88.50,$73605.50,77,$88.50
2024-04-18,18:17:00,17565.0,BUY,3,0.02h,Stop Loss,$43.50,$132.00,$73649.00,77,$132.00
2024-04-18,18:32:00,17550.0,SELL,3,0.02h,Stop Loss,$46.50,$178.50,$73695.50,77,$178.50
2024-04-18,18:50:00,17558.25,BUY,3,0.02h,Stop Loss,$-9.00,$169.50,$73686.50,77,$169.50
2024-04-18,18:51:00,17547.0,SELL,3,0.02h,Stop Loss,$70.50,$240.00,$73757.00,77,$240.00
2024-04-18,19:03:00,17571.25,BUY,3,0.02h,Stop Loss,$-9.00,$231.00,$73748.00,77,$231.00
2024-04-18,19:21:00,17556.5,SELL,3,0.02h,Stop Loss,$25.50,$256.50,$73773.50,77,$256.50
2024-04-18,19:30:00,17562.25,BUY,3,0.02h,Stop Loss,$13.50,$270.00,$73787.00,77,$270.00
2024-04-18,19:55:00,17537.5,SELL,3,0.02h,Stop Loss,$28.50,$298.50,$73815.50,77,$298.50
2024-04-18,20:59:00,17531.25,BUY,3,0.02h,Stop Loss,$-9.00,$289.50,$73806.50,77,$289.50
2024-04-18,22:23:00,17534.25,SELL,3,0.02h,Break Even,$-1.50,$288.00,$73805.00,77,$288.00
,,,,,,,,,,,
2024-04-19,12:17:00,17513.5,BUY,3,0.02h,Break Even,$-1.50,$-1.50,$73803.50,78,$-1.50
2024-04-19,12:45:00,17527.0,SELL,3,0.02h,Stop Loss,$51.00,$49.50,$73854.50,78,$49.50
2024-04-19,13:46:00,17492.25,BUY,3,0.02h,Stop Loss,$123.00,$172.50,$73977.50,78,$172.50
2024-04-19,13:51:00,17449.0,SELL,3,0.02h,Stop Loss,$39.00,$211.50,$74016.50,78,$211.50
2024-04-19,14:47:00,17396.25,BUY,3,0.02h,Stop Loss,$39.00,$250.50,$74055.50,78,$250.50
2024-04-19,15:01:00,17378.0,SELL,3,0.02h,Stop Loss,$12.00,$262.50,$74067.50,78,$262.50
2024-04-19,15:48:00,17346.25,BUY,3,0.02h,Stop Loss,$10.50,$273.00,$74078.00,78,$273.00
2024-04-19,15:52:00,17325.25,SELL,3,0.02h,Break Even,$-1.50,$271.50,$74076.50,78,$271.50
2024-04-19,16:46:00,17246.75,BUY,3,0.02h,Stop Loss,$46.50,$318.00,$74123.00,78,$318.00
2024-04-19,17:29:00,17274.25,SELL,3,0.02h,Stop Loss,$85.50,$403.50,$74208.50,78,$403.50
2024-04-19,17:48:00,17284.75,BUY,3,0.02h,Stop Loss,$13.50,$417.00,$74222.00,78,$417.00
2024-04-19,18:01:00,17268.5,SELL,3,0.02h,Stop Loss,$108.00,$525.00,$74330.00,78,$525.00
2024-04-19,19:12:00,17174.5,BUY,3,0.02h,Stop Loss,$48.00,$573.00,$74378.00,78,$573.00
2024-04-19,19:36:00,17154.75,SELL,3,0.02h,Stop Loss,$106.50,$679.50,$74484.50,78,$679.50
2024-04-19,19:55:00,17183.25,BUY,3,0.02h,Break Even,$-1.50,$678.00,$74483.00,78,$678.00
2024-04-19,20:40:00,17174.5,SELL,3,0.02h,Stop Loss,$-9.00,$669.00,$74474.00,78,$669.00
2024-04-19,20:58:00,17180.75,BUY,3,0.02h,Stop Loss,$-9.00,$660.00,$74465.00,78,$660.00
,,,,,,,,,,,
2024-04-22,13:25:00,17295.0,SELL,3,0.02h,Stop Loss,$31.50,$31.50,$74496.50,79,$31.50
2024-04-22,13:47:00,17298.5,BUY,3,0.02h,Stop Loss,$6.00,$37.50,$74502.50,79,$37.50
2024-04-22,14:01:00,17296.75,SELL,3,0.02h,Stop Loss,$-9.00,$28.50,$74493.50,79,$28.50
2024-04-22,14:02:00,17307.75,BUY,3,0.02h,Stop Loss,$16.50,$45.00,$74510.00,79,$45.00
2024-04-22,14:03:00,17295.25,SELL,3,0.02h,Stop Loss,$33.00,$78.00,$74543.00,79,$78.00
2024-04-22,15:27:00,17193.25,BUY,3,0.02h,Break Even,$-1.50,$76.50,$74541.50,79,$76.50
2024-04-22,16:31:00,17247.25,SELL,3,0.02h,Stop Loss,$34.50,$111.00,$74576.00,79,$111.00
2024-04-22,16:48:00,17268.0,BUY,3,0.02h,Break Even,$-1.50,$109.50,$74574.50,79,$109.50
2024-04-22,18:42:00,17413.25,SELL,3,0.02h,Stop Loss,$40.50,$150.00,$74615.00,79,$150.00
2024-04-22,19:10:00,17407.5,BUY,3,0.02h,Break Even,$-1.50,$148.50,$74613.50,79,$148.50
2024-04-22,19:12:00,17399.25,SELL,3,0.02h,Stop Loss,$-9.00,$139.50,$74604.50,79,$139.50
2024-04-22,19:13:00,17409.25,BUY,3,0.02h,Break Even,$-1.50,$138.00,$74603.00,79,$138.00
2024-04-22,19:21:00,17384.25,SELL,3,0.02h,Stop Loss,$21.00,$159.00,$74624.00,79,$159.00
2024-04-22,20:31:00,17338.5,BUY,3,0.02h,Stop Loss,$3.00,$162.00,$74627.00,79,$162.00
2024-04-22,20:49:00,17335.0,SELL,3,0.02h,Stop Loss,$-9.00,$153.00,$74618.00,79,$153.00
2024-04-22,20:53:00,17341.75,BUY,3,0.02h,Stop Loss,$-9.00,$144.00,$74609.00,79,$144.00
2024-04-22,22:15:00,17345.0,SELL,3,0.02h,Stop Loss,$3.00,$147.00,$74612.00,79,$147.00
2024-04-22,22:37:00,17342.5,BUY,3,0.03h,Stop Loss,$-9.00,$138.00,$74603.00,79,$138.00
2024-04-22,22:43:00,17339.0,SELL,3,0.02h,Stop Loss,$-9.00,$129.00,$74594.00,79,$129.00
2024-04-22,22:44:00,17341.0,BUY,3,0.02h,Stop Loss,$-9.00,$120.00,$74585.00,79,$120.00
2024-04-22,22:45:00,17339.75,SELL,3,0.02h,Stop Loss,$-9.00,$111.00,$74576.00,79,$111.00
2024-04-22,22:46:00,17342.5,BUY,3,0.03h,Break Even,$-1.50,$109.50,$74574.50,79,$109.50
2024-04-22,22:57:00,17340.0,SELL,3,0.02h,Break Even,$-1.50,$108.00,$74573.00,79,$108.00
,,,,,,,,,,,
2024-04-23,12:00:00,17391.0,BUY,3,0.02h,Break Even,$-1.50,$-1.50,$74571.50,80,$-1.50
2024-04-23,12:19:00,17363.25,SELL,3,0.02h,Break Even,$-1.50,$-3.00,$74570.00,80,$-3.00
2024-04-23,12:21:00,17374.5,BUY,3,0.02h,Stop Loss,$9.00,$6.00,$74579.00,80,$6.00
2024-04-23,14:52:00,17562.0,SELL,3,0.02h,Stop Loss,$-9.00,$-3.00,$74570.00,80,$-3.00
2024-04-23,14:55:00,17576.75,BUY,3,0.02h,Stop Loss,$36.00,$33.00,$74606.00,80,$33.00
2024-04-23,15:03:00,17544.0,SELL,3,0.02h,Break Even,$-1.50,$31.50,$74604.50,80,$31.50
2024-04-23,15:14:00,17579.0,BUY,3,0.02h,Stop Loss,$10.50,$42.00,$74615.00,80,$42.00
2024-04-23,15:45:00,17583.5,SELL,3,0.02h,Stop Loss,$40.50,$82.50,$74655.50,80,$82.50
2024-04-23,16:06:00,17584.25,BUY,3,0.02h,Break Even,$-1.50,$81.00,$74654.00,80,$81.00
2024-04-23,16:54:00,17598.5,SELL,3,0.02h,Stop Loss,$4.50,$85.50,$74658.50,80,$85.50
2024-04-23,17:08:00,17611.75,BUY,3,0.02h,Stop Loss,$-9.00,$76.50,$74649.50,80,$76.50
2024-04-23,17:12:00,17595.0,SELL,3,0.02h,Stop Loss,$61.50,$138.00,$74711.00,80,$138.00
2024-04-23,17:24:00,17596.25,BUY,3,0.02h,Break Even,$-1.50,$136.50,$74709.50,80,$136.50
2024-04-23,17:26:00,17587.75,SELL,3,0.02h,Stop Loss,$-9.00,$127.50,$74700.50,80,$127.50
2024-04-23,17:29:00,17596.75,BUY,3,0.02h,Stop Loss,$3.00,$130.50,$74703.50,80,$130.50
2024-04-23,18:52:00,17634.5,SELL,3,0.02h,Break Even,$-1.50,$129.00,$74702.00,80,$129.00
2024-04-23,19:38:00,17630.25,BUY,3,0.02h,Break Even,$-1.50,$127.50,$74700.50,80,$127.50
2024-04-23,19:42:00,17626.75,SELL,3,0.02h,Stop Loss,$37.50,$165.00,$74738.00,80,$165.00
2024-04-23,20:05:00,17641.0,BUY,3,0.02h,Stop Loss,$10.50,$175.50,$74748.50,80,$175.50
2024-04-23,22:30:00,17669.5,SELL,3,0.02h,Break Even,$-1.50,$174.00,$74747.00,80,$174.00
2024-04-23,22:46:00,17670.75,BUY,3,0.02h,Stop Loss,$-9.00,$165.00,$74738.00,80,$165.00
,,,,,,,,,,,
2024-04-24,12:43:00,17722.25,SELL,3,0.02h,Break Even,$-1.50,$-1.50,$74736.50,81,$-1.50
2024-04-24,13:25:00,17705.25,BUY,3,0.02h,Stop Loss,$48.00,$46.50,$74784.50,81,$46.50
2024-04-24,13:57:00,17716.75,SELL,3,0.02h,Break Even,$-1.50,$45.00,$74783.00,81,$45.00
2024-04-24,14:08:00,17768.75,BUY,3,0.02h,Stop Loss,$22.50,$67.50,$74805.50,81,$67.50
2024-04-24,14:14:00,17740.75,SELL,3,0.02h,Stop Loss,$117.00,$184.50,$74922.50,81,$184.50
2024-04-24,15:33:00,17669.5,BUY,3,0.02h,Stop Loss,$7.50,$192.00,$74930.00,81,$192.00
2024-04-24,15:44:00,17639.25,SELL,3,0.02h,Stop Loss,$75.00,$267.00,$75005.00,81,$267.00
2024-04-24,16:53:00,17603.5,BUY,3,0.02h,Stop Loss,$9.00,$276.00,$75014.00,81,$276.00
2024-04-24,18:06:00,17668.25,SELL,3,0.02h,Break Even,$-1.50,$274.50,$75012.50,81,$274.50
2024-04-24,19:11:00,17637.5,BUY,3,0.02h,Stop Loss,$34.50,$309.00,$75047.00,81,$309.00
2024-04-24,20:01:00,17665.25,SELL,3,0.02h,Stop Loss,$16.50,$325.50,$75063.50,81,$325.50
2024-04-24,20:02:00,17672.5,BUY,3,0.02h,Break Even,$-1.50,$324.00,$75062.00,81,$324.00
2024-04-24,20:03:00,17666.75,SELL,3,0.02h,Stop Loss,$30.00,$354.00,$75092.00,81,$354.00
2024-04-24,20:55:00,17517.0,BUY,3,0.02h,Break Even,$-1.50,$352.50,$75090.50,81,$352.50
2024-04-24,20:59:00,17502.5,SELL,3,0.02h,Break Even,$-1.50,$351.00,$75089.00,81,$351.00
2024-04-24,22:30:00,17483.75,BUY,3,0.02h,Break Even,$-1.50,$349.50,$75087.50,81,$349.50
2024-04-24,22:37:00,17466.25,SELL,3,0.02h,Stop Loss,$33.00,$382.50,$75120.50,81,$382.50
,,,,,,,,,,,
2024-04-25,12:00:00,17501.0,BUY,3,0.02h,Stop Loss,$-9.00,$-9.00,$75111.50,82,$-9.00
2024-04-25,12:13:00,17465.75,SELL,3,0.02h,Stop Loss,$-9.00,$-18.00,$75102.50,82,$-18.00
2024-04-25,13:44:00,17368.5,BUY,3,0.02h,Stop Loss,$22.50,$4.50,$75125.00,82,$4.50
2024-04-25,14:01:00,17342.0,SELL,3,0.02h,Stop Loss,$46.50,$51.00,$75171.50,82,$51.00
2024-04-25,14:06:00,17370.0,BUY,3,0.02h,Stop Loss,$73.50,$124.50,$75245.00,82,$124.50
2024-04-25,14:35:00,17382.5,SELL,3,0.02h,Break Even,$-1.50,$123.00,$75243.50,82,$123.00
2024-04-25,15:06:00,17378.0,BUY,3,0.02h,Stop Loss,$16.50,$139.50,$75260.00,82,$139.50
2024-04-25,15:18:00,17362.0,SELL,3,0.02h,Stop Loss,$18.00,$157.50,$75278.00,82,$157.50
2024-04-25,15:27:00,17380.75,BUY,3,0.02h,Stop Loss,$13.50,$171.00,$75291.50,82,$171.00
2024-04-25,15:49:00,17371.75,SELL,3,0.02h,Stop Loss,$12.00,$183.00,$75303.50,82,$183.00
2024-04-25,15:55:00,17394.0,BUY,3,0.02h,Stop Loss,$27.00,$210.00,$75330.50,82,$210.00
2024-04-25,17:21:00,17484.25,SELL,3,0.02h,Stop Loss,$37.50,$247.50,$75368.00,82,$247.50
2024-04-25,17:31:00,17502.0,BUY,3,0.02h,Break Even,$-1.50,$246.00,$75366.50,82,$246.00
2024-04-25,18:26:00,17557.75,SELL,3,0.02h,Break Even,$-1.50,$244.50,$75365.00,82,$244.50
2024-04-25,19:01:00,17534.0,BUY,3,0.02h,Stop Loss,$18.00,$262.50,$75383.00,82,$262.50
2024-04-25,19:38:00,17570.0,SELL,3,0.02h,Stop Loss,$40.50,$303.00,$75423.50,82,$303.00
2024-04-25,20:00:00,17569.25,BUY,3,0.02h,Stop Loss,$313.50,$616.50,$75737.00,82,$616.50
2024-04-25,22:02:00,17787.25,SELL,3,0.02h,Stop Loss,$4.50,$621.00,$75741.50,82,$621.00
2024-04-25,22:35:00,17774.25,BUY,3,0.02h,Stop Loss,$-9.00,$612.00,$75732.50,82,$612.00
2024-04-25,22:53:00,17773.5,SELL,3,0.02h,Stop Loss,$-9.00,$603.00,$75723.50,82,$603.00
,,,,,,,,,,,
2024-04-26,12:31:00,17795.5,BUY,3,0.02h,Stop Loss,$79.50,$79.50,$75803.00,83,$79.50
2024-04-26,12:42:00,17736.0,SELL,3,0.02h,Stop Loss,$30.00,$109.50,$75833.00,83,$109.50
2024-04-26,12:45:00,17754.0,BUY,3,0.02h,Break Even,$-1.50,$108.00,$75831.50,83,$108.00
2024-04-26,12:47:00,17735.75,SELL,3,0.02h,Break Even,$-1.50,$106.50,$75830.00,83,$106.50
2024-04-26,13:02:00,17742.5,BUY,3,0.02h,Stop Loss,$18.00,$124.50,$75848.00,83,$124.50
2024-04-26,13:07:00,17717.0,SELL,3,0.02h,Stop Loss,$-9.00,$115.50,$75839.00,83,$115.50
2024-04-26,13:36:00,17734.5,BUY,3,0.02h,Stop Loss,$7.50,$123.00,$75846.50,83,$123.00
2024-04-26,14:31:00,17788.25,SELL,3,0.02h,Break Even,$-1.50,$121.50,$75845.00,83,$121.50
2024-04-26,14:36:00,17828.75,BUY,3,0.02h,Break Even,$-1.50,$120.00,$75843.50,83,$120.00
2024-04-26,15:13:00,17825.25,SELL,3,0.02h,Stop Loss,$9.00,$129.00,$75852.50,83,$129.00
2024-04-26,15:44:00,17849.75,BUY,3,0.02h,Stop Loss,$55.50,$184.50,$75908.00,83,$184.50
2024-04-26,16:01:00,17831.75,SELL,3,0.02h,Break Even,$-1.50,$183.00,$75906.50,83,$183.00
2024-04-26,16:26:00,17851.0,BUY,3,0.02h,Stop Loss,$-9.00,$174.00,$75897.50,83,$174.00
2024-04-26,16:32:00,17835.75,SELL,3,0.02h,Stop Loss,$-9.00,$165.00,$75888.50,83,$165.00
2024-04-26,16:35:00,17854.5,BUY,3,0.02h,Break Even,$-1.50,$163.50,$75887.00,83,$163.50
2024-04-26,17:41:00,17876.75,SELL,3,0.02h,Stop Loss,$69.00,$232.50,$75956.00,83,$232.50
2024-04-26,17:49:00,17892.0,BUY,3,0.02h,Stop Loss,$15.00,$247.50,$75971.00,83,$247.50
2024-04-26,17:57:00,17884.25,SELL,3,0.02h,Stop Loss,$13.50,$261.00,$75984.50,83,$261.00
2024-04-26,18:59:00,17861.25,BUY,3,0.02h,Stop Loss,$21.00,$282.00,$76005.50,83,$282.00
2024-04-26,19:42:00,17872.75,SELL,3,0.02h,Stop Loss,$-9.00,$273.00,$75996.50,83,$273.00
2024-04-26,20:42:00,17838.25,BUY,3,0.02h,Stop Loss,$-9.00,$264.00,$75987.50,83,$264.00
2024-04-26,20:44:00,17836.5,SELL,3,0.03h,Break Even,$-1.50,$262.50,$75986.00,83,$262.50
2024-04-26,20:49:00,17839.0,BUY,3,0.02h,Break Even,$-1.50,$261.00,$75984.50,83,$261.00
,,,,,,,,,,,
2024-04-29,12:37:00,17906.75,SELL,3,0.02h,Break Even,$-1.50,$-1.50,$75983.00,84,$-1.50
2024-04-29,12:41:00,17912.0,BUY,3,0.02h,Stop Loss,$7.50,$6.00,$75990.50,84,$6.00
2024-04-29,13:09:00,17915.0,SELL,3,0.02h,Break Even,$-1.50,$4.50,$75989.00,84,$4.50
2024-04-29,13:31:00,17915.0,BUY,3,0.02h,Stop Loss,$133.50,$138.00,$76122.50,84,$138.00
2024-04-29,13:40:00,17896.5,SELL,3,0.02h,Stop Loss,$126.00,$264.00,$76248.50,84,$264.00
2024-04-29,14:05:00,17872.25,BUY,3,0.02h,Break Even,$-1.50,$262.50,$76247.00,84,$262.50
2024-04-29,14:40:00,17877.0,SELL,3,0.02h,Stop Loss,$-9.00,$253.50,$76238.00,84,$253.50
2024-04-29,15:20:00,17888.0,BUY,3,0.02h,Stop Loss,$-9.00,$244.50,$76229.00,84,$244.50
2024-04-29,15:23:00,17876.75,SELL,3,0.02h,Stop Loss,$22.50,$267.00,$76251.50,84,$267.00
2024-04-29,15:45:00,17883.25,BUY,3,0.02h,Stop Loss,$-9.00,$258.00,$76242.50,84,$258.00
2024-04-29,16:42:00,17888.25,SELL,3,0.02h,Stop Loss,$-9.00,$249.00,$76233.50,84,$249.00
2024-04-29,16:44:00,17904.5,BUY,3,0.02h,Stop Loss,$12.00,$261.00,$76245.50,84,$261.00
2024-04-29,16:49:00,17898.75,SELL,3,0.02h,Break Even,$-1.50,$259.50,$76244.00,84,$259.50
2024-04-29,17:18:00,17895.75,BUY,3,0.02h,Break Even,$-1.50,$258.00,$76242.50,84,$258.00
2024-04-29,17:54:00,17916.0,SELL,3,0.02h,Break Even,$-1.50,$256.50,$76241.00,84,$256.50
2024-04-29,18:47:00,17881.5,BUY,3,0.02h,Stop Loss,$4.50,$261.00,$76245.50,84,$261.00
2024-04-29,19:01:00,17852.5,SELL,3,0.02h,Stop Loss,$60.00,$321.00,$76305.50,84,$321.00
2024-04-29,19:23:00,17850.75,BUY,3,0.02h,Stop Loss,$-9.00,$312.00,$76296.50,84,$312.00
2024-04-29,20:46:00,17913.75,SELL,3,0.02h,Break Even,$-1.50,$310.50,$76295.00,84,$310.50
2024-04-29,22:29:00,17912.75,BUY,3,0.02h,Stop Loss,$-9.00,$301.50,$76286.00,84,$301.50
2024-04-29,22:39:00,17909.0,SELL,3,0.02h,Stop Loss,$-9.00,$292.50,$76277.00,84,$292.50
,,,,,,,,,,,
2024-04-30,12:56:00,17834.5,BUY,3,0.02h,Stop Loss,$-9.00,$-9.00,$76268.00,85,$-9.00
2024-04-30,12:58:00,17822.0,SELL,3,0.02h,Stop Loss,$3.00,$-6.00,$76271.00,85,$-6.00
2024-04-30,13:09:00,17829.25,BUY,3,0.02h,Break Even,$-1.50,$-7.50,$76269.50,85,$-7.50
2024-04-30,13:10:00,17820.75,SELL,3,0.02h,Stop Loss,$-9.00,$-16.50,$76260.50,85,$-16.50
2024-04-30,13:11:00,17832.5,BUY,3,0.02h,Break Even,$-1.50,$-18.00,$76259.00,85,$-18.00
2024-04-30,14:13:00,17846.5,SELL,3,0.02h,Stop Loss,$-9.00,$-27.00,$76250.00,85,$-27.00
2024-04-30,14:16:00,17872.5,BUY,3,0.02h,Break Even,$-1.50,$-28.50,$76248.50,85,$-28.50
2024-04-30,14:22:00,17858.5,SELL,3,0.02h,Stop Loss,$-9.00,$-37.50,$76239.50,85,$-37.50
2024-04-30,14:43:00,17862.75,BUY,3,0.02h,Stop Loss,$-9.00,$-46.50,$76230.50,85,$-46.50
2024-04-30,14:55:00,17841.0,SELL,3,0.02h,Stop Loss,$10.50,$-36.00,$76241.00,85,$-36.00
2024-04-30,15:58:00,17765.5,BUY,3,0.02h,Stop Loss,$-9.00,$-45.00,$76232.00,85,$-45.00
2024-04-30,16:06:00,17746.75,SELL,3,0.02h,Break Even,$-1.50,$-46.50,$76230.50,85,$-46.50
2024-04-30,16:12:00,17760.5,BUY,3,0.02h,Stop Loss,$-9.00,$-55.50,$76221.50,85,$-55.50
2024-04-30,16:32:00,17743.75,SELL,3,0.02h,Stop Loss,$60.00,$4.50,$76281.50,85,$4.50
2024-04-30,17:04:00,17717.25,BUY,3,0.02h,Stop Loss,$-9.00,$-4.50,$76272.50,85,$-4.50
2024-04-30,17:12:00,17695.0,SELL,3,0.02h,Stop Loss,$97.50,$93.00,$76370.00,85,$93.00
2024-04-30,17:25:00,17702.5,BUY,3,0.02h,Stop Loss,$28.50,$121.50,$76398.50,85,$121.50
2024-04-30,18:14:00,17717.5,SELL,3,0.02h,Stop Loss,$-9.00,$112.50,$76389.50,85,$112.50
2024-04-30,18:39:00,17719.25,BUY,3,0.02h,Stop Loss,$-9.00,$103.50,$76380.50,85,$103.50
2024-04-30,18:46:00,17704.0,SELL,3,0.02h,Stop Loss,$16.50,$120.00,$76397.00,85,$120.00
2024-04-30,19:07:00,17695.5,BUY,3,0.02h,Stop Loss,$27.00,$147.00,$76424.00,85,$147.00
2024-04-30,19:17:00,17686.75,SELL,3,0.02h,Stop Loss,$39.00,$186.00,$76463.00,85,$186.00
2024-04-30,19:32:00,17692.75,BUY,3,0.02h,Stop Loss,$30.00,$216.00,$76493.00,85,$216.00
2024-04-30,19:45:00,17683.75,SELL,3,0.02h,Stop Loss,$-9.00,$207.00,$76484.00,85,$207.00
2024-04-30,19:49:00,17695.0,BUY,3,0.02h,Stop Loss,$60.00,$267.00,$76544.00,85,$267.00
2024-04-30,19:52:00,17664.0,SELL,3,0.02h,Stop Loss,$61.50,$328.50,$76605.50,85,$328.50
2024-04-30,22:34:00,17494.25,BUY,3,0.02h,Stop Loss,$-9.00,$319.50,$76596.50,85,$319.50
2024-04-30,22:51:00,17493.25,SELL,3,0.02h,Stop Loss,$-9.00,$310.50,$76587.50,85,$310.50
2024-04-30,22:54:00,17498.5,BUY,3,0.02h,Break Even,$-1.50,$309.00,$76586.00,85,$309.00
,,,,,,,,,,,
2024-05-01,12:00:00,17446.75,SELL,3,0.02h,Stop Loss,$16.50,$16.50,$76602.50,86,$16.50
2024-05-01,12:20:00,17477.0,BUY,3,0.02h,Break Even,$-1.50,$15.00,$76601.00,86,$15.00
2024-05-01,13:05:00,17496.75,SELL,3,0.02h,Break Even,$-1.50,$13.50,$76599.50,86,$13.50
2024-05-01,13:07:00,17499.5,BUY,3,0.02h,Break Even,$-1.50,$12.00,$76598.00,86,$12.00
2024-05-01,13:30:00,17500.25,SELL,3,0.02h,Stop Loss,$67.50,$79.50,$76665.50,86,$79.50
2024-05-01,13:31:00,17512.5,BUY,3,0.02h,Stop Loss,$-9.00,$70.50,$76656.50,86,$70.50
2024-05-01,13:32:00,17487.5,SELL,3,0.02h,Stop Loss,$39.00,$109.50,$76695.50,86,$109.50
2024-05-01,14:28:00,17477.0,BUY,3,0.02h,Stop Loss,$16.50,$126.00,$76712.00,86,$126.00
2024-05-01,15:04:00,17476.25,SELL,3,0.02h,Stop Loss,$13.50,$139.50,$76725.50,86,$139.50
2024-05-01,15:34:00,17455.0,BUY,3,0.02h,Stop Loss,$34.50,$174.00,$76760.00,86,$174.00
2024-05-01,15:52:00,17438.5,SELL,3,0.02h,Stop Loss,$10.50,$184.50,$76770.50,86,$184.50
2024-05-01,16:13:00,17455.25,BUY,3,0.02h,Stop Loss,$9.00,$193.50,$76779.50,86,$193.50
2024-05-01,16:40:00,17445.5,SELL,3,0.02h,Stop Loss,$34.50,$228.00,$76814.00,86,$228.00
2024-05-01,17:24:00,17449.0,BUY,3,0.02h,Stop Loss,$-9.00,$219.00,$76805.00,86,$219.00
2024-05-01,19:22:00,17702.0,SELL,3,0.02h,Stop Loss,$142.50,$361.50,$76947.50,86,$361.50
2024-05-01,19:27:00,17748.5,BUY,3,0.02h,Stop Loss,$72.00,$433.50,$77019.50,86,$433.50
2024-05-01,19:30:00,17717.75,SELL,3,0.02h,Stop Loss,$198.00,$631.50,$77217.50,86,$631.50
2024-05-01,20:47:00,17470.5,BUY,3,0.02h,Stop Loss,$-9.00,$622.50,$77208.50,86,$622.50
2024-05-01,22:52:00,17498.5,SELL,3,0.02h,Stop Loss,$-9.00,$613.50,$77199.50,86,$613.50
2024-05-01,22:55:00,17502.0,BUY,3,0.02h,Break Even,$-1.50,$612.00,$77198.00,86,$612.00
,,,,,,,,,,,
2024-05-02,12:56:00,17585.0,SELL,3,0.02h,Break Even,$-1.50,$-1.50,$77196.50,87,$-1.50
2024-05-02,13:26:00,17582.5,BUY,3,0.02h,Stop Loss,$9.00,$7.50,$77205.50,87,$7.50
2024-05-02,13:32:00,17557.75,SELL,3,0.02h,Break Even,$-1.50,$6.00,$77204.00,87,$6.00
2024-05-02,14:25:00,17497.25,BUY,3,0.02h,Stop Loss,$61.50,$67.50,$77265.50,87,$67.50
2024-05-02,14:43:00,17460.75,SELL,3,0.02h,Stop Loss,$55.50,$123.00,$77321.00,87,$123.00
2024-05-02,14:51:00,17491.0,BUY,3,0.02h,Stop Loss,$25.50,$148.50,$77346.50,87,$148.50
2024-05-02,15:28:00,17519.0,SELL,3,0.02h,Stop Loss,$12.00,$160.50,$77358.50,87,$160.50
2024-05-02,15:48:00,17527.75,BUY,3,0.02h,Stop Loss,$-9.00,$151.50,$77349.50,87,$151.50
2024-05-02,16:12:00,17531.5,SELL,3,0.02h,Stop Loss,$15.00,$166.50,$77364.50,87,$166.50
2024-05-02,16:29:00,17538.75,BUY,3,0.02h,Break Even,$-1.50,$165.00,$77363.00,87,$165.00
2024-05-02,16:31:00,17515.5,SELL,3,0.02h,Stop Loss,$39.00,$204.00,$77402.00,87,$204.00
2024-05-02,16:45:00,17529.25,BUY,3,0.02h,Break Even,$-1.50,$202.50,$77400.50,87,$202.50
2024-05-02,16:58:00,17517.25,SELL,3,0.02h,Stop Loss,$-9.00,$193.50,$77391.50,87,$193.50
2024-05-02,17:01:00,17536.25,BUY,3,0.02h,Stop Loss,$7.50,$201.00,$77399.00,87,$201.00
2024-05-02,19:34:00,17651.5,SELL,3,0.02h,Stop Loss,$15.00,$216.00,$77414.00,87,$216.00
2024-05-02,20:01:00,17675.25,BUY,3,0.02h,Stop Loss,$16.50,$232.50,$77430.50,87,$232.50
2024-05-02,20:18:00,17650.25,SELL,3,0.02h,Break Even,$-1.50,$231.00,$77429.00,87,$231.00
2024-05-02,20:29:00,17662.25,BUY,3,0.02h,Break Even,$-1.50,$229.50,$77427.50,87,$229.50
2024-05-02,22:07:00,17729.0,SELL,3,0.02h,Stop Loss,$21.00,$250.50,$77448.50,87,$250.50
2024-05-02,22:14:00,17743.25,BUY,3,0.02h,Break Even,$-1.50,$249.00,$77447.00,87,$249.00
2024-05-02,22:34:00,17742.5,SELL,3,0.02h,Stop Loss,$-9.00,$240.00,$77438.00,87,$240.00
,,,,,,,,,,,
2024-05-03,12:01:00,17751.0,BUY,3,0.02h,Break Even,$-1.50,$-1.50,$77436.50,88,$-1.50
2024-05-03,12:30:00,17745.0,SELL,3,0.02h,Break Even,$-1.50,$-3.00,$77435.00,88,$-3.00
2024-05-03,12:31:00,17898.75,BUY,3,0.02h,Stop Loss,$90.00,$87.00,$77525.00,88,$87.00
2024-05-03,14:04:00,17949.0,SELL,3,0.02h,Stop Loss,$85.50,$172.50,$77610.50,88,$172.50
2024-05-03,14:32:00,17941.5,BUY,3,0.02h,Stop Loss,$42.00,$214.50,$77652.50,88,$214.50
2024-05-03,14:33:00,17931.0,SELL,3,0.02h,Stop Loss,$16.50,$231.00,$77669.00,88,$231.00
2024-05-03,14:37:00,17950.0,BUY,3,0.02h,Stop Loss,$6.00,$237.00,$77675.00,88,$237.00
2024-05-03,14:55:00,17938.75,SELL,3,0.02h,Stop Loss,$-9.00,$228.00,$77666.00,88,$228.00
2024-05-03,15:23:00,17943.25,BUY,3,0.02h,Stop Loss,$-9.00,$219.00,$77657.00,88,$219.00
2024-05-03,16:19:00,17987.25,SELL,3,0.02h,Stop Loss,$9.00,$228.00,$77666.00,88,$228.00
2024-05-03,16:25:00,17990.75,BUY,3,0.02h,Stop Loss,$10.50,$238.50,$77676.50,88,$238.50
2024-05-03,16:33:00,17985.5,SELL,3,0.02h,Stop Loss,$-9.00,$229.50,$77667.50,88,$229.50
2024-05-03,16:37:00,17993.0,BUY,3,0.02h,Break Even,$-1.50,$228.00,$77666.00,88,$228.00
2024-05-03,16:51:00,17987.0,SELL,3,0.02h,Stop Loss,$9.00,$237.00,$77675.00,88,$237.00
2024-05-03,17:09:00,17989.25,BUY,3,0.02h,Stop Loss,$-9.00,$228.00,$77666.00,88,$228.00
2024-05-03,17:32:00,17983.25,SELL,3,0.02h,Stop Loss,$76.50,$304.50,$77742.50,88,$304.50
2024-05-03,17:42:00,17997.75,BUY,3,0.02h,Stop Loss,$-9.00,$295.50,$77733.50,88,$295.50
2024-05-03,17:44:00,17980.0,SELL,3,0.02h,Break Even,$-1.50,$294.00,$77732.00,88,$294.00
2024-05-03,17:50:00,17989.0,BUY,3,0.02h,Break Even,$-1.50,$292.50,$77730.50,88,$292.50
2024-05-03,18:42:00,18017.0,SELL,3,0.02h,Stop Loss,$-9.00,$283.50,$77721.50,88,$283.50
2024-05-03,18:43:00,18020.75,BUY,3,0.02h,Stop Loss,$-9.00,$274.50,$77712.50,88,$274.50
2024-05-03,18:45:00,18012.5,SELL,3,0.02h,Stop Loss,$-9.00,$265.50,$77703.50,88,$265.50
2024-05-03,18:54:00,18020.25,BUY,3,0.02h,Stop Loss,$-9.00,$256.50,$77694.50,88,$256.50
2024-05-03,18:55:00,18014.0,SELL,3,0.02h,Stop Loss,$87.00,$343.50,$77781.50,88,$343.50
2024-05-03,19:07:00,18022.5,BUY,3,0.02h,Stop Loss,$-9.00,$334.50,$77772.50,88,$334.50
2024-05-03,19:19:00,18010.25,SELL,3,0.02h,Break Even,$-1.50,$333.00,$77771.00,88,$333.00
2024-05-03,19:30:00,18016.25,BUY,3,0.02h,Stop Loss,$-9.00,$324.00,$77762.00,88,$324.00
2024-05-03,19:31:00,18008.75,SELL,3,0.02h,Break Even,$-1.50,$322.50,$77760.50,88,$322.50
2024-05-03,20:02:00,18017.75,BUY,3,0.02h,Stop Loss,$-9.00,$313.50,$77751.50,88,$313.50
2024-05-03,20:49:00,18021.0,SELL,3,0.02h,Break Even,$-1.50,$312.00,$77750.00,88,$312.00
2024-05-03,20:58:00,18023.25,BUY,3,0.02h,Stop Loss,$-9.00,$303.00,$77741.00,88,$303.00
,,,,,,,,,,,
2024-05-06,12:48:00,18059.5,SELL,3,0.02h,Stop Loss,$-9.00,$-9.00,$77732.00,89,$-9.00
2024-05-06,12:50:00,18061.75,BUY,3,0.02h,Stop Loss,$-9.00,$-18.00,$77723.00,89,$-18.00
2024-05-06,12:55:00,18059.75,SELL,3,0.02h,Break Even,$-1.50,$-19.50,$77721.50,89,$-19.50
2024-05-06,13:04:00,18063.75,BUY,3,0.02h,Stop Loss,$-9.00,$-28.50,$77712.50,89,$-28.50
2024-05-06,13:07:00,18057.25,SELL,3,0.02h,Stop Loss,$-9.00,$-37.50,$77703.50,89,$-37.50
2024-05-06,13:12:00,18062.75,BUY,3,0.02h,Stop Loss,$-9.00,$-46.50,$77694.50,89,$-46.50
2024-05-06,13:14:00,18055.0,SELL,3,0.02h,Stop Loss,$-9.00,$-55.50,$77685.50,89,$-55.50
2024-05-06,13:19:00,18064.75,BUY,3,0.02h,Stop Loss,$-9.00,$-64.50,$77676.50,89,$-64.50
2024-05-06,13:32:00,18056.0,SELL,3,0.02h,Stop Loss,$60.00,$-4.50,$77736.50,89,$-4.50
2024-05-06,13:36:00,18076.75,BUY,3,0.02h,Stop Loss,$18.00,$13.50,$77754.50,89,$13.50
2024-05-06,14:14:00,18091.75,SELL,3,0.02h,Break Even,$-1.50,$12.00,$77753.00,89,$12.00
2024-05-06,14:16:00,18099.5,BUY,3,0.02h,Break Even,$-1.50,$10.50,$77751.50,89,$10.50
2024-05-06,14:17:00,18097.25,SELL,3,0.02h,Stop Loss,$52.50,$63.00,$77804.00,89,$63.00
2024-05-06,14:25:00,18100.5,BUY,3,0.02h,Stop Loss,$18.00,$81.00,$77822.00,89,$81.00
2024-05-06,14:30:00,18094.25,SELL,3,0.02h,Stop Loss,$-9.00,$72.00,$77813.00,89,$72.00
2024-05-06,14:39:00,18102.25,BUY,3,0.02h,Stop Loss,$-9.00,$63.00,$77804.00,89,$63.00
2024-05-06,14:48:00,18091.0,SELL,3,0.02h,Stop Loss,$-9.00,$54.00,$77795.00,89,$54.00
2024-05-06,14:52:00,18100.5,BUY,3,0.02h,Stop Loss,$22.50,$76.50,$77817.50,89,$76.50
2024-05-06,14:59:00,18095.0,SELL,3,0.02h,Break Even,$-1.50,$75.00,$77816.00,89,$75.00
2024-05-06,15:12:00,18096.5,BUY,3,0.02h,Break Even,$-1.50,$73.50,$77814.50,89,$73.50
2024-05-06,15:14:00,18087.0,SELL,3,0.02h,Stop Loss,$4.50,$78.00,$77819.00,89,$78.00
2024-05-06,15:24:00,18101.25,BUY,3,0.02h,Stop Loss,$-9.00,$69.00,$77810.00,89,$69.00
2024-05-06,16:02:00,18103.25,SELL,3,0.02h,Stop Loss,$3.00,$72.00,$77813.00,89,$72.00
2024-05-06,16:34:00,18096.5,BUY,3,0.02h,Break Even,$-1.50,$70.50,$77811.50,89,$70.50
2024-05-06,16:55:00,18099.0,SELL,3,0.02h,Break Even,$-1.50,$69.00,$77810.00,89,$69.00
2024-05-06,16:57:00,18104.5,BUY,3,0.02h,Stop Loss,$18.00,$87.00,$77828.00,89,$87.00
2024-05-06,17:12:00,18096.0,SELL,3,0.02h,Stop Loss,$-9.00,$78.00,$77819.00,89,$78.00
2024-05-06,17:25:00,18111.75,BUY,3,0.02h,Stop Loss,$-9.00,$69.00,$77810.00,89,$69.00
2024-05-06,18:23:00,18131.0,SELL,3,0.02h,Stop Loss,$-9.00,$60.00,$77801.00,89,$60.00
2024-05-06,18:24:00,18135.25,BUY,3,0.02h,Stop Loss,$19.50,$79.50,$77820.50,89,$79.50
2024-05-06,18:42:00,18133.75,SELL,3,0.02h,Break Even,$-1.50,$78.00,$77819.00,89,$78.00
2024-05-06,18:48:00,18142.75,BUY,3,0.02h,Stop Loss,$3.00,$81.00,$77822.00,89,$81.00
2024-05-06,19:14:00,18137.5,SELL,3,0.02h,Stop Loss,$-9.00,$72.00,$77813.00,89,$72.00
2024-05-06,19:23:00,18145.25,BUY,3,0.02h,Stop Loss,$-9.00,$63.00,$77804.00,89,$63.00
2024-05-06,19:31:00,18136.5,SELL,3,0.02h,Stop Loss,$10.50,$73.50,$77814.50,89,$73.50
2024-05-06,19:38:00,18149.75,BUY,3,0.02h,Stop Loss,$-9.00,$64.50,$77805.50,89,$64.50
2024-05-06,20:56:00,18183.5,SELL,3,0.02h,Stop Loss,$-9.00,$55.50,$77796.50,89,$55.50
2024-05-06,22:17:00,18184.75,BUY,3,0.02h,Stop Loss,$-9.00,$46.50,$77787.50,89,$46.50
,,,,,,,,,,,
2024-05-07,12:00:00,18164.75,SELL,3,0.02h,Stop Loss,$-9.00,$-9.00,$77778.50,90,$-9.00
2024-05-07,12:42:00,18171.5,BUY,3,0.02h,Stop Loss,$7.50,$-1.50,$77786.00,90,$-1.50
2024-05-07,13:52:00,18200.75,SELL,3,0.02h,Stop Loss,$7.50,$6.00,$77793.50,90,$6.00
2024-05-07,14:14:00,18208.75,BUY,3,0.02h,Stop Loss,$40.50,$46.50,$77834.00,90,$46.50
2024-05-07,14:24:00,18191.5,SELL,3,0.02h,Stop Loss,$12.00,$58.50,$77846.00,90,$58.50
2024-05-07,14:39:00,18205.0,BUY,3,0.02h,Break Even,$-1.50,$57.00,$77844.50,90,$57.00
2024-05-07,15:34:00,18236.75,SELL,3,0.02h,Break Even,$-1.50,$55.50,$77843.00,90,$55.50
2024-05-07,15:45:00,18252.5,BUY,3,0.02h,Stop Loss,$-9.00,$46.50,$77834.00,90,$46.50
2024-05-07,16:23:00,18251.0,SELL,3,0.02h,Break Even,$-1.50,$45.00,$77832.50,90,$45.00
2024-05-07,16:25:00,18257.5,BUY,3,0.02h,Break Even,$-1.50,$43.50,$77831.00,90,$43.50
2024-05-07,16:32:00,18250.5,SELL,3,0.02h,Break Even,$-1.50,$42.00,$77829.50,90,$42.00
2024-05-07,16:44:00,18258.25,BUY,3,0.02h,Stop Loss,$-9.00,$33.00,$77820.50,90,$33.00
2024-05-07,16:46:00,18245.75,SELL,3,0.02h,Break Even,$-1.50,$31.50,$77819.00,90,$31.50
2024-05-07,17:09:00,18244.75,BUY,3,0.02h,Break Even,$-1.50,$30.00,$77817.50,90,$30.00
2024-05-07,17:18:00,18240.0,SELL,3,0.02h,Stop Loss,$9.00,$39.00,$77826.50,90,$39.00
2024-05-07,17:21:00,18247.75,BUY,3,0.02h,Stop Loss,$3.00,$42.00,$77829.50,90,$42.00
2024-05-07,17:41:00,18240.75,SELL,3,0.02h,Stop Loss,$-9.00,$33.00,$77820.50,90,$33.00
2024-05-07,18:45:00,18191.5,BUY,3,0.02h,Stop Loss,$-9.00,$24.00,$77811.50,90,$24.00
2024-05-07,19:19:00,18186.5,SELL,3,0.02h,Stop Loss,$-9.00,$15.00,$77802.50,90,$15.00
2024-05-07,19:22:00,18201.25,BUY,3,0.02h,Stop Loss,$-9.00,$6.00,$77793.50,90,$6.00
2024-05-07,19:33:00,18192.0,SELL,3,0.02h,Break Even,$-1.50,$4.50,$77792.00,90,$4.50
2024-05-07,19:37:00,18201.5,BUY,3,0.02h,Break Even,$-1.50,$3.00,$77790.50,90,$3.00
2024-05-07,19:39:00,18195.0,SELL,3,0.02h,Break Even,$-1.50,$1.50,$77789.00,90,$1.50
2024-05-07,19:40:00,18202.25,BUY,3,0.02h,Break Even,$-1.50,$0.00,$77787.50,90,$0.00
2024-05-07,19:43:00,18193.25,SELL,3,0.02h,Break Even,$-1.50,$-1.50,$77786.00,90,$-1.50
2024-05-07,19:49:00,18201.5,BUY,3,0.02h,Stop Loss,$7.50,$6.00,$77793.50,90,$6.00
2024-05-07,20:03:00,18199.5,SELL,3,0.02h,Stop Loss,$-9.00,$-3.00,$77784.50,90,$-3.00
2024-05-07,20:06:00,18208.5,BUY,3,0.02h,Break Even,$-1.50,$-4.50,$77783.00,90,$-4.50
2024-05-07,20:31:00,18207.0,SELL,3,0.02h,Break Even,$-1.50,$-6.00,$77781.50,90,$-6.00
2024-05-07,22:23:00,18193.75,BUY,3,0.02h,Break Even,$-1.50,$-7.50,$77780.00,90,$-7.50
,,,,,,,,,,,
2024-05-08,12:00:00,18152.5,SELL,3,0.02h,Stop Loss,$30.00,$30.00,$77810.00,91,$30.00
2024-05-08,13:18:00,18091.0,BUY,3,0.02h,Stop Loss,$-9.00,$21.00,$77801.00,91,$21.00
2024-05-08,13:19:00,18088.25,SELL,3,0.02h,Break Even,$-1.50,$19.50,$77799.50,91,$19.50
2024-05-08,13:28:00,18092.25,BUY,3,0.02h,Break Even,$-1.50,$18.00,$77798.00,91,$18.00
2024-05-08,13:30:00,18083.25,SELL,3,0.02h,Stop Loss,$4.50,$22.50,$77802.50,91,$22.50
2024-05-08,13:31:00,18097.25,BUY,3,0.02h,Stop Loss,$48.00,$70.50,$77850.50,91,$70.50
2024-05-08,15:06:00,18208.0,SELL,3,0.02h,Break Even,$-1.50,$69.00,$77849.00,91,$69.00
2024-05-08,16:19:00,18182.75,BUY,3,0.02h,Stop Loss,$21.00,$90.00,$77870.00,91,$90.00
2024-05-08,16:36:00,18160.25,SELL,3,0.02h,Stop Loss,$10.50,$100.50,$77880.50,91,$100.50
2024-05-08,16:50:00,18176.0,BUY,3,0.02h,Stop Loss,$-9.00,$91.50,$77871.50,91,$91.50
2024-05-08,16:51:00,18169.75,SELL,3,0.02h,Break Even,$-1.50,$90.00,$77870.00,91,$90.00
2024-05-08,17:44:00,18159.75,BUY,3,0.02h,Stop Loss,$25.50,$115.50,$77895.50,91,$115.50
2024-05-08,18:27:00,18176.5,SELL,3,0.02h,Stop Loss,$-9.00,$106.50,$77886.50,91,$106.50
2024-05-08,18:29:00,18186.0,BUY,3,0.02h,Stop Loss,$-9.00,$97.50,$77877.50,91,$97.50
2024-05-08,18:42:00,18176.5,SELL,3,0.02h,Break Even,$-1.50,$96.00,$77876.00,91,$96.00
2024-05-08,19:18:00,18180.25,BUY,3,0.02h,Break Even,$-1.50,$94.50,$77874.50,91,$94.50
2024-05-08,20:01:00,18178.0,SELL,3,0.02h,Stop Loss,$-9.00,$85.50,$77865.50,91,$85.50
2024-05-08,20:55:00,18161.0,BUY,3,0.02h,Break Even,$-1.50,$84.00,$77864.00,91,$84.00
2024-05-08,22:03:00,18158.75,SELL,3,0.02h,Break Even,$-1.50,$82.50,$77862.50,91,$82.50
2024-05-08,22:06:00,18163.5,BUY,3,0.02h,Break Even,$-1.50,$81.00,$77861.00,91,$81.00
2024-05-08,22:43:00,18168.25,SELL,3,0.03h,Break Even,$-1.50,$79.50,$77859.50,91,$79.50
,,,,,,,,,,,
2024-05-09,12:25:00,18159.25,BUY,3,0.02h,Break Even,$-1.50,$-1.50,$77858.00,92,$-1.50
2024-05-09,13:23:00,18196.75,SELL,3,0.02h,Break Even,$-1.50,$-3.00,$77856.50,92,$-3.00
2024-05-09,14:01:00,18160.5,BUY,3,0.02h,Stop Loss,$15.00,$12.00,$77871.50,92,$12.00
2024-05-09,14:17:00,18148.5,SELL,3,0.02h,Stop Loss,$7.50,$19.50,$77879.00,92,$19.50
2024-05-09,14:26:00,18160.5,BUY,3,0.02h,Stop Loss,$24.00,$43.50,$77903.00,92,$43.50
2024-05-09,14:30:00,18151.25,SELL,3,0.02h,Stop Loss,$-9.00,$34.50,$77894.00,92,$34.50
2024-05-09,14:31:00,18166.25,BUY,3,0.02h,Stop Loss,$24.00,$58.50,$77918.00,92,$58.50
2024-05-09,15:42:00,18212.0,SELL,3,0.02h,Stop Loss,$-9.00,$49.50,$77909.00,92,$49.50
2024-05-09,16:15:00,18199.25,BUY,3,0.02h,Break Even,$-1.50,$48.00,$77907.50,92,$48.00
2024-05-09,16:34:00,18185.5,SELL,3,0.02h,Stop Loss,$10.50,$58.50,$77918.00,92,$58.50
2024-05-09,16:38:00,18205.5,BUY,3,0.02h,Break Even,$-1.50,$57.00,$77916.50,92,$57.00
2024-05-09,17:20:00,18215.25,SELL,3,0.02h,Stop Loss,$141.00,$198.00,$78057.50,92,$198.00
2024-05-09,17:31:00,18215.75,BUY,3,0.02h,Break Even,$-1.50,$196.50,$78056.00,92,$196.50
2024-05-09,17:38:00,18212.5,SELL,3,0.02h,Stop Loss,$-9.00,$187.50,$78047.00,92,$187.50
2024-05-09,17:39:00,18215.0,BUY,3,0.02h,Stop Loss,$-9.00,$178.50,$78038.00,92,$178.50
2024-05-09,17:42:00,18213.0,SELL,3,0.02h,Break Even,$-1.50,$177.00,$78036.50,92,$177.00
2024-05-09,17:45:00,18218.25,BUY,3,0.02h,Stop Loss,$12.00,$189.00,$78048.50,92,$189.00
2024-05-09,17:49:00,18209.25,SELL,3,0.02h,Stop Loss,$-9.00,$180.00,$78039.50,92,$180.00
2024-05-09,18:28:00,18213.75,BUY,3,0.02h,Stop Loss,$3.00,$183.00,$78042.50,92,$183.00
2024-05-09,19:11:00,18222.5,SELL,3,0.02h,Stop Loss,$13.50,$196.50,$78056.00,92,$196.50
2024-05-09,19:54:00,18211.5,BUY,3,0.02h,Break Even,$-1.50,$195.00,$78054.50,92,$195.00
2024-05-09,19:56:00,18201.5,SELL,3,0.02h,Stop Loss,$7.50,$202.50,$78062.00,92,$202.50
2024-05-09,20:00:00,18215.75,BUY,3,0.02h,Stop Loss,$-9.00,$193.50,$78053.00,92,$193.50
2024-05-09,20:37:00,18228.0,SELL,3,0.03h,Break Even,$-1.50,$192.00,$78051.50,92,$192.00
2024-05-09,20:40:00,18230.0,BUY,3,0.05h,Break Even,$-1.50,$190.50,$78050.00,92,$190.50
2024-05-09,20:52:00,18228.25,SELL,3,0.02h,Break Even,$-1.50,$189.00,$78048.50,92,$189.00
2024-05-09,22:13:00,18227.5,BUY,3,0.02h,Break Even,$-1.50,$187.50,$78047.00,92,$187.50
,,,,,,,,,,,
2024-05-10,12:38:00,18277.75,SELL,3,0.02h,Stop Loss,$7.50,$7.50,$78054.50,93,$7.50
2024-05-10,13:11:00,18269.75,BUY,3,0.02h,Stop Loss,$-9.00,$-1.50,$78045.50,93,$-1.50
2024-05-10,14:02:00,18293.75,SELL,3,0.02h,Break Even,$-1.50,$-3.00,$78044.00,93,$-3.00
2024-05-10,15:16:00,18232.0,BUY,3,0.02h,Break Even,$-1.50,$-4.50,$78042.50,93,$-4.50
2024-05-10,15:38:00,18215.0,SELL,3,0.02h,Stop Loss,$-9.00,$-13.50,$78033.50,93,$-13.50
2024-05-10,15:53:00,18227.5,BUY,3,0.02h,Stop Loss,$27.00,$13.50,$78060.50,93,$13.50
2024-05-10,16:05:00,18214.0,SELL,3,0.02h,Stop Loss,$-9.00,$4.50,$78051.50,93,$4.50
2024-05-10,16:11:00,18227.75,BUY,3,0.02h,Break Even,$-1.50,$3.00,$78050.00,93,$3.00
2024-05-10,16:37:00,18226.25,SELL,3,0.02h,Stop Loss,$4.50,$7.50,$78054.50,93,$7.50
2024-05-10,16:49:00,18246.5,BUY,3,0.02h,Stop Loss,$10.50,$18.00,$78065.00,93,$18.00
2024-05-10,17:06:00,18235.75,SELL,3,0.02h,Break Even,$-1.50,$16.50,$78063.50,93,$16.50
2024-05-10,17:38:00,18231.75,BUY,3,0.02h,Break Even,$-1.50,$15.00,$78062.00,93,$15.00
2024-05-10,17:39:00,18225.0,SELL,3,0.02h,Stop Loss,$-9.00,$6.00,$78053.00,93,$6.00
2024-05-10,17:53:00,18235.25,BUY,3,0.02h,Break Even,$-1.50,$4.50,$78051.50,93,$4.50
2024-05-10,18:28:00,18247.25,SELL,3,0.02h,Stop Loss,$-9.00,$-4.50,$78042.50,93,$-4.50
2024-05-10,18:49:00,18248.25,BUY,3,0.02h,Stop Loss,$-9.00,$-13.50,$78033.50,93,$-13.50
2024-05-10,19:45:00,18250.75,SELL,3,0.02h,Break Even,$-1.50,$-15.00,$78032.00,93,$-15.00
2024-05-10,19:55:00,18265.0,BUY,3,0.02h,Break Even,$-1.50,$-16.50,$78030.50,93,$-16.50
2024-05-10,20:02:00,18248.5,SELL,3,0.02h,Break Even,$-1.50,$-18.00,$78029.00,93,$-18.00
,,,,,,,,,,,
2024-05-13,12:00:00,18318.0,BUY,3,0.02h,Break Even,$-1.50,$-1.50,$78027.50,94,$-1.50
2024-05-13,13:03:00,18312.25,SELL,3,0.02h,Stop Loss,$22.50,$21.00,$78050.00,94,$21.00
2024-05-13,13:14:00,18321.5,BUY,3,0.02h,Break Even,$-1.50,$19.50,$78048.50,94,$19.50
2024-05-13,13:34:00,18310.5,SELL,3,0.02h,Stop Loss,$91.50,$111.00,$78140.00,94,$111.00
2024-05-13,14:04:00,18293.25,BUY,3,0.02h,Stop Loss,$18.00,$129.00,$78158.00,94,$129.00
2024-05-13,14:33:00,18288.25,SELL,3,0.02h,Stop Loss,$-9.00,$120.00,$78149.00,94,$120.00
2024-05-13,14:50:00,18300.25,BUY,3,0.02h,Break Even,$-1.50,$118.50,$78147.50,94,$118.50
2024-05-13,15:01:00,18289.5,SELL,3,0.02h,Stop Loss,$-9.00,$109.50,$78138.50,94,$109.50
2024-05-13,15:10:00,18296.5,BUY,3,0.02h,Stop Loss,$37.50,$147.00,$78176.00,94,$147.00
2024-05-13,15:22:00,18287.0,SELL,3,0.02h,Stop Loss,$9.00,$156.00,$78185.00,94,$156.00
2024-05-13,15:53:00,18289.0,BUY,3,0.02h,Break Even,$-1.50,$154.50,$78183.50,94,$154.50
2024-05-13,16:43:00,18297.25,SELL,3,0.02h,Stop Loss,$-9.00,$145.50,$78174.50,94,$145.50
2024-05-13,17:21:00,18285.75,BUY,3,0.02h,Stop Loss,$30.00,$175.50,$78204.50,94,$175.50
2024-05-13,17:39:00,18279.25,SELL,3,0.02h,Break Even,$-1.50,$174.00,$78203.00,94,$174.00
2024-05-13,17:59:00,18285.0,BUY,3,0.02h,Stop Loss,$-9.00,$165.00,$78194.00,94,$165.00
2024-05-13,18:02:00,18272.5,SELL,3,0.02h,Stop Loss,$3.00,$168.00,$78197.00,94,$168.00
2024-05-13,18:14:00,18279.0,BUY,3,0.02h,Stop Loss,$-9.00,$159.00,$78188.00,94,$159.00
2024-05-13,18:17:00,18274.0,SELL,3,0.02h,Break Even,$-1.50,$157.50,$78186.50,94,$157.50
2024-05-13,18:18:00,18279.0,BUY,3,0.02h,Break Even,$-1.50,$156.00,$78185.00,94,$156.00
2024-05-13,18:34:00,18278.0,SELL,3,0.02h,Stop Loss,$-9.00,$147.00,$78176.00,94,$147.00
2024-05-13,18:35:00,18284.5,BUY,3,0.02h,Break Even,$-1.50,$145.50,$78174.50,94,$145.50
2024-05-13,18:50:00,18278.0,SELL,3,0.02h,Break Even,$-1.50,$144.00,$78173.00,94,$144.00
2024-05-13,19:00:00,18288.0,BUY,3,0.02h,Stop Loss,$-9.00,$135.00,$78164.00,94,$135.00
2024-05-13,19:25:00,18282.0,SELL,3,0.02h,Break Even,$-1.50,$133.50,$78162.50,94,$133.50
2024-05-13,19:34:00,18290.75,BUY,3,0.02h,Break Even,$-1.50,$132.00,$78161.00,94,$132.00
2024-05-13,19:50:00,18287.5,SELL,3,0.02h,Stop Loss,$-9.00,$123.00,$78152.00,94,$123.00
2024-05-13,19:53:00,18298.5,BUY,3,0.02h,Break Even,$-1.50,$121.50,$78150.50,94,$121.50
2024-05-13,19:57:00,18285.5,SELL,3,0.02h,Stop Loss,$-9.00,$112.50,$78141.50,94,$112.50
2024-05-13,20:01:00,18295.75,BUY,3,0.02h,Stop Loss,$6.00,$118.50,$78147.50,94,$118.50
2024-05-13,20:09:00,18288.0,SELL,3,0.02h,Break Even,$-1.50,$117.00,$78146.00,94,$117.00
2024-05-13,20:27:00,18290.25,BUY,3,0.07h,Break Even,$-1.50,$115.50,$78144.50,94,$115.50
2024-05-13,20:41:00,18289.5,SELL,3,0.02h,Break Even,$-1.50,$114.00,$78143.00,94,$114.00
2024-05-13,22:15:00,18285.5,BUY,3,0.10h,Break Even,$-1.50,$112.50,$78141.50,94,$112.50
2024-05-13,22:23:00,18281.25,SELL,3,0.02h,Break Even,$-1.50,$111.00,$78140.00,94,$111.00
2024-05-13,22:48:00,18281.5,BUY,3,0.07h,Break Even,$-1.50,$109.50,$78138.50,94,$109.50
,,,,,,,,,,,
2024-05-14,12:31:00,18221.0,SELL,3,0.02h,Stop Loss,$97.50,$97.50,$78236.00,95,$97.50
2024-05-14,12:54:00,18269.25,BUY,3,0.02h,Break Even,$-1.50,$96.00,$78234.50,95,$96.00
2024-05-14,13:01:00,18252.5,SELL,3,0.02h,Break Even,$-1.50,$94.50,$78233.00,95,$94.50
2024-05-14,13:10:00,18265.0,BUY,3,0.02h,Stop Loss,$16.50,$111.00,$78249.50,95,$111.00
2024-05-14,14:00:00,18290.0,SELL,3,0.02h,Stop Loss,$7.50,$118.50,$78257.00,95,$118.50
2024-05-14,14:12:00,18307.25,BUY,3,0.02h,Stop Loss,$25.50,$144.00,$78282.50,95,$144.00
2024-05-14,14:18:00,18286.0,SELL,3,0.02h,Stop Loss,$27.00,$171.00,$78309.50,95,$171.00
2024-05-14,14:23:00,18313.5,BUY,3,0.02h,Stop Loss,$108.00,$279.00,$78417.50,95,$279.00
2024-05-14,14:39:00,18302.5,SELL,3,0.02h,Stop Loss,$12.00,$291.00,$78429.50,95,$291.00
2024-05-14,14:58:00,18324.75,BUY,3,0.02h,Stop Loss,$60.00,$351.00,$78489.50,95,$351.00
2024-05-14,15:34:00,18337.5,SELL,3,0.02h,Stop Loss,$9.00,$360.00,$78498.50,95,$360.00
2024-05-14,16:10:00,18328.25,BUY,3,0.02h,Stop Loss,$-9.00,$351.00,$78489.50,95,$351.00
2024-05-14,16:18:00,18318.75,SELL,3,0.02h,Break Even,$-1.50,$349.50,$78488.00,95,$349.50
2024-05-14,16:55:00,18311.75,BUY,3,0.02h,Break Even,$-1.50,$348.00,$78486.50,95,$348.00
2024-05-14,17:07:00,18302.75,SELL,3,0.02h,Break Even,$-1.50,$346.50,$78485.00,95,$346.50
2024-05-14,17:23:00,18313.5,BUY,3,0.02h,Stop Loss,$3.00,$349.50,$78488.00,95,$349.50
2024-05-14,19:50:00,18413.0,SELL,3,0.02h,Stop Loss,$-9.00,$340.50,$78479.00,95,$340.50
2024-05-14,19:52:00,18424.5,BUY,3,0.02h,Stop Loss,$9.00,$349.50,$78488.00,95,$349.50
2024-05-14,20:01:00,18412.25,SELL,3,0.02h,Break Even,$-1.50,$348.00,$78486.50,95,$348.00
2024-05-14,20:51:00,18410.0,BUY,3,0.02h,Stop Loss,$-9.00,$339.00,$78477.50,95,$339.00
2024-05-14,22:04:00,18405.75,SELL,3,0.02h,Stop Loss,$-9.00,$330.00,$78468.50,95,$330.00
2024-05-14,22:06:00,18411.0,BUY,3,0.02h,Break Even,$-1.50,$328.50,$78467.00,95,$328.50
,,,,,,,,,,,
2024-05-15,12:00:00,18410.75,SELL,3,0.02h,Break Even,$-1.50,$-1.50,$78465.50,96,$-1.50
2024-05-15,12:31:00,18523.25,BUY,3,0.02h,Stop Loss,$121.50,$120.00,$78587.00,96,$120.00
2024-05-15,13:22:00,18501.25,SELL,3,0.02h,Stop Loss,$-9.00,$111.00,$78578.00,96,$111.00
2024-05-15,13:25:00,18510.25,BUY,3,0.02h,Stop Loss,$-9.00,$102.00,$78569.00,96,$102.00
2024-05-15,13:26:00,18500.0,SELL,3,0.02h,Break Even,$-1.50,$100.50,$78567.50,96,$100.50
2024-05-15,13:29:00,18509.0,BUY,3,0.02h,Stop Loss,$-9.00,$91.50,$78558.50,96,$91.50
2024-05-15,13:46:00,18504.5,SELL,3,0.02h,Stop Loss,$87.00,$178.50,$78645.50,96,$178.50
2024-05-15,14:04:00,18505.75,BUY,3,0.02h,Stop Loss,$22.50,$201.00,$78668.00,96,$201.00
2024-05-15,16:01:00,18582.75,SELL,3,0.02h,Stop Loss,$-9.00,$192.00,$78659.00,96,$192.00
2024-05-15,16:12:00,18601.0,BUY,3,0.02h,Stop Loss,$-9.00,$183.00,$78650.00,96,$183.00
2024-05-15,18:29:00,18683.0,SELL,3,0.02h,Stop Loss,$-9.00,$174.00,$78641.00,96,$174.00
2024-05-15,18:41:00,18689.75,BUY,3,0.02h,Stop Loss,$-9.00,$165.00,$78632.00,96,$165.00
2024-05-15,18:45:00,18680.5,SELL,3,0.02h,Stop Loss,$3.00,$168.00,$78635.00,96,$168.00
2024-05-15,18:55:00,18687.75,BUY,3,0.02h,Stop Loss,$-9.00,$159.00,$78626.00,96,$159.00
2024-05-15,19:03:00,18681.5,SELL,3,0.02h,Break Even,$-1.50,$157.50,$78624.50,96,$157.50
2024-05-15,19:06:00,18687.5,BUY,3,0.02h,Stop Loss,$-9.00,$148.50,$78615.50,96,$148.50
2024-05-15,19:34:00,18688.5,SELL,3,0.02h,Break Even,$-1.50,$147.00,$78614.00,96,$147.00
2024-05-15,19:57:00,18695.5,BUY,3,0.02h,Stop Loss,$12.00,$159.00,$78626.00,96,$159.00
2024-05-15,20:01:00,18681.5,SELL,3,0.02h,Stop Loss,$16.50,$175.50,$78642.50,96,$175.50
2024-05-15,20:31:00,18686.0,BUY,3,0.02h,Break Even,$-1.50,$174.00,$78641.00,96,$174.00
2024-05-15,20:51:00,18684.75,SELL,3,0.02h,Break Even,$-1.50,$172.50,$78639.50,96,$172.50
2024-05-15,20:57:00,18692.25,BUY,3,1.07h,Stop Loss,$21.00,$193.50,$78660.50,96,$193.50
2024-05-15,22:58:00,18698.75,SELL,3,0.02h,Stop Loss,$-9.00,$184.50,$78651.50,96,$184.50
,,,,,,,,,,,
2024-05-16,12:00:00,18715.0,BUY,3,0.02h,Stop Loss,$-9.00,$-9.00,$78642.50,97,$-9.00
2024-05-16,12:33:00,18709.25,SELL,3,0.02h,Stop Loss,$21.00,$12.00,$78663.50,97,$12.00
2024-05-16,13:39:00,18692.75,BUY,3,0.02h,Break Even,$-1.50,$10.50,$78662.00,97,$10.50
2024-05-16,14:07:00,18691.0,SELL,3,0.02h,Stop Loss,$84.00,$94.50,$78746.00,97,$94.50
2024-05-16,14:19:00,18702.75,BUY,3,0.02h,Stop Loss,$15.00,$109.50,$78761.00,97,$109.50
2024-05-16,15:17:00,18732.0,SELL,3,0.02h,Stop Loss,$6.00,$115.50,$78767.00,97,$115.50
2024-05-16,15:31:00,18744.25,BUY,3,0.02h,Break Even,$-1.50,$114.00,$78765.50,97,$114.00
2024-05-16,15:41:00,18734.25,SELL,3,0.02h,Break Even,$-1.50,$112.50,$78764.00,97,$112.50
2024-05-16,15:53:00,18742.0,BUY,3,0.02h,Stop Loss,$3.00,$115.50,$78767.00,97,$115.50
2024-05-16,16:01:00,18731.75,SELL,3,0.02h,Stop Loss,$108.00,$223.50,$78875.00,97,$223.50
2024-05-16,16:46:00,18727.0,BUY,3,0.02h,Break Even,$-1.50,$222.00,$78873.50,97,$222.00
2024-05-16,17:05:00,18724.0,SELL,3,0.02h,Break Even,$-1.50,$220.50,$78872.00,97,$220.50
2024-05-16,17:09:00,18732.0,BUY,3,0.02h,Break Even,$-1.50,$219.00,$78870.50,97,$219.00
2024-05-16,17:21:00,18719.5,SELL,3,0.02h,Stop Loss,$132.00,$351.00,$79002.50,97,$351.00
2024-05-16,17:55:00,18706.25,BUY,3,0.02h,Break Even,$-1.50,$349.50,$79001.00,97,$349.50
2024-05-16,18:07:00,18688.5,SELL,3,0.02h,Stop Loss,$18.00,$367.50,$79019.00,97,$367.50
2024-05-16,18:35:00,18685.0,BUY,3,0.02h,Stop Loss,$7.50,$375.00,$79026.50,97,$375.00
2024-05-16,18:58:00,18687.0,SELL,3,0.02h,Stop Loss,$-9.00,$366.00,$79017.50,97,$366.00
2024-05-16,19:00:00,18695.25,BUY,3,0.02h,Break Even,$-1.50,$364.50,$79016.00,97,$364.50
2024-05-16,19:19:00,18690.0,SELL,3,0.02h,Stop Loss,$-9.00,$355.50,$79007.00,97,$355.50
2024-05-16,19:55:00,18687.5,BUY,3,0.02h,Stop Loss,$-9.00,$346.50,$78998.00,97,$346.50
2024-05-16,19:57:00,18665.0,SELL,3,0.02h,Break Even,$-1.50,$345.00,$78996.50,97,$345.00
2024-05-16,20:45:00,18642.0,BUY,3,0.02h,Stop Loss,$-9.00,$336.00,$78987.50,97,$336.00
2024-05-16,20:53:00,18639.0,SELL,3,0.03h,Break Even,$-1.50,$334.50,$78986.00,97,$334.50
2024-05-16,22:01:00,18646.0,BUY,3,0.02h,Stop Loss,$-9.00,$325.50,$78977.00,97,$325.50
2024-05-16,22:35:00,18643.75,SELL,3,0.02h,Stop Loss,$-9.00,$316.50,$78968.00,97,$316.50
2024-05-16,22:42:00,18648.75,BUY,3,0.02h,Break Even,$-1.50,$315.00,$78966.50,97,$315.00
,,,,,,,,,,,
2024-05-17,13:05:00,18677.75,SELL,3,0.02h,Break Even,$-1.50,$-1.50,$78965.00,98,$-1.50
2024-05-17,14:06:00,18645.5,BUY,3,0.02h,Stop Loss,$-9.00,$-10.50,$78956.00,98,$-10.50
2024-05-17,14:07:00,18635.0,SELL,3,0.02h,Stop Loss,$13.50,$3.00,$78969.50,98,$3.00
2024-05-17,14:22:00,18646.75,BUY,3,0.02h,Stop Loss,$4.50,$7.50,$78974.00,98,$7.50
2024-05-17,15:01:00,18658.5,SELL,3,0.02h,Stop Loss,$10.50,$18.00,$78984.50,98,$18.00
2024-05-17,15:30:00,18654.75,BUY,3,0.02h,Stop Loss,$-9.00,$9.00,$78975.50,98,$9.00
2024-05-17,15:32:00,18647.0,SELL,3,0.02h,Stop Loss,$7.50,$16.50,$78983.00,98,$16.50
2024-05-17,15:56:00,18646.0,BUY,3,0.02h,Break Even,$-1.50,$15.00,$78981.50,98,$15.00
2024-05-17,16:13:00,18643.25,SELL,3,0.02h,Break Even,$-1.50,$13.50,$78980.00,98,$13.50
2024-05-17,16:55:00,18637.75,BUY,3,0.02h,Break Even,$-1.50,$12.00,$78978.50,98,$12.00
2024-05-17,17:07:00,18630.0,SELL,3,0.02h,Stop Loss,$-9.00,$3.00,$78969.50,98,$3.00
2024-05-17,17:43:00,18626.0,BUY,3,0.02h,Break Even,$-1.50,$1.50,$78968.00,98,$1.50
2024-05-17,17:48:00,18620.0,SELL,3,0.02h,Stop Loss,$-9.00,$-7.50,$78959.00,98,$-7.50
2024-05-17,18:39:00,18581.25,BUY,3,0.02h,Stop Loss,$6.00,$-1.50,$78965.00,98,$-1.50
2024-05-17,18:45:00,18577.0,SELL,3,0.02h,Stop Loss,$-9.00,$-10.50,$78956.00,98,$-10.50
2024-05-17,18:49:00,18585.75,BUY,3,0.02h,Stop Loss,$21.00,$10.50,$78977.00,98,$10.50
2024-05-17,19:47:00,18626.5,SELL,3,0.02h,Break Even,$-1.50,$9.00,$78975.50,98,$9.00
2024-05-17,19:53:00,18631.0,BUY,3,0.02h,Break Even,$-1.50,$7.50,$78974.00,98,$7.50
2024-05-17,19:57:00,18625.0,SELL,3,0.02h,Stop Loss,$16.50,$24.00,$78990.50,98,$24.00
2024-05-17,20:00:00,18638.5,BUY,3,0.02h,Break Even,$-1.50,$22.50,$78989.00,98,$22.50
2024-05-17,20:01:00,18623.25,SELL,3,0.02h,Break Even,$-1.50,$21.00,$78987.50,98,$21.00
2024-05-17,20:19:00,18628.75,BUY,3,0.02h,Break Even,$-1.50,$19.50,$78986.00,98,$19.50
,,,,,,,,,,,
2024-05-20,12:29:00,18673.25,SELL,3,0.02h,Break Even,$-1.50,$-1.50,$78984.50,99,$-1.50
2024-05-20,13:16:00,18652.5,BUY,3,0.02h,Break Even,$-1.50,$-3.00,$78983.00,99,$-3.00
2024-05-20,13:26:00,18645.25,SELL,3,0.02h,Stop Loss,$13.50,$10.50,$78996.50,99,$10.50
2024-05-20,13:33:00,18665.5,BUY,3,0.02h,Stop Loss,$73.50,$84.00,$79070.00,99,$84.00
2024-05-20,14:58:00,18742.5,SELL,3,0.02h,Stop Loss,$10.50,$94.50,$79080.50,99,$94.50
2024-05-20,15:26:00,18752.5,BUY,3,0.02h,Stop Loss,$-9.00,$85.50,$79071.50,99,$85.50
2024-05-20,15:44:00,18740.5,SELL,3,0.02h,Break Even,$-1.50,$84.00,$79070.00,99,$84.00
2024-05-20,16:03:00,18748.5,BUY,3,0.02h,Stop Loss,$-9.00,$75.00,$79061.00,99,$75.00
2024-05-20,16:16:00,18745.5,SELL,3,0.02h,Stop Loss,$4.50,$79.50,$79065.50,99,$79.50
2024-05-20,16:19:00,18752.0,BUY,3,0.02h,Stop Loss,$-9.00,$70.50,$79056.50,99,$70.50
2024-05-20,16:25:00,18746.25,SELL,3,0.02h,Break Even,$-1.50,$69.00,$79055.00,99,$69.00
2024-05-20,16:33:00,18752.5,BUY,3,0.02h,Stop Loss,$-9.00,$60.00,$79046.00,99,$60.00
2024-05-20,17:21:00,18776.25,SELL,3,0.02h,Stop Loss,$15.00,$75.00,$79061.00,99,$75.00
2024-05-20,18:28:00,18745.25,BUY,3,0.02h,Break Even,$-1.50,$73.50,$79059.50,99,$73.50
2024-05-20,18:59:00,18752.75,SELL,3,0.02h,Stop Loss,$10.50,$84.00,$79070.00,99,$84.00
2024-05-20,19:06:00,18760.0,BUY,3,0.02h,Stop Loss,$-9.00,$75.00,$79061.00,99,$75.00
2024-05-20,19:37:00,18765.25,SELL,3,0.02h,Break Even,$-1.50,$73.50,$79059.50,99,$73.50
2024-05-20,20:02:00,18773.0,BUY,3,0.02h,Stop Loss,$-9.00,$64.50,$79050.50,99,$64.50
2024-05-20,20:07:00,18748.5,SELL,3,0.02h,Break Even,$-1.50,$63.00,$79049.00,99,$63.00
2024-05-20,20:35:00,18748.75,BUY,3,0.02h,Break Even,$-1.50,$61.50,$79047.50,99,$61.50
2024-05-20,20:46:00,18744.25,SELL,3,0.02h,Break Even,$-1.50,$60.00,$79046.00,99,$60.00
2024-05-20,20:55:00,18748.0,BUY,3,0.02h,Stop Loss,$-9.00,$51.00,$79037.00,99,$51.00
2024-05-20,21:00:00,18745.5,SELL,3,1.02h,Break Even,$-1.50,$49.50,$79035.50,99,$49.50
2024-05-20,22:01:00,18752.25,BUY,3,0.02h,Break Even,$-1.50,$48.00,$79034.00,99,$48.00
2024-05-20,22:21:00,18748.75,SELL,3,0.02h,Stop Loss,$-9.00,$39.00,$79025.00,99,$39.00
,,,,,,,,,,,
2024-05-21,12:00:00,18750.5,BUY,3,0.02h,Stop Loss,$-9.00,$-9.00,$79016.00,100,$-9.00
2024-05-21,12:16:00,18742.5,SELL,3,0.02h,Break Even,$-1.50,$-10.50,$79014.50,100,$-10.50
2024-05-21,13:37:00,18712.5,BUY,3,0.02h,Stop Loss,$-9.00,$-19.50,$79005.50,100,$-19.50
2024-05-21,13:47:00,18685.0,SELL,3,0.02h,Stop Loss,$-9.00,$-28.50,$78996.50,100,$-28.50
2024-05-21,13:53:00,18712.5,BUY,3,0.02h,Stop Loss,$9.00,$-19.50,$79005.50,100,$-19.50
2024-05-21,15:33:00,18748.0,SELL,3,0.02h,Stop Loss,$-9.00,$-28.50,$78996.50,100,$-28.50
2024-05-21,16:07:00,18748.25,BUY,3,0.02h,Break Even,$-1.50,$-30.00,$78995.00,100,$-30.00
2024-05-21,16:36:00,18757.75,SELL,3,0.02h,Break Even,$-1.50,$-31.50,$78993.50,100,$-31.50
2024-05-21,17:28:00,18751.5,BUY,3,0.02h,Stop Loss,$10.50,$-21.00,$79004.00,100,$-21.00
2024-05-21,18:18:00,18767.5,SELL,3,0.02h,Stop Loss,$-9.00,$-30.00,$78995.00,100,$-30.00
2024-05-21,18:53:00,18768.25,BUY,3,0.02h,Stop Loss,$-9.00,$-39.00,$78986.00,100,$-39.00
2024-05-21,19:28:00,18769.75,SELL,3,0.02h,Stop Loss,$-9.00,$-48.00,$78977.00,100,$-48.00
2024-05-21,19:32:00,18781.25,BUY,3,0.02h,Break Even,$-1.50,$-49.50,$78975.50,100,$-49.50
2024-05-21,19:51:00,18781.0,SELL,3,0.02h,Break Even,$-1.50,$-51.00,$78974.00,100,$-51.00
2024-05-21,19:53:00,18791.25,BUY,3,0.02h,Break Even,$-1.50,$-52.50,$78972.50,100,$-52.50
2024-05-21,20:57:00,18803.5,SELL,3,0.02h,Break Even,$-1.50,$-54.00,$78971.00,100,$-54.00
2024-05-21,22:21:00,18803.25,BUY,3,0.02h,Break Even,$-1.50,$-55.50,$78969.50,100,$-55.50
,,,,,,,,,,,
2024-05-22,12:00:00,18792.5,SELL,3,0.02h,Stop Loss,$-9.00,$-9.00,$78960.50,101,$-9.00
2024-05-22,12:41:00,18796.75,BUY,3,0.02h,Stop Loss,$-9.00,$-18.00,$78951.50,101,$-18.00
2024-05-22,13:10:00,18795.5,SELL,3,0.02h,Break Even,$-1.50,$-19.50,$78950.00,101,$-19.50
2024-05-22,13:19:00,18807.0,BUY,3,0.02h,Break Even,$-1.50,$-21.00,$78948.50,101,$-21.00
2024-05-22,13:42:00,18799.0,SELL,3,0.02h,Stop Loss,$7.50,$-13.50,$78956.00,101,$-13.50
2024-05-22,13:47:00,18816.5,BUY,3,0.02h,Break Even,$-1.50,$-15.00,$78954.50,101,$-15.00
2024-05-22,14:09:00,18811.25,SELL,3,0.02h,Stop Loss,$-9.00,$-24.00,$78945.50,101,$-24.00
2024-05-22,14:15:00,18825.0,BUY,3,0.02h,Stop Loss,$3.00,$-21.00,$78948.50,101,$-21.00
2024-05-22,14:23:00,18806.25,SELL,3,0.02h,Stop Loss,$-9.00,$-30.00,$78939.50,101,$-30.00
2024-05-22,14:42:00,18816.5,BUY,3,0.02h,Stop Loss,$10.50,$-19.50,$78950.00,101,$-19.50
2024-05-22,14:44:00,18808.75,SELL,3,0.02h,Stop Loss,$22.50,$3.00,$78972.50,101,$3.00
2024-05-22,14:58:00,18818.75,BUY,3,0.02h,Stop Loss,$6.00,$9.00,$78978.50,101,$9.00
2024-05-22,15:42:00,18831.5,SELL,3,0.03h,Break Even,$-1.50,$7.50,$78977.00,101,$7.50
2024-05-22,16:09:00,18828.0,BUY,3,0.02h,Stop Loss,$-9.00,$-1.50,$78968.00,101,$-1.50
2024-05-22,16:27:00,18823.0,SELL,3,0.02h,Break Even,$-1.50,$-3.00,$78966.50,101,$-3.00
2024-05-22,17:07:00,18809.25,BUY,3,0.02h,Break Even,$-1.50,$-4.50,$78965.00,101,$-4.50
2024-05-22,17:33:00,18810.75,SELL,3,0.02h,Stop Loss,$10.50,$6.00,$78975.50,101,$6.00
2024-05-22,18:49:00,18721.75,BUY,3,0.02h,Stop Loss,$51.00,$57.00,$79026.50,101,$57.00
2024-05-22,19:20:00,18702.25,SELL,3,0.02h,Stop Loss,$-9.00,$48.00,$79017.50,101,$48.00
2024-05-22,19:25:00,18737.5,BUY,3,0.02h,Break Even,$-1.50,$46.50,$79016.00,101,$46.50
2024-05-22,19:47:00,18745.0,SELL,3,0.02h,Break Even,$-1.50,$45.00,$79014.50,101,$45.00
2024-05-22,19:57:00,18762.25,BUY,3,0.02h,Stop Loss,$36.00,$81.00,$79050.50,101,$81.00
2024-05-22,20:34:00,18800.25,SELL,3,0.02h,Stop Loss,$186.00,$267.00,$79236.50,101,$267.00
2024-05-22,20:45:00,18821.0,BUY,3,0.02h,Stop Loss,$15.00,$282.00,$79251.50,101,$282.00
,,,,,,,,,,,
2024-05-23,12:59:00,19005.5,SELL,3,0.02h,Break Even,$-1.50,$-1.50,$79250.00,102,$-1.50
2024-05-23,14:13:00,18898.0,BUY,3,0.02h,Stop Loss,$13.50,$12.00,$79263.50,102,$12.00
2024-05-23,14:23:00,18864.0,SELL,3,0.02h,Stop Loss,$-9.00,$3.00,$79254.50,102,$3.00
2024-05-23,14:32:00,18888.0,BUY,3,0.02h,Stop Loss,$103.50,$106.50,$79358.00,102,$106.50
2024-05-23,14:47:00,18885.75,SELL,3,0.02h,Stop Loss,$66.00,$172.50,$79424.00,102,$172.50
2024-05-23,15:09:00,18870.5,BUY,3,0.02h,Stop Loss,$100.50,$273.00,$79524.50,102,$273.00
2024-05-23,16:09:00,18910.0,SELL,3,0.02h,Stop Loss,$21.00,$294.00,$79545.50,102,$294.00
2024-05-23,16:24:00,18913.5,BUY,3,0.02h,Stop Loss,$10.50,$304.50,$79556.00,102,$304.50
2024-05-23,16:43:00,18909.0,SELL,3,0.02h,Stop Loss,$36.00,$340.50,$79592.00,102,$340.50
2024-05-23,19:18:00,18654.5,BUY,3,0.02h,Stop Loss,$10.50,$351.00,$79602.50,102,$351.00
2024-05-23,20:26:00,18689.25,SELL,3,0.07h,Stop Loss,$-9.00,$342.00,$79593.50,102,$342.00
2024-05-23,22:01:00,18687.75,BUY,3,0.02h,Stop Loss,$-9.00,$333.00,$79584.50,102,$333.00
2024-05-23,22:15:00,18683.75,SELL,3,0.02h,Break Even,$-1.50,$331.50,$79583.00,102,$331.50
2024-05-23,22:21:00,18689.75,BUY,3,0.02h,Stop Loss,$-9.00,$322.50,$79574.00,102,$322.50
,,,,,,,,,,,
2024-05-24,12:26:00,18728.75,SELL,3,0.02h,Break Even,$-1.50,$-1.50,$79572.50,103,$-1.50
2024-05-24,12:32:00,18745.25,BUY,3,0.02h,Stop Loss,$34.50,$33.00,$79607.00,103,$33.00
2024-05-24,12:55:00,18745.75,SELL,3,0.02h,Break Even,$-1.50,$31.50,$79605.50,103,$31.50
2024-05-24,13:02:00,18766.0,BUY,3,0.02h,Break Even,$-1.50,$30.00,$79604.00,103,$30.00
2024-05-24,13:07:00,18751.0,SELL,3,0.02h,Break Even,$-1.50,$28.50,$79602.50,103,$28.50
2024-05-24,13:29:00,18761.0,BUY,3,0.02h,Stop Loss,$33.00,$61.50,$79635.50,103,$61.50
2024-05-24,13:41:00,18745.0,SELL,3,0.02h,Stop Loss,$6.00,$67.50,$79641.50,103,$67.50
2024-05-24,13:43:00,18759.5,BUY,3,0.02h,Stop Loss,$51.00,$118.50,$79692.50,103,$118.50
2024-05-24,13:53:00,18748.5,SELL,3,0.02h,Stop Loss,$46.50,$165.00,$79739.00,103,$165.00
2024-05-24,14:01:00,18792.25,BUY,3,0.02h,Stop Loss,$13.50,$178.50,$79752.50,103,$178.50
2024-05-24,15:39:00,18893.0,SELL,3,0.02h,Stop Loss,$31.50,$210.00,$79784.00,103,$210.00
2024-05-24,15:45:00,18906.5,BUY,3,0.02h,Stop Loss,$-9.00,$201.00,$79775.00,103,$201.00
2024-05-24,15:46:00,18900.0,SELL,3,0.02h,Stop Loss,$9.00,$210.00,$79784.00,103,$210.00
2024-05-24,16:08:00,18900.75,BUY,3,0.02h,Break Even,$-1.50,$208.50,$79782.50,103,$208.50
2024-05-24,16:09:00,18893.5,SELL,3,0.02h,Stop Loss,$-9.00,$199.50,$79773.50,103,$199.50
2024-05-24,16:11:00,18900.5,BUY,3,0.02h,Stop Loss,$6.00,$205.50,$79779.50,103,$205.50
2024-05-24,16:37:00,18894.75,SELL,3,0.02h,Stop Loss,$-9.00,$196.50,$79770.50,103,$196.50
2024-05-24,16:55:00,18909.0,BUY,3,0.02h,Stop Loss,$-9.00,$187.50,$79761.50,103,$187.50
2024-05-24,16:57:00,18889.75,SELL,3,0.02h,Stop Loss,$3.00,$190.50,$79764.50,103,$190.50
2024-05-24,17:21:00,18889.25,BUY,3,0.02h,Stop Loss,$-9.00,$181.50,$79755.50,103,$181.50
2024-05-24,17:22:00,18885.75,SELL,3,0.02h,Stop Loss,$-9.00,$172.50,$79746.50,103,$172.50
2024-05-24,17:23:00,18891.25,BUY,3,0.02h,Stop Loss,$-9.00,$163.50,$79737.50,103,$163.50
2024-05-24,17:34:00,18882.5,SELL,3,0.02h,Break Even,$-1.50,$162.00,$79736.00,103,$162.00
2024-05-24,17:52:00,18895.75,BUY,3,0.02h,Stop Loss,$-9.00,$153.00,$79727.00,103,$153.00
2024-05-24,18:24:00,18903.25,SELL,3,0.02h,Stop Loss,$33.00,$186.00,$79760.00,103,$186.00
2024-05-24,19:28:00,18869.5,BUY,3,0.02h,Stop Loss,$-9.00,$177.00,$79751.00,103,$177.00
2024-05-24,19:30:00,18862.25,SELL,3,0.02h,Stop Loss,$13.50,$190.50,$79764.50,103,$190.50
2024-05-24,19:32:00,18872.5,BUY,3,0.02h,Stop Loss,$-9.00,$181.50,$79755.50,103,$181.50
2024-05-24,19:46:00,18866.5,SELL,3,0.02h,Break Even,$-1.50,$180.00,$79754.00,103,$180.00
2024-05-24,20:00:00,18874.0,BUY,3,0.02h,Stop Loss,$18.00,$198.00,$79772.00,103,$198.00
2024-05-24,20:21:00,18867.25,SELL,3,0.02h,Stop Loss,$-9.00,$189.00,$79763.00,103,$189.00
2024-05-24,20:26:00,18870.25,BUY,3,0.02h,Stop Loss,$-9.00,$180.00,$79754.00,103,$180.00
2024-05-24,20:29:00,18868.0,SELL,3,0.03h,Break Even,$-1.50,$178.50,$79752.50,103,$178.50
2024-05-24,20:35:00,18871.0,BUY,3,0.02h,Stop Loss,$-9.00,$169.50,$79743.50,103,$169.50
,,,,,,,,,,,
2024-05-27,12:38:00,18874.25,SELL,3,0.02h,Stop Loss,$-9.00,$-9.00,$79734.50,104,$-9.00
2024-05-27,13:10:00,18875.25,BUY,3,0.02h,Break Even,$-1.50,$-10.50,$79733.00,104,$-10.50
2024-05-27,13:53:00,18890.0,SELL,3,0.02h,Stop Loss,$13.50,$3.00,$79746.50,104,$3.00
2024-05-27,14:35:00,18884.0,BUY,3,0.02h,Stop Loss,$4.50,$7.50,$79751.00,104,$7.50
2024-05-27,16:12:00,18934.75,SELL,3,0.02h,Stop Loss,$-9.00,$-1.50,$79742.00,104,$-1.50
2024-05-27,16:14:00,18939.75,BUY,3,0.02h,Stop Loss,$-9.00,$-10.50,$79733.00,104,$-10.50
2024-05-27,16:41:00,18943.25,SELL,3,0.02h,Stop Loss,$-9.00,$-19.50,$79724.00,104,$-19.50
2024-05-27,16:42:00,18945.5,BUY,3,0.02h,Stop Loss,$-9.00,$-28.50,$79715.00,104,$-28.50
2024-05-27,16:43:00,18942.0,SELL,3,0.02h,Stop Loss,$-9.00,$-37.50,$79706.00,104,$-37.50
2024-05-27,16:47:00,18951.0,BUY,3,0.02h,Stop Loss,$-9.00,$-46.50,$79697.00,104,$-46.50
2024-05-27,22:01:00,18938.0,SELL,3,0.02h,Stop Loss,$9.00,$-37.50,$79706.00,104,$-37.50
2024-05-27,22:52:00,18917.5,BUY,3,0.02h,Break Even,$-1.50,$-39.00,$79704.50,104,$-39.00
,,,,,,,,,,,
2024-05-28,12:20:00,18919.25,SELL,3,0.02h,Stop Loss,$-9.00,$-9.00,$79695.50,105,$-9.00
2024-05-28,12:26:00,18927.75,BUY,3,0.02h,Break Even,$-1.50,$-10.50,$79694.00,105,$-10.50
2024-05-28,12:32:00,18916.75,SELL,3,0.02h,Stop Loss,$-9.00,$-19.50,$79685.00,105,$-19.50
2024-05-28,12:40:00,18925.75,BUY,3,0.02h,Break Even,$-1.50,$-21.00,$79683.50,105,$-21.00
2024-05-28,12:43:00,18918.5,SELL,3,0.02h,Break Even,$-1.50,$-22.50,$79682.00,105,$-22.50
2024-05-28,13:01:00,18919.25,BUY,3,0.02h,Stop Loss,$-9.00,$-31.50,$79673.00,105,$-31.50
2024-05-28,13:02:00,18913.75,SELL,3,0.02h,Stop Loss,$7.50,$-24.00,$79680.50,105,$-24.00
2024-05-28,13:13:00,18916.0,BUY,3,0.02h,Stop Loss,$12.00,$-12.00,$79692.50,105,$-12.00
2024-05-28,13:35:00,18911.0,SELL,3,0.02h,Stop Loss,$4.50,$-7.50,$79697.00,105,$-7.50
2024-05-28,14:06:00,18880.5,BUY,3,0.02h,Stop Loss,$57.00,$49.50,$79754.00,105,$49.50
2024-05-28,14:39:00,18885.75,SELL,3,0.02h,Stop Loss,$16.50,$66.00,$79770.50,105,$66.00
2024-05-28,14:43:00,18901.0,BUY,3,0.02h,Stop Loss,$9.00,$75.00,$79779.50,105,$75.00
2024-05-28,15:07:00,18904.5,SELL,3,0.02h,Stop Loss,$-9.00,$66.00,$79770.50,105,$66.00
2024-05-28,15:13:00,18917.25,BUY,3,0.02h,Break Even,$-1.50,$64.50,$79769.00,105,$64.50
2024-05-28,15:17:00,18904.75,SELL,3,0.02h,Stop Loss,$-9.00,$55.50,$79760.00,105,$55.50
2024-05-28,15:20:00,18917.0,BUY,3,0.02h,Break Even,$-1.50,$54.00,$79758.50,105,$54.00
2024-05-28,15:57:00,18921.25,SELL,3,0.02h,Stop Loss,$-9.00,$45.00,$79749.50,105,$45.00
2024-05-28,16:02:00,18929.5,BUY,3,0.02h,Stop Loss,$-9.00,$36.00,$79740.50,105,$36.00
2024-05-28,16:06:00,18920.25,SELL,3,0.02h,Stop Loss,$3.00,$39.00,$79743.50,105,$39.00
2024-05-28,16:14:00,18931.0,BUY,3,0.02h,Stop Loss,$9.00,$48.00,$79752.50,105,$48.00
2024-05-28,16:18:00,18915.75,SELL,3,0.02h,Break Even,$-1.50,$46.50,$79751.00,105,$46.50
2024-05-28,16:37:00,18926.75,BUY,3,0.02h,Stop Loss,$-9.00,$37.50,$79742.00,105,$37.50
2024-05-28,16:59:00,18922.5,SELL,3,0.02h,Break Even,$-1.50,$36.00,$79740.50,105,$36.00
2024-05-28,17:15:00,18926.5,BUY,3,0.02h,Stop Loss,$-9.00,$27.00,$79731.50,105,$27.00
2024-05-28,17:16:00,18921.5,SELL,3,0.02h,Stop Loss,$3.00,$30.00,$79734.50,105,$30.00
2024-05-28,17:19:00,18927.25,BUY,3,0.02h,Stop Loss,$7.50,$37.50,$79742.00,105,$37.50
2024-05-28,17:23:00,18919.25,SELL,3,0.02h,Break Even,$-1.50,$36.00,$79740.50,105,$36.00
2024-05-28,17:26:00,18925.0,BUY,3,0.02h,Stop Loss,$-9.00,$27.00,$79731.50,105,$27.00
2024-05-28,17:27:00,18921.5,SELL,3,0.02h,Stop Loss,$-9.00,$18.00,$79722.50,105,$18.00
2024-05-28,17:28:00,18927.25,BUY,3,0.02h,Stop Loss,$-9.00,$9.00,$79713.50,105,$9.00
2024-05-28,17:48:00,18926.5,SELL,3,0.02h,Stop Loss,$15.00,$24.00,$79728.50,105,$24.00
2024-05-28,18:09:00,18916.5,BUY,3,0.02h,Break Even,$-1.50,$22.50,$79727.00,105,$22.50
2024-05-28,18:18:00,18903.0,SELL,3,0.02h,Stop Loss,$30.00,$52.50,$79757.00,105,$52.50
2024-05-28,18:58:00,18861.0,BUY,3,0.02h,Stop Loss,$34.50,$87.00,$79791.50,105,$87.00
2024-05-28,19:48:00,18883.75,SELL,3,0.02h,Stop Loss,$40.50,$127.50,$79832.00,105,$127.50
2024-05-28,19:54:00,18900.5,BUY,3,0.02h,Stop Loss,$3.00,$130.50,$79835.00,105,$130.50
2024-05-28,22:02:00,18939.25,SELL,3,0.02h,Break Even,$-1.50,$129.00,$79833.50,105,$129.00
2024-05-28,22:48:00,18940.75,BUY,3,0.15h,Break Even,$-1.50,$127.50,$79832.00,105,$127.50
,,,,,,,,,,,
2024-05-29,12:00:00,18817.75,SELL,3,0.02h,Stop Loss,$-9.00,$-9.00,$79823.00,106,$-9.00
2024-05-29,13:31:00,18797.75,BUY,3,0.02h,Stop Loss,$24.00,$15.00,$79847.00,106,$15.00
2024-05-29,15:04:00,18858.75,SELL,3,0.02h,Break Even,$-1.50,$13.50,$79845.50,106,$13.50
2024-05-29,15:27:00,18854.25,BUY,3,0.02h,Stop Loss,$9.00,$22.50,$79854.50,106,$22.50
2024-05-29,15:33:00,18840.0,SELL,3,0.02h,Stop Loss,$30.00,$52.50,$79884.50,106,$52.50
2024-05-29,15:55:00,18849.0,BUY,3,0.02h,Stop Loss,$13.50,$66.00,$79898.00,106,$66.00
2024-05-29,16:10:00,18841.25,SELL,3,0.02h,Stop Loss,$79.50,$145.50,$79977.50,106,$145.50
2024-05-29,16:22:00,18845.0,BUY,3,0.02h,Stop Loss,$15.00,$160.50,$79992.50,106,$160.50
2024-05-29,17:03:00,18852.25,SELL,3,0.02h,Stop Loss,$12.00,$172.50,$80004.50,106,$172.50
2024-05-29,17:31:00,18851.0,BUY,3,0.02h,Break Even,$-1.50,$171.00,$80003.00,106,$171.00
2024-05-29,17:34:00,18842.25,SELL,3,0.02h,Stop Loss,$27.00,$198.00,$80030.00,106,$198.00
2024-05-29,17:52:00,18849.5,BUY,3,0.02h,Stop Loss,$57.00,$255.00,$80087.00,106,$255.00
2024-05-29,18:21:00,18850.75,SELL,3,0.02h,Stop Loss,$-9.00,$246.00,$80078.00,106,$246.00
2024-05-29,19:16:00,18836.0,BUY,3,0.02h,Break Even,$-1.50,$244.50,$80076.50,106,$244.50
2024-05-29,19:45:00,18836.75,SELL,3,0.02h,Stop Loss,$10.50,$255.00,$80087.00,106,$255.00
,,,,,,,,,,,
2024-05-30,12:00:00,18745.5,BUY,3,0.02h,Stop Loss,$-9.00,$-9.00,$80078.00,107,$-9.00
2024-05-30,12:56:00,18768.75,SELL,3,0.02h,Stop Loss,$27.00,$18.00,$80105.00,107,$18.00
2024-05-30,13:25:00,18766.0,BUY,3,0.02h,Break Even,$-1.50,$16.50,$80103.50,107,$16.50
2024-05-30,13:33:00,18758.0,SELL,3,0.02h,Stop Loss,$76.50,$93.00,$80180.00,107,$93.00
2024-05-30,14:07:00,18746.5,BUY,3,0.02h,Break Even,$-1.50,$91.50,$80178.50,107,$91.50
2024-05-30,14:11:00,18725.5,SELL,3,0.02h,Stop Loss,$132.00,$223.50,$80310.50,107,$223.50
2024-05-30,15:23:00,18657.0,BUY,3,0.02h,Stop Loss,$4.50,$228.00,$80315.00,107,$228.00
2024-05-30,15:59:00,18675.0,SELL,3,0.02h,Stop Loss,$27.00,$255.00,$80342.00,107,$255.00
2024-05-30,16:05:00,18692.75,BUY,3,0.02h,Stop Loss,$21.00,$276.00,$80363.00,107,$276.00
2024-05-30,16:30:00,18686.0,SELL,3,0.02h,Stop Loss,$4.50,$280.50,$80367.50,107,$280.50
2024-05-30,16:34:00,18696.0,BUY,3,0.02h,Stop Loss,$12.00,$292.50,$80379.50,107,$292.50
2024-05-30,16:44:00,18689.0,SELL,3,0.02h,Stop Loss,$-9.00,$283.50,$80370.50,107,$283.50
2024-05-30,16:54:00,18698.5,BUY,3,0.02h,Stop Loss,$9.00,$292.50,$80379.50,107,$292.50
2024-05-30,16:58:00,18688.5,SELL,3,0.02h,Stop Loss,$-9.00,$283.50,$80370.50,107,$283.50
2024-05-30,17:00:00,18696.5,BUY,3,0.02h,Stop Loss,$-9.00,$274.50,$80361.50,107,$274.50
2024-05-30,17:49:00,18706.75,SELL,3,0.02h,Stop Loss,$3.00,$277.50,$80364.50,107,$277.50
2024-05-30,19:16:00,18670.0,BUY,3,0.02h,Break Even,$-1.50,$276.00,$80363.00,107,$276.00
2024-05-30,19:19:00,18664.5,SELL,3,0.02h,Stop Loss,$37.50,$313.50,$80400.50,107,$313.50
2024-05-30,20:28:00,18581.0,BUY,3,0.02h,Stop Loss,$48.00,$361.50,$80448.50,107,$361.50
2024-05-30,20:54:00,18584.25,SELL,3,0.02h,Stop Loss,$-9.00,$352.50,$80439.50,107,$352.50
2024-05-30,20:59:00,18591.5,BUY,3,0.02h,Stop Loss,$16.50,$369.00,$80456.00,107,$369.00
2024-05-30,22:01:00,18570.0,SELL,3,0.02h,Break Even,$-1.50,$367.50,$80454.50,107,$367.50
2024-05-30,22:34:00,18570.25,BUY,3,0.02h,Stop Loss,$-9.00,$358.50,$80445.50,107,$358.50
2024-05-30,22:54:00,18570.75,SELL,3,0.03h,Break Even,$-1.50,$357.00,$80444.00,107,$357.00
,,,,,,,,,,,
2024-05-31,12:24:00,18569.0,BUY,3,0.02h,Break Even,$-1.50,$-1.50,$80442.50,108,$-1.50
2024-05-31,13:07:00,18638.25,SELL,3,0.02h,Stop Loss,$10.50,$9.00,$80453.00,108,$9.00
2024-05-31,13:44:00,18627.25,BUY,3,0.02h,Break Even,$-1.50,$7.50,$80451.50,108,$7.50
2024-05-31,13:46:00,18589.25,SELL,3,0.02h,Stop Loss,$73.50,$81.00,$80525.00,108,$81.00
2024-05-31,16:41:00,18279.5,BUY,3,0.02h,Stop Loss,$24.00,$105.00,$80549.00,108,$105.00
2024-05-31,17:43:00,18334.5,SELL,3,0.02h,Break Even,$-1.50,$103.50,$80547.50,108,$103.50
2024-05-31,17:46:00,18354.25,BUY,3,0.02h,Break Even,$-1.50,$102.00,$80546.00,108,$102.00
2024-05-31,17:55:00,18340.0,SELL,3,0.02h,Stop Loss,$-9.00,$93.00,$80537.00,108,$93.00
2024-05-31,18:19:00,18339.75,BUY,3,0.02h,Break Even,$-1.50,$91.50,$80535.50,108,$91.50
2024-05-31,18:24:00,18335.75,SELL,3,0.02h,Stop Loss,$7.50,$99.00,$80543.00,108,$99.00
2024-05-31,18:42:00,18335.5,BUY,3,0.02h,Stop Loss,$6.00,$105.00,$80549.00,108,$105.00
2024-05-31,20:50:00,18576.5,SELL,3,0.02h,Break Even,$-1.50,$103.50,$80547.50,108,$103.50
,,,,,,,,,,,
2024-06-03,12:00:00,18688.5,BUY,3,0.02h,Break Even,$-1.50,$-1.50,$80546.00,109,$-1.50
2024-06-03,12:37:00,18679.5,SELL,3,0.02h,Stop Loss,$-9.00,$-10.50,$80537.00,109,$-10.50
2024-06-03,12:44:00,18689.5,BUY,3,0.02h,Break Even,$-1.50,$-12.00,$80535.50,109,$-12.00
2024-06-03,12:47:00,18684.75,SELL,3,0.02h,Break Even,$-1.50,$-13.50,$80534.00,109,$-13.50
2024-06-03,13:02:00,18691.5,BUY,3,0.02h,Break Even,$-1.50,$-15.00,$80532.50,109,$-15.00
2024-06-03,13:53:00,18679.5,SELL,3,0.02h,Break Even,$-1.50,$-16.50,$80531.00,109,$-16.50
2024-06-03,14:19:00,18690.0,BUY,3,0.02h,Stop Loss,$63.00,$46.50,$80594.00,109,$46.50
2024-06-03,14:23:00,18682.5,SELL,3,0.02h,Break Even,$-1.50,$45.00,$80592.50,109,$45.00
2024-06-03,14:24:00,18702.25,BUY,3,0.02h,Stop Loss,$22.50,$67.50,$80615.00,109,$67.50
2024-06-03,14:33:00,18678.0,SELL,3,0.02h,Break Even,$-1.50,$66.00,$80613.50,109,$66.00
2024-06-03,15:20:00,18604.75,BUY,3,0.02h,Stop Loss,$42.00,$108.00,$80655.50,109,$108.00
2024-06-03,15:47:00,18594.5,SELL,3,0.02h,Break Even,$-1.50,$106.50,$80654.00,109,$106.50
2024-06-03,15:55:00,18615.75,BUY,3,0.02h,Stop Loss,$-9.00,$97.50,$80645.00,109,$97.50
2024-06-03,15:56:00,18608.25,SELL,3,0.02h,Stop Loss,$49.50,$147.00,$80694.50,109,$147.00
2024-06-03,17:21:00,18498.5,BUY,3,0.02h,Stop Loss,$18.00,$165.00,$80712.50,109,$165.00
2024-06-03,18:14:00,18541.25,SELL,3,0.02h,Stop Loss,$67.50,$232.50,$80780.00,109,$232.50
2024-06-03,18:24:00,18568.0,BUY,3,0.02h,Stop Loss,$-9.00,$223.50,$80771.00,109,$223.50
2024-06-03,18:30:00,18538.0,SELL,3,0.02h,Break Even,$-1.50,$222.00,$80769.50,109,$222.00
2024-06-03,18:37:00,18562.75,BUY,3,0.02h,Stop Loss,$-9.00,$213.00,$80760.50,109,$213.00
2024-06-03,18:54:00,18550.25,SELL,3,0.02h,Stop Loss,$13.50,$226.50,$80774.00,109,$226.50
2024-06-03,19:03:00,18568.75,BUY,3,0.02h,Break Even,$-1.50,$225.00,$80772.50,109,$225.00
2024-06-03,19:40:00,18571.5,SELL,3,0.02h,Stop Loss,$18.00,$243.00,$80790.50,109,$243.00
2024-06-03,19:47:00,18598.5,BUY,3,0.02h,Stop Loss,$-9.00,$234.00,$80781.50,109,$234.00
2024-06-03,20:46:00,18662.0,SELL,3,0.02h,Stop Loss,$-9.00,$225.00,$80772.50,109,$225.00
2024-06-03,22:25:00,18660.5,BUY,3,0.03h,Stop Loss,$-9.00,$216.00,$80763.50,109,$216.00
2024-06-03,22:45:00,18660.0,SELL,3,0.02h,Stop Loss,$-9.00,$207.00,$80754.50,109,$207.00
,,,,,,,,,,,
2024-06-04,12:32:00,18589.5,BUY,3,0.02h,Stop Loss,$9.00,$9.00,$80763.50,110,$9.00
2024-06-04,13:35:00,18594.25,SELL,3,0.02h,Stop Loss,$55.50,$64.50,$80819.00,110,$64.50
2024-06-04,14:02:00,18659.5,BUY,3,0.02h,Stop Loss,$-9.00,$55.50,$80810.00,110,$55.50
2024-06-04,14:07:00,18596.5,SELL,3,0.02h,Break Even,$-1.50,$54.00,$80808.50,110,$54.00
2024-06-04,14:29:00,18619.25,BUY,3,0.02h,Stop Loss,$4.50,$58.50,$80813.00,110,$58.50
2024-06-04,14:56:00,18621.0,SELL,3,0.02h,Stop Loss,$57.00,$115.50,$80870.00,110,$115.50
2024-06-04,15:21:00,18626.5,BUY,3,0.02h,Stop Loss,$34.50,$150.00,$80904.50,110,$150.00
2024-06-04,15:30:00,18601.5,SELL,3,0.02h,Stop Loss,$36.00,$186.00,$80940.50,110,$186.00
2024-06-04,15:55:00,18600.5,BUY,3,0.02h,Stop Loss,$6.00,$192.00,$80946.50,110,$192.00
2024-06-04,15:59:00,18592.0,SELL,3,0.02h,Stop Loss,$28.50,$220.50,$80975.00,110,$220.50
2024-06-04,16:26:00,18590.25,BUY,3,0.02h,Stop Loss,$12.00,$232.50,$80987.00,110,$232.50
2024-06-04,17:04:00,18616.5,SELL,3,0.02h,Break Even,$-1.50,$231.00,$80985.50,110,$231.00
2024-06-04,17:17:00,18628.75,BUY,3,0.02h,Stop Loss,$18.00,$249.00,$81003.50,110,$249.00
2024-06-04,17:27:00,18614.75,SELL,3,0.02h,Break Even,$-1.50,$247.50,$81002.00,110,$247.50
2024-06-04,17:29:00,18634.25,BUY,3,0.02h,Stop Loss,$28.50,$276.00,$81030.50,110,$276.00
2024-06-04,17:38:00,18622.25,SELL,3,0.02h,Break Even,$-1.50,$274.50,$81029.00,110,$274.50
2024-06-04,17:42:00,18631.5,BUY,3,0.02h,Stop Loss,$12.00,$286.50,$81041.00,110,$286.50
2024-06-04,17:44:00,18621.5,SELL,3,0.02h,Stop Loss,$7.50,$294.00,$81048.50,110,$294.00
2024-06-04,17:49:00,18628.5,BUY,3,0.02h,Break Even,$-1.50,$292.50,$81047.00,110,$292.50
2024-06-04,17:50:00,18625.25,SELL,3,0.02h,Stop Loss,$-9.00,$283.50,$81038.00,110,$283.50
2024-06-04,17:51:00,18630.25,BUY,3,0.02h,Stop Loss,$-9.00,$274.50,$81029.00,110,$274.50
2024-06-04,18:59:00,18712.25,SELL,3,0.02h,Break Even,$-1.50,$273.00,$81027.50,110,$273.00
2024-06-04,19:44:00,18682.75,BUY,3,0.02h,Stop Loss,$49.50,$322.50,$81077.00,110,$322.50
2024-06-04,22:06:00,18707.5,SELL,3,0.02h,Break Even,$-1.50,$321.00,$81075.50,110,$321.00
2024-06-04,22:27:00,18703.75,BUY,3,0.03h,Stop Loss,$-9.00,$312.00,$81066.50,110,$312.00
,,,,,,,,,,,
2024-06-05,12:32:00,18782.75,SELL,3,0.02h,Stop Loss,$6.00,$6.00,$81072.50,111,$6.00
2024-06-05,12:37:00,18800.75,BUY,3,0.02h,Break Even,$-1.50,$4.50,$81071.00,111,$4.50
2024-06-05,13:35:00,18833.75,SELL,3,0.02h,Stop Loss,$100.50,$105.00,$81171.50,111,$105.00
2024-06-05,13:46:00,18841.75,BUY,3,0.02h,Stop Loss,$4.50,$109.50,$81176.00,111,$109.50
2024-06-05,14:08:00,18831.75,SELL,3,0.02h,Stop Loss,$7.50,$117.00,$81183.50,111,$117.00
2024-06-05,14:22:00,18849.75,BUY,3,0.02h,Stop Loss,$13.50,$130.50,$81197.00,111,$130.50
2024-06-05,15:55:00,18969.0,SELL,3,0.02h,Stop Loss,$19.50,$150.00,$81216.50,111,$150.00
2024-06-05,16:12:00,18973.75,BUY,3,0.02h,Break Even,$-1.50,$148.50,$81215.00,111,$148.50
2024-06-05,16:16:00,18961.75,SELL,3,0.02h,Stop Loss,$-9.00,$139.50,$81206.00,111,$139.50
2024-06-05,16:21:00,18974.25,BUY,3,0.02h,Stop Loss,$-9.00,$130.50,$81197.00,111,$130.50
2024-06-05,17:21:00,18982.0,SELL,3,0.02h,Stop Loss,$6.00,$136.50,$81203.00,111,$136.50
2024-06-05,17:34:00,19009.25,BUY,3,0.02h,Stop Loss,$-9.00,$127.50,$81194.00,111,$127.50
2024-06-05,18:09:00,19013.25,SELL,3,0.02h,Stop Loss,$-9.00,$118.50,$81185.00,111,$118.50
2024-06-05,18:11:00,19019.5,BUY,3,0.02h,Break Even,$-1.50,$117.00,$81183.50,111,$117.00
2024-06-05,18:14:00,19009.75,SELL,3,0.02h,Break Even,$-1.50,$115.50,$81182.00,111,$115.50
2024-06-05,18:23:00,19019.25,BUY,3,0.02h,Break Even,$-1.50,$114.00,$81180.50,111,$114.00
2024-06-05,19:27:00,19035.75,SELL,3,0.02h,Stop Loss,$21.00,$135.00,$81201.50,111,$135.00
2024-06-05,19:38:00,19046.75,BUY,3,0.02h,Stop Loss,$9.00,$144.00,$81210.50,111,$144.00
2024-06-05,19:47:00,19036.25,SELL,3,0.02h,Stop Loss,$10.50,$154.50,$81221.00,111,$154.50
2024-06-05,19:53:00,19053.5,BUY,3,0.02h,Stop Loss,$31.50,$186.00,$81252.50,111,$186.00
2024-06-05,22:02:00,19076.5,SELL,3,0.02h,Stop Loss,$-9.00,$177.00,$81243.50,111,$177.00
2024-06-05,22:37:00,19083.0,BUY,3,0.02h,Break Even,$-1.50,$175.50,$81242.00,111,$175.50
,,,,,,,,,,,
2024-06-06,12:25:00,19097.5,SELL,3,0.02h,Stop Loss,$9.00,$9.00,$81251.00,112,$9.00
2024-06-06,12:53:00,19095.5,BUY,3,0.02h,Stop Loss,$-9.00,$0.00,$81242.00,112,$0.00
2024-06-06,13:46:00,19086.25,SELL,3,0.02h,Stop Loss,$93.00,$93.00,$81335.00,112,$93.00
2024-06-06,14:24:00,19082.25,BUY,3,0.02h,Stop Loss,$9.00,$102.00,$81344.00,112,$102.00
2024-06-06,14:53:00,19079.75,SELL,3,0.02h,Stop Loss,$-9.00,$93.00,$81335.00,112,$93.00
2024-06-06,14:56:00,19097.25,BUY,3,0.02h,Stop Loss,$-9.00,$84.00,$81326.00,112,$84.00
2024-06-06,15:00:00,19083.0,SELL,3,0.02h,Stop Loss,$30.00,$114.00,$81356.00,112,$114.00
2024-06-06,15:10:00,19090.75,BUY,3,0.02h,Break Even,$-1.50,$112.50,$81354.50,112,$112.50
2024-06-06,15:11:00,19087.75,SELL,3,0.02h,Stop Loss,$7.50,$120.00,$81362.00,112,$120.00
2024-06-06,15:54:00,19067.75,BUY,3,0.02h,Stop Loss,$7.50,$127.50,$81369.50,112,$127.50
2024-06-06,16:01:00,19062.0,SELL,3,0.02h,Stop Loss,$6.00,$133.50,$81375.50,112,$133.50
2024-06-06,16:05:00,19070.75,BUY,3,0.02h,Stop Loss,$13.50,$147.00,$81389.00,112,$147.00
2024-06-06,16:16:00,19056.25,SELL,3,0.02h,Stop Loss,$79.50,$226.50,$81468.50,112,$226.50
2024-06-06,16:55:00,19052.75,BUY,3,0.02h,Break Even,$-1.50,$225.00,$81467.00,112,$225.00
2024-06-06,17:49:00,19070.5,SELL,3,0.02h,Break Even,$-1.50,$223.50,$81465.50,112,$223.50
2024-06-06,17:56:00,19082.25,BUY,3,0.02h,Stop Loss,$-9.00,$214.50,$81456.50,112,$214.50
2024-06-06,17:57:00,19072.25,SELL,3,0.02h,Break Even,$-1.50,$213.00,$81455.00,112,$213.00
2024-06-06,18:35:00,19052.0,BUY,3,0.02h,Stop Loss,$10.50,$223.50,$81465.50,112,$223.50
2024-06-06,18:37:00,19045.75,SELL,3,0.02h,Stop Loss,$6.00,$229.50,$81471.50,112,$229.50
2024-06-06,18:41:00,19052.5,BUY,3,0.02h,Break Even,$-1.50,$228.00,$81470.00,112,$228.00
2024-06-06,19:14:00,19056.0,SELL,3,0.02h,Stop Loss,$27.00,$255.00,$81497.00,112,$255.00
2024-06-06,19:32:00,19061.25,BUY,3,0.02h,Stop Loss,$-9.00,$246.00,$81488.00,112,$246.00
2024-06-06,19:36:00,19051.5,SELL,3,0.02h,Break Even,$-1.50,$244.50,$81486.50,112,$244.50
2024-06-06,19:39:00,19060.0,BUY,3,0.02h,Stop Loss,$-9.00,$235.50,$81477.50,112,$235.50
2024-06-06,19:40:00,19055.0,SELL,3,0.02h,Stop Loss,$30.00,$265.50,$81507.50,112,$265.50
2024-06-06,19:49:00,19065.5,BUY,3,0.02h,Stop Loss,$28.50,$294.00,$81536.00,112,$294.00
2024-06-06,20:03:00,19047.75,SELL,3,0.02h,Break Even,$-1.50,$292.50,$81534.50,112,$292.50
2024-06-06,20:08:00,19064.25,BUY,3,0.02h,Break Even,$-1.50,$291.00,$81533.00,112,$291.00
2024-06-06,20:42:00,19063.5,SELL,3,0.02h,Stop Loss,$-9.00,$282.00,$81524.00,112,$282.00
2024-06-06,20:57:00,19066.75,BUY,3,0.02h,Stop Loss,$-9.00,$273.00,$81515.00,112,$273.00
2024-06-06,22:02:00,19062.25,SELL,3,0.02h,Stop Loss,$-9.00,$264.00,$81506.00,112,$264.00
2024-06-06,22:08:00,19066.75,BUY,3,0.02h,Stop Loss,$-9.00,$255.00,$81497.00,112,$255.00
2024-06-06,22:09:00,19063.0,SELL,3,0.02h,Stop Loss,$-9.00,$246.00,$81488.00,112,$246.00
2024-06-06,22:13:00,19068.75,BUY,3,0.02h,Stop Loss,$-9.00,$237.00,$81479.00,112,$237.00
,,,,,,,,,,,
2024-06-07,12:31:00,19009.0,SELL,3,0.02h,Stop Loss,$121.50,$121.50,$81600.50,113,$121.50
2024-06-07,13:06:00,19025.25,BUY,3,0.02h,Stop Loss,$31.50,$153.00,$81632.00,113,$153.00
2024-06-07,13:35:00,18996.25,SELL,3,0.02h,Break Even,$-1.50,$151.50,$81630.50,113,$151.50
2024-06-07,13:46:00,19025.5,BUY,3,0.02h,Stop Loss,$24.00,$175.50,$81654.50,113,$175.50
2024-06-07,14:12:00,19028.5,SELL,3,0.02h,Break Even,$-1.50,$174.00,$81653.00,113,$174.00
2024-06-07,14:14:00,19041.5,BUY,3,0.02h,Stop Loss,$-9.00,$165.00,$81644.00,113,$165.00
2024-06-07,14:30:00,19038.5,SELL,3,0.02h,Stop Loss,$15.00,$180.00,$81659.00,113,$180.00
2024-06-07,14:33:00,19042.25,BUY,3,0.02h,Stop Loss,$4.50,$184.50,$81663.50,113,$184.50
2024-06-07,14:34:00,19036.0,SELL,3,0.02h,Stop Loss,$-9.00,$175.50,$81654.50,113,$175.50
2024-06-07,14:35:00,19046.75,BUY,3,0.02h,Stop Loss,$31.50,$207.00,$81686.00,113,$207.00
2024-06-07,15:01:00,19055.25,SELL,3,0.02h,Stop Loss,$21.00,$228.00,$81707.00,113,$228.00
2024-06-07,15:25:00,19061.75,BUY,3,0.02h,Stop Loss,$3.00,$231.00,$81710.00,113,$231.00
2024-06-07,16:43:00,19094.25,SELL,3,0.02h,Stop Loss,$-9.00,$222.00,$81701.00,113,$222.00
2024-06-07,16:53:00,19111.25,BUY,3,0.02h,Stop Loss,$18.00,$240.00,$81719.00,113,$240.00
2024-06-07,17:38:00,19122.25,SELL,3,0.02h,Stop Loss,$25.50,$265.50,$81744.50,113,$265.50
2024-06-07,17:52:00,19132.25,BUY,3,0.02h,Stop Loss,$6.00,$271.50,$81750.50,113,$271.50
2024-06-07,18:00:00,19115.0,SELL,3,0.02h,Stop Loss,$171.00,$442.50,$81921.50,113,$442.50
2024-06-07,18:32:00,19052.25,BUY,3,0.02h,Break Even,$-1.50,$441.00,$81920.00,113,$441.00
2024-06-07,19:01:00,19039.0,SELL,3,0.02h,Stop Loss,$3.00,$444.00,$81923.00,113,$444.00
2024-06-07,19:30:00,19047.5,BUY,3,0.02h,Stop Loss,$-9.00,$435.00,$81914.00,113,$435.00
2024-06-07,19:52:00,19037.5,SELL,3,0.02h,Stop Loss,$73.50,$508.50,$81987.50,113,$508.50
2024-06-07,19:59:00,19044.25,BUY,3,0.02h,Stop Loss,$19.50,$528.00,$82007.00,113,$528.00
2024-06-07,20:01:00,19039.5,SELL,3,0.02h,Stop Loss,$7.50,$535.50,$82014.50,113,$535.50
2024-06-07,20:50:00,19024.5,BUY,3,0.02h,Stop Loss,$9.00,$544.50,$82023.50,113,$544.50
,,,,,,,,,,,
2024-06-10,12:24:00,19023.5,SELL,3,0.02h,Stop Loss,$-9.00,$-9.00,$82014.50,114,$-9.00
2024-06-10,13:33:00,19005.75,BUY,3,0.02h,Stop Loss,$-9.00,$-18.00,$82005.50,114,$-18.00
2024-06-10,13:48:00,18992.5,SELL,3,0.02h,Break Even,$-1.50,$-19.50,$82004.00,114,$-19.50
2024-06-10,14:09:00,19010.0,BUY,3,0.02h,Stop Loss,$18.00,$-1.50,$82022.00,114,$-1.50
2024-06-10,14:18:00,19001.25,SELL,3,0.02h,Break Even,$-1.50,$-3.00,$82020.50,114,$-3.00
2024-06-10,14:20:00,19009.0,BUY,3,0.02h,Stop Loss,$33.00,$30.00,$82053.50,114,$30.00
2024-06-10,16:02:00,19091.75,SELL,3,0.02h,Stop Loss,$-9.00,$21.00,$82044.50,114,$21.00
2024-06-10,16:12:00,19105.0,BUY,3,0.02h,Break Even,$-1.50,$19.50,$82043.00,114,$19.50
2024-06-10,16:32:00,19104.25,SELL,3,0.02h,Stop Loss,$30.00,$49.50,$82073.00,114,$49.50
2024-06-10,16:35:00,19109.5,BUY,3,0.02h,Stop Loss,$-9.00,$40.50,$82064.00,114,$40.50
2024-06-10,16:41:00,19104.5,SELL,3,0.02h,Stop Loss,$-9.00,$31.50,$82055.00,114,$31.50
2024-06-10,16:42:00,19109.5,BUY,3,0.02h,Break Even,$-1.50,$30.00,$82053.50,114,$30.00
2024-06-10,16:48:00,19100.25,SELL,3,0.02h,Stop Loss,$-9.00,$21.00,$82044.50,114,$21.00
2024-06-10,16:53:00,19109.5,BUY,3,0.02h,Stop Loss,$3.00,$24.00,$82047.50,114,$24.00
2024-06-10,17:01:00,19092.25,SELL,3,0.02h,Break Even,$-1.50,$22.50,$82046.00,114,$22.50
2024-06-10,17:47:00,19090.75,BUY,3,0.02h,Stop Loss,$-9.00,$13.50,$82037.00,114,$13.50
2024-06-10,18:11:00,19083.0,SELL,3,0.02h,Stop Loss,$4.50,$18.00,$82041.50,114,$18.00
2024-06-10,18:41:00,19071.5,BUY,3,0.02h,Stop Loss,$57.00,$75.00,$82098.50,114,$75.00
2024-06-10,19:34:00,19097.75,SELL,3,0.02h,Break Even,$-1.50,$73.50,$82097.00,114,$73.50
2024-06-10,19:42:00,19115.0,BUY,3,0.02h,Stop Loss,$-9.00,$64.50,$82088.00,114,$64.50
2024-06-10,19:46:00,19096.0,SELL,3,0.02h,Break Even,$-1.50,$63.00,$82086.50,114,$63.00
2024-06-10,20:00:00,19112.75,BUY,3,0.02h,Break Even,$-1.50,$61.50,$82085.00,114,$61.50
2024-06-10,20:02:00,19094.0,SELL,3,0.02h,Stop Loss,$-9.00,$52.50,$82076.00,114,$52.50
2024-06-10,20:27:00,19094.25,BUY,3,0.07h,Stop Loss,$-9.00,$43.50,$82067.00,114,$43.50
2024-06-10,22:06:00,19099.0,SELL,3,0.02h,Stop Loss,$-9.00,$34.50,$82058.00,114,$34.50
2024-06-10,22:37:00,19099.5,BUY,3,0.02h,Break Even,$-1.50,$33.00,$82056.50,114,$33.00
2024-06-10,22:46:00,19096.5,SELL,3,0.02h,Stop Loss,$-9.00,$24.00,$82047.50,114,$24.00
,,,,,,,,,,,
2024-06-11,12:45:00,19066.0,BUY,3,0.02h,Stop Loss,$-9.00,$-9.00,$82038.50,115,$-9.00
2024-06-11,12:53:00,19057.5,SELL,3,0.02h,Break Even,$-1.50,$-10.50,$82037.00,115,$-10.50
2024-06-11,13:14:00,19058.5,BUY,3,0.02h,Break Even,$-1.50,$-12.00,$82035.50,115,$-12.00
2024-06-11,13:26:00,19050.0,SELL,3,0.02h,Stop Loss,$-9.00,$-21.00,$82026.50,115,$-21.00
2024-06-11,13:30:00,19057.5,BUY,3,0.02h,Stop Loss,$31.50,$10.50,$82058.00,115,$10.50
2024-06-11,13:32:00,19048.5,SELL,3,0.02h,Stop Loss,$-9.00,$1.50,$82049.00,115,$1.50
2024-06-11,13:33:00,19060.5,BUY,3,0.02h,Stop Loss,$75.00,$76.50,$82124.00,115,$76.50
2024-06-11,13:47:00,19048.25,SELL,3,0.02h,Stop Loss,$220.50,$297.00,$82344.50,115,$297.00
2024-06-11,14:05:00,19053.5,BUY,3,0.02h,Stop Loss,$58.50,$355.50,$82403.00,115,$355.50
2024-06-11,15:10:00,19107.0,SELL,3,0.02h,Stop Loss,$-9.00,$346.50,$82394.00,115,$346.50
2024-06-11,15:24:00,19115.25,BUY,3,0.02h,Break Even,$-1.50,$345.00,$82392.50,115,$345.00
2024-06-11,15:40:00,19111.25,SELL,3,0.02h,Stop Loss,$19.50,$364.50,$82412.00,115,$364.50
2024-06-11,16:13:00,19092.0,BUY,3,0.02h,Break Even,$-1.50,$363.00,$82410.50,115,$363.00
2024-06-11,16:24:00,19083.5,SELL,3,0.02h,Break Even,$-1.50,$361.50,$82409.00,115,$361.50
2024-06-11,16:26:00,19093.5,BUY,3,0.02h,Break Even,$-1.50,$360.00,$82407.50,115,$360.00
2024-06-11,16:59:00,19097.0,SELL,3,0.02h,Stop Loss,$16.50,$376.50,$82424.00,115,$376.50
2024-06-11,17:03:00,19113.25,BUY,3,0.02h,Stop Loss,$60.00,$436.50,$82484.00,115,$436.50
2024-06-11,17:25:00,19110.5,SELL,3,0.02h,Stop Loss,$-9.00,$427.50,$82475.00,115,$427.50
2024-06-11,17:33:00,19124.75,BUY,3,0.02h,Break Even,$-1.50,$426.00,$82473.50,115,$426.00
2024-06-11,18:54:00,19199.25,SELL,3,0.02h,Stop Loss,$-9.00,$417.00,$82464.50,115,$417.00
2024-06-11,19:03:00,19216.5,BUY,3,0.02h,Stop Loss,$15.00,$432.00,$82479.50,115,$432.00
2024-06-11,19:12:00,19201.75,SELL,3,0.02h,Stop Loss,$15.00,$447.00,$82494.50,115,$447.00
2024-06-11,19:42:00,19203.75,BUY,3,0.02h,Stop Loss,$-9.00,$438.00,$82485.50,115,$438.00
2024-06-11,20:39:00,19243.75,SELL,3,0.02h,Break Even,$-1.50,$436.50,$82484.00,115,$436.50
2024-06-11,20:58:00,19247.25,BUY,3,0.02h,Stop Loss,$-9.00,$427.50,$82475.00,115,$427.50
2024-06-11,22:02:00,19240.25,SELL,3,0.02h,Stop Loss,$15.00,$442.50,$82490.00,115,$442.50
2024-06-11,22:22:00,19240.25,BUY,3,0.02h,Break Even,$-1.50,$441.00,$82488.50,115,$441.00
,,,,,,,,,,,
2024-06-12,12:28:00,19266.25,SELL,3,0.02h,Stop Loss,$-9.00,$-9.00,$82479.50,116,$-9.00
2024-06-12,12:30:00,19286.5,BUY,3,0.02h,Stop Loss,$1011.00,$1002.00,$83490.50,116,$1002.00
2024-06-12,13:24:00,19414.0,SELL,3,0.02h,Stop Loss,$-9.00,$993.00,$83481.50,116,$993.00
2024-06-12,13:35:00,19435.5,BUY,3,0.02h,Break Even,$-1.50,$991.50,$83480.00,116,$991.50
2024-06-12,14:44:00,19510.25,SELL,3,0.02h,Stop Loss,$61.50,$1053.00,$83541.50,116,$1053.00
2024-06-12,15:07:00,19522.5,BUY,3,0.02h,Break Even,$-1.50,$1051.50,$83540.00,116,$1051.50
2024-06-12,15:16:00,19503.5,SELL,3,0.02h,Stop Loss,$-9.00,$1042.50,$83531.00,116,$1042.50
2024-06-12,15:20:00,19523.5,BUY,3,0.02h,Stop Loss,$10.50,$1053.00,$83541.50,116,$1053.00
2024-06-12,15:45:00,19518.25,SELL,3,0.02h,Stop Loss,$15.00,$1068.00,$83556.50,116,$1068.00
2024-06-12,16:10:00,19519.75,BUY,3,0.02h,Break Even,$-1.50,$1066.50,$83555.00,116,$1066.50
2024-06-12,16:13:00,19509.75,SELL,3,0.02h,Stop Loss,$-9.00,$1057.50,$83546.00,116,$1057.50
2024-06-12,16:45:00,19511.0,BUY,3,0.02h,Stop Loss,$10.50,$1068.00,$83556.50,116,$1068.00
2024-06-12,16:57:00,19504.5,SELL,3,0.02h,Stop Loss,$-9.00,$1059.00,$83547.50,116,$1059.00
2024-06-12,17:00:00,19509.5,BUY,3,0.02h,Stop Loss,$13.50,$1072.50,$83561.00,116,$1072.50
2024-06-12,17:32:00,19505.25,SELL,3,0.02h,Stop Loss,$55.50,$1128.00,$83616.50,116,$1128.00
2024-06-12,17:56:00,19516.25,BUY,3,0.02h,Break Even,$-1.50,$1126.50,$83615.00,116,$1126.50
2024-06-12,18:01:00,19488.5,SELL,3,0.02h,Stop Loss,$84.00,$1210.50,$83699.00,116,$1210.50
2024-06-12,18:19:00,19516.0,BUY,3,0.02h,Stop Loss,$13.50,$1224.00,$83712.50,116,$1224.00
2024-06-12,18:36:00,19488.5,SELL,3,0.02h,Stop Loss,$40.50,$1264.50,$83753.00,116,$1264.50
2024-06-12,18:40:00,19540.0,BUY,3,0.02h,Break Even,$-1.50,$1263.00,$83751.50,116,$1263.00
2024-06-12,18:46:00,19495.0,SELL,3,0.02h,Stop Loss,$19.50,$1282.50,$83771.00,116,$1282.50
2024-06-12,18:59:00,19518.5,BUY,3,0.02h,Stop Loss,$31.50,$1314.00,$83802.50,116,$1314.00
2024-06-12,19:26:00,19494.25,SELL,3,0.02h,Stop Loss,$52.50,$1366.50,$83855.00,116,$1366.50
2024-06-12,19:52:00,19498.25,BUY,3,0.02h,Stop Loss,$64.50,$1431.00,$83919.50,116,$1431.00
2024-06-12,20:04:00,19468.25,SELL,3,0.02h,Stop Loss,$7.50,$1438.50,$83927.00,116,$1438.50
2024-06-12,20:16:00,19540.75,BUY,3,0.02h,Stop Loss,$72.00,$1510.50,$83999.00,116,$1510.50
2024-06-12,22:17:00,19589.75,SELL,3,0.02h,Break Even,$-1.50,$1509.00,$83997.50,116,$1509.00
2024-06-12,22:21:00,19597.5,BUY,3,0.02h,Break Even,$-1.50,$1507.50,$83996.00,116,$1507.50
2024-06-12,22:41:00,19593.75,SELL,3,0.02h,Stop Loss,$-9.00,$1498.50,$83987.00,116,$1498.50
,,,,,,,,,,,
2024-06-13,12:00:00,19873.25,BUY,3,0.02h,Stop Loss,$-9.00,$-9.00,$83978.00,117,$-9.00
2024-06-13,12:23:00,19637.0,SELL,3,0.02h,Stop Loss,$-9.00,$-18.00,$83969.00,117,$-18.00
2024-06-13,12:24:00,19895.75,BUY,3,0.02h,Stop Loss,$-9.00,$-27.00,$83960.00,117,$-27.00
2024-06-13,12:25:00,19634.75,SELL,3,0.02h,Break Even,$-1.50,$-28.50,$83958.50,117,$-28.50
2024-06-13,12:27:00,19900.25,BUY,3,0.02h,Stop Loss,$-9.00,$-37.50,$83949.50,117,$-37.50
2024-06-13,12:28:00,19637.75,SELL,3,0.02h,Break Even,$-1.50,$-39.00,$83948.00,117,$-39.00
2024-06-13,12:31:00,19931.75,BUY,3,0.02h,Stop Loss,$-9.00,$-48.00,$83939.00,117,$-48.00
2024-06-13,12:32:00,19669.5,SELL,3,0.02h,Stop Loss,$10.50,$-37.50,$83949.50,117,$-37.50
2024-06-13,12:38:00,19913.75,BUY,3,0.02h,Stop Loss,$-9.00,$-46.50,$83940.50,117,$-46.50
2024-06-13,12:39:00,19652.75,SELL,3,0.02h,Stop Loss,$88.50,$42.00,$84029.00,117,$42.00
2024-06-13,12:43:00,19904.75,BUY,3,0.02h,Stop Loss,$-9.00,$33.00,$84020.00,117,$33.00
2024-06-13,12:44:00,19633.0,SELL,3,0.02h,Stop Loss,$-9.00,$24.00,$84011.00,117,$24.00
2024-06-13,12:45:00,19899.5,BUY,3,0.02h,Break Even,$-1.50,$22.50,$84009.50,117,$22.50
2024-06-13,12:53:00,19631.5,SELL,3,0.02h,Break Even,$-1.50,$21.00,$84008.00,117,$21.00
2024-06-13,12:55:00,19901.0,BUY,3,0.02h,Stop Loss,$-9.00,$12.00,$83999.00,117,$12.00
2024-06-13,12:56:00,19633.0,SELL,3,0.02h,Stop Loss,$7.50,$19.50,$84006.50,117,$19.50
2024-06-13,12:58:00,19898.0,BUY,3,0.02h,Stop Loss,$-9.00,$10.50,$83997.50,117,$10.50
2024-06-13,13:00:00,19629.25,SELL,3,0.02h,Stop Loss,$7.50,$18.00,$84005.00,117,$18.00
2024-06-13,13:07:00,19882.0,BUY,3,0.02h,Stop Loss,$-9.00,$9.00,$83996.00,117,$9.00
2024-06-13,13:08:00,19623.75,SELL,3,0.02h,Stop Loss,$-9.00,$0.00,$83987.00,117,$0.00
2024-06-13,13:09:00,19884.25,BUY,3,0.02h,Stop Loss,$-9.00,$-9.00,$83978.00,117,$-9.00
2024-06-13,13:10:00,19619.5,SELL,3,0.02h,Break Even,$-1.50,$-10.50,$83976.50,117,$-10.50
2024-06-13,13:16:00,19893.75,BUY,3,0.02h,Break Even,$-1.50,$-12.00,$83975.00,117,$-12.00
2024-06-13,13:26:00,19640.25,SELL,3,0.02h,Stop Loss,$-9.00,$-21.00,$83966.00,117,$-21.00
2024-06-13,13:27:00,19900.5,BUY,3,0.02h,Stop Loss,$10.50,$-10.50,$83976.50,117,$-10.50
2024-06-13,13:31:00,19635.0,SELL,3,0.02h,Stop Loss,$21.00,$10.50,$83997.50,117,$10.50
2024-06-13,13:41:00,19917.0,BUY,3,0.02h,Stop Loss,$4.50,$15.00,$84002.00,117,$15.00
2024-06-13,13:50:00,19653.25,SELL,3,0.02h,Stop Loss,$-9.00,$6.00,$83993.00,117,$6.00
2024-06-13,13:51:00,19912.5,BUY,3,0.02h,Stop Loss,$-9.00,$-3.00,$83984.00,117,$-3.00
2024-06-13,13:52:00,19637.5,SELL,3,0.02h,Stop Loss,$13.50,$10.50,$83997.50,117,$10.50
2024-06-13,13:54:00,19894.5,BUY,3,0.02h,Stop Loss,$45.00,$55.50,$84042.50,117,$55.50
2024-06-13,13:56:00,19637.5,SELL,3,0.02h,Stop Loss,$18.00,$73.50,$84060.50,117,$73.50
2024-06-13,14:03:00,19905.5,BUY,3,0.02h,Stop Loss,$-9.00,$64.50,$84051.50,117,$64.50
2024-06-13,14:04:00,19641.75,SELL,3,0.02h,Stop Loss,$60.00,$124.50,$84111.50,117,$124.50
2024-06-13,14:08:00,19898.0,BUY,3,0.02h,Break Even,$-1.50,$123.00,$84110.00,117,$123.00
2024-06-13,14:12:00,19606.25,SELL,3,0.02h,Stop Loss,$54.00,$177.00,$84164.00,117,$177.00
2024-06-13,14:22:00,19827.25,BUY,3,0.02h,Stop Loss,$-9.00,$168.00,$84155.00,117,$168.00
2024-06-13,14:23:00,19559.75,SELL,3,0.02h,Stop Loss,$118.50,$286.50,$84273.50,117,$286.50
2024-06-13,14:26:00,19815.0,BUY,3,0.02h,Stop Loss,$-9.00,$277.50,$84264.50,117,$277.50
2024-06-13,14:36:00,19559.0,SELL,3,0.02h,Break Even,$-1.50,$276.00,$84263.00,117,$276.00
2024-06-13,14:43:00,19843.0,BUY,3,0.02h,Stop Loss,$-9.00,$267.00,$84254.00,117,$267.00
2024-06-13,14:49:00,19567.0,SELL,3,0.02h,Stop Loss,$-9.00,$258.00,$84245.00,117,$258.00
2024-06-13,14:50:00,19844.75,BUY,3,0.02h,Break Even,$-1.50,$256.50,$84243.50,117,$256.50
2024-06-13,14:54:00,19572.75,SELL,3,0.02h,Break Even,$-1.50,$255.00,$84242.00,117,$255.00
2024-06-13,14:57:00,19826.25,BUY,3,0.02h,Stop Loss,$-9.00,$246.00,$84233.00,117,$246.00
2024-06-13,14:58:00,19560.75,SELL,3,0.02h,Stop Loss,$10.50,$256.50,$84243.50,117,$256.50
2024-06-13,15:07:00,19839.0,BUY,3,0.02h,Stop Loss,$-9.00,$247.50,$84234.50,117,$247.50
2024-06-13,15:08:00,19582.25,SELL,3,0.02h,Break Even,$-1.50,$246.00,$84233.00,117,$246.00
2024-06-13,15:11:00,19850.0,BUY,3,0.02h,Break Even,$-1.50,$244.50,$84231.50,117,$244.50
2024-06-13,15:16:00,19559.0,SELL,3,0.02h,Break Even,$-1.50,$243.00,$84230.00,117,$243.00
2024-06-13,15:30:00,19840.0,BUY,3,0.02h,Stop Loss,$-9.00,$234.00,$84221.00,117,$234.00
2024-06-13,15:31:00,19585.75,SELL,3,0.02h,Stop Loss,$-9.00,$225.00,$84212.00,117,$225.00
2024-06-13,15:33:00,19855.25,BUY,3,0.02h,Break Even,$-1.50,$223.50,$84210.50,117,$223.50
2024-06-13,15:51:00,19601.25,SELL,3,0.02h,Stop Loss,$30.00,$253.50,$84240.50,117,$253.50
2024-06-13,15:53:00,19861.25,BUY,3,0.02h,Stop Loss,$-9.00,$244.50,$84231.50,117,$244.50
2024-06-13,15:54:00,19594.75,SELL,3,0.02h,Stop Loss,$-9.00,$235.50,$84222.50,117,$235.50
2024-06-13,15:55:00,19856.0,BUY,3,0.02h,Stop Loss,$12.00,$247.50,$84234.50,117,$247.50
2024-06-13,15:57:00,19594.75,SELL,3,0.02h,Stop Loss,$4.50,$252.00,$84239.00,117,$252.00
2024-06-13,16:04:00,19816.75,BUY,3,0.02h,Stop Loss,$-9.00,$243.00,$84230.00,117,$243.00
2024-06-13,16:05:00,19561.5,SELL,3,0.02h,Stop Loss,$-9.00,$234.00,$84221.00,117,$234.00
2024-06-13,16:06:00,19831.0,BUY,3,0.02h,Stop Loss,$-9.00,$225.00,$84212.00,117,$225.00
2024-06-13,16:07:00,19572.5,SELL,3,0.02h,Stop Loss,$-9.00,$216.00,$84203.00,117,$216.00
2024-06-13,16:08:00,19829.25,BUY,3,0.02h,Stop Loss,$-9.00,$207.00,$84194.00,117,$207.00
2024-06-13,16:09:00,19563.75,SELL,3,0.02h,Stop Loss,$25.50,$232.50,$84219.50,117,$232.50
2024-06-13,16:16:00,19814.0,BUY,3,0.02h,Break Even,$-1.50,$231.00,$84218.00,117,$231.00
2024-06-13,16:26:00,19519.5,SELL,3,0.02h,Stop Loss,$61.50,$292.50,$84279.50,117,$292.50
2024-06-13,16:36:00,19798.25,BUY,3,0.02h,Break Even,$-1.50,$291.00,$84278.00,117,$291.00
2024-06-13,16:43:00,19536.5,SELL,3,0.02h,Break Even,$-1.50,$289.50,$84276.50,117,$289.50
2024-06-13,16:49:00,19774.0,BUY,3,0.02h,Stop Loss,$-9.00,$280.50,$84267.50,117,$280.50
2024-06-13,16:50:00,19521.5,SELL,3,0.02h,Stop Loss,$-9.00,$271.50,$84258.50,117,$271.50
2024-06-13,16:51:00,19789.75,BUY,3,0.02h,Stop Loss,$-9.00,$262.50,$84249.50,117,$262.50
2024-06-13,16:52:00,19538.0,SELL,3,0.02h,Stop Loss,$-9.00,$253.50,$84240.50,117,$253.50
2024-06-13,16:53:00,19804.25,BUY,3,0.02h,Stop Loss,$-9.00,$244.50,$84231.50,117,$244.50
2024-06-13,16:54:00,19545.0,SELL,3,0.02h,Break Even,$-1.50,$243.00,$84230.00,117,$243.00
2024-06-13,17:00:00,19804.5,BUY,3,0.02h,Stop Loss,$40.50,$283.50,$84270.50,117,$283.50
2024-06-13,17:08:00,19558.75,SELL,3,0.02h,Break Even,$-1.50,$282.00,$84269.00,117,$282.00
2024-06-13,17:10:00,19817.25,BUY,3,0.02h,Stop Loss,$24.00,$306.00,$84293.00,117,$306.00
2024-06-13,17:15:00,19572.25,SELL,3,0.02h,Stop Loss,$57.00,$363.00,$84350.00,117,$363.00
2024-06-13,17:21:00,19823.0,BUY,3,0.02h,Break Even,$-1.50,$361.50,$84348.50,117,$361.50
2024-06-13,17:24:00,19565.25,SELL,3,0.02h,Break Even,$-1.50,$360.00,$84347.00,117,$360.00
2024-06-13,17:45:00,19839.5,BUY,3,0.02h,Stop Loss,$-9.00,$351.00,$84338.00,117,$351.00
2024-06-13,17:55:00,19579.75,SELL,3,0.02h,Stop Loss,$-9.00,$342.00,$84329.00,117,$342.00
2024-06-13,17:56:00,19839.0,BUY,3,0.02h,Stop Loss,$-9.00,$333.00,$84320.00,117,$333.00
2024-06-13,18:14:00,19583.5,SELL,3,0.02h,Stop Loss,$-9.00,$324.00,$84311.00,117,$324.00
2024-06-13,18:15:00,19845.5,BUY,3,0.02h,Stop Loss,$-9.00,$315.00,$84302.00,117,$315.00
2024-06-13,18:21:00,19586.25,SELL,3,0.02h,Stop Loss,$-9.00,$306.00,$84293.00,117,$306.00
2024-06-13,18:22:00,19848.0,BUY,3,0.02h,Stop Loss,$-9.00,$297.00,$84284.00,117,$297.00
2024-06-13,18:23:00,19588.0,SELL,3,0.02h,Stop Loss,$-9.00,$288.00,$84275.00,117,$288.00
2024-06-13,18:34:00,19853.5,BUY,3,0.02h,Stop Loss,$-9.00,$279.00,$84266.00,117,$279.00
2024-06-13,18:38:00,19589.0,SELL,3,0.02h,Stop Loss,$16.50,$295.50,$84282.50,117,$295.50
2024-06-13,18:40:00,19846.25,BUY,3,0.02h,Stop Loss,$-9.00,$286.50,$84273.50,117,$286.50
2024-06-13,18:41:00,19589.25,SELL,3,0.02h,Stop Loss,$-9.00,$277.50,$84264.50,117,$277.50
2024-06-13,18:49:00,19851.5,BUY,3,0.02h,Stop Loss,$6.00,$283.50,$84270.50,117,$283.50
2024-06-13,19:00:00,19599.0,SELL,3,0.02h,Stop Loss,$22.50,$306.00,$84293.00,117,$306.00
2024-06-13,19:04:00,19865.25,BUY,3,0.02h,Stop Loss,$-9.00,$297.00,$84284.00,117,$297.00
2024-06-13,19:05:00,19610.5,SELL,3,0.02h,Stop Loss,$-9.00,$288.00,$84275.00,117,$288.00
2024-06-13,19:06:00,19871.5,BUY,3,0.02h,Stop Loss,$-9.00,$279.00,$84266.00,117,$279.00
2024-06-13,19:07:00,19606.5,SELL,3,0.02h,Stop Loss,$-9.00,$270.00,$84257.00,117,$270.00
2024-06-13,19:14:00,19864.25,BUY,3,0.02h,Stop Loss,$-9.00,$261.00,$84248.00,117,$261.00
2024-06-13,19:17:00,19590.5,SELL,3,0.02h,Stop Loss,$-9.00,$252.00,$84239.00,117,$252.00
2024-06-13,19:18:00,19860.75,BUY,3,0.02h,Stop Loss,$-9.00,$243.00,$84230.00,117,$243.00
2024-06-13,19:19:00,19601.0,SELL,3,0.02h,Stop Loss,$-9.00,$234.00,$84221.00,117,$234.00
2024-06-13,19:28:00,19865.75,BUY,3,0.02h,Stop Loss,$-9.00,$225.00,$84212.00,117,$225.00
2024-06-13,19:29:00,19608.5,SELL,3,0.02h,Stop Loss,$21.00,$246.00,$84233.00,117,$246.00
2024-06-13,19:34:00,19858.5,BUY,3,0.02h,Stop Loss,$-9.00,$237.00,$84224.00,117,$237.00
2024-06-13,19:35:00,19600.0,SELL,3,0.02h,Stop Loss,$15.00,$252.00,$84239.00,117,$252.00
2024-06-13,19:44:00,19863.75,BUY,3,0.02h,Break Even,$-1.50,$250.50,$84237.50,117,$250.50
2024-06-13,19:56:00,19617.25,SELL,3,0.02h,Stop Loss,$-9.00,$241.50,$84228.50,117,$241.50
2024-06-13,19:57:00,19882.5,BUY,3,0.02h,Stop Loss,$7.50,$249.00,$84236.00,117,$249.00
2024-06-13,20:07:00,19622.75,SELL,3,0.02h,Stop Loss,$43.50,$292.50,$84279.50,117,$292.50
2024-06-13,20:10:00,19872.0,BUY,3,0.02h,Stop Loss,$-9.00,$283.50,$84270.50,117,$283.50
2024-06-13,20:11:00,19613.25,SELL,3,0.02h,Stop Loss,$6.00,$289.50,$84276.50,117,$289.50
2024-06-13,20:15:00,19877.75,BUY,3,0.02h,Stop Loss,$-9.00,$280.50,$84267.50,117,$280.50
2024-06-13,20:19:00,19611.75,SELL,3,0.02h,Stop Loss,$-9.00,$271.50,$84258.50,117,$271.50
2024-06-13,20:23:00,19873.75,BUY,3,0.02h,Stop Loss,$-9.00,$262.50,$84249.50,117,$262.50
2024-06-13,20:24:00,19613.0,SELL,3,0.02h,Break Even,$-1.50,$261.00,$84248.00,117,$261.00
2024-06-13,20:29:00,19875.25,BUY,3,0.02h,Stop Loss,$-9.00,$252.00,$84239.00,117,$252.00
2024-06-13,20:30:00,19613.5,SELL,3,0.02h,Stop Loss,$6.00,$258.00,$84245.00,117,$258.00
2024-06-13,20:33:00,19874.5,BUY,3,0.02h,Stop Loss,$-9.00,$249.00,$84236.00,117,$249.00
2024-06-13,20:39:00,19605.25,SELL,3,0.02h,Break Even,$-1.50,$247.50,$84234.50,117,$247.50
2024-06-13,20:49:00,19857.25,BUY,3,0.02h,Stop Loss,$-9.00,$238.50,$84225.50,117,$238.50
2024-06-13,20:53:00,19600.25,SELL,3,0.02h,Stop Loss,$-9.00,$229.50,$84216.50,117,$229.50
2024-06-13,20:54:00,19859.25,BUY,3,0.02h,Break Even,$-1.50,$228.00,$84215.00,117,$228.00
2024-06-13,20:58:00,19606.5,SELL,3,0.02h,Stop Loss,$-9.00,$219.00,$84206.00,117,$219.00
2024-06-13,20:59:00,19868.0,BUY,3,0.02h,Stop Loss,$-9.00,$210.00,$84197.00,117,$210.00
2024-06-13,21:00:00,19608.25,SELL,3,1.02h,Stop Loss,$73.50,$283.50,$84270.50,117,$283.50
2024-06-13,22:03:00,19857.0,BUY,3,0.02h,Stop Loss,$-9.00,$274.50,$84261.50,117,$274.50
2024-06-13,22:07:00,19595.75,SELL,3,0.02h,Stop Loss,$-9.00,$265.50,$84252.50,117,$265.50
2024-06-13,22:10:00,19860.5,BUY,3,0.02h,Stop Loss,$-9.00,$256.50,$84243.50,117,$256.50
2024-06-13,22:19:00,19607.5,SELL,3,0.02h,Break Even,$-1.50,$255.00,$84242.00,117,$255.00
2024-06-13,22:30:00,19871.0,BUY,3,0.02h,Stop Loss,$-9.00,$246.00,$84233.00,117,$246.00
2024-06-13,22:31:00,19607.25,SELL,3,0.02h,Stop Loss,$-9.00,$237.00,$84224.00,117,$237.00
2024-06-13,22:32:00,19870.75,BUY,3,0.02h,Stop Loss,$-9.00,$228.00,$84215.00,117,$228.00
2024-06-13,22:33:00,19609.25,SELL,3,0.02h,Stop Loss,$-9.00,$219.00,$84206.00,117,$219.00
2024-06-13,22:34:00,19874.0,BUY,3,0.02h,Stop Loss,$-9.00,$210.00,$84197.00,117,$210.00
2024-06-13,22:40:00,19612.5,SELL,3,0.07h,Stop Loss,$-9.00,$201.00,$84188.00,117,$201.00
2024-06-13,22:45:00,19875.0,BUY,3,0.02h,Stop Loss,$-9.00,$192.00,$84179.00,117,$192.00
2024-06-13,22:46:00,19612.25,SELL,3,0.02h,Stop Loss,$-9.00,$183.00,$84170.00,117,$183.00
2024-06-13,22:47:00,19876.0,BUY,3,0.03h,Stop Loss,$-9.00,$174.00,$84161.00,117,$174.00
2024-06-13,22:50:00,19612.25,SELL,3,0.02h,Stop Loss,$-9.00,$165.00,$84152.00,117,$165.00
2024-06-13,22:51:00,19872.5,BUY,3,0.02h,Stop Loss,$-9.00,$156.00,$84143.00,117,$156.00
2024-06-13,22:58:00,19610.25,SELL,3,0.03h,Break Even,$-1.50,$154.50,$84141.50,117,$154.50
,,,,,,,,,,,
2024-06-14,12:05:00,19805.25,BUY,3,0.02h,Stop Loss,$-9.00,$-9.00,$84132.50,118,$-9.00
2024-06-14,12:07:00,19552.0,SELL,3,0.02h,Stop Loss,$-9.00,$-18.00,$84123.50,118,$-18.00
2024-06-14,12:08:00,19809.0,BUY,3,0.02h,Break Even,$-1.50,$-19.50,$84122.00,118,$-19.50
2024-06-14,12:10:00,19544.0,SELL,3,0.02h,Stop Loss,$-9.00,$-28.50,$84113.00,118,$-28.50
2024-06-14,12:12:00,19809.5,BUY,3,0.02h,Stop Loss,$-9.00,$-37.50,$84104.00,118,$-37.50
2024-06-14,12:14:00,19534.75,SELL,3,0.02h,Stop Loss,$-9.00,$-46.50,$84095.00,118,$-46.50
2024-06-14,12:16:00,19800.75,BUY,3,0.02h,Stop Loss,$-9.00,$-55.50,$84086.00,118,$-55.50
2024-06-14,12:17:00,19543.25,SELL,3,0.02h,Stop Loss,$-9.00,$-64.50,$84077.00,118,$-64.50
2024-06-14,12:21:00,19816.5,BUY,3,0.02h,Stop Loss,$-9.00,$-73.50,$84068.00,118,$-73.50
2024-06-14,12:22:00,19556.5,SELL,3,0.02h,Stop Loss,$-9.00,$-82.50,$84059.00,118,$-82.50
2024-06-14,12:23:00,19825.0,BUY,3,0.02h,Stop Loss,$-9.00,$-91.50,$84050.00,118,$-91.50
2024-06-14,12:26:00,19564.5,SELL,3,0.02h,Stop Loss,$-9.00,$-100.50,$84041.00,118,$-100.50
2024-06-14,12:27:00,19823.5,BUY,3,0.02h,Break Even,$-1.50,$-102.00,$84039.50,118,$-102.00
2024-06-14,12:42:00,19559.25,SELL,3,0.02h,Stop Loss,$-9.00,$-111.00,$84030.50,118,$-111.00
2024-06-14,12:56:00,19822.25,BUY,3,0.02h,Stop Loss,$-9.00,$-120.00,$84021.50,118,$-120.00
2024-06-14,12:57:00,19558.75,SELL,3,0.02h,Stop Loss,$-9.00,$-129.00,$84012.50,118,$-129.00
2024-06-14,12:58:00,19819.75,BUY,3,0.02h,Break Even,$-1.50,$-130.50,$84011.00,118,$-130.50
2024-06-14,13:03:00,19558.5,SELL,3,0.02h,Stop Loss,$10.50,$-120.00,$84021.50,118,$-120.00
2024-06-14,13:06:00,19818.25,BUY,3,0.02h,Stop Loss,$-9.00,$-129.00,$84012.50,118,$-129.00
2024-06-14,13:08:00,19559.25,SELL,3,0.02h,Stop Loss,$-9.00,$-138.00,$84003.50,118,$-138.00
2024-06-14,13:09:00,19818.75,BUY,3,0.02h,Break Even,$-1.50,$-139.50,$84002.00,118,$-139.50
2024-06-14,13:11:00,19557.5,SELL,3,0.02h,Stop Loss,$-9.00,$-148.50,$83993.00,118,$-148.50
2024-06-14,13:12:00,19822.0,BUY,3,0.02h,Break Even,$-1.50,$-150.00,$83991.50,118,$-150.00
2024-06-14,13:18:00,19559.0,SELL,3,0.02h,Break Even,$-1.50,$-151.50,$83990.00,118,$-151.50
2024-06-14,13:24:00,19827.25,BUY,3,0.02h,Break Even,$-1.50,$-153.00,$83988.50,118,$-153.00
2024-06-14,13:28:00,19565.0,SELL,3,0.02h,Stop Loss,$-9.00,$-162.00,$83979.50,118,$-162.00
2024-06-14,13:29:00,19830.5,BUY,3,0.02h,Stop Loss,$36.00,$-126.00,$84015.50,118,$-126.00
2024-06-14,13:31:00,19577.75,SELL,3,0.02h,Stop Loss,$-9.00,$-135.00,$84006.50,118,$-135.00
2024-06-14,13:32:00,19842.75,BUY,3,0.02h,Stop Loss,$-9.00,$-144.00,$83997.50,118,$-144.00
2024-06-14,13:33:00,19561.0,SELL,3,0.02h,Stop Loss,$3.00,$-141.00,$84000.50,118,$-141.00
2024-06-14,13:37:00,19847.25,BUY,3,0.02h,Stop Loss,$-9.00,$-150.00,$83991.50,118,$-150.00
2024-06-14,13:38:00,19590.5,SELL,3,0.02h,Stop Loss,$-9.00,$-159.00,$83982.50,118,$-159.00
2024-06-14,13:39:00,19856.25,BUY,3,0.02h,Stop Loss,$-9.00,$-168.00,$83973.50,118,$-168.00
2024-06-14,13:40:00,19599.25,SELL,3,0.02h,Stop Loss,$21.00,$-147.00,$83994.50,118,$-147.00
2024-06-14,13:44:00,19852.0,BUY,3,0.02h,Stop Loss,$21.00,$-126.00,$84015.50,118,$-126.00
2024-06-14,13:52:00,19626.25,SELL,3,0.02h,Stop Loss,$-9.00,$-135.00,$84006.50,118,$-135.00
2024-06-14,13:53:00,19893.5,BUY,3,0.02h,Stop Loss,$-9.00,$-144.00,$83997.50,118,$-144.00
2024-06-14,13:54:00,19632.0,SELL,3,0.02h,Stop Loss,$16.50,$-127.50,$84014.00,118,$-127.50
2024-06-14,14:01:00,19875.0,BUY,3,0.02h,Stop Loss,$-9.00,$-136.50,$84005.00,118,$-136.50
2024-06-14,14:02:00,19620.25,SELL,3,0.02h,Stop Loss,$7.50,$-129.00,$84012.50,118,$-129.00
2024-06-14,14:06:00,19869.5,BUY,3,0.02h,Stop Loss,$-9.00,$-138.00,$84003.50,118,$-138.00
2024-06-14,14:07:00,19610.75,SELL,3,0.02h,Stop Loss,$-9.00,$-147.00,$83994.50,118,$-147.00
2024-06-14,14:08:00,19890.5,BUY,3,0.02h,Stop Loss,$-9.00,$-156.00,$83985.50,118,$-156.00
2024-06-14,14:10:00,19605.25,SELL,3,0.02h,Stop Loss,$-9.00,$-165.00,$83976.50,118,$-165.00
2024-06-14,14:11:00,19868.5,BUY,3,0.02h,Stop Loss,$-9.00,$-174.00,$83967.50,118,$-174.00
2024-06-14,14:12:00,19605.5,SELL,3,0.02h,Stop Loss,$-9.00,$-183.00,$83958.50,118,$-183.00
2024-06-14,14:13:00,19857.25,BUY,3,0.02h,Stop Loss,$-9.00,$-192.00,$83949.50,118,$-192.00
2024-06-14,14:14:00,19598.75,SELL,3,0.02h,Stop Loss,$-9.00,$-201.00,$83940.50,118,$-201.00
2024-06-14,14:15:00,19856.25,BUY,3,0.02h,Stop Loss,$55.50,$-145.50,$83996.00,118,$-145.50
2024-06-14,14:22:00,19641.5,SELL,3,0.02h,Stop Loss,$51.00,$-94.50,$84047.00,118,$-94.50
2024-06-14,14:24:00,19900.25,BUY,3,0.02h,Stop Loss,$39.00,$-55.50,$84086.00,118,$-55.50
2024-06-14,14:30:00,19624.25,SELL,3,0.02h,Stop Loss,$12.00,$-43.50,$84098.00,118,$-43.50
2024-06-14,14:34:00,19866.5,BUY,3,0.02h,Stop Loss,$-9.00,$-52.50,$84089.00,118,$-52.50
2024-06-14,14:35:00,19610.0,SELL,3,0.02h,Stop Loss,$-9.00,$-61.50,$84080.00,118,$-61.50
2024-06-14,14:36:00,19862.0,BUY,3,0.02h,Stop Loss,$-9.00,$-70.50,$84071.00,118,$-70.50
2024-06-14,14:37:00,19592.5,SELL,3,0.02h,Stop Loss,$63.00,$-7.50,$84134.00,118,$-7.50
2024-06-14,14:40:00,19836.75,BUY,3,0.02h,Stop Loss,$-9.00,$-16.50,$84125.00,118,$-16.50
2024-06-14,14:41:00,19585.25,SELL,3,0.02h,Stop Loss,$18.00,$1.50,$84143.00,118,$1.50
2024-06-14,14:45:00,19864.75,BUY,3,0.02h,Break Even,$-1.50,$0.00,$84141.50,118,$0.00
2024-06-14,14:53:00,19625.25,SELL,3,0.02h,Stop Loss,$4.50,$4.50,$84146.00,118,$4.50
2024-06-14,14:55:00,19891.75,BUY,3,0.02h,Stop Loss,$-9.00,$-4.50,$84137.00,118,$-4.50
2024-06-14,14:56:00,19629.25,SELL,3,0.02h,Stop Loss,$16.50,$12.00,$84153.50,118,$12.00
2024-06-14,15:00:00,19890.0,BUY,3,0.02h,Break Even,$-1.50,$10.50,$84152.00,118,$10.50
2024-06-14,15:10:00,19600.75,SELL,3,0.02h,Stop Loss,$-9.00,$1.50,$84143.00,118,$1.50
2024-06-14,15:11:00,19866.25,BUY,3,0.02h,Stop Loss,$-9.00,$-7.50,$84134.00,118,$-7.50
2024-06-14,15:12:00,19612.25,SELL,3,0.02h,Stop Loss,$-9.00,$-16.50,$84125.00,118,$-16.50
2024-06-14,15:13:00,19882.5,BUY,3,0.02h,Break Even,$-1.50,$-18.00,$84123.50,118,$-18.00
2024-06-14,15:15:00,19624.5,SELL,3,0.02h,Stop Loss,$-9.00,$-27.00,$84114.50,118,$-27.00
2024-06-14,15:16:00,19881.0,BUY,3,0.02h,Break Even,$-1.50,$-28.50,$84113.00,118,$-28.50
2024-06-14,15:18:00,19609.75,SELL,3,0.02h,Stop Loss,$-9.00,$-37.50,$84104.00,118,$-37.50
2024-06-14,15:19:00,19878.75,BUY,3,0.02h,Stop Loss,$-9.00,$-46.50,$84095.00,118,$-46.50
2024-06-14,15:21:00,19625.25,SELL,3,0.02h,Stop Loss,$70.50,$24.00,$84165.50,118,$24.00
2024-06-14,15:36:00,19881.25,BUY,3,0.02h,Stop Loss,$-9.00,$15.00,$84156.50,118,$15.00
2024-06-14,15:37:00,19620.0,SELL,3,0.02h,Stop Loss,$36.00,$51.00,$84192.50,118,$51.00
2024-06-14,15:40:00,19871.0,BUY,3,0.02h,Stop Loss,$-9.00,$42.00,$84183.50,118,$42.00
2024-06-14,15:41:00,19602.25,SELL,3,0.02h,Stop Loss,$-9.00,$33.00,$84174.50,118,$33.00
2024-06-14,15:42:00,19860.0,BUY,3,0.02h,Stop Loss,$-9.00,$24.00,$84165.50,118,$24.00
2024-06-14,15:43:00,19601.0,SELL,3,0.02h,Stop Loss,$52.50,$76.50,$84218.00,118,$76.50
2024-06-14,15:48:00,19836.75,BUY,3,0.02h,Break Even,$-1.50,$75.00,$84216.50,118,$75.00
2024-06-14,15:56:00,19603.25,SELL,3,0.02h,Stop Loss,$-9.00,$66.00,$84207.50,118,$66.00
2024-06-14,15:57:00,19868.0,BUY,3,0.02h,Stop Loss,$-9.00,$57.00,$84198.50,118,$57.00
2024-06-14,15:58:00,19602.25,SELL,3,0.02h,Stop Loss,$-9.00,$48.00,$84189.50,118,$48.00
2024-06-14,16:00:00,19877.25,BUY,3,0.02h,Stop Loss,$-9.00,$39.00,$84180.50,118,$39.00
2024-06-14,16:03:00,19617.25,SELL,3,0.02h,Break Even,$-1.50,$37.50,$84179.00,118,$37.50
2024-06-14,16:06:00,19877.5,BUY,3,0.02h,Break Even,$-1.50,$36.00,$84177.50,118,$36.00
2024-06-14,16:28:00,19620.25,SELL,3,0.02h,Stop Loss,$25.50,$61.50,$84203.00,118,$61.50
2024-06-14,16:36:00,19875.75,BUY,3,0.02h,Break Even,$-1.50,$60.00,$84201.50,118,$60.00
2024-06-14,16:39:00,19627.0,SELL,3,0.02h,Stop Loss,$-9.00,$51.00,$84192.50,118,$51.00
2024-06-14,16:40:00,19893.0,BUY,3,0.02h,Stop Loss,$-9.00,$42.00,$84183.50,118,$42.00
2024-06-14,16:42:00,19623.75,SELL,3,0.02h,Stop Loss,$10.50,$52.50,$84194.00,118,$52.50
2024-06-14,16:46:00,19889.0,BUY,3,0.02h,Stop Loss,$-9.00,$43.50,$84185.00,118,$43.50
2024-06-14,16:47:00,19626.0,SELL,3,0.02h,Stop Loss,$-9.00,$34.50,$84176.00,118,$34.50
2024-06-14,16:48:00,19887.25,BUY,3,0.02h,Stop Loss,$-9.00,$25.50,$84167.00,118,$25.50
2024-06-14,16:50:00,19626.25,SELL,3,0.02h,Stop Loss,$-9.00,$16.50,$84158.00,118,$16.50
2024-06-14,16:51:00,19890.75,BUY,3,0.02h,Stop Loss,$-9.00,$7.50,$84149.00,118,$7.50
2024-06-14,16:52:00,19635.0,SELL,3,0.02h,Break Even,$-1.50,$6.00,$84147.50,118,$6.00
2024-06-14,16:55:00,19883.0,BUY,3,0.02h,Stop Loss,$-9.00,$-3.00,$84138.50,118,$-3.00
2024-06-14,16:56:00,19623.75,SELL,3,0.02h,Stop Loss,$-9.00,$-12.00,$84129.50,118,$-12.00
2024-06-14,16:59:00,19888.25,BUY,3,0.02h,Stop Loss,$4.50,$-7.50,$84134.00,118,$-7.50
2024-06-14,17:14:00,19652.5,SELL,3,0.02h,Stop Loss,$-9.00,$-16.50,$84125.00,118,$-16.50
2024-06-14,17:15:00,19911.5,BUY,3,0.02h,Stop Loss,$54.00,$37.50,$84179.00,118,$37.50
2024-06-14,17:19:00,19647.5,SELL,3,0.02h,Stop Loss,$-9.00,$28.50,$84170.00,118,$28.50
2024-06-14,17:27:00,19916.5,BUY,3,0.02h,Stop Loss,$-9.00,$19.50,$84161.00,118,$19.50
2024-06-14,17:28:00,19662.0,SELL,3,0.02h,Stop Loss,$-9.00,$10.50,$84152.00,118,$10.50
2024-06-14,17:32:00,19923.25,BUY,3,0.02h,Stop Loss,$24.00,$34.50,$84176.00,118,$34.50
2024-06-14,17:34:00,19666.75,SELL,3,0.02h,Stop Loss,$-9.00,$25.50,$84167.00,118,$25.50
2024-06-14,17:35:00,19929.75,BUY,3,0.02h,Stop Loss,$-9.00,$16.50,$84158.00,118,$16.50
2024-06-14,17:38:00,19669.75,SELL,3,0.02h,Stop Loss,$-9.00,$7.50,$84149.00,118,$7.50
2024-06-14,17:46:00,19928.5,BUY,3,0.02h,Stop Loss,$-9.00,$-1.50,$84140.00,118,$-1.50
2024-06-14,17:47:00,19666.75,SELL,3,0.02h,Stop Loss,$7.50,$6.00,$84147.50,118,$6.00
2024-06-14,17:56:00,19924.25,BUY,3,0.02h,Stop Loss,$-9.00,$-3.00,$84138.50,118,$-3.00
2024-06-14,18:06:00,19662.5,SELL,3,0.02h,Break Even,$-1.50,$-4.50,$84137.00,118,$-4.50
2024-06-14,18:12:00,19906.0,BUY,3,0.02h,Stop Loss,$16.50,$12.00,$84153.50,118,$12.00
2024-06-14,18:15:00,19644.25,SELL,3,0.02h,Stop Loss,$-9.00,$3.00,$84144.50,118,$3.00
2024-06-14,18:16:00,19901.25,BUY,3,0.02h,Stop Loss,$-9.00,$-6.00,$84135.50,118,$-6.00
2024-06-14,18:29:00,19660.0,SELL,3,0.02h,Stop Loss,$-9.00,$-15.00,$84126.50,118,$-15.00
2024-06-14,18:30:00,19917.0,BUY,3,0.02h,Stop Loss,$-9.00,$-24.00,$84117.50,118,$-24.00
2024-06-14,18:31:00,19652.5,SELL,3,0.02h,Break Even,$-1.50,$-25.50,$84116.00,118,$-25.50
2024-06-14,18:43:00,19900.0,BUY,3,0.02h,Stop Loss,$-9.00,$-34.50,$84107.00,118,$-34.50
2024-06-14,18:44:00,19642.75,SELL,3,0.02h,Break Even,$-1.50,$-36.00,$84105.50,118,$-36.00
2024-06-14,18:47:00,19909.25,BUY,3,0.02h,Stop Loss,$-9.00,$-45.00,$84096.50,118,$-45.00
2024-06-14,18:48:00,19650.75,SELL,3,0.02h,Stop Loss,$9.00,$-36.00,$84105.50,118,$-36.00
2024-06-14,18:51:00,19917.5,BUY,3,0.02h,Stop Loss,$15.00,$-21.00,$84120.50,118,$-21.00
2024-06-14,18:54:00,19667.0,SELL,3,0.02h,Stop Loss,$-9.00,$-30.00,$84111.50,118,$-30.00
2024-06-14,18:58:00,19923.25,BUY,3,0.02h,Stop Loss,$-9.00,$-39.00,$84102.50,118,$-39.00
2024-06-14,18:59:00,19668.5,SELL,3,0.02h,Break Even,$-1.50,$-40.50,$84101.00,118,$-40.50
2024-06-14,19:05:00,19933.0,BUY,3,0.02h,Stop Loss,$-9.00,$-49.50,$84092.00,118,$-49.50
2024-06-14,19:20:00,19669.5,SELL,3,0.02h,Stop Loss,$-9.00,$-58.50,$84083.00,118,$-58.50
2024-06-14,19:21:00,19926.75,BUY,3,0.02h,Break Even,$-1.50,$-60.00,$84081.50,118,$-60.00
2024-06-14,19:27:00,19668.5,SELL,3,0.02h,Stop Loss,$-9.00,$-69.00,$84072.50,118,$-69.00
2024-06-14,19:28:00,19930.0,BUY,3,0.02h,Stop Loss,$-9.00,$-78.00,$84063.50,118,$-78.00
2024-06-14,19:29:00,19668.25,SELL,3,0.02h,Stop Loss,$-9.00,$-87.00,$84054.50,118,$-87.00
2024-06-14,19:35:00,19927.0,BUY,3,0.02h,Stop Loss,$15.00,$-72.00,$84069.50,118,$-72.00
2024-06-14,19:37:00,19671.5,SELL,3,0.02h,Stop Loss,$-9.00,$-81.00,$84060.50,118,$-81.00
2024-06-14,19:38:00,19931.0,BUY,3,0.02h,Stop Loss,$-9.00,$-90.00,$84051.50,118,$-90.00
2024-06-14,19:40:00,19664.25,SELL,3,0.02h,Stop Loss,$-9.00,$-99.00,$84042.50,118,$-99.00
2024-06-14,19:41:00,19925.0,BUY,3,0.02h,Stop Loss,$-9.00,$-108.00,$84033.50,118,$-108.00
2024-06-14,19:46:00,19649.0,SELL,3,0.02h,Break Even,$-1.50,$-109.50,$84032.00,118,$-109.50
2024-06-14,19:49:00,19916.5,BUY,3,0.02h,Stop Loss,$-9.00,$-118.50,$84023.00,118,$-118.50
2024-06-14,19:52:00,19654.5,SELL,3,0.02h,Break Even,$-1.50,$-120.00,$84021.50,118,$-120.00
2024-06-14,19:55:00,19914.5,BUY,3,0.02h,Stop Loss,$21.00,$-99.00,$84042.50,118,$-99.00
2024-06-14,19:58:00,19668.25,SELL,3,0.02h,Stop Loss,$-9.00,$-108.00,$84033.50,118,$-108.00
2024-06-14,20:03:00,19945.75,BUY,3,0.02h,Stop Loss,$-9.00,$-117.00,$84024.50,118,$-117.00
2024-06-14,20:04:00,19686.0,SELL,3,0.02h,Stop Loss,$-9.00,$-126.00,$84015.50,118,$-126.00
2024-06-14,20:05:00,19946.0,BUY,3,0.02h,Stop Loss,$-9.00,$-135.00,$84006.50,118,$-135.00
2024-06-14,20:06:00,19688.5,SELL,3,0.02h,Break Even,$-1.50,$-136.50,$84005.00,118,$-136.50
2024-06-14,20:12:00,19944.5,BUY,3,0.02h,Stop Loss,$-9.00,$-145.50,$83996.00,118,$-145.50
2024-06-14,20:13:00,19686.75,SELL,3,0.02h,Stop Loss,$-9.00,$-154.50,$83987.00,118,$-154.50
2024-06-14,20:14:00,19948.75,BUY,3,0.02h,Stop Loss,$-9.00,$-163.50,$83978.00,118,$-163.50
2024-06-14,20:24:00,19689.75,SELL,3,0.02h,Stop Loss,$-9.00,$-172.50,$83969.00,118,$-172.50
2024-06-14,20:25:00,19953.0,BUY,3,0.02h,Stop Loss,$-9.00,$-181.50,$83960.00,118,$-181.50
2024-06-14,20:26:00,19696.25,SELL,3,0.02h,Stop Loss,$-9.00,$-190.50,$83951.00,118,$-190.50
2024-06-14,20:27:00,19958.25,BUY,3,0.02h,Stop Loss,$-9.00,$-199.50,$83942.00,118,$-199.50
2024-06-14,20:34:00,19694.25,SELL,3,0.02h,Stop Loss,$-9.00,$-208.50,$83933.00,118,$-208.50
2024-06-14,20:35:00,19953.25,BUY,3,0.02h,Stop Loss,$-9.00,$-217.50,$83924.00,118,$-217.50
2024-06-14,20:36:00,19694.5,SELL,3,0.02h,Stop Loss,$-9.00,$-226.50,$83915.00,118,$-226.50
2024-06-14,20:38:00,19954.0,BUY,3,0.02h,Stop Loss,$-9.00,$-235.50,$83906.00,118,$-235.50
2024-06-14,20:40:00,19693.0,SELL,3,0.02h,Stop Loss,$-9.00,$-244.50,$83897.00,118,$-244.50
2024-06-14,20:45:00,19953.5,BUY,3,0.02h,Stop Loss,$-9.00,$-253.50,$83888.00,118,$-253.50
2024-06-14,20:53:00,19686.5,SELL,3,0.02h,Stop Loss,$-9.00,$-262.50,$83879.00,118,$-262.50
,,,,,,,,,,,
2024-06-17,12:01:00,19981.5,BUY,3,0.02h,Stop Loss,$-9.00,$-9.00,$83870.00,119,$-9.00
2024-06-17,12:36:00,19959.5,SELL,3,0.02h,Stop Loss,$4.50,$-4.50,$83874.50,119,$-4.50
2024-06-17,13:29:00,19954.0,BUY,3,0.02h,Stop Loss,$12.00,$7.50,$83886.50,119,$7.50
2024-06-17,13:35:00,19940.25,SELL,3,0.02h,Stop Loss,$51.00,$58.50,$83937.50,119,$58.50
2024-06-17,13:42:00,19953.0,BUY,3,0.02h,Break Even,$-1.50,$57.00,$83936.00,119,$57.00
2024-06-17,13:43:00,19947.75,SELL,3,0.02h,Stop Loss,$40.50,$97.50,$83976.50,119,$97.50
2024-06-17,14:00:00,19954.5,BUY,3,0.02h,Break Even,$-1.50,$96.00,$83975.00,119,$96.00
2024-06-17,14:27:00,19946.5,SELL,3,0.02h,Stop Loss,$30.00,$126.00,$84005.00,119,$126.00
2024-06-17,14:36:00,19968.5,BUY,3,0.02h,Break Even,$-1.50,$124.50,$84003.50,119,$124.50
2024-06-17,14:51:00,19960.5,SELL,3,0.02h,Stop Loss,$19.50,$144.00,$84023.00,119,$144.00
2024-06-17,14:58:00,19973.0,BUY,3,0.02h,Break Even,$-1.50,$142.50,$84021.50,119,$142.50
2024-06-17,15:56:00,20002.25,SELL,3,0.02h,Stop Loss,$-9.00,$133.50,$84012.50,119,$133.50
2024-06-17,15:57:00,20014.0,BUY,3,0.02h,Break Even,$-1.50,$132.00,$84011.00,119,$132.00
2024-06-17,15:58:00,20009.5,SELL,3,0.02h,Stop Loss,$-9.00,$123.00,$84002.00,119,$123.00
2024-06-17,16:00:00,20015.0,BUY,3,0.02h,Stop Loss,$16.50,$139.50,$84018.50,119,$139.50
2024-06-17,18:19:00,20225.75,SELL,3,0.02h,Break Even,$-1.50,$138.00,$84017.00,119,$138.00
2024-06-17,18:30:00,20240.25,BUY,3,0.02h,Stop Loss,$9.00,$147.00,$84026.00,119,$147.00
2024-06-17,18:41:00,20234.25,SELL,3,0.02h,Break Even,$-1.50,$145.50,$84024.50,119,$145.50
2024-06-17,19:12:00,20236.75,BUY,3,0.02h,Break Even,$-1.50,$144.00,$84023.00,119,$144.00
2024-06-17,19:37:00,20239.75,SELL,3,0.02h,Break Even,$-1.50,$142.50,$84021.50,119,$142.50
2024-06-17,20:30:00,20181.75,BUY,3,0.02h,Stop Loss,$-9.00,$133.50,$84012.50,119,$133.50
2024-06-17,20:36:00,20179.75,SELL,3,0.02h,Stop Loss,$-9.00,$124.50,$84003.50,119,$124.50
2024-06-17,20:43:00,20183.25,BUY,3,0.03h,Break Even,$-1.50,$123.00,$84002.00,119,$123.00
2024-06-17,20:50:00,20178.75,SELL,3,0.02h,Stop Loss,$-9.00,$114.00,$83993.00,119,$114.00
2024-06-17,20:56:00,20182.75,BUY,3,0.05h,Break Even,$-1.50,$112.50,$83991.50,119,$112.50
2024-06-17,22:38:00,20206.5,SELL,3,0.02h,Break Even,$-1.50,$111.00,$83990.00,119,$111.00
2024-06-17,22:44:00,20210.25,BUY,3,0.02h,Stop Loss,$-9.00,$102.00,$83981.00,119,$102.00
2024-06-17,22:50:00,20207.25,SELL,3,0.02h,Stop Loss,$-9.00,$93.00,$83972.00,119,$93.00
,,,,,,,,,,,
2024-06-18,12:20:00,20230.0,BUY,3,0.02h,Break Even,$-1.50,$-1.50,$83970.50,120,$-1.50
2024-06-18,12:23:00,19958.25,SELL,3,0.02h,Stop Loss,$-9.00,$-10.50,$83961.50,120,$-10.50
2024-06-18,12:24:00,20233.5,BUY,3,0.02h,Stop Loss,$10.50,$0.00,$83972.00,120,$0.00
2024-06-18,12:34:00,19931.0,SELL,3,0.02h,Stop Loss,$-9.00,$-9.00,$83963.00,120,$-9.00
2024-06-18,12:35:00,20215.75,BUY,3,0.02h,Stop Loss,$15.00,$6.00,$83978.00,120,$6.00
2024-06-18,12:37:00,19936.5,SELL,3,0.02h,Stop Loss,$-9.00,$-3.00,$83969.00,120,$-3.00
2024-06-18,12:38:00,20207.25,BUY,3,0.02h,Stop Loss,$-9.00,$-12.00,$83960.00,120,$-12.00
2024-06-18,12:39:00,19932.0,SELL,3,0.02h,Stop Loss,$-9.00,$-21.00,$83951.00,120,$-21.00
2024-06-18,12:45:00,20198.75,BUY,3,0.02h,Stop Loss,$-9.00,$-30.00,$83942.00,120,$-30.00
2024-06-18,12:46:00,19933.25,SELL,3,0.02h,Stop Loss,$-9.00,$-39.00,$83933.00,120,$-39.00
2024-06-18,12:47:00,20210.25,BUY,3,0.02h,Stop Loss,$-9.00,$-48.00,$83924.00,120,$-48.00
2024-06-18,12:49:00,19934.25,SELL,3,0.02h,Break Even,$-1.50,$-49.50,$83922.50,120,$-49.50
2024-06-18,12:56:00,20210.25,BUY,3,0.02h,Stop Loss,$-9.00,$-58.50,$83913.50,120,$-58.50
2024-06-18,13:00:00,19936.0,SELL,3,0.02h,Stop Loss,$-9.00,$-67.50,$83904.50,120,$-67.50
2024-06-18,13:01:00,20199.25,BUY,3,0.02h,Stop Loss,$-9.00,$-76.50,$83895.50,120,$-76.50
2024-06-18,13:02:00,19922.0,SELL,3,0.02h,Stop Loss,$-9.00,$-85.50,$83886.50,120,$-85.50
2024-06-18,13:03:00,20201.75,BUY,3,0.02h,Stop Loss,$-9.00,$-94.50,$83877.50,120,$-94.50
2024-06-18,13:09:00,19921.0,SELL,3,0.02h,Stop Loss,$-9.00,$-103.50,$83868.50,120,$-103.50
2024-06-18,13:10:00,20195.25,BUY,3,0.02h,Break Even,$-1.50,$-105.00,$83867.00,120,$-105.00
2024-06-18,13:19:00,19933.25,SELL,3,0.02h,Stop Loss,$-9.00,$-114.00,$83858.00,120,$-114.00
2024-06-18,13:20:00,20204.5,BUY,3,0.02h,Break Even,$-1.50,$-115.50,$83856.50,120,$-115.50
2024-06-18,13:23:00,19929.75,SELL,3,0.02h,Stop Loss,$9.00,$-106.50,$83865.50,120,$-106.50
2024-06-18,13:38:00,20211.5,BUY,3,0.02h,Break Even,$-1.50,$-108.00,$83864.00,120,$-108.00
2024-06-18,13:44:00,19909.75,SELL,3,0.02h,Stop Loss,$-9.00,$-117.00,$83855.00,120,$-117.00
2024-06-18,13:45:00,20190.75,BUY,3,0.02h,Stop Loss,$-9.00,$-126.00,$83846.00,120,$-126.00
2024-06-18,13:46:00,19914.0,SELL,3,0.02h,Stop Loss,$48.00,$-78.00,$83894.00,120,$-78.00
2024-06-18,13:56:00,20182.0,BUY,3,0.02h,Stop Loss,$45.00,$-33.00,$83939.00,120,$-33.00
2024-06-18,14:03:00,19903.25,SELL,3,0.02h,Break Even,$-1.50,$-34.50,$83937.50,120,$-34.50
2024-06-18,14:05:00,20189.75,BUY,3,0.02h,Stop Loss,$27.00,$-7.50,$83964.50,120,$-7.50
2024-06-18,14:24:00,19902.5,SELL,3,0.02h,Stop Loss,$-9.00,$-16.50,$83955.50,120,$-16.50
2024-06-18,14:31:00,20181.0,BUY,3,0.02h,Stop Loss,$-9.00,$-25.50,$83946.50,120,$-25.50
2024-06-18,14:32:00,19908.0,SELL,3,0.02h,Stop Loss,$-9.00,$-34.50,$83937.50,120,$-34.50
2024-06-18,14:39:00,20192.0,BUY,3,0.02h,Stop Loss,$-9.00,$-43.50,$83928.50,120,$-43.50
2024-06-18,14:40:00,19917.75,SELL,3,0.02h,Stop Loss,$15.00,$-28.50,$83943.50,120,$-28.50
2024-06-18,14:44:00,20170.75,BUY,3,0.02h,Stop Loss,$-9.00,$-37.50,$83934.50,120,$-37.50
2024-06-18,14:45:00,19892.25,SELL,3,0.02h,Stop Loss,$-9.00,$-46.50,$83925.50,120,$-46.50
2024-06-18,14:46:00,20159.0,BUY,3,0.02h,Stop Loss,$70.50,$24.00,$83996.00,120,$24.00
2024-06-18,14:57:00,19886.5,SELL,3,0.02h,Stop Loss,$-9.00,$15.00,$83987.00,120,$15.00
2024-06-18,14:58:00,20156.75,BUY,3,0.02h,Stop Loss,$16.50,$31.50,$84003.50,120,$31.50
2024-06-18,15:00:00,19886.5,SELL,3,0.02h,Stop Loss,$-9.00,$22.50,$83994.50,120,$22.50
2024-06-18,15:02:00,20176.0,BUY,3,0.02h,Break Even,$-1.50,$21.00,$83993.00,120,$21.00
2024-06-18,15:05:00,19874.0,SELL,3,0.02h,Stop Loss,$28.50,$49.50,$84021.50,120,$49.50
2024-06-18,15:15:00,20135.5,BUY,3,0.02h,Stop Loss,$36.00,$85.50,$84057.50,120,$85.50
2024-06-18,15:17:00,19865.75,SELL,3,0.02h,Stop Loss,$-9.00,$76.50,$84048.50,120,$76.50
2024-06-18,15:22:00,20155.75,BUY,3,0.02h,Stop Loss,$-9.00,$67.50,$84039.50,120,$67.50
2024-06-18,15:23:00,19881.25,SELL,3,0.02h,Stop Loss,$-9.00,$58.50,$84030.50,120,$58.50
2024-06-18,15:29:00,20154.75,BUY,3,0.02h,Break Even,$-1.50,$57.00,$84029.00,120,$57.00
2024-06-18,15:34:00,19877.5,SELL,3,0.02h,Break Even,$-1.50,$55.50,$84027.50,120,$55.50
2024-06-18,15:37:00,20161.25,BUY,3,0.02h,Stop Loss,$12.00,$67.50,$84039.50,120,$67.50
2024-06-18,15:44:00,19895.75,SELL,3,0.02h,Break Even,$-1.50,$66.00,$84038.00,120,$66.00
2024-06-18,15:49:00,20175.75,BUY,3,0.02h,Stop Loss,$-9.00,$57.00,$84029.00,120,$57.00
2024-06-18,15:50:00,19903.0,SELL,3,0.02h,Stop Loss,$9.00,$66.00,$84038.00,120,$66.00
2024-06-18,15:55:00,20173.25,BUY,3,0.02h,Stop Loss,$-9.00,$57.00,$84029.00,120,$57.00
2024-06-18,16:00:00,19911.25,SELL,3,0.02h,Stop Loss,$-9.00,$48.00,$84020.00,120,$48.00
2024-06-18,16:01:00,20189.25,BUY,3,0.02h,Stop Loss,$-9.00,$39.00,$84011.00,120,$39.00
2024-06-18,16:02:00,19912.5,SELL,3,0.02h,Stop Loss,$-9.00,$30.00,$84002.00,120,$30.00
2024-06-18,16:19:00,20174.0,BUY,3,0.02h,Break Even,$-1.50,$28.50,$84000.50,120,$28.50
2024-06-18,16:34:00,19899.5,SELL,3,0.02h,Stop Loss,$-9.00,$19.50,$83991.50,120,$19.50
2024-06-18,16:35:00,20177.25,BUY,3,0.02h,Stop Loss,$-9.00,$10.50,$83982.50,120,$10.50
2024-06-18,16:36:00,19905.25,SELL,3,0.02h,Stop Loss,$7.50,$18.00,$83990.00,120,$18.00
2024-06-18,16:40:00,20178.5,BUY,3,0.02h,Break Even,$-1.50,$16.50,$83988.50,120,$16.50
2024-06-18,16:42:00,19903.5,SELL,3,0.02h,Break Even,$-1.50,$15.00,$83987.00,120,$15.00
2024-06-18,16:51:00,20180.5,BUY,3,0.02h,Stop Loss,$13.50,$28.50,$84000.50,120,$28.50
2024-06-18,17:09:00,19925.5,SELL,3,0.02h,Stop Loss,$-9.00,$19.50,$83991.50,120,$19.50
2024-06-18,17:10:00,20205.25,BUY,3,0.02h,Stop Loss,$-9.00,$10.50,$83982.50,120,$10.50
2024-06-18,17:11:00,19925.25,SELL,3,0.02h,Break Even,$-1.50,$9.00,$83981.00,120,$9.00
2024-06-18,17:18:00,20200.0,BUY,3,0.02h,Stop Loss,$-9.00,$0.00,$83972.00,120,$0.00
2024-06-18,17:19:00,19927.0,SELL,3,0.02h,Stop Loss,$-9.00,$-9.00,$83963.00,120,$-9.00
2024-06-18,17:20:00,20203.25,BUY,3,0.02h,Break Even,$-1.50,$-10.50,$83961.50,120,$-10.50
2024-06-18,17:22:00,19933.0,SELL,3,0.02h,Break Even,$-1.50,$-12.00,$83960.00,120,$-12.00
2024-06-18,17:31:00,20206.0,BUY,3,0.02h,Break Even,$-1.50,$-13.50,$83958.50,120,$-13.50
2024-06-18,17:40:00,19933.0,SELL,3,0.02h,Stop Loss,$-9.00,$-22.50,$83949.50,120,$-22.50
2024-06-18,17:41:00,20213.75,BUY,3,0.02h,Break Even,$-1.50,$-24.00,$83948.00,120,$-24.00
2024-06-18,17:49:00,19948.25,SELL,3,0.02h,Stop Loss,$-9.00,$-33.00,$83939.00,120,$-33.00
2024-06-18,17:58:00,20209.75,BUY,3,0.02h,Break Even,$-1.50,$-34.50,$83937.50,120,$-34.50
2024-06-18,18:04:00,19894.5,SELL,3,0.02h,Stop Loss,$7.50,$-27.00,$83945.00,120,$-27.00
2024-06-18,18:25:00,20180.25,BUY,3,0.02h,Break Even,$-1.50,$-28.50,$83943.50,120,$-28.50
2024-06-18,18:32:00,19910.5,SELL,3,0.02h,Stop Loss,$-9.00,$-37.50,$83934.50,120,$-37.50
2024-06-18,18:43:00,20187.25,BUY,3,0.02h,Stop Loss,$-9.00,$-46.50,$83925.50,120,$-46.50
2024-06-18,18:50:00,19905.0,SELL,3,0.02h,Stop Loss,$-9.00,$-55.50,$83916.50,120,$-55.50
2024-06-18,18:51:00,20189.25,BUY,3,0.02h,Break Even,$-1.50,$-57.00,$83915.00,120,$-57.00
2024-06-18,18:57:00,19913.25,SELL,3,0.02h,Stop Loss,$-9.00,$-66.00,$83906.00,120,$-66.00
2024-06-18,18:58:00,20193.5,BUY,3,0.02h,Stop Loss,$18.00,$-48.00,$83924.00,120,$-48.00
2024-06-18,19:02:00,19917.75,SELL,3,0.02h,Stop Loss,$30.00,$-18.00,$83954.00,120,$-18.00
2024-06-18,19:05:00,20184.25,BUY,3,0.02h,Stop Loss,$-9.00,$-27.00,$83945.00,120,$-27.00
2024-06-18,19:06:00,19916.25,SELL,3,0.02h,Stop Loss,$22.50,$-4.50,$83967.50,120,$-4.50
2024-06-18,19:09:00,20186.25,BUY,3,0.02h,Stop Loss,$-9.00,$-13.50,$83958.50,120,$-13.50
2024-06-18,19:10:00,19909.25,SELL,3,0.02h,Stop Loss,$-9.00,$-22.50,$83949.50,120,$-22.50
2024-06-18,19:11:00,20183.5,BUY,3,0.02h,Break Even,$-1.50,$-24.00,$83948.00,120,$-24.00
2024-06-18,19:17:00,19921.25,SELL,3,0.02h,Stop Loss,$6.00,$-18.00,$83954.00,120,$-18.00
2024-06-18,19:21:00,20194.5,BUY,3,0.02h,Break Even,$-1.50,$-19.50,$83952.50,120,$-19.50
2024-06-18,19:23:00,19921.5,SELL,3,0.02h,Stop Loss,$-9.00,$-28.50,$83943.50,120,$-28.50
2024-06-18,19:24:00,20196.5,BUY,3,0.02h,Break Even,$-1.50,$-30.00,$83942.00,120,$-30.00
2024-06-18,19:26:00,19923.5,SELL,3,0.02h,Break Even,$-1.50,$-31.50,$83940.50,120,$-31.50
2024-06-18,19:28:00,20199.25,BUY,3,0.02h,Stop Loss,$-9.00,$-40.50,$83931.50,120,$-40.50
2024-06-18,19:29:00,19920.75,SELL,3,0.02h,Stop Loss,$25.50,$-15.00,$83957.00,120,$-15.00
2024-06-18,19:48:00,20182.5,BUY,3,0.02h,Stop Loss,$3.00,$-12.00,$83960.00,120,$-12.00
2024-06-18,19:56:00,19925.25,SELL,3,0.02h,Break Even,$-1.50,$-13.50,$83958.50,120,$-13.50
2024-06-18,19:59:00,20204.0,BUY,3,0.02h,Stop Loss,$-9.00,$-22.50,$83949.50,120,$-22.50
2024-06-18,20:00:00,19923.25,SELL,3,0.02h,Stop Loss,$25.50,$3.00,$83975.00,120,$3.00
2024-06-18,20:08:00,20201.0,BUY,3,0.02h,Stop Loss,$-9.00,$-6.00,$83966.00,120,$-6.00
2024-06-18,20:09:00,19923.25,SELL,3,0.02h,Stop Loss,$-9.00,$-15.00,$83957.00,120,$-15.00
2024-06-18,20:12:00,20205.0,BUY,3,0.02h,Break Even,$-1.50,$-16.50,$83955.50,120,$-16.50
2024-06-18,20:19:00,19928.75,SELL,3,0.02h,Stop Loss,$-9.00,$-25.50,$83946.50,120,$-25.50
2024-06-18,20:20:00,20205.5,BUY,3,0.02h,Stop Loss,$-9.00,$-34.50,$83937.50,120,$-34.50
2024-06-18,20:22:00,19930.25,SELL,3,0.02h,Stop Loss,$-9.00,$-43.50,$83928.50,120,$-43.50
2024-06-18,20:23:00,20204.5,BUY,3,0.03h,Stop Loss,$-9.00,$-52.50,$83919.50,120,$-52.50
2024-06-18,20:26:00,19929.25,SELL,3,0.02h,Stop Loss,$-9.00,$-61.50,$83910.50,120,$-61.50
2024-06-18,20:27:00,20206.75,BUY,3,0.02h,Stop Loss,$-9.00,$-70.50,$83901.50,120,$-70.50
2024-06-18,20:32:00,19931.0,SELL,3,0.02h,Break Even,$-1.50,$-72.00,$83900.00,120,$-72.00
2024-06-18,20:34:00,20206.0,BUY,3,0.02h,Stop Loss,$-9.00,$-81.00,$83891.00,120,$-81.00
2024-06-18,20:35:00,19929.5,SELL,3,0.02h,Stop Loss,$-9.00,$-90.00,$83882.00,120,$-90.00
2024-06-18,20:37:00,20205.0,BUY,3,0.02h,Stop Loss,$-9.00,$-99.00,$83873.00,120,$-99.00
2024-06-18,20:38:00,19928.5,SELL,3,0.02h,Stop Loss,$-9.00,$-108.00,$83864.00,120,$-108.00
2024-06-18,20:39:00,20205.5,BUY,3,0.03h,Stop Loss,$-9.00,$-117.00,$83855.00,120,$-117.00
2024-06-18,21:00:00,19933.5,SELL,3,1.02h,Stop Loss,$-9.00,$-126.00,$83846.00,120,$-126.00
2024-06-18,22:01:00,20208.0,BUY,3,0.02h,Break Even,$-1.50,$-127.50,$83844.50,120,$-127.50
2024-06-18,22:03:00,19931.75,SELL,3,0.02h,Stop Loss,$-9.00,$-136.50,$83835.50,120,$-136.50
2024-06-18,22:13:00,20217.75,BUY,3,0.02h,Stop Loss,$-9.00,$-145.50,$83826.50,120,$-145.50
2024-06-18,22:20:00,19941.0,SELL,3,0.02h,Stop Loss,$-9.00,$-154.50,$83817.50,120,$-154.50
2024-06-18,22:21:00,20219.25,BUY,3,0.02h,Break Even,$-1.50,$-156.00,$83816.00,120,$-156.00
2024-06-18,22:25:00,19942.75,SELL,3,0.02h,Stop Loss,$-9.00,$-165.00,$83807.00,120,$-165.00
2024-06-18,22:26:00,20219.25,BUY,3,0.02h,Stop Loss,$-9.00,$-174.00,$83798.00,120,$-174.00
2024-06-18,22:27:00,19942.75,SELL,3,0.07h,Break Even,$-1.50,$-175.50,$83796.50,120,$-175.50
2024-06-18,22:47:00,20229.0,BUY,3,0.02h,Stop Loss,$-9.00,$-184.50,$83787.50,120,$-184.50
2024-06-18,22:48:00,19953.5,SELL,3,0.02h,Break Even,$-1.50,$-186.00,$83786.00,120,$-186.00
2024-06-18,22:51:00,20229.25,BUY,3,0.02h,Stop Loss,$-9.00,$-195.00,$83777.00,120,$-195.00
2024-06-18,22:52:00,19951.75,SELL,3,0.02h,Stop Loss,$-9.00,$-204.00,$83768.00,120,$-204.00
2024-06-18,22:53:00,20229.75,BUY,3,0.02h,Stop Loss,$-9.00,$-213.00,$83759.00,120,$-213.00
2024-06-18,22:55:00,19952.0,SELL,3,0.03h,Stop Loss,$-9.00,$-222.00,$83750.00,120,$-222.00
2024-06-18,22:57:00,20230.25,BUY,3,0.02h,Stop Loss,$-9.00,$-231.00,$83741.00,120,$-231.00
,,,,,,,,,,,
2024-06-19,12:13:00,19958.5,SELL,3,0.02h,Stop Loss,$-9.00,$-9.00,$83732.00,121,$-9.00
2024-06-19,12:25:00,20232.25,BUY,3,0.02h,Stop Loss,$-9.00,$-18.00,$83723.00,121,$-18.00
2024-06-19,12:26:00,19956.75,SELL,3,0.02h,Stop Loss,$-9.00,$-27.00,$83714.00,121,$-27.00
2024-06-19,12:27:00,20233.0,BUY,3,0.02h,Stop Loss,$-9.00,$-36.00,$83705.00,121,$-36.00
2024-06-19,12:28:00,19958.75,SELL,3,0.02h,Stop Loss,$-9.00,$-45.00,$83696.00,121,$-45.00
2024-06-19,12:29:00,20235.25,BUY,3,0.03h,Stop Loss,$-9.00,$-54.00,$83687.00,121,$-54.00
2024-06-19,12:41:00,19960.75,SELL,3,0.02h,Stop Loss,$-9.00,$-63.00,$83678.00,121,$-63.00
2024-06-19,12:42:00,20238.5,BUY,3,0.02h,Break Even,$-1.50,$-64.50,$83676.50,121,$-64.50
2024-06-19,12:48:00,19965.25,SELL,3,0.02h,Stop Loss,$-9.00,$-73.50,$83667.50,121,$-73.50
2024-06-19,12:50:00,20242.0,BUY,3,0.02h,Stop Loss,$-9.00,$-82.50,$83658.50,121,$-82.50
2024-06-19,12:51:00,19968.75,SELL,3,0.02h,Stop Loss,$-9.00,$-91.50,$83649.50,121,$-91.50
2024-06-19,12:52:00,20244.5,BUY,3,0.02h,Stop Loss,$-9.00,$-100.50,$83640.50,121,$-100.50
2024-06-19,12:54:00,19968.25,SELL,3,0.03h,Stop Loss,$-9.00,$-109.50,$83631.50,121,$-109.50
2024-06-19,13:00:00,20242.0,BUY,3,0.02h,Stop Loss,$-9.00,$-118.50,$83622.50,121,$-118.50
2024-06-19,13:05:00,19971.25,SELL,3,0.02h,Stop Loss,$-9.00,$-127.50,$83613.50,121,$-127.50
2024-06-19,13:06:00,20247.5,BUY,3,0.02h,Break Even,$-1.50,$-129.00,$83612.00,121,$-129.00
2024-06-19,13:09:00,19972.0,SELL,3,0.02h,Stop Loss,$-9.00,$-138.00,$83603.00,121,$-138.00
2024-06-19,13:18:00,20244.75,BUY,3,0.02h,Break Even,$-1.50,$-139.50,$83601.50,121,$-139.50
2024-06-19,13:20:00,19972.25,SELL,3,0.02h,Stop Loss,$-9.00,$-148.50,$83592.50,121,$-148.50
2024-06-19,13:21:00,20245.75,BUY,3,0.02h,Stop Loss,$-9.00,$-157.50,$83583.50,121,$-157.50
2024-06-19,13:22:00,19970.25,SELL,3,0.02h,Break Even,$-1.50,$-159.00,$83582.00,121,$-159.00
2024-06-19,13:24:00,20244.5,BUY,3,0.03h,Stop Loss,$-9.00,$-168.00,$83573.00,121,$-168.00
2024-06-19,13:26:00,19970.0,SELL,3,0.02h,Stop Loss,$-9.00,$-177.00,$83564.00,121,$-177.00
2024-06-19,13:27:00,20243.75,BUY,3,0.02h,Stop Loss,$-9.00,$-186.00,$83555.00,121,$-186.00
2024-06-19,13:28:00,19967.75,SELL,3,0.02h,Break Even,$-1.50,$-187.50,$83553.50,121,$-187.50
2024-06-19,13:30:00,20242.75,BUY,3,0.02h,Stop Loss,$30.00,$-157.50,$83583.50,121,$-157.50
2024-06-19,13:35:00,19971.0,SELL,3,0.02h,Stop Loss,$15.00,$-142.50,$83598.50,121,$-142.50
2024-06-19,13:48:00,20242.25,BUY,3,0.03h,Stop Loss,$-9.00,$-151.50,$83589.50,121,$-151.50
2024-06-19,13:53:00,19965.0,SELL,3,0.02h,Stop Loss,$-9.00,$-160.50,$83580.50,121,$-160.50
2024-06-19,13:54:00,20239.5,BUY,3,0.02h,Stop Loss,$-9.00,$-169.50,$83571.50,121,$-169.50
2024-06-19,13:55:00,19965.0,SELL,3,0.02h,Stop Loss,$-9.00,$-178.50,$83562.50,121,$-178.50
2024-06-19,13:56:00,20239.25,BUY,3,0.03h,Stop Loss,$-9.00,$-187.50,$83553.50,121,$-187.50
2024-06-19,14:08:00,19963.5,SELL,3,0.02h,Stop Loss,$-9.00,$-196.50,$83544.50,121,$-196.50
2024-06-19,14:15:00,20242.0,BUY,3,0.02h,Stop Loss,$-9.00,$-205.50,$83535.50,121,$-205.50
2024-06-19,14:16:00,19964.5,SELL,3,0.05h,Stop Loss,$-9.00,$-214.50,$83526.50,121,$-214.50
2024-06-19,14:23:00,20238.75,BUY,3,0.03h,Stop Loss,$-9.00,$-223.50,$83517.50,121,$-223.50
2024-06-19,14:36:00,19950.0,SELL,3,0.02h,Stop Loss,$-9.00,$-232.50,$83508.50,121,$-232.50
2024-06-19,14:41:00,20232.5,BUY,3,0.02h,Break Even,$-1.50,$-234.00,$83507.00,121,$-234.00
2024-06-19,14:47:00,19962.75,SELL,3,0.02h,Stop Loss,$-9.00,$-243.00,$83498.00,121,$-243.00
2024-06-19,14:48:00,20240.75,BUY,3,0.02h,Stop Loss,$-9.00,$-252.00,$83489.00,121,$-252.00
2024-06-19,14:51:00,19960.75,SELL,3,0.02h,Break Even,$-1.50,$-253.50,$83487.50,121,$-253.50
2024-06-19,14:58:00,20237.25,BUY,3,0.02h,Stop Loss,$-9.00,$-262.50,$83478.50,121,$-262.50
2024-06-19,15:02:00,19963.0,SELL,3,0.02h,Stop Loss,$-9.00,$-271.50,$83469.50,121,$-271.50
2024-06-19,15:03:00,20241.75,BUY,3,0.02h,Stop Loss,$-9.00,$-280.50,$83460.50,121,$-280.50
2024-06-19,15:08:00,19963.0,SELL,3,0.02h,Stop Loss,$-9.00,$-289.50,$83451.50,121,$-289.50
2024-06-19,15:13:00,20241.25,BUY,3,0.02h,Stop Loss,$-9.00,$-298.50,$83442.50,121,$-298.50
2024-06-19,15:23:00,19962.5,SELL,3,0.02h,Stop Loss,$-9.00,$-307.50,$83433.50,121,$-307.50
2024-06-19,15:37:00,20246.5,BUY,3,0.02h,Stop Loss,$-9.00,$-316.50,$83424.50,121,$-316.50
2024-06-19,15:39:00,19969.75,SELL,3,0.02h,Break Even,$-1.50,$-318.00,$83423.00,121,$-318.00
2024-06-19,15:42:00,20245.0,BUY,3,0.02h,Stop Loss,$-9.00,$-327.00,$83414.00,121,$-327.00
2024-06-19,15:53:00,19967.0,SELL,3,0.03h,Stop Loss,$-9.00,$-336.00,$83405.00,121,$-336.00
2024-06-19,15:55:00,20241.75,BUY,3,0.02h,Break Even,$-1.50,$-337.50,$83403.50,121,$-337.50
2024-06-19,16:11:00,19956.75,SELL,3,0.02h,Stop Loss,$-9.00,$-346.50,$83394.50,121,$-346.50
2024-06-19,16:19:00,20236.0,BUY,3,0.02h,Stop Loss,$-9.00,$-355.50,$83385.50,121,$-355.50
2024-06-19,16:27:00,19960.0,SELL,3,0.07h,Break Even,$-1.50,$-357.00,$83384.00,121,$-357.00
2024-06-19,16:36:00,20237.25,BUY,3,0.02h,Stop Loss,$-9.00,$-366.00,$83375.00,121,$-366.00
2024-06-19,16:37:00,19962.5,SELL,3,0.10h,Stop Loss,$-9.00,$-375.00,$83366.00,121,$-375.00
2024-06-19,16:44:00,20238.25,BUY,3,0.02h,Stop Loss,$-9.00,$-384.00,$83357.00,121,$-384.00
2024-06-19,16:45:00,19962.0,SELL,3,0.02h,Stop Loss,$-9.00,$-393.00,$83348.00,121,$-393.00
2024-06-19,16:46:00,20237.0,BUY,3,0.02h,Stop Loss,$-9.00,$-402.00,$83339.00,121,$-402.00
2024-06-19,16:55:00,19957.25,SELL,3,0.02h,Stop Loss,$-9.00,$-411.00,$83330.00,121,$-411.00
2024-06-19,16:56:00,20231.5,BUY,3,0.02h,Stop Loss,$-9.00,$-420.00,$83321.00,121,$-420.00
2024-06-19,16:57:00,19955.5,SELL,3,0.02h,Stop Loss,$-9.00,$-429.00,$83312.00,121,$-429.00
2024-06-19,16:58:00,20231.25,BUY,3,0.02h,Stop Loss,$-9.00,$-438.00,$83303.00,121,$-438.00
2024-06-19,16:59:00,19954.75,SELL,3,0.02h,Stop Loss,$-9.00,$-447.00,$83294.00,121,$-447.00
2024-06-19,17:00:00,20230.75,BUY,3,5.02h,Stop Loss,$-9.00,$-456.00,$83285.00,121,$-456.00
2024-06-19,22:01:00,19961.75,SELL,3,0.03h,Break Even,$-1.50,$-457.50,$83283.50,121,$-457.50
2024-06-19,22:04:00,20237.5,BUY,3,0.02h,Stop Loss,$-9.00,$-466.50,$83274.50,121,$-466.50
2024-06-19,22:12:00,19957.5,SELL,3,0.05h,Stop Loss,$-9.00,$-475.50,$83265.50,121,$-475.50
2024-06-19,22:16:00,20234.0,BUY,3,0.02h,Stop Loss,$-9.00,$-484.50,$83256.50,121,$-484.50
2024-06-19,22:19:00,19958.25,SELL,3,0.02h,Stop Loss,$-9.00,$-493.50,$83247.50,121,$-493.50
2024-06-19,22:20:00,20236.25,BUY,3,0.02h,Stop Loss,$-9.00,$-502.50,$83238.50,121,$-502.50
2024-06-19,22:27:00,19955.5,SELL,3,0.02h,Break Even,$-1.50,$-504.00,$83237.00,121,$-504.00
2024-06-19,22:36:00,20230.5,BUY,3,0.02h,Stop Loss,$-9.00,$-513.00,$83228.00,121,$-513.00
2024-06-19,22:37:00,19955.5,SELL,3,0.02h,Stop Loss,$-9.00,$-522.00,$83219.00,121,$-522.00
2024-06-19,22:38:00,20229.5,BUY,3,0.02h,Stop Loss,$-9.00,$-531.00,$83210.00,121,$-531.00
2024-06-19,22:49:00,19956.0,SELL,3,0.03h,Stop Loss,$-9.00,$-540.00,$83201.00,121,$-540.00
,,,,,,,,,,,
2024-06-20,12:02:00,20297.5,BUY,3,0.02h,Stop Loss,$-9.00,$-9.00,$83192.00,122,$-9.00
2024-06-20,12:03:00,20025.0,SELL,3,0.02h,Stop Loss,$-9.00,$-18.00,$83183.00,122,$-18.00
2024-06-20,12:04:00,20301.75,BUY,3,0.02h,Stop Loss,$-9.00,$-27.00,$83174.00,122,$-27.00
2024-06-20,12:07:00,20025.0,SELL,3,0.02h,Stop Loss,$4.50,$-22.50,$83178.50,122,$-22.50
2024-06-20,12:09:00,20295.25,BUY,3,0.02h,Stop Loss,$-9.00,$-31.50,$83169.50,122,$-31.50
2024-06-20,12:11:00,20007.5,SELL,3,0.02h,Stop Loss,$-9.00,$-40.50,$83160.50,122,$-40.50
2024-06-20,12:14:00,20292.0,BUY,3,0.02h,Stop Loss,$-9.00,$-49.50,$83151.50,122,$-49.50
2024-06-20,12:25:00,20012.0,SELL,3,0.02h,Stop Loss,$-9.00,$-58.50,$83142.50,122,$-58.50
2024-06-20,12:28:00,20296.5,BUY,3,0.02h,Stop Loss,$-9.00,$-67.50,$83133.50,122,$-67.50
2024-06-20,12:29:00,20022.5,SELL,3,0.02h,Break Even,$-1.50,$-69.00,$83132.00,122,$-69.00
2024-06-20,12:34:00,20283.75,BUY,3,0.02h,Stop Loss,$-9.00,$-78.00,$83123.00,122,$-78.00
2024-06-20,12:37:00,20005.25,SELL,3,0.02h,Break Even,$-1.50,$-79.50,$83121.50,122,$-79.50
2024-06-20,12:40:00,20274.0,BUY,3,0.02h,Break Even,$-1.50,$-81.00,$83120.00,122,$-81.00
2024-06-20,12:49:00,19999.0,SELL,3,0.02h,Break Even,$-1.50,$-82.50,$83118.50,122,$-82.50
2024-06-20,12:57:00,20271.25,BUY,3,0.02h,Stop Loss,$-9.00,$-91.50,$83109.50,122,$-91.50
2024-06-20,12:58:00,19991.0,SELL,3,0.02h,Stop Loss,$4.50,$-87.00,$83114.00,122,$-87.00
2024-06-20,13:06:00,20265.5,BUY,3,0.02h,Stop Loss,$-9.00,$-96.00,$83105.00,122,$-96.00
2024-06-20,13:18:00,19974.0,SELL,3,0.02h,Stop Loss,$-9.00,$-105.00,$83096.00,122,$-105.00
2024-06-20,13:31:00,20252.5,BUY,3,0.02h,Stop Loss,$-9.00,$-114.00,$83087.00,122,$-114.00
2024-06-20,13:35:00,19928.75,SELL,3,0.02h,Break Even,$-1.50,$-115.50,$83085.50,122,$-115.50
2024-06-20,13:39:00,20226.75,BUY,3,0.02h,Stop Loss,$22.50,$-93.00,$83108.00,122,$-93.00
2024-06-20,13:51:00,19974.25,SELL,3,0.02h,Stop Loss,$63.00,$-30.00,$83171.00,122,$-30.00
2024-06-20,13:55:00,20237.0,BUY,3,0.02h,Stop Loss,$-9.00,$-39.00,$83162.00,122,$-39.00
2024-06-20,13:56:00,19966.0,SELL,3,0.02h,Stop Loss,$-9.00,$-48.00,$83153.00,122,$-48.00
2024-06-20,14:00:00,20234.25,BUY,3,0.02h,Stop Loss,$18.00,$-30.00,$83171.00,122,$-30.00
2024-06-20,14:02:00,19946.5,SELL,3,0.02h,Stop Loss,$-9.00,$-39.00,$83162.00,122,$-39.00
2024-06-20,14:11:00,20178.75,BUY,3,0.02h,Break Even,$-1.50,$-40.50,$83160.50,122,$-40.50
2024-06-20,14:13:00,19884.75,SELL,3,0.02h,Stop Loss,$7.50,$-33.00,$83168.00,122,$-33.00
2024-06-20,14:24:00,20157.25,BUY,3,0.02h,Break Even,$-1.50,$-34.50,$83166.50,122,$-34.50
2024-06-20,14:29:00,19895.75,SELL,3,0.02h,Break Even,$-1.50,$-36.00,$83165.00,122,$-36.00
2024-06-20,14:36:00,20170.0,BUY,3,0.02h,Stop Loss,$-9.00,$-45.00,$83156.00,122,$-45.00
2024-06-20,14:37:00,19908.0,SELL,3,0.02h,Stop Loss,$-9.00,$-54.00,$83147.00,122,$-54.00
2024-06-20,14:38:00,20189.25,BUY,3,0.02h,Stop Loss,$9.00,$-45.00,$83156.00,122,$-45.00
2024-06-20,14:47:00,19901.0,SELL,3,0.02h,Stop Loss,$-9.00,$-54.00,$83147.00,122,$-54.00
2024-06-20,14:48:00,20172.5,BUY,3,0.02h,Break Even,$-1.50,$-55.50,$83145.50,122,$-55.50
2024-06-20,14:50:00,19903.75,SELL,3,0.02h,Break Even,$-1.50,$-57.00,$83144.00,122,$-57.00
2024-06-20,14:52:00,20190.0,BUY,3,0.02h,Break Even,$-1.50,$-58.50,$83142.50,122,$-58.50
2024-06-20,14:54:00,19916.5,SELL,3,0.02h,Break Even,$-1.50,$-60.00,$83141.00,122,$-60.00
2024-06-20,14:56:00,20191.75,BUY,3,0.02h,Stop Loss,$-9.00,$-69.00,$83132.00,122,$-69.00
2024-06-20,14:57:00,19929.0,SELL,3,0.02h,Stop Loss,$-9.00,$-78.00,$83123.00,122,$-78.00
2024-06-20,14:58:00,20203.5,BUY,3,0.02h,Stop Loss,$24.00,$-54.00,$83147.00,122,$-54.00
2024-06-20,15:03:00,19937.75,SELL,3,0.02h,Break Even,$-1.50,$-55.50,$83145.50,122,$-55.50
2024-06-20,15:11:00,20213.75,BUY,3,0.02h,Stop Loss,$-9.00,$-64.50,$83136.50,122,$-64.50
2024-06-20,15:12:00,19943.25,SELL,3,0.02h,Stop Loss,$-9.00,$-73.50,$83127.50,122,$-73.50
2024-06-20,15:15:00,20214.0,BUY,3,0.02h,Stop Loss,$-9.00,$-82.50,$83118.50,122,$-82.50
2024-06-20,15:16:00,19939.5,SELL,3,0.02h,Break Even,$-1.50,$-84.00,$83117.00,122,$-84.00
2024-06-20,15:18:00,20206.75,BUY,3,0.02h,Stop Loss,$10.50,$-73.50,$83127.50,122,$-73.50
2024-06-20,15:27:00,19917.0,SELL,3,0.02h,Break Even,$-1.50,$-75.00,$83126.00,122,$-75.00
2024-06-20,15:32:00,20198.0,BUY,3,0.02h,Stop Loss,$-9.00,$-84.00,$83117.00,122,$-84.00
2024-06-20,15:33:00,19924.5,SELL,3,0.02h,Stop Loss,$-9.00,$-93.00,$83108.00,122,$-93.00
2024-06-20,15:34:00,20195.5,BUY,3,0.02h,Stop Loss,$-9.00,$-102.00,$83099.00,122,$-102.00
2024-06-20,15:35:00,19929.25,SELL,3,0.02h,Stop Loss,$-9.00,$-111.00,$83090.00,122,$-111.00
2024-06-20,15:36:00,20200.5,BUY,3,0.02h,Stop Loss,$-9.00,$-120.00,$83081.00,122,$-120.00
2024-06-20,15:43:00,19935.75,SELL,3,0.02h,Stop Loss,$-9.00,$-129.00,$83072.00,122,$-129.00
2024-06-20,15:44:00,20204.25,BUY,3,0.02h,Stop Loss,$-9.00,$-138.00,$83063.00,122,$-138.00
2024-06-20,15:45:00,19931.75,SELL,3,0.02h,Stop Loss,$-9.00,$-147.00,$83054.00,122,$-147.00
2024-06-20,15:46:00,20197.75,BUY,3,0.02h,Stop Loss,$-9.00,$-156.00,$83045.00,122,$-156.00
2024-06-20,15:47:00,19917.75,SELL,3,0.02h,Stop Loss,$-9.00,$-165.00,$83036.00,122,$-165.00
2024-06-20,15:48:00,20182.0,BUY,3,0.02h,Stop Loss,$12.00,$-153.00,$83048.00,122,$-153.00
2024-06-20,15:50:00,19887.0,SELL,3,0.02h,Break Even,$-1.50,$-154.50,$83046.50,122,$-154.50
2024-06-20,15:56:00,20179.25,BUY,3,0.02h,Stop Loss,$-9.00,$-163.50,$83037.50,122,$-163.50
2024-06-20,15:59:00,19904.0,SELL,3,0.02h,Stop Loss,$-9.00,$-172.50,$83028.50,122,$-172.50
2024-06-20,16:00:00,20163.25,BUY,3,0.02h,Stop Loss,$-9.00,$-181.50,$83019.50,122,$-181.50
2024-06-20,16:01:00,19889.75,SELL,3,0.02h,Stop Loss,$-9.00,$-190.50,$83010.50,122,$-190.50
2024-06-20,16:02:00,20157.75,BUY,3,0.02h,Stop Loss,$-9.00,$-199.50,$83001.50,122,$-199.50
2024-06-20,16:03:00,19888.25,SELL,3,0.02h,Stop Loss,$-9.00,$-208.50,$82992.50,122,$-208.50
2024-06-20,16:05:00,20159.5,BUY,3,0.02h,Stop Loss,$-9.00,$-217.50,$82983.50,122,$-217.50
2024-06-20,16:06:00,19903.75,SELL,3,0.02h,Break Even,$-1.50,$-219.00,$82982.00,122,$-219.00
2024-06-20,16:09:00,20161.5,BUY,3,0.02h,Stop Loss,$-9.00,$-228.00,$82973.00,122,$-228.00
2024-06-20,16:10:00,19891.25,SELL,3,0.02h,Break Even,$-1.50,$-229.50,$82971.50,122,$-229.50
2024-06-20,16:13:00,20158.5,BUY,3,0.02h,Stop Loss,$-9.00,$-238.50,$82962.50,122,$-238.50
2024-06-20,16:14:00,19892.0,SELL,3,0.02h,Break Even,$-1.50,$-240.00,$82961.00,122,$-240.00
2024-06-20,16:27:00,20098.0,BUY,3,0.02h,Stop Loss,$-9.00,$-249.00,$82952.00,122,$-249.00
2024-06-20,16:29:00,19813.25,SELL,3,0.02h,Stop Loss,$96.00,$-153.00,$83048.00,122,$-153.00
2024-06-20,16:41:00,20048.75,BUY,3,0.02h,Stop Loss,$-9.00,$-162.00,$83039.00,122,$-162.00
2024-06-20,16:42:00,19793.0,SELL,3,0.02h,Stop Loss,$-9.00,$-171.00,$83030.00,122,$-171.00
2024-06-20,16:43:00,20056.75,BUY,3,0.02h,Stop Loss,$7.50,$-163.50,$83037.50,122,$-163.50
2024-06-20,16:47:00,19801.75,SELL,3,0.02h,Stop Loss,$-9.00,$-172.50,$83028.50,122,$-172.50
2024-06-20,16:48:00,20079.0,BUY,3,0.02h,Stop Loss,$-9.00,$-181.50,$83019.50,122,$-181.50
2024-06-20,16:49:00,19803.0,SELL,3,0.02h,Stop Loss,$18.00,$-163.50,$83037.50,122,$-163.50
2024-06-20,16:51:00,20094.0,BUY,3,0.02h,Break Even,$-1.50,$-165.00,$83036.00,122,$-165.00
2024-06-20,17:08:00,19732.0,SELL,3,0.02h,Break Even,$-1.50,$-166.50,$83034.50,122,$-166.50
2024-06-20,17:27:00,20012.5,BUY,3,0.02h,Stop Loss,$25.50,$-141.00,$83060.00,122,$-141.00
2024-06-20,17:29:00,19737.0,SELL,3,0.02h,Stop Loss,$-9.00,$-150.00,$83051.00,122,$-150.00
2024-06-20,17:30:00,20006.5,BUY,3,0.02h,Stop Loss,$115.50,$-34.50,$83166.50,122,$-34.50
2024-06-20,17:34:00,19725.5,SELL,3,0.02h,Stop Loss,$-9.00,$-43.50,$83157.50,122,$-43.50
2024-06-20,17:35:00,19980.0,BUY,3,0.02h,Stop Loss,$28.50,$-15.00,$83186.00,122,$-15.00
2024-06-20,17:37:00,19708.5,SELL,3,0.02h,Stop Loss,$-9.00,$-24.00,$83177.00,122,$-24.00
2024-06-20,17:38:00,19974.0,BUY,3,0.02h,Break Even,$-1.50,$-25.50,$83175.50,122,$-25.50
2024-06-20,17:40:00,19708.5,SELL,3,0.02h,Break Even,$-1.50,$-27.00,$83174.00,122,$-27.00
2024-06-20,17:45:00,20017.0,BUY,3,0.02h,Break Even,$-1.50,$-28.50,$83172.50,122,$-28.50
2024-06-20,18:01:00,19781.5,SELL,3,0.02h,Stop Loss,$-9.00,$-37.50,$83163.50,122,$-37.50
2024-06-20,18:02:00,20051.75,BUY,3,0.02h,Break Even,$-1.50,$-39.00,$83162.00,122,$-39.00
2024-06-20,18:08:00,19811.0,SELL,3,0.02h,Stop Loss,$10.50,$-28.50,$83172.50,122,$-28.50
2024-06-20,18:21:00,20050.5,BUY,3,0.02h,Stop Loss,$54.00,$25.50,$83226.50,122,$25.50
2024-06-20,18:41:00,19782.25,SELL,3,0.02h,Stop Loss,$-9.00,$16.50,$83217.50,122,$16.50
2024-06-20,18:42:00,20043.0,BUY,3,0.02h,Stop Loss,$-9.00,$7.50,$83208.50,122,$7.50
2024-06-20,18:43:00,19773.0,SELL,3,0.02h,Stop Loss,$-9.00,$-1.50,$83199.50,122,$-1.50
2024-06-20,18:48:00,20037.25,BUY,3,0.02h,Stop Loss,$-9.00,$-10.50,$83190.50,122,$-10.50
2024-06-20,18:49:00,19770.0,SELL,3,0.02h,Break Even,$-1.50,$-12.00,$83189.00,122,$-12.00
2024-06-20,18:53:00,20025.0,BUY,3,0.02h,Stop Loss,$28.50,$16.50,$83217.50,122,$16.50
2024-06-20,18:56:00,19762.5,SELL,3,0.02h,Stop Loss,$-9.00,$7.50,$83208.50,122,$7.50
2024-06-20,19:02:00,20016.0,BUY,3,0.02h,Stop Loss,$-9.00,$-1.50,$83199.50,122,$-1.50
2024-06-20,19:03:00,19729.0,SELL,3,0.02h,Stop Loss,$73.50,$72.00,$83273.00,122,$72.00
2024-06-20,19:08:00,20004.5,BUY,3,0.02h,Stop Loss,$-9.00,$63.00,$83264.00,122,$63.00
2024-06-20,19:09:00,19740.5,SELL,3,0.02h,Stop Loss,$6.00,$69.00,$83270.00,122,$69.00
2024-06-20,19:21:00,20002.5,BUY,3,0.02h,Break Even,$-1.50,$67.50,$83268.50,122,$67.50
2024-06-20,19:30:00,19760.75,SELL,3,0.02h,Stop Loss,$6.00,$73.50,$83274.50,122,$73.50
2024-06-20,19:32:00,20028.5,BUY,3,0.02h,Stop Loss,$-9.00,$64.50,$83265.50,122,$64.50
2024-06-20,19:33:00,19760.25,SELL,3,0.02h,Stop Loss,$-9.00,$55.50,$83256.50,122,$55.50
2024-06-20,19:34:00,20036.75,BUY,3,0.02h,Stop Loss,$-9.00,$46.50,$83247.50,122,$46.50
2024-06-20,19:35:00,19786.0,SELL,3,0.02h,Stop Loss,$51.00,$97.50,$83298.50,122,$97.50
2024-06-20,19:37:00,20027.5,BUY,3,0.02h,Stop Loss,$-9.00,$88.50,$83289.50,122,$88.50
2024-06-20,19:38:00,19753.5,SELL,3,0.02h,Stop Loss,$-9.00,$79.50,$83280.50,122,$79.50
2024-06-20,19:39:00,20027.25,BUY,3,0.02h,Stop Loss,$-9.00,$70.50,$83271.50,122,$70.50
2024-06-20,19:52:00,19793.25,SELL,3,0.02h,Stop Loss,$28.50,$99.00,$83300.00,122,$99.00
2024-06-20,19:57:00,20038.75,BUY,3,0.02h,Break Even,$-1.50,$97.50,$83298.50,122,$97.50
2024-06-20,19:59:00,19763.25,SELL,3,0.02h,Stop Loss,$-9.00,$88.50,$83289.50,122,$88.50
2024-06-20,20:00:00,20035.75,BUY,3,0.02h,Stop Loss,$-9.00,$79.50,$83280.50,122,$79.50
2024-06-20,20:01:00,19766.25,SELL,3,0.02h,Stop Loss,$24.00,$103.50,$83304.50,122,$103.50
2024-06-20,20:15:00,20035.5,BUY,3,0.02h,Stop Loss,$-9.00,$94.50,$83295.50,122,$94.50
2024-06-20,20:17:00,19775.25,SELL,3,0.02h,Stop Loss,$6.00,$100.50,$83301.50,122,$100.50
2024-06-20,20:24:00,20046.0,BUY,3,0.02h,Stop Loss,$-9.00,$91.50,$83292.50,122,$91.50
2024-06-20,20:27:00,19772.25,SELL,3,0.02h,Stop Loss,$-9.00,$82.50,$83283.50,122,$82.50
2024-06-20,20:28:00,20042.5,BUY,3,0.02h,Break Even,$-1.50,$81.00,$83282.00,122,$81.00
2024-06-20,20:32:00,19778.25,SELL,3,0.02h,Stop Loss,$-9.00,$72.00,$83273.00,122,$72.00
2024-06-20,20:35:00,20049.75,BUY,3,0.02h,Break Even,$-1.50,$70.50,$83271.50,122,$70.50
2024-06-20,20:47:00,19782.0,SELL,3,0.02h,Break Even,$-1.50,$69.00,$83270.00,122,$69.00
2024-06-20,20:49:00,20050.0,BUY,3,0.02h,Stop Loss,$-9.00,$60.00,$83261.00,122,$60.00
2024-06-20,20:59:00,19783.5,SELL,3,0.02h,Stop Loss,$-9.00,$51.00,$83252.00,122,$51.00
2024-06-20,21:00:00,20053.25,BUY,3,1.02h,Stop Loss,$-9.00,$42.00,$83243.00,122,$42.00
2024-06-20,22:08:00,19787.75,SELL,3,0.05h,Stop Loss,$-9.00,$33.00,$83234.00,122,$33.00
2024-06-20,22:17:00,20060.0,BUY,3,0.02h,Stop Loss,$-9.00,$24.00,$83225.00,122,$24.00
2024-06-20,22:18:00,19791.25,SELL,3,0.02h,Stop Loss,$-9.00,$15.00,$83216.00,122,$15.00
2024-06-20,22:19:00,20058.25,BUY,3,0.02h,Break Even,$-1.50,$13.50,$83214.50,122,$13.50
2024-06-20,22:24:00,19791.5,SELL,3,0.05h,Break Even,$-1.50,$12.00,$83213.00,122,$12.00
2024-06-20,22:32:00,20057.75,BUY,3,0.02h,Stop Loss,$-9.00,$3.00,$83204.00,122,$3.00
2024-06-20,22:35:00,19788.25,SELL,3,0.02h,Stop Loss,$-9.00,$-6.00,$83195.00,122,$-6.00
2024-06-20,22:36:00,20058.0,BUY,3,0.03h,Stop Loss,$-9.00,$-15.00,$83186.00,122,$-15.00
2024-06-20,22:41:00,19788.25,SELL,3,0.03h,Stop Loss,$-9.00,$-24.00,$83177.00,122,$-24.00
2024-06-20,22:43:00,20056.0,BUY,3,0.02h,Stop Loss,$-9.00,$-33.00,$83168.00,122,$-33.00
2024-06-20,22:44:00,19789.25,SELL,3,0.02h,Break Even,$-1.50,$-34.50,$83166.50,122,$-34.50
2024-06-20,22:47:00,20056.0,BUY,3,0.02h,Stop Loss,$-9.00,$-43.50,$83157.50,122,$-43.50
2024-06-20,22:48:00,19788.0,SELL,3,0.07h,Stop Loss,$-9.00,$-52.50,$83148.50,122,$-52.50
2024-06-20,22:53:00,20058.25,BUY,3,0.02h,Break Even,$-1.50,$-54.00,$83147.00,122,$-54.00
,,,,,,,,,,,
2024-06-21,12:04:00,19735.0,SELL,3,0.02h,Stop Loss,$-9.00,$-9.00,$83138.00,123,$-9.00
2024-06-21,12:20:00,19995.75,BUY,3,0.02h,Stop Loss,$-9.00,$-18.00,$83129.00,123,$-18.00
2024-06-21,12:21:00,19727.75,SELL,3,0.02h,Stop Loss,$18.00,$0.00,$83147.00,123,$0.00
2024-06-21,12:24:00,19991.0,BUY,3,0.02h,Stop Loss,$-9.00,$-9.00,$83138.00,123,$-9.00
2024-06-21,12:30:00,19727.75,SELL,3,0.02h,Stop Loss,$10.50,$1.50,$83148.50,123,$1.50
2024-06-21,12:40:00,20021.75,BUY,3,0.02h,Stop Loss,$-9.00,$-7.50,$83139.50,123,$-7.50
2024-06-21,12:41:00,19753.75,SELL,3,0.02h,Stop Loss,$-9.00,$-16.50,$83130.50,123,$-16.50
2024-06-21,12:42:00,20014.25,BUY,3,0.02h,Stop Loss,$58.50,$42.00,$83189.00,123,$42.00
2024-06-21,12:52:00,19764.75,SELL,3,0.02h,Stop Loss,$-9.00,$33.00,$83180.00,123,$33.00
2024-06-21,12:53:00,20029.0,BUY,3,0.02h,Stop Loss,$-9.00,$24.00,$83171.00,123,$24.00
2024-06-21,12:55:00,19760.75,SELL,3,0.02h,Stop Loss,$-9.00,$15.00,$83162.00,123,$15.00
2024-06-21,12:56:00,20032.5,BUY,3,0.02h,Stop Loss,$-9.00,$6.00,$83153.00,123,$6.00
2024-06-21,12:57:00,19766.5,SELL,3,0.02h,Stop Loss,$-9.00,$-3.00,$83144.00,123,$-3.00
2024-06-21,12:58:00,20032.25,BUY,3,0.02h,Break Even,$-1.50,$-4.50,$83142.50,123,$-4.50
2024-06-21,13:03:00,19763.25,SELL,3,0.02h,Stop Loss,$57.00,$52.50,$83199.50,123,$52.50
2024-06-21,13:11:00,20023.75,BUY,3,0.02h,Stop Loss,$-9.00,$43.50,$83190.50,123,$43.50
2024-06-21,13:15:00,19768.25,SELL,3,0.02h,Stop Loss,$19.50,$63.00,$83210.00,123,$63.00
2024-06-21,13:20:00,20038.75,BUY,3,0.02h,Stop Loss,$-9.00,$54.00,$83201.00,123,$54.00
2024-06-21,13:50:00,19957.5,SELL,3,0.02h,Stop Loss,$103.50,$157.50,$83304.50,123,$157.50
2024-06-21,14:05:00,19961.5,BUY,3,0.02h,Stop Loss,$16.50,$174.00,$83321.00,123,$174.00
2024-06-21,14:27:00,19965.75,SELL,3,0.02h,Stop Loss,$16.50,$190.50,$83337.50,123,$190.50
2024-06-21,14:47:00,19977.75,BUY,3,0.02h,Stop Loss,$46.50,$237.00,$83384.00,123,$237.00
2024-06-21,15:29:00,19994.5,SELL,3,0.02h,Stop Loss,$4.50,$241.50,$83388.50,123,$241.50
2024-06-21,15:43:00,20013.0,BUY,3,0.02h,Stop Loss,$6.00,$247.50,$83394.50,123,$247.50
2024-06-21,16:16:00,20043.75,SELL,3,0.02h,Break Even,$-1.50,$246.00,$83393.00,123,$246.00
2024-06-21,16:17:00,20053.75,BUY,3,0.02h,Stop Loss,$15.00,$261.00,$83408.00,123,$261.00
2024-06-21,16:25:00,20042.75,SELL,3,0.02h,Stop Loss,$12.00,$273.00,$83420.00,123,$273.00
2024-06-21,17:52:00,19977.75,BUY,3,0.02h,Stop Loss,$46.50,$319.50,$83466.50,123,$319.50
2024-06-21,18:00:00,19961.25,SELL,3,0.02h,Break Even,$-1.50,$318.00,$83465.00,123,$318.00
2024-06-21,18:12:00,19974.5,BUY,3,0.02h,Stop Loss,$18.00,$336.00,$83483.00,123,$336.00
2024-06-21,18:40:00,19982.25,SELL,3,0.02h,Break Even,$-1.50,$334.50,$83481.50,123,$334.50
2024-06-21,19:03:00,19989.75,BUY,3,0.02h,Stop Loss,$21.00,$355.50,$83502.50,123,$355.50
2024-06-21,19:31:00,19993.5,SELL,3,0.02h,Break Even,$-1.50,$354.00,$83501.00,123,$354.00
2024-06-21,19:35:00,20002.75,BUY,3,0.02h,Stop Loss,$6.00,$360.00,$83507.00,123,$360.00
2024-06-21,19:47:00,19992.0,SELL,3,0.02h,Stop Loss,$7.50,$367.50,$83514.50,123,$367.50
2024-06-21,19:55:00,20001.5,BUY,3,0.02h,Break Even,$-1.50,$366.00,$83513.00,123,$366.00
2024-06-21,19:56:00,19997.0,SELL,3,0.02h,Stop Loss,$33.00,$399.00,$83546.00,123,$399.00
2024-06-21,20:09:00,19998.5,BUY,3,0.02h,Stop Loss,$-9.00,$390.00,$83537.00,123,$390.00
2024-06-21,20:55:00,20006.5,SELL,3,0.05h,Stop Loss,$-9.00,$381.00,$83528.00,123,$381.00
2024-06-21,21:00:00,20009.0,BUY,3,63.00h,Stop Loss,$-9.00,$372.00,$83519.00,123,$372.00
,,,,,,,,,,,
2024-06-24,12:00:00,19954.0,SELL,3,0.02h,Stop Loss,$22.50,$22.50,$83541.50,124,$22.50
2024-06-24,12:25:00,19967.5,BUY,3,0.02h,Break Even,$-1.50,$21.00,$83540.00,124,$21.00
2024-06-24,12:35:00,19953.75,SELL,3,0.02h,Stop Loss,$46.50,$67.50,$83586.50,124,$67.50
2024-06-24,13:25:00,19926.25,BUY,3,0.02h,Stop Loss,$-9.00,$58.50,$83577.50,124,$58.50
2024-06-24,13:42:00,19907.25,SELL,3,0.02h,Stop Loss,$42.00,$100.50,$83619.50,124,$100.50
2024-06-24,13:56:00,19931.75,BUY,3,0.02h,Break Even,$-1.50,$99.00,$83618.00,124,$99.00
2024-06-24,14:22:00,19949.5,SELL,3,0.02h,Stop Loss,$3.00,$102.00,$83621.00,124,$102.00
2024-06-24,15:01:00,19897.75,BUY,3,0.02h,Break Even,$-1.50,$100.50,$83619.50,124,$100.50
2024-06-24,15:27:00,19882.5,SELL,3,0.02h,Stop Loss,$36.00,$136.50,$83655.50,124,$136.50
2024-06-24,15:36:00,19911.25,BUY,3,0.02h,Stop Loss,$-9.00,$127.50,$83646.50,124,$127.50
2024-06-24,15:37:00,19902.0,SELL,3,0.02h,Stop Loss,$-9.00,$118.50,$83637.50,124,$118.50
2024-06-24,15:38:00,19908.0,BUY,3,0.02h,Stop Loss,$51.00,$169.50,$83688.50,124,$169.50
2024-06-24,15:51:00,19900.25,SELL,3,0.02h,Stop Loss,$33.00,$202.50,$83721.50,124,$202.50
2024-06-24,16:00:00,19918.0,BUY,3,0.02h,Break Even,$-1.50,$201.00,$83720.00,124,$201.00
2024-06-24,16:08:00,19899.0,SELL,3,0.02h,Stop Loss,$24.00,$225.00,$83744.00,124,$225.00
2024-06-24,16:21:00,19902.75,BUY,3,0.02h,Stop Loss,$-9.00,$216.00,$83735.00,124,$216.00
2024-06-24,16:23:00,19896.75,SELL,3,0.02h,Break Even,$-1.50,$214.50,$83733.50,124,$214.50
2024-06-24,16:24:00,19903.0,BUY,3,0.02h,Break Even,$-1.50,$213.00,$83732.00,124,$213.00
2024-06-24,16:25:00,19898.0,SELL,3,0.02h,Break Even,$-1.50,$211.50,$83730.50,124,$211.50
2024-06-24,16:31:00,19907.25,BUY,3,0.02h,Break Even,$-1.50,$210.00,$83729.00,124,$210.00
2024-06-24,16:40:00,19896.75,SELL,3,0.02h,Stop Loss,$-9.00,$201.00,$83720.00,124,$201.00
2024-06-24,17:47:00,19821.75,BUY,3,0.02h,Stop Loss,$-9.00,$192.00,$83711.00,124,$192.00
2024-06-24,17:49:00,19815.0,SELL,3,0.02h,Stop Loss,$12.00,$204.00,$83723.00,124,$204.00
2024-06-24,17:57:00,19828.5,BUY,3,0.02h,Stop Loss,$-9.00,$195.00,$83714.00,124,$195.00
2024-06-24,17:59:00,19810.5,SELL,3,0.02h,Break Even,$-1.50,$193.50,$83712.50,124,$193.50
2024-06-24,18:40:00,19800.25,BUY,3,0.02h,Break Even,$-1.50,$192.00,$83711.00,124,$192.00
2024-06-24,19:22:00,19826.25,SELL,3,0.02h,Break Even,$-1.50,$190.50,$83709.50,124,$190.50
2024-06-24,20:44:00,19751.25,BUY,3,0.02h,Stop Loss,$-9.00,$181.50,$83700.50,124,$181.50
2024-06-24,20:53:00,19746.75,SELL,3,0.02h,Stop Loss,$-9.00,$172.50,$83691.50,124,$172.50
2024-06-24,21:00:00,19753.25,BUY,3,1.02h,Stop Loss,$79.50,$252.00,$83771.00,124,$252.00
2024-06-24,22:47:00,19761.75,SELL,3,0.02h,Stop Loss,$-9.00,$243.00,$83762.00,124,$243.00
2024-06-24,22:48:00,19762.25,BUY,3,0.07h,Stop Loss,$-9.00,$234.00,$83753.00,124,$234.00
2024-06-24,22:52:00,19761.25,SELL,3,0.03h,Stop Loss,$-9.00,$225.00,$83744.00,124,$225.00
2024-06-24,22:54:00,19763.25,BUY,3,0.02h,Break Even,$-1.50,$223.50,$83742.50,124,$223.50
2024-06-24,23:00:00,19759.75,SELL,3,13.00h,Stop Loss,$-9.00,$214.50,$83733.50,124,$214.50
,,,,,,,,,,,
2024-06-25,12:00:00,19819.75,BUY,3,0.02h,Stop Loss,$3.00,$3.00,$83736.50,125,$3.00
2024-06-25,12:33:00,19817.25,SELL,3,0.02h,Stop Loss,$-9.00,$-6.00,$83727.50,125,$-6.00
2024-06-25,12:38:00,19829.75,BUY,3,0.02h,Break Even,$-1.50,$-7.50,$83726.00,125,$-7.50
2024-06-25,12:42:00,19820.0,SELL,3,0.02h,Stop Loss,$-9.00,$-16.50,$83717.00,125,$-16.50
2024-06-25,12:57:00,19827.75,BUY,3,0.02h,Stop Loss,$4.50,$-12.00,$83721.50,125,$-12.00
2024-06-25,13:28:00,19832.0,SELL,3,0.02h,Stop Loss,$27.00,$15.00,$83748.50,125,$15.00
2024-06-25,13:46:00,19836.75,BUY,3,0.02h,Stop Loss,$-9.00,$6.00,$83739.50,125,$6.00
2024-06-25,14:46:00,19871.75,SELL,3,0.02h,Stop Loss,$-9.00,$-3.00,$83730.50,125,$-3.00
2024-06-25,15:03:00,19889.75,BUY,3,0.02h,Stop Loss,$10.50,$7.50,$83741.00,125,$7.50
2024-06-25,16:12:00,19943.5,SELL,3,0.02h,Stop Loss,$25.50,$33.00,$83766.50,125,$33.00
2024-06-25,17:15:00,19887.25,BUY,3,0.02h,Stop Loss,$-9.00,$24.00,$83757.50,125,$24.00
2024-06-25,18:49:00,19920.5,SELL,3,0.02h,Break Even,$-1.50,$22.50,$83756.00,125,$22.50
2024-06-25,19:00:00,19950.0,BUY,3,0.02h,Stop Loss,$-9.00,$13.50,$83747.00,125,$13.50
2024-06-25,19:01:00,19939.75,SELL,3,0.02h,Stop Loss,$-9.00,$4.50,$83738.00,125,$4.50
2024-06-25,19:03:00,19945.75,BUY,3,0.02h,Break Even,$-1.50,$3.00,$83736.50,125,$3.00
2024-06-25,19:04:00,19941.25,SELL,3,0.02h,Stop Loss,$-9.00,$-6.00,$83727.50,125,$-6.00
2024-06-25,19:06:00,19947.25,BUY,3,0.02h,Break Even,$-1.50,$-7.50,$83726.00,125,$-7.50
2024-06-25,19:11:00,19938.0,SELL,3,0.02h,Break Even,$-1.50,$-9.00,$83724.50,125,$-9.00
2024-06-25,19:17:00,19950.75,BUY,3,0.02h,Stop Loss,$16.50,$7.50,$83741.00,125,$7.50
2024-06-25,19:46:00,19957.0,SELL,3,0.02h,Stop Loss,$9.00,$16.50,$83750.00,125,$16.50
2024-06-25,19:59:00,19973.0,BUY,3,0.02h,Stop Loss,$16.50,$33.00,$83766.50,125,$33.00
2024-06-25,22:33:00,19976.25,SELL,3,0.02h,Break Even,$-1.50,$31.50,$83765.00,125,$31.50
2024-06-25,22:58:00,19976.5,BUY,3,0.02h,Break Even,$-1.50,$30.00,$83763.50,125,$30.00
,,,,,,,,,,,
2024-06-26,12:15:00,19979.25,SELL,3,0.02h,Stop Loss,$3.00,$3.00,$83766.50,126,$3.00
2024-06-26,13:28:00,19929.25,BUY,3,0.02h,Break Even,$-1.50,$1.50,$83765.00,126,$1.50
2024-06-26,14:29:00,19956.25,SELL,3,0.02h,Stop Loss,$52.50,$54.00,$83817.50,126,$54.00
2024-06-26,14:46:00,19997.0,BUY,3,0.02h,Stop Loss,$40.50,$94.50,$83858.00,126,$94.50
2024-06-26,15:00:00,19974.75,SELL,3,0.02h,Stop Loss,$19.50,$114.00,$83877.50,126,$114.00
2024-06-26,15:23:00,19966.25,BUY,3,0.02h,Stop Loss,$30.00,$144.00,$83907.50,126,$144.00
2024-06-26,15:32:00,19951.0,SELL,3,0.02h,Break Even,$-1.50,$142.50,$83906.00,126,$142.50
2024-06-26,15:39:00,19966.75,BUY,3,0.02h,Break Even,$-1.50,$141.00,$83904.50,126,$141.00
2024-06-26,16:18:00,19998.75,SELL,3,0.02h,Break Even,$-1.50,$139.50,$83903.00,126,$139.50
2024-06-26,16:28:00,20013.25,BUY,3,0.02h,Stop Loss,$24.00,$163.50,$83927.00,126,$163.50
2024-06-26,16:38:00,19997.0,SELL,3,0.02h,Stop Loss,$42.00,$205.50,$83969.00,126,$205.50
2024-06-26,17:13:00,19978.75,BUY,3,0.02h,Stop Loss,$4.50,$210.00,$83973.50,126,$210.00
2024-06-26,17:20:00,19946.5,SELL,3,0.02h,Stop Loss,$46.50,$256.50,$84020.00,126,$256.50
2024-06-26,17:35:00,19969.25,BUY,3,0.02h,Stop Loss,$-9.00,$247.50,$84011.00,126,$247.50
2024-06-26,17:38:00,19958.0,SELL,3,0.02h,Stop Loss,$-9.00,$238.50,$84002.00,126,$238.50
2024-06-26,17:39:00,19966.5,BUY,3,0.02h,Stop Loss,$18.00,$256.50,$84020.00,126,$256.50
2024-06-26,18:05:00,19964.5,SELL,3,0.02h,Stop Loss,$22.50,$279.00,$84042.50,126,$279.00
2024-06-26,18:14:00,19972.0,BUY,3,0.02h,Break Even,$-1.50,$277.50,$84041.00,126,$277.50
2024-06-26,18:23:00,19964.25,SELL,3,0.02h,Stop Loss,$-9.00,$268.50,$84032.00,126,$268.50
2024-06-26,18:25:00,19976.5,BUY,3,0.02h,Break Even,$-1.50,$267.00,$84030.50,126,$267.00
2024-06-26,18:37:00,19963.75,SELL,3,0.02h,Break Even,$-1.50,$265.50,$84029.00,126,$265.50
2024-06-26,18:48:00,19972.75,BUY,3,0.02h,Stop Loss,$13.50,$279.00,$84042.50,126,$279.00
2024-06-26,18:56:00,19960.0,SELL,3,0.02h,Stop Loss,$39.00,$318.00,$84081.50,126,$318.00
2024-06-26,19:24:00,19948.25,BUY,3,0.02h,Break Even,$-1.50,$316.50,$84080.00,126,$316.50
2024-06-26,20:03:00,19926.75,SELL,3,0.02h,Stop Loss,$10.50,$327.00,$84090.50,126,$327.00
2024-06-26,20:44:00,19947.25,BUY,3,0.02h,Stop Loss,$-9.00,$318.00,$84081.50,126,$318.00
2024-06-26,20:51:00,19943.75,SELL,3,0.02h,Stop Loss,$-9.00,$309.00,$84072.50,126,$309.00
2024-06-26,20:55:00,19948.5,BUY,3,0.02h,Break Even,$-1.50,$307.50,$84071.00,126,$307.50
2024-06-26,22:16:00,19948.75,SELL,3,0.02h,Stop Loss,$-9.00,$298.50,$84062.00,126,$298.50
,,,,,,,,,,,
2024-06-27,12:00:00,19974.5,BUY,3,0.02h,Stop Loss,$39.00,$39.00,$84101.00,127,$39.00
2024-06-27,12:30:00,19968.0,SELL,3,0.02h,Stop Loss,$67.50,$106.50,$84168.50,127,$106.50
2024-06-27,12:32:00,19989.0,BUY,3,0.02h,Stop Loss,$24.00,$130.50,$84192.50,127,$130.50
2024-06-27,13:13:00,19992.0,SELL,3,0.02h,Break Even,$-1.50,$129.00,$84191.00,127,$129.00
2024-06-27,13:18:00,20000.0,BUY,3,0.02h,Stop Loss,$-9.00,$120.00,$84182.00,127,$120.00
2024-06-27,13:22:00,19993.5,SELL,3,0.02h,Break Even,$-1.50,$118.50,$84180.50,127,$118.50
2024-06-27,13:31:00,20015.75,BUY,3,0.02h,Stop Loss,$45.00,$163.50,$84225.50,127,$163.50
2024-06-27,13:54:00,20044.0,SELL,3,0.02h,Stop Loss,$-9.00,$154.50,$84216.50,127,$154.50
2024-06-27,14:01:00,20069.75,BUY,3,0.02h,Stop Loss,$39.00,$193.50,$84255.50,127,$193.50
2024-06-27,14:33:00,20062.0,SELL,3,0.02h,Stop Loss,$-9.00,$184.50,$84246.50,127,$184.50
2024-06-27,15:19:00,20032.25,BUY,3,0.02h,Break Even,$-1.50,$183.00,$84245.00,127,$183.00
2024-06-27,15:20:00,20023.25,SELL,3,0.02h,Stop Loss,$28.50,$211.50,$84273.50,127,$211.50
2024-06-27,15:57:00,19988.75,BUY,3,0.02h,Break Even,$-1.50,$210.00,$84272.00,127,$210.00
2024-06-27,17:00:00,20028.75,SELL,3,0.02h,Stop Loss,$-9.00,$201.00,$84263.00,127,$201.00
2024-06-27,17:04:00,20047.0,BUY,3,0.02h,Break Even,$-1.50,$199.50,$84261.50,127,$199.50
2024-06-27,17:14:00,20036.75,SELL,3,0.02h,Break Even,$-1.50,$198.00,$84260.00,127,$198.00
2024-06-27,17:27:00,20042.5,BUY,3,0.02h,Stop Loss,$12.00,$210.00,$84272.00,127,$210.00
2024-06-27,17:55:00,20050.0,SELL,3,0.02h,Stop Loss,$-9.00,$201.00,$84263.00,127,$201.00
2024-06-27,18:49:00,20020.5,BUY,3,0.02h,Stop Loss,$12.00,$213.00,$84275.00,127,$213.00
2024-06-27,19:35:00,20040.5,SELL,3,0.02h,Break Even,$-1.50,$211.50,$84273.50,127,$211.50
2024-06-27,19:42:00,20049.75,BUY,3,0.02h,Stop Loss,$-9.00,$202.50,$84264.50,127,$202.50
2024-06-27,19:43:00,20040.5,SELL,3,0.02h,Break Even,$-1.50,$201.00,$84263.00,127,$201.00
2024-06-27,20:01:00,20059.75,BUY,3,0.02h,Stop Loss,$3.00,$204.00,$84266.00,127,$204.00
2024-06-27,20:42:00,20067.0,SELL,3,0.02h,Break Even,$-1.50,$202.50,$84264.50,127,$202.50
2024-06-27,20:55:00,20069.0,BUY,3,0.02h,Stop Loss,$-9.00,$193.50,$84255.50,127,$193.50
2024-06-27,21:00:00,20067.25,SELL,3,1.02h,Stop Loss,$4.50,$198.00,$84260.00,127,$198.00
2024-06-27,22:11:00,20069.0,BUY,3,0.02h,Stop Loss,$-9.00,$189.00,$84251.00,127,$189.00
2024-06-27,23:00:00,20083.0,SELL,3,13.00h,Stop Loss,$-9.00,$180.00,$84242.00,127,$180.00
,,,,,,,,,,,
2024-06-28,12:00:00,20126.75,BUY,3,0.02h,Break Even,$-1.50,$-1.50,$84240.50,128,$-1.50
2024-06-28,12:39:00,20130.25,SELL,3,0.02h,Stop Loss,$-9.00,$-10.50,$84231.50,128,$-10.50
2024-06-28,13:39:00,20087.5,BUY,3,0.02h,Stop Loss,$15.00,$4.50,$84246.50,128,$4.50
2024-06-28,14:37:00,20210.0,SELL,3,0.02h,Stop Loss,$36.00,$40.50,$84282.50,128,$40.50
2024-06-28,15:35:00,20120.5,BUY,3,0.02h,Stop Loss,$-9.00,$31.50,$84273.50,128,$31.50
2024-06-28,15:44:00,20101.0,SELL,3,0.02h,Stop Loss,$4.50,$36.00,$84278.00,128,$36.00
2024-06-28,15:51:00,20120.75,BUY,3,0.02h,Break Even,$-1.50,$34.50,$84276.50,128,$34.50
2024-06-28,15:59:00,20103.5,SELL,3,0.02h,Stop Loss,$-9.00,$25.50,$84267.50,128,$25.50
2024-06-28,16:02:00,20113.75,BUY,3,0.02h,Break Even,$-1.50,$24.00,$84266.00,128,$24.00
2024-06-28,16:03:00,20105.0,SELL,3,0.02h,Stop Loss,$27.00,$51.00,$84293.00,128,$51.00
2024-06-28,16:30:00,20070.75,BUY,3,0.02h,Stop Loss,$24.00,$75.00,$84317.00,128,$75.00
2024-06-28,16:34:00,20046.5,SELL,3,0.02h,Stop Loss,$66.00,$141.00,$84383.00,128,$141.00
2024-06-28,17:00:00,20036.5,BUY,3,0.02h,Stop Loss,$-9.00,$132.00,$84374.00,128,$132.00
2024-06-28,17:32:00,20046.25,SELL,3,0.02h,Break Even,$-1.50,$130.50,$84372.50,128,$130.50
2024-06-28,18:05:00,20058.25,BUY,3,0.02h,Stop Loss,$-9.00,$121.50,$84363.50,128,$121.50
2024-06-28,18:23:00,20014.0,SELL,3,0.02h,Stop Loss,$33.00,$154.50,$84396.50,128,$154.50
2024-06-28,19:44:00,20013.0,BUY,3,0.02h,Stop Loss,$9.00,$163.50,$84405.50,128,$163.50
2024-06-28,19:56:00,19966.75,SELL,3,0.02h,Stop Loss,$81.00,$244.50,$84486.50,128,$244.50
2024-06-28,20:20:00,19968.75,BUY,3,0.02h,Stop Loss,$-9.00,$235.50,$84477.50,128,$235.50
2024-06-28,20:35:00,19961.5,SELL,3,0.02h,Stop Loss,$-9.00,$226.50,$84468.50,128,$226.50
2024-06-28,20:44:00,19970.75,BUY,3,0.02h,Break Even,$-1.50,$225.00,$84467.00,128,$225.00
,,,,,,,,,,,
2024-07-01,12:34:00,19976.75,SELL,3,0.02h,Stop Loss,$-9.00,$-9.00,$84458.00,129,$-9.00
2024-07-01,12:35:00,19981.75,BUY,3,0.02h,Break Even,$-1.50,$-10.50,$84456.50,129,$-10.50
2024-07-01,12:37:00,19978.0,SELL,3,0.02h,Break Even,$-1.50,$-12.00,$84455.00,129,$-12.00
2024-07-01,12:53:00,19981.0,BUY,3,0.02h,Stop Loss,$10.50,$-1.50,$84465.50,129,$-1.50
2024-07-01,13:08:00,19965.75,SELL,3,0.02h,Break Even,$-1.50,$-3.00,$84464.00,129,$-3.00
2024-07-01,13:32:00,19976.5,BUY,3,0.02h,Break Even,$-1.50,$-4.50,$84462.50,129,$-4.50
2024-07-01,13:33:00,19946.25,SELL,3,0.02h,Stop Loss,$19.50,$15.00,$84482.00,129,$15.00
2024-07-01,14:04:00,19904.0,BUY,3,0.02h,Stop Loss,$66.00,$81.00,$84548.00,129,$81.00
2024-07-01,14:12:00,19853.25,SELL,3,0.02h,Stop Loss,$75.00,$156.00,$84623.00,129,$156.00
2024-07-01,14:22:00,19909.25,BUY,3,0.02h,Stop Loss,$160.50,$316.50,$84783.50,129,$316.50
2024-07-01,14:42:00,19877.0,SELL,3,0.02h,Stop Loss,$-9.00,$307.50,$84774.50,129,$307.50
2024-07-01,15:12:00,19926.5,BUY,3,0.02h,Break Even,$-1.50,$306.00,$84773.00,129,$306.00
2024-07-01,16:59:00,20006.0,SELL,3,0.02h,Break Even,$-1.50,$304.50,$84771.50,129,$304.50
2024-07-01,17:37:00,20008.5,BUY,3,0.02h,Break Even,$-1.50,$303.00,$84770.00,129,$303.00
2024-07-01,17:50:00,19995.75,SELL,3,0.02h,Stop Loss,$3.00,$306.00,$84773.00,129,$306.00
2024-07-01,18:08:00,20004.75,BUY,3,0.02h,Stop Loss,$31.50,$337.50,$84804.50,129,$337.50
2024-07-01,18:29:00,20006.5,SELL,3,0.02h,Break Even,$-1.50,$336.00,$84803.00,129,$336.00
2024-07-01,18:59:00,20017.0,BUY,3,0.02h,Stop Loss,$-9.00,$327.00,$84794.00,129,$327.00
2024-07-01,19:02:00,20008.25,SELL,3,0.02h,Stop Loss,$9.00,$336.00,$84803.00,129,$336.00
2024-07-01,19:06:00,20025.5,BUY,3,0.02h,Stop Loss,$16.50,$352.50,$84819.50,129,$352.50
2024-07-01,19:23:00,20018.5,SELL,3,0.02h,Break Even,$-1.50,$351.00,$84818.00,129,$351.00
2024-07-01,19:36:00,20031.25,BUY,3,0.02h,Break Even,$-1.50,$349.50,$84816.50,129,$349.50
2024-07-01,19:47:00,20012.5,SELL,3,0.02h,Stop Loss,$6.00,$355.50,$84822.50,129,$355.50
2024-07-01,19:51:00,20031.5,BUY,3,0.02h,Stop Loss,$37.50,$393.00,$84860.00,129,$393.00
2024-07-01,20:16:00,20041.0,SELL,3,0.02h,Stop Loss,$4.50,$397.50,$84864.50,129,$397.50
2024-07-01,20:26:00,20048.25,BUY,3,0.02h,Stop Loss,$-9.00,$388.50,$84855.50,129,$388.50
2024-07-01,20:27:00,20045.25,SELL,3,0.02h,Stop Loss,$-9.00,$379.50,$84846.50,129,$379.50
2024-07-01,20:28:00,20046.75,BUY,3,0.05h,Stop Loss,$-9.00,$370.50,$84837.50,129,$370.50
2024-07-01,20:44:00,20046.0,BUY,3,0.02h,Stop Loss,$-9.00,$361.50,$84828.50,129,$361.50
2024-07-01,20:46:00,20042.5,SELL,3,0.02h,Stop Loss,$-9.00,$352.50,$84819.50,129,$352.50
2024-07-01,22:02:00,20047.0,BUY,3,0.02h,Stop Loss,$9.00,$361.50,$84828.50,129,$361.50
2024-07-01,22:19:00,20042.75,SELL,3,0.02h,Stop Loss,$-9.00,$352.50,$84819.50,129,$352.50
,,,,,,,,,,,
2024-07-02,12:34:00,19958.75,BUY,3,0.02h,Break Even,$-1.50,$-1.50,$84818.00,130,$-1.50
2024-07-02,12:35:00,19953.5,SELL,3,0.02h,Stop Loss,$-9.00,$-10.50,$84809.00,130,$-10.50
2024-07-02,13:01:00,19954.0,BUY,3,0.02h,Stop Loss,$31.50,$21.00,$84840.50,130,$21.00
2024-07-02,14:11:00,20027.5,SELL,3,0.02h,Stop Loss,$12.00,$33.00,$84852.50,130,$33.00
2024-07-02,14:30:00,20058.5,BUY,3,0.02h,Stop Loss,$100.50,$133.50,$84953.00,130,$133.50
2024-07-02,15:21:00,20102.75,SELL,3,0.02h,Stop Loss,$88.50,$222.00,$85041.50,130,$222.00
2024-07-02,15:26:00,20124.0,BUY,3,0.02h,Break Even,$-1.50,$220.50,$85040.00,130,$220.50
2024-07-02,15:55:00,20126.5,SELL,3,0.02h,Stop Loss,$22.50,$243.00,$85062.50,130,$243.00
2024-07-02,16:29:00,20102.75,BUY,3,0.02h,Stop Loss,$19.50,$262.50,$85082.00,130,$262.50
2024-07-02,18:35:00,20211.25,SELL,3,0.02h,Stop Loss,$-9.00,$253.50,$85073.00,130,$253.50
2024-07-02,18:36:00,20217.5,BUY,3,0.02h,Stop Loss,$4.50,$258.00,$85077.50,130,$258.00
2024-07-02,18:37:00,20216.75,SELL,3,0.02h,Break Even,$-1.50,$256.50,$85076.00,130,$256.50
2024-07-02,18:38:00,20218.25,BUY,3,0.02h,Stop Loss,$12.00,$268.50,$85088.00,130,$268.50
2024-07-02,19:05:00,20221.25,SELL,3,0.02h,Stop Loss,$-9.00,$259.50,$85079.00,130,$259.50
2024-07-02,19:26:00,20224.75,BUY,3,0.02h,Stop Loss,$-9.00,$250.50,$85070.00,130,$250.50
2024-07-02,19:42:00,20218.25,SELL,3,0.02h,Break Even,$-1.50,$249.00,$85068.50,130,$249.00
2024-07-02,19:54:00,20231.5,BUY,3,0.02h,Stop Loss,$21.00,$270.00,$85089.50,130,$270.00
2024-07-02,20:38:00,20242.5,SELL,3,0.02h,Stop Loss,$7.50,$277.50,$85097.00,130,$277.50
2024-07-02,21:00:00,20240.25,BUY,3,1.02h,Break Even,$-1.50,$276.00,$85095.50,130,$276.00
2024-07-02,22:02:00,20234.5,SELL,3,0.02h,Break Even,$-1.50,$274.50,$85094.00,130,$274.50
2024-07-02,22:11:00,20238.5,BUY,3,0.03h,Stop Loss,$-9.00,$265.50,$85085.00,130,$265.50
2024-07-02,22:14:00,20235.5,SELL,3,0.02h,Stop Loss,$-9.00,$256.50,$85076.00,130,$256.50
2024-07-02,22:22:00,20239.5,BUY,3,0.02h,Break Even,$-1.50,$255.00,$85074.50,130,$255.00
,,,,,,,,,,,
2024-07-03,12:10:00,20242.0,SELL,3,0.02h,Break Even,$-1.50,$-1.50,$85073.00,131,$-1.50
2024-07-03,13:01:00,20221.75,BUY,3,0.02h,Break Even,$-1.50,$-3.00,$85071.50,131,$-3.00
2024-07-03,13:06:00,20211.5,SELL,3,0.02h,Stop Loss,$-9.00,$-12.00,$85062.50,131,$-12.00
2024-07-03,13:09:00,20221.5,BUY,3,0.02h,Stop Loss,$-9.00,$-21.00,$85053.50,131,$-21.00
2024-07-03,13:24:00,20212.5,SELL,3,0.02h,Break Even,$-1.50,$-22.50,$85052.00,131,$-22.50
2024-07-03,13:31:00,20242.5,BUY,3,0.02h,Stop Loss,$67.50,$45.00,$85119.50,131,$45.00
2024-07-03,14:26:00,20257.5,SELL,3,0.02h,Stop Loss,$60.00,$105.00,$85179.50,131,$105.00
2024-07-03,14:39:00,20281.0,BUY,3,0.02h,Stop Loss,$-9.00,$96.00,$85170.50,131,$96.00
2024-07-03,15:36:00,20334.5,SELL,3,0.02h,Break Even,$-1.50,$94.50,$85169.00,131,$94.50
2024-07-03,15:44:00,20343.75,BUY,3,0.02h,Stop Loss,$21.00,$115.50,$85190.00,131,$115.50
2024-07-03,16:41:00,20396.5,SELL,3,0.02h,Stop Loss,$3.00,$118.50,$85193.00,131,$118.50
2024-07-03,16:57:00,20406.75,BUY,3,0.02h,Stop Loss,$28.50,$147.00,$85221.50,131,$147.00
2024-07-03,22:02:00,20405.5,SELL,3,0.02h,Break Even,$-1.50,$145.50,$85220.00,131,$145.50
2024-07-03,22:23:00,20406.75,BUY,3,0.02h,Stop Loss,$-9.00,$136.50,$85211.00,131,$136.50
2024-07-03,22:49:00,20406.5,SELL,3,0.07h,Stop Loss,$19.50,$156.00,$85230.50,131,$156.00
,,,,,,,,,,,
2024-07-04,12:09:00,20404.25,BUY,3,0.07h,Stop Loss,$-9.00,$-9.00,$85221.50,132,$-9.00
2024-07-04,13:25:00,20406.5,SELL,3,0.02h,Stop Loss,$-9.00,$-18.00,$85212.50,132,$-18.00
2024-07-04,15:01:00,20378.5,BUY,3,0.02h,Break Even,$-1.50,$-19.50,$85211.00,132,$-19.50
2024-07-04,15:50:00,20386.5,SELL,3,0.02h,Break Even,$-1.50,$-21.00,$85209.50,132,$-21.00
2024-07-04,16:29:00,20383.0,BUY,3,0.02h,Stop Loss,$-9.00,$-30.00,$85200.50,132,$-30.00
2024-07-04,16:48:00,20380.5,SELL,3,0.02h,Stop Loss,$-9.00,$-39.00,$85191.50,132,$-39.00
2024-07-04,16:51:00,20384.0,BUY,3,0.02h,Stop Loss,$-9.00,$-48.00,$85182.50,132,$-48.00
2024-07-04,16:54:00,20379.75,SELL,3,0.02h,Stop Loss,$-9.00,$-57.00,$85173.50,132,$-57.00
2024-07-04,22:05:00,20384.0,BUY,3,0.02h,Stop Loss,$21.00,$-36.00,$85194.50,132,$-36.00
2024-07-04,22:31:00,20382.25,SELL,3,0.02h,Stop Loss,$-9.00,$-45.00,$85185.50,132,$-45.00
2024-07-04,22:33:00,20386.0,BUY,3,0.02h,Break Even,$-1.50,$-46.50,$85184.00,132,$-46.50
2024-07-04,22:48:00,20383.5,SELL,3,0.02h,Stop Loss,$-9.00,$-55.50,$85175.00,132,$-55.50
2024-07-04,22:53:00,20386.25,BUY,3,0.05h,Stop Loss,$-9.00,$-64.50,$85166.00,132,$-64.50
2024-07-04,22:59:00,20382.25,SELL,3,0.02h,Stop Loss,$-9.00,$-73.50,$85157.00,132,$-73.50
,,,,,,,,,,,
2024-07-05,12:00:00,20433.5,BUY,3,0.02h,Break Even,$-1.50,$-1.50,$85155.50,133,$-1.50
2024-07-05,12:48:00,20439.5,SELL,3,0.02h,Stop Loss,$54.00,$52.50,$85209.50,133,$52.50
2024-07-05,13:21:00,20426.5,BUY,3,0.02h,Stop Loss,$24.00,$76.50,$85233.50,133,$76.50
2024-07-05,14:12:00,20467.25,SELL,3,0.02h,Break Even,$-1.50,$75.00,$85232.00,133,$75.00
2024-07-05,14:19:00,20507.75,BUY,3,0.02h,Stop Loss,$18.00,$93.00,$85250.00,133,$93.00
2024-07-05,15:02:00,20520.5,SELL,3,0.02h,Break Even,$-1.50,$91.50,$85248.50,133,$91.50
2024-07-05,15:08:00,20537.25,BUY,3,0.02h,Stop Loss,$40.50,$132.00,$85289.00,133,$132.00
2024-07-05,16:09:00,20582.75,SELL,3,0.02h,Stop Loss,$-9.00,$123.00,$85280.00,133,$123.00
2024-07-05,16:12:00,20594.25,BUY,3,0.02h,Stop Loss,$19.50,$142.50,$85299.50,133,$142.50
2024-07-05,16:36:00,20595.0,SELL,3,0.02h,Stop Loss,$-9.00,$133.50,$85290.50,133,$133.50
2024-07-05,17:15:00,20595.0,BUY,3,0.02h,Stop Loss,$7.50,$141.00,$85298.00,133,$141.00
2024-07-05,18:01:00,20621.75,SELL,3,0.02h,Stop Loss,$37.50,$178.50,$85335.50,133,$178.50
2024-07-05,18:14:00,20627.25,BUY,3,0.02h,Stop Loss,$-9.00,$169.50,$85326.50,133,$169.50
2024-07-05,18:24:00,20615.5,SELL,3,0.02h,Stop Loss,$30.00,$199.50,$85356.50,133,$199.50
2024-07-05,18:50:00,20612.5,BUY,3,0.02h,Stop Loss,$3.00,$202.50,$85359.50,133,$202.50
2024-07-05,19:33:00,20616.75,SELL,3,0.02h,Stop Loss,$-9.00,$193.50,$85350.50,133,$193.50
2024-07-05,19:35:00,20626.75,BUY,3,0.02h,Stop Loss,$-9.00,$184.50,$85341.50,133,$184.50
2024-07-05,20:01:00,20613.0,SELL,3,0.02h,Break Even,$-1.50,$183.00,$85340.00,133,$183.00
,,,,,,,,,,,
2024-07-08,12:00:00,20628.25,BUY,3,0.02h,Stop Loss,$-9.00,$-9.00,$85331.00,134,$-9.00
2024-07-08,12:45:00,20632.75,SELL,3,0.02h,Stop Loss,$-9.00,$-18.00,$85322.00,134,$-18.00
2024-07-08,12:47:00,20633.5,BUY,3,0.02h,Stop Loss,$-9.00,$-27.00,$85313.00,134,$-27.00
2024-07-08,12:48:00,20630.5,SELL,3,0.02h,Break Even,$-1.50,$-28.50,$85311.50,134,$-28.50
2024-07-08,13:06:00,20632.5,BUY,3,0.02h,Stop Loss,$-9.00,$-37.50,$85302.50,134,$-37.50
2024-07-08,13:31:00,20628.25,SELL,3,0.02h,Stop Loss,$43.50,$6.00,$85346.00,134,$6.00
2024-07-08,13:51:00,20646.5,BUY,3,0.02h,Stop Loss,$24.00,$30.00,$85370.00,134,$30.00
2024-07-08,14:01:00,20607.75,SELL,3,0.02h,Stop Loss,$46.50,$76.50,$85416.50,134,$76.50
2024-07-08,14:08:00,20633.75,BUY,3,0.02h,Stop Loss,$3.00,$79.50,$85419.50,134,$79.50
2024-07-08,14:21:00,20611.25,SELL,3,0.02h,Stop Loss,$12.00,$91.50,$85431.50,134,$91.50
2024-07-08,14:31:00,20631.75,BUY,3,0.02h,Stop Loss,$-9.00,$82.50,$85422.50,134,$82.50
2024-07-08,14:34:00,20615.0,SELL,3,0.02h,Break Even,$-1.50,$81.00,$85421.00,134,$81.00
2024-07-08,15:03:00,20618.5,BUY,3,0.02h,Stop Loss,$43.50,$124.50,$85464.50,134,$124.50
2024-07-08,16:04:00,20647.5,SELL,3,0.02h,Break Even,$-1.50,$123.00,$85463.00,134,$123.00
2024-07-08,16:49:00,20626.25,BUY,3,0.02h,Break Even,$-1.50,$121.50,$85461.50,134,$121.50
2024-07-08,17:52:00,20647.25,SELL,3,0.02h,Break Even,$-1.50,$120.00,$85460.00,134,$120.00
2024-07-08,18:21:00,20646.5,BUY,3,0.02h,Stop Loss,$-9.00,$111.00,$85451.00,134,$111.00
2024-07-08,18:33:00,20635.0,SELL,3,0.02h,Break Even,$-1.50,$109.50,$85449.50,134,$109.50
2024-07-08,18:55:00,20638.25,BUY,3,0.02h,Stop Loss,$21.00,$130.50,$85470.50,134,$130.50
2024-07-08,19:12:00,20633.25,SELL,3,0.02h,Break Even,$-1.50,$129.00,$85469.00,134,$129.00
2024-07-08,19:44:00,20633.5,BUY,3,0.02h,Stop Loss,$16.50,$145.50,$85485.50,134,$145.50
2024-07-08,20:35:00,20675.5,SELL,3,0.02h,Stop Loss,$-9.00,$136.50,$85476.50,134,$136.50
2024-07-08,20:43:00,20678.0,BUY,3,0.02h,Stop Loss,$-9.00,$127.50,$85467.50,134,$127.50
2024-07-08,20:44:00,20677.0,SELL,3,0.02h,Stop Loss,$-9.00,$118.50,$85458.50,134,$118.50
2024-07-08,20:46:00,20677.25,BUY,3,0.03h,Break Even,$-1.50,$117.00,$85457.00,134,$117.00
2024-07-08,22:39:00,20690.75,SELL,3,0.05h,Break Even,$-1.50,$115.50,$85455.50,134,$115.50
2024-07-08,22:48:00,20694.75,BUY,3,0.02h,Stop Loss,$-9.00,$106.50,$85446.50,134,$106.50
2024-07-08,22:55:00,20691.0,SELL,3,0.02h,Break Even,$-1.50,$105.00,$85445.00,134,$105.00
,,,,,,,,,,,
2024-07-09,12:00:00,20725.5,BUY,3,0.02h,Break Even,$-1.50,$-1.50,$85443.50,135,$-1.50
2024-07-09,12:25:00,20715.25,SELL,3,0.02h,Break Even,$-1.50,$-3.00,$85442.00,135,$-3.00
2024-07-09,12:51:00,20719.0,BUY,3,0.02h,Break Even,$-1.50,$-4.50,$85440.50,135,$-4.50
2024-07-09,13:52:00,20726.5,SELL,3,0.02h,Break Even,$-1.50,$-6.00,$85439.00,135,$-6.00
2024-07-09,13:55:00,20739.25,BUY,3,0.02h,Break Even,$-1.50,$-7.50,$85437.50,135,$-7.50
2024-07-09,14:07:00,20720.0,SELL,3,0.02h,Break Even,$-1.50,$-9.00,$85436.00,135,$-9.00
2024-07-09,14:12:00,20753.25,BUY,3,0.02h,Stop Loss,$90.00,$81.00,$85526.00,135,$81.00
2024-07-09,14:25:00,20718.75,SELL,3,0.02h,Stop Loss,$37.50,$118.50,$85563.50,135,$118.50
2024-07-09,14:45:00,20728.5,BUY,3,0.02h,Stop Loss,$45.00,$163.50,$85608.50,135,$163.50
2024-07-09,14:56:00,20712.25,SELL,3,0.02h,Stop Loss,$48.00,$211.50,$85656.50,135,$211.50
2024-07-09,15:47:00,20698.75,BUY,3,0.02h,Stop Loss,$4.50,$216.00,$85661.00,135,$216.00
2024-07-09,16:27:00,20696.0,SELL,3,0.02h,Stop Loss,$-9.00,$207.00,$85652.00,135,$207.00
2024-07-09,17:03:00,20682.0,BUY,3,0.02h,Stop Loss,$31.50,$238.50,$85683.50,135,$238.50
2024-07-09,17:17:00,20663.25,SELL,3,0.02h,Stop Loss,$88.50,$327.00,$85772.00,135,$327.00
2024-07-09,17:39:00,20652.0,BUY,3,0.02h,Break Even,$-1.50,$325.50,$85770.50,135,$325.50
2024-07-09,17:48:00,20643.5,SELL,3,0.02h,Break Even,$-1.50,$324.00,$85769.00,135,$324.00
2024-07-09,17:52:00,20652.25,BUY,3,0.02h,Stop Loss,$18.00,$342.00,$85787.00,135,$342.00
2024-07-09,18:07:00,20650.5,SELL,3,0.02h,Stop Loss,$-9.00,$333.00,$85778.00,135,$333.00
2024-07-09,18:09:00,20656.75,BUY,3,0.02h,Stop Loss,$19.50,$352.50,$85797.50,135,$352.50
2024-07-09,18:28:00,20654.75,SELL,3,0.02h,Stop Loss,$13.50,$366.00,$85811.00,135,$366.00
2024-07-09,18:37:00,20664.5,BUY,3,0.02h,Break Even,$-1.50,$364.50,$85809.50,135,$364.50
2024-07-09,18:56:00,20660.25,SELL,3,0.02h,Stop Loss,$10.50,$375.00,$85820.00,135,$375.00
2024-07-09,19:00:00,20671.5,BUY,3,0.02h,Break Even,$-1.50,$373.50,$85818.50,135,$373.50
2024-07-09,19:22:00,20659.5,SELL,3,0.02h,Stop Loss,$3.00,$376.50,$85821.50,135,$376.50
2024-07-09,19:39:00,20667.0,BUY,3,0.02h,Stop Loss,$-9.00,$367.50,$85812.50,135,$367.50
2024-07-09,20:12:00,20673.25,SELL,3,0.03h,Stop Loss,$-9.00,$358.50,$85803.50,135,$358.50
2024-07-09,20:15:00,20675.0,BUY,3,0.02h,Break Even,$-1.50,$357.00,$85802.00,135,$357.00
2024-07-09,22:54:00,20692.25,SELL,3,0.02h,Stop Loss,$-9.00,$348.00,$85793.00,135,$348.00
,,,,,,,,,,,
2024-07-10,12:00:00,20749.75,BUY,3,0.02h,Break Even,$-1.50,$-1.50,$85791.50,136,$-1.50
2024-07-10,12:47:00,20755.0,SELL,3,0.02h,Break Even,$-1.50,$-3.00,$85790.00,136,$-3.00
2024-07-10,13:07:00,20758.5,BUY,3,0.02h,Break Even,$-1.50,$-4.50,$85788.50,136,$-4.50
2024-07-10,13:20:00,20755.5,SELL,3,0.02h,Stop Loss,$-9.00,$-13.50,$85779.50,136,$-13.50
2024-07-10,13:26:00,20765.0,BUY,3,0.02h,Stop Loss,$-9.00,$-22.50,$85770.50,136,$-22.50
2024-07-10,13:32:00,20752.5,SELL,3,0.02h,Stop Loss,$51.00,$28.50,$85821.50,136,$28.50
2024-07-10,13:46:00,20761.25,BUY,3,0.02h,Stop Loss,$-9.00,$19.50,$85812.50,136,$19.50
2024-07-10,14:21:00,20761.0,SELL,3,0.02h,Stop Loss,$13.50,$33.00,$85826.00,136,$33.00
2024-07-10,15:23:00,20735.0,BUY,3,0.02h,Stop Loss,$-9.00,$24.00,$85817.00,136,$24.00
2024-07-10,17:27:00,20848.25,SELL,3,0.02h,Stop Loss,$-9.00,$15.00,$85808.00,136,$15.00
2024-07-10,17:28:00,20857.75,BUY,3,0.02h,Stop Loss,$-9.00,$6.00,$85799.00,136,$6.00
2024-07-10,18:20:00,20867.0,SELL,3,0.02h,Stop Loss,$16.50,$22.50,$85815.50,136,$22.50
2024-07-10,18:36:00,20872.75,BUY,3,0.02h,Stop Loss,$-9.00,$13.50,$85806.50,136,$13.50
2024-07-10,18:42:00,20867.0,SELL,3,0.02h,Break Even,$-1.50,$12.00,$85805.00,136,$12.00
2024-07-10,18:44:00,20873.25,BUY,3,0.02h,Stop Loss,$-9.00,$3.00,$85796.00,136,$3.00
2024-07-10,19:02:00,20869.75,SELL,3,0.02h,Stop Loss,$15.00,$18.00,$85811.00,136,$18.00
2024-07-10,19:30:00,20870.0,BUY,3,0.02h,Stop Loss,$-9.00,$9.00,$85802.00,136,$9.00
2024-07-10,20:04:00,20884.0,SELL,3,0.02h,Stop Loss,$9.00,$18.00,$85811.00,136,$18.00
2024-07-10,20:20:00,20893.5,BUY,3,0.02h,Stop Loss,$-9.00,$9.00,$85802.00,136,$9.00
2024-07-10,20:47:00,20886.75,SELL,3,0.02h,Stop Loss,$-9.00,$0.00,$85793.00,136,$0.00
2024-07-10,20:55:00,20892.5,BUY,3,0.02h,Break Even,$-1.50,$-1.50,$85791.50,136,$-1.50
2024-07-10,22:14:00,20893.25,SELL,3,0.03h,Stop Loss,$-9.00,$-10.50,$85782.50,136,$-10.50
2024-07-10,22:25:00,20896.5,BUY,3,0.02h,Stop Loss,$-9.00,$-19.50,$85773.50,136,$-19.50
2024-07-10,22:33:00,20892.5,SELL,3,0.07h,Stop Loss,$18.00,$-1.50,$85791.50,136,$-1.50
2024-07-10,22:58:00,20889.75,BUY,3,0.02h,Break Even,$-1.50,$-3.00,$85790.00,136,$-3.00
,,,,,,,,,,,
2024-07-11,12:00:00,20882.25,SELL,3,0.02h,Break Even,$-1.50,$-1.50,$85788.50,137,$-1.50
2024-07-11,12:30:00,20888.75,BUY,3,0.02h,Stop Loss,$496.50,$495.00,$86285.00,137,$495.00
2024-07-11,12:52:00,20907.5,SELL,3,0.02h,Stop Loss,$105.00,$600.00,$86390.00,137,$600.00
2024-07-11,13:18:00,20914.0,BUY,3,0.02h,Break Even,$-1.50,$598.50,$86388.50,137,$598.50
2024-07-11,13:29:00,20895.5,SELL,3,0.02h,Stop Loss,$28.50,$627.00,$86417.00,137,$627.00
2024-07-11,16:11:00,20519.0,BUY,3,0.02h,Stop Loss,$18.00,$645.00,$86435.00,137,$645.00
2024-07-11,16:19:00,20481.5,SELL,3,0.02h,Stop Loss,$-9.00,$636.00,$86426.00,137,$636.00
2024-07-11,16:31:00,20510.0,BUY,3,0.02h,Stop Loss,$22.50,$658.50,$86448.50,137,$658.50
2024-07-11,16:48:00,20470.5,SELL,3,0.02h,Stop Loss,$88.50,$747.00,$86537.00,137,$747.00
2024-07-11,17:17:00,20474.25,BUY,3,0.02h,Break Even,$-1.50,$745.50,$86535.50,137,$745.50
2024-07-11,17:35:00,20459.5,SELL,3,0.02h,Stop Loss,$34.50,$780.00,$86570.00,137,$780.00
2024-07-11,18:17:00,20412.5,BUY,3,0.02h,Stop Loss,$-9.00,$771.00,$86561.00,137,$771.00
2024-07-11,19:22:00,20466.5,SELL,3,0.02h,Stop Loss,$12.00,$783.00,$86573.00,137,$783.00
2024-07-11,19:38:00,20481.25,BUY,3,0.02h,Stop Loss,$21.00,$804.00,$86594.00,137,$804.00
2024-07-11,19:45:00,20448.25,SELL,3,0.02h,Break Even,$-1.50,$802.50,$86592.50,137,$802.50
2024-07-11,19:50:00,20466.0,BUY,3,0.02h,Stop Loss,$48.00,$850.50,$86640.50,137,$850.50
2024-07-11,19:55:00,20447.0,SELL,3,0.02h,Stop Loss,$37.50,$888.00,$86678.00,137,$888.00
2024-07-11,20:31:00,20452.0,BUY,3,0.02h,Stop Loss,$-9.00,$879.00,$86669.00,137,$879.00
2024-07-11,20:39:00,20442.75,SELL,3,0.02h,Stop Loss,$-9.00,$870.00,$86660.00,137,$870.00
2024-07-11,20:40:00,20445.5,BUY,3,0.02h,Break Even,$-1.50,$868.50,$86658.50,137,$868.50
2024-07-11,20:43:00,20442.5,SELL,3,0.02h,Break Even,$-1.50,$867.00,$86657.00,137,$867.00
2024-07-11,20:45:00,20445.5,BUY,3,0.02h,Break Even,$-1.50,$865.50,$86655.50,137,$865.50
2024-07-11,20:46:00,20442.5,SELL,3,0.02h,Stop Loss,$3.00,$868.50,$86658.50,137,$868.50
2024-07-11,22:04:00,20444.25,BUY,3,0.02h,Stop Loss,$3.00,$871.50,$86661.50,137,$871.50
2024-07-11,22:07:00,20437.5,SELL,3,0.02h,Break Even,$-1.50,$870.00,$86660.00,137,$870.00
2024-07-11,22:32:00,20440.0,BUY,3,0.02h,Stop Loss,$25.50,$895.50,$86685.50,137,$895.50
,,,,,,,,,,,
2024-07-12,12:03:00,20429.5,SELL,3,0.02h,Break Even,$-1.50,$-1.50,$86684.00,138,$-1.50
2024-07-12,12:35:00,20429.0,BUY,3,0.02h,Stop Loss,$-9.00,$-10.50,$86675.00,138,$-10.50
2024-07-12,13:19:00,20436.0,SELL,3,0.02h,Break Even,$-1.50,$-12.00,$86673.50,138,$-12.00
2024-07-12,13:31:00,20459.25,BUY,3,0.02h,Stop Loss,$49.50,$37.50,$86723.00,138,$37.50
2024-07-12,14:24:00,20536.75,SELL,3,0.02h,Break Even,$-1.50,$36.00,$86721.50,138,$36.00
2024-07-12,14:26:00,20558.75,BUY,3,0.02h,Break Even,$-1.50,$34.50,$86720.00,138,$34.50
2024-07-12,15:20:00,20634.75,SELL,3,0.02h,Stop Loss,$3.00,$37.50,$86723.00,138,$37.50
2024-07-12,15:30:00,20655.5,BUY,3,0.02h,Break Even,$-1.50,$36.00,$86721.50,138,$36.00
2024-07-12,15:35:00,20638.0,SELL,3,0.02h,Break Even,$-1.50,$34.50,$86720.00,138,$34.50
2024-07-12,15:40:00,20654.0,BUY,3,0.02h,Stop Loss,$21.00,$55.50,$86741.00,138,$55.50
2024-07-12,15:54:00,20647.75,SELL,3,0.02h,Stop Loss,$-9.00,$46.50,$86732.00,138,$46.50
2024-07-12,16:37:00,20606.5,BUY,3,0.02h,Break Even,$-1.50,$45.00,$86730.50,138,$45.00
2024-07-12,16:50:00,20589.75,SELL,3,0.02h,Stop Loss,$-9.00,$36.00,$86721.50,138,$36.00
2024-07-12,16:51:00,20597.0,BUY,3,0.02h,Stop Loss,$19.50,$55.50,$86741.00,138,$55.50
2024-07-12,18:08:00,20703.5,SELL,3,0.02h,Break Even,$-1.50,$54.00,$86739.50,138,$54.00
2024-07-12,18:41:00,20709.5,BUY,3,0.02h,Stop Loss,$-9.00,$45.00,$86730.50,138,$45.00
2024-07-12,18:53:00,20701.25,SELL,3,0.02h,Break Even,$-1.50,$43.50,$86729.00,138,$43.50
2024-07-12,18:58:00,20708.5,BUY,3,0.02h,Break Even,$-1.50,$42.00,$86727.50,138,$42.00
2024-07-12,19:05:00,20698.25,SELL,3,0.02h,Stop Loss,$-9.00,$33.00,$86718.50,138,$33.00
2024-07-12,20:42:00,20537.5,BUY,3,0.02h,Break Even,$-1.50,$31.50,$86717.00,138,$31.50
,,,,,,,,,,,
2024-07-15,12:39:00,20612.5,SELL,3,0.02h,Stop Loss,$19.50,$19.50,$86736.50,139,$19.50
2024-07-15,13:06:00,20612.5,BUY,3,0.02h,Break Even,$-1.50,$18.00,$86735.00,139,$18.00
2024-07-15,13:13:00,20602.0,SELL,3,0.02h,Break Even,$-1.50,$16.50,$86733.50,139,$16.50
2024-07-15,13:21:00,20612.75,BUY,3,0.02h,Break Even,$-1.50,$15.00,$86732.00,139,$15.00
2024-07-15,13:46:00,20599.25,SELL,3,0.02h,Stop Loss,$57.00,$72.00,$86789.00,139,$72.00
2024-07-15,13:55:00,20635.25,BUY,3,0.02h,Break Even,$-1.50,$70.50,$86787.50,139,$70.50
2024-07-15,15:30:00,20734.5,SELL,3,0.02h,Stop Loss,$57.00,$127.50,$86844.50,139,$127.50
2024-07-15,16:30:00,20663.75,BUY,3,0.02h,Stop Loss,$-9.00,$118.50,$86835.50,139,$118.50
2024-07-15,16:46:00,20645.75,SELL,3,0.02h,Stop Loss,$36.00,$154.50,$86871.50,139,$154.50
2024-07-15,16:59:00,20654.0,BUY,3,0.02h,Break Even,$-1.50,$153.00,$86870.00,139,$153.00
2024-07-15,17:01:00,20617.25,SELL,3,0.02h,Stop Loss,$129.00,$282.00,$86999.00,139,$282.00
2024-07-15,17:25:00,20647.5,BUY,3,0.02h,Break Even,$-1.50,$280.50,$86997.50,139,$280.50
2024-07-15,17:28:00,20616.5,SELL,3,0.02h,Stop Loss,$72.00,$352.50,$87069.50,139,$352.50
2024-07-15,18:24:00,20589.25,BUY,3,0.02h,Stop Loss,$40.50,$393.00,$87110.00,139,$393.00
2024-07-15,18:46:00,20588.5,SELL,3,0.02h,Stop Loss,$-9.00,$384.00,$87101.00,139,$384.00
2024-07-15,18:48:00,20606.25,BUY,3,0.02h,Stop Loss,$28.50,$412.50,$87129.50,139,$412.50
2024-07-15,19:37:00,20611.5,SELL,3,0.02h,Stop Loss,$12.00,$424.50,$87141.50,139,$424.50
2024-07-15,20:01:00,20599.25,BUY,3,0.02h,Break Even,$-1.50,$423.00,$87140.00,139,$423.00
2024-07-15,22:35:00,20639.25,SELL,3,0.02h,Stop Loss,$10.50,$433.50,$87150.50,139,$433.50
,,,,,,,,,,,
2024-07-16,12:27:00,20634.25,BUY,3,0.02h,Stop Loss,$-9.00,$-9.00,$87141.50,140,$-9.00
2024-07-16,12:51:00,20628.25,SELL,3,0.02h,Stop Loss,$27.00,$18.00,$87168.50,140,$18.00
2024-07-16,13:12:00,20636.0,BUY,3,0.02h,Break Even,$-1.50,$16.50,$87167.00,140,$16.50
2024-07-16,13:46:00,20630.75,SELL,3,0.02h,Stop Loss,$37.50,$54.00,$87204.50,140,$54.00
2024-07-16,14:33:00,20548.75,BUY,3,0.02h,Stop Loss,$-9.00,$45.00,$87195.50,140,$45.00
2024-07-16,14:59:00,20543.75,SELL,3,0.02h,Stop Loss,$48.00,$93.00,$87243.50,140,$93.00
2024-07-16,15:05:00,20568.5,BUY,3,0.02h,Break Even,$-1.50,$91.50,$87242.00,140,$91.50
2024-07-16,15:22:00,20561.5,SELL,3,0.02h,Stop Loss,$-9.00,$82.50,$87233.00,140,$82.50
2024-07-16,15:51:00,20554.0,BUY,3,0.02h,Stop Loss,$54.00,$136.50,$87287.00,140,$136.50
2024-07-16,16:08:00,20547.25,SELL,3,0.02h,Stop Loss,$-9.00,$127.50,$87278.00,140,$127.50
2024-07-16,16:49:00,20518.75,BUY,3,0.02h,Stop Loss,$10.50,$138.00,$87288.50,140,$138.00
2024-07-16,17:16:00,20515.0,SELL,3,0.02h,Stop Loss,$67.50,$205.50,$87356.00,140,$205.50
2024-07-16,17:49:00,20523.5,BUY,3,0.02h,Stop Loss,$-9.00,$196.50,$87347.00,140,$196.50
2024-07-16,18:04:00,20508.5,SELL,3,0.02h,Break Even,$-1.50,$195.00,$87345.50,140,$195.00
2024-07-16,18:06:00,20522.75,BUY,3,0.02h,Break Even,$-1.50,$193.50,$87344.00,140,$193.50
2024-07-16,18:14:00,20506.5,SELL,3,0.02h,Stop Loss,$-9.00,$184.50,$87335.00,140,$184.50
2024-07-16,18:24:00,20528.5,BUY,3,0.02h,Stop Loss,$85.50,$270.00,$87420.50,140,$270.00
2024-07-16,19:20:00,20566.75,SELL,3,0.02h,Stop Loss,$13.50,$283.50,$87434.00,140,$283.50
2024-07-16,19:34:00,20584.25,BUY,3,0.02h,Stop Loss,$48.00,$331.50,$87482.00,140,$331.50
2024-07-16,19:47:00,20568.5,SELL,3,0.02h,Break Even,$-1.50,$330.00,$87480.50,140,$330.00
2024-07-16,19:52:00,20593.25,BUY,3,0.02h,Stop Loss,$3.00,$333.00,$87483.50,140,$333.00
2024-07-16,20:24:00,20594.25,SELL,3,0.03h,Break Even,$-1.50,$331.50,$87482.00,140,$331.50
2024-07-16,20:29:00,20599.0,BUY,3,0.02h,Stop Loss,$-9.00,$322.50,$87473.00,140,$322.50
2024-07-16,20:47:00,20597.0,SELL,3,0.03h,Stop Loss,$-9.00,$313.50,$87464.00,140,$313.50
2024-07-16,22:19:00,20591.75,BUY,3,0.02h,Stop Loss,$-9.00,$304.50,$87455.00,140,$304.50
2024-07-16,22:21:00,20588.5,SELL,3,0.02h,Break Even,$-1.50,$303.00,$87453.50,140,$303.00
2024-07-16,22:35:00,20592.0,BUY,3,0.02h,Stop Loss,$-9.00,$294.00,$87444.50,140,$294.00
2024-07-16,22:49:00,20587.25,SELL,3,0.02h,Stop Loss,$-9.00,$285.00,$87435.50,140,$285.00
,,,,,,,,,,,
2024-07-17,13:10:00,20293.5,BUY,3,0.02h,Break Even,$-1.50,$-1.50,$87434.00,141,$-1.50
2024-07-17,13:13:00,20284.0,SELL,3,0.02h,Break Even,$-1.50,$-3.00,$87432.50,141,$-3.00
2024-07-17,14:36:00,20169.5,BUY,3,0.02h,Break Even,$-1.50,$-4.50,$87431.00,141,$-4.50
2024-07-17,14:50:00,20125.25,SELL,3,0.02h,Stop Loss,$43.50,$39.00,$87474.50,141,$39.00
2024-07-17,15:20:00,20127.75,BUY,3,0.02h,Stop Loss,$-9.00,$30.00,$87465.50,141,$30.00
2024-07-17,15:21:00,20113.5,SELL,3,0.02h,Break Even,$-1.50,$28.50,$87464.00,141,$28.50
2024-07-17,15:22:00,20138.0,BUY,3,0.02h,Stop Loss,$27.00,$55.50,$87491.00,141,$55.50
2024-07-17,15:27:00,20097.5,SELL,3,0.02h,Break Even,$-1.50,$54.00,$87489.50,141,$54.00
2024-07-17,15:31:00,20130.0,BUY,3,0.02h,Stop Loss,$4.50,$58.50,$87494.00,141,$58.50
2024-07-17,15:37:00,20108.0,SELL,3,0.02h,Stop Loss,$-9.00,$49.50,$87485.00,141,$49.50
2024-07-17,16:55:00,20047.75,BUY,3,0.02h,Stop Loss,$61.50,$111.00,$87546.50,141,$111.00
2024-07-17,17:10:00,20023.0,SELL,3,0.02h,Stop Loss,$-9.00,$102.00,$87537.50,141,$102.00
2024-07-17,17:22:00,20051.0,BUY,3,0.02h,Break Even,$-1.50,$100.50,$87536.00,141,$100.50
2024-07-17,17:29:00,20033.0,SELL,3,0.02h,Stop Loss,$-9.00,$91.50,$87527.00,141,$91.50
2024-07-17,17:30:00,20046.5,BUY,3,0.02h,Stop Loss,$57.00,$148.50,$87584.00,141,$148.50
2024-07-17,17:44:00,20040.5,SELL,3,0.02h,Break Even,$-1.50,$147.00,$87582.50,141,$147.00
2024-07-17,18:11:00,20048.0,BUY,3,0.02h,Stop Loss,$18.00,$165.00,$87600.50,141,$165.00
2024-07-17,18:40:00,20041.25,SELL,3,0.02h,Stop Loss,$-9.00,$156.00,$87591.50,141,$156.00
2024-07-17,19:13:00,20039.5,BUY,3,0.02h,Break Even,$-1.50,$154.50,$87590.00,141,$154.50
2024-07-17,19:18:00,20013.0,SELL,3,0.02h,Break Even,$-1.50,$153.00,$87588.50,141,$153.00
2024-07-17,19:22:00,20032.25,BUY,3,0.02h,Stop Loss,$87.00,$240.00,$87675.50,141,$240.00
2024-07-17,19:40:00,20027.25,SELL,3,0.02h,Stop Loss,$-9.00,$231.00,$87666.50,141,$231.00
2024-07-17,19:50:00,20055.0,BUY,3,0.02h,Stop Loss,$75.00,$306.00,$87741.50,141,$306.00
2024-07-17,19:57:00,20014.25,SELL,3,0.02h,Stop Loss,$39.00,$345.00,$87780.50,141,$345.00
2024-07-17,20:24:00,20009.25,BUY,3,0.02h,Stop Loss,$37.50,$382.50,$87818.00,141,$382.50
2024-07-17,20:47:00,20009.75,SELL,3,0.02h,Stop Loss,$-9.00,$373.50,$87809.00,141,$373.50
2024-07-17,21:26:00,20017.0,BUY,3,0.58h,Stop Loss,$160.50,$534.00,$87969.50,141,$534.00
2024-07-17,22:38:00,20042.5,SELL,3,0.02h,Stop Loss,$22.50,$556.50,$87992.00,141,$556.50
2024-07-17,22:51:00,20052.75,BUY,3,0.02h,Stop Loss,$-9.00,$547.50,$87983.00,141,$547.50
,,,,,,,,,,,
2024-07-18,13:23:00,20136.75,SELL,3,0.02h,Break Even,$-1.50,$-1.50,$87981.50,142,$-1.50
2024-07-18,14:06:00,20092.25,BUY,3,0.02h,Stop Loss,$58.50,$57.00,$88040.00,142,$57.00
2024-07-18,14:21:00,20056.75,SELL,3,0.02h,Stop Loss,$25.50,$82.50,$88065.50,142,$82.50
2024-07-18,14:54:00,20011.5,BUY,3,0.02h,Stop Loss,$30.00,$112.50,$88095.50,142,$112.50
2024-07-18,15:07:00,19948.75,SELL,3,0.02h,Stop Loss,$57.00,$169.50,$88152.50,142,$169.50
2024-07-18,16:10:00,19837.75,BUY,3,0.02h,Stop Loss,$-9.00,$160.50,$88143.50,142,$160.50
2024-07-18,16:20:00,19810.25,SELL,3,0.02h,Break Even,$-1.50,$159.00,$88142.00,142,$159.00
2024-07-18,16:21:00,19815.25,BUY,3,0.02h,Stop Loss,$105.00,$264.00,$88247.00,142,$264.00
2024-07-18,17:09:00,19874.25,SELL,3,0.02h,Stop Loss,$49.50,$313.50,$88296.50,142,$313.50
2024-07-18,17:13:00,19914.0,BUY,3,0.02h,Stop Loss,$-9.00,$304.50,$88287.50,142,$304.50
2024-07-18,17:38:00,19906.0,SELL,3,0.02h,Stop Loss,$73.50,$378.00,$88361.00,142,$378.00
2024-07-18,17:48:00,19916.0,BUY,3,0.02h,Stop Loss,$28.50,$406.50,$88389.50,142,$406.50
2024-07-18,17:52:00,19883.75,SELL,3,0.02h,Stop Loss,$34.50,$441.00,$88424.00,142,$441.00
2024-07-18,18:25:00,19886.0,BUY,3,0.02h,Stop Loss,$-9.00,$432.00,$88415.00,142,$432.00
2024-07-18,18:28:00,19856.75,SELL,3,0.02h,Stop Loss,$22.50,$454.50,$88437.50,142,$454.50
2024-07-18,18:57:00,19845.25,BUY,3,0.02h,Stop Loss,$6.00,$460.50,$88443.50,142,$460.50
2024-07-18,19:08:00,19830.0,SELL,3,0.02h,Stop Loss,$66.00,$526.50,$88509.50,142,$526.50
2024-07-18,19:30:00,19823.75,BUY,3,0.02h,Stop Loss,$39.00,$565.50,$88548.50,142,$565.50
2024-07-18,22:23:00,19947.5,SELL,3,0.02h,Break Even,$-1.50,$564.00,$88547.00,142,$564.00
2024-07-18,22:48:00,19959.5,BUY,3,0.02h,Break Even,$-1.50,$562.50,$88545.50,142,$562.50
,,,,,,,,,,,
2024-07-19,12:00:00,19923.5,SELL,3,0.02h,Stop Loss,$-9.00,$-9.00,$88536.50,143,$-9.00
2024-07-19,12:36:00,19925.5,BUY,3,0.02h,Stop Loss,$33.00,$24.00,$88569.50,143,$24.00
2024-07-19,13:04:00,19919.25,SELL,3,0.02h,Stop Loss,$22.50,$46.50,$88592.00,143,$46.50
2024-07-19,13:40:00,19927.5,BUY,3,0.02h,Stop Loss,$159.00,$205.50,$88751.00,143,$205.50
2024-07-19,13:48:00,19862.75,SELL,3,0.02h,Stop Loss,$3.00,$208.50,$88754.00,143,$208.50
2024-07-19,13:52:00,19922.25,BUY,3,0.02h,Stop Loss,$42.00,$250.50,$88796.00,143,$250.50
2024-07-19,14:13:00,19879.0,SELL,3,0.02h,Stop Loss,$168.00,$418.50,$88964.00,143,$418.50
2024-07-19,14:55:00,19821.5,BUY,3,0.02h,Stop Loss,$49.50,$468.00,$89013.50,143,$468.00
2024-07-19,15:11:00,19800.5,SELL,3,0.02h,Stop Loss,$84.00,$552.00,$89097.50,143,$552.00
2024-07-19,15:52:00,19767.25,BUY,3,0.02h,Stop Loss,$13.50,$565.50,$89111.00,143,$565.50
2024-07-19,16:20:00,19778.0,SELL,3,0.02h,Break Even,$-1.50,$564.00,$89109.50,143,$564.00
2024-07-19,17:00:00,19728.75,BUY,3,0.02h,Break Even,$-1.50,$562.50,$89108.00,143,$562.50
2024-07-19,17:03:00,19695.75,SELL,3,0.02h,Stop Loss,$10.50,$573.00,$89118.50,143,$573.00
2024-07-19,17:34:00,19690.5,BUY,3,0.02h,Stop Loss,$27.00,$600.00,$89145.50,143,$600.00
2024-07-19,17:44:00,19667.75,SELL,3,0.02h,Break Even,$-1.50,$598.50,$89144.00,143,$598.50
2024-07-19,17:47:00,19700.25,BUY,3,0.02h,Stop Loss,$36.00,$634.50,$89180.00,143,$634.50
2024-07-19,18:23:00,19708.75,SELL,3,0.02h,Stop Loss,$22.50,$657.00,$89202.50,143,$657.00
2024-07-19,18:52:00,19711.75,BUY,3,0.02h,Break Even,$-1.50,$655.50,$89201.00,143,$655.50
2024-07-19,19:33:00,19743.75,SELL,3,0.02h,Stop Loss,$24.00,$679.50,$89225.00,143,$679.50
2024-07-19,20:44:00,19703.5,BUY,3,0.02h,Stop Loss,$-9.00,$670.50,$89216.00,143,$670.50
2024-07-19,20:56:00,19700.5,SELL,3,0.02h,Break Even,$-1.50,$669.00,$89214.50,143,$669.00
,,,,,,,,,,,
2024-07-22,12:00:00,19897.5,BUY,3,0.02h,Break Even,$-1.50,$-1.50,$89213.00,144,$-1.50
2024-07-22,12:53:00,19913.5,SELL,3,0.02h,Break Even,$-1.50,$-3.00,$89211.50,144,$-3.00
2024-07-22,13:04:00,19924.75,BUY,3,0.02h,Stop Loss,$-9.00,$-12.00,$89202.50,144,$-12.00
2024-07-22,13:32:00,19901.0,SELL,3,0.02h,Stop Loss,$15.00,$3.00,$89217.50,144,$3.00
2024-07-22,13:39:00,19974.25,BUY,3,0.02h,Stop Loss,$6.00,$9.00,$89223.50,144,$9.00
2024-07-22,14:02:00,19945.5,SELL,3,0.02h,Stop Loss,$46.50,$55.50,$89270.00,144,$55.50
2024-07-22,14:29:00,19962.25,BUY,3,0.02h,Stop Loss,$13.50,$69.00,$89283.50,144,$69.00
2024-07-22,14:55:00,19964.25,SELL,3,0.02h,Break Even,$-1.50,$67.50,$89282.00,144,$67.50
2024-07-22,15:06:00,19987.75,BUY,3,0.02h,Stop Loss,$40.50,$108.00,$89322.50,144,$108.00
2024-07-22,15:10:00,19895.75,SELL,3,0.02h,Stop Loss,$7.50,$115.50,$89330.00,144,$115.50
2024-07-22,15:54:00,19859.5,BUY,3,0.02h,Stop Loss,$49.50,$165.00,$89379.50,144,$165.00
2024-07-22,17:58:00,19989.5,SELL,3,0.02h,Stop Loss,$22.50,$187.50,$89402.00,144,$187.50
2024-07-22,18:01:00,19998.75,BUY,3,0.02h,Stop Loss,$9.00,$196.50,$89411.00,144,$196.50
2024-07-22,18:44:00,20017.5,SELL,3,0.02h,Stop Loss,$-9.00,$187.50,$89402.00,144,$187.50
2024-07-22,18:54:00,20032.0,BUY,3,0.02h,Break Even,$-1.50,$186.00,$89400.50,144,$186.00
2024-07-22,18:56:00,20022.0,SELL,3,0.02h,Stop Loss,$49.50,$235.50,$89450.00,144,$235.50
2024-07-22,19:39:00,20014.75,BUY,3,0.02h,Stop Loss,$19.50,$255.00,$89469.50,144,$255.00
2024-07-22,19:55:00,19992.25,SELL,3,0.02h,Break Even,$-1.50,$253.50,$89468.00,144,$253.50
2024-07-22,20:58:00,19976.5,BUY,3,0.02h,Break Even,$-1.50,$252.00,$89466.50,144,$252.00
2024-07-22,22:48:00,19986.5,SELL,3,0.02h,Break Even,$-1.50,$250.50,$89465.00,144,$250.50
,,,,,,,,,,,
2024-07-23,12:01:00,19992.75,BUY,3,0.02h,Stop Loss,$-9.00,$-9.00,$89456.00,145,$-9.00
2024-07-23,12:06:00,19981.25,SELL,3,0.02h,Stop Loss,$-9.00,$-18.00,$89447.00,145,$-18.00
2024-07-23,12:48:00,19955.75,BUY,3,0.02h,Stop Loss,$39.00,$21.00,$89486.00,145,$21.00
2024-07-23,13:14:00,19958.75,SELL,3,0.02h,Stop Loss,$3.00,$24.00,$89489.00,145,$24.00
2024-07-23,13:19:00,19975.0,BUY,3,0.02h,Stop Loss,$-9.00,$15.00,$89480.00,145,$15.00
2024-07-23,13:29:00,19956.25,SELL,3,0.02h,Break Even,$-1.50,$13.50,$89478.50,145,$13.50
2024-07-23,13:38:00,19988.5,BUY,3,0.02h,Stop Loss,$12.00,$25.50,$89490.50,145,$25.50
2024-07-23,14:03:00,19972.25,SELL,3,0.02h,Stop Loss,$51.00,$76.50,$89541.50,145,$76.50
2024-07-23,14:08:00,20014.5,BUY,3,0.02h,Stop Loss,$33.00,$109.50,$89574.50,145,$109.50
2024-07-23,14:33:00,20006.75,SELL,3,0.02h,Stop Loss,$51.00,$160.50,$89625.50,145,$160.50
2024-07-23,15:02:00,19988.75,BUY,3,0.02h,Stop Loss,$-9.00,$151.50,$89616.50,145,$151.50
2024-07-23,15:45:00,20049.5,SELL,3,0.02h,Break Even,$-1.50,$150.00,$89615.00,145,$150.00
2024-07-23,17:23:00,19963.25,BUY,3,0.02h,Stop Loss,$9.00,$159.00,$89624.00,145,$159.00
2024-07-23,17:42:00,19953.25,SELL,3,0.02h,Stop Loss,$16.50,$175.50,$89640.50,145,$175.50
2024-07-23,17:47:00,19964.5,BUY,3,0.02h,Stop Loss,$21.00,$196.50,$89661.50,145,$196.50
2024-07-23,18:26:00,19968.75,SELL,3,0.02h,Stop Loss,$112.50,$309.00,$89774.00,145,$309.00
2024-07-23,18:39:00,19986.25,BUY,3,0.02h,Stop Loss,$4.50,$313.50,$89778.50,145,$313.50
2024-07-23,18:42:00,19967.75,SELL,3,0.02h,Stop Loss,$6.00,$319.50,$89784.50,145,$319.50
2024-07-23,19:00:00,19976.25,BUY,3,0.02h,Break Even,$-1.50,$318.00,$89783.00,145,$318.00
2024-07-23,19:19:00,19973.25,SELL,3,0.02h,Break Even,$-1.50,$316.50,$89781.50,145,$316.50
2024-07-23,19:22:00,19984.5,BUY,3,0.02h,Stop Loss,$34.50,$351.00,$89816.00,145,$351.00
2024-07-23,19:35:00,19974.25,SELL,3,0.02h,Break Even,$-1.50,$349.50,$89814.50,145,$349.50
2024-07-23,20:05:00,19986.75,BUY,3,0.02h,Stop Loss,$33.00,$382.50,$89847.50,145,$382.50
2024-07-23,20:13:00,19932.75,SELL,3,0.02h,Stop Loss,$12.00,$394.50,$89859.50,145,$394.50
2024-07-23,20:24:00,19960.0,BUY,3,0.02h,Stop Loss,$-9.00,$385.50,$89850.50,145,$385.50
2024-07-23,21:00:00,19944.75,SELL,3,1.02h,Stop Loss,$757.50,$1143.00,$90608.00,145,$1143.00
2024-07-23,22:40:00,19828.75,BUY,3,0.02h,Stop Loss,$28.50,$1171.50,$90636.50,145,$1171.50
2024-07-23,22:49:00,19823.5,SELL,3,0.02h,Break Even,$-1.50,$1170.00,$90635.00,145,$1170.00
2024-07-23,22:50:00,19827.0,BUY,3,0.02h,Break Even,$-1.50,$1168.50,$90633.50,145,$1168.50
2024-07-23,22:54:00,19823.25,SELL,3,0.02h,Break Even,$-1.50,$1167.00,$90632.00,145,$1167.00
,,,,,,,,,,,
2024-07-24,13:01:00,19636.25,BUY,3,0.02h,Break Even,$-1.50,$-1.50,$90630.50,146,$-1.50
2024-07-24,13:26:00,19629.25,SELL,3,0.02h,Stop Loss,$-9.00,$-10.50,$90621.50,146,$-10.50
2024-07-24,13:27:00,19641.25,BUY,3,0.02h,Stop Loss,$7.50,$-3.00,$90629.00,146,$-3.00
2024-07-24,13:31:00,19631.75,SELL,3,0.02h,Break Even,$-1.50,$-4.50,$90627.50,146,$-4.50
2024-07-24,13:32:00,19645.5,BUY,3,0.02h,Stop Loss,$18.00,$13.50,$90645.50,146,$13.50
2024-07-24,13:33:00,19629.25,SELL,3,0.02h,Stop Loss,$129.00,$142.50,$90774.50,146,$142.50
2024-07-24,15:38:00,19404.5,BUY,3,0.02h,Stop Loss,$4.50,$147.00,$90779.00,146,$147.00
2024-07-24,15:41:00,19391.0,SELL,3,0.02h,Stop Loss,$31.50,$178.50,$90810.50,146,$178.50
2024-07-24,16:23:00,19358.25,BUY,3,0.02h,Stop Loss,$-9.00,$169.50,$90801.50,146,$169.50
2024-07-24,16:24:00,19347.75,SELL,3,0.02h,Break Even,$-1.50,$168.00,$90800.00,146,$168.00
2024-07-24,17:07:00,19343.0,BUY,3,0.02h,Break Even,$-1.50,$166.50,$90798.50,146,$166.50
2024-07-24,17:31:00,19340.25,SELL,3,0.02h,Break Even,$-1.50,$165.00,$90797.00,146,$165.00
2024-07-24,17:36:00,19363.0,BUY,3,0.02h,Stop Loss,$-9.00,$156.00,$90788.00,146,$156.00
2024-07-24,17:49:00,19342.5,SELL,3,0.02h,Stop Loss,$10.50,$166.50,$90798.50,146,$166.50
2024-07-24,19:35:00,19267.75,BUY,3,0.02h,Stop Loss,$-9.00,$157.50,$90789.50,146,$157.50
2024-07-24,19:53:00,19243.5,SELL,3,0.02h,Stop Loss,$109.50,$267.00,$90899.00,146,$267.00
2024-07-24,20:10:00,19248.0,BUY,3,0.02h,Stop Loss,$40.50,$307.50,$90939.50,146,$307.50
2024-07-24,20:55:00,19259.25,SELL,3,0.02h,Break Even,$-1.50,$306.00,$90938.00,146,$306.00
2024-07-24,22:01:00,19270.75,BUY,3,0.02h,Stop Loss,$7.50,$313.50,$90945.50,146,$313.50
2024-07-24,22:30:00,19278.25,SELL,3,0.02h,Break Even,$-1.50,$312.00,$90944.00,146,$312.00
2024-07-24,22:35:00,19288.25,BUY,3,0.02h,Stop Loss,$-9.00,$303.00,$90935.00,146,$303.00
2024-07-24,22:48:00,19280.25,SELL,3,0.02h,Break Even,$-1.50,$301.50,$90933.50,146,$301.50
,,,,,,,,,,,
2024-07-25,12:36:00,19161.25,BUY,3,0.02h,Stop Loss,$136.50,$136.50,$91070.00,147,$136.50
2024-07-25,13:06:00,19189.0,SELL,3,0.02h,Stop Loss,$-9.00,$127.50,$91061.00,147,$127.50
2024-07-25,13:07:00,19208.25,BUY,3,0.02h,Stop Loss,$46.50,$174.00,$91107.50,147,$174.00
2024-07-25,13:31:00,19198.75,SELL,3,0.02h,Stop Loss,$37.50,$211.50,$91145.00,147,$211.50
2024-07-25,14:24:00,19029.5,BUY,3,0.02h,Stop Loss,$121.50,$333.00,$91266.50,147,$333.00
2024-07-25,15:28:00,19187.75,SELL,3,0.02h,Stop Loss,$13.50,$346.50,$91280.00,147,$346.50
2024-07-25,15:40:00,19222.5,BUY,3,0.02h,Stop Loss,$-9.00,$337.50,$91271.00,147,$337.50
2024-07-25,15:41:00,19201.5,SELL,3,0.02h,Stop Loss,$178.50,$516.00,$91449.50,147,$516.00
2024-07-25,15:54:00,19203.0,BUY,3,0.02h,Stop Loss,$34.50,$550.50,$91484.00,147,$550.50
2024-07-25,16:52:00,19304.25,SELL,3,0.02h,Break Even,$-1.50,$549.00,$91482.50,147,$549.00
2024-07-25,17:00:00,19333.5,BUY,3,0.02h,Stop Loss,$42.00,$591.00,$91524.50,147,$591.00
2024-07-25,17:16:00,19314.0,SELL,3,0.02h,Stop Loss,$22.50,$613.50,$91547.00,147,$613.50
2024-07-25,17:59:00,19300.0,BUY,3,0.02h,Stop Loss,$-9.00,$604.50,$91538.00,147,$604.50
2024-07-25,18:05:00,19256.25,SELL,3,0.02h,Stop Loss,$121.50,$726.00,$91659.50,147,$726.00
2024-07-25,18:35:00,19243.5,BUY,3,0.02h,Break Even,$-1.50,$724.50,$91658.00,147,$724.50
2024-07-25,18:37:00,19204.75,SELL,3,0.02h,Stop Loss,$9.00,$733.50,$91667.00,147,$733.50
2024-07-25,19:21:00,19155.0,BUY,3,0.02h,Stop Loss,$147.00,$880.50,$91814.00,147,$880.50
2024-07-25,19:38:00,19158.0,SELL,3,0.02h,Stop Loss,$70.50,$951.00,$91884.50,147,$951.00
2024-07-25,20:48:00,18983.5,BUY,3,0.02h,Stop Loss,$-9.00,$942.00,$91875.50,147,$942.00
2024-07-25,22:28:00,19013.25,SELL,3,0.02h,Stop Loss,$-9.00,$933.00,$91866.50,147,$933.00
2024-07-25,22:34:00,19022.75,BUY,3,0.02h,Break Even,$-1.50,$931.50,$91865.00,147,$931.50
2024-07-25,22:50:00,19015.75,SELL,3,0.02h,Break Even,$-1.50,$930.00,$91863.50,147,$930.00
,,,,,,,,,,,
2024-07-26,12:00:00,19212.5,BUY,3,0.02h,Break Even,$-1.50,$-1.50,$91862.00,148,$-1.50
2024-07-26,12:36:00,19177.5,SELL,3,0.02h,Break Even,$-1.50,$-3.00,$91860.50,148,$-3.00
2024-07-26,13:26:00,19181.75,BUY,3,0.02h,Break Even,$-1.50,$-4.50,$91859.00,148,$-4.50
2024-07-26,13:29:00,19160.0,SELL,3,0.02h,Stop Loss,$-9.00,$-13.50,$91850.00,148,$-13.50
2024-07-26,14:01:00,19164.5,BUY,3,0.02h,Stop Loss,$33.00,$19.50,$91883.00,148,$19.50
2024-07-26,14:07:00,19081.5,SELL,3,0.02h,Stop Loss,$15.00,$34.50,$91898.00,148,$34.50
2024-07-26,14:24:00,19126.25,BUY,3,0.02h,Stop Loss,$129.00,$163.50,$92027.00,148,$163.50
2024-07-26,14:33:00,19073.5,SELL,3,0.02h,Stop Loss,$54.00,$217.50,$92081.00,148,$217.50
2024-07-26,14:59:00,19119.0,BUY,3,0.02h,Stop Loss,$75.00,$292.50,$92156.00,148,$292.50
2024-07-26,15:19:00,19107.5,SELL,3,0.02h,Stop Loss,$24.00,$316.50,$92180.00,148,$316.50
2024-07-26,15:32:00,19133.25,BUY,3,0.02h,Stop Loss,$16.50,$333.00,$92196.50,148,$333.00
2024-07-26,15:37:00,19113.5,SELL,3,0.02h,Break Even,$-1.50,$331.50,$92195.00,148,$331.50
2024-07-26,15:38:00,19134.25,BUY,3,0.02h,Stop Loss,$22.50,$354.00,$92217.50,148,$354.00
2024-07-26,17:11:00,19271.25,SELL,3,0.02h,Stop Loss,$19.50,$373.50,$92237.00,148,$373.50
2024-07-26,17:13:00,19279.0,BUY,3,0.02h,Stop Loss,$9.00,$382.50,$92246.00,148,$382.50
2024-07-26,17:15:00,19264.5,SELL,3,0.02h,Stop Loss,$-9.00,$373.50,$92237.00,148,$373.50
2024-07-26,17:17:00,19278.0,BUY,3,0.02h,Stop Loss,$4.50,$378.00,$92241.50,148,$378.00
2024-07-26,17:35:00,19231.5,SELL,3,0.02h,Stop Loss,$243.00,$621.00,$92484.50,148,$621.00
2024-07-26,18:04:00,19210.0,BUY,3,0.02h,Break Even,$-1.50,$619.50,$92483.00,148,$619.50
2024-07-26,18:05:00,19192.0,SELL,3,0.02h,Stop Loss,$36.00,$655.50,$92519.00,148,$655.50
2024-07-26,18:08:00,19208.75,BUY,3,0.02h,Break Even,$-1.50,$654.00,$92517.50,148,$654.00
2024-07-26,18:20:00,19170.25,SELL,3,0.02h,Break Even,$-1.50,$652.50,$92516.00,148,$652.50
2024-07-26,19:23:00,19140.75,BUY,3,0.02h,Stop Loss,$24.00,$676.50,$92540.00,148,$676.50
2024-07-26,19:35:00,19116.75,SELL,3,0.02h,Stop Loss,$24.00,$700.50,$92564.00,148,$700.50
2024-07-26,19:42:00,19170.25,BUY,3,0.02h,Stop Loss,$-9.00,$691.50,$92555.00,148,$691.50
2024-07-26,19:54:00,19133.25,SELL,3,0.02h,Stop Loss,$70.50,$762.00,$92625.50,148,$762.00
2024-07-26,20:01:00,19174.25,BUY,3,0.02h,Break Even,$-1.50,$760.50,$92624.00,148,$760.50
2024-07-26,20:39:00,19177.5,SELL,3,0.02h,Stop Loss,$-9.00,$751.50,$92615.00,148,$751.50
,,,,,,,,,,,
2024-07-29,12:00:00,19297.0,BUY,3,0.02h,Stop Loss,$66.00,$66.00,$92681.00,149,$66.00
2024-07-29,12:52:00,19316.5,SELL,3,0.02h,Break Even,$-1.50,$64.50,$92679.50,149,$64.50
2024-07-29,13:40:00,19312.75,BUY,3,0.02h,Stop Loss,$36.00,$100.50,$92715.50,149,$100.50
2024-07-29,14:10:00,19307.75,SELL,3,0.02h,Stop Loss,$76.50,$177.00,$92792.00,149,$177.00
2024-07-29,14:42:00,19304.75,BUY,3,0.02h,Stop Loss,$43.50,$220.50,$92835.50,149,$220.50
2024-07-29,14:51:00,19252.25,SELL,3,0.02h,Stop Loss,$12.00,$232.50,$92847.50,149,$232.50
2024-07-29,15:45:00,19164.75,BUY,3,0.02h,Stop Loss,$70.50,$303.00,$92918.00,149,$303.00
2024-07-29,16:52:00,19297.25,SELL,3,0.02h,Break Even,$-1.50,$301.50,$92916.50,149,$301.50
2024-07-29,16:56:00,19328.5,BUY,3,0.02h,Stop Loss,$4.50,$306.00,$92921.00,149,$306.00
2024-07-29,16:59:00,19313.5,SELL,3,0.02h,Stop Loss,$46.50,$352.50,$92967.50,149,$352.50
2024-07-29,17:04:00,19319.25,BUY,3,0.02h,Stop Loss,$-9.00,$343.50,$92958.50,149,$343.50
2024-07-29,17:06:00,19310.0,SELL,3,0.02h,Stop Loss,$-9.00,$334.50,$92949.50,149,$334.50
2024-07-29,17:11:00,19324.75,BUY,3,0.02h,Stop Loss,$13.50,$348.00,$92963.00,149,$348.00
2024-07-29,17:21:00,19308.75,SELL,3,0.02h,Stop Loss,$40.50,$388.50,$93003.50,149,$388.50
2024-07-29,18:58:00,19213.75,BUY,3,0.02h,Stop Loss,$52.50,$441.00,$93056.00,149,$441.00
2024-07-29,19:53:00,19238.75,SELL,3,0.02h,Stop Loss,$43.50,$484.50,$93099.50,149,$484.50
2024-07-29,20:27:00,19210.5,BUY,3,0.02h,Stop Loss,$6.00,$490.50,$93105.50,149,$490.50
2024-07-29,20:53:00,19210.0,SELL,3,0.02h,Break Even,$-1.50,$489.00,$93104.00,149,$489.00
2024-07-29,21:00:00,19221.75,BUY,3,1.02h,Stop Loss,$55.50,$544.50,$93159.50,149,$544.50
2024-07-29,22:33:00,19217.5,SELL,3,0.02h,Stop Loss,$-9.00,$535.50,$93150.50,149,$535.50
,,,,,,,,,,,
2024-07-30,12:00:00,19261.75,BUY,3,0.02h,Break Even,$-1.50,$-1.50,$93149.00,150,$-1.50
2024-07-30,12:29:00,19257.25,SELL,3,0.02h,Stop Loss,$9.00,$7.50,$93158.00,150,$7.50
2024-07-30,12:35:00,19261.0,BUY,3,0.02h,Stop Loss,$-9.00,$-1.50,$93149.00,150,$-1.50
2024-07-30,12:36:00,19257.0,SELL,3,0.02h,Stop Loss,$-9.00,$-10.50,$93140.00,150,$-10.50
2024-07-30,12:37:00,19265.5,BUY,3,0.02h,Break Even,$-1.50,$-12.00,$93138.50,150,$-12.00
2024-07-30,13:10:00,19264.5,SELL,3,0.02h,Stop Loss,$-9.00,$-21.00,$93129.50,150,$-21.00
2024-07-30,13:11:00,19268.0,BUY,3,0.02h,Stop Loss,$-9.00,$-30.00,$93120.50,150,$-30.00
2024-07-30,13:46:00,19236.25,SELL,3,0.02h,Stop Loss,$15.00,$-15.00,$93135.50,150,$-15.00
2024-07-30,14:18:00,19229.0,BUY,3,0.02h,Break Even,$-1.50,$-16.50,$93134.00,150,$-16.50
2024-07-30,14:19:00,19199.0,SELL,3,0.02h,Stop Loss,$33.00,$16.50,$93167.00,150,$16.50
2024-07-30,16:10:00,18968.5,BUY,3,0.02h,Break Even,$-1.50,$15.00,$93165.50,150,$15.00
2024-07-30,16:22:00,18929.0,SELL,3,0.02h,Stop Loss,$67.50,$82.50,$93233.00,150,$82.50
2024-07-30,16:43:00,18945.25,BUY,3,0.02h,Break Even,$-1.50,$81.00,$93231.50,150,$81.00
2024-07-30,16:46:00,18915.5,SELL,3,0.02h,Stop Loss,$97.50,$178.50,$93329.00,150,$178.50
2024-07-30,17:15:00,18878.75,BUY,3,0.02h,Stop Loss,$34.50,$213.00,$93363.50,150,$213.00
2024-07-30,18:48:00,18962.75,SELL,3,0.02h,Stop Loss,$18.00,$231.00,$93381.50,150,$231.00
2024-07-30,19:24:00,18947.5,BUY,3,0.02h,Break Even,$-1.50,$229.50,$93380.00,150,$229.50
2024-07-30,19:32:00,18926.25,SELL,3,0.02h,Stop Loss,$40.50,$270.00,$93420.50,150,$270.00
2024-07-30,19:47:00,18936.5,BUY,3,0.02h,Stop Loss,$198.00,$468.00,$93618.50,150,$468.00
2024-07-30,20:01:00,18866.75,SELL,3,0.02h,Stop Loss,$571.50,$1039.50,$94190.00,150,$1039.50
2024-07-30,20:30:00,18839.5,BUY,3,0.02h,Stop Loss,$27.00,$1066.50,$94217.00,150,$1066.50
2024-07-30,20:56:00,18847.5,SELL,3,0.02h,Break Even,$-1.50,$1065.00,$94215.50,150,$1065.00
2024-07-30,22:01:00,18875.0,BUY,3,0.02h,Stop Loss,$88.50,$1153.50,$94304.00,150,$1153.50
2024-07-30,22:51:00,18969.0,SELL,3,0.02h,Break Even,$-1.50,$1152.00,$94302.50,150,$1152.00
,,,,,,,,,,,
2024-07-31,12:00:00,19251.75,BUY,3,0.02h,Stop Loss,$15.00,$15.00,$94317.50,151,$15.00
2024-07-31,13:33:00,19335.5,SELL,3,0.02h,Stop Loss,$27.00,$42.00,$94344.50,151,$42.00
2024-07-31,13:41:00,19398.25,BUY,3,0.02h,Stop Loss,$39.00,$81.00,$94383.50,151,$81.00
2024-07-31,13:47:00,19334.5,SELL,3,0.02h,Stop Loss,$-9.00,$72.00,$94374.50,151,$72.00
2024-07-31,13:50:00,19364.0,BUY,3,0.02h,Break Even,$-1.50,$70.50,$94373.00,151,$70.50
2024-07-31,14:49:00,19447.25,SELL,3,0.02h,Stop Loss,$42.00,$112.50,$94415.00,151,$112.50
2024-07-31,15:04:00,19456.5,BUY,3,0.02h,Stop Loss,$25.50,$138.00,$94440.50,151,$138.00
2024-07-31,15:48:00,19481.25,SELL,3,0.02h,Break Even,$-1.50,$136.50,$94439.00,151,$136.50
2024-07-31,15:49:00,19487.0,BUY,3,0.02h,Break Even,$-1.50,$135.00,$94437.50,151,$135.00
2024-07-31,15:51:00,19476.75,SELL,3,0.02h,Stop Loss,$61.50,$196.50,$94499.00,151,$196.50
2024-07-31,16:14:00,19475.25,BUY,3,0.02h,Stop Loss,$33.00,$229.50,$94532.00,151,$229.50
2024-07-31,16:25:00,19461.75,SELL,3,0.02h,Stop Loss,$97.50,$327.00,$94629.50,151,$327.00
2024-07-31,16:52:00,19452.75,BUY,3,0.02h,Break Even,$-1.50,$325.50,$94628.00,151,$325.50
2024-07-31,16:54:00,19440.25,SELL,3,0.02h,Stop Loss,$33.00,$358.50,$94661.00,151,$358.50
2024-07-31,17:06:00,19447.75,BUY,3,0.02h,Stop Loss,$9.00,$367.50,$94670.00,151,$367.50
2024-07-31,17:26:00,19436.0,SELL,3,0.02h,Stop Loss,$3.00,$370.50,$94673.00,151,$370.50
2024-07-31,17:51:00,19432.5,BUY,3,0.02h,Stop Loss,$-9.00,$361.50,$94664.00,151,$361.50
2024-07-31,19:14:00,19535.75,SELL,3,0.02h,Stop Loss,$45.00,$406.50,$94709.00,151,$406.50
2024-07-31,19:17:00,19555.25,BUY,3,0.02h,Stop Loss,$54.00,$460.50,$94763.00,151,$460.50
2024-07-31,19:19:00,19502.5,SELL,3,0.02h,Stop Loss,$166.50,$627.00,$94929.50,151,$627.00
2024-07-31,19:41:00,19515.25,BUY,3,0.02h,Stop Loss,$63.00,$690.00,$94992.50,151,$690.00
2024-07-31,19:53:00,19463.75,SELL,3,0.02h,Stop Loss,$55.50,$745.50,$95048.00,151,$745.50
2024-07-31,20:01:00,19550.0,BUY,3,0.02h,Stop Loss,$151.50,$897.00,$95199.50,151,$897.00
2024-07-31,22:32:00,19621.25,SELL,3,0.02h,Stop Loss,$-9.00,$888.00,$95190.50,151,$888.00
2024-07-31,22:37:00,19637.0,BUY,3,0.02h,Break Even,$-1.50,$886.50,$95189.00,151,$886.50
2024-07-31,22:40:00,19609.5,SELL,3,0.02h,Break Even,$-1.50,$885.00,$95187.50,151,$885.00
2024-07-31,22:53:00,19638.0,BUY,3,0.02h,Break Even,$-1.50,$883.50,$95186.00,151,$883.50
,,,,,,,,,,,
2024-08-01,12:00:00,19574.25,SELL,3,0.02h,Break Even,$-1.50,$-1.50,$95184.50,152,$-1.50
2024-08-01,12:19:00,19613.0,BUY,3,0.02h,Stop Loss,$4.50,$3.00,$95189.00,152,$3.00
2024-08-01,12:40:00,19608.5,SELL,3,0.02h,Stop Loss,$54.00,$57.00,$95243.00,152,$57.00
2024-08-01,13:40:00,19563.25,BUY,3,0.02h,Stop Loss,$123.00,$180.00,$95366.00,152,$180.00
2024-08-01,14:06:00,19578.75,SELL,3,0.02h,Stop Loss,$84.00,$264.00,$95450.00,152,$264.00
2024-08-01,16:08:00,19227.75,BUY,3,0.02h,Stop Loss,$-9.00,$255.00,$95441.00,152,$255.00
2024-08-01,16:21:00,19175.5,SELL,3,0.02h,Stop Loss,$40.50,$295.50,$95481.50,152,$295.50
2024-08-01,17:58:00,18981.5,BUY,3,0.02h,Stop Loss,$81.00,$376.50,$95562.50,152,$376.50
2024-08-01,18:13:00,18950.0,SELL,3,0.02h,Break Even,$-1.50,$375.00,$95561.00,152,$375.00
2024-08-01,19:02:00,18915.25,BUY,3,0.02h,Stop Loss,$43.50,$418.50,$95604.50,152,$418.50
2024-08-01,20:03:00,18953.0,SELL,3,0.02h,Stop Loss,$180.00,$598.50,$95784.50,152,$598.50
2024-08-01,20:39:00,18929.25,BUY,3,0.02h,Stop Loss,$3.00,$601.50,$95787.50,152,$601.50
2024-08-01,20:41:00,18908.5,SELL,3,0.02h,Stop Loss,$45.00,$646.50,$95832.50,152,$646.50
2024-08-01,20:48:00,18928.75,BUY,3,0.02h,Break Even,$-1.50,$645.00,$95831.00,152,$645.00
2024-08-01,22:09:00,18925.25,SELL,3,0.02h,Stop Loss,$43.50,$688.50,$95874.50,152,$688.50
2024-08-01,22:29:00,18938.0,BUY,3,0.02h,Stop Loss,$3.00,$691.50,$95877.50,152,$691.50
2024-08-01,22:39:00,18901.5,SELL,3,0.02h,Stop Loss,$108.00,$799.50,$95985.50,152,$799.50
,,,,,,,,,,,
2024-08-02,12:54:00,18612.0,BUY,3,0.02h,Stop Loss,$130.50,$130.50,$96116.00,153,$130.50
2024-08-02,13:02:00,18573.0,SELL,3,0.02h,Stop Loss,$99.00,$229.50,$96215.00,153,$229.50
2024-08-02,13:09:00,18595.25,BUY,3,0.02h,Stop Loss,$24.00,$253.50,$96239.00,153,$253.50
2024-08-02,13:34:00,18562.75,SELL,3,0.02h,Stop Loss,$105.00,$358.50,$96344.00,153,$358.50
2024-08-02,13:40:00,18719.25,BUY,3,0.02h,Stop Loss,$210.00,$568.50,$96554.00,153,$568.50
2024-08-02,13:52:00,18605.25,SELL,3,0.02h,Stop Loss,$100.50,$669.00,$96654.50,153,$669.00
2024-08-02,14:30:00,18486.75,BUY,3,0.02h,Stop Loss,$201.00,$870.00,$96855.50,153,$870.00
2024-08-02,14:36:00,18457.25,SELL,3,0.02h,Stop Loss,$96.00,$966.00,$96951.50,153,$966.00
2024-08-02,14:47:00,18499.5,BUY,3,0.02h,Stop Loss,$145.50,$1111.50,$97097.00,153,$1111.50
2024-08-02,14:57:00,18453.0,SELL,3,0.02h,Stop Loss,$105.00,$1216.50,$97202.00,153,$1216.50
2024-08-02,15:13:00,18476.75,BUY,3,0.02h,Stop Loss,$7.50,$1224.00,$97209.50,153,$1224.00
2024-08-02,15:21:00,18432.5,SELL,3,0.02h,Break Even,$-1.50,$1222.50,$97208.00,153,$1222.50
2024-08-02,15:24:00,18493.25,BUY,3,0.02h,Stop Loss,$63.00,$1285.50,$97271.00,153,$1285.50
2024-08-02,16:12:00,18535.5,SELL,3,0.02h,Stop Loss,$66.00,$1351.50,$97337.00,153,$1351.50
2024-08-02,16:22:00,18607.5,BUY,3,0.02h,Break Even,$-1.50,$1350.00,$97335.50,153,$1350.00
2024-08-02,16:38:00,18563.25,SELL,3,0.02h,Break Even,$-1.50,$1348.50,$97334.00,153,$1348.50
2024-08-02,16:41:00,18608.0,BUY,3,0.02h,Stop Loss,$130.50,$1479.00,$97464.50,153,$1479.00
2024-08-02,16:48:00,18558.75,SELL,3,0.02h,Stop Loss,$7.50,$1486.50,$97472.00,153,$1486.50
2024-08-02,17:15:00,18550.25,BUY,3,0.02h,Stop Loss,$28.50,$1515.00,$97500.50,153,$1515.00
2024-08-02,17:23:00,18509.75,SELL,3,0.02h,Stop Loss,$36.00,$1551.00,$97536.50,153,$1551.00
2024-08-02,17:59:00,18484.5,BUY,3,0.02h,Stop Loss,$39.00,$1590.00,$97575.50,153,$1590.00
2024-08-02,18:15:00,18474.25,SELL,3,0.02h,Stop Loss,$34.50,$1624.50,$97610.00,153,$1624.50
2024-08-02,18:23:00,18501.25,BUY,3,0.02h,Stop Loss,$57.00,$1681.50,$97667.00,153,$1681.50
2024-08-02,18:59:00,18514.75,SELL,3,0.02h,Stop Loss,$85.50,$1767.00,$97752.50,153,$1767.00
2024-08-02,19:04:00,18532.0,BUY,3,0.02h,Break Even,$-1.50,$1765.50,$97751.00,153,$1765.50
2024-08-02,19:05:00,18520.75,SELL,3,0.02h,Stop Loss,$76.50,$1842.00,$97827.50,153,$1842.00
2024-08-02,19:15:00,18540.25,BUY,3,0.02h,Stop Loss,$3.00,$1845.00,$97830.50,153,$1845.00
2024-08-02,19:39:00,18504.5,SELL,3,0.02h,Stop Loss,$85.50,$1930.50,$97916.00,153,$1930.50
2024-08-02,19:56:00,18555.25,BUY,3,0.02h,Stop Loss,$129.00,$2059.50,$98045.00,153,$2059.50
2024-08-02,20:32:00,18543.25,SELL,3,0.02h,Stop Loss,$9.00,$2068.50,$98054.00,153,$2068.50
,,,,,,,,,,,
2024-08-05,12:57:00,17526.5,BUY,3,0.02h,Stop Loss,$178.50,$178.50,$98232.50,154,$178.50
2024-08-05,13:30:00,17564.25,SELL,3,0.02h,Stop Loss,$309.00,$487.50,$98541.50,154,$487.50
2024-08-05,13:34:00,17681.0,BUY,3,0.02h,Stop Loss,$148.50,$636.00,$98690.00,154,$636.00
2024-08-05,14:28:00,17906.75,SELL,3,0.02h,Stop Loss,$135.00,$771.00,$98825.00,154,$771.00
2024-08-05,14:37:00,17968.5,BUY,3,0.02h,Stop Loss,$78.00,$849.00,$98903.00,154,$849.00
2024-08-05,15:01:00,17918.0,SELL,3,0.02h,Stop Loss,$151.50,$1000.50,$99054.50,154,$1000.50
2024-08-05,15:08:00,18018.75,BUY,3,0.02h,Stop Loss,$601.50,$1602.00,$99656.00,154,$1602.00
2024-08-05,15:44:00,18080.75,SELL,3,0.02h,Stop Loss,$52.50,$1654.50,$99708.50,154,$1654.50
2024-08-05,16:04:00,18151.75,BUY,3,0.02h,Break Even,$-1.50,$1653.00,$99707.00,154,$1653.00
2024-08-05,16:38:00,18139.5,SELL,3,0.02h,Stop Loss,$48.00,$1701.00,$99755.00,154,$1701.00
2024-08-05,17:16:00,18104.25,BUY,3,0.02h,Stop Loss,$24.00,$1725.00,$99779.00,154,$1725.00
2024-08-05,17:50:00,18101.0,SELL,3,0.02h,Stop Loss,$31.50,$1756.50,$99810.50,154,$1756.50
2024-08-05,18:31:00,18052.5,BUY,3,0.02h,Stop Loss,$19.50,$1776.00,$99830.00,154,$1776.00
2024-08-05,18:39:00,17999.75,SELL,3,0.02h,Stop Loss,$19.50,$1795.50,$99849.50,154,$1795.50
2024-08-05,19:05:00,17996.0,BUY,3,0.02h,Stop Loss,$-9.00,$1786.50,$99840.50,154,$1786.50
2024-08-05,19:10:00,17926.75,SELL,3,0.02h,Break Even,$-1.50,$1785.00,$99839.00,154,$1785.00
2024-08-05,19:23:00,17948.0,BUY,3,0.02h,Stop Loss,$40.50,$1825.50,$99879.50,154,$1825.50
2024-08-05,19:45:00,17932.75,SELL,3,0.02h,Stop Loss,$25.50,$1851.00,$99905.00,154,$1851.00
2024-08-05,19:54:00,17968.25,BUY,3,0.02h,Break Even,$-1.50,$1849.50,$99903.50,154,$1849.50
2024-08-05,22:46:00,18215.0,SELL,3,0.02h,Stop Loss,$9.00,$1858.50,$99912.50,154,$1858.50
,,,,,,,,,,,
2024-08-06,13:20:00,18102.25,BUY,3,0.02h,Stop Loss,$7.50,$7.50,$99920.00,155,$7.50
2024-08-06,13:25:00,18082.25,SELL,3,0.02h,Stop Loss,$3.00,$10.50,$99923.00,155,$10.50
2024-08-06,13:26:00,18105.75,BUY,3,0.02h,Stop Loss,$111.00,$121.50,$100034.00,155,$121.50
2024-08-06,13:38:00,18047.25,SELL,3,0.02h,Stop Loss,$21.00,$142.50,$100055.00,155,$142.50
2024-08-06,13:54:00,18117.25,BUY,3,0.02h,Stop Loss,$127.50,$270.00,$100182.50,155,$270.00
2024-08-06,14:31:00,18133.5,SELL,3,0.02h,Stop Loss,$10.50,$280.50,$100193.00,155,$280.50
2024-08-06,14:37:00,18193.5,BUY,3,0.02h,Stop Loss,$159.00,$439.50,$100352.00,155,$439.50
2024-08-06,15:14:00,18280.0,SELL,3,0.02h,Stop Loss,$82.50,$522.00,$100434.50,155,$522.00
2024-08-06,15:44:00,18250.25,BUY,3,0.02h,Stop Loss,$63.00,$585.00,$100497.50,155,$585.00
2024-08-06,16:27:00,18330.25,SELL,3,0.02h,Stop Loss,$9.00,$594.00,$100506.50,155,$594.00
2024-08-06,16:42:00,18358.75,BUY,3,0.02h,Stop Loss,$30.00,$624.00,$100536.50,155,$624.00
2024-08-06,17:19:00,18408.0,SELL,3,0.02h,Stop Loss,$24.00,$648.00,$100560.50,155,$648.00
2024-08-06,17:30:00,18422.75,BUY,3,0.02h,Stop Loss,$61.50,$709.50,$100622.00,155,$709.50
2024-08-06,17:44:00,18402.75,SELL,3,0.02h,Stop Loss,$15.00,$724.50,$100637.00,155,$724.50
2024-08-06,17:54:00,18428.0,BUY,3,0.02h,Stop Loss,$33.00,$757.50,$100670.00,155,$757.50
2024-08-06,18:04:00,18408.0,SELL,3,0.02h,Break Even,$-1.50,$756.00,$100668.50,155,$756.00
2024-08-06,18:18:00,18425.5,BUY,3,0.02h,Stop Loss,$69.00,$825.00,$100737.50,155,$825.00
2024-08-06,18:58:00,18442.75,SELL,3,0.02h,Stop Loss,$187.50,$1012.50,$100925.00,155,$1012.50
2024-08-06,19:26:00,18366.0,BUY,3,0.02h,Break Even,$-1.50,$1011.00,$100923.50,155,$1011.00
2024-08-06,19:37:00,18330.5,SELL,3,0.02h,Stop Loss,$6.00,$1017.00,$100929.50,155,$1017.00
2024-08-06,20:21:00,18265.5,BUY,3,0.02h,Break Even,$-1.50,$1015.50,$100928.00,155,$1015.50
2024-08-06,20:33:00,18181.25,SELL,3,0.02h,Stop Loss,$-9.00,$1006.50,$100919.00,155,$1006.50
2024-08-06,22:21:00,18126.0,BUY,3,0.02h,Stop Loss,$60.00,$1066.50,$100979.00,155,$1066.50
2024-08-06,22:37:00,18085.0,SELL,3,0.02h,Break Even,$-1.50,$1065.00,$100977.50,155,$1065.00
2024-08-06,22:56:00,18100.0,BUY,3,0.02h,Break Even,$-1.50,$1063.50,$100976.00,155,$1063.50
,,,,,,,,,,,
2024-08-07,12:56:00,18416.5,SELL,3,0.02h,Stop Loss,$-9.00,$-9.00,$100967.00,156,$-9.00
2024-08-07,13:01:00,18436.0,BUY,3,0.02h,Stop Loss,$9.00,$0.00,$100976.00,156,$0.00
2024-08-07,13:04:00,18425.5,SELL,3,0.02h,Stop Loss,$4.50,$4.50,$100980.50,156,$4.50
2024-08-07,13:10:00,18438.0,BUY,3,0.02h,Break Even,$-1.50,$3.00,$100979.00,156,$3.00
2024-08-07,13:13:00,18418.5,SELL,3,0.02h,Stop Loss,$52.50,$55.50,$101031.50,156,$55.50
2024-08-07,13:26:00,18433.75,BUY,3,0.02h,Stop Loss,$16.50,$72.00,$101048.00,156,$72.00
2024-08-07,14:08:00,18503.25,SELL,3,0.02h,Stop Loss,$12.00,$84.00,$101060.00,156,$84.00
2024-08-07,14:10:00,18533.5,BUY,3,0.02h,Stop Loss,$52.50,$136.50,$101112.50,156,$136.50
2024-08-07,14:18:00,18482.75,SELL,3,0.02h,Stop Loss,$235.50,$372.00,$101348.00,156,$372.00
2024-08-07,14:45:00,18503.25,BUY,3,0.02h,Stop Loss,$120.00,$492.00,$101468.00,156,$492.00
2024-08-07,15:14:00,18491.75,SELL,3,0.02h,Stop Loss,$49.50,$541.50,$101517.50,156,$541.50
2024-08-07,16:22:00,18382.0,BUY,3,0.02h,Stop Loss,$22.50,$564.00,$101540.00,156,$564.00
2024-08-07,16:43:00,18351.5,SELL,3,0.02h,Stop Loss,$115.50,$679.50,$101655.50,156,$679.50
2024-08-07,17:38:00,18232.0,BUY,3,0.02h,Stop Loss,$69.00,$748.50,$101724.50,156,$748.50
2024-08-07,17:42:00,18196.0,SELL,3,0.02h,Stop Loss,$27.00,$775.50,$101751.50,156,$775.50
2024-08-07,18:30:00,18080.0,BUY,3,0.02h,Stop Loss,$-9.00,$766.50,$101742.50,156,$766.50
2024-08-07,18:32:00,18049.5,SELL,3,0.02h,Stop Loss,$111.00,$877.50,$101853.50,156,$877.50
2024-08-07,19:03:00,18085.25,BUY,3,0.02h,Stop Loss,$114.00,$991.50,$101967.50,156,$991.50
2024-08-07,19:27:00,18077.0,SELL,3,0.02h,Stop Loss,$64.50,$1056.00,$102032.00,156,$1056.00
2024-08-07,19:38:00,18103.25,BUY,3,0.02h,Stop Loss,$54.00,$1110.00,$102086.00,156,$1110.00
2024-08-07,19:41:00,18076.0,SELL,3,0.02h,Stop Loss,$19.50,$1129.50,$102105.50,156,$1129.50
2024-08-07,22:19:00,17891.0,BUY,3,0.02h,Stop Loss,$42.00,$1171.50,$102147.50,156,$1171.50
2024-08-07,22:47:00,17897.5,SELL,3,0.02h,Stop Loss,$40.50,$1212.00,$102188.00,156,$1212.00
2024-08-07,22:59:00,17906.75,BUY,3,0.02h,Stop Loss,$-9.00,$1203.00,$102179.00,156,$1203.00
,,,,,,,,,,,
2024-08-08,12:27:00,17966.5,SELL,3,0.02h,Break Even,$-1.50,$-1.50,$102177.50,157,$-1.50
2024-08-08,12:29:00,17981.0,BUY,3,0.02h,Stop Loss,$63.00,$61.50,$102240.50,157,$61.50
2024-08-08,13:38:00,18163.75,SELL,3,0.02h,Stop Loss,$103.50,$165.00,$102344.00,157,$165.00
2024-08-08,13:59:00,18174.5,BUY,3,0.02h,Stop Loss,$214.50,$379.50,$102558.50,157,$379.50
2024-08-08,15:08:00,18383.5,SELL,3,0.02h,Stop Loss,$39.00,$418.50,$102597.50,157,$418.50
2024-08-08,15:25:00,18395.75,BUY,3,0.02h,Stop Loss,$10.50,$429.00,$102608.00,157,$429.00
2024-08-08,15:42:00,18377.75,SELL,3,0.02h,Stop Loss,$19.50,$448.50,$102627.50,157,$448.50
2024-08-08,15:43:00,18389.25,BUY,3,0.02h,Stop Loss,$-9.00,$439.50,$102618.50,157,$439.50
2024-08-08,15:47:00,18376.0,SELL,3,0.02h,Break Even,$-1.50,$438.00,$102617.00,157,$438.00
2024-08-08,15:55:00,18396.75,BUY,3,0.02h,Stop Loss,$31.50,$469.50,$102648.50,157,$469.50
2024-08-08,16:31:00,18408.5,SELL,3,0.02h,Stop Loss,$132.00,$601.50,$102780.50,157,$601.50
2024-08-08,16:53:00,18411.0,BUY,3,0.02h,Stop Loss,$51.00,$652.50,$102831.50,157,$652.50
2024-08-08,17:03:00,18381.25,SELL,3,0.02h,Stop Loss,$61.50,$714.00,$102893.00,157,$714.00
2024-08-08,17:13:00,18412.0,BUY,3,0.02h,Stop Loss,$61.50,$775.50,$102954.50,157,$775.50
2024-08-08,18:28:00,18498.75,SELL,3,0.02h,Break Even,$-1.50,$774.00,$102953.00,157,$774.00
2024-08-08,19:13:00,18506.0,BUY,3,0.02h,Stop Loss,$6.00,$780.00,$102959.00,157,$780.00
2024-08-08,19:18:00,18484.75,SELL,3,0.02h,Stop Loss,$70.50,$850.50,$103029.50,157,$850.50
2024-08-08,19:23:00,18501.0,BUY,3,0.02h,Stop Loss,$21.00,$871.50,$103050.50,157,$871.50
2024-08-08,19:29:00,18463.25,SELL,3,0.02h,Stop Loss,$127.50,$999.00,$103178.00,157,$999.00
2024-08-08,19:44:00,18495.0,BUY,3,0.02h,Stop Loss,$75.00,$1074.00,$103253.00,157,$1074.00
2024-08-08,20:53:00,18563.0,SELL,3,0.02h,Break Even,$-1.50,$1072.50,$103251.50,157,$1072.50
2024-08-08,20:56:00,18566.0,BUY,3,0.02h,Stop Loss,$-9.00,$1063.50,$103242.50,157,$1063.50
2024-08-08,21:00:00,18557.5,SELL,3,1.02h,Stop Loss,$114.00,$1177.50,$103356.50,157,$1177.50
2024-08-08,22:03:00,18573.75,BUY,3,0.02h,Break Even,$-1.50,$1176.00,$103355.00,157,$1176.00
2024-08-08,22:06:00,18555.0,SELL,3,0.02h,Break Even,$-1.50,$1174.50,$103353.50,157,$1174.50
2024-08-08,22:25:00,18552.75,BUY,3,0.02h,Stop Loss,$9.00,$1183.50,$103362.50,157,$1183.50
2024-08-08,22:42:00,18545.25,SELL,3,0.02h,Break Even,$-1.50,$1182.00,$103361.00,157,$1182.00
2024-08-08,23:00:00,18561.5,BUY,3,13.00h,Stop Loss,$-9.00,$1173.00,$103352.00,157,$1173.00
,,,,,,,,,,,
2024-08-09,12:00:00,18525.25,SELL,3,0.02h,Stop Loss,$49.50,$49.50,$103401.50,158,$49.50
2024-08-09,12:53:00,18439.25,BUY,3,0.02h,Break Even,$-1.50,$48.00,$103400.00,158,$48.00
2024-08-09,12:54:00,18429.5,SELL,3,0.02h,Stop Loss,$108.00,$156.00,$103508.00,158,$156.00
2024-08-09,12:57:00,18440.75,BUY,3,0.02h,Stop Loss,$-9.00,$147.00,$103499.00,158,$147.00
2024-08-09,13:00:00,18424.0,SELL,3,0.02h,Stop Loss,$67.50,$214.50,$103566.50,158,$214.50
2024-08-09,13:07:00,18439.75,BUY,3,0.02h,Break Even,$-1.50,$213.00,$103565.00,158,$213.00
2024-08-09,13:25:00,18429.25,SELL,3,0.02h,Stop Loss,$-9.00,$204.00,$103556.00,158,$204.00
2024-08-09,13:29:00,18448.0,BUY,3,0.02h,Stop Loss,$28.50,$232.50,$103584.50,158,$232.50
2024-08-09,13:47:00,18437.0,SELL,3,0.02h,Break Even,$-1.50,$231.00,$103583.00,158,$231.00
2024-08-09,13:54:00,18475.25,BUY,3,0.02h,Stop Loss,$45.00,$276.00,$103628.00,158,$276.00
2024-08-09,13:57:00,18437.5,SELL,3,0.02h,Stop Loss,$46.50,$322.50,$103674.50,158,$322.50
2024-08-09,14:05:00,18490.5,BUY,3,0.02h,Break Even,$-1.50,$321.00,$103673.00,158,$321.00
2024-08-09,14:30:00,18495.25,SELL,3,0.02h,Stop Loss,$129.00,$450.00,$103802.00,158,$450.00
2024-08-09,14:48:00,18501.0,BUY,3,0.02h,Stop Loss,$46.50,$496.50,$103848.50,158,$496.50
2024-08-09,15:25:00,18535.0,SELL,3,0.02h,Stop Loss,$-9.00,$487.50,$103839.50,158,$487.50
2024-08-09,15:27:00,18546.5,BUY,3,0.02h,Stop Loss,$40.50,$528.00,$103880.00,158,$528.00
2024-08-09,15:29:00,18531.5,SELL,3,0.02h,Stop Loss,$127.50,$655.50,$104007.50,158,$655.50
2024-08-09,15:50:00,18530.0,BUY,3,0.02h,Stop Loss,$7.50,$663.00,$104015.00,158,$663.00
2024-08-09,15:57:00,18481.25,SELL,3,0.02h,Stop Loss,$30.00,$693.00,$104045.00,158,$693.00
2024-08-09,16:30:00,18481.25,BUY,3,0.02h,Stop Loss,$105.00,$798.00,$104150.00,158,$798.00
2024-08-09,17:51:00,18619.25,SELL,3,0.02h,Break Even,$-1.50,$796.50,$104148.50,158,$796.50
2024-08-09,18:41:00,18601.0,BUY,3,0.02h,Stop Loss,$3.00,$799.50,$104151.50,158,$799.50
2024-08-09,18:53:00,18584.5,SELL,3,0.02h,Stop Loss,$73.50,$873.00,$104225.00,158,$873.00
2024-08-09,19:08:00,18600.0,BUY,3,0.02h,Stop Loss,$19.50,$892.50,$104244.50,158,$892.50
2024-08-09,19:54:00,18596.5,SELL,3,0.02h,Stop Loss,$100.50,$993.00,$104345.00,158,$993.00
2024-08-09,20:04:00,18617.75,BUY,3,0.02h,Break Even,$-1.50,$991.50,$104343.50,158,$991.50
2024-08-09,20:22:00,18608.5,SELL,3,0.02h,Stop Loss,$-9.00,$982.50,$104334.50,158,$982.50
,,,,,,,,,,,
2024-08-12,12:00:00,18664.5,BUY,3,0.02h,Break Even,$-1.50,$-1.50,$104333.00,159,$-1.50
2024-08-12,12:43:00,18666.75,SELL,3,0.02h,Stop Loss,$15.00,$13.50,$104348.00,159,$13.50
2024-08-12,13:03:00,18671.0,BUY,3,0.02h,Stop Loss,$-9.00,$4.50,$104339.00,159,$4.50
2024-08-12,13:10:00,18655.0,SELL,3,0.02h,Stop Loss,$-9.00,$-4.50,$104330.00,159,$-4.50
2024-08-12,13:27:00,18663.0,BUY,3,0.02h,Break Even,$-1.50,$-6.00,$104328.50,159,$-6.00
2024-08-12,13:29:00,18639.25,SELL,3,0.02h,Break Even,$-1.50,$-7.50,$104327.00,159,$-7.50
2024-08-12,14:07:00,18605.25,BUY,3,0.02h,Stop Loss,$58.50,$51.00,$104385.50,159,$51.00
2024-08-12,15:23:00,18682.0,SELL,3,0.02h,Stop Loss,$247.50,$298.50,$104633.00,159,$298.50
2024-08-12,15:51:00,18670.75,BUY,3,0.02h,Stop Loss,$81.00,$379.50,$104714.00,159,$379.50
2024-08-12,16:19:00,18686.25,SELL,3,0.02h,Break Even,$-1.50,$378.00,$104712.50,159,$378.00
2024-08-12,16:26:00,18699.75,BUY,3,0.02h,Stop Loss,$4.50,$382.50,$104717.00,159,$382.50
2024-08-12,16:29:00,18685.25,SELL,3,0.02h,Break Even,$-1.50,$381.00,$104715.50,159,$381.00
2024-08-12,16:30:00,18694.75,BUY,3,0.02h,Stop Loss,$22.50,$403.50,$104738.00,159,$403.50
2024-08-12,16:37:00,18688.75,SELL,3,0.02h,Stop Loss,$13.50,$417.00,$104751.50,159,$417.00
2024-08-12,16:40:00,18709.75,BUY,3,0.02h,Stop Loss,$16.50,$433.50,$104768.00,159,$433.50
2024-08-12,16:43:00,18686.5,SELL,3,0.02h,Stop Loss,$-9.00,$424.50,$104759.00,159,$424.50
2024-08-12,16:44:00,18698.75,BUY,3,0.02h,Break Even,$-1.50,$423.00,$104757.50,159,$423.00
2024-08-12,16:53:00,18686.25,SELL,3,0.02h,Break Even,$-1.50,$421.50,$104756.00,159,$421.50
2024-08-12,17:20:00,18664.0,BUY,3,0.02h,Stop Loss,$42.00,$463.50,$104798.00,159,$463.50
2024-08-12,17:39:00,18642.75,SELL,3,0.02h,Stop Loss,$-9.00,$454.50,$104789.00,159,$454.50
2024-08-12,18:17:00,18627.0,BUY,3,0.02h,Break Even,$-1.50,$453.00,$104787.50,159,$453.00
2024-08-12,18:31:00,18608.75,SELL,3,0.02h,Break Even,$-1.50,$451.50,$104786.00,159,$451.50
2024-08-12,18:37:00,18629.25,BUY,3,0.02h,Stop Loss,$4.50,$456.00,$104790.50,159,$456.00
2024-08-12,19:09:00,18619.25,SELL,3,0.02h,Stop Loss,$19.50,$475.50,$104810.00,159,$475.50
2024-08-12,19:13:00,18635.0,BUY,3,0.02h,Stop Loss,$-9.00,$466.50,$104801.00,159,$466.50
2024-08-12,19:14:00,18617.0,SELL,3,0.02h,Stop Loss,$4.50,$471.00,$104805.50,159,$471.00
2024-08-12,19:26:00,18631.25,BUY,3,0.02h,Stop Loss,$25.50,$496.50,$104831.00,159,$496.50
2024-08-12,19:30:00,18620.5,SELL,3,0.02h,Stop Loss,$-9.00,$487.50,$104822.00,159,$487.50
2024-08-12,19:31:00,18631.5,BUY,3,0.02h,Break Even,$-1.50,$486.00,$104820.50,159,$486.00
2024-08-12,19:33:00,18623.75,SELL,3,0.02h,Stop Loss,$18.00,$504.00,$104838.50,159,$504.00
2024-08-12,19:59:00,18618.25,BUY,3,0.02h,Stop Loss,$156.00,$660.00,$104994.50,159,$660.00
2024-08-12,20:30:00,18631.5,SELL,3,0.02h,Break Even,$-1.50,$658.50,$104993.00,159,$658.50
2024-08-12,22:01:00,18645.0,BUY,3,0.02h,Stop Loss,$6.00,$664.50,$104999.00,159,$664.50
2024-08-12,22:32:00,18636.25,SELL,3,0.02h,Stop Loss,$16.50,$681.00,$105015.50,159,$681.00
2024-08-12,22:51:00,18641.5,BUY,3,0.02h,Break Even,$-1.50,$679.50,$105014.00,159,$679.50
2024-08-12,22:56:00,18634.5,SELL,3,0.02h,Stop Loss,$-9.00,$670.50,$105005.00,159,$670.50
2024-08-12,22:57:00,18636.5,BUY,3,0.02h,Break Even,$-1.50,$669.00,$105003.50,159,$669.00
,,,,,,,,,,,
2024-08-13,13:17:00,18800.0,SELL,3,0.02h,Break Even,$-1.50,$-1.50,$105002.00,160,$-1.50
2024-08-13,13:19:00,18813.5,BUY,3,0.02h,Stop Loss,$-9.00,$-10.50,$104993.00,160,$-10.50
2024-08-13,14:19:00,18878.0,SELL,3,0.02h,Break Even,$-1.50,$-12.00,$104991.50,160,$-12.00
2024-08-13,14:27:00,18902.75,BUY,3,0.02h,Stop Loss,$28.50,$16.50,$105020.00,160,$16.50
2024-08-13,14:32:00,18873.5,SELL,3,0.02h,Stop Loss,$12.00,$28.50,$105032.00,160,$28.50
2024-08-13,14:38:00,18903.0,BUY,3,0.02h,Stop Loss,$-9.00,$19.50,$105023.00,160,$19.50
2024-08-13,17:27:00,19067.0,SELL,3,0.02h,Stop Loss,$43.50,$63.00,$105066.50,160,$63.00
2024-08-13,17:32:00,19078.5,BUY,3,0.02h,Stop Loss,$13.50,$76.50,$105080.00,160,$76.50
2024-08-13,17:34:00,19065.5,SELL,3,0.02h,Stop Loss,$49.50,$126.00,$105129.50,160,$126.00
2024-08-13,17:44:00,19079.0,BUY,3,0.02h,Break Even,$-1.50,$124.50,$105128.00,160,$124.50
2024-08-13,17:47:00,19015.75,SELL,3,0.02h,Stop Loss,$10.50,$135.00,$105138.50,160,$135.00
2024-08-13,18:06:00,19059.0,BUY,3,0.02h,Stop Loss,$24.00,$159.00,$105162.50,160,$159.00
2024-08-13,18:19:00,19045.0,SELL,3,0.02h,Break Even,$-1.50,$157.50,$105161.00,160,$157.50
2024-08-13,18:24:00,19063.0,BUY,3,0.02h,Stop Loss,$22.50,$180.00,$105183.50,160,$180.00
2024-08-13,19:06:00,19052.5,SELL,3,0.02h,Break Even,$-1.50,$178.50,$105182.00,160,$178.50
2024-08-13,19:31:00,19063.5,BUY,3,0.02h,Stop Loss,$24.00,$202.50,$105206.00,160,$202.50
2024-08-13,20:30:00,19097.25,SELL,3,0.02h,Stop Loss,$39.00,$241.50,$105245.00,160,$241.50
2024-08-13,20:59:00,19096.5,BUY,3,0.02h,Stop Loss,$7.50,$249.00,$105252.50,160,$249.00
2024-08-13,22:20:00,19099.25,SELL,3,0.02h,Stop Loss,$30.00,$279.00,$105282.50,160,$279.00
2024-08-13,22:54:00,19099.0,BUY,3,0.02h,Stop Loss,$-9.00,$270.00,$105273.50,160,$270.00
2024-08-13,22:55:00,19097.0,SELL,3,0.02h,Stop Loss,$-9.00,$261.00,$105264.50,160,$261.00
2024-08-13,22:57:00,19098.75,BUY,3,0.02h,Stop Loss,$-9.00,$252.00,$105255.50,160,$252.00
2024-08-13,22:58:00,19097.75,SELL,3,0.02h,Stop Loss,$-9.00,$243.00,$105246.50,160,$243.00
2024-08-13,23:00:00,19099.0,BUY,3,13.00h,Stop Loss,$76.50,$319.50,$105323.00,160,$319.50
,,,,,,,,,,,
2024-08-14,12:13:00,19099.75,SELL,3,0.02h,Stop Loss,$3.00,$3.00,$105326.00,161,$3.00
2024-08-14,12:28:00,19104.75,BUY,3,0.02h,Stop Loss,$48.00,$51.00,$105374.00,161,$51.00
2024-08-14,12:33:00,19063.5,SELL,3,0.02h,Stop Loss,$51.00,$102.00,$105425.00,161,$102.00
2024-08-14,12:40:00,19122.5,BUY,3,0.02h,Stop Loss,$-9.00,$93.00,$105416.00,161,$93.00
2024-08-14,13:21:00,19133.75,SELL,3,0.02h,Break Even,$-1.50,$91.50,$105414.50,161,$91.50
2024-08-14,13:22:00,19138.75,BUY,3,0.02h,Break Even,$-1.50,$90.00,$105413.00,161,$90.00
2024-08-14,13:29:00,19126.25,SELL,3,0.02h,Break Even,$-1.50,$88.50,$105411.50,161,$88.50
2024-08-14,13:31:00,19162.5,BUY,3,0.02h,Stop Loss,$54.00,$142.50,$105465.50,161,$142.50
2024-08-14,13:35:00,19108.25,SELL,3,0.02h,Stop Loss,$130.50,$273.00,$105596.00,161,$273.00
2024-08-14,14:44:00,18995.75,BUY,3,0.02h,Stop Loss,$9.00,$282.00,$105605.00,161,$282.00
2024-08-14,16:15:00,19162.0,SELL,3,0.02h,Stop Loss,$85.50,$367.50,$105690.50,161,$367.50
2024-08-14,17:02:00,19068.75,BUY,3,0.02h,Stop Loss,$30.00,$397.50,$105720.50,161,$397.50
2024-08-14,17:28:00,19064.75,SELL,3,0.02h,Stop Loss,$-9.00,$388.50,$105711.50,161,$388.50
2024-08-14,17:30:00,19084.5,BUY,3,0.02h,Stop Loss,$12.00,$400.50,$105723.50,161,$400.50
2024-08-14,17:40:00,19071.0,SELL,3,0.02h,Break Even,$-1.50,$399.00,$105722.00,161,$399.00
2024-08-14,17:50:00,19084.25,BUY,3,0.02h,Stop Loss,$7.50,$406.50,$105729.50,161,$406.50
2024-08-14,17:52:00,19073.25,SELL,3,0.02h,Stop Loss,$-9.00,$397.50,$105720.50,161,$397.50
2024-08-14,17:54:00,19086.75,BUY,3,0.02h,Break Even,$-1.50,$396.00,$105719.00,161,$396.00
2024-08-14,18:01:00,19051.75,SELL,3,0.02h,Break Even,$-1.50,$394.50,$105717.50,161,$394.50
2024-08-14,18:21:00,19082.25,BUY,3,0.02h,Stop Loss,$16.50,$411.00,$105734.00,161,$411.00
2024-08-14,18:47:00,19078.5,SELL,3,0.02h,Stop Loss,$18.00,$429.00,$105752.00,161,$429.00
2024-08-14,18:53:00,19091.5,BUY,3,0.02h,Stop Loss,$6.00,$435.00,$105758.00,161,$435.00
2024-08-14,19:11:00,19076.5,SELL,3,0.02h,Break Even,$-1.50,$433.50,$105756.50,161,$433.50
2024-08-14,19:42:00,19071.5,BUY,3,0.02h,Stop Loss,$10.50,$444.00,$105767.00,161,$444.00
2024-08-14,20:36:00,19143.75,SELL,3,0.02h,Stop Loss,$-9.00,$435.00,$105758.00,161,$435.00
2024-08-14,20:48:00,19148.25,BUY,3,0.02h,Stop Loss,$-9.00,$426.00,$105749.00,161,$426.00
2024-08-14,20:53:00,19144.75,SELL,3,0.02h,Break Even,$-1.50,$424.50,$105747.50,161,$424.50
2024-08-14,22:54:00,19133.0,BUY,3,0.02h,Stop Loss,$-9.00,$415.50,$105738.50,161,$415.50
2024-08-14,22:56:00,19126.75,SELL,3,0.03h,Stop Loss,$-9.00,$406.50,$105729.50,161,$406.50
,,,,,,,,,,,
2024-08-15,12:00:00,19163.0,BUY,3,0.02h,Stop Loss,$4.50,$4.50,$105734.00,162,$4.50
2024-08-15,13:18:00,19322.25,SELL,3,0.02h,Stop Loss,$10.50,$15.00,$105744.50,162,$15.00
2024-08-15,13:25:00,19335.75,BUY,3,0.02h,Stop Loss,$3.00,$18.00,$105747.50,162,$18.00
2024-08-15,14:57:00,19472.25,SELL,3,0.02h,Stop Loss,$7.50,$25.50,$105755.00,162,$25.50
2024-08-15,15:05:00,19494.25,BUY,3,0.02h,Stop Loss,$12.00,$37.50,$105767.00,162,$37.50
2024-08-15,15:36:00,19505.5,SELL,3,0.02h,Break Even,$-1.50,$36.00,$105765.50,162,$36.00
2024-08-15,15:37:00,19515.0,BUY,3,0.02h,Stop Loss,$9.00,$45.00,$105774.50,162,$45.00
2024-08-15,16:41:00,19547.0,SELL,3,0.02h,Stop Loss,$88.50,$133.50,$105863.00,162,$133.50
2024-08-15,17:16:00,19539.25,BUY,3,0.02h,Stop Loss,$15.00,$148.50,$105878.00,162,$148.50
2024-08-15,18:17:00,19569.0,SELL,3,0.02h,Stop Loss,$-9.00,$139.50,$105869.00,162,$139.50
2024-08-15,18:22:00,19586.0,BUY,3,0.02h,Stop Loss,$-9.00,$130.50,$105860.00,162,$130.50
2024-08-15,18:33:00,19578.5,SELL,3,0.02h,Break Even,$-1.50,$129.00,$105858.50,162,$129.00
2024-08-15,18:34:00,19583.0,BUY,3,0.02h,Break Even,$-1.50,$127.50,$105857.00,162,$127.50
2024-08-15,18:40:00,19580.0,SELL,3,0.02h,Stop Loss,$6.00,$133.50,$105863.00,162,$133.50
2024-08-15,18:49:00,19582.75,BUY,3,0.02h,Break Even,$-1.50,$132.00,$105861.50,162,$132.00
2024-08-15,18:51:00,19573.5,SELL,3,0.02h,Stop Loss,$21.00,$153.00,$105882.50,162,$153.00
2024-08-15,18:58:00,19584.5,BUY,3,0.02h,Stop Loss,$-9.00,$144.00,$105873.50,162,$144.00
2024-08-15,19:01:00,19566.75,SELL,3,0.02h,Break Even,$-1.50,$142.50,$105872.00,162,$142.50
2024-08-15,19:07:00,19585.5,BUY,3,0.02h,Break Even,$-1.50,$141.00,$105870.50,162,$141.00
2024-08-15,19:13:00,19571.5,SELL,3,0.02h,Break Even,$-1.50,$139.50,$105869.00,162,$139.50
2024-08-15,19:20:00,19584.0,BUY,3,0.02h,Stop Loss,$-9.00,$130.50,$105860.00,162,$130.50
2024-08-15,19:49:00,19586.0,SELL,3,0.02h,Stop Loss,$58.50,$189.00,$105918.50,162,$189.00
2024-08-15,20:03:00,19579.5,BUY,3,0.02h,Break Even,$-1.50,$187.50,$105917.00,162,$187.50
2024-08-15,20:04:00,19573.25,SELL,3,0.02h,Stop Loss,$27.00,$214.50,$105944.00,162,$214.50
2024-08-15,20:10:00,19583.0,BUY,3,0.02h,Break Even,$-1.50,$213.00,$105942.50,162,$213.00
2024-08-15,20:15:00,19566.0,SELL,3,0.02h,Stop Loss,$-9.00,$204.00,$105933.50,162,$204.00
2024-08-15,20:29:00,19583.25,BUY,3,0.02h,Stop Loss,$10.50,$214.50,$105944.00,162,$214.50
2024-08-15,20:50:00,19577.5,SELL,3,0.02h,Break Even,$-1.50,$213.00,$105942.50,162,$213.00
2024-08-15,22:13:00,19579.75,BUY,3,0.02h,Stop Loss,$-9.00,$204.00,$105933.50,162,$204.00
,,,,,,,,,,,
2024-08-16,12:00:00,19553.25,SELL,3,0.02h,Stop Loss,$-9.00,$-9.00,$105924.50,163,$-9.00
2024-08-16,13:01:00,19479.25,BUY,3,0.02h,Break Even,$-1.50,$-10.50,$105923.00,163,$-10.50
2024-08-16,13:31:00,19466.0,SELL,3,0.02h,Break Even,$-1.50,$-12.00,$105921.50,163,$-12.00
2024-08-16,13:33:00,19503.25,BUY,3,0.02h,Stop Loss,$48.00,$36.00,$105969.50,163,$36.00
2024-08-16,13:47:00,19486.5,SELL,3,0.02h,Stop Loss,$9.00,$45.00,$105978.50,163,$45.00
2024-08-16,13:51:00,19521.25,BUY,3,0.02h,Stop Loss,$39.00,$84.00,$106017.50,163,$84.00
2024-08-16,14:00:00,19495.75,SELL,3,0.02h,Stop Loss,$13.50,$97.50,$106031.00,163,$97.50
2024-08-16,14:01:00,19525.5,BUY,3,0.02h,Stop Loss,$7.50,$105.00,$106038.50,163,$105.00
2024-08-16,14:41:00,19553.5,SELL,3,0.02h,Stop Loss,$51.00,$156.00,$106089.50,163,$156.00
2024-08-16,15:29:00,19532.0,BUY,3,0.02h,Break Even,$-1.50,$154.50,$106088.00,163,$154.50
2024-08-16,17:16:00,19627.0,SELL,3,0.02h,Break Even,$-1.50,$153.00,$106086.50,163,$153.00
2024-08-16,17:21:00,19636.5,BUY,3,0.02h,Break Even,$-1.50,$151.50,$106085.00,163,$151.50
2024-08-16,17:22:00,19633.5,SELL,3,0.02h,Stop Loss,$-9.00,$142.50,$106076.00,163,$142.50
2024-08-16,17:23:00,19637.25,BUY,3,0.02h,Stop Loss,$13.50,$156.00,$106089.50,163,$156.00
2024-08-16,17:42:00,19629.75,SELL,3,0.02h,Stop Loss,$-9.00,$147.00,$106080.50,163,$147.00
2024-08-16,17:44:00,19640.25,BUY,3,0.02h,Stop Loss,$21.00,$168.00,$106101.50,163,$168.00
2024-08-16,17:48:00,19630.0,SELL,3,0.02h,Stop Loss,$-9.00,$159.00,$106092.50,163,$159.00
2024-08-16,18:30:00,19615.5,BUY,3,0.02h,Stop Loss,$3.00,$162.00,$106095.50,163,$162.00
2024-08-16,18:44:00,19603.0,SELL,3,0.02h,Stop Loss,$12.00,$174.00,$106107.50,163,$174.00
2024-08-16,18:55:00,19616.0,BUY,3,0.02h,Break Even,$-1.50,$172.50,$106106.00,163,$172.50
2024-08-16,19:11:00,19606.5,SELL,3,0.02h,Break Even,$-1.50,$171.00,$106104.50,163,$171.00
2024-08-16,19:35:00,19611.75,BUY,3,0.02h,Break Even,$-1.50,$169.50,$106103.00,163,$169.50
2024-08-16,19:40:00,19603.25,SELL,3,0.02h,Break Even,$-1.50,$168.00,$106101.50,163,$168.00
2024-08-16,19:57:00,19608.75,BUY,3,0.02h,Stop Loss,$3.00,$171.00,$106104.50,163,$171.00
2024-08-16,20:32:00,19606.25,SELL,3,0.02h,Stop Loss,$4.50,$175.50,$106109.00,163,$175.50
2024-08-16,20:53:00,19610.5,BUY,3,0.02h,Break Even,$-1.50,$174.00,$106107.50,163,$174.00
2024-08-16,21:00:00,19604.5,SELL,3,63.00h,Stop Loss,$-9.00,$165.00,$106098.50,163,$165.00
,,,,,,,,,,,
2024-08-19,12:04:00,19618.0,BUY,3,0.02h,Break Even,$-1.50,$-1.50,$106097.00,164,$-1.50
2024-08-19,12:37:00,19621.25,SELL,3,0.02h,Stop Loss,$-9.00,$-10.50,$106088.00,164,$-10.50
2024-08-19,12:48:00,19628.75,BUY,3,0.02h,Stop Loss,$-9.00,$-19.50,$106079.00,164,$-19.50
2024-08-19,12:53:00,19618.5,SELL,3,0.02h,Stop Loss,$-9.00,$-28.50,$106070.00,164,$-28.50
2024-08-19,13:06:00,19630.5,BUY,3,0.02h,Break Even,$-1.50,$-30.00,$106068.50,164,$-30.00
2024-08-19,13:23:00,19623.0,SELL,3,0.02h,Break Even,$-1.50,$-31.50,$106067.00,164,$-31.50
2024-08-19,13:48:00,19613.5,BUY,3,0.02h,Stop Loss,$40.50,$9.00,$106107.50,164,$9.00
2024-08-19,13:55:00,19583.25,SELL,3,0.02h,Stop Loss,$27.00,$36.00,$106134.50,164,$36.00
2024-08-19,14:09:00,19619.0,BUY,3,0.02h,Stop Loss,$-9.00,$27.00,$106125.50,164,$27.00
2024-08-19,14:18:00,19549.25,SELL,3,0.02h,Stop Loss,$-9.00,$18.00,$106116.50,164,$18.00
2024-08-19,14:28:00,19610.25,BUY,3,0.02h,Stop Loss,$13.50,$31.50,$106130.00,164,$31.50
2024-08-19,15:19:00,19643.0,SELL,3,0.02h,Break Even,$-1.50,$30.00,$106128.50,164,$30.00
2024-08-19,15:25:00,19662.5,BUY,3,0.02h,Stop Loss,$-9.00,$21.00,$106119.50,164,$21.00
2024-08-19,15:42:00,19655.0,SELL,3,0.02h,Break Even,$-1.50,$19.50,$106118.00,164,$19.50
2024-08-19,15:45:00,19659.5,BUY,3,0.02h,Stop Loss,$21.00,$40.50,$106139.00,164,$40.50
2024-08-19,15:58:00,19644.75,SELL,3,0.02h,Stop Loss,$132.00,$172.50,$106271.00,164,$172.50
2024-08-19,16:17:00,19655.0,BUY,3,0.02h,Stop Loss,$16.50,$189.00,$106287.50,164,$189.00
2024-08-19,16:36:00,19649.0,SELL,3,0.02h,Stop Loss,$-9.00,$180.00,$106278.50,164,$180.00
2024-08-19,16:39:00,19660.75,BUY,3,0.02h,Break Even,$-1.50,$178.50,$106277.00,164,$178.50
2024-08-19,17:15:00,19681.75,SELL,3,0.02h,Stop Loss,$24.00,$202.50,$106301.00,164,$202.50
2024-08-19,17:22:00,19690.5,BUY,3,0.02h,Stop Loss,$-9.00,$193.50,$106292.00,164,$193.50
2024-08-19,19:03:00,19761.75,SELL,3,0.02h,Stop Loss,$-9.00,$184.50,$106283.00,164,$184.50
2024-08-19,19:16:00,19767.75,BUY,3,0.02h,Stop Loss,$6.00,$190.50,$106289.00,164,$190.50
2024-08-19,19:47:00,19768.5,SELL,3,0.02h,Stop Loss,$-9.00,$181.50,$106280.00,164,$181.50
2024-08-19,19:52:00,19792.5,BUY,3,0.02h,Stop Loss,$48.00,$229.50,$106328.00,164,$229.50
2024-08-19,20:48:00,19860.25,SELL,3,0.02h,Stop Loss,$-9.00,$220.50,$106319.00,164,$220.50
2024-08-19,22:02:00,19868.25,BUY,3,0.02h,Stop Loss,$-9.00,$211.50,$106310.00,164,$211.50
2024-08-19,22:48:00,19864.75,SELL,3,0.02h,Stop Loss,$-9.00,$202.50,$106301.00,164,$202.50
,,,,,,,,,,,
2024-08-20,12:01:00,19878.25,BUY,3,0.02h,Stop Loss,$-9.00,$-9.00,$106292.00,165,$-9.00
2024-08-20,12:09:00,19869.0,SELL,3,0.02h,Stop Loss,$-9.00,$-18.00,$106283.00,165,$-18.00
2024-08-20,12:10:00,19877.0,BUY,3,0.02h,Break Even,$-1.50,$-19.50,$106281.50,165,$-19.50
2024-08-20,12:23:00,19867.25,SELL,3,0.02h,Stop Loss,$-9.00,$-28.50,$106272.50,165,$-28.50
2024-08-20,13:32:00,19839.75,BUY,3,0.02h,Stop Loss,$30.00,$1.50,$106302.50,165,$1.50
2024-08-20,14:12:00,19862.5,SELL,3,0.02h,Stop Loss,$196.50,$198.00,$106499.00,165,$198.00
2024-08-20,14:54:00,19808.5,BUY,3,0.02h,Break Even,$-1.50,$196.50,$106497.50,165,$196.50
2024-08-20,14:58:00,19783.25,SELL,3,0.02h,Break Even,$-1.50,$195.00,$106496.00,165,$195.00
2024-08-20,15:14:00,19800.75,BUY,3,0.02h,Break Even,$-1.50,$193.50,$106494.50,165,$193.50
2024-08-20,15:31:00,19797.0,SELL,3,0.02h,Break Even,$-1.50,$192.00,$106493.00,165,$192.00
2024-08-20,15:32:00,19807.25,BUY,3,0.02h,Stop Loss,$9.00,$201.00,$106502.00,165,$201.00
2024-08-20,15:45:00,19795.0,SELL,3,0.02h,Stop Loss,$66.00,$267.00,$106568.00,165,$267.00
2024-08-20,15:54:00,19820.5,BUY,3,0.02h,Stop Loss,$10.50,$277.50,$106578.50,165,$277.50
2024-08-20,16:17:00,19820.25,SELL,3,0.02h,Stop Loss,$37.50,$315.00,$106616.00,165,$315.00
2024-08-20,16:51:00,19813.5,BUY,3,0.02h,Break Even,$-1.50,$313.50,$106614.50,165,$313.50
2024-08-20,16:52:00,19807.0,SELL,3,0.02h,Stop Loss,$12.00,$325.50,$106626.50,165,$325.50
2024-08-20,17:28:00,19792.25,BUY,3,0.02h,Stop Loss,$-9.00,$316.50,$106617.50,165,$316.50
2024-08-20,18:50:00,19849.75,SELL,3,0.02h,Break Even,$-1.50,$315.00,$106616.00,165,$315.00
2024-08-20,19:05:00,19853.0,BUY,3,0.02h,Stop Loss,$6.00,$321.00,$106622.00,165,$321.00
2024-08-20,19:09:00,19839.75,SELL,3,0.02h,Break Even,$-1.50,$319.50,$106620.50,165,$319.50
2024-08-20,19:49:00,19837.5,BUY,3,0.02h,Stop Loss,$24.00,$343.50,$106644.50,165,$343.50
2024-08-20,19:55:00,19826.75,SELL,3,0.02h,Stop Loss,$48.00,$391.50,$106692.50,165,$391.50
2024-08-20,20:15:00,19831.5,BUY,3,0.02h,Stop Loss,$-9.00,$382.50,$106683.50,165,$382.50
2024-08-20,20:24:00,19818.75,SELL,3,0.02h,Stop Loss,$-9.00,$373.50,$106674.50,165,$373.50
2024-08-20,22:26:00,19803.25,BUY,3,0.02h,Break Even,$-1.50,$372.00,$106673.00,165,$372.00
2024-08-20,22:29:00,19799.0,SELL,3,0.02h,Stop Loss,$-9.00,$363.00,$106664.00,165,$363.00
2024-08-20,22:32:00,19803.5,BUY,3,0.02h,Break Even,$-1.50,$361.50,$106662.50,165,$361.50
2024-08-20,22:47:00,19800.5,SELL,3,0.02h,Stop Loss,$-9.00,$352.50,$106653.50,165,$352.50
,,,,,,,,,,,
2024-08-21,12:00:00,19832.25,BUY,3,0.02h,Break Even,$-1.50,$-1.50,$106652.00,166,$-1.50
2024-08-21,12:51:00,19845.25,SELL,3,0.02h,Break Even,$-1.50,$-3.00,$106650.50,166,$-3.00
2024-08-21,13:06:00,19853.0,BUY,3,0.02h,Stop Loss,$-9.00,$-12.00,$106641.50,166,$-12.00
2024-08-21,13:21:00,19843.75,SELL,3,0.02h,Break Even,$-1.50,$-13.50,$106640.00,166,$-13.50
2024-08-21,13:25:00,19854.5,BUY,3,0.02h,Stop Loss,$-9.00,$-22.50,$106631.00,166,$-22.50
2024-08-21,13:29:00,19844.0,SELL,3,0.02h,Stop Loss,$9.00,$-13.50,$106640.00,166,$-13.50
2024-08-21,13:42:00,19855.5,BUY,3,0.02h,Break Even,$-1.50,$-15.00,$106638.50,166,$-15.00
2024-08-21,14:17:00,19869.0,SELL,3,0.02h,Stop Loss,$30.00,$15.00,$106668.50,166,$15.00
2024-08-21,14:20:00,19898.25,BUY,3,0.02h,Stop Loss,$30.00,$45.00,$106698.50,166,$45.00
2024-08-21,14:28:00,19881.75,SELL,3,0.02h,Break Even,$-1.50,$43.50,$106697.00,166,$43.50
2024-08-21,14:37:00,19935.5,BUY,3,0.02h,Stop Loss,$30.00,$73.50,$106727.00,166,$73.50
2024-08-21,14:52:00,19859.75,SELL,3,0.02h,Stop Loss,$298.50,$372.00,$107025.50,166,$372.00
2024-08-21,15:13:00,19879.75,BUY,3,0.02h,Stop Loss,$49.50,$421.50,$107075.00,166,$421.50
2024-08-21,15:27:00,19864.0,SELL,3,0.02h,Break Even,$-1.50,$420.00,$107073.50,166,$420.00
2024-08-21,16:19:00,19818.25,BUY,3,0.02h,Stop Loss,$67.50,$487.50,$107141.00,166,$487.50
2024-08-21,17:19:00,19858.5,SELL,3,0.02h,Stop Loss,$-9.00,$478.50,$107132.00,166,$478.50
2024-08-21,17:32:00,19868.25,BUY,3,0.02h,Break Even,$-1.50,$477.00,$107130.50,166,$477.00
2024-08-21,18:40:00,19904.25,SELL,3,0.02h,Stop Loss,$28.50,$505.50,$107159.00,166,$505.50
2024-08-21,18:55:00,19915.0,BUY,3,0.02h,Break Even,$-1.50,$504.00,$107157.50,166,$504.00
2024-08-21,19:01:00,19898.25,SELL,3,0.02h,Stop Loss,$33.00,$537.00,$107190.50,166,$537.00
2024-08-21,19:34:00,19875.0,BUY,3,0.02h,Stop Loss,$-9.00,$528.00,$107181.50,166,$528.00
2024-08-21,19:39:00,19865.0,SELL,3,0.02h,Stop Loss,$-9.00,$519.00,$107172.50,166,$519.00
2024-08-21,19:40:00,19875.25,BUY,3,0.02h,Break Even,$-1.50,$517.50,$107171.00,166,$517.50
2024-08-21,19:44:00,19859.75,SELL,3,0.02h,Stop Loss,$-9.00,$508.50,$107162.00,166,$508.50
2024-08-21,19:49:00,19879.0,BUY,3,0.02h,Stop Loss,$22.50,$531.00,$107184.50,166,$531.00
2024-08-21,20:48:00,19912.75,SELL,3,0.02h,Stop Loss,$-9.00,$522.00,$107175.50,166,$522.00
2024-08-21,20:52:00,19918.75,BUY,3,0.02h,Stop Loss,$-9.00,$513.00,$107166.50,166,$513.00
2024-08-21,22:06:00,19913.75,SELL,3,0.02h,Stop Loss,$-9.00,$504.00,$107157.50,166,$504.00
2024-08-21,22:07:00,19922.5,BUY,3,0.02h,Stop Loss,$6.00,$510.00,$107163.50,166,$510.00
2024-08-21,23:00:00,19935.0,SELL,3,13.00h,Stop Loss,$-9.00,$501.00,$107154.50,166,$501.00
,,,,,,,,,,,
2024-08-22,12:00:00,19976.75,BUY,3,0.02h,Stop Loss,$3.00,$3.00,$107157.50,167,$3.00
2024-08-22,12:21:00,19964.25,SELL,3,0.02h,Stop Loss,$22.50,$25.50,$107180.00,167,$25.50
2024-08-22,12:31:00,19981.25,BUY,3,0.02h,Stop Loss,$12.00,$37.50,$107192.00,167,$37.50
2024-08-22,12:37:00,19963.5,SELL,3,0.02h,Stop Loss,$88.50,$126.00,$107280.50,167,$126.00
2024-08-22,12:45:00,19969.75,BUY,3,0.02h,Break Even,$-1.50,$124.50,$107279.00,167,$124.50
2024-08-22,12:46:00,19959.75,SELL,3,0.02h,Stop Loss,$25.50,$150.00,$107304.50,167,$150.00
2024-08-22,12:52:00,19971.75,BUY,3,0.02h,Stop Loss,$6.00,$156.00,$107310.50,167,$156.00
2024-08-22,13:39:00,19981.25,SELL,3,0.02h,Stop Loss,$46.50,$202.50,$107357.00,167,$202.50
2024-08-22,13:57:00,20003.75,BUY,3,0.02h,Stop Loss,$10.50,$213.00,$107367.50,167,$213.00
2024-08-22,14:01:00,19973.75,SELL,3,0.02h,Stop Loss,$94.50,$307.50,$107462.00,167,$307.50
2024-08-22,15:03:00,19905.5,BUY,3,0.02h,Stop Loss,$9.00,$316.50,$107471.00,167,$316.50
2024-08-22,15:11:00,19869.0,SELL,3,0.02h,Stop Loss,$45.00,$361.50,$107516.00,167,$361.50
2024-08-22,16:06:00,19736.0,BUY,3,0.02h,Stop Loss,$7.50,$369.00,$107523.50,167,$369.00
2024-08-22,16:51:00,19775.25,SELL,3,0.02h,Stop Loss,$94.50,$463.50,$107618.00,167,$463.50
2024-08-22,17:28:00,19720.75,BUY,3,0.02h,Break Even,$-1.50,$462.00,$107616.50,167,$462.00
2024-08-22,17:30:00,19709.25,SELL,3,0.02h,Stop Loss,$7.50,$469.50,$107624.00,167,$469.50
2024-08-22,18:16:00,19639.75,BUY,3,0.02h,Break Even,$-1.50,$468.00,$107622.50,167,$468.00
2024-08-22,18:55:00,19629.25,SELL,3,0.02h,Stop Loss,$-9.00,$459.00,$107613.50,167,$459.00
2024-08-22,19:05:00,19660.75,BUY,3,0.02h,Break Even,$-1.50,$457.50,$107612.00,167,$457.50
2024-08-22,19:11:00,19630.0,SELL,3,0.02h,Stop Loss,$-9.00,$448.50,$107603.00,167,$448.50
2024-08-22,20:03:00,19597.25,BUY,3,0.02h,Stop Loss,$18.00,$466.50,$107621.00,167,$466.50
2024-08-22,20:44:00,19609.5,SELL,3,0.02h,Break Even,$-1.50,$465.00,$107619.50,167,$465.00
2024-08-22,20:45:00,19613.5,BUY,3,0.02h,Stop Loss,$15.00,$480.00,$107634.50,167,$480.00
2024-08-22,22:23:00,19619.0,SELL,3,0.02h,Stop Loss,$-9.00,$471.00,$107625.50,167,$471.00
2024-08-22,22:24:00,19622.25,BUY,3,0.02h,Break Even,$-1.50,$469.50,$107624.00,167,$469.50
,,,,,,,,,,,
2024-08-23,13:27:00,19761.5,SELL,3,0.02h,Stop Loss,$10.50,$10.50,$107634.50,168,$10.50
2024-08-23,13:50:00,19749.5,BUY,3,0.02h,Stop Loss,$21.00,$31.50,$107655.50,168,$31.50
2024-08-23,14:38:00,19830.25,SELL,3,0.02h,Stop Loss,$130.50,$162.00,$107786.00,168,$162.00
2024-08-23,15:16:00,19780.25,BUY,3,0.02h,Break Even,$-1.50,$160.50,$107784.50,168,$160.50
2024-08-23,15:46:00,19718.0,SELL,3,0.02h,Stop Loss,$34.50,$195.00,$107819.00,168,$195.00
2024-08-23,16:36:00,19690.75,BUY,3,0.02h,Stop Loss,$34.50,$229.50,$107853.50,168,$229.50
2024-08-23,16:43:00,19608.25,SELL,3,0.02h,Stop Loss,$6.00,$235.50,$107859.50,168,$235.50
2024-08-23,16:56:00,19689.75,BUY,3,0.02h,Stop Loss,$39.00,$274.50,$107898.50,168,$274.50
2024-08-23,18:00:00,19732.75,SELL,3,0.02h,Stop Loss,$40.50,$315.00,$107939.00,168,$315.00
2024-08-23,18:05:00,19748.75,BUY,3,0.02h,Break Even,$-1.50,$313.50,$107937.50,168,$313.50
2024-08-23,18:33:00,19742.25,SELL,3,0.02h,Break Even,$-1.50,$312.00,$107936.00,168,$312.00
2024-08-23,18:41:00,19753.75,BUY,3,0.02h,Stop Loss,$42.00,$354.00,$107978.00,168,$354.00
2024-08-23,18:58:00,19742.5,SELL,3,0.02h,Stop Loss,$99.00,$453.00,$108077.00,168,$453.00
2024-08-23,19:13:00,19755.25,BUY,3,0.02h,Stop Loss,$165.00,$618.00,$108242.00,168,$618.00
2024-08-23,19:39:00,19770.25,SELL,3,0.02h,Stop Loss,$54.00,$672.00,$108296.00,168,$672.00
2024-08-23,19:54:00,19781.75,BUY,3,0.02h,Stop Loss,$127.50,$799.50,$108423.50,168,$799.50
2024-08-23,20:34:00,19786.75,SELL,3,0.02h,Break Even,$-1.50,$798.00,$108422.00,168,$798.00
,,,,,,,,,,,
2024-08-26,12:12:00,19784.5,BUY,3,0.02h,Break Even,$-1.50,$-1.50,$108420.50,169,$-1.50
2024-08-26,12:28:00,19776.5,SELL,3,0.02h,Stop Loss,$-9.00,$-10.50,$108411.50,169,$-10.50
2024-08-26,12:55:00,19773.0,BUY,3,0.02h,Break Even,$-1.50,$-12.00,$108410.00,169,$-12.00
2024-08-26,13:05:00,19760.25,SELL,3,0.02h,Stop Loss,$-9.00,$-21.00,$108401.00,169,$-21.00
2024-08-26,13:09:00,19774.0,BUY,3,0.02h,Stop Loss,$-9.00,$-30.00,$108392.00,169,$-30.00
2024-08-26,13:31:00,19768.25,SELL,3,0.02h,Stop Loss,$132.00,$102.00,$108524.00,169,$102.00
2024-08-26,13:34:00,19793.75,BUY,3,0.02h,Stop Loss,$25.50,$127.50,$108549.50,169,$127.50
2024-08-26,13:43:00,19760.25,SELL,3,0.02h,Stop Loss,$61.50,$189.00,$108611.00,169,$189.00
2024-08-26,14:57:00,19576.75,BUY,3,0.02h,Stop Loss,$42.00,$231.00,$108653.00,169,$231.00
2024-08-26,15:33:00,19595.25,SELL,3,0.02h,Stop Loss,$-9.00,$222.00,$108644.00,169,$222.00
2024-08-26,15:43:00,19611.0,BUY,3,0.02h,Stop Loss,$40.50,$262.50,$108684.50,169,$262.50
2024-08-26,15:46:00,19588.5,SELL,3,0.02h,Stop Loss,$6.00,$268.50,$108690.50,169,$268.50
2024-08-26,16:18:00,19579.0,BUY,3,0.02h,Break Even,$-1.50,$267.00,$108689.00,169,$267.00
2024-08-26,16:57:00,19619.5,SELL,3,0.02h,Break Even,$-1.50,$265.50,$108687.50,169,$265.50
2024-08-26,17:26:00,19618.25,BUY,3,0.02h,Stop Loss,$-9.00,$256.50,$108678.50,169,$256.50
2024-08-26,17:30:00,19595.25,SELL,3,0.02h,Break Even,$-1.50,$255.00,$108677.00,169,$255.00
2024-08-26,18:17:00,19541.25,BUY,3,0.02h,Break Even,$-1.50,$253.50,$108675.50,169,$253.50
2024-08-26,19:09:00,19597.25,SELL,3,0.02h,Break Even,$-1.50,$252.00,$108674.00,169,$252.00
2024-08-26,19:55:00,19586.5,BUY,3,0.02h,Break Even,$-1.50,$250.50,$108672.50,169,$250.50
2024-08-26,19:57:00,19571.0,SELL,3,0.02h,Stop Loss,$66.00,$316.50,$108738.50,169,$316.50
2024-08-26,20:00:00,19593.5,BUY,3,0.02h,Stop Loss,$3.00,$319.50,$108741.50,169,$319.50
2024-08-26,20:06:00,19575.25,SELL,3,0.02h,Break Even,$-1.50,$318.00,$108740.00,169,$318.00
2024-08-26,20:55:00,19566.5,BUY,3,0.02h,Break Even,$-1.50,$316.50,$108738.50,169,$316.50
2024-08-26,21:00:00,19549.75,SELL,3,1.02h,Stop Loss,$-9.00,$307.50,$108729.50,169,$307.50
2024-08-26,22:01:00,19565.75,BUY,3,0.02h,Stop Loss,$12.00,$319.50,$108741.50,169,$319.50
2024-08-26,22:10:00,19535.75,SELL,3,0.02h,Break Even,$-1.50,$318.00,$108740.00,169,$318.00
2024-08-26,22:58:00,19535.75,BUY,3,0.03h,Break Even,$-1.50,$316.50,$108738.50,169,$316.50
,,,,,,,,,,,
2024-08-27,12:21:00,19554.5,SELL,3,0.02h,Stop Loss,$3.00,$3.00,$108741.50,170,$3.00
2024-08-27,13:24:00,19516.0,BUY,3,0.02h,Stop Loss,$3.00,$6.00,$108744.50,170,$6.00
2024-08-27,13:38:00,19488.25,SELL,3,0.02h,Stop Loss,$99.00,$105.00,$108843.50,170,$105.00
2024-08-27,13:52:00,19509.75,BUY,3,0.02h,Stop Loss,$126.00,$231.00,$108969.50,170,$231.00
2024-08-27,15:20:00,19656.0,SELL,3,0.02h,Stop Loss,$22.50,$253.50,$108992.00,170,$253.50
2024-08-27,16:03:00,19614.5,BUY,3,0.02h,Stop Loss,$3.00,$256.50,$108995.00,170,$256.50
2024-08-27,16:32:00,19618.0,SELL,3,0.02h,Stop Loss,$-9.00,$247.50,$108986.00,170,$247.50
2024-08-27,16:33:00,19635.75,BUY,3,0.02h,Stop Loss,$34.50,$282.00,$109020.50,170,$282.00
2024-08-27,16:42:00,19610.5,SELL,3,0.02h,Stop Loss,$144.00,$426.00,$109164.50,170,$426.00
2024-08-27,16:51:00,19638.5,BUY,3,0.02h,Stop Loss,$31.50,$457.50,$109196.00,170,$457.50
2024-08-27,17:05:00,19622.25,SELL,3,0.02h,Stop Loss,$10.50,$468.00,$109206.50,170,$468.00
2024-08-27,17:06:00,19631.5,BUY,3,0.02h,Break Even,$-1.50,$466.50,$109205.00,170,$466.50
2024-08-27,18:12:00,19670.75,SELL,3,0.02h,Stop Loss,$43.50,$510.00,$109248.50,170,$510.00
2024-08-27,18:46:00,19667.0,BUY,3,0.02h,Stop Loss,$-9.00,$501.00,$109239.50,170,$501.00
2024-08-27,18:50:00,19658.75,SELL,3,0.02h,Stop Loss,$91.50,$592.50,$109331.00,170,$592.50
2024-08-27,19:28:00,19656.5,BUY,3,0.02h,Stop Loss,$-9.00,$583.50,$109322.00,170,$583.50
2024-08-27,19:32:00,19640.25,SELL,3,0.02h,Stop Loss,$18.00,$601.50,$109340.00,170,$601.50
2024-08-27,19:40:00,19650.5,BUY,3,0.02h,Stop Loss,$19.50,$621.00,$109359.50,170,$621.00
2024-08-27,19:54:00,19636.75,SELL,3,0.02h,Break Even,$-1.50,$619.50,$109358.00,170,$619.50
2024-08-27,20:04:00,19654.25,BUY,3,0.02h,Stop Loss,$19.50,$639.00,$109377.50,170,$639.00
2024-08-27,20:13:00,19646.0,SELL,3,0.02h,Stop Loss,$-9.00,$630.00,$109368.50,170,$630.00
2024-08-27,22:02:00,19644.25,BUY,3,0.02h,Break Even,$-1.50,$628.50,$109367.00,170,$628.50
2024-08-27,22:11:00,19607.25,SELL,3,0.02h,Stop Loss,$15.00,$643.50,$109382.00,170,$643.50
2024-08-27,23:00:00,19595.75,BUY,3,13.00h,Stop Loss,$129.00,$772.50,$109511.00,170,$772.50
,,,,,,,,,,,
2024-08-28,13:07:00,19630.25,SELL,3,0.02h,Stop Loss,$60.00,$60.00,$109571.00,171,$60.00
2024-08-28,13:31:00,19653.75,BUY,3,0.02h,Break Even,$-1.50,$58.50,$109569.50,171,$58.50
2024-08-28,13:38:00,19610.75,SELL,3,0.02h,Stop Loss,$31.50,$90.00,$109601.00,171,$90.00
2024-08-28,14:20:00,19568.5,BUY,3,0.02h,Stop Loss,$27.00,$117.00,$109628.00,171,$117.00
2024-08-28,14:38:00,19559.0,SELL,3,0.02h,Break Even,$-1.50,$115.50,$109626.50,171,$115.50
2024-08-28,15:37:00,19400.75,BUY,3,0.02h,Stop Loss,$10.50,$126.00,$109637.00,171,$126.00
2024-08-28,16:16:00,19406.25,SELL,3,0.02h,Stop Loss,$99.00,$225.00,$109736.00,171,$225.00
2024-08-28,16:35:00,19417.0,BUY,3,0.02h,Stop Loss,$13.50,$238.50,$109749.50,171,$238.50
2024-08-28,17:15:00,19417.25,SELL,3,0.02h,Stop Loss,$13.50,$252.00,$109763.00,171,$252.00
2024-08-28,17:36:00,19436.5,BUY,3,0.02h,Stop Loss,$-9.00,$243.00,$109754.00,171,$243.00
2024-08-28,17:39:00,19430.0,SELL,3,0.02h,Stop Loss,$43.50,$286.50,$109797.50,171,$286.50
2024-08-28,18:24:00,19333.5,BUY,3,0.02h,Break Even,$-1.50,$285.00,$109796.00,171,$285.00
2024-08-28,18:25:00,19326.0,SELL,3,0.02h,Stop Loss,$9.00,$294.00,$109805.00,171,$294.00
2024-08-28,18:34:00,19334.5,BUY,3,0.02h,Break Even,$-1.50,$292.50,$109803.50,171,$292.50
2024-08-28,18:45:00,19324.75,SELL,3,0.02h,Break Even,$-1.50,$291.00,$109802.00,171,$291.00
2024-08-28,18:51:00,19342.5,BUY,3,0.02h,Stop Loss,$90.00,$381.00,$109892.00,171,$381.00
2024-08-28,19:58:00,19432.5,SELL,3,0.02h,Stop Loss,$67.50,$448.50,$109959.50,171,$448.50
2024-08-28,20:20:00,19449.0,BUY,3,0.02h,Break Even,$-1.50,$447.00,$109958.00,171,$447.00
2024-08-28,20:24:00,19347.25,SELL,3,0.02h,Stop Loss,$504.00,$951.00,$110462.00,171,$951.00
,,,,,,,,,,,
2024-08-29,12:00:00,19466.25,BUY,3,0.02h,Stop Loss,$10.50,$10.50,$110472.50,172,$10.50
2024-08-29,12:44:00,19451.75,SELL,3,0.02h,Stop Loss,$31.50,$42.00,$110504.00,172,$42.00
2024-08-29,12:49:00,19482.25,BUY,3,0.02h,Break Even,$-1.50,$40.50,$110502.50,172,$40.50
2024-08-29,13:01:00,19464.75,SELL,3,0.02h,Stop Loss,$-9.00,$31.50,$110493.50,172,$31.50
2024-08-29,13:02:00,19473.75,BUY,3,0.02h,Stop Loss,$10.50,$42.00,$110504.00,172,$42.00
2024-08-29,13:27:00,19474.75,SELL,3,0.02h,Stop Loss,$19.50,$61.50,$110523.50,172,$61.50
2024-08-29,13:29:00,19493.5,BUY,3,0.02h,Stop Loss,$40.50,$102.00,$110564.00,172,$102.00
2024-08-29,14:16:00,19605.0,SELL,3,0.02h,Stop Loss,$105.00,$207.00,$110669.00,172,$207.00
2024-08-29,14:30:00,19599.25,BUY,3,0.02h,Stop Loss,$61.50,$268.50,$110730.50,172,$268.50
2024-08-29,15:06:00,19637.75,SELL,3,0.02h,Stop Loss,$78.00,$346.50,$110808.50,172,$346.50
2024-08-29,15:11:00,19663.75,BUY,3,0.02h,Stop Loss,$-9.00,$337.50,$110799.50,172,$337.50
2024-08-29,15:20:00,19637.25,SELL,3,0.02h,Stop Loss,$108.00,$445.50,$110907.50,172,$445.50
2024-08-29,15:40:00,19649.0,BUY,3,0.02h,Break Even,$-1.50,$444.00,$110906.00,172,$444.00
2024-08-29,15:45:00,19622.75,SELL,3,0.02h,Break Even,$-1.50,$442.50,$110904.50,172,$442.50
2024-08-29,16:01:00,19645.0,BUY,3,0.02h,Stop Loss,$21.00,$463.50,$110925.50,172,$463.50
2024-08-29,16:51:00,19657.5,SELL,3,0.02h,Break Even,$-1.50,$462.00,$110924.00,172,$462.00
2024-08-29,17:37:00,19623.75,BUY,3,0.02h,Stop Loss,$-9.00,$453.00,$110915.00,172,$453.00
2024-08-29,17:38:00,19615.5,SELL,3,0.02h,Break Even,$-1.50,$451.50,$110913.50,172,$451.50
2024-08-29,17:57:00,19627.0,BUY,3,0.02h,Break Even,$-1.50,$450.00,$110912.00,172,$450.00
2024-08-29,18:02:00,19584.75,SELL,3,0.02h,Break Even,$-1.50,$448.50,$110910.50,172,$448.50
2024-08-29,19:26:00,19401.25,BUY,3,0.02h,Stop Loss,$6.00,$454.50,$110916.50,172,$454.50
2024-08-29,19:51:00,19402.75,SELL,3,0.02h,Stop Loss,$78.00,$532.50,$110994.50,172,$532.50
2024-08-29,20:07:00,19420.5,BUY,3,0.02h,Stop Loss,$15.00,$547.50,$111009.50,172,$547.50
2024-08-29,20:50:00,19441.25,SELL,3,0.02h,Stop Loss,$-9.00,$538.50,$111000.50,172,$538.50
2024-08-29,20:55:00,19447.0,BUY,3,0.02h,Break Even,$-1.50,$537.00,$110999.00,172,$537.00
2024-08-29,22:06:00,19437.25,SELL,3,0.02h,Stop Loss,$67.50,$604.50,$111066.50,172,$604.50
2024-08-29,22:32:00,19438.25,BUY,3,0.02h,Stop Loss,$-9.00,$595.50,$111057.50,172,$595.50
2024-08-29,22:37:00,19431.0,SELL,3,0.02h,Stop Loss,$-9.00,$586.50,$111048.50,172,$586.50
2024-08-29,22:45:00,19438.0,BUY,3,0.02h,Break Even,$-1.50,$585.00,$111047.00,172,$585.00
2024-08-29,22:51:00,19430.75,SELL,3,0.02h,Break Even,$-1.50,$583.50,$111045.50,172,$583.50
,,,,,,,,,,,
2024-08-30,12:00:00,19526.75,BUY,3,0.02h,Stop Loss,$43.50,$43.50,$111089.00,173,$43.50
2024-08-30,12:36:00,19517.0,SELL,3,0.02h,Stop Loss,$31.50,$75.00,$111120.50,173,$75.00
2024-08-30,12:44:00,19554.0,BUY,3,0.02h,Stop Loss,$-9.00,$66.00,$111111.50,173,$66.00
2024-08-30,12:47:00,19534.25,SELL,3,0.02h,Stop Loss,$28.50,$94.50,$111140.00,173,$94.50
2024-08-30,13:09:00,19536.75,BUY,3,0.02h,Stop Loss,$19.50,$114.00,$111159.50,173,$114.00
2024-08-30,13:34:00,19525.5,SELL,3,0.02h,Stop Loss,$40.50,$154.50,$111200.00,173,$154.50
2024-08-30,13:42:00,19565.0,BUY,3,0.02h,Stop Loss,$18.00,$172.50,$111218.00,173,$172.50
2024-08-30,14:15:00,19575.25,SELL,3,0.02h,Stop Loss,$75.00,$247.50,$111293.00,173,$247.50
2024-08-30,14:37:00,19583.0,BUY,3,0.02h,Stop Loss,$-9.00,$238.50,$111284.00,173,$238.50
2024-08-30,14:47:00,19555.25,SELL,3,0.02h,Stop Loss,$28.50,$267.00,$111312.50,173,$267.00
2024-08-30,14:50:00,19588.5,BUY,3,0.02h,Break Even,$-1.50,$265.50,$111311.00,173,$265.50
2024-08-30,14:53:00,19563.25,SELL,3,0.02h,Stop Loss,$130.50,$396.00,$111441.50,173,$396.00
2024-08-30,15:54:00,19470.75,BUY,3,0.02h,Stop Loss,$6.00,$402.00,$111447.50,173,$402.00
2024-08-30,16:01:00,19424.25,SELL,3,0.02h,Stop Loss,$49.50,$451.50,$111497.00,173,$451.50
2024-08-30,16:08:00,19467.5,BUY,3,0.02h,Stop Loss,$27.00,$478.50,$111524.00,173,$478.50
2024-08-30,16:22:00,19456.0,SELL,3,0.02h,Stop Loss,$19.50,$498.00,$111543.50,173,$498.00
2024-08-30,16:52:00,19431.75,BUY,3,0.02h,Stop Loss,$76.50,$574.50,$111620.00,173,$574.50
2024-08-30,17:24:00,19458.25,SELL,3,0.02h,Stop Loss,$31.50,$606.00,$111651.50,173,$606.00
2024-08-30,17:32:00,19472.75,BUY,3,0.02h,Stop Loss,$42.00,$648.00,$111693.50,173,$648.00
2024-08-30,17:45:00,19467.0,SELL,3,0.02h,Stop Loss,$24.00,$672.00,$111717.50,173,$672.00
2024-08-30,18:12:00,19469.25,BUY,3,0.02h,Stop Loss,$21.00,$693.00,$111738.50,173,$693.00
2024-08-30,19:13:00,19504.5,SELL,3,0.02h,Stop Loss,$48.00,$741.00,$111786.50,173,$741.00
2024-08-30,19:19:00,19520.25,BUY,3,0.02h,Stop Loss,$6.00,$747.00,$111792.50,173,$747.00
2024-08-30,19:44:00,19529.5,SELL,3,0.02h,Break Even,$-1.50,$745.50,$111791.00,173,$745.50
2024-08-30,19:51:00,19593.5,BUY,3,0.02h,Stop Loss,$61.50,$807.00,$111852.50,173,$807.00
2024-08-30,20:42:00,19597.75,SELL,3,0.02h,Stop Loss,$-9.00,$798.00,$111843.50,173,$798.00
,,,,,,,,,,,
2024-09-02,12:01:00,19610.5,BUY,3,0.02h,Break Even,$-1.50,$-1.50,$111842.00,174,$-1.50
2024-09-02,12:29:00,19613.0,SELL,3,0.02h,Stop Loss,$-9.00,$-10.50,$111833.00,174,$-10.50
2024-09-02,12:32:00,19616.75,BUY,3,0.02h,Break Even,$-1.50,$-12.00,$111831.50,174,$-12.00
2024-09-02,12:35:00,19613.5,SELL,3,0.02h,Stop Loss,$-9.00,$-21.00,$111822.50,174,$-21.00
2024-09-02,12:53:00,19613.25,BUY,3,0.02h,Stop Loss,$-9.00,$-30.00,$111813.50,174,$-30.00
2024-09-02,12:58:00,19609.75,SELL,3,0.02h,Break Even,$-1.50,$-31.50,$111812.00,174,$-31.50
2024-09-02,13:02:00,19615.25,BUY,3,0.02h,Stop Loss,$4.50,$-27.00,$111816.50,174,$-27.00
2024-09-02,13:30:00,19618.0,SELL,3,0.02h,Stop Loss,$-9.00,$-36.00,$111807.50,174,$-36.00
2024-09-02,13:31:00,19621.75,BUY,3,0.02h,Stop Loss,$4.50,$-31.50,$111812.00,174,$-31.50
2024-09-02,13:35:00,19617.75,SELL,3,0.02h,Break Even,$-1.50,$-33.00,$111810.50,174,$-33.00
2024-09-02,13:39:00,19625.5,BUY,3,0.02h,Break Even,$-1.50,$-34.50,$111809.00,174,$-34.50
2024-09-02,14:00:00,19619.5,SELL,3,0.02h,Break Even,$-1.50,$-36.00,$111807.50,174,$-36.00
2024-09-02,14:32:00,19617.75,BUY,3,0.02h,Stop Loss,$58.50,$22.50,$111866.00,174,$22.50
2024-09-02,15:26:00,19656.25,SELL,3,0.02h,Break Even,$-1.50,$21.00,$111864.50,174,$21.00
2024-09-02,15:51:00,19653.75,BUY,3,0.02h,Break Even,$-1.50,$19.50,$111863.00,174,$19.50
2024-09-02,16:08:00,19650.0,SELL,3,0.02h,Stop Loss,$-9.00,$10.50,$111854.00,174,$10.50
2024-09-02,16:10:00,19654.75,BUY,3,0.02h,Break Even,$-1.50,$9.00,$111852.50,174,$9.00
2024-09-02,16:21:00,19651.25,SELL,3,0.02h,Break Even,$-1.50,$7.50,$111851.00,174,$7.50
2024-09-02,16:42:00,19653.5,BUY,3,0.02h,Stop Loss,$-9.00,$-1.50,$111842.00,174,$-1.50
2024-09-02,16:49:00,19648.0,SELL,3,0.02h,Stop Loss,$9.00,$7.50,$111851.00,174,$7.50
2024-09-02,22:01:00,19663.0,BUY,3,0.02h,Stop Loss,$-9.00,$-1.50,$111842.00,174,$-1.50
2024-09-02,22:25:00,19663.75,SELL,3,0.02h,Stop Loss,$19.50,$18.00,$111861.50,174,$18.00
,,,,,,,,,,,
2024-09-03,12:41:00,19514.75,BUY,3,0.02h,Stop Loss,$15.00,$15.00,$111876.50,175,$15.00
2024-09-03,12:54:00,19507.0,SELL,3,0.02h,Stop Loss,$10.50,$25.50,$111887.00,175,$25.50
2024-09-03,13:22:00,19495.0,BUY,3,0.02h,Stop Loss,$-9.00,$16.50,$111878.00,175,$16.50
2024-09-03,13:30:00,19478.25,SELL,3,0.02h,Stop Loss,$151.50,$168.00,$112029.50,175,$168.00
2024-09-03,15:13:00,19216.5,BUY,3,0.02h,Stop Loss,$28.50,$196.50,$112058.00,175,$196.50
2024-09-03,15:25:00,19195.75,SELL,3,0.02h,Stop Loss,$21.00,$217.50,$112079.00,175,$217.50
2024-09-03,15:37:00,19219.75,BUY,3,0.02h,Break Even,$-1.50,$216.00,$112077.50,175,$216.00
2024-09-03,15:41:00,19184.75,SELL,3,0.02h,Stop Loss,$36.00,$252.00,$112113.50,175,$252.00
2024-09-03,16:16:00,19176.5,BUY,3,0.02h,Stop Loss,$97.50,$349.50,$112211.00,175,$349.50
2024-09-03,16:27:00,19159.25,SELL,3,0.02h,Stop Loss,$6.00,$355.50,$112217.00,175,$355.50
2024-09-03,17:08:00,19157.75,BUY,3,0.02h,Stop Loss,$27.00,$382.50,$112244.00,175,$382.50
2024-09-03,17:13:00,19139.0,SELL,3,0.02h,Stop Loss,$57.00,$439.50,$112301.00,175,$439.50
2024-09-03,17:22:00,19168.0,BUY,3,0.02h,Stop Loss,$42.00,$481.50,$112343.00,175,$481.50
2024-09-03,17:35:00,19138.25,SELL,3,0.02h,Stop Loss,$-9.00,$472.50,$112334.00,175,$472.50
2024-09-03,18:40:00,19056.25,BUY,3,0.02h,Stop Loss,$10.50,$483.00,$112344.50,175,$483.00
2024-09-03,18:43:00,19049.75,SELL,3,0.02h,Stop Loss,$15.00,$498.00,$112359.50,175,$498.00
2024-09-03,19:02:00,19055.75,BUY,3,0.02h,Break Even,$-1.50,$496.50,$112358.00,175,$496.50
2024-09-03,19:12:00,19045.75,SELL,3,0.02h,Stop Loss,$16.50,$513.00,$112374.50,175,$513.00
2024-09-03,19:22:00,19060.25,BUY,3,0.02h,Break Even,$-1.50,$511.50,$112373.00,175,$511.50
2024-09-03,19:25:00,19044.25,SELL,3,0.02h,Stop Loss,$10.50,$522.00,$112383.50,175,$522.00
2024-09-03,19:59:00,19001.25,BUY,3,0.02h,Stop Loss,$64.50,$586.50,$112448.00,175,$586.50
2024-09-03,20:19:00,18994.0,SELL,3,0.02h,Stop Loss,$-9.00,$577.50,$112439.00,175,$577.50
2024-09-03,20:55:00,18987.5,BUY,3,0.02h,Stop Loss,$21.00,$598.50,$112460.00,175,$598.50
2024-09-03,22:06:00,18971.0,SELL,3,0.02h,Break Even,$-1.50,$597.00,$112458.50,175,$597.00
2024-09-03,22:20:00,18982.0,BUY,3,0.02h,Stop Loss,$18.00,$615.00,$112476.50,175,$615.00
2024-09-03,22:50:00,18981.0,SELL,3,0.02h,Stop Loss,$-9.00,$606.00,$112467.50,175,$606.00
,,,,,,,,,,,
2024-09-04,12:44:00,18888.75,BUY,3,0.02h,Stop Loss,$18.00,$18.00,$112485.50,176,$18.00
2024-09-04,13:11:00,18892.25,SELL,3,0.02h,Stop Loss,$4.50,$22.50,$112490.00,176,$22.50
2024-09-04,13:35:00,18922.25,BUY,3,0.02h,Break Even,$-1.50,$21.00,$112488.50,176,$21.00
2024-09-04,14:01:00,18852.0,SELL,3,0.02h,Break Even,$-1.50,$19.50,$112487.00,176,$19.50
2024-09-04,14:10:00,18971.75,BUY,3,0.02h,Stop Loss,$157.50,$177.00,$112644.50,176,$177.00
2024-09-04,14:19:00,18931.5,SELL,3,0.02h,Stop Loss,$25.50,$202.50,$112670.00,176,$202.50
2024-09-04,14:24:00,18962.0,BUY,3,0.02h,Stop Loss,$48.00,$250.50,$112718.00,176,$250.50
2024-09-04,15:16:00,19054.75,SELL,3,0.02h,Stop Loss,$31.50,$282.00,$112749.50,176,$282.00
2024-09-04,15:55:00,19029.25,BUY,3,0.02h,Stop Loss,$-9.00,$273.00,$112740.50,176,$273.00
2024-09-04,15:57:00,18991.25,SELL,3,0.02h,Stop Loss,$7.50,$280.50,$112748.00,176,$280.50
2024-09-04,16:17:00,19023.5,BUY,3,0.02h,Stop Loss,$46.50,$327.00,$112794.50,176,$327.00
2024-09-04,16:47:00,19032.5,SELL,3,0.02h,Break Even,$-1.50,$325.50,$112793.00,176,$325.50
2024-09-04,16:56:00,19053.25,BUY,3,0.02h,Stop Loss,$13.50,$339.00,$112806.50,176,$339.00
2024-09-04,17:05:00,19041.25,SELL,3,0.02h,Stop Loss,$-9.00,$330.00,$112797.50,176,$330.00
2024-09-04,17:11:00,19060.0,BUY,3,0.02h,Stop Loss,$21.00,$351.00,$112818.50,176,$351.00
2024-09-04,17:15:00,19036.75,SELL,3,0.02h,Break Even,$-1.50,$349.50,$112817.00,176,$349.50
2024-09-04,17:23:00,19058.75,BUY,3,0.02h,Stop Loss,$-9.00,$340.50,$112808.00,176,$340.50
2024-09-04,17:25:00,19037.5,SELL,3,0.02h,Stop Loss,$22.50,$363.00,$112830.50,176,$363.00
2024-09-04,18:15:00,19016.75,BUY,3,0.02h,Stop Loss,$34.50,$397.50,$112865.00,176,$397.50
2024-09-04,18:20:00,18991.0,SELL,3,0.02h,Stop Loss,$12.00,$409.50,$112877.00,176,$409.50
2024-09-04,18:27:00,19018.25,BUY,3,0.02h,Break Even,$-1.50,$408.00,$112875.50,176,$408.00
2024-09-04,18:35:00,18991.25,SELL,3,0.02h,Stop Loss,$106.50,$514.50,$112982.00,176,$514.50
2024-09-04,19:24:00,18937.75,BUY,3,0.02h,Stop Loss,$69.00,$583.50,$113051.00,176,$583.50
2024-09-04,20:01:00,18960.75,SELL,3,0.02h,Stop Loss,$37.50,$621.00,$113088.50,176,$621.00
2024-09-04,20:30:00,18954.75,BUY,3,0.02h,Break Even,$-1.50,$619.50,$113087.00,176,$619.50
2024-09-04,22:20:00,18962.75,SELL,3,0.02h,Stop Loss,$-9.00,$610.50,$113078.00,176,$610.50
2024-09-04,22:33:00,18971.75,BUY,3,0.02h,Stop Loss,$28.50,$639.00,$113106.50,176,$639.00
2024-09-04,22:59:00,18974.25,SELL,3,0.02h,Break Even,$-1.50,$637.50,$113105.00,176,$637.50
,,,,,,,,,,,
2024-09-05,12:33:00,18911.5,BUY,3,0.02h,Stop Loss,$4.50,$4.50,$113109.50,177,$4.50
2024-09-05,12:41:00,18861.75,SELL,3,0.02h,Stop Loss,$34.50,$39.00,$113144.00,177,$39.00
2024-09-05,12:48:00,18889.75,BUY,3,0.02h,Stop Loss,$28.50,$67.50,$113172.50,177,$67.50
2024-09-05,13:26:00,18897.5,SELL,3,0.02h,Stop Loss,$15.00,$82.50,$113187.50,177,$82.50
2024-09-05,13:34:00,18932.25,BUY,3,0.02h,Stop Loss,$19.50,$102.00,$113207.00,177,$102.00
2024-09-05,14:17:00,19048.75,SELL,3,0.02h,Stop Loss,$21.00,$123.00,$113228.00,177,$123.00
2024-09-05,14:18:00,19058.25,BUY,3,0.02h,Stop Loss,$37.50,$160.50,$113265.50,177,$160.50
2024-09-05,14:45:00,19071.0,SELL,3,0.02h,Stop Loss,$205.50,$366.00,$113471.00,177,$366.00
2024-09-05,16:04:00,18907.25,BUY,3,0.02h,Stop Loss,$-9.00,$357.00,$113462.00,177,$357.00
2024-09-05,16:17:00,18879.75,SELL,3,0.02h,Stop Loss,$10.50,$367.50,$113472.50,177,$367.50
2024-09-05,16:21:00,18899.75,BUY,3,0.02h,Stop Loss,$15.00,$382.50,$113487.50,177,$382.50
2024-09-05,16:53:00,18932.0,SELL,3,0.02h,Stop Loss,$37.50,$420.00,$113525.00,177,$420.00
2024-09-05,16:58:00,18950.75,BUY,3,0.02h,Break Even,$-1.50,$418.50,$113523.50,177,$418.50
2024-09-05,17:06:00,18930.5,SELL,3,0.02h,Stop Loss,$135.00,$553.50,$113658.50,177,$553.50
2024-09-05,17:38:00,18950.25,BUY,3,0.02h,Break Even,$-1.50,$552.00,$113657.00,177,$552.00
2024-09-05,18:26:00,18993.25,SELL,3,0.02h,Break Even,$-1.50,$550.50,$113655.50,177,$550.50
2024-09-05,18:38:00,19009.5,BUY,3,0.02h,Stop Loss,$-9.00,$541.50,$113646.50,177,$541.50
2024-09-05,18:43:00,18989.25,SELL,3,0.02h,Break Even,$-1.50,$540.00,$113645.00,177,$540.00
2024-09-05,18:48:00,19012.0,BUY,3,0.02h,Break Even,$-1.50,$538.50,$113643.50,177,$538.50
2024-09-05,18:59:00,18992.5,SELL,3,0.02h,Stop Loss,$6.00,$544.50,$113649.50,177,$544.50
2024-09-05,19:32:00,18971.5,BUY,3,0.02h,Stop Loss,$45.00,$589.50,$113694.50,177,$589.50
2024-09-05,19:42:00,18942.5,SELL,3,0.02h,Stop Loss,$54.00,$643.50,$113748.50,177,$643.50
2024-09-05,20:00:00,18975.75,BUY,3,0.02h,Stop Loss,$49.50,$693.00,$113798.00,177,$693.00
2024-09-05,20:17:00,18933.5,SELL,3,0.02h,Stop Loss,$102.00,$795.00,$113900.00,177,$795.00
2024-09-05,20:47:00,18931.0,BUY,3,0.02h,Stop Loss,$-9.00,$786.00,$113891.00,177,$786.00
2024-09-05,20:49:00,18926.5,SELL,3,0.02h,Stop Loss,$36.00,$822.00,$113927.00,177,$822.00
2024-09-05,22:02:00,18929.75,BUY,3,0.02h,Stop Loss,$-9.00,$813.00,$113918.00,177,$813.00
2024-09-05,22:11:00,18918.5,SELL,3,0.02h,Stop Loss,$16.50,$829.50,$113934.50,177,$829.50
2024-09-05,22:44:00,18915.5,BUY,3,0.02h,Stop Loss,$-9.00,$820.50,$113925.50,177,$820.50
2024-09-05,22:48:00,18910.75,SELL,3,0.02h,Stop Loss,$-9.00,$811.50,$113916.50,177,$811.50
2024-09-05,22:53:00,18921.0,BUY,3,0.02h,Stop Loss,$-9.00,$802.50,$113907.50,177,$802.50
,,,,,,,,,,,
2024-09-06,12:00:00,18782.75,SELL,3,0.02h,Break Even,$-1.50,$-1.50,$113906.00,178,$-1.50
2024-09-06,12:31:00,18853.25,BUY,3,0.02h,Stop Loss,$9.00,$7.50,$113915.00,178,$7.50
2024-09-06,13:33:00,18891.75,SELL,3,0.02h,Stop Loss,$19.50,$27.00,$113934.50,178,$27.00
2024-09-06,15:03:00,18603.5,BUY,3,0.02h,Stop Loss,$61.50,$88.50,$113996.00,178,$88.50
2024-09-06,15:09:00,18536.0,SELL,3,0.02h,Stop Loss,$33.00,$121.50,$114029.00,178,$121.50
2024-09-06,15:34:00,18544.75,BUY,3,0.02h,Stop Loss,$-9.00,$112.50,$114020.00,178,$112.50
2024-09-06,15:36:00,18520.5,SELL,3,0.02h,Stop Loss,$78.00,$190.50,$114098.00,178,$190.50
2024-09-06,16:14:00,18477.5,BUY,3,0.02h,Stop Loss,$52.50,$243.00,$114150.50,178,$243.00
2024-09-06,16:15:00,18470.0,SELL,3,0.02h,Stop Loss,$45.00,$288.00,$114195.50,178,$288.00
2024-09-06,16:26:00,18484.5,BUY,3,0.02h,Break Even,$-1.50,$286.50,$114194.00,178,$286.50
2024-09-06,16:29:00,18456.25,SELL,3,0.02h,Stop Loss,$30.00,$316.50,$114224.00,178,$316.50
2024-09-06,16:36:00,18484.25,BUY,3,0.02h,Stop Loss,$25.50,$342.00,$114249.50,178,$342.00
2024-09-06,16:41:00,18449.0,SELL,3,0.02h,Stop Loss,$7.50,$349.50,$114257.00,178,$349.50
2024-09-06,16:46:00,18472.5,BUY,3,0.02h,Break Even,$-1.50,$348.00,$114255.50,178,$348.00
2024-09-06,16:47:00,18463.25,SELL,3,0.02h,Stop Loss,$16.50,$364.50,$114272.00,178,$364.50
2024-09-06,17:05:00,18470.25,BUY,3,0.02h,Break Even,$-1.50,$363.00,$114270.50,178,$363.00
2024-09-06,17:33:00,18494.25,SELL,3,0.02h,Stop Loss,$57.00,$420.00,$114327.50,178,$420.00
2024-09-06,17:57:00,18490.75,BUY,3,0.02h,Stop Loss,$-9.00,$411.00,$114318.50,178,$411.00
2024-09-06,18:03:00,18457.25,SELL,3,0.02h,Stop Loss,$13.50,$424.50,$114332.00,178,$424.50
2024-09-06,18:42:00,18458.25,BUY,3,0.02h,Stop Loss,$30.00,$454.50,$114362.00,178,$454.50
2024-09-06,19:37:00,18495.5,SELL,3,0.02h,Stop Loss,$111.00,$565.50,$114473.00,178,$565.50
2024-09-06,19:50:00,18516.75,BUY,3,0.02h,Stop Loss,$70.50,$636.00,$114543.50,178,$636.00
2024-09-06,19:52:00,18477.5,SELL,3,0.02h,Stop Loss,$52.50,$688.50,$114596.00,178,$688.50
,,,,,,,,,,,
2024-09-09,12:00:00,18596.5,BUY,3,0.02h,Stop Loss,$24.00,$24.00,$114620.00,179,$24.00
2024-09-09,14:20:00,18651.75,SELL,3,0.02h,Stop Loss,$51.00,$75.00,$114671.00,179,$75.00
2024-09-09,15:27:00,18541.5,BUY,3,0.02h,Stop Loss,$9.00,$84.00,$114680.00,179,$84.00
2024-09-09,17:25:00,18709.0,SELL,3,0.02h,Break Even,$-1.50,$82.50,$114678.50,179,$82.50
2024-09-09,18:47:00,18613.25,BUY,3,0.02h,Stop Loss,$3.00,$85.50,$114681.50,179,$85.50
2024-09-09,19:00:00,18603.75,SELL,3,0.02h,Stop Loss,$24.00,$109.50,$114705.50,179,$109.50
2024-09-09,19:11:00,18608.0,BUY,3,0.02h,Stop Loss,$7.50,$117.00,$114713.00,179,$117.00
2024-09-09,19:12:00,18600.0,SELL,3,0.02h,Break Even,$-1.50,$115.50,$114711.50,179,$115.50
2024-09-09,19:13:00,18604.25,BUY,3,0.02h,Break Even,$-1.50,$114.00,$114710.00,179,$114.00
2024-09-09,19:15:00,18596.5,SELL,3,0.02h,Stop Loss,$-9.00,$105.00,$114701.00,179,$105.00
2024-09-09,19:16:00,18606.25,BUY,3,0.02h,Stop Loss,$21.00,$126.00,$114722.00,179,$126.00
2024-09-09,19:21:00,18596.5,SELL,3,0.02h,Stop Loss,$54.00,$180.00,$114776.00,179,$180.00
2024-09-09,19:26:00,18608.25,BUY,3,0.02h,Stop Loss,$61.50,$241.50,$114837.50,179,$241.50
2024-09-09,20:49:00,18716.5,SELL,3,0.02h,Stop Loss,$-9.00,$232.50,$114828.50,179,$232.50
2024-09-09,22:01:00,18735.0,BUY,3,0.02h,Stop Loss,$-9.00,$223.50,$114819.50,179,$223.50
2024-09-09,22:12:00,18716.25,SELL,3,0.02h,Stop Loss,$22.50,$246.00,$114842.00,179,$246.00
2024-09-09,22:32:00,18724.5,BUY,3,0.02h,Stop Loss,$-9.00,$237.00,$114833.00,179,$237.00
2024-09-09,22:44:00,18712.0,SELL,3,0.02h,Stop Loss,$9.00,$246.00,$114842.00,179,$246.00
,,,,,,,,,,,
2024-09-10,12:10:00,18715.0,BUY,3,0.02h,Stop Loss,$7.50,$7.50,$114849.50,180,$7.50
2024-09-10,13:17:00,18756.0,SELL,3,0.02h,Break Even,$-1.50,$6.00,$114848.00,180,$6.00
2024-09-10,13:19:00,18760.0,BUY,3,0.02h,Stop Loss,$16.50,$22.50,$114864.50,180,$22.50
2024-09-10,13:38:00,18747.0,SELL,3,0.02h,Stop Loss,$67.50,$90.00,$114932.00,180,$90.00
2024-09-10,13:54:00,18772.75,BUY,3,0.02h,Stop Loss,$46.50,$136.50,$114978.50,180,$136.50
2024-09-10,14:13:00,18739.5,SELL,3,0.02h,Stop Loss,$186.00,$322.50,$115164.50,180,$322.50
2024-09-10,14:30:00,18780.75,BUY,3,0.02h,Stop Loss,$10.50,$333.00,$115175.00,180,$333.00
2024-09-10,14:44:00,18734.0,SELL,3,0.02h,Stop Loss,$90.00,$423.00,$115265.00,180,$423.00
2024-09-10,15:10:00,18732.25,BUY,3,0.02h,Stop Loss,$91.50,$514.50,$115356.50,180,$514.50
2024-09-10,15:40:00,18742.0,SELL,3,0.02h,Stop Loss,$9.00,$523.50,$115365.50,180,$523.50
2024-09-10,16:25:00,18647.0,BUY,3,0.02h,Stop Loss,$27.00,$550.50,$115392.50,180,$550.50
2024-09-10,18:53:00,18820.75,SELL,3,0.02h,Stop Loss,$-9.00,$541.50,$115383.50,180,$541.50
2024-09-10,19:10:00,18833.0,BUY,3,0.02h,Stop Loss,$48.00,$589.50,$115431.50,180,$589.50
2024-09-10,19:45:00,18848.0,SELL,3,0.02h,Break Even,$-1.50,$588.00,$115430.00,180,$588.00
2024-09-10,19:48:00,18858.25,BUY,3,0.02h,Stop Loss,$-9.00,$579.00,$115421.00,180,$579.00
2024-09-10,19:51:00,18840.25,SELL,3,0.02h,Stop Loss,$-9.00,$570.00,$115412.00,180,$570.00
2024-09-10,19:56:00,18855.75,BUY,3,0.02h,Stop Loss,$15.00,$585.00,$115427.00,180,$585.00
2024-09-10,20:03:00,18846.25,SELL,3,0.02h,Break Even,$-1.50,$583.50,$115425.50,180,$583.50
2024-09-10,20:55:00,18831.25,BUY,3,0.02h,Stop Loss,$-9.00,$574.50,$115416.50,180,$574.50
2024-09-10,22:13:00,18828.0,SELL,3,0.02h,Break Even,$-1.50,$573.00,$115415.00,180,$573.00
2024-09-10,22:16:00,18834.25,BUY,3,0.02h,Stop Loss,$-9.00,$564.00,$115406.00,180,$564.00
2024-09-10,22:31:00,18828.75,SELL,3,0.02h,Stop Loss,$-9.00,$555.00,$115397.00,180,$555.00
2024-09-10,22:41:00,18834.0,BUY,3,0.02h,Stop Loss,$25.50,$580.50,$115422.50,180,$580.50
,,,,,,,,,,,
2024-09-11,12:01:00,18828.5,SELL,3,0.02h,Stop Loss,$10.50,$10.50,$115433.00,181,$10.50
2024-09-11,12:14:00,18839.0,BUY,3,0.02h,Stop Loss,$-9.00,$1.50,$115424.00,181,$1.50
2024-09-11,12:31:00,18754.25,SELL,3,0.02h,Stop Loss,$120.00,$121.50,$115544.00,181,$121.50
2024-09-11,12:50:00,18822.5,BUY,3,0.02h,Stop Loss,$30.00,$151.50,$115574.00,181,$151.50
2024-09-11,13:32:00,18891.0,SELL,3,0.02h,Stop Loss,$97.50,$249.00,$115671.50,181,$249.00
2024-09-11,15:05:00,18607.25,BUY,3,0.02h,Stop Loss,$225.00,$474.00,$115896.50,181,$474.00
2024-09-11,16:48:00,18885.25,SELL,3,0.02h,Stop Loss,$27.00,$501.00,$115923.50,181,$501.00
2024-09-11,16:55:00,18916.0,BUY,3,0.02h,Stop Loss,$-9.00,$492.00,$115914.50,181,$492.00
2024-09-11,18:55:00,19107.25,SELL,3,0.02h,Break Even,$-1.50,$490.50,$115913.00,181,$490.50
2024-09-11,18:56:00,19134.75,BUY,3,0.02h,Stop Loss,$16.50,$507.00,$115929.50,181,$507.00
2024-09-11,19:00:00,19127.75,SELL,3,0.02h,Stop Loss,$81.00,$588.00,$116010.50,181,$588.00
2024-09-11,19:08:00,19138.5,BUY,3,0.02h,Stop Loss,$40.50,$628.50,$116051.00,181,$628.50
2024-09-11,20:47:00,19246.25,SELL,3,0.02h,Break Even,$-1.50,$627.00,$116049.50,181,$627.00
2024-09-11,20:48:00,19249.0,BUY,3,0.02h,Stop Loss,$-9.00,$618.00,$116040.50,181,$618.00
2024-09-11,20:50:00,19246.25,SELL,3,0.02h,Break Even,$-1.50,$616.50,$116039.00,181,$616.50
2024-09-11,20:52:00,19249.5,BUY,3,0.02h,Stop Loss,$-9.00,$607.50,$116030.00,181,$607.50
2024-09-11,20:57:00,19242.75,SELL,3,0.02h,Stop Loss,$-9.00,$598.50,$116021.00,181,$598.50
2024-09-11,22:21:00,19245.25,BUY,3,0.02h,Break Even,$-1.50,$597.00,$116019.50,181,$597.00
,,,,,,,,,,,
2024-09-12,12:35:00,19269.25,SELL,3,0.02h,Stop Loss,$3.00,$3.00,$116022.50,182,$3.00
2024-09-12,12:55:00,19501.5,BUY,3,0.02h,Break Even,$-1.50,$1.50,$116021.00,182,$1.50
2024-09-12,12:58:00,19267.5,SELL,3,0.02h,Stop Loss,$-9.00,$-7.50,$116012.00,182,$-7.50
2024-09-12,12:59:00,19495.75,BUY,3,0.02h,Stop Loss,$-9.00,$-16.50,$116003.00,182,$-16.50
2024-09-12,13:01:00,19256.25,SELL,3,0.02h,Stop Loss,$-9.00,$-25.50,$115994.00,182,$-25.50
2024-09-12,13:02:00,19498.0,BUY,3,0.02h,Stop Loss,$-9.00,$-34.50,$115985.00,182,$-34.50
2024-09-12,13:03:00,19267.75,SELL,3,0.02h,Stop Loss,$-9.00,$-43.50,$115976.00,182,$-43.50
2024-09-12,13:04:00,19498.25,BUY,3,0.02h,Stop Loss,$33.00,$-10.50,$116009.00,182,$-10.50
2024-09-12,13:09:00,19273.0,SELL,3,0.02h,Stop Loss,$-9.00,$-19.50,$116000.00,182,$-19.50
2024-09-12,13:10:00,19512.0,BUY,3,0.02h,Stop Loss,$7.50,$-12.00,$116007.50,182,$-12.00
2024-09-12,13:21:00,19261.5,SELL,3,0.02h,Stop Loss,$-9.00,$-21.00,$115998.50,182,$-21.00
2024-09-12,13:22:00,19495.75,BUY,3,0.02h,Stop Loss,$-9.00,$-30.00,$115989.50,182,$-30.00
2024-09-12,13:23:00,19261.5,SELL,3,0.02h,Stop Loss,$-9.00,$-39.00,$115980.50,182,$-39.00
2024-09-12,13:26:00,19499.5,BUY,3,0.02h,Stop Loss,$22.50,$-16.50,$116003.00,182,$-16.50
2024-09-12,13:30:00,19259.0,SELL,3,0.02h,Stop Loss,$145.50,$129.00,$116148.50,182,$129.00
2024-09-12,13:42:00,19495.0,BUY,3,0.02h,Stop Loss,$120.00,$249.00,$116268.50,182,$249.00
2024-09-12,13:47:00,19247.0,SELL,3,0.02h,Stop Loss,$154.50,$403.50,$116423.00,182,$403.50
2024-09-12,13:52:00,19441.25,BUY,3,0.02h,Stop Loss,$-9.00,$394.50,$116414.00,182,$394.50
2024-09-12,13:53:00,19232.0,SELL,3,0.02h,Stop Loss,$-9.00,$385.50,$116405.00,182,$385.50
2024-09-12,13:55:00,19494.25,BUY,3,0.02h,Stop Loss,$-9.00,$376.50,$116396.00,182,$376.50
2024-09-12,13:56:00,19240.75,SELL,3,0.02h,Stop Loss,$18.00,$394.50,$116414.00,182,$394.50
2024-09-12,14:01:00,19490.0,BUY,3,0.02h,Stop Loss,$57.00,$451.50,$116471.00,182,$451.50
2024-09-12,14:05:00,19241.0,SELL,3,0.02h,Stop Loss,$45.00,$496.50,$116516.00,182,$496.50
2024-09-12,14:14:00,19548.0,BUY,3,0.02h,Stop Loss,$21.00,$517.50,$116537.00,182,$517.50
2024-09-12,14:25:00,19323.75,SELL,3,0.02h,Stop Loss,$-9.00,$508.50,$116528.00,182,$508.50
2024-09-12,14:26:00,19561.25,BUY,3,0.02h,Stop Loss,$-9.00,$499.50,$116519.00,182,$499.50
2024-09-12,14:28:00,19331.25,SELL,3,0.02h,Stop Loss,$-9.00,$490.50,$116510.00,182,$490.50
2024-09-12,14:29:00,19574.5,BUY,3,0.02h,Break Even,$-1.50,$489.00,$116508.50,182,$489.00
2024-09-12,14:38:00,19301.5,SELL,3,0.02h,Stop Loss,$42.00,$531.00,$116550.50,182,$531.00
2024-09-12,14:51:00,19543.0,BUY,3,0.02h,Stop Loss,$22.50,$553.50,$116573.00,182,$553.50
2024-09-12,14:54:00,19312.5,SELL,3,0.02h,Stop Loss,$-9.00,$544.50,$116564.00,182,$544.50
2024-09-12,14:56:00,19582.25,BUY,3,0.02h,Stop Loss,$-9.00,$535.50,$116555.00,182,$535.50
2024-09-12,14:57:00,19334.5,SELL,3,0.02h,Stop Loss,$-9.00,$526.50,$116546.00,182,$526.50
2024-09-12,14:58:00,19546.25,BUY,3,0.02h,Stop Loss,$4.50,$531.00,$116550.50,182,$531.00
2024-09-12,15:01:00,19266.25,SELL,3,0.02h,Break Even,$-1.50,$529.50,$116549.00,182,$529.50
2024-09-12,15:06:00,19563.5,BUY,3,0.02h,Break Even,$-1.50,$528.00,$116547.50,182,$528.00
2024-09-12,15:15:00,19375.25,SELL,3,0.02h,Stop Loss,$300.00,$828.00,$116847.50,182,$828.00
2024-09-12,15:20:00,19570.25,BUY,3,0.02h,Break Even,$-1.50,$826.50,$116846.00,182,$826.50
2024-09-12,15:23:00,19317.5,SELL,3,0.02h,Stop Loss,$72.00,$898.50,$116918.00,182,$898.50
2024-09-12,15:27:00,19529.5,BUY,3,0.02h,Stop Loss,$-9.00,$889.50,$116909.00,182,$889.50
2024-09-12,15:28:00,19309.25,SELL,3,0.02h,Stop Loss,$-9.00,$880.50,$116900.00,182,$880.50
2024-09-12,15:29:00,19536.25,BUY,3,0.02h,Stop Loss,$-9.00,$871.50,$116891.00,182,$871.50
2024-09-12,15:30:00,19288.25,SELL,3,0.02h,Stop Loss,$-9.00,$862.50,$116882.00,182,$862.50
2024-09-12,15:31:00,19523.25,BUY,3,0.02h,Stop Loss,$78.00,$940.50,$116960.00,182,$940.50
2024-09-12,15:33:00,19299.75,SELL,3,0.02h,Stop Loss,$-9.00,$931.50,$116951.00,182,$931.50
2024-09-12,15:34:00,19528.0,BUY,3,0.02h,Stop Loss,$-9.00,$922.50,$116942.00,182,$922.50
2024-09-12,15:35:00,19282.5,SELL,3,0.02h,Break Even,$-1.50,$921.00,$116940.50,182,$921.00
2024-09-12,15:38:00,19535.75,BUY,3,0.02h,Stop Loss,$-9.00,$912.00,$116931.50,182,$912.00
2024-09-12,15:46:00,19268.0,SELL,3,0.02h,Stop Loss,$-9.00,$903.00,$116922.50,182,$903.00
2024-09-12,15:48:00,19499.25,BUY,3,0.02h,Break Even,$-1.50,$901.50,$116921.00,182,$901.50
2024-09-12,15:57:00,19272.25,SELL,3,0.02h,Stop Loss,$-9.00,$892.50,$116912.00,182,$892.50
2024-09-12,15:59:00,19494.5,BUY,3,0.02h,Stop Loss,$-9.00,$883.50,$116903.00,182,$883.50
2024-09-12,16:00:00,19265.5,SELL,3,0.02h,Stop Loss,$25.50,$909.00,$116928.50,182,$909.00
2024-09-12,16:06:00,19521.25,BUY,3,0.02h,Stop Loss,$-9.00,$900.00,$116919.50,182,$900.00
2024-09-12,16:07:00,19298.25,SELL,3,0.02h,Stop Loss,$-9.00,$891.00,$116910.50,182,$891.00
2024-09-12,16:15:00,19539.0,BUY,3,0.02h,Stop Loss,$4.50,$895.50,$116915.00,182,$895.50
2024-09-12,16:18:00,19301.25,SELL,3,0.02h,Break Even,$-1.50,$894.00,$116913.50,182,$894.00
2024-09-12,16:24:00,19530.5,BUY,3,0.02h,Stop Loss,$-9.00,$885.00,$116904.50,182,$885.00
2024-09-12,16:25:00,19303.0,SELL,3,0.02h,Stop Loss,$-9.00,$876.00,$116895.50,182,$876.00
2024-09-12,16:27:00,19553.75,BUY,3,0.02h,Stop Loss,$-9.00,$867.00,$116886.50,182,$867.00
2024-09-12,16:28:00,19307.0,SELL,3,0.02h,Break Even,$-1.50,$865.50,$116885.00,182,$865.50
2024-09-12,16:34:00,19550.25,BUY,3,0.02h,Stop Loss,$-9.00,$856.50,$116876.00,182,$856.50
2024-09-12,16:55:00,19357.5,SELL,3,0.02h,Stop Loss,$33.00,$889.50,$116909.00,182,$889.50
2024-09-12,16:58:00,19613.25,BUY,3,0.02h,Stop Loss,$-9.00,$880.50,$116900.00,182,$880.50
2024-09-12,16:59:00,19381.25,SELL,3,0.02h,Stop Loss,$-9.00,$871.50,$116891.00,182,$871.50
2024-09-12,17:00:00,19615.5,BUY,3,0.02h,Stop Loss,$52.50,$924.00,$116943.50,182,$924.00
2024-09-12,17:11:00,19389.5,SELL,3,0.02h,Stop Loss,$-9.00,$915.00,$116934.50,182,$915.00
2024-09-12,17:12:00,19617.0,BUY,3,0.02h,Stop Loss,$-9.00,$906.00,$116925.50,182,$906.00
2024-09-12,17:13:00,19388.75,SELL,3,0.02h,Stop Loss,$-9.00,$897.00,$116916.50,182,$897.00
2024-09-12,17:18:00,19635.25,BUY,3,0.02h,Break Even,$-1.50,$895.50,$116915.00,182,$895.50
2024-09-12,17:29:00,19413.25,SELL,3,0.02h,Stop Loss,$-9.00,$886.50,$116906.00,182,$886.50
2024-09-12,17:30:00,19639.25,BUY,3,0.02h,Stop Loss,$6.00,$892.50,$116912.00,182,$892.50
2024-09-12,17:34:00,19404.75,SELL,3,0.02h,Stop Loss,$-9.00,$883.50,$116903.00,182,$883.50
2024-09-12,17:35:00,19644.75,BUY,3,0.02h,Stop Loss,$-9.00,$874.50,$116894.00,182,$874.50
2024-09-12,17:36:00,19410.5,SELL,3,0.02h,Stop Loss,$-9.00,$865.50,$116885.00,182,$865.50
2024-09-12,17:39:00,19662.75,BUY,3,0.02h,Stop Loss,$15.00,$880.50,$116900.00,182,$880.50
2024-09-12,17:43:00,19424.5,SELL,3,0.02h,Stop Loss,$31.50,$912.00,$116931.50,182,$912.00
2024-09-12,17:55:00,19691.75,BUY,3,0.02h,Stop Loss,$43.50,$955.50,$116975.00,182,$955.50
2024-09-12,18:06:00,19463.75,SELL,3,0.02h,Stop Loss,$13.50,$969.00,$116988.50,182,$969.00
2024-09-12,18:08:00,19696.0,BUY,3,0.02h,Stop Loss,$-9.00,$960.00,$116979.50,182,$960.00
2024-09-12,18:10:00,19454.25,SELL,3,0.02h,Stop Loss,$72.00,$1032.00,$117051.50,182,$1032.00
2024-09-12,18:14:00,19682.25,BUY,3,0.02h,Stop Loss,$-9.00,$1023.00,$117042.50,182,$1023.00
2024-09-12,18:16:00,19445.0,SELL,3,0.02h,Stop Loss,$-9.00,$1014.00,$117033.50,182,$1014.00
2024-09-12,18:17:00,19679.5,BUY,3,0.02h,Stop Loss,$-9.00,$1005.00,$117024.50,182,$1005.00
2024-09-12,18:18:00,19447.25,SELL,3,0.02h,Break Even,$-1.50,$1003.50,$117023.00,182,$1003.50
2024-09-12,18:24:00,19689.5,BUY,3,0.02h,Stop Loss,$-9.00,$994.50,$117014.00,182,$994.50
2024-09-12,18:25:00,19470.25,SELL,3,0.02h,Break Even,$-1.50,$993.00,$117012.50,182,$993.00
2024-09-12,18:28:00,19706.5,BUY,3,0.02h,Stop Loss,$-9.00,$984.00,$117003.50,182,$984.00
2024-09-12,18:29:00,19474.75,SELL,3,0.02h,Stop Loss,$-9.00,$975.00,$116994.50,182,$975.00
2024-09-12,18:30:00,19705.75,BUY,3,0.02h,Stop Loss,$42.00,$1017.00,$117036.50,182,$1017.00
2024-09-12,18:33:00,19453.0,SELL,3,0.02h,Stop Loss,$-9.00,$1008.00,$117027.50,182,$1008.00
2024-09-12,18:35:00,19700.75,BUY,3,0.02h,Stop Loss,$24.00,$1032.00,$117051.50,182,$1032.00
2024-09-12,18:46:00,19464.5,SELL,3,0.02h,Stop Loss,$-9.00,$1023.00,$117042.50,182,$1023.00
2024-09-12,18:47:00,19701.5,BUY,3,0.02h,Stop Loss,$-9.00,$1014.00,$117033.50,182,$1014.00
2024-09-12,18:48:00,19474.25,SELL,3,0.02h,Stop Loss,$75.00,$1089.00,$117108.50,182,$1089.00
2024-09-12,19:04:00,19677.0,BUY,3,0.02h,Stop Loss,$-9.00,$1080.00,$117099.50,182,$1080.00
2024-09-12,19:05:00,19439.75,SELL,3,0.02h,Stop Loss,$-9.00,$1071.00,$117090.50,182,$1071.00
2024-09-12,19:10:00,19692.25,BUY,3,0.02h,Stop Loss,$-9.00,$1062.00,$117081.50,182,$1062.00
2024-09-12,19:11:00,19460.25,SELL,3,0.02h,Stop Loss,$-9.00,$1053.00,$117072.50,182,$1053.00
2024-09-12,19:12:00,19684.75,BUY,3,0.02h,Stop Loss,$16.50,$1069.50,$117089.00,182,$1069.50
2024-09-12,19:21:00,19452.75,SELL,3,0.02h,Stop Loss,$63.00,$1132.50,$117152.00,182,$1132.50
2024-09-12,19:25:00,19684.75,BUY,3,0.02h,Stop Loss,$13.50,$1146.00,$117165.50,182,$1146.00
2024-09-12,19:35:00,19445.0,SELL,3,0.02h,Break Even,$-1.50,$1144.50,$117164.00,182,$1144.50
2024-09-12,19:45:00,19690.0,BUY,3,0.02h,Break Even,$-1.50,$1143.00,$117162.50,182,$1143.00
2024-09-12,19:47:00,19443.5,SELL,3,0.02h,Stop Loss,$-9.00,$1134.00,$117153.50,182,$1134.00
2024-09-12,19:48:00,19670.5,BUY,3,0.02h,Stop Loss,$3.00,$1137.00,$117156.50,182,$1137.00
2024-09-12,19:52:00,19437.25,SELL,3,0.02h,Stop Loss,$-9.00,$1128.00,$117147.50,182,$1128.00
2024-09-12,19:53:00,19665.0,BUY,3,0.02h,Stop Loss,$10.50,$1138.50,$117158.00,182,$1138.50
2024-09-12,19:56:00,19431.25,SELL,3,0.02h,Stop Loss,$-9.00,$1129.50,$117149.00,182,$1129.50
2024-09-12,19:57:00,19669.75,BUY,3,0.02h,Stop Loss,$-9.00,$1120.50,$117140.00,182,$1120.50
2024-09-12,19:58:00,19431.0,SELL,3,0.02h,Break Even,$-1.50,$1119.00,$117138.50,182,$1119.00
2024-09-12,20:01:00,19683.0,BUY,3,0.02h,Stop Loss,$28.50,$1147.50,$117167.00,182,$1147.50
2024-09-12,20:04:00,19447.75,SELL,3,0.02h,Stop Loss,$-9.00,$1138.50,$117158.00,182,$1138.50
2024-09-12,20:05:00,19683.0,BUY,3,0.02h,Stop Loss,$-9.00,$1129.50,$117149.00,182,$1129.50
2024-09-12,20:07:00,19419.5,SELL,3,0.02h,Stop Loss,$87.00,$1216.50,$117236.00,182,$1216.50
2024-09-12,20:14:00,19653.25,BUY,3,0.03h,Break Even,$-1.50,$1215.00,$117234.50,182,$1215.00
2024-09-12,20:23:00,19429.5,SELL,3,0.02h,Stop Loss,$-9.00,$1206.00,$117225.50,182,$1206.00
2024-09-12,20:25:00,19662.25,BUY,3,0.02h,Stop Loss,$-9.00,$1197.00,$117216.50,182,$1197.00
2024-09-12,20:26:00,19429.0,SELL,3,0.02h,Break Even,$-1.50,$1195.50,$117215.00,182,$1195.50
2024-09-12,20:32:00,19663.5,BUY,3,0.02h,Stop Loss,$15.00,$1210.50,$117230.00,182,$1210.50
2024-09-12,20:37:00,19423.0,SELL,3,0.02h,Stop Loss,$-9.00,$1201.50,$117221.00,182,$1201.50
2024-09-12,20:38:00,19660.5,BUY,3,0.02h,Stop Loss,$-9.00,$1192.50,$117212.00,182,$1192.50
2024-09-12,20:39:00,19422.25,SELL,3,0.02h,Stop Loss,$-9.00,$1183.50,$117203.00,182,$1183.50
2024-09-12,20:41:00,19659.0,BUY,3,0.02h,Stop Loss,$-9.00,$1174.50,$117194.00,182,$1174.50
2024-09-12,20:42:00,19428.0,SELL,3,0.02h,Break Even,$-1.50,$1173.00,$117192.50,182,$1173.00
2024-09-12,20:53:00,19652.5,BUY,3,0.02h,Stop Loss,$-9.00,$1164.00,$117183.50,182,$1164.00
2024-09-12,20:54:00,19417.5,SELL,3,0.02h,Stop Loss,$-9.00,$1155.00,$117174.50,182,$1155.00
2024-09-12,20:55:00,19651.0,BUY,3,0.02h,Stop Loss,$-9.00,$1146.00,$117165.50,182,$1146.00
2024-09-12,20:56:00,19417.75,SELL,3,0.02h,Stop Loss,$-9.00,$1137.00,$117156.50,182,$1137.00
2024-09-12,20:58:00,19653.5,BUY,3,0.02h,Stop Loss,$-9.00,$1128.00,$117147.50,182,$1128.00
2024-09-12,20:59:00,19412.5,SELL,3,0.02h,Stop Loss,$-9.00,$1119.00,$117138.50,182,$1119.00
2024-09-12,21:00:00,19647.25,BUY,3,1.02h,Stop Loss,$25.50,$1144.50,$117164.00,182,$1144.50
2024-09-12,22:07:00,19423.0,SELL,3,0.02h,Break Even,$-1.50,$1143.00,$117162.50,182,$1143.00
2024-09-12,22:11:00,19660.0,BUY,3,0.03h,Stop Loss,$21.00,$1164.00,$117183.50,182,$1164.00
2024-09-12,22:22:00,19431.75,SELL,3,0.02h,Stop Loss,$-9.00,$1155.00,$117174.50,182,$1155.00
2024-09-12,22:25:00,19665.0,BUY,3,0.02h,Break Even,$-1.50,$1153.50,$117173.00,182,$1153.50
2024-09-12,22:29:00,19437.5,SELL,3,0.02h,Break Even,$-1.50,$1152.00,$117171.50,182,$1152.00
2024-09-12,22:40:00,19671.5,BUY,3,0.02h,Stop Loss,$-9.00,$1143.00,$117162.50,182,$1143.00
2024-09-12,22:41:00,19437.75,SELL,3,0.02h,Stop Loss,$-9.00,$1134.00,$117153.50,182,$1134.00
2024-09-12,22:42:00,19673.25,BUY,3,0.02h,Stop Loss,$-9.00,$1125.00,$117144.50,182,$1125.00
2024-09-12,22:43:00,19437.0,SELL,3,0.02h,Stop Loss,$-9.00,$1116.00,$117135.50,182,$1116.00
2024-09-12,22:44:00,19673.0,BUY,3,0.02h,Break Even,$-1.50,$1114.50,$117134.00,182,$1114.50
2024-09-12,22:47:00,19444.5,SELL,3,0.02h,Break Even,$-1.50,$1113.00,$117132.50,182,$1113.00
2024-09-12,23:00:00,19677.0,BUY,3,13.00h,Stop Loss,$-9.00,$1104.00,$117123.50,182,$1104.00
,,,,,,,,,,,
2024-09-13,12:00:00,19453.75,SELL,3,0.02h,Stop Loss,$3.00,$3.00,$117126.50,183,$3.00
2024-09-13,12:02:00,19696.0,BUY,3,0.02h,Stop Loss,$-9.00,$-6.00,$117117.50,183,$-6.00
2024-09-13,12:04:00,19462.0,SELL,3,0.02h,Stop Loss,$-9.00,$-15.00,$117108.50,183,$-15.00
2024-09-13,12:05:00,19701.0,BUY,3,0.02h,Stop Loss,$-9.00,$-24.00,$117099.50,183,$-24.00
2024-09-13,12:22:00,19462.75,SELL,3,0.02h,Stop Loss,$-9.00,$-33.00,$117090.50,183,$-33.00
2024-09-13,12:23:00,19696.25,BUY,3,0.02h,Stop Loss,$-9.00,$-42.00,$117081.50,183,$-42.00
2024-09-13,12:24:00,19458.25,SELL,3,0.02h,Stop Loss,$-9.00,$-51.00,$117072.50,183,$-51.00
2024-09-13,12:30:00,19688.75,BUY,3,0.02h,Stop Loss,$-9.00,$-60.00,$117063.50,183,$-60.00
2024-09-13,12:31:00,19448.25,SELL,3,0.02h,Break Even,$-1.50,$-61.50,$117062.00,183,$-61.50
2024-09-13,12:33:00,19688.0,BUY,3,0.02h,Stop Loss,$12.00,$-49.50,$117074.00,183,$-49.50
2024-09-13,12:35:00,19448.75,SELL,3,0.02h,Stop Loss,$-9.00,$-58.50,$117065.00,183,$-58.50
2024-09-13,12:36:00,19686.0,BUY,3,0.02h,Break Even,$-1.50,$-60.00,$117063.50,183,$-60.00
2024-09-13,12:42:00,19421.5,SELL,3,0.02h,Stop Loss,$33.00,$-27.00,$117096.50,183,$-27.00
2024-09-13,12:45:00,19669.0,BUY,3,0.02h,Stop Loss,$19.50,$-7.50,$117116.00,183,$-7.50
2024-09-13,12:50:00,19442.75,SELL,3,0.02h,Stop Loss,$-9.00,$-16.50,$117107.00,183,$-16.50
2024-09-13,13:01:00,19685.75,BUY,3,0.02h,Stop Loss,$-9.00,$-25.50,$117098.00,183,$-25.50
2024-09-13,13:02:00,19446.75,SELL,3,0.02h,Stop Loss,$-9.00,$-34.50,$117089.00,183,$-34.50
2024-09-13,13:03:00,19680.5,BUY,3,0.02h,Break Even,$-1.50,$-36.00,$117087.50,183,$-36.00
2024-09-13,13:17:00,19430.0,SELL,3,0.02h,Stop Loss,$-9.00,$-45.00,$117078.50,183,$-45.00
2024-09-13,13:28:00,19671.5,BUY,3,0.02h,Stop Loss,$-9.00,$-54.00,$117069.50,183,$-54.00
2024-09-13,13:33:00,19420.75,SELL,3,0.02h,Stop Loss,$-9.00,$-63.00,$117060.50,183,$-63.00
2024-09-13,13:34:00,19673.25,BUY,3,0.02h,Stop Loss,$-9.00,$-72.00,$117051.50,183,$-72.00
2024-09-13,13:35:00,19446.5,SELL,3,0.02h,Stop Loss,$-9.00,$-81.00,$117042.50,183,$-81.00
2024-09-13,13:36:00,19683.5,BUY,3,0.02h,Stop Loss,$82.50,$1.50,$117125.00,183,$1.50
2024-09-13,13:40:00,19470.75,SELL,3,0.02h,Stop Loss,$12.00,$13.50,$117137.00,183,$13.50
2024-09-13,13:42:00,19711.75,BUY,3,0.02h,Stop Loss,$49.50,$63.00,$117186.50,183,$63.00
2024-09-13,13:46:00,19477.5,SELL,3,0.02h,Stop Loss,$84.00,$147.00,$117270.50,183,$147.00
2024-09-13,13:49:00,19725.0,BUY,3,0.02h,Stop Loss,$-9.00,$138.00,$117261.50,183,$138.00
2024-09-13,13:50:00,19474.5,SELL,3,0.02h,Stop Loss,$40.50,$178.50,$117302.00,183,$178.50
2024-09-13,13:52:00,19720.75,BUY,3,0.02h,Stop Loss,$12.00,$190.50,$117314.00,183,$190.50
2024-09-13,13:55:00,19479.0,SELL,3,0.02h,Stop Loss,$-9.00,$181.50,$117305.00,183,$181.50
2024-09-13,13:56:00,19708.5,BUY,3,0.02h,Stop Loss,$-9.00,$172.50,$117296.00,183,$172.50
2024-09-13,13:57:00,19477.25,SELL,3,0.02h,Stop Loss,$-9.00,$163.50,$117287.00,183,$163.50
2024-09-13,13:58:00,19704.75,BUY,3,0.02h,Stop Loss,$31.50,$195.00,$117318.50,183,$195.00
2024-09-13,14:01:00,19459.5,SELL,3,0.02h,Stop Loss,$12.00,$207.00,$117330.50,183,$207.00
2024-09-13,14:04:00,19703.0,BUY,3,0.02h,Stop Loss,$-9.00,$198.00,$117321.50,183,$198.00
2024-09-13,14:05:00,19482.25,SELL,3,0.02h,Stop Loss,$-9.00,$189.00,$117312.50,183,$189.00
2024-09-13,14:06:00,19711.0,BUY,3,0.02h,Stop Loss,$138.00,$327.00,$117450.50,183,$327.00
2024-09-13,14:09:00,19502.5,SELL,3,0.02h,Break Even,$-1.50,$325.50,$117449.00,183,$325.50
2024-09-13,14:13:00,19742.5,BUY,3,0.02h,Stop Loss,$-9.00,$316.50,$117440.00,183,$316.50
2024-09-13,14:14:00,19484.75,SELL,3,0.02h,Stop Loss,$40.50,$357.00,$117480.50,183,$357.00
2024-09-13,14:16:00,19738.0,BUY,3,0.02h,Stop Loss,$-9.00,$348.00,$117471.50,183,$348.00
2024-09-13,14:17:00,19506.0,SELL,3,0.02h,Break Even,$-1.50,$346.50,$117470.00,183,$346.50
2024-09-13,14:21:00,19740.25,BUY,3,0.02h,Break Even,$-1.50,$345.00,$117468.50,183,$345.00
2024-09-13,14:27:00,19494.25,SELL,3,0.02h,Stop Loss,$97.50,$442.50,$117566.00,183,$442.50
2024-09-13,14:38:00,19698.25,BUY,3,0.02h,Stop Loss,$21.00,$463.50,$117587.00,183,$463.50
2024-09-13,14:52:00,19502.25,SELL,3,0.02h,Stop Loss,$73.50,$537.00,$117660.50,183,$537.00
2024-09-13,14:55:00,19744.75,BUY,3,0.02h,Stop Loss,$-9.00,$528.00,$117651.50,183,$528.00
2024-09-13,14:56:00,19514.75,SELL,3,0.02h,Stop Loss,$-9.00,$519.00,$117642.50,183,$519.00
2024-09-13,15:00:00,19749.25,BUY,3,0.02h,Stop Loss,$10.50,$529.50,$117653.00,183,$529.50
2024-09-13,15:11:00,19518.25,SELL,3,0.02h,Stop Loss,$7.50,$537.00,$117660.50,183,$537.00
2024-09-13,15:13:00,19764.75,BUY,3,0.02h,Stop Loss,$24.00,$561.00,$117684.50,183,$561.00
2024-09-13,15:23:00,19536.25,SELL,3,0.02h,Stop Loss,$-9.00,$552.00,$117675.50,183,$552.00
2024-09-13,15:33:00,19761.5,BUY,3,0.02h,Stop Loss,$-9.00,$543.00,$117666.50,183,$543.00
2024-09-13,15:34:00,19522.0,SELL,3,0.02h,Stop Loss,$12.00,$555.00,$117678.50,183,$555.00
2024-09-13,15:40:00,19745.5,BUY,3,0.02h,Stop Loss,$-9.00,$546.00,$117669.50,183,$546.00
2024-09-13,15:41:00,19526.0,SELL,3,0.02h,Stop Loss,$25.50,$571.50,$117695.00,183,$571.50
2024-09-13,15:43:00,19762.25,BUY,3,0.02h,Break Even,$-1.50,$570.00,$117693.50,183,$570.00
2024-09-13,15:50:00,19531.25,SELL,3,0.02h,Stop Loss,$31.50,$601.50,$117725.00,183,$601.50
2024-09-13,15:52:00,19765.5,BUY,3,0.02h,Stop Loss,$12.00,$613.50,$117737.00,183,$613.50
2024-09-13,15:58:00,19538.5,SELL,3,0.02h,Stop Loss,$25.50,$639.00,$117762.50,183,$639.00
2024-09-13,16:04:00,19782.75,BUY,3,0.02h,Stop Loss,$-9.00,$630.00,$117753.50,183,$630.00
2024-09-13,16:05:00,19547.25,SELL,3,0.02h,Stop Loss,$49.50,$679.50,$117803.00,183,$679.50
2024-09-13,16:12:00,19757.0,BUY,3,0.02h,Stop Loss,$-9.00,$670.50,$117794.00,183,$670.50
2024-09-13,16:13:00,19527.25,SELL,3,0.02h,Stop Loss,$135.00,$805.50,$117929.00,183,$805.50
2024-09-13,16:15:00,19741.25,BUY,3,0.02h,Stop Loss,$-9.00,$796.50,$117920.00,183,$796.50
2024-09-13,16:16:00,19492.75,SELL,3,0.02h,Stop Loss,$21.00,$817.50,$117941.00,183,$817.50
2024-09-13,16:19:00,19731.25,BUY,3,0.02h,Stop Loss,$16.50,$834.00,$117957.50,183,$834.00
2024-09-13,16:42:00,19494.25,SELL,3,0.02h,Stop Loss,$-9.00,$825.00,$117948.50,183,$825.00
2024-09-13,16:46:00,19724.5,BUY,3,0.02h,Stop Loss,$4.50,$829.50,$117953.00,183,$829.50
2024-09-13,16:50:00,19489.75,SELL,3,0.02h,Stop Loss,$-9.00,$820.50,$117944.00,183,$820.50
2024-09-13,17:01:00,19778.25,BUY,3,0.02h,Stop Loss,$-9.00,$811.50,$117935.00,183,$811.50
2024-09-13,17:02:00,19544.75,SELL,3,0.02h,Stop Loss,$28.50,$840.00,$117963.50,183,$840.00
2024-09-13,17:06:00,19787.25,BUY,3,0.02h,Stop Loss,$10.50,$850.50,$117974.00,183,$850.50
2024-09-13,17:11:00,19551.5,SELL,3,0.02h,Stop Loss,$12.00,$862.50,$117986.00,183,$862.50
2024-09-13,17:17:00,19792.5,BUY,3,0.02h,Stop Loss,$-9.00,$853.50,$117977.00,183,$853.50
2024-09-13,17:18:00,19559.75,SELL,3,0.02h,Stop Loss,$-9.00,$844.50,$117968.00,183,$844.50
2024-09-13,17:19:00,19798.5,BUY,3,0.02h,Stop Loss,$-9.00,$835.50,$117959.00,183,$835.50
2024-09-13,17:28:00,19549.75,SELL,3,0.02h,Break Even,$-1.50,$834.00,$117957.50,183,$834.00
2024-09-13,17:33:00,19803.0,BUY,3,0.02h,Break Even,$-1.50,$832.50,$117956.00,183,$832.50
2024-09-13,17:42:00,19556.5,SELL,3,0.02h,Stop Loss,$10.50,$843.00,$117966.50,183,$843.00
2024-09-13,17:45:00,19800.75,BUY,3,0.02h,Stop Loss,$-9.00,$834.00,$117957.50,183,$834.00
2024-09-13,17:46:00,19563.25,SELL,3,0.02h,Stop Loss,$-9.00,$825.00,$117948.50,183,$825.00
2024-09-13,17:47:00,19802.0,BUY,3,0.02h,Break Even,$-1.50,$823.50,$117947.00,183,$823.50
2024-09-13,17:54:00,19571.75,SELL,3,0.02h,Stop Loss,$-9.00,$814.50,$117938.00,183,$814.50
2024-09-13,17:55:00,19804.5,BUY,3,0.02h,Stop Loss,$-9.00,$805.50,$117929.00,183,$805.50
2024-09-13,17:56:00,19569.0,SELL,3,0.02h,Stop Loss,$-9.00,$796.50,$117920.00,183,$796.50
2024-09-13,17:57:00,19806.5,BUY,3,0.02h,Stop Loss,$-9.00,$787.50,$117911.00,183,$787.50
2024-09-13,17:58:00,19568.25,SELL,3,0.02h,Stop Loss,$-9.00,$778.50,$117902.00,183,$778.50
2024-09-13,18:02:00,19780.5,BUY,3,0.02h,Stop Loss,$-9.00,$769.50,$117893.00,183,$769.50
2024-09-13,18:03:00,19545.0,SELL,3,0.02h,Stop Loss,$-9.00,$760.50,$117884.00,183,$760.50
2024-09-13,18:05:00,19782.5,BUY,3,0.02h,Stop Loss,$39.00,$799.50,$117923.00,183,$799.50
2024-09-13,18:08:00,19566.25,SELL,3,0.02h,Break Even,$-1.50,$798.00,$117921.50,183,$798.00
2024-09-13,18:17:00,19776.75,BUY,3,0.02h,Stop Loss,$-9.00,$789.00,$117912.50,183,$789.00
2024-09-13,18:18:00,19537.0,SELL,3,0.02h,Stop Loss,$16.50,$805.50,$117929.00,183,$805.50
2024-09-13,18:24:00,19764.25,BUY,3,0.02h,Stop Loss,$-9.00,$796.50,$117920.00,183,$796.50
2024-09-13,18:25:00,19512.5,SELL,3,0.02h,Stop Loss,$-9.00,$787.50,$117911.00,183,$787.50
2024-09-13,18:27:00,19751.25,BUY,3,0.02h,Stop Loss,$-9.00,$778.50,$117902.00,183,$778.50
2024-09-13,18:28:00,19510.0,SELL,3,0.02h,Stop Loss,$-9.00,$769.50,$117893.00,183,$769.50
2024-09-13,18:36:00,19738.75,BUY,3,0.02h,Stop Loss,$22.50,$792.00,$117915.50,183,$792.00
2024-09-13,18:38:00,19503.0,SELL,3,0.02h,Stop Loss,$-9.00,$783.00,$117906.50,183,$783.00
2024-09-13,18:46:00,19761.75,BUY,3,0.02h,Stop Loss,$-9.00,$774.00,$117897.50,183,$774.00
2024-09-13,18:47:00,19523.0,SELL,3,0.02h,Stop Loss,$24.00,$798.00,$117921.50,183,$798.00
2024-09-13,18:49:00,19749.0,BUY,3,0.02h,Stop Loss,$-9.00,$789.00,$117912.50,183,$789.00
2024-09-13,18:50:00,19510.5,SELL,3,0.02h,Stop Loss,$-9.00,$780.00,$117903.50,183,$780.00
2024-09-13,18:51:00,19736.75,BUY,3,0.02h,Stop Loss,$-9.00,$771.00,$117894.50,183,$771.00
2024-09-13,18:52:00,19506.25,SELL,3,0.02h,Stop Loss,$24.00,$795.00,$117918.50,183,$795.00
2024-09-13,18:57:00,19746.0,BUY,3,0.02h,Stop Loss,$-9.00,$786.00,$117909.50,183,$786.00
2024-09-13,18:58:00,19509.5,SELL,3,0.02h,Stop Loss,$4.50,$790.50,$117914.00,183,$790.50
2024-09-13,19:09:00,19740.5,BUY,3,0.02h,Stop Loss,$-9.00,$781.50,$117905.00,183,$781.50
2024-09-13,19:10:00,19504.75,SELL,3,0.02h,Stop Loss,$-9.00,$772.50,$117896.00,183,$772.50
2024-09-13,19:11:00,19738.75,BUY,3,0.02h,Break Even,$-1.50,$771.00,$117894.50,183,$771.00
2024-09-13,19:15:00,19511.75,SELL,3,0.02h,Stop Loss,$-9.00,$762.00,$117885.50,183,$762.00
2024-09-13,19:16:00,19750.25,BUY,3,0.02h,Stop Loss,$25.50,$787.50,$117911.00,183,$787.50
2024-09-13,19:24:00,19525.0,SELL,3,0.02h,Stop Loss,$-9.00,$778.50,$117902.00,183,$778.50
2024-09-13,19:25:00,19765.0,BUY,3,0.02h,Stop Loss,$-9.00,$769.50,$117893.00,183,$769.50
2024-09-13,19:42:00,19528.5,SELL,3,0.02h,Break Even,$-1.50,$768.00,$117891.50,183,$768.00
2024-09-13,19:45:00,19771.0,BUY,3,0.02h,Stop Loss,$-9.00,$759.00,$117882.50,183,$759.00
2024-09-13,19:46:00,19536.75,SELL,3,0.02h,Break Even,$-1.50,$757.50,$117881.00,183,$757.50
2024-09-13,19:53:00,19780.5,BUY,3,0.02h,Break Even,$-1.50,$756.00,$117879.50,183,$756.00
2024-09-13,19:58:00,19537.25,SELL,3,0.02h,Break Even,$-1.50,$754.50,$117878.00,183,$754.50
2024-09-13,20:02:00,19752.5,BUY,3,0.02h,Stop Loss,$-9.00,$745.50,$117869.00,183,$745.50
2024-09-13,20:03:00,19507.0,SELL,3,0.02h,Stop Loss,$-9.00,$736.50,$117860.00,183,$736.50
2024-09-13,20:14:00,19743.0,BUY,3,0.02h,Stop Loss,$19.50,$756.00,$117879.50,183,$756.00
2024-09-13,20:18:00,19517.5,SELL,3,0.02h,Stop Loss,$-9.00,$747.00,$117870.50,183,$747.00
2024-09-13,20:19:00,19755.5,BUY,3,0.02h,Stop Loss,$-9.00,$738.00,$117861.50,183,$738.00
2024-09-13,20:20:00,19519.5,SELL,3,0.02h,Break Even,$-1.50,$736.50,$117860.00,183,$736.50
2024-09-13,20:29:00,19758.75,BUY,3,0.02h,Break Even,$-1.50,$735.00,$117858.50,183,$735.00
2024-09-13,20:32:00,19518.5,SELL,3,0.02h,Stop Loss,$-9.00,$726.00,$117849.50,183,$726.00
2024-09-13,20:41:00,19756.5,BUY,3,0.02h,Stop Loss,$-9.00,$717.00,$117840.50,183,$717.00
2024-09-13,20:42:00,19520.75,SELL,3,0.02h,Stop Loss,$-9.00,$708.00,$117831.50,183,$708.00
2024-09-13,20:43:00,19757.75,BUY,3,0.03h,Stop Loss,$-9.00,$699.00,$117822.50,183,$699.00
2024-09-13,20:54:00,19506.0,SELL,3,0.02h,Stop Loss,$-9.00,$690.00,$117813.50,183,$690.00
2024-09-13,20:55:00,19742.75,BUY,3,0.02h,Stop Loss,$-9.00,$681.00,$117804.50,183,$681.00
2024-09-13,20:56:00,19503.5,SELL,3,0.02h,Stop Loss,$-9.00,$672.00,$117795.50,183,$672.00
2024-09-13,20:57:00,19741.0,BUY,3,0.05h,Break Even,$-1.50,$670.50,$117794.00,183,$670.50
,,,,,,,,,,,
2024-09-16,12:21:00,19676.75,SELL,3,0.02h,Break Even,$-1.50,$-1.50,$117792.50,184,$-1.50
2024-09-16,12:41:00,19678.25,BUY,3,0.02h,Stop Loss,$-9.00,$-10.50,$117783.50,184,$-10.50
2024-09-16,12:42:00,19669.25,SELL,3,0.02h,Stop Loss,$-9.00,$-19.50,$117774.50,184,$-19.50
2024-09-16,13:01:00,19673.5,BUY,3,0.02h,Stop Loss,$10.50,$-9.00,$117785.00,184,$-9.00
2024-09-16,13:08:00,19667.0,SELL,3,0.02h,Stop Loss,$-9.00,$-18.00,$117776.00,184,$-18.00
2024-09-16,13:50:00,19641.75,BUY,3,0.02h,Stop Loss,$54.00,$36.00,$117830.00,184,$36.00
2024-09-16,14:21:00,19640.75,SELL,3,0.02h,Stop Loss,$-9.00,$27.00,$117821.00,184,$27.00
2024-09-16,15:12:00,19597.75,BUY,3,0.02h,Stop Loss,$43.50,$70.50,$117864.50,184,$70.50
2024-09-16,15:39:00,19595.0,SELL,3,0.02h,Stop Loss,$-9.00,$61.50,$117855.50,184,$61.50
2024-09-16,15:59:00,19597.5,BUY,3,0.02h,Break Even,$-1.50,$60.00,$117854.00,184,$60.00
2024-09-16,16:14:00,19583.5,SELL,3,0.02h,Break Even,$-1.50,$58.50,$117852.50,184,$58.50
2024-09-16,16:29:00,19598.25,BUY,3,0.02h,Break Even,$-1.50,$57.00,$117851.00,184,$57.00
2024-09-16,16:45:00,19577.75,SELL,3,0.02h,Stop Loss,$3.00,$60.00,$117854.00,184,$60.00
2024-09-16,16:51:00,19599.5,BUY,3,0.02h,Stop Loss,$25.50,$85.50,$117879.50,184,$85.50
2024-09-16,17:20:00,19606.75,SELL,3,0.02h,Stop Loss,$16.50,$102.00,$117896.00,184,$102.00
2024-09-16,17:26:00,19623.0,BUY,3,0.02h,Stop Loss,$28.50,$130.50,$117924.50,184,$130.50
2024-09-16,18:08:00,19641.25,SELL,3,0.02h,Break Even,$-1.50,$129.00,$117923.00,184,$129.00
2024-09-16,18:12:00,19665.75,BUY,3,0.02h,Stop Loss,$4.50,$133.50,$117927.50,184,$133.50
2024-09-16,18:41:00,19645.25,SELL,3,0.02h,Stop Loss,$-9.00,$124.50,$117918.50,184,$124.50
2024-09-16,19:00:00,19665.5,BUY,3,0.02h,Break Even,$-1.50,$123.00,$117917.00,184,$123.00
2024-09-16,19:15:00,19648.0,SELL,3,0.02h,Stop Loss,$22.50,$145.50,$117939.50,184,$145.50
2024-09-16,19:32:00,19654.0,BUY,3,0.02h,Stop Loss,$7.50,$153.00,$117947.00,184,$153.00
2024-09-16,20:03:00,19664.25,SELL,3,0.02h,Stop Loss,$9.00,$162.00,$117956.00,184,$162.00
2024-09-16,20:23:00,19667.5,BUY,3,0.02h,Break Even,$-1.50,$160.50,$117954.50,184,$160.50
2024-09-16,20:34:00,19662.0,SELL,3,0.02h,Break Even,$-1.50,$159.00,$117953.00,184,$159.00
2024-09-16,22:04:00,19661.75,BUY,3,0.02h,Stop Loss,$28.50,$187.50,$117981.50,184,$187.50
2024-09-16,22:51:00,19686.0,SELL,3,0.02h,Stop Loss,$-9.00,$178.50,$117972.50,184,$178.50
2024-09-16,22:53:00,19690.75,BUY,3,0.02h,Stop Loss,$6.00,$184.50,$117978.50,184,$184.50
2024-09-16,22:57:00,19683.0,SELL,3,0.02h,Break Even,$-1.50,$183.00,$117977.00,184,$183.00
,,,,,,,,,,,
2024-09-17,12:01:00,19793.25,BUY,3,0.02h,Stop Loss,$-9.00,$-9.00,$117968.00,185,$-9.00
2024-09-17,12:03:00,19557.5,SELL,3,0.02h,Break Even,$-1.50,$-10.50,$117966.50,185,$-10.50
2024-09-17,12:12:00,19782.75,BUY,3,0.02h,Stop Loss,$-9.00,$-19.50,$117957.50,185,$-19.50
2024-09-17,12:18:00,19534.0,SELL,3,0.02h,Break Even,$-1.50,$-21.00,$117956.00,185,$-21.00
2024-09-17,12:25:00,19773.5,BUY,3,0.02h,Stop Loss,$10.50,$-10.50,$117966.50,185,$-10.50
2024-09-17,12:27:00,19542.5,SELL,3,0.02h,Stop Loss,$-9.00,$-19.50,$117957.50,185,$-19.50
2024-09-17,12:28:00,19780.5,BUY,3,0.02h,Stop Loss,$-9.00,$-28.50,$117948.50,185,$-28.50
2024-09-17,12:29:00,19548.5,SELL,3,0.02h,Stop Loss,$37.50,$9.00,$117986.00,185,$9.00
2024-09-17,12:31:00,19788.0,BUY,3,0.02h,Break Even,$-1.50,$7.50,$117984.50,185,$7.50
2024-09-17,12:40:00,19550.75,SELL,3,0.02h,Break Even,$-1.50,$6.00,$117983.00,185,$6.00
2024-09-17,12:48:00,19782.0,BUY,3,0.02h,Stop Loss,$4.50,$10.50,$117987.50,185,$10.50
2024-09-17,13:01:00,19567.75,SELL,3,0.02h,Stop Loss,$-9.00,$1.50,$117978.50,185,$1.50
2024-09-17,13:02:00,19801.75,BUY,3,0.02h,Break Even,$-1.50,$0.00,$117977.00,185,$0.00
2024-09-17,13:08:00,19573.0,SELL,3,0.02h,Stop Loss,$-9.00,$-9.00,$117968.00,185,$-9.00
2024-09-17,13:10:00,19810.0,BUY,3,0.02h,Break Even,$-1.50,$-10.50,$117966.50,185,$-10.50
2024-09-17,13:15:00,19568.5,SELL,3,0.02h,Break Even,$-1.50,$-12.00,$117965.00,185,$-12.00
2024-09-17,13:20:00,19797.5,BUY,3,0.02h,Stop Loss,$-9.00,$-21.00,$117956.00,185,$-21.00
2024-09-17,13:24:00,19558.0,SELL,3,0.02h,Break Even,$-1.50,$-22.50,$117954.50,185,$-22.50
2024-09-17,13:36:00,19768.25,BUY,3,0.02h,Stop Loss,$132.00,$109.50,$118086.50,185,$109.50
2024-09-17,13:38:00,19539.75,SELL,3,0.02h,Stop Loss,$85.50,$195.00,$118172.00,185,$195.00
2024-09-17,13:48:00,19797.0,BUY,3,0.02h,Stop Loss,$51.00,$246.00,$118223.00,185,$246.00
2024-09-17,14:01:00,19514.5,SELL,3,0.02h,Stop Loss,$30.00,$276.00,$118253.00,185,$276.00
2024-09-17,14:04:00,19778.0,BUY,3,0.02h,Stop Loss,$81.00,$357.00,$118334.00,185,$357.00
2024-09-17,14:25:00,19559.75,SELL,3,0.02h,Stop Loss,$-9.00,$348.00,$118325.00,185,$348.00
2024-09-17,14:27:00,19802.5,BUY,3,0.02h,Stop Loss,$24.00,$372.00,$118349.00,185,$372.00
2024-09-17,14:33:00,19557.0,SELL,3,0.02h,Stop Loss,$103.50,$475.50,$118452.50,185,$475.50
2024-09-17,14:45:00,19817.75,BUY,3,0.02h,Stop Loss,$141.00,$616.50,$118593.50,185,$616.50
2024-09-17,14:55:00,19581.75,SELL,3,0.02h,Stop Loss,$-9.00,$607.50,$118584.50,185,$607.50
2024-09-17,14:56:00,19816.25,BUY,3,0.02h,Break Even,$-1.50,$606.00,$118583.00,185,$606.00
2024-09-17,14:59:00,19546.25,SELL,3,0.02h,Stop Loss,$189.00,$795.00,$118772.00,185,$795.00
2024-09-17,15:06:00,19773.0,BUY,3,0.02h,Stop Loss,$34.50,$829.50,$118806.50,185,$829.50
2024-09-17,15:14:00,19561.0,SELL,3,0.02h,Stop Loss,$-9.00,$820.50,$118797.50,185,$820.50
2024-09-17,15:15:00,19800.25,BUY,3,0.02h,Stop Loss,$24.00,$844.50,$118821.50,185,$844.50
2024-09-17,15:17:00,19576.0,SELL,3,0.02h,Stop Loss,$57.00,$901.50,$118878.50,185,$901.50
2024-09-17,15:23:00,19771.75,BUY,3,0.02h,Stop Loss,$51.00,$952.50,$118929.50,185,$952.50
2024-09-17,15:25:00,19553.25,SELL,3,0.02h,Break Even,$-1.50,$951.00,$118928.00,185,$951.00
2024-09-17,15:44:00,19759.75,BUY,3,0.02h,Stop Loss,$-9.00,$942.00,$118919.00,185,$942.00
2024-09-17,15:45:00,19524.25,SELL,3,0.02h,Break Even,$-1.50,$940.50,$118917.50,185,$940.50
2024-09-17,15:47:00,19776.25,BUY,3,0.02h,Stop Loss,$-9.00,$931.50,$118908.50,185,$931.50
2024-09-17,15:56:00,19521.5,SELL,3,0.02h,Stop Loss,$-9.00,$922.50,$118899.50,185,$922.50
2024-09-17,15:57:00,19767.5,BUY,3,0.02h,Stop Loss,$-9.00,$913.50,$118890.50,185,$913.50
2024-09-17,15:58:00,19531.5,SELL,3,0.02h,Stop Loss,$-9.00,$904.50,$118881.50,185,$904.50
2024-09-17,15:59:00,19772.5,BUY,3,0.02h,Stop Loss,$7.50,$912.00,$118889.00,185,$912.00
2024-09-17,16:02:00,19542.5,SELL,3,0.02h,Stop Loss,$-9.00,$903.00,$118880.00,185,$903.00
2024-09-17,16:03:00,19780.5,BUY,3,0.02h,Stop Loss,$7.50,$910.50,$118887.50,185,$910.50
2024-09-17,16:05:00,19530.0,SELL,3,0.02h,Stop Loss,$-9.00,$901.50,$118878.50,185,$901.50
2024-09-17,16:07:00,19767.0,BUY,3,0.02h,Stop Loss,$15.00,$916.50,$118893.50,185,$916.50
2024-09-17,16:09:00,19526.25,SELL,3,0.02h,Stop Loss,$24.00,$940.50,$118917.50,185,$940.50
2024-09-17,16:12:00,19754.25,BUY,3,0.02h,Break Even,$-1.50,$939.00,$118916.00,185,$939.00
2024-09-17,16:15:00,19514.0,SELL,3,0.02h,Stop Loss,$-9.00,$930.00,$118907.00,185,$930.00
2024-09-17,16:16:00,19738.25,BUY,3,0.02h,Stop Loss,$-9.00,$921.00,$118898.00,185,$921.00
2024-09-17,16:18:00,19496.75,SELL,3,0.02h,Stop Loss,$136.50,$1057.50,$119034.50,185,$1057.50
2024-09-17,16:33:00,19689.5,BUY,3,0.02h,Stop Loss,$6.00,$1063.50,$119040.50,185,$1063.50
2024-09-17,16:39:00,19448.75,SELL,3,0.02h,Stop Loss,$-9.00,$1054.50,$119031.50,185,$1054.50
2024-09-17,16:55:00,19641.75,BUY,3,0.02h,Stop Loss,$70.50,$1125.00,$119102.00,185,$1125.00
2024-09-17,16:57:00,19424.25,SELL,3,0.02h,Stop Loss,$-9.00,$1116.00,$119093.00,185,$1116.00
2024-09-17,16:58:00,19658.5,BUY,3,0.02h,Break Even,$-1.50,$1114.50,$119091.50,185,$1114.50
2024-09-17,17:03:00,19407.75,SELL,3,0.02h,Stop Loss,$24.00,$1138.50,$119115.50,185,$1138.50
2024-09-17,17:08:00,19635.75,BUY,3,0.02h,Stop Loss,$31.50,$1170.00,$119147.00,185,$1170.00
2024-09-17,17:10:00,19408.25,SELL,3,0.02h,Stop Loss,$37.50,$1207.50,$119184.50,185,$1207.50
2024-09-17,17:13:00,19634.75,BUY,3,0.02h,Stop Loss,$61.50,$1269.00,$119246.00,185,$1269.00
2024-09-17,17:15:00,19412.75,SELL,3,0.02h,Stop Loss,$28.50,$1297.50,$119274.50,185,$1297.50
2024-09-17,17:20:00,19654.0,BUY,3,0.02h,Stop Loss,$40.50,$1338.00,$119315.00,185,$1338.00
2024-09-17,17:31:00,19458.25,SELL,3,0.02h,Stop Loss,$24.00,$1362.00,$119339.00,185,$1362.00
2024-09-17,17:38:00,19667.5,BUY,3,0.02h,Stop Loss,$-9.00,$1353.00,$119330.00,185,$1353.00
2024-09-17,17:43:00,19389.75,SELL,3,0.02h,Stop Loss,$93.00,$1446.00,$119423.00,185,$1446.00
2024-09-17,17:53:00,19654.0,BUY,3,0.02h,Stop Loss,$84.00,$1530.00,$119507.00,185,$1530.00
2024-09-17,17:59:00,19426.25,SELL,3,0.02h,Break Even,$-1.50,$1528.50,$119505.50,185,$1528.50
2024-09-17,18:03:00,19666.25,BUY,3,0.02h,Stop Loss,$25.50,$1554.00,$119531.00,185,$1554.00
2024-09-17,18:05:00,19435.75,SELL,3,0.02h,Stop Loss,$-9.00,$1545.00,$119522.00,185,$1545.00
2024-09-17,18:06:00,19671.0,BUY,3,0.02h,Break Even,$-1.50,$1543.50,$119520.50,185,$1543.50
2024-09-17,18:09:00,19433.0,SELL,3,0.02h,Stop Loss,$-9.00,$1534.50,$119511.50,185,$1534.50
2024-09-17,18:19:00,19655.75,BUY,3,0.02h,Stop Loss,$-9.00,$1525.50,$119502.50,185,$1525.50
2024-09-17,18:20:00,19417.25,SELL,3,0.02h,Stop Loss,$-9.00,$1516.50,$119493.50,185,$1516.50
2024-09-17,18:21:00,19646.25,BUY,3,0.02h,Stop Loss,$124.50,$1641.00,$119618.00,185,$1641.00
2024-09-17,18:24:00,19443.25,SELL,3,0.02h,Stop Loss,$-9.00,$1632.00,$119609.00,185,$1632.00
2024-09-17,18:25:00,19678.0,BUY,3,0.02h,Stop Loss,$-9.00,$1623.00,$119600.00,185,$1623.00
2024-09-17,18:29:00,19427.75,SELL,3,0.02h,Stop Loss,$-9.00,$1614.00,$119591.00,185,$1614.00
2024-09-17,18:30:00,19662.0,BUY,3,0.02h,Stop Loss,$-9.00,$1605.00,$119582.00,185,$1605.00
2024-09-17,18:31:00,19417.5,SELL,3,0.02h,Stop Loss,$48.00,$1653.00,$119630.00,185,$1653.00
2024-09-17,18:37:00,19662.0,BUY,3,0.02h,Stop Loss,$-9.00,$1644.00,$119621.00,185,$1644.00
2024-09-17,18:38:00,19425.0,SELL,3,0.02h,Stop Loss,$-9.00,$1635.00,$119612.00,185,$1635.00
2024-09-17,18:39:00,19661.75,BUY,3,0.02h,Stop Loss,$-9.00,$1626.00,$119603.00,185,$1626.00
2024-09-17,18:40:00,19427.25,SELL,3,0.02h,Stop Loss,$-9.00,$1617.00,$119594.00,185,$1617.00
2024-09-17,18:41:00,19664.5,BUY,3,0.02h,Stop Loss,$-9.00,$1608.00,$119585.00,185,$1608.00
2024-09-17,18:45:00,19433.5,SELL,3,0.02h,Stop Loss,$-9.00,$1599.00,$119576.00,185,$1599.00
2024-09-17,18:46:00,19662.25,BUY,3,0.02h,Stop Loss,$-9.00,$1590.00,$119567.00,185,$1590.00
2024-09-17,18:47:00,19420.75,SELL,3,0.02h,Stop Loss,$-9.00,$1581.00,$119558.00,185,$1581.00
2024-09-17,18:48:00,19657.75,BUY,3,0.02h,Stop Loss,$-9.00,$1572.00,$119549.00,185,$1572.00
2024-09-17,18:49:00,19388.25,SELL,3,0.02h,Break Even,$-1.50,$1570.50,$119547.50,185,$1570.50
2024-09-17,18:53:00,19624.0,BUY,3,0.02h,Stop Loss,$-9.00,$1561.50,$119538.50,185,$1561.50
2024-09-17,18:54:00,19378.0,SELL,3,0.02h,Stop Loss,$-9.00,$1552.50,$119529.50,185,$1552.50
2024-09-17,18:55:00,19631.25,BUY,3,0.02h,Stop Loss,$48.00,$1600.50,$119577.50,185,$1600.50
2024-09-17,18:59:00,19398.25,SELL,3,0.02h,Stop Loss,$-9.00,$1591.50,$119568.50,185,$1591.50
2024-09-17,19:00:00,19640.5,BUY,3,0.02h,Stop Loss,$-9.00,$1582.50,$119559.50,185,$1582.50
2024-09-17,19:01:00,19404.25,SELL,3,0.02h,Stop Loss,$-9.00,$1573.50,$119550.50,185,$1573.50
2024-09-17,19:02:00,19651.75,BUY,3,0.02h,Stop Loss,$-9.00,$1564.50,$119541.50,185,$1564.50
2024-09-17,19:03:00,19414.0,SELL,3,0.02h,Stop Loss,$-9.00,$1555.50,$119532.50,185,$1555.50
2024-09-17,19:04:00,19642.25,BUY,3,0.02h,Break Even,$-1.50,$1554.00,$119531.00,185,$1554.00
2024-09-17,19:09:00,19413.75,SELL,3,0.02h,Break Even,$-1.50,$1552.50,$119529.50,185,$1552.50
2024-09-17,19:13:00,19661.75,BUY,3,0.02h,Stop Loss,$-9.00,$1543.50,$119520.50,185,$1543.50
2024-09-17,19:14:00,19421.0,SELL,3,0.02h,Break Even,$-1.50,$1542.00,$119519.00,185,$1542.00
2024-09-17,19:16:00,19664.25,BUY,3,0.02h,Break Even,$-1.50,$1540.50,$119517.50,185,$1540.50
2024-09-17,19:31:00,19413.5,SELL,3,0.02h,Stop Loss,$-9.00,$1531.50,$119508.50,185,$1531.50
2024-09-17,19:43:00,19645.25,BUY,3,0.02h,Break Even,$-1.50,$1530.00,$119507.00,185,$1530.00
2024-09-17,19:45:00,19403.75,SELL,3,0.02h,Break Even,$-1.50,$1528.50,$119505.50,185,$1528.50
2024-09-17,19:49:00,19653.25,BUY,3,0.02h,Stop Loss,$24.00,$1552.50,$119529.50,185,$1552.50
2024-09-17,19:54:00,19436.5,SELL,3,0.02h,Break Even,$-1.50,$1551.00,$119528.00,185,$1551.00
2024-09-17,20:00:00,19682.0,BUY,3,0.02h,Stop Loss,$-9.00,$1542.00,$119519.00,185,$1542.00
2024-09-17,20:25:00,19455.25,SELL,3,0.02h,Stop Loss,$-9.00,$1533.00,$119510.00,185,$1533.00
2024-09-17,20:33:00,19700.75,BUY,3,0.02h,Stop Loss,$-9.00,$1524.00,$119501.00,185,$1524.00
2024-09-17,20:34:00,19459.75,SELL,3,0.03h,Stop Loss,$-9.00,$1515.00,$119492.00,185,$1515.00
2024-09-17,20:44:00,19693.0,BUY,3,0.02h,Break Even,$-1.50,$1513.50,$119490.50,185,$1513.50
2024-09-17,22:03:00,19445.75,SELL,3,0.03h,Stop Loss,$-9.00,$1504.50,$119481.50,185,$1504.50
2024-09-17,22:19:00,19691.5,BUY,3,0.02h,Stop Loss,$-9.00,$1495.50,$119472.50,185,$1495.50
2024-09-17,22:24:00,19458.5,SELL,3,0.02h,Stop Loss,$-9.00,$1486.50,$119463.50,185,$1486.50
2024-09-17,22:25:00,19693.5,BUY,3,0.02h,Stop Loss,$-9.00,$1477.50,$119454.50,185,$1477.50
2024-09-17,22:35:00,19457.25,SELL,3,0.02h,Stop Loss,$-9.00,$1468.50,$119445.50,185,$1468.50
2024-09-17,22:43:00,19689.75,BUY,3,0.02h,Stop Loss,$-9.00,$1459.50,$119436.50,185,$1459.50
2024-09-17,22:44:00,19453.5,SELL,3,0.03h,Break Even,$-1.50,$1458.00,$119435.00,185,$1458.00
2024-09-17,22:46:00,19687.0,BUY,3,0.02h,Stop Loss,$-9.00,$1449.00,$119426.00,185,$1449.00
2024-09-17,22:47:00,19453.75,SELL,3,0.02h,Stop Loss,$-9.00,$1440.00,$119417.00,185,$1440.00
2024-09-17,22:52:00,19697.25,BUY,3,0.02h,Stop Loss,$-9.00,$1431.00,$119408.00,185,$1431.00
2024-09-17,22:53:00,19458.25,SELL,3,0.02h,Stop Loss,$-9.00,$1422.00,$119399.00,185,$1422.00
2024-09-17,22:54:00,19691.25,BUY,3,0.02h,Stop Loss,$-9.00,$1413.00,$119390.00,185,$1413.00
2024-09-17,22:55:00,19455.75,SELL,3,0.02h,Break Even,$-1.50,$1411.50,$119388.50,185,$1411.50
2024-09-17,22:57:00,19684.5,BUY,3,0.02h,Stop Loss,$4.50,$1416.00,$119393.00,185,$1416.00
,,,,,,,,,,,
2024-09-18,12:00:00,19467.5,SELL,3,0.02h,Stop Loss,$15.00,$15.00,$119408.00,186,$15.00
2024-09-18,12:07:00,19685.0,BUY,3,0.02h,Stop Loss,$9.00,$24.00,$119417.00,186,$24.00
2024-09-18,12:11:00,19452.25,SELL,3,0.02h,Stop Loss,$-9.00,$15.00,$119408.00,186,$15.00
2024-09-18,12:12:00,19684.75,BUY,3,0.02h,Stop Loss,$-9.00,$6.00,$119399.00,186,$6.00
2024-09-18,12:13:00,19447.25,SELL,3,0.02h,Stop Loss,$-9.00,$-3.00,$119390.00,186,$-3.00
2024-09-18,12:14:00,19679.5,BUY,3,0.02h,Stop Loss,$-9.00,$-12.00,$119381.00,186,$-12.00
2024-09-18,12:21:00,19451.5,SELL,3,0.02h,Stop Loss,$-9.00,$-21.00,$119372.00,186,$-21.00
2024-09-18,12:24:00,19695.0,BUY,3,0.02h,Stop Loss,$-9.00,$-30.00,$119363.00,186,$-30.00
2024-09-18,12:25:00,19461.5,SELL,3,0.02h,Stop Loss,$-9.00,$-39.00,$119354.00,186,$-39.00
2024-09-18,12:26:00,19696.75,BUY,3,0.02h,Stop Loss,$-9.00,$-48.00,$119345.00,186,$-48.00
2024-09-18,12:27:00,19459.5,SELL,3,0.02h,Stop Loss,$-9.00,$-57.00,$119336.00,186,$-57.00
2024-09-18,12:28:00,19698.25,BUY,3,0.02h,Break Even,$-1.50,$-58.50,$119334.50,186,$-58.50
2024-09-18,12:30:00,19464.5,SELL,3,0.02h,Stop Loss,$-9.00,$-67.50,$119325.50,186,$-67.50
2024-09-18,12:41:00,19728.0,BUY,3,0.02h,Stop Loss,$-9.00,$-76.50,$119316.50,186,$-76.50
2024-09-18,12:42:00,19487.0,SELL,3,0.02h,Stop Loss,$-9.00,$-85.50,$119307.50,186,$-85.50
2024-09-18,12:43:00,19722.5,BUY,3,0.02h,Stop Loss,$3.00,$-82.50,$119310.50,186,$-82.50
2024-09-18,12:53:00,19486.0,SELL,3,0.02h,Stop Loss,$-9.00,$-91.50,$119301.50,186,$-91.50
2024-09-18,12:54:00,19721.75,BUY,3,0.02h,Break Even,$-1.50,$-93.00,$119300.00,186,$-93.00
2024-09-18,13:00:00,19490.75,SELL,3,0.02h,Stop Loss,$-9.00,$-102.00,$119291.00,186,$-102.00
2024-09-18,13:06:00,19727.0,BUY,3,0.02h,Break Even,$-1.50,$-103.50,$119289.50,186,$-103.50
2024-09-18,13:11:00,19488.0,SELL,3,0.02h,Stop Loss,$-9.00,$-112.50,$119280.50,186,$-112.50
2024-09-18,13:12:00,19725.75,BUY,3,0.02h,Stop Loss,$-9.00,$-121.50,$119271.50,186,$-121.50
2024-09-18,13:13:00,19492.75,SELL,3,0.02h,Stop Loss,$-9.00,$-130.50,$119262.50,186,$-130.50
2024-09-18,13:14:00,19728.25,BUY,3,0.02h,Stop Loss,$-9.00,$-139.50,$119253.50,186,$-139.50
2024-09-18,13:15:00,19494.0,SELL,3,0.02h,Stop Loss,$-9.00,$-148.50,$119244.50,186,$-148.50
2024-09-18,13:18:00,19726.75,BUY,3,0.02h,Stop Loss,$-9.00,$-157.50,$119235.50,186,$-157.50
2024-09-18,13:19:00,19489.75,SELL,3,0.02h,Stop Loss,$-9.00,$-166.50,$119226.50,186,$-166.50
2024-09-18,13:20:00,19727.75,BUY,3,0.02h,Break Even,$-1.50,$-168.00,$119225.00,186,$-168.00
2024-09-18,13:29:00,19497.25,SELL,3,0.02h,Stop Loss,$27.00,$-141.00,$119252.00,186,$-141.00
2024-09-18,13:32:00,19712.25,BUY,3,0.02h,Stop Loss,$-9.00,$-150.00,$119243.00,186,$-150.00
2024-09-18,13:33:00,19480.75,SELL,3,0.02h,Stop Loss,$22.50,$-127.50,$119265.50,186,$-127.50
2024-09-18,13:52:00,19699.0,BUY,3,0.02h,Stop Loss,$-9.00,$-136.50,$119256.50,186,$-136.50
2024-09-18,13:53:00,19467.25,SELL,3,0.02h,Stop Loss,$18.00,$-118.50,$119274.50,186,$-118.50
2024-09-18,13:55:00,19694.25,BUY,3,0.02h,Stop Loss,$69.00,$-49.50,$119343.50,186,$-49.50
2024-09-18,14:03:00,19456.5,SELL,3,0.02h,Break Even,$-1.50,$-51.00,$119342.00,186,$-51.00
2024-09-18,14:06:00,19698.5,BUY,3,0.02h,Stop Loss,$7.50,$-43.50,$119349.50,186,$-43.50
2024-09-18,14:10:00,19447.0,SELL,3,0.02h,Stop Loss,$24.00,$-19.50,$119373.50,186,$-19.50
2024-09-18,14:14:00,19668.0,BUY,3,0.02h,Stop Loss,$-9.00,$-28.50,$119364.50,186,$-28.50
2024-09-18,14:15:00,19452.0,SELL,3,0.02h,Stop Loss,$-9.00,$-37.50,$119355.50,186,$-37.50
2024-09-18,14:16:00,19687.5,BUY,3,0.02h,Stop Loss,$-9.00,$-46.50,$119346.50,186,$-46.50
2024-09-18,14:17:00,19443.25,SELL,3,0.02h,Stop Loss,$12.00,$-34.50,$119358.50,186,$-34.50
2024-09-18,14:19:00,19671.5,BUY,3,0.02h,Break Even,$-1.50,$-36.00,$119357.00,186,$-36.00
2024-09-18,14:21:00,19426.5,SELL,3,0.02h,Stop Loss,$18.00,$-18.00,$119375.00,186,$-18.00
2024-09-18,14:36:00,19681.5,BUY,3,0.02h,Stop Loss,$3.00,$-15.00,$119378.00,186,$-15.00
2024-09-18,15:00:00,19455.5,SELL,3,0.02h,Stop Loss,$9.00,$-6.00,$119387.00,186,$-6.00
2024-09-18,15:15:00,19674.0,BUY,3,0.02h,Stop Loss,$-9.00,$-15.00,$119378.00,186,$-15.00
2024-09-18,15:16:00,19434.25,SELL,3,0.02h,Stop Loss,$-9.00,$-24.00,$119369.00,186,$-24.00
2024-09-18,15:17:00,19665.0,BUY,3,0.02h,Stop Loss,$-9.00,$-33.00,$119360.00,186,$-33.00
2024-09-18,15:18:00,19431.25,SELL,3,0.02h,Stop Loss,$-9.00,$-42.00,$119351.00,186,$-42.00
2024-09-18,15:19:00,19664.75,BUY,3,0.02h,Stop Loss,$-9.00,$-51.00,$119342.00,186,$-51.00
2024-09-18,15:20:00,19429.75,SELL,3,0.02h,Stop Loss,$60.00,$9.00,$119402.00,186,$9.00
2024-09-18,15:25:00,19642.0,BUY,3,0.02h,Break Even,$-1.50,$7.50,$119400.50,186,$7.50
2024-09-18,15:29:00,19428.5,SELL,3,0.02h,Stop Loss,$13.50,$21.00,$119414.00,186,$21.00
2024-09-18,15:33:00,19640.25,BUY,3,0.02h,Stop Loss,$-9.00,$12.00,$119405.00,186,$12.00
2024-09-18,15:34:00,19402.25,SELL,3,0.02h,Stop Loss,$-9.00,$3.00,$119396.00,186,$3.00
2024-09-18,15:35:00,19634.5,BUY,3,0.02h,Stop Loss,$-9.00,$-6.00,$119387.00,186,$-6.00
2024-09-18,15:36:00,19404.0,SELL,3,0.02h,Stop Loss,$-9.00,$-15.00,$119378.00,186,$-15.00
2024-09-18,15:37:00,19636.25,BUY,3,0.02h,Stop Loss,$-9.00,$-24.00,$119369.00,186,$-24.00
2024-09-18,15:38:00,19406.0,SELL,3,0.02h,Stop Loss,$-9.00,$-33.00,$119360.00,186,$-33.00
2024-09-18,15:39:00,19638.0,BUY,3,0.02h,Stop Loss,$-9.00,$-42.00,$119351.00,186,$-42.00
2024-09-18,15:46:00,19380.5,SELL,3,0.02h,Stop Loss,$-9.00,$-51.00,$119342.00,186,$-51.00
2024-09-18,16:05:00,19588.75,BUY,3,0.02h,Stop Loss,$13.50,$-37.50,$119355.50,186,$-37.50
2024-09-18,16:10:00,19373.5,SELL,3,0.02h,Stop Loss,$-9.00,$-46.50,$119346.50,186,$-46.50
2024-09-18,16:11:00,19622.25,BUY,3,0.02h,Stop Loss,$-9.00,$-55.50,$119337.50,186,$-55.50
2024-09-18,16:12:00,19390.25,SELL,3,0.02h,Break Even,$-1.50,$-57.00,$119336.00,186,$-57.00
2024-09-18,16:16:00,19637.0,BUY,3,0.02h,Stop Loss,$37.50,$-19.50,$119373.50,186,$-19.50
2024-09-18,16:27:00,19432.0,SELL,3,0.02h,Stop Loss,$-9.00,$-28.50,$119364.50,186,$-28.50
2024-09-18,16:28:00,19670.0,BUY,3,0.02h,Stop Loss,$-9.00,$-37.50,$119355.50,186,$-37.50
2024-09-18,16:29:00,19437.0,SELL,3,0.02h,Break Even,$-1.50,$-39.00,$119354.00,186,$-39.00
2024-09-18,16:31:00,19667.75,BUY,3,0.02h,Break Even,$-1.50,$-40.50,$119352.50,186,$-40.50
2024-09-18,16:37:00,19431.5,SELL,3,0.02h,Break Even,$-1.50,$-42.00,$119351.00,186,$-42.00
2024-09-18,16:39:00,19668.25,BUY,3,0.02h,Stop Loss,$-9.00,$-51.00,$119342.00,186,$-51.00
2024-09-18,16:40:00,19430.25,SELL,3,0.02h,Stop Loss,$-9.00,$-60.00,$119333.00,186,$-60.00
2024-09-18,16:41:00,19655.25,BUY,3,0.02h,Stop Loss,$-9.00,$-69.00,$119324.00,186,$-69.00
2024-09-18,16:42:00,19426.0,SELL,3,0.02h,Stop Loss,$-9.00,$-78.00,$119315.00,186,$-78.00
2024-09-18,16:47:00,19668.5,BUY,3,0.02h,Stop Loss,$24.00,$-54.00,$119339.00,186,$-54.00
2024-09-18,16:52:00,19447.75,SELL,3,0.02h,Stop Loss,$-9.00,$-63.00,$119330.00,186,$-63.00
2024-09-18,16:53:00,19686.25,BUY,3,0.02h,Break Even,$-1.50,$-64.50,$119328.50,186,$-64.50
2024-09-18,17:07:00,19464.75,SELL,3,0.02h,Stop Loss,$-9.00,$-73.50,$119319.50,186,$-73.50
2024-09-18,17:09:00,19702.0,BUY,3,0.02h,Stop Loss,$-9.00,$-82.50,$119310.50,186,$-82.50
2024-09-18,17:10:00,19463.75,SELL,3,0.02h,Break Even,$-1.50,$-84.00,$119309.00,186,$-84.00
2024-09-18,17:16:00,19689.5,BUY,3,0.02h,Stop Loss,$-9.00,$-93.00,$119300.00,186,$-93.00
2024-09-18,17:17:00,19452.0,SELL,3,0.02h,Stop Loss,$-9.00,$-102.00,$119291.00,186,$-102.00
2024-09-18,17:18:00,19686.5,BUY,3,0.02h,Stop Loss,$-9.00,$-111.00,$119282.00,186,$-111.00
2024-09-18,17:19:00,19451.25,SELL,3,0.02h,Break Even,$-1.50,$-112.50,$119280.50,186,$-112.50
2024-09-18,17:25:00,19677.0,BUY,3,0.02h,Stop Loss,$-9.00,$-121.50,$119271.50,186,$-121.50
2024-09-18,17:26:00,19453.25,SELL,3,0.02h,Stop Loss,$-9.00,$-130.50,$119262.50,186,$-130.50
2024-09-18,17:27:00,19688.5,BUY,3,0.02h,Stop Loss,$6.00,$-124.50,$119268.50,186,$-124.50
2024-09-18,17:31:00,19472.5,SELL,3,0.02h,Stop Loss,$-9.00,$-133.50,$119259.50,186,$-133.50
2024-09-18,17:39:00,19690.25,BUY,3,0.02h,Stop Loss,$-9.00,$-142.50,$119250.50,186,$-142.50
2024-09-18,17:40:00,19453.75,SELL,3,0.02h,Stop Loss,$-9.00,$-151.50,$119241.50,186,$-151.50
2024-09-18,17:41:00,19689.0,BUY,3,0.02h,Break Even,$-1.50,$-153.00,$119240.00,186,$-153.00
2024-09-18,17:46:00,19466.5,SELL,3,0.02h,Stop Loss,$69.00,$-84.00,$119309.00,186,$-84.00
2024-09-18,17:55:00,19689.25,BUY,3,0.02h,Stop Loss,$-9.00,$-93.00,$119300.00,186,$-93.00
2024-09-18,18:13:00,19453.75,SELL,3,0.02h,Stop Loss,$-9.00,$-102.00,$119291.00,186,$-102.00
2024-09-18,18:14:00,19701.5,BUY,3,0.02h,Stop Loss,$231.00,$129.00,$119522.00,186,$129.00
2024-09-18,18:16:00,19516.5,SELL,3,0.02h,Stop Loss,$-9.00,$120.00,$119513.00,186,$120.00
2024-09-18,18:17:00,19766.0,BUY,3,0.02h,Stop Loss,$196.50,$316.50,$119709.50,186,$316.50
2024-09-18,18:25:00,19565.75,SELL,3,0.02h,Stop Loss,$15.00,$331.50,$119724.50,186,$331.50
2024-09-18,18:27:00,19792.25,BUY,3,0.02h,Stop Loss,$-9.00,$322.50,$119715.50,186,$322.50
2024-09-18,18:28:00,19548.5,SELL,3,0.02h,Break Even,$-1.50,$321.00,$119714.00,186,$321.00
2024-09-18,18:32:00,19817.75,BUY,3,0.02h,Stop Loss,$-9.00,$312.00,$119705.00,186,$312.00
2024-09-18,18:33:00,19605.0,SELL,3,0.02h,Stop Loss,$4.50,$316.50,$119709.50,186,$316.50
2024-09-18,18:35:00,19864.0,BUY,3,0.02h,Break Even,$-1.50,$315.00,$119708.00,186,$315.00
2024-09-18,18:46:00,19515.25,SELL,3,0.02h,Stop Loss,$-9.00,$306.00,$119699.00,186,$306.00
2024-09-18,18:47:00,19793.5,BUY,3,0.02h,Stop Loss,$75.00,$381.00,$119774.00,186,$381.00
2024-09-18,18:50:00,19543.0,SELL,3,0.02h,Stop Loss,$-9.00,$372.00,$119765.00,186,$372.00
2024-09-18,18:51:00,19776.5,BUY,3,0.02h,Stop Loss,$123.00,$495.00,$119888.00,186,$495.00
2024-09-18,18:53:00,19581.5,SELL,3,0.02h,Stop Loss,$40.50,$535.50,$119928.50,186,$535.50
2024-09-18,19:19:00,19680.0,BUY,3,0.02h,Stop Loss,$-9.00,$526.50,$119919.50,186,$526.50
2024-09-18,19:20:00,19468.5,SELL,3,0.02h,Stop Loss,$393.00,$919.50,$120312.50,186,$919.50
2024-09-18,19:24:00,19676.0,BUY,3,0.02h,Stop Loss,$72.00,$991.50,$120384.50,186,$991.50
2024-09-18,19:37:00,19431.0,SELL,3,0.02h,Stop Loss,$-9.00,$982.50,$120375.50,186,$982.50
2024-09-18,19:56:00,19595.75,BUY,3,0.02h,Stop Loss,$27.00,$1009.50,$120402.50,186,$1009.50
2024-09-18,20:01:00,19351.25,SELL,3,0.02h,Stop Loss,$76.50,$1086.00,$120479.00,186,$1086.00
2024-09-18,20:08:00,19632.0,BUY,3,0.02h,Stop Loss,$82.50,$1168.50,$120561.50,186,$1168.50
2024-09-18,20:12:00,19403.0,SELL,3,0.02h,Break Even,$-1.50,$1167.00,$120560.00,186,$1167.00
2024-09-18,20:18:00,19654.0,BUY,3,0.02h,Stop Loss,$-9.00,$1158.00,$120551.00,186,$1158.00
2024-09-18,20:19:00,19428.5,SELL,3,0.02h,Stop Loss,$-9.00,$1149.00,$120542.00,186,$1149.00
2024-09-18,20:20:00,19661.0,BUY,3,0.02h,Break Even,$-1.50,$1147.50,$120540.50,186,$1147.50
2024-09-18,20:29:00,19411.75,SELL,3,0.02h,Stop Loss,$-9.00,$1138.50,$120531.50,186,$1138.50
2024-09-18,20:30:00,19643.75,BUY,3,0.02h,Stop Loss,$-9.00,$1129.50,$120522.50,186,$1129.50
2024-09-18,20:31:00,19419.5,SELL,3,0.02h,Break Even,$-1.50,$1128.00,$120521.00,186,$1128.00
2024-09-18,20:44:00,19623.75,BUY,3,0.02h,Stop Loss,$-9.00,$1119.00,$120512.00,186,$1119.00
2024-09-18,20:45:00,19399.75,SELL,3,0.02h,Stop Loss,$-9.00,$1110.00,$120503.00,186,$1110.00
2024-09-18,20:46:00,19626.75,BUY,3,0.02h,Break Even,$-1.50,$1108.50,$120501.50,186,$1108.50
2024-09-18,20:51:00,19406.25,SELL,3,0.02h,Stop Loss,$-9.00,$1099.50,$120492.50,186,$1099.50
2024-09-18,20:52:00,19629.75,BUY,3,0.02h,Stop Loss,$-9.00,$1090.50,$120483.50,186,$1090.50
2024-09-18,20:53:00,19397.25,SELL,3,0.03h,Break Even,$-1.50,$1089.00,$120482.00,186,$1089.00
2024-09-18,20:55:00,19632.0,BUY,3,0.02h,Break Even,$-1.50,$1087.50,$120480.50,186,$1087.50
2024-09-18,21:00:00,19403.75,SELL,3,1.02h,Stop Loss,$-9.00,$1078.50,$120471.50,186,$1078.50
2024-09-18,22:01:00,19645.0,BUY,3,0.02h,Break Even,$-1.50,$1077.00,$120470.00,186,$1077.00
2024-09-18,22:04:00,19433.25,SELL,3,0.02h,Stop Loss,$-9.00,$1068.00,$120461.00,186,$1068.00
2024-09-18,22:05:00,19660.5,BUY,3,0.02h,Stop Loss,$-9.00,$1059.00,$120452.00,186,$1059.00
2024-09-18,22:06:00,19425.5,SELL,3,0.02h,Stop Loss,$-9.00,$1050.00,$120443.00,186,$1050.00
2024-09-18,22:07:00,19653.75,BUY,3,0.02h,Stop Loss,$-9.00,$1041.00,$120434.00,186,$1041.00
2024-09-18,22:08:00,19422.25,SELL,3,0.02h,Stop Loss,$-9.00,$1032.00,$120425.00,186,$1032.00
2024-09-18,22:09:00,19650.25,BUY,3,0.02h,Break Even,$-1.50,$1030.50,$120423.50,186,$1030.50
2024-09-18,22:15:00,19428.75,SELL,3,0.02h,Stop Loss,$-9.00,$1021.50,$120414.50,186,$1021.50
2024-09-18,22:16:00,19664.0,BUY,3,0.02h,Stop Loss,$-9.00,$1012.50,$120405.50,186,$1012.50
2024-09-18,22:17:00,19436.0,SELL,3,0.02h,Stop Loss,$-9.00,$1003.50,$120396.50,186,$1003.50
2024-09-18,22:19:00,19675.5,BUY,3,0.02h,Break Even,$-1.50,$1002.00,$120395.00,186,$1002.00
2024-09-18,22:22:00,19445.25,SELL,3,0.02h,Break Even,$-1.50,$1000.50,$120393.50,186,$1000.50
2024-09-18,22:24:00,19673.5,BUY,3,0.02h,Stop Loss,$-9.00,$991.50,$120384.50,186,$991.50
2024-09-18,22:36:00,19452.75,SELL,3,0.02h,Stop Loss,$-9.00,$982.50,$120375.50,186,$982.50
2024-09-18,22:37:00,19685.0,BUY,3,0.02h,Break Even,$-1.50,$981.00,$120374.00,186,$981.00
2024-09-18,22:39:00,19451.75,SELL,3,0.02h,Stop Loss,$-9.00,$972.00,$120365.00,186,$972.00
2024-09-18,22:44:00,19683.5,BUY,3,0.02h,Break Even,$-1.50,$970.50,$120363.50,186,$970.50
2024-09-18,22:46:00,19448.0,SELL,3,0.02h,Break Even,$-1.50,$969.00,$120362.00,186,$969.00
2024-09-18,22:56:00,19664.0,BUY,3,0.02h,Break Even,$-1.50,$967.50,$120360.50,186,$967.50
,,,,,,,,,,,
2024-09-19,12:37:00,19766.75,SELL,3,0.02h,Stop Loss,$12.00,$12.00,$120372.50,187,$12.00
2024-09-19,12:40:00,20003.0,BUY,3,0.02h,Stop Loss,$57.00,$69.00,$120429.50,187,$69.00
2024-09-19,12:53:00,19763.25,SELL,3,0.02h,Stop Loss,$-9.00,$60.00,$120420.50,187,$60.00
2024-09-19,12:54:00,19995.5,BUY,3,0.02h,Stop Loss,$-9.00,$51.00,$120411.50,187,$51.00
2024-09-19,12:55:00,19762.25,SELL,3,0.02h,Stop Loss,$-9.00,$42.00,$120402.50,187,$42.00
2024-09-19,13:04:00,19994.75,BUY,3,0.02h,Stop Loss,$-9.00,$33.00,$120393.50,187,$33.00
2024-09-19,13:24:00,19796.5,SELL,3,0.02h,Break Even,$-1.50,$31.50,$120392.00,187,$31.50
2024-09-19,13:32:00,20039.5,BUY,3,0.02h,Stop Loss,$39.00,$70.50,$120431.00,187,$70.50
2024-09-19,13:34:00,19798.75,SELL,3,0.02h,Stop Loss,$64.50,$135.00,$120495.50,187,$135.00
2024-09-19,13:36:00,20020.0,BUY,3,0.02h,Break Even,$-1.50,$133.50,$120494.00,187,$133.50
2024-09-19,13:40:00,19812.75,SELL,3,0.02h,Stop Loss,$-9.00,$124.50,$120485.00,187,$124.50
2024-09-19,13:41:00,20060.5,BUY,3,0.02h,Stop Loss,$54.00,$178.50,$120539.00,187,$178.50
2024-09-19,13:47:00,19784.25,SELL,3,0.02h,Stop Loss,$31.50,$210.00,$120570.50,187,$210.00
2024-09-19,13:50:00,20015.25,BUY,3,0.02h,Stop Loss,$-9.00,$201.00,$120561.50,187,$201.00
2024-09-19,13:58:00,19767.0,SELL,3,0.02h,Stop Loss,$-9.00,$192.00,$120552.50,187,$192.00
2024-09-19,13:59:00,20008.25,BUY,3,0.02h,Stop Loss,$7.50,$199.50,$120560.00,187,$199.50
2024-09-19,14:07:00,19794.0,SELL,3,0.02h,Stop Loss,$-9.00,$190.50,$120551.00,187,$190.50
2024-09-19,14:09:00,20040.0,BUY,3,0.02h,Break Even,$-1.50,$189.00,$120549.50,187,$189.00
2024-09-19,14:12:00,19809.0,SELL,3,0.02h,Break Even,$-1.50,$187.50,$120548.00,187,$187.50
2024-09-19,14:16:00,20059.0,BUY,3,0.02h,Stop Loss,$-9.00,$178.50,$120539.00,187,$178.50
2024-09-19,14:17:00,19821.0,SELL,3,0.02h,Stop Loss,$-9.00,$169.50,$120530.00,187,$169.50
2024-09-19,14:18:00,20071.25,BUY,3,0.02h,Stop Loss,$55.50,$225.00,$120585.50,187,$225.00
2024-09-19,14:23:00,19843.5,SELL,3,0.02h,Stop Loss,$-9.00,$216.00,$120576.50,187,$216.00
2024-09-19,14:24:00,20075.75,BUY,3,0.02h,Stop Loss,$85.50,$301.50,$120662.00,187,$301.50
2024-09-19,14:27:00,19862.0,SELL,3,0.02h,Stop Loss,$-9.00,$292.50,$120653.00,187,$292.50
2024-09-19,14:29:00,20129.25,BUY,3,0.02h,Stop Loss,$-9.00,$283.50,$120644.00,187,$283.50
2024-09-19,14:30:00,19893.0,SELL,3,0.02h,Break Even,$-1.50,$282.00,$120642.50,187,$282.00
2024-09-19,14:32:00,20153.75,BUY,3,0.02h,Stop Loss,$7.50,$289.50,$120650.00,187,$289.50
2024-09-19,14:39:00,19895.5,SELL,3,0.02h,Stop Loss,$-9.00,$280.50,$120641.00,187,$280.50
2024-09-19,14:40:00,20142.5,BUY,3,0.02h,Stop Loss,$-9.00,$271.50,$120632.00,187,$271.50
2024-09-19,14:43:00,19879.5,SELL,3,0.02h,Stop Loss,$55.50,$327.00,$120687.50,187,$327.00
2024-09-19,14:49:00,20095.75,BUY,3,0.02h,Stop Loss,$73.50,$400.50,$120761.00,187,$400.50
2024-09-19,14:51:00,19862.5,SELL,3,0.02h,Stop Loss,$-9.00,$391.50,$120752.00,187,$391.50
2024-09-19,14:52:00,20092.25,BUY,3,0.02h,Stop Loss,$-9.00,$382.50,$120743.00,187,$382.50
2024-09-19,14:53:00,19846.25,SELL,3,0.02h,Stop Loss,$-9.00,$373.50,$120734.00,187,$373.50
2024-09-19,14:54:00,20086.25,BUY,3,0.02h,Stop Loss,$-9.00,$364.50,$120725.00,187,$364.50
2024-09-19,14:55:00,19844.0,SELL,3,0.02h,Stop Loss,$49.50,$414.00,$120774.50,187,$414.00
2024-09-19,15:05:00,20104.25,BUY,3,0.02h,Break Even,$-1.50,$412.50,$120773.00,187,$412.50
2024-09-19,15:09:00,19835.5,SELL,3,0.02h,Stop Loss,$-9.00,$403.50,$120764.00,187,$403.50
2024-09-19,15:16:00,20101.75,BUY,3,0.02h,Stop Loss,$129.00,$532.50,$120893.00,187,$532.50
2024-09-19,15:26:00,19903.25,SELL,3,0.02h,Stop Loss,$24.00,$556.50,$120917.00,187,$556.50
2024-09-19,15:28:00,20134.75,BUY,3,0.02h,Break Even,$-1.50,$555.00,$120915.50,187,$555.00
2024-09-19,15:33:00,19891.75,SELL,3,0.02h,Stop Loss,$42.00,$597.00,$120957.50,187,$597.00
2024-09-19,15:36:00,20137.25,BUY,3,0.02h,Stop Loss,$-9.00,$588.00,$120948.50,187,$588.00
2024-09-19,15:37:00,19900.25,SELL,3,0.02h,Stop Loss,$-9.00,$579.00,$120939.50,187,$579.00
2024-09-19,15:38:00,20137.5,BUY,3,0.02h,Stop Loss,$-9.00,$570.00,$120930.50,187,$570.00
2024-09-19,15:39:00,19898.25,SELL,3,0.02h,Stop Loss,$-9.00,$561.00,$120921.50,187,$561.00
2024-09-19,15:40:00,20135.25,BUY,3,0.02h,Stop Loss,$-9.00,$552.00,$120912.50,187,$552.00
2024-09-19,15:51:00,19901.5,SELL,3,0.02h,Stop Loss,$-9.00,$543.00,$120903.50,187,$543.00
2024-09-19,15:52:00,20113.5,BUY,3,0.02h,Stop Loss,$-9.00,$534.00,$120894.50,187,$534.00
2024-09-19,15:54:00,19868.5,SELL,3,0.02h,Stop Loss,$-9.00,$525.00,$120885.50,187,$525.00
2024-09-19,16:00:00,20098.25,BUY,3,0.02h,Stop Loss,$34.50,$559.50,$120920.00,187,$559.50
2024-09-19,16:02:00,19880.0,SELL,3,0.02h,Stop Loss,$-9.00,$550.50,$120911.00,187,$550.50
2024-09-19,16:03:00,20123.75,BUY,3,0.02h,Stop Loss,$31.50,$582.00,$120942.50,187,$582.00
2024-09-19,16:05:00,19898.5,SELL,3,0.02h,Stop Loss,$-9.00,$573.00,$120933.50,187,$573.00
2024-09-19,16:06:00,20130.5,BUY,3,0.02h,Stop Loss,$3.00,$576.00,$120936.50,187,$576.00
2024-09-19,16:11:00,19906.25,SELL,3,0.02h,Stop Loss,$60.00,$636.00,$120996.50,187,$636.00
2024-09-19,16:14:00,20124.75,BUY,3,0.02h,Stop Loss,$-9.00,$627.00,$120987.50,187,$627.00
2024-09-19,16:18:00,19905.0,SELL,3,0.02h,Stop Loss,$-9.00,$618.00,$120978.50,187,$618.00
2024-09-19,16:19:00,20137.0,BUY,3,0.02h,Stop Loss,$36.00,$654.00,$121014.50,187,$654.00
2024-09-19,16:26:00,19918.75,SELL,3,0.02h,Break Even,$-1.50,$652.50,$121013.00,187,$652.50
2024-09-19,16:31:00,20163.5,BUY,3,0.02h,Stop Loss,$-9.00,$643.50,$121004.00,187,$643.50
2024-09-19,16:32:00,19918.5,SELL,3,0.02h,Break Even,$-1.50,$642.00,$121002.50,187,$642.00
2024-09-19,16:35:00,20161.75,BUY,3,0.02h,Break Even,$-1.50,$640.50,$121001.00,187,$640.50
2024-09-19,16:39:00,19930.5,SELL,3,0.02h,Break Even,$-1.50,$639.00,$120999.50,187,$639.00
2024-09-19,16:41:00,20168.0,BUY,3,0.02h,Stop Loss,$-9.00,$630.00,$120990.50,187,$630.00
2024-09-19,16:42:00,19924.25,SELL,3,0.02h,Stop Loss,$-9.00,$621.00,$120981.50,187,$621.00
2024-09-19,16:43:00,20159.75,BUY,3,0.02h,Break Even,$-1.50,$619.50,$120980.00,187,$619.50
2024-09-19,16:50:00,19929.5,SELL,3,0.02h,Stop Loss,$-9.00,$610.50,$120971.00,187,$610.50
2024-09-19,16:51:00,20167.25,BUY,3,0.02h,Stop Loss,$-9.00,$601.50,$120962.00,187,$601.50
2024-09-19,16:52:00,19930.0,SELL,3,0.02h,Stop Loss,$-9.00,$592.50,$120953.00,187,$592.50
2024-09-19,16:53:00,20168.0,BUY,3,0.02h,Break Even,$-1.50,$591.00,$120951.50,187,$591.00
2024-09-19,16:57:00,19926.0,SELL,3,0.02h,Stop Loss,$-9.00,$582.00,$120942.50,187,$582.00
2024-09-19,17:05:00,20160.25,BUY,3,0.02h,Stop Loss,$-9.00,$573.00,$120933.50,187,$573.00
2024-09-19,17:06:00,19921.25,SELL,3,0.02h,Stop Loss,$-9.00,$564.00,$120924.50,187,$564.00
2024-09-19,17:07:00,20148.25,BUY,3,0.02h,Stop Loss,$-9.00,$555.00,$120915.50,187,$555.00
2024-09-19,17:08:00,19915.75,SELL,3,0.02h,Stop Loss,$-9.00,$546.00,$120906.50,187,$546.00
2024-09-19,17:09:00,20149.0,BUY,3,0.02h,Stop Loss,$-9.00,$537.00,$120897.50,187,$537.00
2024-09-19,17:10:00,19918.5,SELL,3,0.02h,Stop Loss,$-9.00,$528.00,$120888.50,187,$528.00
2024-09-19,17:11:00,20151.75,BUY,3,0.02h,Stop Loss,$-9.00,$519.00,$120879.50,187,$519.00
2024-09-19,17:12:00,19916.25,SELL,3,0.02h,Stop Loss,$27.00,$546.00,$120906.50,187,$546.00
2024-09-19,17:17:00,20165.75,BUY,3,0.02h,Stop Loss,$-9.00,$537.00,$120897.50,187,$537.00
2024-09-19,17:18:00,19932.75,SELL,3,0.02h,Stop Loss,$-9.00,$528.00,$120888.50,187,$528.00
2024-09-19,17:19:00,20164.75,BUY,3,0.02h,Stop Loss,$3.00,$531.00,$120891.50,187,$531.00
2024-09-19,17:31:00,19931.75,SELL,3,0.02h,Stop Loss,$18.00,$549.00,$120909.50,187,$549.00
2024-09-19,17:37:00,20167.25,BUY,3,0.02h,Stop Loss,$-9.00,$540.00,$120900.50,187,$540.00
2024-09-19,17:38:00,19938.5,SELL,3,0.02h,Stop Loss,$-9.00,$531.00,$120891.50,187,$531.00
2024-09-19,17:39:00,20172.25,BUY,3,0.02h,Stop Loss,$3.00,$534.00,$120894.50,187,$534.00
2024-09-19,17:42:00,19943.0,SELL,3,0.02h,Stop Loss,$-9.00,$525.00,$120885.50,187,$525.00
2024-09-19,17:43:00,20183.0,BUY,3,0.02h,Stop Loss,$-9.00,$516.00,$120876.50,187,$516.00
2024-09-19,17:44:00,19936.5,SELL,3,0.02h,Stop Loss,$-9.00,$507.00,$120867.50,187,$507.00
2024-09-19,17:45:00,20183.0,BUY,3,0.02h,Break Even,$-1.50,$505.50,$120866.00,187,$505.50
2024-09-19,17:50:00,19955.75,SELL,3,0.02h,Stop Loss,$31.50,$537.00,$120897.50,187,$537.00
2024-09-19,18:01:00,20198.5,BUY,3,0.02h,Stop Loss,$-9.00,$528.00,$120888.50,187,$528.00
2024-09-19,18:02:00,19958.75,SELL,3,0.02h,Stop Loss,$-9.00,$519.00,$120879.50,187,$519.00
2024-09-19,18:03:00,20191.25,BUY,3,0.02h,Stop Loss,$4.50,$523.50,$120884.00,187,$523.50
2024-09-19,18:07:00,19956.0,SELL,3,0.02h,Stop Loss,$57.00,$580.50,$120941.00,187,$580.50
2024-09-19,18:13:00,20170.75,BUY,3,0.02h,Stop Loss,$-9.00,$571.50,$120932.00,187,$571.50
2024-09-19,18:20:00,19902.25,SELL,3,0.02h,Stop Loss,$9.00,$580.50,$120941.00,187,$580.50
2024-09-19,18:32:00,20148.25,BUY,3,0.02h,Break Even,$-1.50,$579.00,$120939.50,187,$579.00
2024-09-19,18:39:00,19906.0,SELL,3,0.02h,Stop Loss,$-9.00,$570.00,$120930.50,187,$570.00
2024-09-19,18:40:00,20151.5,BUY,3,0.02h,Stop Loss,$-9.00,$561.00,$120921.50,187,$561.00
2024-09-19,18:41:00,19908.25,SELL,3,0.02h,Stop Loss,$6.00,$567.00,$120927.50,187,$567.00
2024-09-19,18:46:00,20142.25,BUY,3,0.02h,Stop Loss,$40.50,$607.50,$120968.00,187,$607.50
2024-09-19,18:53:00,19893.25,SELL,3,0.02h,Stop Loss,$16.50,$624.00,$120984.50,187,$624.00
2024-09-19,18:59:00,20142.25,BUY,3,0.02h,Stop Loss,$25.50,$649.50,$121010.00,187,$649.50
2024-09-19,19:05:00,19904.5,SELL,3,0.02h,Stop Loss,$66.00,$715.50,$121076.00,187,$715.50
2024-09-19,19:08:00,20130.25,BUY,3,0.02h,Stop Loss,$-9.00,$706.50,$121067.00,187,$706.50
2024-09-19,19:09:00,19890.5,SELL,3,0.02h,Stop Loss,$31.50,$738.00,$121098.50,187,$738.00
2024-09-19,19:19:00,20097.0,BUY,3,0.02h,Stop Loss,$7.50,$745.50,$121106.00,187,$745.50
2024-09-19,19:21:00,19842.0,SELL,3,0.02h,Stop Loss,$-9.00,$736.50,$121097.00,187,$736.50
2024-09-19,19:22:00,20089.25,BUY,3,0.02h,Stop Loss,$-9.00,$727.50,$121088.00,187,$727.50
2024-09-19,19:23:00,19863.5,SELL,3,0.02h,Stop Loss,$-9.00,$718.50,$121079.00,187,$718.50
2024-09-19,19:26:00,20111.25,BUY,3,0.02h,Stop Loss,$-9.00,$709.50,$121070.00,187,$709.50
2024-09-19,19:30:00,19871.75,SELL,3,0.02h,Stop Loss,$72.00,$781.50,$121142.00,187,$781.50
2024-09-19,19:44:00,20117.75,BUY,3,0.02h,Break Even,$-1.50,$780.00,$121140.50,187,$780.00
2024-09-19,19:52:00,19840.75,SELL,3,0.02h,Stop Loss,$-9.00,$771.00,$121131.50,187,$771.00
2024-09-19,19:53:00,20070.25,BUY,3,0.02h,Stop Loss,$-9.00,$762.00,$121122.50,187,$762.00
2024-09-19,19:54:00,19834.25,SELL,3,0.02h,Stop Loss,$-9.00,$753.00,$121113.50,187,$753.00
2024-09-19,19:55:00,20091.5,BUY,3,0.02h,Stop Loss,$28.50,$781.50,$121142.00,187,$781.50
2024-09-19,19:58:00,19844.0,SELL,3,0.02h,Stop Loss,$52.50,$834.00,$121194.50,187,$834.00
2024-09-19,20:02:00,20076.75,BUY,3,0.02h,Stop Loss,$3.00,$837.00,$121197.50,187,$837.00
2024-09-19,20:04:00,19839.25,SELL,3,0.02h,Stop Loss,$6.00,$843.00,$121203.50,187,$843.00
2024-09-19,20:18:00,20060.25,BUY,3,0.02h,Stop Loss,$-9.00,$834.00,$121194.50,187,$834.00
2024-09-19,20:19:00,19826.0,SELL,3,0.02h,Stop Loss,$-9.00,$825.00,$121185.50,187,$825.00
2024-09-19,20:24:00,20060.75,BUY,3,0.02h,Stop Loss,$4.50,$829.50,$121190.00,187,$829.50
2024-09-19,20:27:00,19830.75,SELL,3,0.02h,Break Even,$-1.50,$828.00,$121188.50,187,$828.00
2024-09-19,20:33:00,20063.25,BUY,3,0.02h,Stop Loss,$-9.00,$819.00,$121179.50,187,$819.00
2024-09-19,20:45:00,19834.5,SELL,3,0.02h,Stop Loss,$43.50,$862.50,$121223.00,187,$862.50
2024-09-19,20:52:00,20065.0,BUY,3,0.02h,Stop Loss,$-9.00,$853.50,$121214.00,187,$853.50
2024-09-19,20:54:00,19824.5,SELL,3,0.03h,Break Even,$-1.50,$852.00,$121212.50,187,$852.00
2024-09-19,21:00:00,20063.25,BUY,3,1.02h,Stop Loss,$30.00,$882.00,$121242.50,187,$882.00
2024-09-19,22:08:00,19835.25,SELL,3,0.03h,Break Even,$-1.50,$880.50,$121241.00,187,$880.50
2024-09-19,22:16:00,20069.5,BUY,3,0.02h,Break Even,$-1.50,$879.00,$121239.50,187,$879.00
2024-09-19,22:18:00,19822.0,SELL,3,0.02h,Stop Loss,$-9.00,$870.00,$121230.50,187,$870.00
2024-09-19,22:23:00,20060.25,BUY,3,0.02h,Stop Loss,$-9.00,$861.00,$121221.50,187,$861.00
2024-09-19,22:24:00,19826.75,SELL,3,0.03h,Break Even,$-1.50,$859.50,$121220.00,187,$859.50
2024-09-19,22:26:00,20063.75,BUY,3,0.02h,Stop Loss,$4.50,$864.00,$121224.50,187,$864.00
2024-09-19,22:31:00,19828.5,SELL,3,0.02h,Stop Loss,$-9.00,$855.00,$121215.50,187,$855.00
2024-09-19,22:32:00,20060.25,BUY,3,0.02h,Break Even,$-1.50,$853.50,$121214.00,187,$853.50
2024-09-19,22:37:00,19816.5,SELL,3,0.02h,Stop Loss,$-9.00,$844.50,$121205.00,187,$844.50
2024-09-19,22:38:00,20054.75,BUY,3,0.02h,Stop Loss,$-9.00,$835.50,$121196.00,187,$835.50
2024-09-19,22:40:00,19801.25,SELL,3,0.02h,Break Even,$-1.50,$834.00,$121194.50,187,$834.00
2024-09-19,22:45:00,20040.75,BUY,3,0.02h,Stop Loss,$-9.00,$825.00,$121185.50,187,$825.00
2024-09-19,22:46:00,19805.0,SELL,3,0.02h,Stop Loss,$22.50,$847.50,$121208.00,187,$847.50
2024-09-19,22:52:00,20038.5,BUY,3,0.02h,Stop Loss,$13.50,$861.00,$121221.50,187,$861.00
2024-09-19,22:54:00,19805.0,SELL,3,0.02h,Stop Loss,$-9.00,$852.00,$121212.50,187,$852.00
2024-09-19,22:55:00,20044.0,BUY,3,0.02h,Stop Loss,$-9.00,$843.00,$121203.50,187,$843.00
,,,,,,,,,,,
2024-09-20,12:02:00,19791.0,SELL,3,0.02h,Stop Loss,$-9.00,$-9.00,$121194.50,188,$-9.00
2024-09-20,12:05:00,20033.5,BUY,3,0.02h,Stop Loss,$-9.00,$-18.00,$121185.50,188,$-18.00
2024-09-20,12:06:00,19802.0,SELL,3,0.02h,Stop Loss,$22.50,$4.50,$121208.00,188,$4.50
2024-09-20,12:16:00,20050.25,BUY,3,0.02h,Break Even,$-1.50,$3.00,$121206.50,188,$3.00
2024-09-20,12:23:00,19810.5,SELL,3,0.02h,Stop Loss,$-9.00,$-6.00,$121197.50,188,$-6.00
2024-09-20,12:25:00,20046.75,BUY,3,0.02h,Stop Loss,$9.00,$3.00,$121206.50,188,$3.00
2024-09-20,12:34:00,19821.75,SELL,3,0.02h,Stop Loss,$-9.00,$-6.00,$121197.50,188,$-6.00
2024-09-20,12:37:00,20057.25,BUY,3,0.02h,Stop Loss,$-9.00,$-15.00,$121188.50,188,$-15.00
2024-09-20,12:38:00,19823.25,SELL,3,0.02h,Stop Loss,$-9.00,$-24.00,$121179.50,188,$-24.00
2024-09-20,12:45:00,20071.0,BUY,3,0.02h,Stop Loss,$-9.00,$-33.00,$121170.50,188,$-33.00
2024-09-20,12:46:00,19830.75,SELL,3,0.02h,Stop Loss,$-9.00,$-42.00,$121161.50,188,$-42.00
2024-09-20,12:48:00,20070.0,BUY,3,0.02h,Stop Loss,$9.00,$-33.00,$121170.50,188,$-33.00
2024-09-20,12:58:00,19824.5,SELL,3,0.02h,Break Even,$-1.50,$-34.50,$121169.00,188,$-34.50
2024-09-20,13:01:00,20064.0,BUY,3,0.02h,Stop Loss,$-9.00,$-43.50,$121160.00,188,$-43.50
2024-09-20,13:21:00,19795.25,SELL,3,0.02h,Stop Loss,$-9.00,$-52.50,$121151.00,188,$-52.50
2024-09-20,13:33:00,20040.75,BUY,3,0.02h,Stop Loss,$33.00,$-19.50,$121184.00,188,$-19.50
2024-09-20,13:59:00,20007.75,SELL,3,0.02h,Stop Loss,$78.00,$58.50,$121262.00,188,$58.50
2024-09-20,14:29:00,20007.75,BUY,3,0.02h,Break Even,$-1.50,$57.00,$121260.50,188,$57.00
2024-09-20,14:31:00,19989.75,SELL,3,0.02h,Stop Loss,$61.50,$118.50,$121322.00,188,$118.50
2024-09-20,14:40:00,20009.25,BUY,3,0.02h,Stop Loss,$-9.00,$109.50,$121313.00,188,$109.50
2024-09-20,14:44:00,19991.5,SELL,3,0.02h,Stop Loss,$19.50,$129.00,$121332.50,188,$129.00
2024-09-20,15:34:00,19930.75,BUY,3,0.02h,Stop Loss,$103.50,$232.50,$121436.00,188,$232.50
2024-09-20,17:05:00,20004.25,SELL,3,0.02h,Break Even,$-1.50,$231.00,$121434.50,188,$231.00
2024-09-20,17:18:00,20018.5,BUY,3,0.02h,Break Even,$-1.50,$229.50,$121433.00,188,$229.50
2024-09-20,17:23:00,20008.0,SELL,3,0.02h,Break Even,$-1.50,$228.00,$121431.50,188,$228.00
2024-09-20,17:34:00,20021.5,BUY,3,0.02h,Stop Loss,$7.50,$235.50,$121439.00,188,$235.50
2024-09-20,17:46:00,20011.0,SELL,3,0.02h,Stop Loss,$22.50,$258.00,$121461.50,188,$258.00
2024-09-20,18:50:00,19957.5,BUY,3,0.02h,Stop Loss,$12.00,$270.00,$121473.50,188,$270.00
2024-09-20,19:53:00,20036.75,SELL,3,0.02h,Break Even,$-1.50,$268.50,$121472.00,188,$268.50
2024-09-20,20:41:00,20022.25,BUY,3,0.02h,Stop Loss,$-9.00,$259.50,$121463.00,188,$259.50
,,,,,,,,,,,
2024-09-23,12:51:00,20073.5,SELL,3,0.02h,Break Even,$-1.50,$-1.50,$121461.50,189,$-1.50
2024-09-23,12:58:00,20089.75,BUY,3,0.02h,Stop Loss,$7.50,$6.00,$121469.00,189,$6.00
2024-09-23,13:12:00,20080.5,SELL,3,0.02h,Stop Loss,$31.50,$37.50,$121500.50,189,$37.50
2024-09-23,13:49:00,20082.25,BUY,3,0.02h,Stop Loss,$91.50,$129.00,$121592.00,189,$129.00
2024-09-23,14:15:00,20057.25,SELL,3,0.02h,Stop Loss,$40.50,$169.50,$121632.50,189,$169.50
2024-09-23,14:22:00,20086.75,BUY,3,0.02h,Stop Loss,$67.50,$237.00,$121700.00,189,$237.00
2024-09-23,14:39:00,20074.5,SELL,3,0.02h,Stop Loss,$84.00,$321.00,$121784.00,189,$321.00
2024-09-23,14:45:00,20104.75,BUY,3,0.02h,Break Even,$-1.50,$319.50,$121782.50,189,$319.50
2024-09-23,15:02:00,20083.25,SELL,3,0.02h,Stop Loss,$34.50,$354.00,$121817.00,189,$354.00
2024-09-23,15:27:00,20083.75,BUY,3,0.02h,Stop Loss,$-9.00,$345.00,$121808.00,189,$345.00
2024-09-23,16:03:00,20102.25,SELL,3,0.02h,Stop Loss,$22.50,$367.50,$121830.50,189,$367.50
2024-09-23,17:20:00,20051.75,BUY,3,0.02h,Stop Loss,$19.50,$387.00,$121850.00,189,$387.00
2024-09-23,17:29:00,20037.25,SELL,3,0.02h,Break Even,$-1.50,$385.50,$121848.50,189,$385.50
2024-09-23,17:33:00,20049.5,BUY,3,0.02h,Stop Loss,$25.50,$411.00,$121874.00,189,$411.00
2024-09-23,18:30:00,20067.0,SELL,3,0.02h,Break Even,$-1.50,$409.50,$121872.50,189,$409.50
2024-09-23,18:43:00,20075.75,BUY,3,0.02h,Stop Loss,$-9.00,$400.50,$121863.50,189,$400.50
2024-09-23,18:46:00,20068.5,SELL,3,0.02h,Stop Loss,$-9.00,$391.50,$121854.50,189,$391.50
2024-09-23,18:51:00,20076.5,BUY,3,0.02h,Stop Loss,$-9.00,$382.50,$121845.50,189,$382.50
2024-09-23,19:10:00,20068.25,SELL,3,0.02h,Stop Loss,$12.00,$394.50,$121857.50,189,$394.50
2024-09-23,19:23:00,20077.25,BUY,3,0.02h,Stop Loss,$-9.00,$385.50,$121848.50,189,$385.50
2024-09-23,19:44:00,20069.75,SELL,3,0.02h,Stop Loss,$73.50,$459.00,$121922.00,189,$459.00
2024-09-23,19:50:00,20085.0,BUY,3,0.02h,Break Even,$-1.50,$457.50,$121920.50,189,$457.50
2024-09-23,19:54:00,20067.25,SELL,3,0.02h,Break Even,$-1.50,$456.00,$121919.00,189,$456.00
2024-09-23,19:57:00,20076.75,BUY,3,0.02h,Stop Loss,$10.50,$466.50,$121929.50,189,$466.50
2024-09-23,20:08:00,20067.0,SELL,3,0.02h,Break Even,$-1.50,$465.00,$121928.00,189,$465.00
2024-09-23,20:53:00,20062.0,BUY,3,0.02h,Stop Loss,$-9.00,$456.00,$121919.00,189,$456.00
2024-09-23,20:59:00,20058.25,SELL,3,0.02h,Stop Loss,$-9.00,$447.00,$121910.00,189,$447.00
2024-09-23,21:00:00,20063.25,BUY,3,1.02h,Stop Loss,$6.00,$453.00,$121916.00,189,$453.00
2024-09-23,22:07:00,20054.75,SELL,3,0.02h,Stop Loss,$21.00,$474.00,$121937.00,189,$474.00
2024-09-23,22:33:00,20055.25,BUY,3,0.02h,Stop Loss,$-9.00,$465.00,$121928.00,189,$465.00
2024-09-23,22:39:00,20052.0,SELL,3,0.02h,Stop Loss,$7.50,$472.50,$121935.50,189,$472.50
2024-09-23,23:00:00,20051.25,BUY,3,13.00h,Stop Loss,$306.00,$778.50,$122241.50,189,$778.50
,,,,,,,,,,,
2024-09-24,12:33:00,20098.5,SELL,3,0.02h,Stop Loss,$10.50,$10.50,$122252.00,190,$10.50
2024-09-24,12:49:00,20109.0,BUY,3,0.02h,Stop Loss,$3.00,$13.50,$122255.00,190,$13.50
2024-09-24,13:33:00,20117.75,SELL,3,0.02h,Stop Loss,$30.00,$43.50,$122285.00,190,$43.50
2024-09-24,14:48:00,20014.25,BUY,3,0.02h,Stop Loss,$9.00,$52.50,$122294.00,190,$52.50
2024-09-24,16:26:00,20183.5,SELL,3,0.02h,Stop Loss,$52.50,$105.00,$122346.50,190,$105.00
2024-09-24,16:34:00,20197.0,BUY,3,0.02h,Break Even,$-1.50,$103.50,$122345.00,190,$103.50
2024-09-24,16:54:00,20191.75,SELL,3,0.02h,Stop Loss,$58.50,$162.00,$122403.50,190,$162.00
2024-09-24,17:17:00,20185.5,BUY,3,0.02h,Stop Loss,$22.50,$184.50,$122426.00,190,$184.50
2024-09-24,17:24:00,20173.25,SELL,3,0.02h,Break Even,$-1.50,$183.00,$122424.50,190,$183.00
2024-09-24,17:34:00,20183.0,BUY,3,0.02h,Stop Loss,$10.50,$193.50,$122435.00,190,$193.50
2024-09-24,17:49:00,20177.5,SELL,3,0.02h,Stop Loss,$36.00,$229.50,$122471.00,190,$229.50
2024-09-24,18:54:00,20153.0,BUY,3,0.02h,Break Even,$-1.50,$228.00,$122469.50,190,$228.00
2024-09-24,19:19:00,20146.0,SELL,3,0.02h,Break Even,$-1.50,$226.50,$122468.00,190,$226.50
2024-09-24,19:21:00,20153.5,BUY,3,0.02h,Stop Loss,$3.00,$229.50,$122471.00,190,$229.50
2024-09-24,19:31:00,20146.5,SELL,3,0.02h,Break Even,$-1.50,$228.00,$122469.50,190,$228.00
2024-09-24,19:39:00,20154.25,BUY,3,0.02h,Stop Loss,$28.50,$256.50,$122498.00,190,$256.50
2024-09-24,19:57:00,20151.75,SELL,3,0.02h,Break Even,$-1.50,$255.00,$122496.50,190,$255.00
2024-09-24,20:01:00,20165.75,BUY,3,0.02h,Break Even,$-1.50,$253.50,$122495.00,190,$253.50
2024-09-24,22:01:00,20183.25,SELL,3,0.02h,Break Even,$-1.50,$252.00,$122493.50,190,$252.00
2024-09-24,22:14:00,20185.5,BUY,3,0.02h,Break Even,$-1.50,$250.50,$122492.00,190,$250.50
2024-09-24,22:19:00,20184.25,SELL,3,0.02h,Stop Loss,$3.00,$253.50,$122495.00,190,$253.50
2024-09-24,22:46:00,20185.5,BUY,3,0.02h,Stop Loss,$-9.00,$244.50,$122486.00,190,$244.50
,,,,,,,,,,,
2024-09-25,12:00:00,20140.75,SELL,3,0.02h,Stop Loss,$-9.00,$-9.00,$122477.00,191,$-9.00
2024-09-25,12:28:00,20144.0,BUY,3,0.02h,Break Even,$-1.50,$-10.50,$122475.50,191,$-10.50
2024-09-25,12:29:00,20142.25,SELL,3,0.02h,Break Even,$-1.50,$-12.00,$122474.00,191,$-12.00
2024-09-25,12:31:00,20145.5,BUY,3,0.02h,Stop Loss,$9.00,$-3.00,$122483.00,191,$-3.00
2024-09-25,12:48:00,20141.25,SELL,3,0.02h,Break Even,$-1.50,$-4.50,$122481.50,191,$-4.50
2024-09-25,12:55:00,20149.0,BUY,3,0.02h,Stop Loss,$-9.00,$-13.50,$122472.50,191,$-13.50
2024-09-25,12:57:00,20142.75,SELL,3,0.02h,Break Even,$-1.50,$-15.00,$122471.00,191,$-15.00
2024-09-25,12:59:00,20150.0,BUY,3,0.02h,Stop Loss,$-9.00,$-24.00,$122462.00,191,$-24.00
2024-09-25,13:04:00,20142.0,SELL,3,0.02h,Stop Loss,$-9.00,$-33.00,$122453.00,191,$-33.00
2024-09-25,13:10:00,20151.0,BUY,3,0.02h,Stop Loss,$-9.00,$-42.00,$122444.00,191,$-42.00
2024-09-25,13:20:00,20146.0,SELL,3,0.02h,Stop Loss,$-9.00,$-51.00,$122435.00,191,$-51.00
2024-09-25,13:31:00,20160.75,BUY,3,0.02h,Stop Loss,$73.50,$22.50,$122508.50,191,$22.50
2024-09-25,14:30:00,20227.5,SELL,3,0.02h,Stop Loss,$72.00,$94.50,$122580.50,191,$94.50
2024-09-25,15:09:00,20243.75,BUY,3,0.02h,Break Even,$-1.50,$93.00,$122579.00,191,$93.00
2024-09-25,15:13:00,20222.25,SELL,3,0.02h,Stop Loss,$19.50,$112.50,$122598.50,191,$112.50
2024-09-25,15:39:00,20238.5,BUY,3,0.02h,Stop Loss,$-9.00,$103.50,$122589.50,191,$103.50
2024-09-25,15:47:00,20208.5,SELL,3,0.02h,Break Even,$-1.50,$102.00,$122588.00,191,$102.00
2024-09-25,16:21:00,20207.0,BUY,3,0.02h,Stop Loss,$9.00,$111.00,$122597.00,191,$111.00
2024-09-25,16:44:00,20195.75,SELL,3,0.02h,Break Even,$-1.50,$109.50,$122595.50,191,$109.50
2024-09-25,17:27:00,20181.0,BUY,3,0.02h,Stop Loss,$9.00,$118.50,$122604.50,191,$118.50
2024-09-25,17:36:00,20162.0,SELL,3,0.02h,Break Even,$-1.50,$117.00,$122603.00,191,$117.00
2024-09-25,17:55:00,20186.0,BUY,3,0.02h,Stop Loss,$13.50,$130.50,$122616.50,191,$130.50
2024-09-25,18:13:00,20176.0,SELL,3,0.02h,Break Even,$-1.50,$129.00,$122615.00,191,$129.00
2024-09-25,18:27:00,20185.5,BUY,3,0.02h,Stop Loss,$4.50,$133.50,$122619.50,191,$133.50
2024-09-25,18:58:00,20182.75,SELL,3,0.02h,Stop Loss,$34.50,$168.00,$122654.00,191,$168.00
2024-09-25,19:04:00,20198.5,BUY,3,0.02h,Stop Loss,$-9.00,$159.00,$122645.00,191,$159.00
2024-09-25,19:09:00,20186.75,SELL,3,0.02h,Break Even,$-1.50,$157.50,$122643.50,191,$157.50
2024-09-25,19:38:00,20185.0,BUY,3,0.02h,Break Even,$-1.50,$156.00,$122642.00,191,$156.00
2024-09-25,19:40:00,20179.0,SELL,3,0.02h,Stop Loss,$3.00,$159.00,$122645.00,191,$159.00
2024-09-25,19:49:00,20189.0,BUY,3,0.02h,Break Even,$-1.50,$157.50,$122643.50,191,$157.50
2024-09-25,22:03:00,20232.5,SELL,3,0.02h,Stop Loss,$-9.00,$148.50,$122634.50,191,$148.50
2024-09-25,22:29:00,20237.5,BUY,3,0.02h,Stop Loss,$-9.00,$139.50,$122625.50,191,$139.50
,,,,,,,,,,,
2024-09-26,13:26:00,20508.0,SELL,3,0.02h,Break Even,$-1.50,$-1.50,$122624.00,192,$-1.50
2024-09-26,15:18:00,20274.5,BUY,3,0.02h,Stop Loss,$-9.00,$-10.50,$122615.00,192,$-10.50
2024-09-26,15:19:00,20257.0,SELL,3,0.02h,Stop Loss,$117.00,$106.50,$122732.00,192,$106.50
2024-09-26,15:42:00,20250.0,BUY,3,0.02h,Stop Loss,$40.50,$147.00,$122772.50,192,$147.00
2024-09-26,16:12:00,20277.0,SELL,3,0.02h,Stop Loss,$18.00,$165.00,$122790.50,192,$165.00
2024-09-26,16:54:00,20259.0,BUY,3,0.02h,Stop Loss,$-9.00,$156.00,$122781.50,192,$156.00
2024-09-26,16:55:00,20252.25,SELL,3,0.02h,Stop Loss,$6.00,$162.00,$122787.50,192,$162.00
2024-09-26,17:31:00,20256.5,BUY,3,0.02h,Stop Loss,$52.50,$214.50,$122840.00,192,$214.50
2024-09-26,18:48:00,20326.0,SELL,3,0.02h,Stop Loss,$-9.00,$205.50,$122831.00,192,$205.50
2024-09-26,18:52:00,20334.0,BUY,3,0.02h,Break Even,$-1.50,$204.00,$122829.50,192,$204.00
2024-09-26,19:03:00,20323.25,SELL,3,0.02h,Stop Loss,$-9.00,$195.00,$122820.50,192,$195.00
2024-09-26,19:06:00,20337.75,BUY,3,0.02h,Stop Loss,$-9.00,$186.00,$122811.50,192,$186.00
2024-09-26,19:40:00,20345.75,SELL,3,0.02h,Break Even,$-1.50,$184.50,$122810.00,192,$184.50
2024-09-26,19:50:00,20353.5,BUY,3,0.02h,Break Even,$-1.50,$183.00,$122808.50,192,$183.00
2024-09-26,19:51:00,20346.25,SELL,3,0.02h,Stop Loss,$60.00,$243.00,$122868.50,192,$243.00
2024-09-26,20:08:00,20352.0,BUY,3,0.02h,Break Even,$-1.50,$241.50,$122867.00,192,$241.50
2024-09-26,20:21:00,20344.0,SELL,3,0.02h,Break Even,$-1.50,$240.00,$122865.50,192,$240.00
2024-09-26,20:27:00,20347.0,BUY,3,0.02h,Stop Loss,$-9.00,$231.00,$122856.50,192,$231.00
2024-09-26,20:30:00,20346.25,SELL,3,0.02h,Stop Loss,$-9.00,$222.00,$122847.50,192,$222.00
2024-09-26,20:31:00,20348.0,BUY,3,0.02h,Stop Loss,$-9.00,$213.00,$122838.50,192,$213.00
2024-09-26,20:43:00,20343.25,SELL,3,0.02h,Stop Loss,$-9.00,$204.00,$122829.50,192,$204.00
2024-09-26,22:01:00,20350.0,BUY,3,0.02h,Stop Loss,$4.50,$208.50,$122834.00,192,$208.50
2024-09-26,22:39:00,20368.75,SELL,3,0.02h,Stop Loss,$9.00,$217.50,$122843.00,192,$217.50
2024-09-26,22:46:00,20371.5,BUY,3,0.02h,Break Even,$-1.50,$216.00,$122841.50,192,$216.00
2024-09-26,22:53:00,20367.0,SELL,3,0.02h,Break Even,$-1.50,$214.50,$122840.00,192,$214.50
,,,,,,,,,,,
2024-09-27,12:23:00,20359.25,BUY,3,0.02h,Stop Loss,$-9.00,$-9.00,$122831.00,193,$-9.00
2024-09-27,12:24:00,20356.5,SELL,3,0.02h,Break Even,$-1.50,$-10.50,$122829.50,193,$-10.50
2024-09-27,12:28:00,20359.75,BUY,3,0.02h,Break Even,$-1.50,$-12.00,$122828.00,193,$-12.00
2024-09-27,12:55:00,20361.5,SELL,3,0.02h,Stop Loss,$-9.00,$-21.00,$122819.00,193,$-21.00
2024-09-27,13:05:00,20379.25,BUY,3,0.02h,Stop Loss,$10.50,$-10.50,$122829.50,193,$-10.50
2024-09-27,13:26:00,20373.5,SELL,3,0.02h,Break Even,$-1.50,$-12.00,$122828.00,193,$-12.00
2024-09-27,14:04:00,20370.25,BUY,3,0.02h,Stop Loss,$12.00,$0.00,$122840.00,193,$0.00
2024-09-27,14:06:00,20331.0,SELL,3,0.02h,Break Even,$-1.50,$-1.50,$122838.50,193,$-1.50
2024-09-27,14:42:00,20325.5,BUY,3,0.02h,Stop Loss,$4.50,$3.00,$122843.00,193,$3.00
2024-09-27,14:51:00,20298.5,SELL,3,0.02h,Break Even,$-1.50,$1.50,$122841.50,193,$1.50
2024-09-27,15:43:00,20282.5,BUY,3,0.02h,Break Even,$-1.50,$0.00,$122840.00,193,$0.00
2024-09-27,15:50:00,20253.0,SELL,3,0.02h,Stop Loss,$99.00,$99.00,$122939.00,193,$99.00
2024-09-27,16:28:00,20249.75,BUY,3,0.02h,Stop Loss,$40.50,$139.50,$122979.50,193,$139.50
2024-09-27,17:11:00,20252.75,SELL,3,0.02h,Stop Loss,$10.50,$150.00,$122990.00,193,$150.00
2024-09-27,17:48:00,20243.75,BUY,3,0.02h,Break Even,$-1.50,$148.50,$122988.50,193,$148.50
2024-09-27,18:13:00,20255.25,SELL,3,0.02h,Stop Loss,$13.50,$162.00,$123002.00,193,$162.00
2024-09-27,18:48:00,20229.75,BUY,3,0.02h,Stop Loss,$4.50,$166.50,$123006.50,193,$166.50
2024-09-27,19:24:00,20235.75,SELL,3,0.02h,Stop Loss,$25.50,$192.00,$123032.00,193,$192.00
2024-09-27,19:54:00,20232.25,BUY,3,0.02h,Stop Loss,$45.00,$237.00,$123077.00,193,$237.00
2024-09-27,20:00:00,20223.0,SELL,3,0.02h,Stop Loss,$43.50,$280.50,$123120.50,193,$280.50
2024-09-27,20:34:00,20207.25,BUY,3,0.02h,Stop Loss,$-9.00,$271.50,$123111.50,193,$271.50
2024-09-27,20:38:00,20204.0,SELL,3,0.02h,Stop Loss,$4.50,$276.00,$123116.00,193,$276.00
,,,,,,,,,,,
2024-09-30,12:30:00,20162.25,BUY,3,0.02h,Break Even,$-1.50,$-1.50,$123114.50,194,$-1.50
2024-09-30,12:42:00,20154.0,SELL,3,0.02h,Break Even,$-1.50,$-3.00,$123113.00,194,$-3.00
2024-09-30,12:51:00,20169.0,BUY,3,0.02h,Break Even,$-1.50,$-4.50,$123111.50,194,$-4.50
2024-09-30,13:24:00,20173.25,SELL,3,0.02h,Break Even,$-1.50,$-6.00,$123110.00,194,$-6.00
2024-09-30,13:29:00,20178.75,BUY,3,0.02h,Stop Loss,$4.50,$-1.50,$123114.50,194,$-1.50
2024-09-30,13:59:00,20216.75,SELL,3,0.02h,Stop Loss,$84.00,$82.50,$123198.50,194,$82.50
2024-09-30,14:33:00,20177.75,BUY,3,0.02h,Stop Loss,$88.50,$171.00,$123287.00,194,$171.00
2024-09-30,14:47:00,20177.25,SELL,3,0.02h,Stop Loss,$42.00,$213.00,$123329.00,194,$213.00
2024-09-30,14:51:00,20186.0,BUY,3,0.02h,Stop Loss,$-9.00,$204.00,$123320.00,194,$204.00
2024-09-30,14:52:00,20178.25,SELL,3,0.02h,Break Even,$-1.50,$202.50,$123318.50,194,$202.50
2024-09-30,14:54:00,20186.25,BUY,3,0.02h,Break Even,$-1.50,$201.00,$123317.00,194,$201.00
2024-09-30,14:55:00,20177.5,SELL,3,0.02h,Break Even,$-1.50,$199.50,$123315.50,194,$199.50
2024-09-30,15:02:00,20184.5,BUY,3,0.02h,Stop Loss,$15.00,$214.50,$123330.50,194,$214.50
2024-09-30,15:38:00,20186.0,SELL,3,0.02h,Stop Loss,$13.50,$228.00,$123344.00,194,$228.00
2024-09-30,15:48:00,20217.75,BUY,3,0.02h,Break Even,$-1.50,$226.50,$123342.50,194,$226.50
2024-09-30,16:33:00,20225.75,SELL,3,0.02h,Break Even,$-1.50,$225.00,$123341.00,194,$225.00
2024-09-30,17:53:00,20188.5,BUY,3,0.02h,Stop Loss,$19.50,$244.50,$123360.50,194,$244.50
2024-09-30,18:11:00,20180.75,SELL,3,0.02h,Stop Loss,$27.00,$271.50,$123387.50,194,$271.50
2024-09-30,18:38:00,20146.75,BUY,3,0.02h,Stop Loss,$3.00,$274.50,$123390.50,194,$274.50
2024-09-30,19:02:00,20137.25,SELL,3,0.02h,Stop Loss,$28.50,$303.00,$123419.00,194,$303.00
2024-09-30,19:20:00,20156.5,BUY,3,0.02h,Break Even,$-1.50,$301.50,$123417.50,194,$301.50
2024-09-30,20:42:00,20253.5,SELL,3,0.02h,Stop Loss,$-9.00,$292.50,$123408.50,194,$292.50
2024-09-30,22:29:00,20237.25,BUY,3,0.02h,Stop Loss,$-9.00,$283.50,$123399.50,194,$283.50
2024-09-30,23:00:00,20234.75,SELL,3,13.00h,Stop Loss,$-9.00,$274.50,$123390.50,194,$274.50
,,,,,,,,,,,
2024-10-01,12:00:00,20272.25,BUY,3,0.02h,Break Even,$-1.50,$-1.50,$123389.00,195,$-1.50
2024-10-01,12:32:00,20262.5,SELL,3,0.02h,Stop Loss,$3.00,$1.50,$123392.00,195,$1.50
2024-10-01,12:55:00,20269.75,BUY,3,0.02h,Break Even,$-1.50,$0.00,$123390.50,195,$0.00
2024-10-01,13:16:00,20258.75,SELL,3,0.02h,Break Even,$-1.50,$-1.50,$123389.00,195,$-1.50
2024-10-01,14:43:00,19960.5,BUY,3,0.02h,Stop Loss,$3.00,$1.50,$123392.00,195,$1.50
2024-10-01,14:53:00,19921.0,SELL,3,0.02h,Break Even,$-1.50,$0.00,$123390.50,195,$0.00
2024-10-01,15:30:00,19893.5,BUY,3,0.02h,Stop Loss,$16.50,$16.50,$123407.00,195,$16.50
2024-10-01,16:02:00,19919.5,SELL,3,0.02h,Stop Loss,$13.50,$30.00,$123420.50,195,$30.00
2024-10-01,16:04:00,19955.5,BUY,3,0.02h,Stop Loss,$61.50,$91.50,$123482.00,195,$91.50
2024-10-01,16:27:00,19948.25,SELL,3,0.02h,Stop Loss,$81.00,$172.50,$123563.00,195,$172.50
2024-10-01,16:56:00,19927.5,BUY,3,0.02h,Stop Loss,$21.00,$193.50,$123584.00,195,$193.50
2024-10-01,17:05:00,19894.5,SELL,3,0.02h,Stop Loss,$96.00,$289.50,$123680.00,195,$289.50
2024-10-01,17:33:00,19888.5,BUY,3,0.02h,Stop Loss,$93.00,$382.50,$123773.00,195,$382.50
2024-10-01,18:53:00,20040.0,SELL,3,0.02h,Stop Loss,$43.50,$426.00,$123816.50,195,$426.00
2024-10-01,18:57:00,20061.0,BUY,3,0.02h,Stop Loss,$7.50,$433.50,$123824.00,195,$433.50
2024-10-01,19:06:00,20044.5,SELL,3,0.02h,Break Even,$-1.50,$432.00,$123822.50,195,$432.00
2024-10-01,19:08:00,20053.5,BUY,3,0.02h,Stop Loss,$45.00,$477.00,$123867.50,195,$477.00
2024-10-01,19:13:00,20039.0,SELL,3,0.02h,Stop Loss,$46.50,$523.50,$123914.00,195,$523.50
2024-10-01,20:02:00,20008.75,BUY,3,0.02h,Stop Loss,$30.00,$553.50,$123944.00,195,$553.50
2024-10-01,20:09:00,19983.0,SELL,3,0.02h,Stop Loss,$-9.00,$544.50,$123935.00,195,$544.50
2024-10-01,22:01:00,19980.75,BUY,3,0.02h,Stop Loss,$-9.00,$535.50,$123926.00,195,$535.50
2024-10-01,22:03:00,19952.5,SELL,3,0.02h,Break Even,$-1.50,$534.00,$123924.50,195,$534.00
2024-10-01,22:37:00,19941.25,BUY,3,0.02h,Break Even,$-1.50,$532.50,$123923.00,195,$532.50
2024-10-01,22:45:00,19912.75,SELL,3,0.02h,Stop Loss,$-9.00,$523.50,$123914.00,195,$523.50
,,,,,,,,,,,
2024-10-02,12:01:00,19933.5,BUY,3,0.02h,Stop Loss,$30.00,$30.00,$123944.00,196,$30.00
2024-10-02,12:30:00,19931.5,SELL,3,0.02h,Stop Loss,$-9.00,$21.00,$123935.00,196,$21.00
2024-10-02,12:36:00,19954.25,BUY,3,0.02h,Stop Loss,$33.00,$54.00,$123968.00,196,$54.00
2024-10-02,13:01:00,19963.75,SELL,3,0.02h,Stop Loss,$36.00,$90.00,$124004.00,196,$90.00
2024-10-02,13:56:00,19922.75,BUY,3,0.02h,Break Even,$-1.50,$88.50,$124002.50,196,$88.50
2024-10-02,14:57:00,20002.25,SELL,3,0.02h,Stop Loss,$7.50,$96.00,$124010.00,196,$96.00
2024-10-02,15:04:00,20033.25,BUY,3,0.02h,Stop Loss,$40.50,$136.50,$124050.50,196,$136.50
2024-10-02,15:55:00,20046.0,SELL,3,0.02h,Stop Loss,$27.00,$163.50,$124077.50,196,$163.50
2024-10-02,16:02:00,20062.25,BUY,3,0.02h,Stop Loss,$58.50,$222.00,$124136.00,196,$222.00
2024-10-02,16:20:00,20047.5,SELL,3,0.02h,Stop Loss,$52.50,$274.50,$124188.50,196,$274.50
2024-10-02,16:27:00,20075.25,BUY,3,0.02h,Break Even,$-1.50,$273.00,$124187.00,196,$273.00
2024-10-02,16:32:00,20049.25,SELL,3,0.02h,Break Even,$-1.50,$271.50,$124185.50,196,$271.50
2024-10-02,17:29:00,20018.5,BUY,3,0.02h,Break Even,$-1.50,$270.00,$124184.00,196,$270.00
2024-10-02,17:35:00,19976.25,SELL,3,0.02h,Stop Loss,$28.50,$298.50,$124212.50,196,$298.50
2024-10-02,17:39:00,20005.75,BUY,3,0.02h,Stop Loss,$15.00,$313.50,$124227.50,196,$313.50
2024-10-02,18:25:00,20036.0,SELL,3,0.02h,Break Even,$-1.50,$312.00,$124226.00,196,$312.00
2024-10-02,19:05:00,20028.75,BUY,3,0.02h,Break Even,$-1.50,$310.50,$124224.50,196,$310.50
2024-10-02,19:41:00,20024.75,SELL,3,0.02h,Stop Loss,$-9.00,$301.50,$124215.50,196,$301.50
2024-10-02,19:45:00,20043.75,BUY,3,0.02h,Stop Loss,$25.50,$327.00,$124241.00,196,$327.00
2024-10-02,19:55:00,20030.75,SELL,3,0.02h,Stop Loss,$30.00,$357.00,$124271.00,196,$357.00
2024-10-02,20:11:00,20035.5,BUY,3,0.02h,Stop Loss,$3.00,$360.00,$124274.00,196,$360.00
2024-10-02,22:02:00,20049.0,SELL,3,0.02h,Stop Loss,$40.50,$400.50,$124314.50,196,$400.50
2024-10-02,22:10:00,20067.75,BUY,3,0.02h,Stop Loss,$-9.00,$391.50,$124305.50,196,$391.50
2024-10-02,22:16:00,20055.5,SELL,3,0.02h,Break Even,$-1.50,$390.00,$124304.00,196,$390.00
,,,,,,,,,,,
2024-10-03,12:34:00,19982.75,BUY,3,0.02h,Stop Loss,$-9.00,$-9.00,$124295.00,197,$-9.00
2024-10-03,12:35:00,19964.25,SELL,3,0.02h,Stop Loss,$94.50,$85.50,$124389.50,197,$85.50
2024-10-03,13:33:00,19940.5,BUY,3,0.02h,Stop Loss,$109.50,$195.00,$124499.00,197,$195.00
2024-10-03,14:20:00,20028.25,SELL,3,0.02h,Stop Loss,$69.00,$264.00,$124568.00,197,$264.00
2024-10-03,14:52:00,20019.5,BUY,3,0.02h,Stop Loss,$9.00,$273.00,$124577.00,197,$273.00
2024-10-03,15:00:00,19939.75,SELL,3,0.02h,Stop Loss,$19.50,$292.50,$124596.50,197,$292.50
2024-10-03,15:17:00,19983.0,BUY,3,0.02h,Break Even,$-1.50,$291.00,$124595.00,197,$291.00
2024-10-03,16:07:00,20030.0,SELL,3,0.02h,Stop Loss,$48.00,$339.00,$124643.00,197,$339.00
2024-10-03,16:11:00,20042.75,BUY,3,0.02h,Break Even,$-1.50,$337.50,$124641.50,197,$337.50
2024-10-03,16:17:00,20032.25,SELL,3,0.02h,Stop Loss,$22.50,$360.00,$124664.00,197,$360.00
2024-10-03,16:23:00,20047.5,BUY,3,0.02h,Stop Loss,$-9.00,$351.00,$124655.00,197,$351.00
2024-10-03,16:31:00,20014.0,SELL,3,0.02h,Stop Loss,$9.00,$360.00,$124664.00,197,$360.00
2024-10-03,17:22:00,19936.75,BUY,3,0.02h,Stop Loss,$42.00,$402.00,$124706.00,197,$402.00
2024-10-03,17:43:00,19937.75,SELL,3,0.02h,Break Even,$-1.50,$400.50,$124704.50,197,$400.50
2024-10-03,17:46:00,19960.25,BUY,3,0.02h,Stop Loss,$4.50,$405.00,$124709.00,197,$405.00
2024-10-03,17:51:00,19941.5,SELL,3,0.02h,Break Even,$-1.50,$403.50,$124707.50,197,$403.50
2024-10-03,17:55:00,19956.25,BUY,3,0.02h,Stop Loss,$34.50,$438.00,$124742.00,197,$438.00
2024-10-03,18:18:00,19955.75,SELL,3,0.02h,Break Even,$-1.50,$436.50,$124740.50,197,$436.50
2024-10-03,18:20:00,19965.75,BUY,3,0.02h,Break Even,$-1.50,$435.00,$124739.00,197,$435.00
2024-10-03,18:23:00,19933.75,SELL,3,0.02h,Break Even,$-1.50,$433.50,$124737.50,197,$433.50
2024-10-03,18:41:00,19956.5,BUY,3,0.02h,Stop Loss,$28.50,$462.00,$124766.00,197,$462.00
2024-10-03,18:58:00,19948.5,SELL,3,0.02h,Stop Loss,$10.50,$472.50,$124776.50,197,$472.50
2024-10-03,19:25:00,19940.0,BUY,3,0.02h,Break Even,$-1.50,$471.00,$124775.00,197,$471.00
2024-10-03,19:29:00,19918.0,SELL,3,0.02h,Stop Loss,$-9.00,$462.00,$124766.00,197,$462.00
2024-10-03,19:35:00,19944.25,BUY,3,0.02h,Stop Loss,$9.00,$471.00,$124775.00,197,$471.00
2024-10-03,20:26:00,19983.5,SELL,3,0.02h,Break Even,$-1.50,$469.50,$124773.50,197,$469.50
2024-10-03,22:29:00,19955.75,BUY,3,0.02h,Stop Loss,$-9.00,$460.50,$124764.50,197,$460.50
,,,,,,,,,,,
2024-10-04,13:25:00,20225.0,SELL,3,0.02h,Break Even,$-1.50,$-1.50,$124763.00,198,$-1.50
2024-10-04,14:44:00,20079.25,BUY,3,0.02h,Stop Loss,$79.50,$78.00,$124842.50,198,$78.00
2024-10-04,15:16:00,20099.0,SELL,3,0.02h,Break Even,$-1.50,$76.50,$124841.00,198,$76.50
2024-10-04,15:53:00,20088.0,BUY,3,0.02h,Stop Loss,$67.50,$144.00,$124908.50,198,$144.00
2024-10-04,16:14:00,20100.25,SELL,3,0.02h,Stop Loss,$28.50,$172.50,$124937.00,198,$172.50
2024-10-04,16:34:00,20111.75,BUY,3,0.02h,Stop Loss,$-9.00,$163.50,$124928.00,198,$163.50
2024-10-04,17:03:00,20142.75,SELL,3,0.02h,Stop Loss,$-9.00,$154.50,$124919.00,198,$154.50
2024-10-04,17:16:00,20156.5,BUY,3,0.02h,Stop Loss,$39.00,$193.50,$124958.00,198,$193.50
2024-10-04,17:30:00,20145.0,SELL,3,0.02h,Stop Loss,$15.00,$208.50,$124973.00,198,$208.50
2024-10-04,17:45:00,20168.0,BUY,3,0.02h,Stop Loss,$-9.00,$199.50,$124964.00,198,$199.50
2024-10-04,17:54:00,20130.0,SELL,3,0.02h,Stop Loss,$22.50,$222.00,$124986.50,198,$222.00
2024-10-04,18:23:00,20141.75,BUY,3,0.02h,Stop Loss,$-9.00,$213.00,$124977.50,198,$213.00
2024-10-04,20:17:00,20214.0,SELL,3,0.02h,Stop Loss,$-9.00,$204.00,$124968.50,198,$204.00
,,,,,,,,,,,
2024-10-07,12:38:00,20136.0,BUY,3,0.02h,Stop Loss,$-9.00,$-9.00,$124959.50,199,$-9.00
2024-10-07,12:55:00,20132.25,SELL,3,0.02h,Stop Loss,$16.50,$7.50,$124976.00,199,$7.50
2024-10-07,13:09:00,20142.5,BUY,3,0.02h,Stop Loss,$-9.00,$-1.50,$124967.00,199,$-1.50
2024-10-07,13:44:00,20118.75,SELL,3,0.02h,Stop Loss,$48.00,$46.50,$125015.00,199,$46.50
2024-10-07,14:06:00,20142.5,BUY,3,0.02h,Stop Loss,$-9.00,$37.50,$125006.00,199,$37.50
2024-10-07,14:45:00,20147.75,SELL,3,0.02h,Stop Loss,$13.50,$51.00,$125019.50,199,$51.00
2024-10-07,14:57:00,20165.25,BUY,3,0.02h,Stop Loss,$37.50,$88.50,$125057.00,199,$88.50
2024-10-07,15:02:00,20142.75,SELL,3,0.02h,Stop Loss,$79.50,$168.00,$125136.50,199,$168.00
2024-10-07,15:15:00,20158.75,BUY,3,0.02h,Break Even,$-1.50,$166.50,$125135.00,199,$166.50
2024-10-07,15:39:00,20148.5,SELL,3,0.02h,Break Even,$-1.50,$165.00,$125133.50,199,$165.00
2024-10-07,15:41:00,20168.0,BUY,3,0.02h,Break Even,$-1.50,$163.50,$125132.00,199,$163.50
2024-10-07,15:44:00,20149.25,SELL,3,0.02h,Break Even,$-1.50,$162.00,$125130.50,199,$162.00
2024-10-07,16:18:00,20159.5,BUY,3,0.02h,Break Even,$-1.50,$160.50,$125129.00,199,$160.50
2024-10-07,16:33:00,20137.0,SELL,3,0.02h,Break Even,$-1.50,$159.00,$125127.50,199,$159.00
2024-10-07,17:03:00,20150.25,BUY,3,0.02h,Stop Loss,$6.00,$165.00,$125133.50,199,$165.00
2024-10-07,17:24:00,20132.75,SELL,3,0.02h,Stop Loss,$-9.00,$156.00,$125124.50,199,$156.00
2024-10-07,17:57:00,20134.25,BUY,3,0.02h,Stop Loss,$12.00,$168.00,$125136.50,199,$168.00
2024-10-07,18:03:00,20121.5,SELL,3,0.02h,Stop Loss,$15.00,$183.00,$125151.50,199,$183.00
2024-10-07,19:23:00,20015.75,BUY,3,0.02h,Stop Loss,$7.50,$190.50,$125159.00,199,$190.50
2024-10-07,19:29:00,19994.75,SELL,3,0.02h,Stop Loss,$13.50,$204.00,$125172.50,199,$204.00
2024-10-07,19:52:00,20008.75,BUY,3,0.02h,Stop Loss,$16.50,$220.50,$125189.00,199,$220.50
2024-10-07,20:56:00,20018.5,SELL,3,0.02h,Break Even,$-1.50,$219.00,$125187.50,199,$219.00
2024-10-07,22:02:00,20029.0,BUY,3,0.02h,Break Even,$-1.50,$217.50,$125186.00,199,$217.50
2024-10-07,22:05:00,20017.5,SELL,3,0.02h,Stop Loss,$30.00,$247.50,$125216.00,199,$247.50
,,,,,,,,,,,
2024-10-08,12:00:00,20094.0,BUY,3,0.02h,Stop Loss,$7.50,$7.50,$125223.50,200,$7.50
2024-10-08,12:42:00,20061.75,SELL,3,0.02h,Stop Loss,$-9.00,$-1.50,$125214.50,200,$-1.50
2024-10-08,13:05:00,20067.0,BUY,3,0.02h,Break Even,$-1.50,$-3.00,$125213.00,200,$-3.00
2024-10-08,13:06:00,20064.0,SELL,3,0.02h,Stop Loss,$7.50,$4.50,$125220.50,200,$4.50
2024-10-08,13:10:00,20072.0,BUY,3,0.02h,Stop Loss,$10.50,$15.00,$125231.00,200,$15.00
2024-10-08,15:12:00,20228.25,SELL,3,0.02h,Stop Loss,$13.50,$28.50,$125244.50,200,$28.50
2024-10-08,15:42:00,20235.5,BUY,3,0.02h,Stop Loss,$12.00,$40.50,$125256.50,200,$40.50
2024-10-08,16:04:00,20230.25,SELL,3,0.02h,Stop Loss,$33.00,$73.50,$125289.50,200,$73.50
2024-10-08,16:23:00,20233.5,BUY,3,0.02h,Break Even,$-1.50,$72.00,$125288.00,200,$72.00
2024-10-08,16:25:00,20224.0,SELL,3,0.02h,Stop Loss,$-9.00,$63.00,$125279.00,200,$63.00
2024-10-08,16:28:00,20238.5,BUY,3,0.02h,Break Even,$-1.50,$61.50,$125277.50,200,$61.50
2024-10-08,16:50:00,20222.75,SELL,3,0.02h,Stop Loss,$16.50,$78.00,$125294.00,200,$78.00
2024-10-08,17:01:00,20234.5,BUY,3,0.02h,Stop Loss,$-9.00,$69.00,$125285.00,200,$69.00
2024-10-08,17:02:00,20230.75,SELL,3,0.02h,Stop Loss,$9.00,$78.00,$125294.00,200,$78.00
2024-10-08,17:35:00,20207.75,BUY,3,0.02h,Stop Loss,$37.50,$115.50,$125331.50,200,$115.50
2024-10-08,18:32:00,20228.0,SELL,3,0.02h,Stop Loss,$7.50,$123.00,$125339.00,200,$123.00
2024-10-08,18:36:00,20242.0,BUY,3,0.02h,Break Even,$-1.50,$121.50,$125337.50,200,$121.50
2024-10-08,20:01:00,20286.5,SELL,3,0.02h,Stop Loss,$18.00,$139.50,$125355.50,200,$139.50
2024-10-08,20:38:00,20292.5,BUY,3,0.02h,Break Even,$-1.50,$138.00,$125354.00,200,$138.00
2024-10-08,20:56:00,20280.5,SELL,3,0.02h,Stop Loss,$-9.00,$129.00,$125345.00,200,$129.00
2024-10-08,22:26:00,20286.25,BUY,3,0.02h,Stop Loss,$-9.00,$120.00,$125336.00,200,$120.00
2024-10-08,22:27:00,20284.25,SELL,3,0.03h,Break Even,$-1.50,$118.50,$125334.50,200,$118.50
2024-10-08,22:56:00,20284.5,BUY,3,0.02h,Stop Loss,$36.00,$154.50,$125370.50,200,$154.50
,,,,,,,,,,,
2024-10-09,12:00:00,20257.25,SELL,3,0.02h,Break Even,$-1.50,$-1.50,$125369.00,201,$-1.50
2024-10-09,12:30:00,20271.75,BUY,3,0.02h,Stop Loss,$-9.00,$-10.50,$125360.00,201,$-10.50
2024-10-09,12:45:00,20264.5,SELL,3,0.02h,Stop Loss,$18.00,$7.50,$125378.00,201,$7.50
2024-10-09,12:57:00,20272.75,BUY,3,0.02h,Break Even,$-1.50,$6.00,$125376.50,201,$6.00
2024-10-09,13:31:00,20284.25,SELL,3,0.02h,Stop Loss,$96.00,$102.00,$125472.50,201,$102.00
2024-10-09,14:02:00,20271.25,BUY,3,0.02h,Stop Loss,$12.00,$114.00,$125484.50,201,$114.00
2024-10-09,14:48:00,20321.5,SELL,3,0.02h,Break Even,$-1.50,$112.50,$125483.00,201,$112.50
2024-10-09,14:58:00,20347.75,BUY,3,0.02h,Stop Loss,$4.50,$117.00,$125487.50,201,$117.00
2024-10-09,16:06:00,20403.5,SELL,3,0.02h,Break Even,$-1.50,$115.50,$125486.00,201,$115.50
2024-10-09,16:31:00,20409.0,BUY,3,0.02h,Stop Loss,$24.00,$139.50,$125510.00,201,$139.50
2024-10-09,16:53:00,20403.75,SELL,3,0.02h,Stop Loss,$42.00,$181.50,$125552.00,201,$181.50
2024-10-09,17:14:00,20407.0,BUY,3,0.02h,Break Even,$-1.50,$180.00,$125550.50,201,$180.00
2024-10-09,17:52:00,20411.5,SELL,3,0.02h,Stop Loss,$90.00,$270.00,$125640.50,201,$270.00
2024-10-09,18:08:00,20410.5,BUY,3,0.02h,Break Even,$-1.50,$268.50,$125639.00,201,$268.50
2024-10-09,18:12:00,20400.0,SELL,3,0.02h,Stop Loss,$9.00,$277.50,$125648.00,201,$277.50
2024-10-09,18:15:00,20410.75,BUY,3,0.02h,Stop Loss,$-9.00,$268.50,$125639.00,201,$268.50
2024-10-09,18:17:00,20401.5,SELL,3,0.02h,Break Even,$-1.50,$267.00,$125637.50,201,$267.00
2024-10-09,18:25:00,20413.25,BUY,3,0.02h,Stop Loss,$67.50,$334.50,$125705.00,201,$334.50
2024-10-09,19:01:00,20427.75,SELL,3,0.02h,Stop Loss,$19.50,$354.00,$125724.50,201,$354.00
2024-10-09,19:06:00,20441.25,BUY,3,0.02h,Stop Loss,$-9.00,$345.00,$125715.50,201,$345.00
2024-10-09,19:08:00,20420.5,SELL,3,0.02h,Stop Loss,$30.00,$375.00,$125745.50,201,$375.00
2024-10-09,19:19:00,20435.0,BUY,3,0.02h,Stop Loss,$3.00,$378.00,$125748.50,201,$378.00
2024-10-09,20:03:00,20441.25,SELL,3,0.02h,Stop Loss,$10.50,$388.50,$125759.00,201,$388.50
2024-10-09,20:38:00,20436.75,BUY,3,0.02h,Stop Loss,$-9.00,$379.50,$125750.00,201,$379.50
2024-10-09,22:09:00,20437.0,SELL,3,0.02h,Stop Loss,$-9.00,$370.50,$125741.00,201,$370.50
2024-10-09,22:13:00,20440.0,BUY,3,0.02h,Break Even,$-1.50,$369.00,$125739.50,201,$369.00
2024-10-09,22:15:00,20437.0,SELL,3,0.02h,Stop Loss,$-9.00,$360.00,$125730.50,201,$360.00
2024-10-09,22:17:00,20441.0,BUY,3,0.02h,Break Even,$-1.50,$358.50,$125729.00,201,$358.50
,,,,,,,,,,,
2024-10-10,12:00:00,20437.25,SELL,3,0.02h,Break Even,$-1.50,$-1.50,$125727.50,202,$-1.50
2024-10-10,12:09:00,20450.75,BUY,3,0.02h,Break Even,$-1.50,$-3.00,$125726.00,202,$-3.00
2024-10-10,12:16:00,20444.75,SELL,3,0.02h,Break Even,$-1.50,$-4.50,$125724.50,202,$-4.50
2024-10-10,13:05:00,20380.25,BUY,3,0.02h,Break Even,$-1.50,$-6.00,$125723.00,202,$-6.00
2024-10-10,13:10:00,20362.5,SELL,3,0.02h,Stop Loss,$24.00,$18.00,$125747.00,202,$18.00
2024-10-10,13:32:00,20380.25,BUY,3,0.02h,Stop Loss,$31.50,$49.50,$125778.50,202,$49.50
2024-10-10,13:48:00,20331.75,SELL,3,0.02h,Stop Loss,$91.50,$141.00,$125870.00,202,$141.00
2024-10-10,13:58:00,20371.25,BUY,3,0.02h,Stop Loss,$37.50,$178.50,$125907.50,202,$178.50
2024-10-10,14:26:00,20381.0,SELL,3,0.02h,Break Even,$-1.50,$177.00,$125906.00,202,$177.00
2024-10-10,14:27:00,20391.75,BUY,3,0.02h,Stop Loss,$90.00,$267.00,$125996.00,202,$267.00
2024-10-10,14:35:00,20380.0,SELL,3,0.02h,Stop Loss,$15.00,$282.00,$126011.00,202,$282.00
2024-10-10,14:44:00,20410.0,BUY,3,0.02h,Stop Loss,$30.00,$312.00,$126041.00,202,$312.00
2024-10-10,14:54:00,20377.25,SELL,3,0.02h,Stop Loss,$16.50,$328.50,$126057.50,202,$328.50
2024-10-10,15:08:00,20403.25,BUY,3,0.02h,Stop Loss,$43.50,$372.00,$126101.00,202,$372.00
2024-10-10,16:28:00,20478.75,SELL,3,0.02h,Stop Loss,$52.50,$424.50,$126153.50,202,$424.50
2024-10-10,17:21:00,20455.75,BUY,3,0.02h,Stop Loss,$19.50,$444.00,$126173.00,202,$444.00
2024-10-10,17:47:00,20446.5,SELL,3,0.02h,Stop Loss,$81.00,$525.00,$126254.00,202,$525.00
2024-10-10,18:50:00,20411.0,BUY,3,0.02h,Stop Loss,$-9.00,$516.00,$126245.00,202,$516.00
2024-10-10,18:51:00,20402.5,SELL,3,0.02h,Stop Loss,$-9.00,$507.00,$126236.00,202,$507.00
2024-10-10,18:53:00,20410.25,BUY,3,0.02h,Break Even,$-1.50,$505.50,$126234.50,202,$505.50
2024-10-10,19:05:00,20401.5,SELL,3,0.02h,Stop Loss,$33.00,$538.50,$126267.50,202,$538.50
2024-10-10,19:20:00,20413.5,BUY,3,0.02h,Stop Loss,$6.00,$544.50,$126273.50,202,$544.50
2024-10-10,19:37:00,20404.5,SELL,3,0.02h,Stop Loss,$25.50,$570.00,$126299.00,202,$570.00
2024-10-10,19:48:00,20416.5,BUY,3,0.02h,Break Even,$-1.50,$568.50,$126297.50,202,$568.50
2024-10-10,20:10:00,20420.0,SELL,3,0.02h,Stop Loss,$-9.00,$559.50,$126288.50,202,$559.50
2024-10-10,20:17:00,20430.0,BUY,3,0.02h,Stop Loss,$-9.00,$550.50,$126279.50,202,$550.50
2024-10-10,22:01:00,20432.0,SELL,3,0.02h,Stop Loss,$4.50,$555.00,$126284.00,202,$555.00
2024-10-10,22:24:00,20433.0,BUY,3,0.02h,Stop Loss,$-9.00,$546.00,$126275.00,202,$546.00
2024-10-10,22:39:00,20430.5,SELL,3,0.02h,Break Even,$-1.50,$544.50,$126273.50,202,$544.50
2024-10-10,22:40:00,20433.75,BUY,3,0.02h,Break Even,$-1.50,$543.00,$126272.00,202,$543.00
2024-10-10,22:56:00,20433.0,SELL,3,0.02h,Stop Loss,$-9.00,$534.00,$126263.00,202,$534.00
,,,,,,,,,,,
2024-10-11,12:32:00,20408.25,BUY,3,0.02h,Stop Loss,$12.00,$12.00,$126275.00,203,$12.00
2024-10-11,12:39:00,20383.75,SELL,3,0.02h,Stop Loss,$52.50,$64.50,$126327.50,203,$64.50
2024-10-11,13:48:00,20354.5,BUY,3,0.02h,Break Even,$-1.50,$63.00,$126326.00,203,$63.00
2024-10-11,14:46:00,20434.25,SELL,3,0.02h,Stop Loss,$-9.00,$54.00,$126317.00,203,$54.00
2024-10-11,15:04:00,20441.5,BUY,3,0.02h,Stop Loss,$45.00,$99.00,$126362.00,203,$99.00
2024-10-11,15:19:00,20423.5,SELL,3,0.02h,Stop Loss,$63.00,$162.00,$126425.00,203,$162.00
2024-10-11,15:34:00,20442.75,BUY,3,0.02h,Stop Loss,$21.00,$183.00,$126446.00,203,$183.00
2024-10-11,16:16:00,20452.75,SELL,3,0.02h,Stop Loss,$12.00,$195.00,$126458.00,203,$195.00
2024-10-11,16:59:00,20439.5,BUY,3,0.02h,Break Even,$-1.50,$193.50,$126456.50,203,$193.50
2024-10-11,17:14:00,20424.25,SELL,3,0.02h,Stop Loss,$-9.00,$184.50,$126447.50,203,$184.50
2024-10-11,17:25:00,20437.75,BUY,3,0.02h,Stop Loss,$7.50,$192.00,$126455.00,203,$192.00
2024-10-11,18:01:00,20437.5,SELL,3,0.02h,Break Even,$-1.50,$190.50,$126453.50,203,$190.50
2024-10-11,18:06:00,20444.5,BUY,3,0.02h,Break Even,$-1.50,$189.00,$126452.00,203,$189.00
2024-10-11,18:37:00,20454.0,SELL,3,0.02h,Stop Loss,$3.00,$192.00,$126455.00,203,$192.00
2024-10-11,18:49:00,20459.0,BUY,3,0.02h,Break Even,$-1.50,$190.50,$126453.50,203,$190.50
2024-10-11,19:38:00,20473.5,SELL,3,0.02h,Stop Loss,$10.50,$201.00,$126464.00,203,$201.00
,,,,,,,,,,,
2024-10-14,12:00:00,20506.75,BUY,3,0.02h,Break Even,$-1.50,$-1.50,$126462.50,204,$-1.50
2024-10-14,13:30:00,20550.5,SELL,3,0.02h,Stop Loss,$37.50,$36.00,$126500.00,204,$36.00
2024-10-14,13:32:00,20557.0,BUY,3,0.02h,Stop Loss,$81.00,$117.00,$126581.00,204,$117.00
2024-10-14,14:14:00,20627.75,SELL,3,0.02h,Stop Loss,$9.00,$126.00,$126590.00,204,$126.00
2024-10-14,14:29:00,20638.25,BUY,3,0.02h,Stop Loss,$19.50,$145.50,$126609.50,204,$145.50
2024-10-14,14:46:00,20627.0,SELL,3,0.02h,Stop Loss,$3.00,$148.50,$126612.50,204,$148.50
2024-10-14,15:22:00,20578.5,BUY,3,0.02h,Stop Loss,$30.00,$178.50,$126642.50,204,$178.50
2024-10-14,15:26:00,20561.0,SELL,3,0.02h,Stop Loss,$58.50,$237.00,$126701.00,204,$237.00
2024-10-14,15:48:00,20568.0,BUY,3,0.02h,Stop Loss,$9.00,$246.00,$126710.00,204,$246.00
2024-10-14,16:58:00,20601.25,SELL,3,0.02h,Stop Loss,$-9.00,$237.00,$126701.00,204,$237.00
2024-10-14,17:04:00,20618.5,BUY,3,0.02h,Stop Loss,$6.00,$243.00,$126707.00,204,$243.00
2024-10-14,17:11:00,20606.75,SELL,3,0.02h,Stop Loss,$24.00,$267.00,$126731.00,204,$267.00
2024-10-14,17:27:00,20611.5,BUY,3,0.02h,Stop Loss,$-9.00,$258.00,$126722.00,204,$258.00
2024-10-14,17:34:00,20600.0,SELL,3,0.02h,Stop Loss,$13.50,$271.50,$126735.50,204,$271.50
2024-10-14,17:39:00,20612.5,BUY,3,0.02h,Break Even,$-1.50,$270.00,$126734.00,204,$270.00
2024-10-14,18:01:00,20603.0,SELL,3,0.02h,Break Even,$-1.50,$268.50,$126732.50,204,$268.50
2024-10-14,18:06:00,20611.0,BUY,3,0.02h,Break Even,$-1.50,$267.00,$126731.00,204,$267.00
2024-10-14,19:01:00,20620.0,SELL,3,0.02h,Stop Loss,$4.50,$271.50,$126735.50,204,$271.50
2024-10-14,19:15:00,20627.25,BUY,3,0.02h,Stop Loss,$13.50,$285.00,$126749.00,204,$285.00
2024-10-14,19:55:00,20633.5,SELL,3,0.02h,Stop Loss,$30.00,$315.00,$126779.00,204,$315.00
2024-10-14,20:44:00,20627.5,BUY,3,0.02h,Stop Loss,$-9.00,$306.00,$126770.00,204,$306.00
2024-10-14,22:12:00,20625.0,SELL,3,0.03h,Break Even,$-1.50,$304.50,$126768.50,204,$304.50
2024-10-14,22:29:00,20631.0,BUY,3,0.02h,Stop Loss,$-9.00,$295.50,$126759.50,204,$295.50
2024-10-14,22:36:00,20624.75,SELL,3,0.02h,Break Even,$-1.50,$294.00,$126758.00,204,$294.00
2024-10-14,22:59:00,20625.5,BUY,3,13.02h,Stop Loss,$-9.00,$285.00,$126749.00,204,$285.00
,,,,,,,,,,,
2024-10-15,12:00:00,20613.0,SELL,3,0.02h,Stop Loss,$6.00,$6.00,$126755.00,205,$6.00
2024-10-15,12:19:00,20628.5,BUY,3,0.02h,Break Even,$-1.50,$4.50,$126753.50,205,$4.50
2024-10-15,12:27:00,20614.5,SELL,3,0.02h,Break Even,$-1.50,$3.00,$126752.00,205,$3.00
2024-10-15,12:53:00,20616.75,BUY,3,0.02h,Stop Loss,$7.50,$10.50,$126759.50,205,$10.50
2024-10-15,13:30:00,20631.25,SELL,3,0.02h,Stop Loss,$132.00,$142.50,$126891.50,205,$142.50
2024-10-15,13:55:00,20639.75,BUY,3,0.02h,Stop Loss,$82.50,$225.00,$126974.00,205,$225.00
2024-10-15,14:10:00,20621.25,SELL,3,0.02h,Stop Loss,$94.50,$319.50,$127068.50,205,$319.50
2024-10-15,15:16:00,20436.0,BUY,3,0.02h,Stop Loss,$22.50,$342.00,$127091.00,205,$342.00
2024-10-15,15:26:00,20402.75,SELL,3,0.02h,Stop Loss,$9.00,$351.00,$127100.00,205,$351.00
2024-10-15,15:34:00,20422.75,BUY,3,0.02h,Stop Loss,$43.50,$394.50,$127143.50,205,$394.50
2024-10-15,15:40:00,20400.0,SELL,3,0.02h,Stop Loss,$36.00,$430.50,$127179.50,205,$430.50
2024-10-15,16:11:00,20390.5,BUY,3,0.02h,Stop Loss,$4.50,$435.00,$127184.00,205,$435.00
2024-10-15,16:46:00,20391.5,SELL,3,0.02h,Stop Loss,$52.50,$487.50,$127236.50,205,$487.50
2024-10-15,17:41:00,20373.0,BUY,3,0.02h,Break Even,$-1.50,$486.00,$127235.00,205,$486.00
2024-10-15,17:58:00,20356.25,SELL,3,0.02h,Stop Loss,$-9.00,$477.00,$127226.00,205,$477.00
2024-10-15,18:04:00,20385.25,BUY,3,0.02h,Break Even,$-1.50,$475.50,$127224.50,205,$475.50
2024-10-15,18:10:00,20364.75,SELL,3,0.02h,Stop Loss,$3.00,$478.50,$127227.50,205,$478.50
2024-10-15,18:22:00,20378.75,BUY,3,0.02h,Break Even,$-1.50,$477.00,$127226.00,205,$477.00
2024-10-15,18:34:00,20363.0,SELL,3,0.02h,Stop Loss,$12.00,$489.00,$127238.00,205,$489.00
2024-10-15,19:43:00,20306.75,BUY,3,0.02h,Break Even,$-1.50,$487.50,$127236.50,205,$487.50
2024-10-15,20:18:00,20321.75,SELL,3,0.02h,Stop Loss,$-9.00,$478.50,$127227.50,205,$478.50
2024-10-15,20:25:00,20336.5,BUY,3,0.02h,Break Even,$-1.50,$477.00,$127226.00,205,$477.00
2024-10-15,20:47:00,20332.5,SELL,3,0.02h,Stop Loss,$-9.00,$468.00,$127217.00,205,$468.00
2024-10-15,20:49:00,20336.5,BUY,3,0.02h,Break Even,$-1.50,$466.50,$127215.50,205,$466.50
2024-10-15,20:57:00,20333.75,SELL,3,0.02h,Break Even,$-1.50,$465.00,$127214.00,205,$465.00
2024-10-15,22:22:00,20329.25,BUY,3,0.02h,Stop Loss,$-9.00,$456.00,$127205.00,205,$456.00
,,,,,,,,,,,
2024-10-16,12:21:00,20354.75,SELL,3,0.02h,Break Even,$-1.50,$-1.50,$127203.50,206,$-1.50
2024-10-16,12:53:00,20359.75,BUY,3,0.02h,Break Even,$-1.50,$-3.00,$127202.00,206,$-3.00
2024-10-16,13:00:00,20351.25,SELL,3,0.02h,Break Even,$-1.50,$-4.50,$127200.50,206,$-4.50
2024-10-16,13:01:00,20355.5,BUY,3,0.02h,Break Even,$-1.50,$-6.00,$127199.00,206,$-6.00
2024-10-16,13:23:00,20355.5,SELL,3,0.02h,Break Even,$-1.50,$-7.50,$127197.50,206,$-7.50
2024-10-16,14:09:00,20265.5,BUY,3,0.02h,Stop Loss,$108.00,$100.50,$127305.50,206,$100.50
2024-10-16,14:40:00,20280.0,SELL,3,0.02h,Stop Loss,$60.00,$160.50,$127365.50,206,$160.50
2024-10-16,15:12:00,20297.0,BUY,3,0.02h,Stop Loss,$34.50,$195.00,$127400.00,206,$195.00
2024-10-16,15:47:00,20294.5,SELL,3,0.02h,Stop Loss,$34.50,$229.50,$127434.50,206,$229.50
2024-10-16,16:11:00,20298.75,BUY,3,0.02h,Break Even,$-1.50,$228.00,$127433.00,206,$228.00
2024-10-16,16:14:00,20279.75,SELL,3,0.02h,Break Even,$-1.50,$226.50,$127431.50,206,$226.50
2024-10-16,16:24:00,20296.0,BUY,3,0.02h,Stop Loss,$3.00,$229.50,$127434.50,206,$229.50
2024-10-16,17:19:00,20313.0,SELL,3,0.02h,Stop Loss,$18.00,$247.50,$127452.50,206,$247.50
2024-10-16,17:35:00,20326.0,BUY,3,0.02h,Break Even,$-1.50,$246.00,$127451.00,206,$246.00
2024-10-16,17:41:00,20311.25,SELL,3,0.02h,Break Even,$-1.50,$244.50,$127449.50,206,$244.50
2024-10-16,17:44:00,20326.25,BUY,3,0.02h,Stop Loss,$13.50,$258.00,$127463.00,206,$258.00
2024-10-16,18:08:00,20323.75,SELL,3,0.02h,Stop Loss,$12.00,$270.00,$127475.00,206,$270.00
2024-10-16,18:11:00,20336.25,BUY,3,0.02h,Break Even,$-1.50,$268.50,$127473.50,206,$268.50
2024-10-16,19:02:00,20356.75,SELL,3,0.02h,Stop Loss,$10.50,$279.00,$127484.00,206,$279.00
2024-10-16,19:12:00,20364.25,BUY,3,0.02h,Stop Loss,$-9.00,$270.00,$127475.00,206,$270.00
2024-10-16,19:13:00,20358.0,SELL,3,0.02h,Break Even,$-1.50,$268.50,$127473.50,206,$268.50
2024-10-16,19:17:00,20361.75,BUY,3,0.02h,Break Even,$-1.50,$267.00,$127472.00,206,$267.00
2024-10-16,19:18:00,20358.5,SELL,3,0.02h,Break Even,$-1.50,$265.50,$127470.50,206,$265.50
2024-10-16,20:32:00,20339.0,BUY,3,0.02h,Break Even,$-1.50,$264.00,$127469.00,206,$264.00
2024-10-16,20:50:00,20333.25,SELL,3,0.02h,Stop Loss,$-9.00,$255.00,$127460.00,206,$255.00
2024-10-16,22:31:00,20328.5,BUY,3,0.02h,Stop Loss,$-9.00,$246.00,$127451.00,206,$246.00
2024-10-16,22:37:00,20323.75,SELL,3,0.02h,Stop Loss,$-9.00,$237.00,$127442.00,206,$237.00
2024-10-16,22:47:00,20328.5,BUY,3,0.02h,Break Even,$-1.50,$235.50,$127440.50,206,$235.50
,,,,,,,,,,,
2024-10-17,13:31:00,20548.0,SELL,3,0.02h,Stop Loss,$30.00,$30.00,$127470.50,207,$30.00
2024-10-17,14:21:00,20444.5,BUY,3,0.02h,Stop Loss,$12.00,$42.00,$127482.50,207,$42.00
2024-10-17,14:38:00,20414.25,SELL,3,0.02h,Stop Loss,$60.00,$102.00,$127542.50,207,$102.00
2024-10-17,15:10:00,20424.0,BUY,3,0.02h,Stop Loss,$22.50,$124.50,$127565.00,207,$124.50
2024-10-17,16:23:00,20487.75,SELL,3,0.02h,Break Even,$-1.50,$123.00,$127563.50,207,$123.00
2024-10-17,16:45:00,20488.25,BUY,3,0.02h,Stop Loss,$-9.00,$114.00,$127554.50,207,$114.00
2024-10-17,16:54:00,20471.75,SELL,3,0.02h,Stop Loss,$-9.00,$105.00,$127545.50,207,$105.00
2024-10-17,16:56:00,20486.25,BUY,3,0.02h,Stop Loss,$-9.00,$96.00,$127536.50,207,$96.00
2024-10-17,16:58:00,20474.25,SELL,3,0.02h,Stop Loss,$90.00,$186.00,$127626.50,207,$186.00
2024-10-17,17:05:00,20489.5,BUY,3,0.02h,Stop Loss,$-9.00,$177.00,$127617.50,207,$177.00
2024-10-17,17:20:00,20475.5,SELL,3,0.02h,Break Even,$-1.50,$175.50,$127616.00,207,$175.50
2024-10-17,17:40:00,20478.0,BUY,3,0.02h,Break Even,$-1.50,$174.00,$127614.50,207,$174.00
2024-10-17,17:57:00,20476.75,SELL,3,0.02h,Stop Loss,$19.50,$193.50,$127634.00,207,$193.50
2024-10-17,18:48:00,20413.25,BUY,3,0.02h,Stop Loss,$-9.00,$184.50,$127625.00,207,$184.50
2024-10-17,19:21:00,20409.0,SELL,3,0.02h,Stop Loss,$40.50,$225.00,$127665.50,207,$225.00
2024-10-17,20:02:00,20383.75,BUY,3,0.02h,Stop Loss,$30.00,$255.00,$127695.50,207,$255.00
2024-10-17,20:03:00,20372.75,SELL,3,0.02h,Break Even,$-1.50,$253.50,$127694.00,207,$253.50
2024-10-17,20:04:00,20379.25,BUY,3,0.02h,Stop Loss,$6.00,$259.50,$127700.00,207,$259.50
2024-10-17,20:28:00,20388.75,SELL,3,0.02h,Stop Loss,$-9.00,$250.50,$127691.00,207,$250.50
2024-10-17,22:02:00,20388.0,BUY,3,0.02h,Stop Loss,$-9.00,$241.50,$127682.00,207,$241.50
2024-10-17,22:03:00,20385.25,SELL,3,0.02h,Stop Loss,$25.50,$267.00,$127707.50,207,$267.00
2024-10-17,22:14:00,20386.0,BUY,3,0.02h,Break Even,$-1.50,$265.50,$127706.00,207,$265.50
,,,,,,,,,,,
2024-10-18,13:27:00,20462.0,SELL,3,0.02h,Break Even,$-1.50,$-1.50,$127704.50,208,$-1.50
2024-10-18,13:44:00,20489.25,BUY,3,0.02h,Stop Loss,$57.00,$55.50,$127761.50,208,$55.50
2024-10-18,13:51:00,20463.0,SELL,3,0.02h,Stop Loss,$42.00,$97.50,$127803.50,208,$97.50
2024-10-18,13:56:00,20485.0,BUY,3,0.02h,Stop Loss,$3.00,$100.50,$127806.50,208,$100.50
2024-10-18,14:20:00,20487.5,SELL,3,0.02h,Stop Loss,$3.00,$103.50,$127809.50,208,$103.50
2024-10-18,14:22:00,20492.75,BUY,3,0.02h,Break Even,$-1.50,$102.00,$127808.00,208,$102.00
2024-10-18,14:23:00,20487.5,SELL,3,0.02h,Stop Loss,$40.50,$142.50,$127848.50,208,$142.50
2024-10-18,14:25:00,20492.5,BUY,3,0.02h,Stop Loss,$3.00,$145.50,$127851.50,208,$145.50
2024-10-18,14:26:00,20487.0,SELL,3,0.02h,Break Even,$-1.50,$144.00,$127850.00,208,$144.00
2024-10-18,14:27:00,20492.0,BUY,3,0.02h,Stop Loss,$-9.00,$135.00,$127841.00,208,$135.00
2024-10-18,14:28:00,20480.0,SELL,3,0.02h,Stop Loss,$15.00,$150.00,$127856.00,208,$150.00
2024-10-18,14:30:00,20499.5,BUY,3,0.02h,Stop Loss,$22.50,$172.50,$127878.50,208,$172.50
2024-10-18,14:37:00,20475.75,SELL,3,0.02h,Stop Loss,$10.50,$183.00,$127889.00,208,$183.00
2024-10-18,14:43:00,20494.25,BUY,3,0.02h,Break Even,$-1.50,$181.50,$127887.50,208,$181.50
2024-10-18,14:53:00,20481.75,SELL,3,0.02h,Stop Loss,$21.00,$202.50,$127908.50,208,$202.50
2024-10-18,15:07:00,20487.5,BUY,3,0.02h,Stop Loss,$10.50,$213.00,$127919.00,208,$213.00
2024-10-18,15:39:00,20491.5,SELL,3,0.02h,Stop Loss,$-9.00,$204.00,$127910.00,208,$204.00
2024-10-18,16:33:00,20468.0,BUY,3,0.02h,Stop Loss,$19.50,$223.50,$127929.50,208,$223.50
2024-10-18,17:27:00,20500.75,SELL,3,0.02h,Stop Loss,$58.50,$282.00,$127988.00,208,$282.00
2024-10-18,17:47:00,20503.0,BUY,3,0.02h,Stop Loss,$-9.00,$273.00,$127979.00,208,$273.00
2024-10-18,17:51:00,20494.5,SELL,3,0.02h,Break Even,$-1.50,$271.50,$127977.50,208,$271.50
2024-10-18,18:13:00,20495.75,BUY,3,0.02h,Break Even,$-1.50,$270.00,$127976.00,208,$270.00
2024-10-18,18:38:00,20495.0,SELL,3,0.02h,Stop Loss,$15.00,$285.00,$127991.00,208,$285.00
2024-10-18,19:28:00,20490.5,BUY,3,0.02h,Stop Loss,$12.00,$297.00,$128003.00,208,$297.00
2024-10-18,19:35:00,20481.0,SELL,3,0.02h,Stop Loss,$9.00,$306.00,$128012.00,208,$306.00
2024-10-18,19:38:00,20489.25,BUY,3,0.02h,Stop Loss,$-9.00,$297.00,$128003.00,208,$297.00
2024-10-18,19:39:00,20481.0,SELL,3,0.02h,Break Even,$-1.50,$295.50,$128001.50,208,$295.50
2024-10-18,19:58:00,20488.5,BUY,3,0.02h,Stop Loss,$-9.00,$286.50,$127992.50,208,$286.50
2024-10-18,20:30:00,20489.75,SELL,3,0.02h,Break Even,$-1.50,$285.00,$127991.00,208,$285.00
2024-10-18,20:32:00,20491.0,BUY,3,0.03h,Break Even,$-1.50,$283.50,$127989.50,208,$283.50
2024-10-18,20:35:00,20488.0,SELL,3,0.02h,Stop Loss,$-9.00,$274.50,$127980.50,208,$274.50
2024-10-18,20:40:00,20492.25,BUY,3,0.02h,Stop Loss,$-9.00,$265.50,$127971.50,208,$265.50
2024-10-18,20:49:00,20489.5,SELL,3,0.02h,Break Even,$-1.50,$264.00,$127970.00,208,$264.00
,,,,,,,,,,,
2024-10-21,12:31:00,20390.75,BUY,3,0.02h,Break Even,$-1.50,$-1.50,$127968.50,209,$-1.50
2024-10-21,12:41:00,20388.0,SELL,3,0.02h,Stop Loss,$-9.00,$-10.50,$127959.50,209,$-10.50
2024-10-21,12:42:00,20392.25,BUY,3,0.02h,Stop Loss,$-9.00,$-19.50,$127950.50,209,$-19.50
2024-10-21,12:43:00,20385.25,SELL,3,0.02h,Stop Loss,$-9.00,$-28.50,$127941.50,209,$-28.50
2024-10-21,12:46:00,20396.25,BUY,3,0.02h,Stop Loss,$-9.00,$-37.50,$127932.50,209,$-37.50
2024-10-21,14:29:00,20507.0,SELL,3,0.02h,Stop Loss,$15.00,$-22.50,$127947.50,209,$-22.50
2024-10-21,15:39:00,20379.75,BUY,3,0.02h,Stop Loss,$117.00,$94.50,$128064.50,209,$94.50
2024-10-21,16:29:00,20441.0,SELL,3,0.02h,Stop Loss,$-9.00,$85.50,$128055.50,209,$85.50
2024-10-21,16:35:00,20453.0,BUY,3,0.02h,Break Even,$-1.50,$84.00,$128054.00,209,$84.00
2024-10-21,16:36:00,20444.0,SELL,3,0.02h,Stop Loss,$30.00,$114.00,$128084.00,209,$114.00
2024-10-21,16:50:00,20445.5,BUY,3,0.02h,Stop Loss,$6.00,$120.00,$128090.00,209,$120.00
2024-10-21,17:23:00,20463.75,SELL,3,0.02h,Stop Loss,$-9.00,$111.00,$128081.00,209,$111.00
2024-10-21,17:28:00,20474.0,BUY,3,0.02h,Stop Loss,$-9.00,$102.00,$128072.00,209,$102.00
2024-10-21,18:07:00,20478.25,SELL,3,0.02h,Stop Loss,$10.50,$112.50,$128082.50,209,$112.50
2024-10-21,18:17:00,20491.75,BUY,3,0.02h,Break Even,$-1.50,$111.00,$128081.00,209,$111.00
2024-10-21,18:21:00,20480.5,SELL,3,0.02h,Stop Loss,$10.50,$121.50,$128091.50,209,$121.50
2024-10-21,19:11:00,20470.25,BUY,3,0.02h,Stop Loss,$-9.00,$112.50,$128082.50,209,$112.50
2024-10-21,19:32:00,20469.75,SELL,3,0.02h,Stop Loss,$4.50,$117.00,$128087.00,209,$117.00
2024-10-21,19:47:00,20481.75,BUY,3,0.02h,Stop Loss,$-9.00,$108.00,$128078.00,209,$108.00
2024-10-21,20:55:00,20536.75,SELL,3,0.02h,Stop Loss,$-9.00,$99.00,$128069.00,209,$99.00
2024-10-21,20:59:00,20543.75,BUY,3,0.02h,Stop Loss,$-9.00,$90.00,$128060.00,209,$90.00
2024-10-21,22:01:00,20536.75,SELL,3,0.02h,Stop Loss,$13.50,$103.50,$128073.50,209,$103.50
2024-10-21,22:16:00,20539.0,BUY,3,0.02h,Stop Loss,$-9.00,$94.50,$128064.50,209,$94.50
2024-10-21,22:17:00,20531.75,SELL,3,0.02h,Break Even,$-1.50,$93.00,$128063.00,209,$93.00
,,,,,,,,,,,
2024-10-22,13:15:00,20391.75,BUY,3,0.02h,Break Even,$-1.50,$-1.50,$128061.50,210,$-1.50
2024-10-22,14:40:00,20482.25,SELL,3,0.02h,Stop Loss,$-9.00,$-10.50,$128052.50,210,$-10.50
2024-10-22,14:56:00,20492.0,BUY,3,0.02h,Break Even,$-1.50,$-12.00,$128051.00,210,$-12.00
2024-10-22,15:12:00,20479.0,SELL,3,0.02h,Stop Loss,$7.50,$-4.50,$128058.50,210,$-4.50
2024-10-22,15:33:00,20486.25,BUY,3,0.02h,Break Even,$-1.50,$-6.00,$128057.00,210,$-6.00
2024-10-22,15:51:00,20474.75,SELL,3,0.02h,Stop Loss,$25.50,$19.50,$128082.50,210,$19.50
2024-10-22,15:56:00,20490.25,BUY,3,0.02h,Stop Loss,$-9.00,$10.50,$128073.50,210,$10.50
2024-10-22,16:00:00,20472.75,SELL,3,0.02h,Stop Loss,$30.00,$40.50,$128103.50,210,$40.50
2024-10-22,16:50:00,20463.25,BUY,3,0.02h,Stop Loss,$61.50,$102.00,$128165.00,210,$102.00
2024-10-22,18:14:00,20549.5,SELL,3,0.02h,Stop Loss,$7.50,$109.50,$128172.50,210,$109.50
2024-10-22,19:12:00,20543.25,BUY,3,0.02h,Break Even,$-1.50,$108.00,$128171.00,210,$108.00
2024-10-22,19:43:00,20544.25,SELL,3,0.02h,Break Even,$-1.50,$106.50,$128169.50,210,$106.50
2024-10-22,19:44:00,20548.25,BUY,3,0.02h,Break Even,$-1.50,$105.00,$128168.00,210,$105.00
2024-10-22,20:01:00,20524.25,SELL,3,0.02h,Stop Loss,$81.00,$186.00,$128249.00,210,$186.00
2024-10-22,20:36:00,20527.25,BUY,3,0.02h,Break Even,$-1.50,$184.50,$128247.50,210,$184.50
2024-10-22,20:46:00,20518.25,SELL,3,0.02h,Stop Loss,$-9.00,$175.50,$128238.50,210,$175.50
2024-10-22,20:50:00,20527.25,BUY,3,0.02h,Stop Loss,$-9.00,$166.50,$128229.50,210,$166.50
2024-10-22,20:51:00,20521.25,SELL,3,0.02h,Stop Loss,$-9.00,$157.50,$128220.50,210,$157.50
2024-10-22,20:52:00,20525.25,BUY,3,0.02h,Break Even,$-1.50,$156.00,$128219.00,210,$156.00
2024-10-22,21:00:00,20517.5,SELL,3,1.02h,Stop Loss,$69.00,$225.00,$128288.00,210,$225.00
2024-10-22,22:34:00,20508.25,BUY,3,0.02h,Stop Loss,$-9.00,$216.00,$128279.00,210,$216.00
2024-10-22,22:40:00,20502.5,SELL,3,0.02h,Stop Loss,$-9.00,$207.00,$128270.00,210,$207.00
2024-10-22,22:47:00,20505.75,BUY,3,0.05h,Stop Loss,$-9.00,$198.00,$128261.00,210,$198.00
2024-10-22,22:51:00,20503.25,SELL,3,0.02h,Stop Loss,$-9.00,$189.00,$128252.00,210,$189.00
,,,,,,,,,,,
2024-10-23,12:20:00,20493.75,BUY,3,0.02h,Stop Loss,$-9.00,$-9.00,$128243.00,211,$-9.00
2024-10-23,12:34:00,20469.5,SELL,3,0.02h,Stop Loss,$16.50,$7.50,$128259.50,211,$7.50
2024-10-23,13:42:00,20436.75,BUY,3,0.02h,Stop Loss,$25.50,$33.00,$128285.00,211,$33.00
2024-10-23,13:45:00,20427.0,SELL,3,0.02h,Stop Loss,$43.50,$76.50,$128328.50,211,$76.50
2024-10-23,13:49:00,20442.25,BUY,3,0.02h,Stop Loss,$-9.00,$67.50,$128319.50,211,$67.50
2024-10-23,13:51:00,20423.5,SELL,3,0.02h,Stop Loss,$55.50,$123.00,$128375.00,211,$123.00
2024-10-23,13:57:00,20440.5,BUY,3,0.02h,Stop Loss,$21.00,$144.00,$128396.00,211,$144.00
2024-10-23,14:01:00,20418.75,SELL,3,0.02h,Stop Loss,$91.50,$235.50,$128487.50,211,$235.50
2024-10-23,14:30:00,20418.25,BUY,3,0.02h,Stop Loss,$34.50,$270.00,$128522.00,211,$270.00
2024-10-23,14:55:00,20407.75,SELL,3,0.02h,Stop Loss,$40.50,$310.50,$128562.50,211,$310.50
2024-10-23,15:46:00,20348.0,BUY,3,0.02h,Stop Loss,$4.50,$315.00,$128567.00,211,$315.00
2024-10-23,16:04:00,20296.0,SELL,3,0.02h,Stop Loss,$12.00,$327.00,$128579.00,211,$327.00
2024-10-23,16:49:00,20273.75,BUY,3,0.02h,Stop Loss,$19.50,$346.50,$128598.50,211,$346.50
2024-10-23,16:52:00,20256.5,SELL,3,0.02h,Stop Loss,$30.00,$376.50,$128628.50,211,$376.50
2024-10-23,18:26:00,20128.0,BUY,3,0.02h,Stop Loss,$27.00,$403.50,$128655.50,211,$403.50
2024-10-23,19:11:00,20166.25,SELL,3,0.02h,Stop Loss,$54.00,$457.50,$128709.50,211,$457.50
2024-10-23,19:19:00,20174.0,BUY,3,0.02h,Stop Loss,$27.00,$484.50,$128736.50,211,$484.50
2024-10-23,20:48:00,20278.0,SELL,3,0.02h,Stop Loss,$-9.00,$475.50,$128727.50,211,$475.50
2024-10-23,20:50:00,20283.25,BUY,3,0.02h,Stop Loss,$-9.00,$466.50,$128718.50,211,$466.50
2024-10-23,20:51:00,20281.0,SELL,3,0.02h,Stop Loss,$-9.00,$457.50,$128709.50,211,$457.50
2024-10-23,20:53:00,20286.25,BUY,3,0.03h,Break Even,$-1.50,$456.00,$128708.00,211,$456.00
2024-10-23,20:56:00,20278.0,SELL,3,0.02h,Stop Loss,$19.50,$475.50,$128727.50,211,$475.50
2024-10-23,22:02:00,20293.5,BUY,3,0.02h,Break Even,$-1.50,$474.00,$128726.00,211,$474.00
2024-10-23,22:18:00,20281.5,SELL,3,0.02h,Stop Loss,$-9.00,$465.00,$128717.00,211,$465.00
2024-10-23,22:26:00,20290.25,BUY,3,0.02h,Stop Loss,$-9.00,$456.00,$128708.00,211,$456.00
2024-10-23,22:32:00,20276.25,SELL,3,0.02h,Stop Loss,$-9.00,$447.00,$128699.00,211,$447.00
2024-10-23,22:58:00,20286.75,BUY,3,0.02h,Break Even,$-1.50,$445.50,$128697.50,211,$445.50
,,,,,,,,,,,
2024-10-24,12:48:00,20398.0,SELL,3,0.02h,Stop Loss,$-9.00,$-9.00,$128688.50,212,$-9.00
2024-10-24,13:14:00,20402.5,BUY,3,0.02h,Break Even,$-1.50,$-10.50,$128687.00,212,$-10.50
2024-10-24,13:22:00,20392.75,SELL,3,0.02h,Stop Loss,$7.50,$-3.00,$128694.50,212,$-3.00
2024-10-24,14:02:00,20351.0,BUY,3,0.02h,Stop Loss,$150.00,$147.00,$128844.50,212,$147.00
2024-10-24,14:23:00,20335.25,SELL,3,0.02h,Break Even,$-1.50,$145.50,$128843.00,212,$145.50
2024-10-24,14:25:00,20357.5,BUY,3,0.02h,Break Even,$-1.50,$144.00,$128841.50,212,$144.00
2024-10-24,14:27:00,20330.0,SELL,3,0.02h,Stop Loss,$93.00,$237.00,$128934.50,212,$237.00
2024-10-24,14:34:00,20355.25,BUY,3,0.02h,Stop Loss,$39.00,$276.00,$128973.50,212,$276.00
2024-10-24,14:49:00,20340.5,SELL,3,0.02h,Stop Loss,$34.50,$310.50,$129008.00,212,$310.50
2024-10-24,15:12:00,20340.75,BUY,3,0.02h,Break Even,$-1.50,$309.00,$129006.50,212,$309.00
2024-10-24,15:30:00,20340.25,SELL,3,0.02h,Break Even,$-1.50,$307.50,$129005.00,212,$307.50
2024-10-24,15:32:00,20347.0,BUY,3,0.02h,Break Even,$-1.50,$306.00,$129003.50,212,$306.00
2024-10-24,15:33:00,20341.25,SELL,3,0.02h,Stop Loss,$18.00,$324.00,$129021.50,212,$324.00
2024-10-24,16:00:00,20327.75,BUY,3,0.02h,Stop Loss,$51.00,$375.00,$129072.50,212,$375.00
2024-10-24,16:07:00,20291.5,SELL,3,0.02h,Stop Loss,$48.00,$423.00,$129120.50,212,$423.00
2024-10-24,16:25:00,20307.0,BUY,3,0.02h,Stop Loss,$16.50,$439.50,$129137.00,212,$439.50
2024-10-24,17:23:00,20362.5,SELL,3,0.02h,Stop Loss,$12.00,$451.50,$129149.00,212,$451.50
2024-10-24,17:39:00,20369.75,BUY,3,0.02h,Break Even,$-1.50,$450.00,$129147.50,212,$450.00
2024-10-24,17:52:00,20355.75,SELL,3,0.02h,Stop Loss,$3.00,$453.00,$129150.50,212,$453.00
2024-10-24,18:13:00,20364.75,BUY,3,0.02h,Stop Loss,$9.00,$462.00,$129159.50,212,$462.00
2024-10-24,18:31:00,20364.0,SELL,3,0.02h,Break Even,$-1.50,$460.50,$129158.00,212,$460.50
2024-10-24,18:51:00,20364.0,BUY,3,0.02h,Stop Loss,$12.00,$472.50,$129170.00,212,$472.50
2024-10-24,19:02:00,20349.0,SELL,3,0.02h,Break Even,$-1.50,$471.00,$129168.50,212,$471.00
2024-10-24,19:10:00,20368.0,BUY,3,0.02h,Stop Loss,$12.00,$483.00,$129180.50,212,$483.00
2024-10-24,19:44:00,20379.5,SELL,3,0.02h,Stop Loss,$-9.00,$474.00,$129171.50,212,$474.00
2024-10-24,19:48:00,20396.0,BUY,3,0.02h,Stop Loss,$7.50,$481.50,$129179.00,212,$481.50
2024-10-24,19:54:00,20385.0,SELL,3,0.02h,Break Even,$-1.50,$480.00,$129177.50,212,$480.00
2024-10-24,19:55:00,20397.75,BUY,3,0.02h,Break Even,$-1.50,$478.50,$129176.00,212,$478.50
2024-10-24,19:59:00,20384.5,SELL,3,0.02h,Stop Loss,$37.50,$516.00,$129213.50,212,$516.00
2024-10-24,20:03:00,20391.5,BUY,3,0.02h,Stop Loss,$6.00,$522.00,$129219.50,212,$522.00
2024-10-24,20:23:00,20394.0,SELL,3,0.02h,Stop Loss,$-9.00,$513.00,$129210.50,212,$513.00
2024-10-24,21:00:00,20391.0,BUY,3,1.02h,Stop Loss,$24.00,$537.00,$129234.50,212,$537.00
2024-10-24,22:05:00,20381.5,SELL,3,0.02h,Break Even,$-1.50,$535.50,$129233.00,212,$535.50
2024-10-24,22:17:00,20384.75,BUY,3,0.02h,Stop Loss,$-9.00,$526.50,$129224.00,212,$526.50
2024-10-24,22:34:00,20378.5,SELL,3,0.02h,Break Even,$-1.50,$525.00,$129222.50,212,$525.00
2024-10-24,22:59:00,20380.75,BUY,3,0.02h,Stop Loss,$-9.00,$516.00,$129213.50,212,$516.00
,,,,,,,,,,,
2024-10-25,13:30:00,20491.25,SELL,3,0.02h,Stop Loss,$-9.00,$-9.00,$129204.50,213,$-9.00
2024-10-25,13:31:00,20519.25,BUY,3,0.02h,Stop Loss,$81.00,$72.00,$129285.50,213,$72.00
2024-10-25,14:44:00,20665.75,SELL,3,0.02h,Stop Loss,$75.00,$147.00,$129360.50,213,$147.00
2024-10-25,15:06:00,20666.25,BUY,3,0.02h,Stop Loss,$43.50,$190.50,$129404.00,213,$190.50
2024-10-25,15:12:00,20645.75,SELL,3,0.02h,Break Even,$-1.50,$189.00,$129402.50,213,$189.00
2024-10-25,15:16:00,20666.0,BUY,3,0.02h,Break Even,$-1.50,$187.50,$129401.00,213,$187.50
2024-10-25,15:27:00,20646.0,SELL,3,0.02h,Stop Loss,$3.00,$190.50,$129404.00,213,$190.50
2024-10-25,16:07:00,20634.75,BUY,3,0.02h,Break Even,$-1.50,$189.00,$129402.50,213,$189.00
2024-10-25,16:50:00,20641.25,SELL,3,0.02h,Stop Loss,$-9.00,$180.00,$129393.50,213,$180.00
2024-10-25,16:54:00,20653.75,BUY,3,0.02h,Stop Loss,$-9.00,$171.00,$129384.50,213,$171.00
2024-10-25,16:57:00,20643.5,SELL,3,0.02h,Stop Loss,$9.00,$180.00,$129393.50,213,$180.00
2024-10-25,17:54:00,20554.25,BUY,3,0.02h,Break Even,$-1.50,$178.50,$129392.00,213,$178.50
2024-10-25,17:56:00,20533.25,SELL,3,0.02h,Break Even,$-1.50,$177.00,$129390.50,213,$177.00
2024-10-25,18:26:00,20514.25,BUY,3,0.02h,Stop Loss,$16.50,$193.50,$129407.00,213,$193.50
2024-10-25,19:05:00,20533.0,SELL,3,0.02h,Stop Loss,$22.50,$216.00,$129429.50,213,$216.00
2024-10-25,19:38:00,20524.5,BUY,3,0.02h,Stop Loss,$6.00,$222.00,$129435.50,213,$222.00
2024-10-25,19:44:00,20515.75,SELL,3,0.02h,Break Even,$-1.50,$220.50,$129434.00,213,$220.50
2024-10-25,19:47:00,20524.0,BUY,3,0.02h,Stop Loss,$-9.00,$211.50,$129425.00,213,$211.50
2024-10-25,19:51:00,20510.5,SELL,3,0.02h,Break Even,$-1.50,$210.00,$129423.50,213,$210.00
,,,,,,,,,,,
2024-10-28,12:00:00,20618.5,BUY,3,0.02h,Stop Loss,$15.00,$15.00,$129438.50,214,$15.00
2024-10-28,13:12:00,20642.25,SELL,3,0.02h,Stop Loss,$3.00,$18.00,$129441.50,214,$18.00
2024-10-28,14:08:00,20567.5,BUY,3,0.02h,Stop Loss,$88.50,$106.50,$129530.00,214,$106.50
2024-10-28,14:37:00,20583.0,SELL,3,0.02h,Stop Loss,$12.00,$118.50,$129542.00,214,$118.50
2024-10-28,14:38:00,20589.25,BUY,3,0.02h,Break Even,$-1.50,$117.00,$129540.50,214,$117.00
2024-10-28,14:39:00,20583.75,SELL,3,0.02h,Stop Loss,$-9.00,$108.00,$129531.50,214,$108.00
2024-10-28,14:40:00,20595.25,BUY,3,0.02h,Stop Loss,$22.50,$130.50,$129554.00,214,$130.50
2024-10-28,14:57:00,20589.0,SELL,3,0.02h,Stop Loss,$33.00,$163.50,$129587.00,214,$163.50
2024-10-28,16:11:00,20548.25,BUY,3,0.02h,Break Even,$-1.50,$162.00,$129585.50,214,$162.00
2024-10-28,16:35:00,20537.75,SELL,3,0.02h,Stop Loss,$34.50,$196.50,$129620.00,214,$196.50
2024-10-28,16:46:00,20554.25,BUY,3,0.02h,Break Even,$-1.50,$195.00,$129618.50,214,$195.00
2024-10-28,16:49:00,20535.75,SELL,3,0.02h,Break Even,$-1.50,$193.50,$129617.00,214,$193.50
2024-10-28,17:09:00,20547.25,BUY,3,0.02h,Stop Loss,$-9.00,$184.50,$129608.00,214,$184.50
2024-10-28,17:12:00,20534.5,SELL,3,0.02h,Stop Loss,$75.00,$259.50,$129683.00,214,$259.50
2024-10-28,17:21:00,20549.0,BUY,3,0.02h,Stop Loss,$6.00,$265.50,$129689.00,214,$265.50
2024-10-28,17:51:00,20541.0,SELL,3,0.02h,Stop Loss,$-9.00,$256.50,$129680.00,214,$256.50
2024-10-28,17:52:00,20550.0,BUY,3,0.02h,Stop Loss,$16.50,$273.00,$129696.50,214,$273.00
2024-10-28,18:04:00,20544.25,SELL,3,0.02h,Stop Loss,$-9.00,$264.00,$129687.50,214,$264.00
2024-10-28,18:07:00,20554.25,BUY,3,0.02h,Break Even,$-1.50,$262.50,$129686.00,214,$262.50
2024-10-28,18:14:00,20541.0,SELL,3,0.02h,Break Even,$-1.50,$261.00,$129684.50,214,$261.00
2024-10-28,18:54:00,20541.5,BUY,3,0.02h,Stop Loss,$16.50,$277.50,$129701.00,214,$277.50
2024-10-28,19:05:00,20526.25,SELL,3,0.02h,Stop Loss,$22.50,$300.00,$129723.50,214,$300.00
2024-10-28,19:28:00,20526.5,BUY,3,0.02h,Break Even,$-1.50,$298.50,$129722.00,214,$298.50
2024-10-28,19:44:00,20520.5,SELL,3,0.02h,Break Even,$-1.50,$297.00,$129720.50,214,$297.00
2024-10-28,20:23:00,20508.25,BUY,3,0.02h,Break Even,$-1.50,$295.50,$129719.00,214,$295.50
2024-10-28,20:52:00,20511.75,SELL,3,0.03h,Break Even,$-1.50,$294.00,$129717.50,214,$294.00
2024-10-28,22:40:00,20499.0,BUY,3,0.02h,Stop Loss,$-9.00,$285.00,$129708.50,214,$285.00
2024-10-28,22:47:00,20495.0,SELL,3,0.02h,Stop Loss,$-9.00,$276.00,$129699.50,214,$276.00
,,,,,,,,,,,
2024-10-29,12:20:00,20493.0,BUY,3,0.02h,Stop Loss,$-9.00,$-9.00,$129690.50,215,$-9.00
2024-10-29,12:21:00,20483.5,SELL,3,0.02h,Break Even,$-1.50,$-10.50,$129689.00,215,$-10.50
2024-10-29,12:30:00,20493.75,BUY,3,0.02h,Break Even,$-1.50,$-12.00,$129687.50,215,$-12.00
2024-10-29,12:51:00,20490.5,SELL,3,0.02h,Break Even,$-1.50,$-13.50,$129686.00,215,$-13.50
2024-10-29,12:53:00,20500.0,BUY,3,0.02h,Break Even,$-1.50,$-15.00,$129684.50,215,$-15.00
2024-10-29,13:00:00,20489.0,SELL,3,0.02h,Break Even,$-1.50,$-16.50,$129683.00,215,$-16.50
2024-10-29,13:06:00,20496.5,BUY,3,0.02h,Stop Loss,$10.50,$-6.00,$129693.50,215,$-6.00
2024-10-29,13:15:00,20491.75,SELL,3,0.02h,Break Even,$-1.50,$-7.50,$129692.00,215,$-7.50
2024-10-29,13:29:00,20510.25,BUY,3,0.02h,Break Even,$-1.50,$-9.00,$129690.50,215,$-9.00
2024-10-29,13:32:00,20479.5,SELL,3,0.02h,Stop Loss,$187.50,$178.50,$129878.00,215,$178.50
2024-10-29,13:46:00,20509.75,BUY,3,0.02h,Stop Loss,$22.50,$201.00,$129900.50,215,$201.00
2024-10-29,15:11:00,20582.5,SELL,3,0.02h,Stop Loss,$10.50,$211.50,$129911.00,215,$211.50
2024-10-29,15:16:00,20596.75,BUY,3,0.02h,Stop Loss,$79.50,$291.00,$129990.50,215,$291.00
2024-10-29,15:36:00,20585.25,SELL,3,0.02h,Stop Loss,$6.00,$297.00,$129996.50,215,$297.00
2024-10-29,15:39:00,20604.25,BUY,3,0.02h,Stop Loss,$-9.00,$288.00,$129987.50,215,$288.00
2024-10-29,16:30:00,20614.75,SELL,3,0.02h,Stop Loss,$-9.00,$279.00,$129978.50,215,$279.00
2024-10-29,16:43:00,20628.5,BUY,3,0.02h,Stop Loss,$30.00,$309.00,$130008.50,215,$309.00
2024-10-29,17:28:00,20659.0,SELL,3,0.02h,Stop Loss,$-9.00,$300.00,$129999.50,215,$300.00
2024-10-29,17:35:00,20676.75,BUY,3,0.02h,Stop Loss,$9.00,$309.00,$130008.50,215,$309.00
2024-10-29,17:44:00,20661.5,SELL,3,0.02h,Stop Loss,$12.00,$321.00,$130020.50,215,$321.00
2024-10-29,17:51:00,20679.5,BUY,3,0.02h,Stop Loss,$-9.00,$312.00,$130011.50,215,$312.00
2024-10-29,18:06:00,20666.0,SELL,3,0.02h,Break Even,$-1.50,$310.50,$130010.00,215,$310.50
2024-10-29,18:20:00,20680.75,BUY,3,0.02h,Break Even,$-1.50,$309.00,$130008.50,215,$309.00
2024-10-29,18:57:00,20695.5,SELL,3,0.02h,Break Even,$-1.50,$307.50,$130007.00,215,$307.50
2024-10-29,19:07:00,20703.0,BUY,3,0.02h,Stop Loss,$4.50,$312.00,$130011.50,215,$312.00
2024-10-29,19:42:00,20721.5,SELL,3,0.02h,Stop Loss,$-9.00,$303.00,$130002.50,215,$303.00
2024-10-29,19:45:00,20734.5,BUY,3,0.02h,Stop Loss,$24.00,$327.00,$130026.50,215,$327.00
2024-10-29,19:52:00,20720.25,SELL,3,0.02h,Break Even,$-1.50,$325.50,$130025.00,215,$325.50
2024-10-29,20:07:00,20731.0,BUY,3,0.02h,Stop Loss,$21.00,$346.50,$130046.00,215,$346.50
2024-10-29,20:19:00,20708.0,SELL,3,0.02h,Stop Loss,$16.50,$363.00,$130062.50,215,$363.00
2024-10-29,20:54:00,20717.25,BUY,3,0.02h,Stop Loss,$-9.00,$354.00,$130053.50,215,$354.00
2024-10-29,20:59:00,20706.0,SELL,3,0.02h,Break Even,$-1.50,$352.50,$130052.00,215,$352.50
2024-10-29,22:01:00,20721.0,BUY,3,0.02h,Stop Loss,$4.50,$357.00,$130056.50,215,$357.00
,,,,,,,,,,,
2024-10-30,12:00:00,20714.5,SELL,3,0.02h,Stop Loss,$-9.00,$-9.00,$130047.50,216,$-9.00
2024-10-30,12:39:00,20712.75,BUY,3,0.02h,Stop Loss,$3.00,$-6.00,$130050.50,216,$-6.00
2024-10-30,12:47:00,20706.0,SELL,3,0.02h,Stop Loss,$4.50,$-1.50,$130055.00,216,$-1.50
2024-10-30,13:57:00,20627.25,BUY,3,0.02h,Stop Loss,$12.00,$10.50,$130067.00,216,$10.50
2024-10-30,14:47:00,20671.75,SELL,3,0.02h,Stop Loss,$24.00,$34.50,$130091.00,216,$34.50
2024-10-30,15:25:00,20650.5,BUY,3,0.02h,Stop Loss,$21.00,$55.50,$130112.00,216,$55.50
2024-10-30,16:10:00,20659.25,SELL,3,0.02h,Stop Loss,$15.00,$70.50,$130127.00,216,$70.50
2024-10-30,16:41:00,20658.25,BUY,3,0.02h,Stop Loss,$-9.00,$61.50,$130118.00,216,$61.50
2024-10-30,16:42:00,20645.5,SELL,3,0.02h,Stop Loss,$-9.00,$52.50,$130109.00,216,$52.50
2024-10-30,16:46:00,20659.0,BUY,3,0.02h,Break Even,$-1.50,$51.00,$130107.50,216,$51.00
2024-10-30,16:57:00,20648.25,SELL,3,0.02h,Stop Loss,$18.00,$69.00,$130125.50,216,$69.00
2024-10-30,18:08:00,20612.75,BUY,3,0.02h,Stop Loss,$10.50,$79.50,$130136.00,216,$79.50
2024-10-30,18:30:00,20596.0,SELL,3,0.02h,Break Even,$-1.50,$78.00,$130134.50,216,$78.00
2024-10-30,18:34:00,20607.5,BUY,3,0.02h,Stop Loss,$4.50,$82.50,$130139.00,216,$82.50
2024-10-30,18:58:00,20609.0,SELL,3,0.02h,Stop Loss,$12.00,$94.50,$130151.00,216,$94.50
2024-10-30,20:05:00,20571.25,BUY,3,0.02h,Break Even,$-1.50,$93.00,$130149.50,216,$93.00
2024-10-30,20:06:00,20533.75,SELL,3,0.02h,Stop Loss,$69.00,$162.00,$130218.50,216,$162.00
2024-10-30,20:30:00,20542.5,BUY,3,0.02h,Stop Loss,$43.50,$205.50,$130262.00,216,$205.50
2024-10-30,20:44:00,20514.0,SELL,3,0.02h,Stop Loss,$-9.00,$196.50,$130253.00,216,$196.50
2024-10-30,20:46:00,20529.0,BUY,3,0.02h,Break Even,$-1.50,$195.00,$130251.50,216,$195.00
2024-10-30,20:51:00,20511.25,SELL,3,0.02h,Break Even,$-1.50,$193.50,$130250.00,216,$193.50
2024-10-30,22:37:00,20454.0,BUY,3,0.02h,Break Even,$-1.50,$192.00,$130248.50,216,$192.00
2024-10-30,22:41:00,20446.5,SELL,3,0.02h,Stop Loss,$-9.00,$183.00,$130239.50,216,$183.00
2024-10-30,22:42:00,20453.0,BUY,3,0.02h,Stop Loss,$12.00,$195.00,$130251.50,216,$195.00
2024-10-30,22:48:00,20437.25,SELL,3,0.02h,Stop Loss,$4.50,$199.50,$130256.00,216,$199.50
,,,,,,,,,,,
2024-10-31,12:26:00,20407.75,BUY,3,0.02h,Break Even,$-1.50,$-1.50,$130254.50,217,$-1.50
2024-10-31,12:36:00,20389.25,SELL,3,0.02h,Stop Loss,$13.50,$12.00,$130268.00,217,$12.00
2024-10-31,12:46:00,20411.25,BUY,3,0.02h,Break Even,$-1.50,$10.50,$130266.50,217,$10.50
2024-10-31,12:50:00,20387.0,SELL,3,0.02h,Stop Loss,$-9.00,$1.50,$130257.50,217,$1.50
2024-10-31,12:52:00,20403.75,BUY,3,0.02h,Stop Loss,$-9.00,$-7.50,$130248.50,217,$-7.50
2024-10-31,12:55:00,20387.0,SELL,3,0.02h,Stop Loss,$12.00,$4.50,$130260.50,217,$4.50
2024-10-31,13:17:00,20393.75,BUY,3,0.02h,Stop Loss,$-9.00,$-4.50,$130251.50,217,$-4.50
2024-10-31,13:21:00,20382.25,SELL,3,0.02h,Stop Loss,$-9.00,$-13.50,$130242.50,217,$-13.50
2024-10-31,13:24:00,20389.75,BUY,3,0.02h,Break Even,$-1.50,$-15.00,$130241.00,217,$-15.00
2024-10-31,13:26:00,20376.0,SELL,3,0.02h,Break Even,$-1.50,$-16.50,$130239.50,217,$-16.50
2024-10-31,14:20:00,20187.0,BUY,3,0.02h,Stop Loss,$4.50,$-12.00,$130244.00,217,$-12.00
2024-10-31,14:28:00,20149.75,SELL,3,0.02h,Stop Loss,$52.50,$40.50,$130296.50,217,$40.50
2024-10-31,15:22:00,20107.0,BUY,3,0.02h,Stop Loss,$7.50,$48.00,$130304.00,217,$48.00
2024-10-31,15:33:00,20076.75,SELL,3,0.02h,Stop Loss,$27.00,$75.00,$130331.00,217,$75.00
2024-10-31,16:02:00,20063.75,BUY,3,0.02h,Stop Loss,$-9.00,$66.00,$130322.00,217,$66.00
2024-10-31,16:03:00,20050.25,SELL,3,0.02h,Stop Loss,$-9.00,$57.00,$130313.00,217,$57.00
2024-10-31,16:05:00,20068.25,BUY,3,0.02h,Stop Loss,$78.00,$135.00,$130391.00,217,$135.00
2024-10-31,16:35:00,20072.75,SELL,3,0.02h,Break Even,$-1.50,$133.50,$130389.50,217,$133.50
2024-10-31,16:41:00,20083.25,BUY,3,0.02h,Stop Loss,$-9.00,$124.50,$130380.50,217,$124.50
2024-10-31,16:42:00,20072.5,SELL,3,0.02h,Stop Loss,$-9.00,$115.50,$130371.50,217,$115.50
2024-10-31,16:44:00,20089.75,BUY,3,0.02h,Stop Loss,$33.00,$148.50,$130404.50,217,$148.50
2024-10-31,17:16:00,20087.5,SELL,3,0.02h,Stop Loss,$6.00,$154.50,$130410.50,217,$154.50
2024-10-31,17:22:00,20098.0,BUY,3,0.02h,Stop Loss,$6.00,$160.50,$130416.50,217,$160.50
2024-10-31,17:27:00,20087.0,SELL,3,0.02h,Stop Loss,$69.00,$229.50,$130485.50,217,$229.50
2024-10-31,18:31:00,20044.5,BUY,3,0.02h,Break Even,$-1.50,$228.00,$130484.00,217,$228.00
2024-10-31,18:34:00,20017.5,SELL,3,0.02h,Stop Loss,$24.00,$252.00,$130508.00,217,$252.00
2024-10-31,18:46:00,20037.0,BUY,3,0.02h,Break Even,$-1.50,$250.50,$130506.50,217,$250.50
2024-10-31,18:49:00,20023.75,SELL,3,0.02h,Stop Loss,$22.50,$273.00,$130529.00,217,$273.00
2024-10-31,18:55:00,20032.75,BUY,3,0.02h,Stop Loss,$19.50,$292.50,$130548.50,217,$292.50
2024-10-31,19:33:00,20064.25,SELL,3,0.02h,Stop Loss,$-9.00,$283.50,$130539.50,217,$283.50
2024-10-31,19:43:00,20085.5,BUY,3,0.02h,Stop Loss,$12.00,$295.50,$130551.50,217,$295.50
2024-10-31,19:55:00,20042.25,SELL,3,0.02h,Stop Loss,$9.00,$304.50,$130560.50,217,$304.50
2024-10-31,20:25:00,20070.75,BUY,3,0.02h,Stop Loss,$16.50,$321.00,$130577.00,217,$321.00
2024-10-31,20:34:00,20028.75,SELL,3,0.02h,Stop Loss,$19.50,$340.50,$130596.50,217,$340.50
2024-10-31,22:01:00,20083.75,BUY,3,0.02h,Stop Loss,$-9.00,$331.50,$130587.50,217,$331.50
2024-10-31,22:52:00,20084.75,SELL,3,0.02h,Stop Loss,$6.00,$337.50,$130593.50,217,$337.50
,,,,,,,,,,,
2024-11-01,12:00:00,20109.0,BUY,3,0.02h,Stop Loss,$21.00,$21.00,$130614.50,218,$21.00
2024-11-01,12:29:00,20101.75,SELL,3,0.02h,Stop Loss,$9.00,$30.00,$130623.50,218,$30.00
2024-11-01,12:33:00,20133.75,BUY,3,0.02h,Stop Loss,$46.50,$76.50,$130670.00,218,$76.50
2024-11-01,12:50:00,20113.75,SELL,3,0.02h,Stop Loss,$21.00,$97.50,$130691.00,218,$97.50
2024-11-01,12:54:00,20123.5,BUY,3,0.02h,Stop Loss,$13.50,$111.00,$130704.50,218,$111.00
2024-11-01,12:59:00,20113.5,SELL,3,0.02h,Break Even,$-1.50,$109.50,$130703.00,218,$109.50
2024-11-01,13:35:00,20111.75,BUY,3,0.02h,Break Even,$-1.50,$108.00,$130701.50,218,$108.00
2024-11-01,14:42:00,20220.25,SELL,3,0.02h,Stop Loss,$54.00,$162.00,$130755.50,218,$162.00
2024-11-01,15:00:00,20235.25,BUY,3,0.02h,Break Even,$-1.50,$160.50,$130754.00,218,$160.50
2024-11-01,15:42:00,20256.0,SELL,3,0.02h,Stop Loss,$10.50,$171.00,$130764.50,218,$171.00
2024-11-01,16:10:00,20248.25,BUY,3,0.02h,Stop Loss,$4.50,$175.50,$130769.00,218,$175.50
2024-11-01,16:19:00,20232.0,SELL,3,0.02h,Break Even,$-1.50,$174.00,$130767.50,218,$174.00
2024-11-01,16:20:00,20244.5,BUY,3,0.02h,Stop Loss,$-9.00,$165.00,$130758.50,218,$165.00
2024-11-01,16:21:00,20232.0,SELL,3,0.02h,Stop Loss,$30.00,$195.00,$130788.50,218,$195.00
2024-11-01,16:35:00,20250.75,BUY,3,0.02h,Break Even,$-1.50,$193.50,$130787.00,218,$193.50
2024-11-01,16:44:00,20198.25,SELL,3,0.02h,Stop Loss,$3.00,$196.50,$130790.00,218,$196.50
2024-11-01,17:17:00,20219.75,BUY,3,0.02h,Break Even,$-1.50,$195.00,$130788.50,218,$195.00
2024-11-01,17:34:00,20195.25,SELL,3,0.02h,Stop Loss,$39.00,$234.00,$130827.50,218,$234.00
2024-11-01,18:26:00,20165.0,BUY,3,0.02h,Stop Loss,$15.00,$249.00,$130842.50,218,$249.00
2024-11-01,18:43:00,20151.5,SELL,3,0.02h,Break Even,$-1.50,$247.50,$130841.00,218,$247.50
2024-11-01,18:45:00,20165.0,BUY,3,0.02h,Stop Loss,$64.50,$312.00,$130905.50,218,$312.00
2024-11-01,19:04:00,20158.0,SELL,3,0.02h,Stop Loss,$-9.00,$303.00,$130896.50,218,$303.00
2024-11-01,19:05:00,20166.75,BUY,3,0.02h,Break Even,$-1.50,$301.50,$130895.00,218,$301.50
2024-11-01,19:29:00,20170.5,SELL,3,0.02h,Stop Loss,$64.50,$366.00,$130959.50,218,$366.00
2024-11-01,19:44:00,20180.75,BUY,3,0.02h,Stop Loss,$-9.00,$357.00,$130950.50,218,$357.00
2024-11-01,19:45:00,20169.25,SELL,3,0.02h,Stop Loss,$12.00,$369.00,$130962.50,218,$369.00
2024-11-01,19:47:00,20175.75,BUY,3,0.02h,Break Even,$-1.50,$367.50,$130961.00,218,$367.50
2024-11-01,19:49:00,20161.0,SELL,3,0.02h,Stop Loss,$15.00,$382.50,$130976.00,218,$382.50
2024-11-01,20:08:00,20161.5,BUY,3,0.02h,Stop Loss,$-9.00,$373.50,$130967.00,218,$373.50
2024-11-01,20:49:00,20163.0,SELL,3,0.02h,Stop Loss,$-9.00,$364.50,$130958.00,218,$364.50
2024-11-01,21:00:00,20169.5,BUY,3,63.00h,Stop Loss,$58.50,$423.00,$131016.50,218,$423.00
,,,,,,,,,,,
2024-11-04,12:16:00,20165.5,SELL,3,0.02h,Break Even,$-1.50,$-1.50,$131015.00,219,$-1.50
2024-11-04,12:52:00,20148.0,BUY,3,0.02h,Stop Loss,$-9.00,$-10.50,$131006.00,219,$-10.50
2024-11-04,13:16:00,20143.5,SELL,3,0.02h,Stop Loss,$-9.00,$-19.50,$130997.00,219,$-19.50
2024-11-04,13:21:00,20165.0,BUY,3,0.02h,Stop Loss,$-9.00,$-28.50,$130988.00,219,$-28.50
2024-11-04,13:25:00,20157.0,SELL,3,0.02h,Stop Loss,$15.00,$-13.50,$131003.00,219,$-13.50
2024-11-04,13:30:00,20161.25,BUY,3,0.02h,Stop Loss,$-9.00,$-22.50,$130994.00,219,$-22.50
2024-11-04,13:46:00,20156.5,SELL,3,0.02h,Stop Loss,$-9.00,$-31.50,$130985.00,219,$-31.50
2024-11-04,14:46:00,20125.5,BUY,3,0.02h,Stop Loss,$18.00,$-13.50,$131003.00,219,$-13.50
2024-11-04,16:21:00,20193.25,SELL,3,0.02h,Stop Loss,$46.50,$33.00,$131049.50,219,$33.00
2024-11-04,17:22:00,20083.0,BUY,3,0.02h,Stop Loss,$19.50,$52.50,$131069.00,219,$52.50
2024-11-04,18:06:00,20119.25,SELL,3,0.02h,Stop Loss,$54.00,$106.50,$131123.00,219,$106.50
2024-11-04,18:15:00,20137.75,BUY,3,0.02h,Stop Loss,$28.50,$135.00,$131151.50,219,$135.00
2024-11-04,19:00:00,20148.75,SELL,3,0.02h,Stop Loss,$-9.00,$126.00,$131142.50,219,$126.00
2024-11-04,19:08:00,20163.5,BUY,3,0.02h,Stop Loss,$10.50,$136.50,$131153.00,219,$136.50
2024-11-04,19:11:00,20149.75,SELL,3,0.02h,Stop Loss,$-9.00,$127.50,$131144.00,219,$127.50
2024-11-04,19:15:00,20159.5,BUY,3,0.02h,Break Even,$-1.50,$126.00,$131142.50,219,$126.00
2024-11-04,19:18:00,20151.5,SELL,3,0.02h,Break Even,$-1.50,$124.50,$131141.00,219,$124.50
2024-11-04,19:38:00,20151.75,BUY,3,0.02h,Break Even,$-1.50,$123.00,$131139.50,219,$123.00
2024-11-04,19:46:00,20145.5,SELL,3,0.02h,Stop Loss,$12.00,$135.00,$131151.50,219,$135.00
2024-11-04,20:26:00,20134.75,BUY,3,0.02h,Break Even,$-1.50,$133.50,$131150.00,219,$133.50
2024-11-04,20:29:00,20118.0,SELL,3,0.02h,Break Even,$-1.50,$132.00,$131148.50,219,$132.00
2024-11-04,21:09:00,20107.25,BUY,3,0.02h,Stop Loss,$9.00,$141.00,$131157.50,219,$141.00
2024-11-04,21:38:00,20104.0,SELL,3,0.02h,Break Even,$-1.50,$139.50,$131156.00,219,$139.50
2024-11-04,21:50:00,20110.25,BUY,3,0.02h,Stop Loss,$-9.00,$130.50,$131147.00,219,$130.50
2024-11-04,21:57:00,20105.5,SELL,3,0.02h,Break Even,$-1.50,$129.00,$131145.50,219,$129.00
2024-11-04,22:00:00,20115.0,BUY,3,14.00h,Stop Loss,$265.50,$394.50,$131411.00,219,$394.50
,,,,,,,,,,,
2024-11-05,12:25:00,20142.25,SELL,3,0.02h,Stop Loss,$4.50,$4.50,$131415.50,220,$4.50
2024-11-05,12:51:00,20148.0,BUY,3,0.02h,Stop Loss,$-9.00,$-4.50,$131406.50,220,$-4.50
2024-11-05,13:13:00,20136.5,SELL,3,0.02h,Break Even,$-1.50,$-6.00,$131405.00,220,$-6.00
2024-11-05,13:23:00,20149.25,BUY,3,0.02h,Stop Loss,$-9.00,$-15.00,$131396.00,220,$-15.00
2024-11-05,13:52:00,20152.75,SELL,3,0.02h,Break Even,$-1.50,$-16.50,$131394.50,220,$-16.50
2024-11-05,14:17:00,20142.25,BUY,3,0.02h,Break Even,$-1.50,$-18.00,$131393.00,220,$-18.00
2024-11-05,15:31:00,20275.0,SELL,3,0.02h,Break Even,$-1.50,$-19.50,$131391.50,220,$-19.50
2024-11-05,15:41:00,20286.75,BUY,3,0.02h,Stop Loss,$9.00,$-10.50,$131400.50,220,$-10.50
2024-11-05,15:53:00,20264.25,SELL,3,0.02h,Stop Loss,$22.50,$12.00,$131423.00,220,$12.00
2024-11-05,16:09:00,20293.25,BUY,3,0.02h,Stop Loss,$12.00,$24.00,$131435.00,220,$24.00
2024-11-05,17:40:00,20349.25,SELL,3,0.02h,Break Even,$-1.50,$22.50,$131433.50,220,$22.50
2024-11-05,17:47:00,20363.75,BUY,3,0.02h,Stop Loss,$10.50,$33.00,$131444.00,220,$33.00
2024-11-05,17:59:00,20344.5,SELL,3,0.02h,Stop Loss,$-9.00,$24.00,$131435.00,220,$24.00
2024-11-05,18:07:00,20365.5,BUY,3,0.02h,Break Even,$-1.50,$22.50,$131433.50,220,$22.50
2024-11-05,18:12:00,20347.0,SELL,3,0.02h,Stop Loss,$10.50,$33.00,$131444.00,220,$33.00
2024-11-05,19:03:00,20321.0,BUY,3,0.02h,Break Even,$-1.50,$31.50,$131442.50,220,$31.50
2024-11-05,19:19:00,20312.75,SELL,3,0.02h,Break Even,$-1.50,$30.00,$131441.00,220,$30.00
2024-11-05,19:28:00,20323.25,BUY,3,0.02h,Break Even,$-1.50,$28.50,$131439.50,220,$28.50
2024-11-05,19:51:00,20313.0,SELL,3,0.02h,Stop Loss,$40.50,$69.00,$131480.00,220,$69.00
2024-11-05,20:09:00,20316.25,BUY,3,0.02h,Stop Loss,$24.00,$93.00,$131504.00,220,$93.00
2024-11-05,20:44:00,20311.0,SELL,3,0.02h,Stop Loss,$-9.00,$84.00,$131495.00,220,$84.00
2024-11-05,20:59:00,20331.25,BUY,3,0.02h,Stop Loss,$78.00,$162.00,$131573.00,220,$162.00
2024-11-05,21:42:00,20362.25,SELL,3,0.02h,Stop Loss,$-9.00,$153.00,$131564.00,220,$153.00
,,,,,,,,,,,
2024-11-06,12:00:00,20607.0,BUY,3,0.02h,Stop Loss,$30.00,$30.00,$131594.00,221,$30.00
2024-11-06,13:03:00,20665.75,SELL,3,0.02h,Stop Loss,$-9.00,$21.00,$131585.00,221,$21.00
2024-11-06,13:17:00,20683.5,BUY,3,0.02h,Stop Loss,$-9.00,$12.00,$131576.00,221,$12.00
2024-11-06,13:46:00,20687.25,SELL,3,0.02h,Stop Loss,$45.00,$57.00,$131621.00,221,$57.00
2024-11-06,14:28:00,20688.5,BUY,3,0.02h,Stop Loss,$-9.00,$48.00,$131612.00,221,$48.00
2024-11-06,14:49:00,20680.5,SELL,3,0.02h,Stop Loss,$90.00,$138.00,$131702.00,221,$138.00
2024-11-06,15:03:00,20725.5,BUY,3,0.02h,Break Even,$-1.50,$136.50,$131700.50,221,$136.50
2024-11-06,15:06:00,20686.5,SELL,3,0.02h,Break Even,$-1.50,$135.00,$131699.00,221,$135.00
2024-11-06,15:11:00,20735.25,BUY,3,0.02h,Stop Loss,$37.50,$172.50,$131736.50,221,$172.50
2024-11-06,15:42:00,20772.25,SELL,3,0.02h,Stop Loss,$132.00,$304.50,$131868.50,221,$304.50
2024-11-06,16:13:00,20747.0,BUY,3,0.02h,Stop Loss,$52.50,$357.00,$131921.00,221,$357.00
2024-11-06,17:22:00,20794.0,SELL,3,0.02h,Break Even,$-1.50,$355.50,$131919.50,221,$355.50
2024-11-06,17:33:00,20801.75,BUY,3,0.02h,Break Even,$-1.50,$354.00,$131918.00,221,$354.00
2024-11-06,17:40:00,20792.0,SELL,3,0.02h,Break Even,$-1.50,$352.50,$131916.50,221,$352.50
2024-11-06,17:43:00,20803.0,BUY,3,0.02h,Break Even,$-1.50,$351.00,$131915.00,221,$351.00
2024-11-06,18:59:00,20853.25,SELL,3,0.02h,Stop Loss,$-9.00,$342.00,$131906.00,221,$342.00
2024-11-06,19:02:00,20873.25,BUY,3,0.02h,Break Even,$-1.50,$340.50,$131904.50,221,$340.50
2024-11-06,19:07:00,20854.0,SELL,3,0.02h,Stop Loss,$12.00,$352.50,$131916.50,221,$352.50
2024-11-06,19:09:00,20869.0,BUY,3,0.02h,Break Even,$-1.50,$351.00,$131915.00,221,$351.00
2024-11-06,19:11:00,20858.25,SELL,3,0.02h,Break Even,$-1.50,$349.50,$131913.50,221,$349.50
2024-11-06,19:14:00,20872.25,BUY,3,0.02h,Stop Loss,$42.00,$391.50,$131955.50,221,$391.50
2024-11-06,19:43:00,20869.0,SELL,3,0.02h,Break Even,$-1.50,$390.00,$131954.00,221,$390.00
2024-11-06,19:48:00,20885.5,BUY,3,0.02h,Stop Loss,$9.00,$399.00,$131963.00,221,$399.00
2024-11-06,19:56:00,20876.5,SELL,3,0.02h,Break Even,$-1.50,$397.50,$131961.50,221,$397.50
2024-11-06,19:58:00,20883.25,BUY,3,0.02h,Break Even,$-1.50,$396.00,$131960.00,221,$396.00
2024-11-06,20:38:00,20897.75,SELL,3,0.02h,Stop Loss,$6.00,$402.00,$131966.00,221,$402.00
2024-11-06,20:45:00,20912.75,BUY,3,0.02h,Break Even,$-1.50,$400.50,$131964.50,221,$400.50
2024-11-06,20:53:00,20881.0,SELL,3,0.02h,Break Even,$-1.50,$399.00,$131963.00,221,$399.00
2024-11-06,21:02:00,20917.75,BUY,3,0.02h,Stop Loss,$28.50,$427.50,$131991.50,221,$427.50
2024-11-06,21:08:00,20897.5,SELL,3,0.02h,Break Even,$-1.50,$426.00,$131990.00,221,$426.00
2024-11-06,21:23:00,20902.25,BUY,3,0.02h,Stop Loss,$51.00,$477.00,$132041.00,221,$477.00
2024-11-06,21:41:00,20901.25,SELL,3,0.02h,Break Even,$-1.50,$475.50,$132039.50,221,$475.50
2024-11-06,21:43:00,20908.0,BUY,3,0.02h,Stop Loss,$22.50,$498.00,$132062.00,221,$498.00
,,,,,,,,,,,
2024-11-07,12:44:00,20960.75,SELL,3,0.02h,Stop Loss,$-9.00,$-9.00,$132053.00,222,$-9.00
2024-11-07,13:00:00,20967.0,BUY,3,0.02h,Stop Loss,$4.50,$-4.50,$132057.50,222,$-4.50
2024-11-07,13:25:00,20978.25,SELL,3,0.02h,Break Even,$-1.50,$-6.00,$132056.00,222,$-6.00
2024-11-07,13:46:00,20989.5,BUY,3,0.02h,Break Even,$-1.50,$-7.50,$132054.50,222,$-7.50
2024-11-07,15:34:00,21092.25,SELL,3,0.02h,Stop Loss,$13.50,$6.00,$132068.00,222,$6.00
2024-11-07,15:37:00,21123.5,BUY,3,0.02h,Break Even,$-1.50,$4.50,$132066.50,222,$4.50
2024-11-07,15:42:00,21106.0,SELL,3,0.02h,Stop Loss,$-9.00,$-4.50,$132057.50,222,$-4.50
2024-11-07,15:43:00,21111.5,BUY,3,0.02h,Break Even,$-1.50,$-6.00,$132056.00,222,$-6.00
2024-11-07,15:44:00,21106.75,SELL,3,0.02h,Stop Loss,$-9.00,$-15.00,$132047.00,222,$-15.00
2024-11-07,15:45:00,21118.75,BUY,3,0.02h,Stop Loss,$57.00,$42.00,$132104.00,222,$42.00
2024-11-07,16:11:00,21132.75,SELL,3,0.02h,Stop Loss,$-9.00,$33.00,$132095.00,222,$33.00
2024-11-07,16:12:00,21145.75,BUY,3,0.02h,Break Even,$-1.50,$31.50,$132093.50,222,$31.50
2024-11-07,17:05:00,21171.5,SELL,3,0.02h,Stop Loss,$15.00,$46.50,$132108.50,222,$46.50
2024-11-07,17:16:00,21179.25,BUY,3,0.02h,Break Even,$-1.50,$45.00,$132107.00,222,$45.00
2024-11-07,17:17:00,21173.75,SELL,3,0.02h,Break Even,$-1.50,$43.50,$132105.50,222,$43.50
2024-11-07,17:18:00,21177.75,BUY,3,0.02h,Stop Loss,$6.00,$49.50,$132111.50,222,$49.50
2024-11-07,17:21:00,21172.0,SELL,3,0.02h,Stop Loss,$-9.00,$40.50,$132102.50,222,$40.50
2024-11-07,17:22:00,21183.5,BUY,3,0.02h,Break Even,$-1.50,$39.00,$132101.00,222,$39.00
2024-11-07,17:26:00,21172.25,SELL,3,0.02h,Break Even,$-1.50,$37.50,$132099.50,222,$37.50
2024-11-07,17:31:00,21184.0,BUY,3,0.02h,Stop Loss,$19.50,$57.00,$132119.00,222,$57.00
2024-11-07,17:34:00,21166.5,SELL,3,0.02h,Break Even,$-1.50,$55.50,$132117.50,222,$55.50
2024-11-07,17:38:00,21185.0,BUY,3,0.02h,Stop Loss,$4.50,$60.00,$132122.00,222,$60.00
2024-11-07,18:08:00,21179.25,SELL,3,0.02h,Stop Loss,$34.50,$94.50,$132156.50,222,$94.50
2024-11-07,18:52:00,21179.25,BUY,3,0.02h,Stop Loss,$12.00,$106.50,$132168.50,222,$106.50
2024-11-07,19:24:00,21179.25,SELL,3,0.02h,Break Even,$-1.50,$105.00,$132167.00,222,$105.00
2024-11-07,19:28:00,21192.0,BUY,3,0.02h,Stop Loss,$-9.00,$96.00,$132158.00,222,$96.00
2024-11-07,19:43:00,21173.75,SELL,3,0.02h,Stop Loss,$12.00,$108.00,$132170.00,222,$108.00
2024-11-07,19:48:00,21199.0,BUY,3,0.02h,Stop Loss,$67.50,$175.50,$132237.50,222,$175.50
2024-11-07,20:35:00,21229.5,SELL,3,0.02h,Break Even,$-1.50,$174.00,$132236.00,222,$174.00
2024-11-07,20:48:00,21243.0,BUY,3,0.02h,Stop Loss,$15.00,$189.00,$132251.00,222,$189.00
2024-11-07,20:52:00,21218.0,SELL,3,0.02h,Stop Loss,$39.00,$228.00,$132290.00,222,$228.00
2024-11-07,21:07:00,21232.5,BUY,3,0.02h,Stop Loss,$15.00,$243.00,$132305.00,222,$243.00
2024-11-07,21:28:00,21232.0,SELL,3,0.02h,Break Even,$-1.50,$241.50,$132303.50,222,$241.50
2024-11-07,21:59:00,21226.75,BUY,3,0.02h,Break Even,$-1.50,$240.00,$132302.00,222,$240.00
,,,,,,,,,,,
2024-11-08,12:00:00,21161.75,SELL,3,0.02h,Stop Loss,$-9.00,$-9.00,$132293.00,223,$-9.00
2024-11-08,12:32:00,21178.0,BUY,3,0.02h,Stop Loss,$-9.00,$-18.00,$132284.00,223,$-18.00
2024-11-08,13:13:00,21174.5,SELL,3,0.02h,Stop Loss,$-9.00,$-27.00,$132275.00,223,$-27.00
2024-11-08,13:24:00,21185.25,BUY,3,0.02h,Stop Loss,$-9.00,$-36.00,$132266.00,223,$-36.00
2024-11-08,13:31:00,21174.75,SELL,3,0.02h,Stop Loss,$4.50,$-31.50,$132270.50,223,$-31.50
2024-11-08,14:10:00,21172.75,BUY,3,0.02h,Stop Loss,$10.50,$-21.00,$132281.00,223,$-21.00
2024-11-08,14:47:00,21194.5,SELL,3,0.02h,Stop Loss,$-9.00,$-30.00,$132272.00,223,$-30.00
2024-11-08,14:48:00,21211.75,BUY,3,0.02h,Stop Loss,$6.00,$-24.00,$132278.00,223,$-24.00
2024-11-08,15:05:00,21190.5,SELL,3,0.02h,Stop Loss,$39.00,$15.00,$132317.00,223,$15.00
2024-11-08,15:22:00,21199.75,BUY,3,0.02h,Break Even,$-1.50,$13.50,$132315.50,223,$13.50
2024-11-08,15:25:00,21181.5,SELL,3,0.02h,Break Even,$-1.50,$12.00,$132314.00,223,$12.00
2024-11-08,15:27:00,21193.25,BUY,3,0.02h,Stop Loss,$6.00,$18.00,$132320.00,223,$18.00
2024-11-08,15:39:00,21188.0,SELL,3,0.02h,Stop Loss,$4.50,$22.50,$132324.50,223,$22.50
2024-11-08,15:51:00,21193.5,BUY,3,0.02h,Stop Loss,$37.50,$60.00,$132362.00,223,$60.00
2024-11-08,16:03:00,21173.25,SELL,3,0.02h,Break Even,$-1.50,$58.50,$132360.50,223,$58.50
2024-11-08,16:12:00,21197.25,BUY,3,0.02h,Stop Loss,$22.50,$81.00,$132383.00,223,$81.00
2024-11-08,16:44:00,21197.5,SELL,3,0.02h,Break Even,$-1.50,$79.50,$132381.50,223,$79.50
2024-11-08,16:51:00,21221.75,BUY,3,0.02h,Break Even,$-1.50,$78.00,$132380.00,223,$78.00
2024-11-08,17:06:00,21207.5,SELL,3,0.02h,Stop Loss,$-9.00,$69.00,$132371.00,223,$69.00
2024-11-08,17:33:00,21217.25,BUY,3,0.02h,Break Even,$-1.50,$67.50,$132369.50,223,$67.50
2024-11-08,18:54:00,21243.5,SELL,3,0.02h,Stop Loss,$25.50,$93.00,$132395.00,223,$93.00
2024-11-08,19:08:00,21253.75,BUY,3,0.02h,Break Even,$-1.50,$91.50,$132393.50,223,$91.50
2024-11-08,19:21:00,21244.5,SELL,3,0.02h,Stop Loss,$-9.00,$82.50,$132384.50,223,$82.50
2024-11-08,19:26:00,21253.0,BUY,3,0.02h,Break Even,$-1.50,$81.00,$132383.00,223,$81.00
2024-11-08,19:49:00,21248.75,SELL,3,0.02h,Break Even,$-1.50,$79.50,$132381.50,223,$79.50
2024-11-08,20:54:00,21223.75,BUY,3,0.02h,Stop Loss,$30.00,$109.50,$132411.50,223,$109.50
2024-11-08,20:57:00,21220.5,SELL,3,0.02h,Stop Loss,$-9.00,$100.50,$132402.50,223,$100.50
2024-11-08,20:58:00,21230.5,BUY,3,0.02h,Break Even,$-1.50,$99.00,$132401.00,223,$99.00
2024-11-08,21:32:00,21228.25,SELL,3,0.02h,Break Even,$-1.50,$97.50,$132399.50,223,$97.50
2024-11-08,21:56:00,21235.5,BUY,3,0.02h,Stop Loss,$-9.00,$88.50,$132390.50,223,$88.50
,,,,,,,,,,,
2024-11-11,13:16:00,21317.75,SELL,3,0.02h,Stop Loss,$4.50,$4.50,$132395.00,224,$4.50
2024-11-11,14:06:00,21299.75,BUY,3,0.02h,Break Even,$-1.50,$3.00,$132393.50,224,$3.00
2024-11-11,14:12:00,21293.25,SELL,3,0.02h,Stop Loss,$7.50,$10.50,$132401.00,224,$10.50
2024-11-11,15:16:00,21197.5,BUY,3,0.02h,Break Even,$-1.50,$9.00,$132399.50,224,$9.00
2024-11-11,15:17:00,21183.5,SELL,3,0.02h,Stop Loss,$7.50,$16.50,$132407.00,224,$16.50
2024-11-11,15:25:00,21197.0,BUY,3,0.02h,Stop Loss,$10.50,$27.00,$132417.50,224,$27.00
2024-11-11,15:49:00,21200.0,SELL,3,0.02h,Stop Loss,$-9.00,$18.00,$132408.50,224,$18.00
2024-11-11,15:54:00,21221.5,BUY,3,0.02h,Break Even,$-1.50,$16.50,$132407.00,224,$16.50
2024-11-11,16:13:00,21211.0,SELL,3,0.02h,Break Even,$-1.50,$15.00,$132405.50,224,$15.00
2024-11-11,16:15:00,21222.5,BUY,3,0.02h,Stop Loss,$-9.00,$6.00,$132396.50,224,$6.00
2024-11-11,16:16:00,21217.5,SELL,3,0.02h,Stop Loss,$3.00,$9.00,$132399.50,224,$9.00
2024-11-11,16:20:00,21228.75,BUY,3,0.02h,Break Even,$-1.50,$7.50,$132398.00,224,$7.50
2024-11-11,16:27:00,21209.75,SELL,3,0.02h,Break Even,$-1.50,$6.00,$132396.50,224,$6.00
2024-11-11,17:38:00,21181.0,BUY,3,0.02h,Break Even,$-1.50,$4.50,$132395.00,224,$4.50
2024-11-11,17:39:00,21176.75,SELL,3,0.02h,Stop Loss,$25.50,$30.00,$132420.50,224,$30.00
2024-11-11,18:30:00,21141.5,BUY,3,0.02h,Stop Loss,$-9.00,$21.00,$132411.50,224,$21.00
2024-11-11,19:12:00,21164.0,SELL,3,0.02h,Stop Loss,$-9.00,$12.00,$132402.50,224,$12.00
2024-11-11,19:35:00,21177.0,BUY,3,0.02h,Stop Loss,$-9.00,$3.00,$132393.50,224,$3.00
2024-11-11,19:48:00,21165.75,SELL,3,0.02h,Stop Loss,$-9.00,$-6.00,$132384.50,224,$-6.00
2024-11-11,19:49:00,21173.0,BUY,3,0.02h,Stop Loss,$3.00,$-3.00,$132387.50,224,$-3.00
2024-11-11,19:53:00,21165.25,SELL,3,0.02h,Break Even,$-1.50,$-4.50,$132386.00,224,$-4.50
2024-11-11,20:00:00,21175.0,BUY,3,0.02h,Stop Loss,$-9.00,$-13.50,$132377.00,224,$-13.50
2024-11-11,20:50:00,21192.5,SELL,3,0.02h,Break Even,$-1.50,$-15.00,$132375.50,224,$-15.00
2024-11-11,20:51:00,21207.0,BUY,3,0.02h,Stop Loss,$3.00,$-12.00,$132378.50,224,$-12.00
2024-11-11,21:33:00,21217.5,SELL,3,0.02h,Stop Loss,$-9.00,$-21.00,$132369.50,224,$-21.00
2024-11-11,21:41:00,21223.25,BUY,3,0.02h,Stop Loss,$-9.00,$-30.00,$132360.50,224,$-30.00
2024-11-11,21:51:00,21220.0,SELL,3,0.02h,Stop Loss,$-9.00,$-39.00,$132351.50,224,$-39.00
2024-11-11,21:52:00,21223.5,BUY,3,0.02h,Stop Loss,$-9.00,$-48.00,$132342.50,224,$-48.00
2024-11-11,21:55:00,21219.25,SELL,3,0.02h,Break Even,$-1.50,$-49.50,$132341.00,224,$-49.50
,,,,,,,,,,,
2024-11-12,12:42:00,21204.5,BUY,3,0.02h,Break Even,$-1.50,$-1.50,$132339.50,225,$-1.50
2024-11-12,12:58:00,21193.0,SELL,3,0.02h,Break Even,$-1.50,$-3.00,$132338.00,225,$-3.00
2024-11-12,13:14:00,21200.75,BUY,3,0.02h,Stop Loss,$-9.00,$-12.00,$132329.00,225,$-12.00
2024-11-12,14:04:00,21213.5,SELL,3,0.02h,Break Even,$-1.50,$-13.50,$132327.50,225,$-13.50
2024-11-12,14:30:00,21214.25,BUY,3,0.02h,Stop Loss,$24.00,$10.50,$132351.50,225,$10.50
2024-11-12,14:31:00,21204.5,SELL,3,0.02h,Stop Loss,$48.00,$58.50,$132399.50,225,$58.50
2024-11-12,14:36:00,21229.25,BUY,3,0.02h,Stop Loss,$51.00,$109.50,$132450.50,225,$109.50
2024-11-12,14:48:00,21212.0,SELL,3,0.02h,Break Even,$-1.50,$108.00,$132449.00,225,$108.00
2024-11-12,14:50:00,21220.5,BUY,3,0.02h,Break Even,$-1.50,$106.50,$132447.50,225,$106.50
2024-11-12,15:05:00,21191.75,SELL,3,0.02h,Break Even,$-1.50,$105.00,$132446.00,225,$105.00
2024-11-12,15:16:00,21219.75,BUY,3,0.02h,Stop Loss,$15.00,$120.00,$132461.00,225,$120.00
2024-11-12,15:19:00,21208.0,SELL,3,0.02h,Stop Loss,$3.00,$123.00,$132464.00,225,$123.00
2024-11-12,15:27:00,21224.0,BUY,3,0.02h,Stop Loss,$12.00,$135.00,$132476.00,225,$135.00
2024-11-12,15:45:00,21204.0,SELL,3,0.02h,Stop Loss,$3.00,$138.00,$132479.00,225,$138.00
2024-11-12,16:54:00,21189.75,BUY,3,0.02h,Stop Loss,$7.50,$145.50,$132486.50,225,$145.50
2024-11-12,17:00:00,21154.5,SELL,3,0.02h,Stop Loss,$34.50,$180.00,$132521.00,225,$180.00
2024-11-12,17:30:00,21159.0,BUY,3,0.02h,Break Even,$-1.50,$178.50,$132519.50,225,$178.50
2024-11-12,17:44:00,21140.5,SELL,3,0.02h,Break Even,$-1.50,$177.00,$132518.00,225,$177.00
2024-11-12,18:16:00,21110.0,BUY,3,0.02h,Stop Loss,$25.50,$202.50,$132543.50,225,$202.50
2024-11-12,19:54:00,21195.75,SELL,3,0.02h,Stop Loss,$12.00,$214.50,$132555.50,225,$214.50
2024-11-12,20:38:00,21190.25,BUY,3,0.02h,Stop Loss,$7.50,$222.00,$132563.00,225,$222.00
2024-11-12,20:53:00,21180.5,SELL,3,0.02h,Stop Loss,$7.50,$229.50,$132570.50,225,$229.50
2024-11-12,21:03:00,21194.25,BUY,3,0.02h,Stop Loss,$-9.00,$220.50,$132561.50,225,$220.50
2024-11-12,21:20:00,21190.5,SELL,3,0.02h,Break Even,$-1.50,$219.00,$132560.00,225,$219.00
2024-11-12,21:26:00,21192.5,BUY,3,0.02h,Break Even,$-1.50,$217.50,$132558.50,225,$217.50
2024-11-12,21:38:00,21189.75,SELL,3,0.02h,Break Even,$-1.50,$216.00,$132557.00,225,$216.00
,,,,,,,,,,,
2024-11-13,12:24:00,21155.5,BUY,3,0.02h,Stop Loss,$-9.00,$-9.00,$132548.00,226,$-9.00
2024-11-13,12:37:00,21143.25,SELL,3,0.02h,Stop Loss,$12.00,$3.00,$132560.00,226,$3.00
2024-11-13,13:11:00,21133.75,BUY,3,0.02h,Break Even,$-1.50,$1.50,$132558.50,226,$1.50
2024-11-13,13:56:00,21180.5,SELL,3,0.02h,Stop Loss,$28.50,$30.00,$132587.00,226,$30.00
2024-11-13,14:23:00,21188.5,BUY,3,0.02h,Stop Loss,$-9.00,$21.00,$132578.00,226,$21.00
2024-11-13,14:28:00,21173.5,SELL,3,0.02h,Stop Loss,$67.50,$88.50,$132645.50,226,$88.50
2024-11-13,15:33:00,21123.75,BUY,3,0.02h,Stop Loss,$37.50,$126.00,$132683.00,226,$126.00
2024-11-13,15:52:00,21101.75,SELL,3,0.02h,Stop Loss,$4.50,$130.50,$132687.50,226,$130.50
2024-11-13,15:56:00,21126.0,BUY,3,0.02h,Break Even,$-1.50,$129.00,$132686.00,226,$129.00
2024-11-13,16:04:00,21109.75,SELL,3,0.02h,Break Even,$-1.50,$127.50,$132684.50,226,$127.50
2024-11-13,16:11:00,21117.25,BUY,3,0.02h,Stop Loss,$37.50,$165.00,$132722.00,226,$165.00
2024-11-13,16:42:00,21125.5,SELL,3,0.02h,Stop Loss,$111.00,$276.00,$132833.00,226,$276.00
2024-11-13,16:49:00,21153.25,BUY,3,0.02h,Stop Loss,$24.00,$300.00,$132857.00,226,$300.00
2024-11-13,17:45:00,21173.0,SELL,3,0.02h,Stop Loss,$-9.00,$291.00,$132848.00,226,$291.00
2024-11-13,17:48:00,21202.5,BUY,3,0.02h,Stop Loss,$15.00,$306.00,$132863.00,226,$306.00
2024-11-13,18:18:00,21213.5,SELL,3,0.02h,Stop Loss,$7.50,$313.50,$132870.50,226,$313.50
2024-11-13,18:24:00,21229.5,BUY,3,0.02h,Break Even,$-1.50,$312.00,$132869.00,226,$312.00
2024-11-13,19:06:00,21231.5,SELL,3,0.02h,Break Even,$-1.50,$310.50,$132867.50,226,$310.50
2024-11-13,20:15:00,21189.0,BUY,3,0.02h,Stop Loss,$25.50,$336.00,$132893.00,226,$336.00
2024-11-13,20:29:00,21180.25,SELL,3,0.02h,Break Even,$-1.50,$334.50,$132891.50,226,$334.50
2024-11-13,20:35:00,21202.5,BUY,3,0.02h,Stop Loss,$84.00,$418.50,$132975.50,226,$418.50
2024-11-13,20:50:00,21192.5,SELL,3,0.02h,Stop Loss,$135.00,$553.50,$133110.50,226,$553.50
2024-11-13,21:13:00,21169.25,BUY,3,0.02h,Stop Loss,$15.00,$568.50,$133125.50,226,$568.50
2024-11-13,21:49:00,21168.75,SELL,3,0.02h,Break Even,$-1.50,$567.00,$133124.00,226,$567.00
,,,,,,,,,,,
2024-11-14,12:02:00,21175.25,BUY,3,0.02h,Break Even,$-1.50,$-1.50,$133122.50,227,$-1.50
2024-11-14,12:07:00,21168.5,SELL,3,0.02h,Break Even,$-1.50,$-3.00,$133121.00,227,$-3.00
2024-11-14,12:19:00,21171.5,BUY,3,0.02h,Stop Loss,$-9.00,$-12.00,$133112.00,227,$-12.00
2024-11-14,12:22:00,21167.75,SELL,3,0.02h,Break Even,$-1.50,$-13.50,$133110.50,227,$-13.50
2024-11-14,12:33:00,21172.25,BUY,3,0.02h,Break Even,$-1.50,$-15.00,$133109.00,227,$-15.00
2024-11-14,12:49:00,21164.75,SELL,3,0.02h,Break Even,$-1.50,$-16.50,$133107.50,227,$-16.50
2024-11-14,13:15:00,21169.5,BUY,3,0.02h,Break Even,$-1.50,$-18.00,$133106.00,227,$-18.00
2024-11-14,13:32:00,21135.0,SELL,3,0.02h,Stop Loss,$-9.00,$-27.00,$133097.00,227,$-27.00
2024-11-14,14:14:00,21139.75,BUY,3,0.02h,Break Even,$-1.50,$-28.50,$133095.50,227,$-28.50
2024-11-14,14:19:00,21133.25,SELL,3,0.02h,Break Even,$-1.50,$-30.00,$133094.00,227,$-30.00
2024-11-14,14:31:00,21161.0,BUY,3,0.02h,Stop Loss,$7.50,$-22.50,$133101.50,227,$-22.50
2024-11-14,14:42:00,21098.75,SELL,3,0.02h,Break Even,$-1.50,$-24.00,$133100.00,227,$-24.00
2024-11-14,15:15:00,21107.0,BUY,3,0.02h,Break Even,$-1.50,$-25.50,$133098.50,227,$-25.50
2024-11-14,15:18:00,21091.5,SELL,3,0.02h,Stop Loss,$130.50,$105.00,$133229.00,227,$105.00
2024-11-14,15:31:00,21097.0,BUY,3,0.02h,Break Even,$-1.50,$103.50,$133227.50,227,$103.50
2024-11-14,15:59:00,21094.5,SELL,3,0.02h,Stop Loss,$54.00,$157.50,$133281.50,227,$157.50
2024-11-14,16:25:00,21112.5,BUY,3,0.02h,Stop Loss,$12.00,$169.50,$133293.50,227,$169.50
2024-11-14,16:54:00,21110.5,SELL,3,0.02h,Stop Loss,$28.50,$198.00,$133322.00,227,$198.00
2024-11-14,17:42:00,21074.25,BUY,3,0.02h,Break Even,$-1.50,$196.50,$133320.50,227,$196.50
2024-11-14,17:49:00,21054.5,SELL,3,0.02h,Stop Loss,$198.00,$394.50,$133518.50,227,$394.50
2024-11-14,17:56:00,21077.5,BUY,3,0.02h,Stop Loss,$3.00,$397.50,$133521.50,227,$397.50
2024-11-14,18:33:00,21089.5,SELL,3,0.02h,Stop Loss,$21.00,$418.50,$133542.50,227,$418.50
2024-11-14,19:06:00,21078.75,BUY,3,0.02h,Stop Loss,$15.00,$433.50,$133557.50,227,$433.50
2024-11-14,19:14:00,21055.75,SELL,3,0.02h,Stop Loss,$13.50,$447.00,$133571.00,227,$447.00
2024-11-14,19:30:00,21066.0,BUY,3,0.02h,Break Even,$-1.50,$445.50,$133569.50,227,$445.50
2024-11-14,19:48:00,21057.25,SELL,3,0.02h,Stop Loss,$16.50,$462.00,$133586.00,227,$462.00
2024-11-14,19:53:00,21077.25,BUY,3,0.02h,Stop Loss,$58.50,$520.50,$133644.50,227,$520.50
2024-11-14,20:01:00,21042.25,SELL,3,0.02h,Stop Loss,$28.50,$549.00,$133673.00,227,$549.00
2024-11-14,20:29:00,21032.25,BUY,3,0.02h,Stop Loss,$24.00,$573.00,$133697.00,227,$573.00
2024-11-14,20:31:00,21016.0,SELL,3,0.02h,Stop Loss,$42.00,$615.00,$133739.00,227,$615.00
2024-11-14,21:00:00,21008.75,BUY,3,0.02h,Stop Loss,$3.00,$618.00,$133742.00,227,$618.00
2024-11-14,21:05:00,20994.75,SELL,3,0.02h,Break Even,$-1.50,$616.50,$133740.50,227,$616.50
2024-11-14,21:36:00,20982.0,BUY,3,0.02h,Stop Loss,$-9.00,$607.50,$133731.50,227,$607.50
,,,,,,,,,,,
2024-11-15,12:00:00,20844.0,SELL,3,0.02h,Stop Loss,$9.00,$9.00,$133740.50,228,$9.00
2024-11-15,12:50:00,20854.75,BUY,3,0.02h,Break Even,$-1.50,$7.50,$133739.00,228,$7.50
2024-11-15,13:07:00,20851.0,SELL,3,0.02h,Break Even,$-1.50,$6.00,$133737.50,228,$6.00
2024-11-15,16:19:00,20566.75,BUY,3,0.02h,Stop Loss,$25.50,$31.50,$133763.00,228,$31.50
2024-11-15,16:38:00,20550.5,SELL,3,0.02h,Stop Loss,$22.50,$54.00,$133785.50,228,$54.00
2024-11-15,17:45:00,20502.75,BUY,3,0.02h,Stop Loss,$34.50,$88.50,$133820.00,228,$88.50
2024-11-15,17:51:00,20467.25,SELL,3,0.02h,Stop Loss,$-9.00,$79.50,$133811.00,228,$79.50
2024-11-15,19:08:00,20440.25,BUY,3,0.02h,Stop Loss,$70.50,$150.00,$133881.50,228,$150.00
2024-11-15,19:21:00,20434.75,SELL,3,0.02h,Stop Loss,$3.00,$153.00,$133884.50,228,$153.00
2024-11-15,19:41:00,20444.5,BUY,3,0.02h,Stop Loss,$30.00,$183.00,$133914.50,228,$183.00
2024-11-15,20:42:00,20468.75,SELL,3,0.02h,Stop Loss,$21.00,$204.00,$133935.50,228,$204.00
2024-11-15,20:55:00,20500.75,BUY,3,0.02h,Stop Loss,$57.00,$261.00,$133992.50,228,$261.00
2024-11-15,21:24:00,20497.25,SELL,3,0.02h,Break Even,$-1.50,$259.50,$133991.00,228,$259.50
2024-11-15,21:41:00,20499.0,BUY,3,0.02h,Stop Loss,$-9.00,$250.50,$133982.00,228,$250.50
2024-11-15,21:46:00,20495.5,SELL,3,0.02h,Stop Loss,$-9.00,$241.50,$133973.00,228,$241.50
2024-11-15,21:47:00,20498.0,BUY,3,0.02h,Stop Loss,$3.00,$244.50,$133976.00,228,$244.50
,,,,,,,,,,,
2024-11-18,12:34:00,20551.0,SELL,3,0.02h,Stop Loss,$-9.00,$-9.00,$133967.00,229,$-9.00
2024-11-18,12:37:00,20567.25,BUY,3,0.02h,Break Even,$-1.50,$-10.50,$133965.50,229,$-10.50
2024-11-18,12:54:00,20562.25,SELL,3,0.02h,Stop Loss,$-9.00,$-19.50,$133956.50,229,$-19.50
2024-11-18,13:36:00,20531.25,BUY,3,0.02h,Stop Loss,$9.00,$-10.50,$133965.50,229,$-10.50
2024-11-18,14:30:00,20557.25,SELL,3,0.02h,Stop Loss,$123.00,$112.50,$134088.50,229,$112.50
2024-11-18,15:03:00,20565.75,BUY,3,0.02h,Break Even,$-1.50,$111.00,$134087.00,229,$111.00
2024-11-18,16:49:00,20684.0,SELL,3,0.02h,Stop Loss,$46.50,$157.50,$134133.50,229,$157.50
2024-11-18,17:28:00,20663.25,BUY,3,0.02h,Stop Loss,$-9.00,$148.50,$134124.50,229,$148.50
2024-11-18,17:31:00,20651.0,SELL,3,0.02h,Break Even,$-1.50,$147.00,$134123.00,229,$147.00
2024-11-18,17:59:00,20656.75,BUY,3,0.02h,Stop Loss,$12.00,$159.00,$134135.00,229,$159.00
2024-11-18,18:27:00,20653.25,SELL,3,0.02h,Break Even,$-1.50,$157.50,$134133.50,229,$157.50
2024-11-18,18:58:00,20646.25,BUY,3,0.02h,Stop Loss,$31.50,$189.00,$134165.00,229,$189.00
2024-11-18,19:11:00,20628.75,SELL,3,0.02h,Stop Loss,$7.50,$196.50,$134172.50,229,$196.50
2024-11-18,19:42:00,20616.75,BUY,3,0.02h,Stop Loss,$9.00,$205.50,$134181.50,229,$205.50
2024-11-18,20:34:00,20632.5,SELL,3,0.02h,Break Even,$-1.50,$204.00,$134180.00,229,$204.00
2024-11-18,20:50:00,20645.25,BUY,3,0.02h,Stop Loss,$-9.00,$195.00,$134171.00,229,$195.00
2024-11-18,20:51:00,20630.5,SELL,3,0.02h,Stop Loss,$4.50,$199.50,$134175.50,229,$199.50
2024-11-18,21:03:00,20645.5,BUY,3,0.02h,Break Even,$-1.50,$198.00,$134174.00,229,$198.00
2024-11-18,21:10:00,20626.25,SELL,3,0.02h,Break Even,$-1.50,$196.50,$134172.50,229,$196.50
2024-11-18,21:44:00,20632.75,BUY,3,0.02h,Stop Loss,$-9.00,$187.50,$134163.50,229,$187.50
,,,,,,,,,,,
2024-11-19,12:00:00,20580.0,SELL,3,0.02h,Break Even,$-1.50,$-1.50,$134162.00,230,$-1.50
2024-11-19,12:15:00,20616.75,BUY,3,0.02h,Break Even,$-1.50,$-3.00,$134160.50,230,$-3.00
2024-11-19,12:17:00,20608.5,SELL,3,0.02h,Stop Loss,$6.00,$3.00,$134166.50,230,$3.00
2024-11-19,12:55:00,20609.25,BUY,3,0.02h,Break Even,$-1.50,$1.50,$134165.00,230,$1.50
2024-11-19,13:10:00,20602.0,SELL,3,0.02h,Break Even,$-1.50,$0.00,$134163.50,230,$0.00
2024-11-19,14:12:00,20481.75,BUY,3,0.02h,Stop Loss,$9.00,$9.00,$134172.50,230,$9.00
2024-11-19,15:01:00,20526.5,SELL,3,0.02h,Stop Loss,$-9.00,$0.00,$134163.50,230,$0.00
2024-11-19,15:02:00,20552.5,BUY,3,0.02h,Break Even,$-1.50,$-1.50,$134162.00,230,$-1.50
2024-11-19,15:03:00,20524.75,SELL,3,0.02h,Stop Loss,$-9.00,$-10.50,$134153.00,230,$-10.50
2024-11-19,15:07:00,20560.75,BUY,3,0.02h,Stop Loss,$4.50,$-6.00,$134157.50,230,$-6.00
2024-11-19,16:54:00,20671.0,SELL,3,0.02h,Stop Loss,$27.00,$21.00,$134184.50,230,$21.00
2024-11-19,17:14:00,20675.75,BUY,3,0.02h,Break Even,$-1.50,$19.50,$134183.00,230,$19.50
2024-11-19,17:22:00,20660.75,SELL,3,0.02h,Stop Loss,$87.00,$106.50,$134270.00,230,$106.50
2024-11-19,17:30:00,20685.0,BUY,3,0.02h,Stop Loss,$-9.00,$97.50,$134261.00,230,$97.50
2024-11-19,17:54:00,20684.5,SELL,3,0.02h,Stop Loss,$-9.00,$88.50,$134252.00,230,$88.50
2024-11-19,17:56:00,20693.75,BUY,3,0.02h,Stop Loss,$-9.00,$79.50,$134243.00,230,$79.50
2024-11-19,18:02:00,20683.75,SELL,3,0.02h,Break Even,$-1.50,$78.00,$134241.50,230,$78.00
2024-11-19,18:04:00,20691.75,BUY,3,0.02h,Stop Loss,$9.00,$87.00,$134250.50,230,$87.00
2024-11-19,19:18:00,20765.25,SELL,3,0.02h,Stop Loss,$9.00,$96.00,$134259.50,230,$96.00
2024-11-19,19:54:00,20744.75,BUY,3,0.02h,Stop Loss,$15.00,$111.00,$134274.50,230,$111.00
2024-11-19,20:04:00,20729.0,SELL,3,0.02h,Break Even,$-1.50,$109.50,$134273.00,230,$109.50
2024-11-19,20:07:00,20743.5,BUY,3,0.02h,Break Even,$-1.50,$108.00,$134271.50,230,$108.00
2024-11-19,21:22:00,20768.0,SELL,3,0.02h,Break Even,$-1.50,$106.50,$134270.00,230,$106.50
,,,,,,,,,,,
2024-11-20,12:00:00,20793.25,BUY,3,0.02h,Break Even,$-1.50,$-1.50,$134268.50,231,$-1.50
2024-11-20,12:36:00,20807.5,SELL,3,0.02h,Stop Loss,$-9.00,$-10.50,$134259.50,231,$-10.50
2024-11-20,12:45:00,20814.0,BUY,3,0.02h,Break Even,$-1.50,$-12.00,$134258.00,231,$-12.00
2024-11-20,13:14:00,20814.25,SELL,3,0.02h,Break Even,$-1.50,$-13.50,$134256.50,231,$-13.50
2024-11-20,13:20:00,20823.25,BUY,3,0.02h,Stop Loss,$4.50,$-9.00,$134261.00,231,$-9.00
2024-11-20,13:28:00,20817.5,SELL,3,0.02h,Break Even,$-1.50,$-10.50,$134259.50,231,$-10.50
2024-11-20,15:34:00,20561.25,BUY,3,0.02h,Stop Loss,$48.00,$37.50,$134307.50,231,$37.50
2024-11-20,16:12:00,20586.75,SELL,3,0.02h,Stop Loss,$6.00,$43.50,$134313.50,231,$43.50
2024-11-20,16:41:00,20610.0,BUY,3,0.02h,Stop Loss,$28.50,$72.00,$134342.00,231,$72.00
2024-11-20,17:11:00,20660.25,SELL,3,0.02h,Stop Loss,$34.50,$106.50,$134376.50,231,$106.50
2024-11-20,17:35:00,20637.75,BUY,3,0.02h,Stop Loss,$19.50,$126.00,$134396.00,231,$126.00
2024-11-20,17:55:00,20609.0,SELL,3,0.02h,Stop Loss,$-9.00,$117.00,$134387.00,231,$117.00
2024-11-20,18:28:00,20625.0,BUY,3,0.02h,Stop Loss,$21.00,$138.00,$134408.00,231,$138.00
2024-11-20,18:35:00,20605.75,SELL,3,0.02h,Stop Loss,$6.00,$144.00,$134414.00,231,$144.00
2024-11-20,19:03:00,20589.75,BUY,3,0.02h,Stop Loss,$13.50,$157.50,$134427.50,231,$157.50
2024-11-20,19:07:00,20570.75,SELL,3,0.02h,Stop Loss,$16.50,$174.00,$134444.00,231,$174.00
2024-11-20,19:35:00,20583.75,BUY,3,0.02h,Stop Loss,$6.00,$180.00,$134450.00,231,$180.00
2024-11-20,20:08:00,20598.25,SELL,3,0.02h,Break Even,$-1.50,$178.50,$134448.50,231,$178.50
2024-11-20,20:10:00,20610.5,BUY,3,0.02h,Stop Loss,$13.50,$192.00,$134462.00,231,$192.00
2024-11-20,21:21:00,20644.25,SELL,3,0.02h,Stop Loss,$198.00,$390.00,$134660.00,231,$390.00
2024-11-20,21:45:00,20711.75,BUY,3,0.02h,Stop Loss,$106.50,$496.50,$134766.50,231,$496.50
,,,,,,,,,,,
2024-11-21,12:37:00,20773.25,SELL,3,0.02h,Break Even,$-1.50,$-1.50,$134765.00,232,$-1.50
2024-11-21,12:43:00,20799.0,BUY,3,0.02h,Stop Loss,$37.50,$36.00,$134802.50,232,$36.00
2024-11-21,12:50:00,20774.25,SELL,3,0.02h,Stop Loss,$3.00,$39.00,$134805.50,232,$39.00
2024-11-21,13:13:00,20777.5,BUY,3,0.02h,Stop Loss,$42.00,$81.00,$134847.50,232,$81.00
2024-11-21,14:34:00,20837.0,SELL,3,0.02h,Stop Loss,$321.00,$402.00,$135168.50,232,$402.00
2024-11-21,15:17:00,20706.25,BUY,3,0.02h,Stop Loss,$-9.00,$393.00,$135159.50,232,$393.00
2024-11-21,15:24:00,20618.0,SELL,3,0.02h,Stop Loss,$150.00,$543.00,$135309.50,232,$543.00
2024-11-21,15:47:00,20615.75,BUY,3,0.02h,Stop Loss,$109.50,$652.50,$135419.00,232,$652.50
2024-11-21,16:47:00,20728.0,SELL,3,0.02h,Stop Loss,$91.50,$744.00,$135510.50,232,$744.00
2024-11-21,17:10:00,20741.5,BUY,3,0.02h,Stop Loss,$31.50,$775.50,$135542.00,232,$775.50
2024-11-21,18:19:00,20822.0,SELL,3,0.02h,Break Even,$-1.50,$774.00,$135540.50,232,$774.00
2024-11-21,18:24:00,20834.25,BUY,3,0.02h,Stop Loss,$30.00,$804.00,$135570.50,232,$804.00
2024-11-21,18:42:00,20831.0,SELL,3,0.02h,Stop Loss,$-9.00,$795.00,$135561.50,232,$795.00
2024-11-21,18:45:00,20849.75,BUY,3,0.02h,Stop Loss,$7.50,$802.50,$135569.00,232,$802.50
2024-11-21,18:53:00,20837.75,SELL,3,0.02h,Stop Loss,$12.00,$814.50,$135581.00,232,$814.50
2024-11-21,18:55:00,20852.5,BUY,3,0.02h,Stop Loss,$52.50,$867.00,$135633.50,232,$867.00
2024-11-21,19:07:00,20845.0,SELL,3,0.02h,Stop Loss,$79.50,$946.50,$135713.00,232,$946.50
2024-11-21,19:27:00,20844.5,BUY,3,0.02h,Stop Loss,$-9.00,$937.50,$135704.00,232,$937.50
2024-11-21,19:51:00,20826.5,SELL,3,0.02h,Stop Loss,$15.00,$952.50,$135719.00,232,$952.50
2024-11-21,19:59:00,20844.0,BUY,3,0.02h,Stop Loss,$16.50,$969.00,$135735.50,232,$969.00
2024-11-21,20:35:00,20852.0,SELL,3,0.02h,Stop Loss,$79.50,$1048.50,$135815.00,232,$1048.50
2024-11-21,21:52:00,20808.5,BUY,3,0.02h,Stop Loss,$-9.00,$1039.50,$135806.00,232,$1039.50
2024-11-21,21:54:00,20798.5,SELL,3,0.02h,Stop Loss,$-9.00,$1030.50,$135797.00,232,$1030.50
2024-11-21,21:55:00,20801.0,BUY,3,0.02h,Stop Loss,$-9.00,$1021.50,$135788.00,232,$1021.50
2024-11-21,21:59:00,20795.5,SELL,3,0.02h,Break Even,$-1.50,$1020.00,$135786.50,232,$1020.00
,,,,,,,,,,,
2024-11-22,12:26:00,20786.75,BUY,3,0.02h,Stop Loss,$-9.00,$-9.00,$135777.50,233,$-9.00
2024-11-22,12:28:00,20782.25,SELL,3,0.02h,Break Even,$-1.50,$-10.50,$135776.00,233,$-10.50
2024-11-22,12:30:00,20789.5,BUY,3,0.02h,Break Even,$-1.50,$-12.00,$135774.50,233,$-12.00
2024-11-22,12:32:00,20777.5,SELL,3,0.02h,Stop Loss,$-9.00,$-21.00,$135765.50,233,$-21.00
2024-11-22,12:36:00,20795.0,BUY,3,0.02h,Break Even,$-1.50,$-22.50,$135764.00,233,$-22.50
2024-11-22,12:43:00,20780.0,SELL,3,0.02h,Break Even,$-1.50,$-24.00,$135762.50,233,$-24.00
2024-11-22,12:48:00,20786.25,BUY,3,0.02h,Stop Loss,$-9.00,$-33.00,$135753.50,233,$-33.00
2024-11-22,12:49:00,20782.0,SELL,3,0.02h,Break Even,$-1.50,$-34.50,$135752.00,233,$-34.50
2024-11-22,12:51:00,20791.0,BUY,3,0.02h,Stop Loss,$-9.00,$-43.50,$135743.00,233,$-43.50
2024-11-22,13:16:00,20785.25,SELL,3,0.02h,Stop Loss,$-9.00,$-52.50,$135734.00,233,$-52.50
2024-11-22,13:21:00,20800.25,BUY,3,0.02h,Stop Loss,$73.50,$21.00,$135807.50,233,$21.00
2024-11-22,13:33:00,20790.5,SELL,3,0.02h,Break Even,$-1.50,$19.50,$135806.00,233,$19.50
2024-11-22,14:08:00,20790.5,BUY,3,0.02h,Stop Loss,$-9.00,$10.50,$135797.00,233,$10.50
2024-11-22,14:23:00,20785.75,SELL,3,0.02h,Stop Loss,$25.50,$36.00,$135822.50,233,$36.00
2024-11-22,14:33:00,20811.25,BUY,3,0.02h,Stop Loss,$43.50,$79.50,$135866.00,233,$79.50
2024-11-22,14:54:00,20798.25,SELL,3,0.02h,Stop Loss,$-9.00,$70.50,$135857.00,233,$70.50
2024-11-22,14:57:00,20835.75,BUY,3,0.02h,Stop Loss,$21.00,$91.50,$135878.00,233,$91.50
2024-11-22,15:06:00,20805.5,SELL,3,0.02h,Stop Loss,$-9.00,$82.50,$135869.00,233,$82.50
2024-11-22,15:40:00,20815.5,BUY,3,0.02h,Stop Loss,$25.50,$108.00,$135894.50,233,$108.00
2024-11-22,16:10:00,20808.5,SELL,3,0.02h,Stop Loss,$39.00,$147.00,$135933.50,233,$147.00
2024-11-22,16:40:00,20804.0,BUY,3,0.02h,Break Even,$-1.50,$145.50,$135932.00,233,$145.50
2024-11-22,16:44:00,20763.75,SELL,3,0.02h,Stop Loss,$15.00,$160.50,$135947.00,233,$160.50
2024-11-22,16:50:00,20794.25,BUY,3,0.02h,Stop Loss,$12.00,$172.50,$135959.00,233,$172.50
2024-11-22,17:36:00,20823.0,SELL,3,0.02h,Stop Loss,$25.50,$198.00,$135984.50,233,$198.00
2024-11-22,17:48:00,20827.5,BUY,3,0.02h,Stop Loss,$33.00,$231.00,$136017.50,233,$231.00
2024-11-22,18:30:00,20851.5,SELL,3,0.02h,Break Even,$-1.50,$229.50,$136016.00,233,$229.50
2024-11-22,18:32:00,20868.0,BUY,3,0.02h,Stop Loss,$12.00,$241.50,$136028.00,233,$241.50
2024-11-22,18:35:00,20857.5,SELL,3,0.02h,Break Even,$-1.50,$240.00,$136026.50,233,$240.00
2024-11-22,19:29:00,20830.5,BUY,3,0.02h,Stop Loss,$-9.00,$231.00,$136017.50,233,$231.00
2024-11-22,20:04:00,20819.25,SELL,3,0.02h,Stop Loss,$85.50,$316.50,$136103.00,233,$316.50
2024-11-22,20:26:00,20827.25,BUY,3,0.02h,Break Even,$-1.50,$315.00,$136101.50,233,$315.00
2024-11-22,20:40:00,20823.0,SELL,3,0.02h,Stop Loss,$9.00,$324.00,$136110.50,233,$324.00
2024-11-22,20:48:00,20833.0,BUY,3,0.02h,Break Even,$-1.50,$322.50,$136109.00,233,$322.50
,,,,,,,,,,,
2024-11-25,12:33:00,20946.75,SELL,3,0.02h,Stop Loss,$-9.00,$-9.00,$136100.00,234,$-9.00
2024-11-25,12:35:00,20958.0,BUY,3,0.02h,Break Even,$-1.50,$-10.50,$136098.50,234,$-10.50
2024-11-25,13:02:00,20956.25,SELL,3,0.02h,Break Even,$-1.50,$-12.00,$136097.00,234,$-12.00
2024-11-25,13:27:00,20955.75,BUY,3,0.02h,Break Even,$-1.50,$-13.50,$136095.50,234,$-13.50
2024-11-25,13:32:00,20949.0,SELL,3,0.02h,Stop Loss,$-9.00,$-22.50,$136086.50,234,$-22.50
2024-11-25,13:35:00,20953.5,BUY,3,0.02h,Break Even,$-1.50,$-24.00,$136085.00,234,$-24.00
2024-11-25,14:30:00,21016.25,SELL,3,0.02h,Stop Loss,$223.50,$199.50,$136308.50,234,$199.50
2024-11-25,14:40:00,21054.75,BUY,3,0.02h,Stop Loss,$40.50,$240.00,$136349.00,234,$240.00
2024-11-25,14:52:00,20973.25,SELL,3,0.02h,Stop Loss,$154.50,$394.50,$136503.50,234,$394.50
2024-11-25,15:31:00,20940.25,BUY,3,0.02h,Stop Loss,$-9.00,$385.50,$136494.50,234,$385.50
2024-11-25,15:34:00,20890.75,SELL,3,0.02h,Stop Loss,$49.50,$435.00,$136544.00,234,$435.00
2024-11-25,15:44:00,20936.0,BUY,3,0.02h,Stop Loss,$33.00,$468.00,$136577.00,234,$468.00
2024-11-25,15:56:00,20911.25,SELL,3,0.02h,Stop Loss,$76.50,$544.50,$136653.50,234,$544.50
2024-11-25,16:13:00,20917.5,BUY,3,0.02h,Stop Loss,$7.50,$552.00,$136661.00,234,$552.00
2024-11-25,16:37:00,20907.0,SELL,3,0.02h,Stop Loss,$40.50,$592.50,$136701.50,234,$592.50
2024-11-25,17:54:00,20845.0,BUY,3,0.02h,Stop Loss,$13.50,$606.00,$136715.00,234,$606.00
2024-11-25,18:32:00,20864.5,SELL,3,0.02h,Stop Loss,$-9.00,$597.00,$136706.00,234,$597.00
2024-11-25,18:33:00,20874.75,BUY,3,0.02h,Stop Loss,$42.00,$639.00,$136748.00,234,$639.00
2024-11-25,18:44:00,20866.25,SELL,3,0.02h,Stop Loss,$45.00,$684.00,$136793.00,234,$684.00
2024-11-25,19:11:00,20864.25,BUY,3,0.02h,Break Even,$-1.50,$682.50,$136791.50,234,$682.50
2024-11-25,19:23:00,20844.25,SELL,3,0.02h,Stop Loss,$91.50,$774.00,$136883.00,234,$774.00
2024-11-25,19:44:00,20857.25,BUY,3,0.02h,Break Even,$-1.50,$772.50,$136881.50,234,$772.50
2024-11-25,20:03:00,20848.75,SELL,3,0.02h,Stop Loss,$31.50,$804.00,$136913.00,234,$804.00
2024-11-25,20:26:00,20856.5,BUY,3,0.02h,Break Even,$-1.50,$802.50,$136911.50,234,$802.50
2024-11-25,21:42:00,20897.5,SELL,3,0.02h,Stop Loss,$-9.00,$793.50,$136902.50,234,$793.50
2024-11-25,21:58:00,20902.5,BUY,3,0.02h,Stop Loss,$-9.00,$784.50,$136893.50,234,$784.50
,,,,,,,,,,,
2024-11-26,12:58:00,20938.25,SELL,3,0.02h,Stop Loss,$-9.00,$-9.00,$136884.50,235,$-9.00
2024-11-26,12:59:00,20947.25,BUY,3,0.02h,Break Even,$-1.50,$-10.50,$136883.00,235,$-10.50
2024-11-26,13:02:00,20941.75,SELL,3,0.02h,Stop Loss,$18.00,$7.50,$136901.00,235,$7.50
2024-11-26,13:34:00,20936.5,BUY,3,0.02h,Stop Loss,$-9.00,$-1.50,$136892.00,235,$-1.50
2024-11-26,14:24:00,20947.0,SELL,3,0.02h,Break Even,$-1.50,$-3.00,$136890.50,235,$-3.00
2024-11-26,14:33:00,20981.0,BUY,3,0.02h,Stop Loss,$31.50,$28.50,$136922.00,235,$28.50
2024-11-26,14:57:00,20957.0,SELL,3,0.02h,Break Even,$-1.50,$27.00,$136920.50,235,$27.00
2024-11-26,15:32:00,20966.0,BUY,3,0.02h,Stop Loss,$28.50,$55.50,$136949.00,235,$55.50
2024-11-26,15:54:00,20957.5,SELL,3,0.02h,Stop Loss,$-9.00,$46.50,$136940.00,235,$46.50
2024-11-26,15:58:00,20971.0,BUY,3,0.02h,Stop Loss,$22.50,$69.00,$136962.50,235,$69.00
2024-11-26,16:00:00,20950.0,SELL,3,0.02h,Stop Loss,$-9.00,$60.00,$136953.50,235,$60.00
2024-11-26,16:03:00,20977.5,BUY,3,0.02h,Stop Loss,$16.50,$76.50,$136970.00,235,$76.50
2024-11-26,16:12:00,20957.5,SELL,3,0.02h,Stop Loss,$12.00,$88.50,$136982.00,235,$88.50
2024-11-26,16:33:00,20960.5,BUY,3,0.02h,Stop Loss,$-9.00,$79.50,$136973.00,235,$79.50
2024-11-26,16:34:00,20953.75,SELL,3,0.02h,Break Even,$-1.50,$78.00,$136971.50,235,$78.00
2024-11-26,16:35:00,20959.25,BUY,3,0.02h,Stop Loss,$-9.00,$69.00,$136962.50,235,$69.00
2024-11-26,16:36:00,20956.0,SELL,3,0.02h,Stop Loss,$52.50,$121.50,$137015.00,235,$121.50
2024-11-26,16:40:00,20963.75,BUY,3,0.02h,Stop Loss,$-9.00,$112.50,$137006.00,235,$112.50
2024-11-26,16:42:00,20948.5,SELL,3,0.02h,Break Even,$-1.50,$111.00,$137004.50,235,$111.00
2024-11-26,16:55:00,20961.0,BUY,3,0.02h,Stop Loss,$9.00,$120.00,$137013.50,235,$120.00
2024-11-26,17:07:00,20945.75,SELL,3,0.02h,Break Even,$-1.50,$118.50,$137012.00,235,$118.50
2024-11-26,17:11:00,20958.25,BUY,3,0.02h,Stop Loss,$-9.00,$109.50,$137003.00,235,$109.50
2024-11-26,17:13:00,20943.5,SELL,3,0.02h,Stop Loss,$7.50,$117.00,$137010.50,235,$117.00
2024-11-26,17:33:00,20947.0,BUY,3,0.02h,Stop Loss,$22.50,$139.50,$137033.00,235,$139.50
2024-11-26,18:11:00,20965.5,SELL,3,0.02h,Break Even,$-1.50,$138.00,$137031.50,235,$138.00
2024-11-26,18:34:00,20966.25,BUY,3,0.02h,Break Even,$-1.50,$136.50,$137030.00,235,$136.50
2024-11-26,18:37:00,20954.75,SELL,3,0.02h,Stop Loss,$3.00,$139.50,$137033.00,235,$139.50
2024-11-26,18:41:00,20966.75,BUY,3,0.02h,Stop Loss,$24.00,$163.50,$137057.00,235,$163.50
2024-11-26,18:58:00,20963.0,SELL,3,0.02h,Stop Loss,$-9.00,$154.50,$137048.00,235,$154.50
2024-11-26,18:59:00,20968.25,BUY,3,0.02h,Break Even,$-1.50,$153.00,$137046.50,235,$153.00
2024-11-26,19:08:00,20958.75,SELL,3,0.02h,Break Even,$-1.50,$151.50,$137045.00,235,$151.50
2024-11-26,19:41:00,20933.25,BUY,3,0.02h,Stop Loss,$30.00,$181.50,$137075.00,235,$181.50
2024-11-26,19:44:00,20925.75,SELL,3,0.02h,Stop Loss,$-9.00,$172.50,$137066.00,235,$172.50
2024-11-26,19:49:00,20935.0,BUY,3,0.02h,Break Even,$-1.50,$171.00,$137064.50,235,$171.00
2024-11-26,19:55:00,20925.75,SELL,3,0.02h,Break Even,$-1.50,$169.50,$137063.00,235,$169.50
2024-11-26,20:02:00,20936.75,BUY,3,0.02h,Break Even,$-1.50,$168.00,$137061.50,235,$168.00
2024-11-26,20:23:00,20938.5,SELL,3,0.02h,Break Even,$-1.50,$166.50,$137060.00,235,$166.50
2024-11-26,20:25:00,20945.0,BUY,3,0.02h,Stop Loss,$21.00,$187.50,$137081.00,235,$187.50
2024-11-26,21:33:00,20993.5,SELL,3,0.02h,Break Even,$-1.50,$186.00,$137079.50,235,$186.00
2024-11-26,21:38:00,21001.0,BUY,3,0.02h,Break Even,$-1.50,$184.50,$137078.00,235,$184.50
,,,,,,,,,,,
2024-11-27,12:00:00,20930.25,SELL,3,0.02h,Stop Loss,$-9.00,$-9.00,$137069.00,236,$-9.00
2024-11-27,12:39:00,20941.5,BUY,3,0.02h,Stop Loss,$-9.00,$-18.00,$137060.00,236,$-18.00
2024-11-27,13:35:00,20947.0,SELL,3,0.02h,Stop Loss,$7.50,$-10.50,$137067.50,236,$-10.50
2024-11-27,13:44:00,20962.25,BUY,3,0.02h,Stop Loss,$-9.00,$-19.50,$137058.50,236,$-19.50
2024-11-27,13:48:00,20949.5,SELL,3,0.02h,Break Even,$-1.50,$-21.00,$137057.00,236,$-21.00
2024-11-27,13:55:00,20959.25,BUY,3,0.02h,Break Even,$-1.50,$-22.50,$137055.50,236,$-22.50
2024-11-27,13:59:00,20951.25,SELL,3,0.02h,Stop Loss,$-9.00,$-31.50,$137046.50,236,$-31.50
2024-11-27,14:18:00,20950.75,BUY,3,0.02h,Stop Loss,$-9.00,$-40.50,$137037.50,236,$-40.50
2024-11-27,14:25:00,20945.0,SELL,3,0.02h,Stop Loss,$-9.00,$-49.50,$137028.50,236,$-49.50
2024-11-27,14:27:00,20953.0,BUY,3,0.02h,Stop Loss,$-9.00,$-58.50,$137019.50,236,$-58.50
2024-11-27,14:28:00,20941.5,SELL,3,0.02h,Stop Loss,$31.50,$-27.00,$137051.00,236,$-27.00
2024-11-27,16:33:00,20736.75,BUY,3,0.02h,Break Even,$-1.50,$-28.50,$137049.50,236,$-28.50
2024-11-27,16:47:00,20714.25,SELL,3,0.02h,Stop Loss,$10.50,$-18.00,$137060.00,236,$-18.00
2024-11-27,17:20:00,20717.0,BUY,3,0.02h,Stop Loss,$30.00,$12.00,$137090.00,236,$12.00
2024-11-27,19:30:00,20801.5,SELL,3,0.02h,Break Even,$-1.50,$10.50,$137088.50,236,$10.50
2024-11-27,19:43:00,20810.25,BUY,3,0.02h,Stop Loss,$27.00,$37.50,$137115.50,236,$37.50
2024-11-27,20:00:00,20804.25,SELL,3,0.02h,Break Even,$-1.50,$36.00,$137114.00,236,$36.00
2024-11-27,20:05:00,20823.25,BUY,3,0.02h,Stop Loss,$19.50,$55.50,$137133.50,236,$55.50
2024-11-27,20:19:00,20808.5,SELL,3,0.02h,Stop Loss,$22.50,$78.00,$137156.00,236,$78.00
2024-11-27,20:50:00,20803.5,BUY,3,0.02h,Stop Loss,$39.00,$117.00,$137195.00,236,$117.00
2024-11-27,21:17:00,20803.0,SELL,3,0.02h,Stop Loss,$-9.00,$108.00,$137186.00,236,$108.00
2024-11-27,21:23:00,20811.0,BUY,3,0.02h,Break Even,$-1.50,$106.50,$137184.50,236,$106.50
2024-11-27,21:28:00,20806.5,SELL,3,0.02h,Stop Loss,$-9.00,$97.50,$137175.50,236,$97.50
2024-11-27,21:50:00,20806.25,BUY,3,0.02h,Stop Loss,$-9.00,$88.50,$137166.50,236,$88.50
,,,,,,,,,,,
2024-11-28,13:19:00,20869.75,SELL,3,0.02h,Break Even,$-1.50,$-1.50,$137165.00,237,$-1.50
2024-11-28,13:41:00,20872.25,BUY,3,0.03h,Break Even,$-1.50,$-3.00,$137163.50,237,$-3.00
2024-11-28,14:02:00,20871.5,SELL,3,0.02h,Stop Loss,$3.00,$0.00,$137166.50,237,$0.00
2024-11-28,14:16:00,20874.0,BUY,3,0.02h,Break Even,$-1.50,$-1.50,$137165.00,237,$-1.50
2024-11-28,15:11:00,20885.5,SELL,3,0.02h,Stop Loss,$-9.00,$-10.50,$137156.00,237,$-10.50
2024-11-28,15:19:00,20894.75,BUY,3,0.02h,Break Even,$-1.50,$-12.00,$137154.50,237,$-12.00
2024-11-28,15:38:00,20889.25,SELL,3,0.02h,Break Even,$-1.50,$-13.50,$137153.00,237,$-13.50
2024-11-28,15:46:00,20898.25,BUY,3,0.02h,Break Even,$-1.50,$-15.00,$137151.50,237,$-15.00
2024-11-28,16:25:00,20901.0,SELL,3,0.02h,Break Even,$-1.50,$-16.50,$137150.00,237,$-16.50
2024-11-28,17:03:00,20888.25,BUY,3,0.02h,Break Even,$-1.50,$-18.00,$137148.50,237,$-18.00
2024-11-28,17:47:00,20888.25,SELL,3,0.02h,Stop Loss,$10.50,$-7.50,$137159.00,237,$-7.50
,,,,,,,,,,,
2024-11-29,13:10:00,20860.0,BUY,3,0.02h,Break Even,$-1.50,$-1.50,$137157.50,238,$-1.50
2024-11-29,13:17:00,20845.75,SELL,3,0.02h,Break Even,$-1.50,$-3.00,$137156.00,238,$-3.00
2024-11-29,14:02:00,20842.0,BUY,3,0.02h,Stop Loss,$6.00,$3.00,$137162.00,238,$3.00
2024-11-29,14:29:00,20828.0,SELL,3,0.02h,Stop Loss,$15.00,$18.00,$137177.00,238,$18.00
2024-11-29,14:40:00,20865.25,BUY,3,0.02h,Stop Loss,$-9.00,$9.00,$137168.00,238,$9.00
2024-11-29,15:50:00,20943.5,SELL,3,0.02h,Stop Loss,$21.00,$30.00,$137189.00,238,$30.00
2024-11-29,16:02:00,20965.5,BUY,3,0.02h,Stop Loss,$18.00,$48.00,$137207.00,238,$48.00
2024-11-29,16:36:00,20976.0,SELL,3,0.02h,Stop Loss,$25.50,$73.50,$137232.50,238,$73.50
2024-11-29,16:45:00,20986.0,BUY,3,0.02h,Break Even,$-1.50,$72.00,$137231.00,238,$72.00
2024-11-29,17:03:00,20983.0,SELL,3,0.02h,Stop Loss,$-9.00,$63.00,$137222.00,238,$63.00
2024-11-29,17:09:00,20996.0,BUY,3,0.02h,Stop Loss,$12.00,$75.00,$137234.00,238,$75.00
2024-11-29,17:15:00,20991.0,SELL,3,0.02h,Break Even,$-1.50,$73.50,$137232.50,238,$73.50
2024-11-29,17:16:00,20996.75,BUY,3,0.02h,Break Even,$-1.50,$72.00,$137231.00,238,$72.00
2024-11-29,17:28:00,20984.25,SELL,3,0.02h,Stop Loss,$4.50,$76.50,$137235.50,238,$76.50
2024-11-29,17:34:00,21000.75,BUY,3,0.02h,Stop Loss,$4.50,$81.00,$137240.00,238,$81.00
2024-11-29,17:47:00,20993.25,SELL,3,0.02h,Stop Loss,$7.50,$88.50,$137247.50,238,$88.50
2024-11-29,17:51:00,21015.25,BUY,3,0.02h,Break Even,$-1.50,$87.00,$137246.00,238,$87.00
2024-11-29,18:00:00,20991.25,SELL,3,0.02h,Stop Loss,$7.50,$94.50,$137253.50,238,$94.50
,,,,,,,,,,,
2024-12-02,12:11:00,20995.25,BUY,3,0.02h,Break Even,$-1.50,$-1.50,$137252.00,239,$-1.50
2024-12-02,13:41:00,21021.0,SELL,3,0.02h,Stop Loss,$42.00,$40.50,$137294.00,239,$40.50
2024-12-02,13:59:00,21024.75,BUY,3,0.02h,Break Even,$-1.50,$39.00,$137292.50,239,$39.00
2024-12-02,14:27:00,21027.75,SELL,3,0.02h,Stop Loss,$-9.00,$30.00,$137283.50,239,$30.00
2024-12-02,14:30:00,21043.0,BUY,3,0.02h,Stop Loss,$100.50,$130.50,$137384.00,239,$130.50
2024-12-02,15:49:00,21181.0,SELL,3,0.02h,Stop Loss,$12.00,$142.50,$137396.00,239,$142.50
2024-12-02,16:08:00,21181.5,BUY,3,0.02h,Break Even,$-1.50,$141.00,$137394.50,239,$141.00
2024-12-02,16:26:00,21177.25,SELL,3,0.02h,Stop Loss,$-9.00,$132.00,$137385.50,239,$132.00
2024-12-02,16:27:00,21183.75,BUY,3,0.02h,Break Even,$-1.50,$130.50,$137384.00,239,$130.50
2024-12-02,17:30:00,21233.5,SELL,3,0.02h,Stop Loss,$27.00,$157.50,$137411.00,239,$157.50
2024-12-02,17:47:00,21244.5,BUY,3,0.02h,Stop Loss,$-9.00,$148.50,$137402.00,239,$148.50
2024-12-02,17:55:00,21235.5,SELL,3,0.02h,Break Even,$-1.50,$147.00,$137400.50,239,$147.00
2024-12-02,18:25:00,21232.75,BUY,3,0.02h,Stop Loss,$-9.00,$138.00,$137391.50,239,$138.00
2024-12-02,18:30:00,21212.25,SELL,3,0.02h,Stop Loss,$73.50,$211.50,$137465.00,239,$211.50
2024-12-02,18:43:00,21221.5,BUY,3,0.02h,Break Even,$-1.50,$210.00,$137463.50,239,$210.00
2024-12-02,18:54:00,21211.25,SELL,3,0.02h,Break Even,$-1.50,$208.50,$137462.00,239,$208.50
2024-12-02,19:33:00,21198.75,BUY,3,0.02h,Stop Loss,$-9.00,$199.50,$137453.00,239,$199.50
2024-12-02,20:45:00,21224.0,SELL,3,0.02h,Break Even,$-1.50,$198.00,$137451.50,239,$198.00
2024-12-02,21:07:00,21225.5,BUY,3,0.02h,Break Even,$-1.50,$196.50,$137450.00,239,$196.50
2024-12-02,21:30:00,21225.0,SELL,3,0.02h,Break Even,$-1.50,$195.00,$137448.50,239,$195.00
2024-12-02,21:40:00,21229.0,BUY,3,0.02h,Stop Loss,$-9.00,$186.00,$137439.50,239,$186.00
2024-12-02,21:43:00,21218.0,SELL,3,0.02h,Stop Loss,$19.50,$205.50,$137459.00,239,$205.50
,,,,,,,,,,,
2024-12-03,12:26:00,21208.75,BUY,3,0.02h,Break Even,$-1.50,$-1.50,$137457.50,240,$-1.50
2024-12-03,12:49:00,21208.5,SELL,3,0.02h,Break Even,$-1.50,$-3.00,$137456.00,240,$-3.00
2024-12-03,13:09:00,21213.25,BUY,3,0.02h,Stop Loss,$-9.00,$-12.00,$137447.00,240,$-12.00
2024-12-03,13:10:00,21207.75,SELL,3,0.02h,Stop Loss,$-9.00,$-21.00,$137438.00,240,$-21.00
2024-12-03,13:11:00,21211.0,BUY,3,0.02h,Break Even,$-1.50,$-22.50,$137436.50,240,$-22.50
2024-12-03,13:19:00,21204.75,SELL,3,0.02h,Stop Loss,$-9.00,$-31.50,$137427.50,240,$-31.50
2024-12-03,13:26:00,21213.0,BUY,3,0.02h,Stop Loss,$-9.00,$-40.50,$137418.50,240,$-40.50
2024-12-03,13:28:00,21208.5,SELL,3,0.02h,Stop Loss,$-9.00,$-49.50,$137409.50,240,$-49.50
2024-12-03,13:29:00,21209.75,BUY,3,0.02h,Break Even,$-1.50,$-51.00,$137408.00,240,$-51.00
2024-12-03,13:30:00,21207.0,SELL,3,0.02h,Break Even,$-1.50,$-52.50,$137406.50,240,$-52.50
2024-12-03,13:36:00,21211.25,BUY,3,0.02h,Stop Loss,$-9.00,$-61.50,$137397.50,240,$-61.50
2024-12-03,13:57:00,21209.0,SELL,3,0.02h,Stop Loss,$19.50,$-42.00,$137417.00,240,$-42.00
2024-12-03,14:36:00,21186.0,BUY,3,0.02h,Stop Loss,$36.00,$-6.00,$137453.00,240,$-6.00
2024-12-03,15:21:00,21188.5,SELL,3,0.02h,Stop Loss,$27.00,$21.00,$137480.00,240,$21.00
2024-12-03,15:37:00,21207.0,BUY,3,0.02h,Stop Loss,$-9.00,$12.00,$137471.00,240,$12.00
2024-12-03,15:43:00,21192.75,SELL,3,0.02h,Stop Loss,$28.50,$40.50,$137499.50,240,$40.50
2024-12-03,16:00:00,21207.5,BUY,3,0.02h,Stop Loss,$10.50,$51.00,$137510.00,240,$51.00
2024-12-03,16:38:00,21216.5,SELL,3,0.02h,Stop Loss,$3.00,$54.00,$137513.00,240,$54.00
2024-12-03,16:55:00,21223.75,BUY,3,0.02h,Break Even,$-1.50,$52.50,$137511.50,240,$52.50
2024-12-03,16:58:00,21217.0,SELL,3,0.02h,Stop Loss,$18.00,$70.50,$137529.50,240,$70.50
2024-12-03,17:23:00,21215.0,BUY,3,0.02h,Stop Loss,$-9.00,$61.50,$137520.50,240,$61.50
2024-12-03,17:25:00,21206.25,SELL,3,0.02h,Break Even,$-1.50,$60.00,$137519.00,240,$60.00
2024-12-03,17:45:00,21208.75,BUY,3,0.02h,Stop Loss,$10.50,$70.50,$137529.50,240,$70.50
2024-12-03,18:30:00,21227.5,SELL,3,0.02h,Stop Loss,$4.50,$75.00,$137534.00,240,$75.00
2024-12-03,18:54:00,21235.25,BUY,3,0.02h,Break Even,$-1.50,$73.50,$137532.50,240,$73.50
2024-12-03,19:05:00,21226.75,SELL,3,0.02h,Break Even,$-1.50,$72.00,$137531.00,240,$72.00
2024-12-03,19:10:00,21233.75,BUY,3,0.02h,Stop Loss,$-9.00,$63.00,$137522.00,240,$63.00
2024-12-03,19:17:00,21226.25,SELL,3,0.02h,Break Even,$-1.50,$61.50,$137520.50,240,$61.50
2024-12-03,19:19:00,21232.75,BUY,3,0.02h,Break Even,$-1.50,$60.00,$137519.00,240,$60.00
2024-12-03,20:19:00,21250.75,SELL,3,0.02h,Stop Loss,$-9.00,$51.00,$137510.00,240,$51.00
2024-12-03,20:21:00,21257.0,BUY,3,0.02h,Break Even,$-1.50,$49.50,$137508.50,240,$49.50
2024-12-03,20:33:00,21251.0,SELL,3,0.02h,Stop Loss,$-9.00,$40.50,$137499.50,240,$40.50
2024-12-03,20:50:00,21256.0,BUY,3,0.02h,Stop Loss,$42.00,$82.50,$137541.50,240,$82.50
,,,,,,,,,,,
2024-12-04,12:56:00,21414.75,SELL,3,0.02h,Break Even,$-1.50,$-1.50,$137540.00,241,$-1.50
2024-12-04,13:09:00,21420.75,BUY,3,0.02h,Break Even,$-1.50,$-3.00,$137538.50,241,$-3.00
2024-12-04,14:21:00,21437.75,SELL,3,0.02h,Stop Loss,$13.50,$10.50,$137552.00,241,$10.50
2024-12-04,14:51:00,21430.5,BUY,3,0.02h,Stop Loss,$-9.00,$1.50,$137543.00,241,$1.50
2024-12-04,15:01:00,21397.75,SELL,3,0.02h,Break Even,$-1.50,$0.00,$137541.50,241,$0.00
2024-12-04,15:06:00,21434.0,BUY,3,0.02h,Break Even,$-1.50,$-1.50,$137540.00,241,$-1.50
2024-12-04,16:17:00,21474.5,SELL,3,0.02h,Break Even,$-1.50,$-3.00,$137538.50,241,$-3.00
2024-12-04,16:53:00,21464.25,BUY,3,0.02h,Break Even,$-1.50,$-4.50,$137537.00,241,$-4.50
2024-12-04,17:33:00,21470.25,SELL,3,0.02h,Stop Loss,$7.50,$3.00,$137544.50,241,$3.00
2024-12-04,17:51:00,21480.5,BUY,3,0.02h,Break Even,$-1.50,$1.50,$137543.00,241,$1.50
2024-12-04,18:18:00,21479.0,SELL,3,0.02h,Break Even,$-1.50,$0.00,$137541.50,241,$0.00
2024-12-04,18:49:00,21468.5,BUY,3,0.02h,Break Even,$-1.50,$-1.50,$137540.00,241,$-1.50
2024-12-04,21:03:00,21525.25,SELL,3,0.02h,Stop Loss,$13.50,$12.00,$137553.50,241,$12.00
2024-12-04,21:43:00,21519.5,BUY,3,0.02h,Break Even,$-1.50,$10.50,$137552.00,241,$10.50
2024-12-04,21:45:00,21516.0,SELL,3,0.02h,Stop Loss,$21.00,$31.50,$137573.00,241,$31.50
2024-12-04,21:59:00,21516.5,BUY,3,0.02h,Break Even,$-1.50,$30.00,$137571.50,241,$30.00
,,,,,,,,,,,
2024-12-05,12:29:00,21521.25,SELL,3,0.02h,Stop Loss,$-9.00,$-9.00,$137562.50,242,$-9.00
2024-12-05,12:36:00,21526.5,BUY,3,0.02h,Stop Loss,$-9.00,$-18.00,$137553.50,242,$-18.00
2024-12-05,13:07:00,21526.75,SELL,3,0.02h,Break Even,$-1.50,$-19.50,$137552.00,242,$-19.50
2024-12-05,13:31:00,21530.5,BUY,3,0.02h,Break Even,$-1.50,$-21.00,$137550.50,242,$-21.00
2024-12-05,13:44:00,21523.5,SELL,3,0.02h,Stop Loss,$15.00,$-6.00,$137565.50,242,$-6.00
2024-12-05,13:58:00,21529.25,BUY,3,0.02h,Stop Loss,$-9.00,$-15.00,$137556.50,242,$-15.00
2024-12-05,14:42:00,21520.75,SELL,3,0.02h,Stop Loss,$-9.00,$-24.00,$137547.50,242,$-24.00
2024-12-05,14:46:00,21537.25,BUY,3,0.02h,Stop Loss,$15.00,$-9.00,$137562.50,242,$-9.00
2024-12-05,14:50:00,21517.5,SELL,3,0.02h,Stop Loss,$36.00,$27.00,$137598.50,242,$27.00
2024-12-05,15:10:00,21530.75,BUY,3,0.02h,Break Even,$-1.50,$25.50,$137597.00,242,$25.50
2024-12-05,15:23:00,21512.75,SELL,3,0.02h,Break Even,$-1.50,$24.00,$137595.50,242,$24.00
2024-12-05,15:34:00,21523.25,BUY,3,0.02h,Stop Loss,$-9.00,$15.00,$137586.50,242,$15.00
2024-12-05,15:42:00,21513.25,SELL,3,0.02h,Break Even,$-1.50,$13.50,$137585.00,242,$13.50
2024-12-05,15:45:00,21527.75,BUY,3,0.02h,Break Even,$-1.50,$12.00,$137583.50,242,$12.00
2024-12-05,15:49:00,21508.25,SELL,3,0.02h,Stop Loss,$34.50,$46.50,$137618.00,242,$46.50
2024-12-05,16:13:00,21513.75,BUY,3,0.02h,Stop Loss,$-9.00,$37.50,$137609.00,242,$37.50
2024-12-05,16:40:00,21518.5,SELL,3,0.02h,Break Even,$-1.50,$36.00,$137607.50,242,$36.00
2024-12-05,16:52:00,21525.75,BUY,3,0.02h,Stop Loss,$-9.00,$27.00,$137598.50,242,$27.00
2024-12-05,16:54:00,21521.75,SELL,3,0.02h,Break Even,$-1.50,$25.50,$137597.00,242,$25.50
2024-12-05,17:00:00,21530.0,BUY,3,0.02h,Break Even,$-1.50,$24.00,$137595.50,242,$24.00
2024-12-05,18:03:00,21549.0,SELL,3,0.02h,Stop Loss,$4.50,$28.50,$137600.00,242,$28.50
2024-12-05,18:42:00,21523.25,BUY,3,0.02h,Stop Loss,$-9.00,$19.50,$137591.00,242,$19.50
2024-12-05,18:50:00,21510.5,SELL,3,0.02h,Stop Loss,$28.50,$48.00,$137619.50,242,$48.00
2024-12-05,19:14:00,21503.0,BUY,3,0.02h,Stop Loss,$6.00,$54.00,$137625.50,242,$54.00
2024-12-05,19:31:00,21495.5,SELL,3,0.02h,Stop Loss,$-9.00,$45.00,$137616.50,242,$45.00
2024-12-05,20:05:00,21497.0,BUY,3,0.02h,Stop Loss,$37.50,$82.50,$137654.00,242,$82.50
2024-12-05,20:16:00,21491.0,SELL,3,0.02h,Stop Loss,$10.50,$93.00,$137664.50,242,$93.00
2024-12-05,20:42:00,21486.25,BUY,3,0.02h,Break Even,$-1.50,$91.50,$137663.00,242,$91.50
2024-12-05,20:55:00,21469.75,SELL,3,0.02h,Stop Loss,$21.00,$112.50,$137684.00,242,$112.50
2024-12-05,21:32:00,21456.25,BUY,3,0.02h,Break Even,$-1.50,$111.00,$137682.50,242,$111.00
2024-12-05,21:57:00,21455.25,SELL,3,0.03h,Break Even,$-1.50,$109.50,$137681.00,242,$109.50
,,,,,,,,,,,
2024-12-06,12:01:00,21459.0,BUY,3,0.02h,Stop Loss,$-9.00,$-9.00,$137672.00,243,$-9.00
2024-12-06,12:41:00,21471.75,SELL,3,0.02h,Stop Loss,$-9.00,$-18.00,$137663.00,243,$-18.00
2024-12-06,12:47:00,21477.75,BUY,3,0.02h,Break Even,$-1.50,$-19.50,$137661.50,243,$-19.50
2024-12-06,12:51:00,21472.5,SELL,3,0.02h,Stop Loss,$-9.00,$-28.50,$137652.50,243,$-28.50
2024-12-06,12:54:00,21477.25,BUY,3,0.02h,Break Even,$-1.50,$-30.00,$137651.00,243,$-30.00
2024-12-06,13:15:00,21478.0,SELL,3,0.02h,Stop Loss,$-9.00,$-39.00,$137642.00,243,$-39.00
2024-12-06,13:16:00,21479.0,BUY,3,0.02h,Break Even,$-1.50,$-40.50,$137640.50,243,$-40.50
2024-12-06,13:18:00,21478.0,SELL,3,0.02h,Stop Loss,$-9.00,$-49.50,$137631.50,243,$-49.50
2024-12-06,13:31:00,21508.0,BUY,3,0.02h,Stop Loss,$27.00,$-22.50,$137658.50,243,$-22.50
2024-12-06,13:51:00,21490.75,SELL,3,0.02h,Break Even,$-1.50,$-24.00,$137657.00,243,$-24.00
2024-12-06,14:03:00,21505.5,BUY,3,0.02h,Break Even,$-1.50,$-25.50,$137655.50,243,$-25.50
2024-12-06,14:07:00,21496.25,SELL,3,0.02h,Stop Loss,$-9.00,$-34.50,$137646.50,243,$-34.50
2024-12-06,14:09:00,21504.0,BUY,3,0.02h,Stop Loss,$4.50,$-30.00,$137651.00,243,$-30.00
2024-12-06,14:30:00,21491.75,SELL,3,0.02h,Stop Loss,$19.50,$-10.50,$137670.50,243,$-10.50
2024-12-06,14:32:00,21513.25,BUY,3,0.02h,Stop Loss,$31.50,$21.00,$137702.00,243,$21.00
2024-12-06,15:45:00,21619.75,SELL,3,0.02h,Stop Loss,$13.50,$34.50,$137715.50,243,$34.50
2024-12-06,16:03:00,21625.75,BUY,3,0.02h,Stop Loss,$-9.00,$25.50,$137706.50,243,$25.50
2024-12-06,16:11:00,21612.0,SELL,3,0.02h,Stop Loss,$36.00,$61.50,$137742.50,243,$61.50
2024-12-06,16:30:00,21620.25,BUY,3,0.02h,Stop Loss,$6.00,$67.50,$137748.50,243,$67.50
2024-12-06,16:48:00,21605.25,SELL,3,0.02h,Stop Loss,$-9.00,$58.50,$137739.50,243,$58.50
2024-12-06,17:10:00,21624.25,BUY,3,0.02h,Break Even,$-1.50,$57.00,$137738.00,243,$57.00
2024-12-06,17:38:00,21622.5,SELL,3,0.02h,Break Even,$-1.50,$55.50,$137736.50,243,$55.50
2024-12-06,17:55:00,21630.25,BUY,3,0.02h,Stop Loss,$-9.00,$46.50,$137727.50,243,$46.50
2024-12-06,18:34:00,21647.0,SELL,3,0.02h,Break Even,$-1.50,$45.00,$137726.00,243,$45.00
2024-12-06,18:53:00,21653.5,BUY,3,0.02h,Break Even,$-1.50,$43.50,$137724.50,243,$43.50
2024-12-06,19:04:00,21642.0,SELL,3,0.02h,Stop Loss,$-9.00,$34.50,$137715.50,243,$34.50
2024-12-06,19:41:00,21629.0,BUY,3,0.02h,Stop Loss,$-9.00,$25.50,$137706.50,243,$25.50
2024-12-06,19:43:00,21626.25,SELL,3,0.02h,Stop Loss,$-9.00,$16.50,$137697.50,243,$16.50
2024-12-06,19:44:00,21632.5,BUY,3,0.02h,Break Even,$-1.50,$15.00,$137696.00,243,$15.00
2024-12-06,20:02:00,21631.5,SELL,3,0.02h,Break Even,$-1.50,$13.50,$137694.50,243,$13.50
2024-12-06,20:08:00,21640.25,BUY,3,0.02h,Stop Loss,$-9.00,$4.50,$137685.50,243,$4.50
2024-12-06,20:50:00,21643.25,SELL,3,0.02h,Stop Loss,$18.00,$22.50,$137703.50,243,$22.50
2024-12-06,20:51:00,21653.25,BUY,3,0.02h,Stop Loss,$3.00,$25.50,$137706.50,243,$25.50
2024-12-06,21:03:00,21645.5,SELL,3,0.02h,Break Even,$-1.50,$24.00,$137705.00,243,$24.00
2024-12-06,21:55:00,21635.5,BUY,3,0.02h,Stop Loss,$-9.00,$15.00,$137696.00,243,$15.00
2024-12-06,21:56:00,21633.0,SELL,3,0.02h,Stop Loss,$-9.00,$6.00,$137687.00,243,$6.00
2024-12-06,22:58:00,21634.0,BUY,3,61.03h,Stop Loss,$-9.00,$-3.00,$137678.00,243,$-3.00
,,,,,,,,,,,
2024-12-09,12:00:00,21615.75,SELL,3,0.02h,Stop Loss,$-9.00,$-9.00,$137669.00,244,$-9.00
2024-12-09,12:29:00,21622.25,BUY,3,0.02h,Stop Loss,$-9.00,$-18.00,$137660.00,244,$-18.00
2024-12-09,12:41:00,21617.75,SELL,3,0.02h,Break Even,$-1.50,$-19.50,$137658.50,244,$-19.50
2024-12-09,12:57:00,21622.0,BUY,3,0.02h,Stop Loss,$4.50,$-15.00,$137663.00,244,$-15.00
2024-12-09,13:11:00,21614.5,SELL,3,0.02h,Break Even,$-1.50,$-16.50,$137661.50,244,$-16.50
2024-12-09,13:23:00,21620.75,BUY,3,0.02h,Stop Loss,$-9.00,$-25.50,$137652.50,244,$-25.50
2024-12-09,13:34:00,21616.0,SELL,3,0.02h,Stop Loss,$-9.00,$-34.50,$137643.50,244,$-34.50
2024-12-09,13:40:00,21623.0,BUY,3,0.02h,Break Even,$-1.50,$-36.00,$137642.00,244,$-36.00
2024-12-09,14:01:00,21617.0,SELL,3,0.02h,Stop Loss,$-9.00,$-45.00,$137633.00,244,$-45.00
2024-12-09,14:19:00,21621.25,BUY,3,0.02h,Stop Loss,$10.50,$-34.50,$137643.50,244,$-34.50
2024-12-09,14:31:00,21592.0,SELL,3,0.02h,Break Even,$-1.50,$-36.00,$137642.00,244,$-36.00
2024-12-09,14:44:00,21620.25,BUY,3,0.02h,Stop Loss,$31.50,$-4.50,$137673.50,244,$-4.50
2024-12-09,15:00:00,21623.5,SELL,3,0.02h,Break Even,$-1.50,$-6.00,$137672.00,244,$-6.00
2024-12-09,15:01:00,21628.5,BUY,3,0.02h,Break Even,$-1.50,$-7.50,$137670.50,244,$-7.50
2024-12-09,15:03:00,21618.0,SELL,3,0.02h,Break Even,$-1.50,$-9.00,$137669.00,244,$-9.00
2024-12-09,16:23:00,21498.0,BUY,3,0.02h,Stop Loss,$15.00,$6.00,$137684.00,244,$6.00
2024-12-09,16:43:00,21491.5,SELL,3,0.02h,Stop Loss,$21.00,$27.00,$137705.00,244,$27.00
2024-12-09,16:53:00,21509.75,BUY,3,0.02h,Break Even,$-1.50,$25.50,$137703.50,244,$25.50
2024-12-09,17:07:00,21498.25,SELL,3,0.02h,Break Even,$-1.50,$24.00,$137702.00,244,$24.00
2024-12-09,17:09:00,21510.25,BUY,3,0.02h,Stop Loss,$24.00,$48.00,$137726.00,244,$48.00
2024-12-09,17:17:00,21493.75,SELL,3,0.02h,Stop Loss,$3.00,$51.00,$137729.00,244,$51.00
2024-12-09,17:40:00,21502.75,BUY,3,0.02h,Stop Loss,$46.50,$97.50,$137775.50,244,$97.50
2024-12-09,17:58:00,21492.0,SELL,3,0.02h,Break Even,$-1.50,$96.00,$137774.00,244,$96.00
2024-12-09,18:18:00,21495.25,BUY,3,0.02h,Stop Loss,$18.00,$114.00,$137792.00,244,$114.00
2024-12-09,19:00:00,21529.75,SELL,3,0.02h,Stop Loss,$30.00,$144.00,$137822.00,244,$144.00
2024-12-09,20:00:00,21476.75,BUY,3,0.02h,Break Even,$-1.50,$142.50,$137820.50,244,$142.50
2024-12-09,20:02:00,21462.5,SELL,3,0.02h,Break Even,$-1.50,$141.00,$137819.00,244,$141.00
2024-12-09,20:34:00,21459.75,BUY,3,0.02h,Stop Loss,$-9.00,$132.00,$137810.00,244,$132.00
2024-12-09,20:35:00,21450.5,SELL,3,0.02h,Stop Loss,$-9.00,$123.00,$137801.00,244,$123.00
2024-12-09,20:36:00,21454.0,BUY,3,0.02h,Break Even,$-1.50,$121.50,$137799.50,244,$121.50
2024-12-09,20:46:00,21449.0,SELL,3,0.02h,Stop Loss,$-9.00,$112.50,$137790.50,244,$112.50
2024-12-09,20:51:00,21471.0,BUY,3,0.02h,Stop Loss,$-9.00,$103.50,$137781.50,244,$103.50
2024-12-09,21:48:00,21473.25,SELL,3,0.02h,Break Even,$-1.50,$102.00,$137780.00,244,$102.00
2024-12-09,21:55:00,21477.0,BUY,3,0.02h,Stop Loss,$21.00,$123.00,$137801.00,244,$123.00
,,,,,,,,,,,
2024-12-10,12:57:00,21523.25,SELL,3,0.02h,Break Even,$-1.50,$-1.50,$137799.50,245,$-1.50
2024-12-10,13:00:00,21529.0,BUY,3,0.02h,Stop Loss,$-9.00,$-10.50,$137790.50,245,$-10.50
2024-12-10,13:21:00,21523.5,SELL,3,0.02h,Stop Loss,$-9.00,$-19.50,$137781.50,245,$-19.50
2024-12-10,14:08:00,21512.75,BUY,3,0.02h,Break Even,$-1.50,$-21.00,$137780.00,245,$-21.00
2024-12-10,14:34:00,21517.0,SELL,3,0.02h,Break Even,$-1.50,$-22.50,$137778.50,245,$-22.50
2024-12-10,14:35:00,21526.25,BUY,3,0.02h,Break Even,$-1.50,$-24.00,$137777.00,245,$-24.00
2024-12-10,14:56:00,21524.0,SELL,3,0.02h,Stop Loss,$31.50,$7.50,$137808.50,245,$7.50
2024-12-10,15:03:00,21569.25,BUY,3,0.02h,Break Even,$-1.50,$6.00,$137807.00,245,$6.00
2024-12-10,15:28:00,21575.0,SELL,3,0.02h,Stop Loss,$16.50,$22.50,$137823.50,245,$22.50
2024-12-10,16:57:00,21481.5,BUY,3,0.02h,Stop Loss,$-9.00,$13.50,$137814.50,245,$13.50
2024-12-10,17:14:00,21463.0,SELL,3,0.02h,Stop Loss,$40.50,$54.00,$137855.00,245,$54.00
2024-12-10,17:24:00,21485.0,BUY,3,0.02h,Stop Loss,$9.00,$63.00,$137864.00,245,$63.00
2024-12-10,17:52:00,21478.0,SELL,3,0.02h,Stop Loss,$16.50,$79.50,$137880.50,245,$79.50
2024-12-10,18:22:00,21474.0,BUY,3,0.02h,Stop Loss,$-9.00,$70.50,$137871.50,245,$70.50
2024-12-10,18:45:00,21467.0,SELL,3,0.02h,Break Even,$-1.50,$69.00,$137870.00,245,$69.00
2024-12-10,19:24:00,21452.75,BUY,3,0.02h,Stop Loss,$3.00,$72.00,$137873.00,245,$72.00
2024-12-10,19:33:00,21445.75,SELL,3,0.02h,Stop Loss,$6.00,$78.00,$137879.00,245,$78.00
2024-12-10,20:42:00,21397.25,BUY,3,0.02h,Stop Loss,$-9.00,$69.00,$137870.00,245,$69.00
,,,,,,,,,,,
2024-12-11,12:36:00,21432.5,SELL,3,0.02h,Stop Loss,$-9.00,$-9.00,$137861.00,246,$-9.00
2024-12-11,12:48:00,21443.5,BUY,3,0.02h,Stop Loss,$-9.00,$-18.00,$137852.00,246,$-18.00
2024-12-11,12:59:00,21438.75,SELL,3,0.02h,Stop Loss,$-9.00,$-27.00,$137843.00,246,$-27.00
2024-12-11,13:04:00,21445.0,BUY,3,0.02h,Break Even,$-1.50,$-28.50,$137841.50,246,$-28.50
2024-12-11,15:30:00,21691.75,SELL,3,0.02h,Break Even,$-1.50,$-30.00,$137840.00,246,$-30.00
2024-12-11,15:34:00,21716.25,BUY,3,0.02h,Stop Loss,$46.50,$16.50,$137886.50,246,$16.50
2024-12-11,15:50:00,21706.25,SELL,3,0.02h,Stop Loss,$-9.00,$7.50,$137877.50,246,$7.50
2024-12-11,16:06:00,21717.0,BUY,3,0.02h,Stop Loss,$40.50,$48.00,$137918.00,246,$48.00
2024-12-11,16:53:00,21744.0,SELL,3,0.02h,Break Even,$-1.50,$46.50,$137916.50,246,$46.50
2024-12-11,17:00:00,21760.0,BUY,3,0.02h,Stop Loss,$31.50,$78.00,$137948.00,246,$78.00
2024-12-11,17:32:00,21764.5,SELL,3,0.02h,Stop Loss,$-9.00,$69.00,$137939.00,246,$69.00
2024-12-11,17:41:00,21784.0,BUY,3,0.02h,Stop Loss,$10.50,$79.50,$137949.50,246,$79.50
2024-12-11,17:53:00,21772.0,SELL,3,0.02h,Break Even,$-1.50,$78.00,$137948.00,246,$78.00
2024-12-11,18:03:00,21790.25,BUY,3,0.02h,Stop Loss,$7.50,$85.50,$137955.50,246,$85.50
2024-12-11,18:55:00,21794.25,SELL,3,0.02h,Stop Loss,$7.50,$93.00,$137963.00,246,$93.00
2024-12-11,19:21:00,21795.25,BUY,3,0.02h,Break Even,$-1.50,$91.50,$137961.50,246,$91.50
2024-12-11,19:48:00,21795.5,SELL,3,0.02h,Break Even,$-1.50,$90.00,$137960.00,246,$90.00
2024-12-11,20:03:00,21805.0,BUY,3,0.02h,Break Even,$-1.50,$88.50,$137958.50,246,$88.50
2024-12-11,20:36:00,21807.5,SELL,3,0.02h,Break Even,$-1.50,$87.00,$137957.00,246,$87.00
,,,,,,,,,,,
2024-12-12,12:00:00,21996.5,BUY,3,0.02h,Break Even,$-1.50,$-1.50,$137955.50,247,$-1.50
2024-12-12,12:05:00,21719.0,SELL,3,0.02h,Stop Loss,$-9.00,$-10.50,$137946.50,247,$-10.50
2024-12-12,12:11:00,21998.25,BUY,3,0.02h,Stop Loss,$-9.00,$-19.50,$137937.50,247,$-19.50
2024-12-12,12:16:00,21721.5,SELL,3,0.02h,Stop Loss,$-9.00,$-28.50,$137928.50,247,$-28.50
2024-12-12,12:17:00,21994.0,BUY,3,0.02h,Stop Loss,$-9.00,$-37.50,$137919.50,247,$-37.50
2024-12-12,12:29:00,21723.5,SELL,3,0.02h,Stop Loss,$-9.00,$-46.50,$137910.50,247,$-46.50
2024-12-12,12:30:00,21994.0,BUY,3,0.02h,Stop Loss,$-9.00,$-55.50,$137901.50,247,$-55.50
2024-12-12,12:38:00,21707.5,SELL,3,0.02h,Stop Loss,$-9.00,$-64.50,$137892.50,247,$-64.50
2024-12-12,12:51:00,21976.0,BUY,3,0.02h,Stop Loss,$-9.00,$-73.50,$137883.50,247,$-73.50
2024-12-12,12:55:00,21697.0,SELL,3,0.02h,Break Even,$-1.50,$-75.00,$137882.00,247,$-75.00
2024-12-12,12:59:00,21969.0,BUY,3,0.03h,Stop Loss,$-9.00,$-84.00,$137873.00,247,$-84.00
2024-12-12,13:12:00,21705.0,SELL,3,0.02h,Stop Loss,$-9.00,$-93.00,$137864.00,247,$-93.00
2024-12-12,13:25:00,21986.5,BUY,3,0.02h,Break Even,$-1.50,$-94.50,$137862.50,247,$-94.50
2024-12-12,13:30:00,21710.75,SELL,3,0.02h,Stop Loss,$-9.00,$-103.50,$137853.50,247,$-103.50
2024-12-12,13:31:00,21972.25,BUY,3,0.02h,Stop Loss,$-9.00,$-112.50,$137844.50,247,$-112.50
2024-12-12,13:33:00,21688.5,SELL,3,0.02h,Stop Loss,$-9.00,$-121.50,$137835.50,247,$-121.50
2024-12-12,13:34:00,21951.25,BUY,3,0.02h,Stop Loss,$4.50,$-117.00,$137840.00,247,$-117.00
2024-12-12,13:36:00,21668.5,SELL,3,0.02h,Stop Loss,$102.00,$-15.00,$137942.00,247,$-15.00
2024-12-12,13:44:00,21952.75,BUY,3,0.02h,Stop Loss,$31.50,$16.50,$137973.50,247,$16.50
2024-12-12,13:54:00,21681.25,SELL,3,0.02h,Break Even,$-1.50,$15.00,$137972.00,247,$15.00
2024-12-12,14:08:00,21959.75,BUY,3,0.02h,Stop Loss,$-9.00,$6.00,$137963.00,247,$6.00
2024-12-12,14:09:00,21695.75,SELL,3,0.02h,Break Even,$-1.50,$4.50,$137961.50,247,$4.50
2024-12-12,14:12:00,21953.0,BUY,3,0.02h,Stop Loss,$-9.00,$-4.50,$137952.50,247,$-4.50
2024-12-12,14:13:00,21676.75,SELL,3,0.02h,Stop Loss,$-9.00,$-13.50,$137943.50,247,$-13.50
2024-12-12,14:14:00,21949.75,BUY,3,0.02h,Stop Loss,$-9.00,$-22.50,$137934.50,247,$-22.50
2024-12-12,14:29:00,21695.0,SELL,3,0.02h,Break Even,$-1.50,$-24.00,$137933.00,247,$-24.00
2024-12-12,14:32:00,21940.75,BUY,3,0.02h,Stop Loss,$27.00,$3.00,$137960.00,247,$3.00
2024-12-12,14:38:00,21665.75,SELL,3,0.02h,Break Even,$-1.50,$1.50,$137958.50,247,$1.50
2024-12-12,14:49:00,21946.75,BUY,3,0.02h,Stop Loss,$-9.00,$-7.50,$137949.50,247,$-7.50
2024-12-12,15:07:00,21674.0,SELL,3,0.02h,Break Even,$-1.50,$-9.00,$137948.00,247,$-9.00
2024-12-12,15:26:00,21972.75,BUY,3,0.02h,Stop Loss,$72.00,$63.00,$138020.00,247,$63.00
2024-12-12,15:37:00,21709.25,SELL,3,0.02h,Stop Loss,$-9.00,$54.00,$138011.00,247,$54.00
2024-12-12,15:38:00,21991.0,BUY,3,0.02h,Stop Loss,$-9.00,$45.00,$138002.00,247,$45.00
2024-12-12,15:46:00,21699.75,SELL,3,0.02h,Break Even,$-1.50,$43.50,$138000.50,247,$43.50
2024-12-12,15:53:00,21982.0,BUY,3,0.02h,Stop Loss,$15.00,$58.50,$138015.50,247,$58.50
2024-12-12,15:57:00,21725.25,SELL,3,0.02h,Stop Loss,$-9.00,$49.50,$138006.50,247,$49.50
2024-12-12,15:58:00,21984.25,BUY,3,0.02h,Stop Loss,$-9.00,$40.50,$137997.50,247,$40.50
2024-12-12,15:59:00,21712.0,SELL,3,0.02h,Stop Loss,$-9.00,$31.50,$137988.50,247,$31.50
2024-12-12,16:00:00,21990.5,BUY,3,0.02h,Stop Loss,$16.50,$48.00,$138005.00,247,$48.00
2024-12-12,16:07:00,21734.75,SELL,3,0.02h,Stop Loss,$-9.00,$39.00,$137996.00,247,$39.00
2024-12-12,16:08:00,22002.0,BUY,3,0.02h,Stop Loss,$-9.00,$30.00,$137987.00,247,$30.00
2024-12-12,16:09:00,21731.5,SELL,3,0.02h,Stop Loss,$10.50,$40.50,$137997.50,247,$40.50
2024-12-12,16:21:00,21990.75,BUY,3,0.02h,Stop Loss,$-9.00,$31.50,$137988.50,247,$31.50
2024-12-12,16:22:00,21722.0,SELL,3,0.02h,Stop Loss,$21.00,$52.50,$138009.50,247,$52.50
2024-12-12,16:25:00,21991.5,BUY,3,0.02h,Stop Loss,$-9.00,$43.50,$138000.50,247,$43.50
2024-12-12,16:26:00,21719.5,SELL,3,0.02h,Stop Loss,$-9.00,$34.50,$137991.50,247,$34.50
2024-12-12,16:27:00,21989.5,BUY,3,0.02h,Stop Loss,$-9.00,$25.50,$137982.50,247,$25.50
2024-12-12,16:35:00,21710.25,SELL,3,0.02h,Break Even,$-1.50,$24.00,$137981.00,247,$24.00
2024-12-12,16:37:00,21972.75,BUY,3,0.02h,Stop Loss,$-9.00,$15.00,$137972.00,247,$15.00
2024-12-12,16:38:00,21709.25,SELL,3,0.02h,Break Even,$-1.50,$13.50,$137970.50,247,$13.50
2024-12-12,16:42:00,21967.25,BUY,3,0.02h,Stop Loss,$-9.00,$4.50,$137961.50,247,$4.50
2024-12-12,16:43:00,21696.75,SELL,3,0.02h,Stop Loss,$10.50,$15.00,$137972.00,247,$15.00
2024-12-12,16:53:00,21952.25,BUY,3,0.02h,Stop Loss,$-9.00,$6.00,$137963.00,247,$6.00
2024-12-12,16:54:00,21684.25,SELL,3,0.02h,Stop Loss,$-9.00,$-3.00,$137954.00,247,$-3.00
2024-12-12,16:55:00,21955.5,BUY,3,0.02h,Stop Loss,$6.00,$3.00,$137960.00,247,$3.00
2024-12-12,17:12:00,21722.5,SELL,3,0.02h,Break Even,$-1.50,$1.50,$137958.50,247,$1.50
2024-12-12,17:20:00,21982.5,BUY,3,0.02h,Stop Loss,$6.00,$7.50,$137964.50,247,$7.50
2024-12-12,17:29:00,21717.25,SELL,3,0.02h,Break Even,$-1.50,$6.00,$137963.00,247,$6.00
2024-12-12,17:33:00,21972.5,BUY,3,0.02h,Stop Loss,$-9.00,$-3.00,$137954.00,247,$-3.00
2024-12-12,17:34:00,21700.25,SELL,3,0.02h,Stop Loss,$10.50,$7.50,$137964.50,247,$7.50
2024-12-12,17:37:00,21959.5,BUY,3,0.02h,Stop Loss,$-9.00,$-1.50,$137955.50,247,$-1.50
2024-12-12,17:38:00,21699.5,SELL,3,0.02h,Break Even,$-1.50,$-3.00,$137954.00,247,$-3.00
2024-12-12,17:45:00,21972.5,BUY,3,0.02h,Stop Loss,$-9.00,$-12.00,$137945.00,247,$-12.00
2024-12-12,17:46:00,21713.25,SELL,3,0.02h,Break Even,$-1.50,$-13.50,$137943.50,247,$-13.50
2024-12-12,17:51:00,21988.25,BUY,3,0.02h,Break Even,$-1.50,$-15.00,$137942.00,247,$-15.00
2024-12-12,17:55:00,21723.25,SELL,3,0.02h,Stop Loss,$-9.00,$-24.00,$137933.00,247,$-24.00
2024-12-12,17:56:00,21997.5,BUY,3,0.02h,Break Even,$-1.50,$-25.50,$137931.50,247,$-25.50
2024-12-12,17:59:00,21737.75,SELL,3,0.02h,Stop Loss,$-9.00,$-34.50,$137922.50,247,$-34.50
2024-12-12,18:00:00,22009.5,BUY,3,0.02h,Stop Loss,$-9.00,$-43.50,$137913.50,247,$-43.50
2024-12-12,18:01:00,21741.25,SELL,3,0.02h,Stop Loss,$-9.00,$-52.50,$137904.50,247,$-52.50
2024-12-12,18:02:00,22006.0,BUY,3,0.02h,Stop Loss,$-9.00,$-61.50,$137895.50,247,$-61.50
2024-12-12,18:07:00,21733.25,SELL,3,0.02h,Stop Loss,$16.50,$-45.00,$137912.00,247,$-45.00
2024-12-12,18:10:00,21993.5,BUY,3,0.02h,Stop Loss,$-9.00,$-54.00,$137903.00,247,$-54.00
2024-12-12,18:11:00,21730.5,SELL,3,0.02h,Stop Loss,$55.50,$1.50,$137958.50,247,$1.50
2024-12-12,18:21:00,22006.0,BUY,3,0.02h,Stop Loss,$-9.00,$-7.50,$137949.50,247,$-7.50
2024-12-12,18:22:00,21732.25,SELL,3,0.02h,Break Even,$-1.50,$-9.00,$137948.00,247,$-9.00
2024-12-12,18:24:00,22006.75,BUY,3,0.02h,Stop Loss,$-9.00,$-18.00,$137939.00,247,$-18.00
2024-12-12,18:26:00,21736.75,SELL,3,0.02h,Break Even,$-1.50,$-19.50,$137937.50,247,$-19.50
2024-12-12,18:28:00,22011.5,BUY,3,0.02h,Stop Loss,$-9.00,$-28.50,$137928.50,247,$-28.50
2024-12-12,18:29:00,21739.0,SELL,3,0.02h,Stop Loss,$-9.00,$-37.50,$137919.50,247,$-37.50
2024-12-12,18:30:00,21997.0,BUY,3,0.02h,Stop Loss,$-9.00,$-46.50,$137910.50,247,$-46.50
2024-12-12,18:41:00,21719.75,SELL,3,0.02h,Stop Loss,$-9.00,$-55.50,$137901.50,247,$-55.50
2024-12-12,18:42:00,21974.0,BUY,3,0.02h,Stop Loss,$-9.00,$-64.50,$137892.50,247,$-64.50
2024-12-12,18:43:00,21706.5,SELL,3,0.02h,Stop Loss,$-9.00,$-73.50,$137883.50,247,$-73.50
2024-12-12,18:47:00,21980.25,BUY,3,0.02h,Stop Loss,$-9.00,$-82.50,$137874.50,247,$-82.50
2024-12-12,18:48:00,21712.0,SELL,3,0.02h,Stop Loss,$-9.00,$-91.50,$137865.50,247,$-91.50
2024-12-12,18:49:00,21977.0,BUY,3,0.02h,Stop Loss,$-9.00,$-100.50,$137856.50,247,$-100.50
2024-12-12,18:50:00,21714.25,SELL,3,0.02h,Stop Loss,$-9.00,$-109.50,$137847.50,247,$-109.50
2024-12-12,18:51:00,21980.25,BUY,3,0.02h,Stop Loss,$-9.00,$-118.50,$137838.50,247,$-118.50
2024-12-12,18:53:00,21705.25,SELL,3,0.02h,Stop Loss,$-9.00,$-127.50,$137829.50,247,$-127.50
2024-12-12,18:54:00,21971.5,BUY,3,0.02h,Break Even,$-1.50,$-129.00,$137828.00,247,$-129.00
2024-12-12,19:03:00,21699.0,SELL,3,0.02h,Stop Loss,$-9.00,$-138.00,$137819.00,247,$-138.00
2024-12-12,19:04:00,21967.25,BUY,3,0.03h,Stop Loss,$10.50,$-127.50,$137829.50,247,$-127.50
2024-12-12,19:06:00,21711.0,SELL,3,0.02h,Stop Loss,$13.50,$-114.00,$137843.00,247,$-114.00
2024-12-12,19:20:00,21958.75,BUY,3,0.02h,Stop Loss,$-9.00,$-123.00,$137834.00,247,$-123.00
2024-12-12,19:21:00,21686.0,SELL,3,0.02h,Stop Loss,$-9.00,$-132.00,$137825.00,247,$-132.00
2024-12-12,19:22:00,21941.75,BUY,3,0.02h,Break Even,$-1.50,$-133.50,$137823.50,247,$-133.50
2024-12-12,19:26:00,21674.75,SELL,3,0.02h,Stop Loss,$-9.00,$-142.50,$137814.50,247,$-142.50
2024-12-12,19:40:00,21957.75,BUY,3,0.02h,Stop Loss,$-9.00,$-151.50,$137805.50,247,$-151.50
2024-12-12,19:54:00,21684.5,SELL,3,0.02h,Stop Loss,$-9.00,$-160.50,$137796.50,247,$-160.50
2024-12-12,20:05:00,21947.75,BUY,3,0.02h,Stop Loss,$-9.00,$-169.50,$137787.50,247,$-169.50
2024-12-12,20:06:00,21683.5,SELL,3,0.02h,Break Even,$-1.50,$-171.00,$137786.00,247,$-171.00
2024-12-12,20:09:00,21943.25,BUY,3,0.02h,Break Even,$-1.50,$-172.50,$137784.50,247,$-172.50
2024-12-12,20:14:00,21663.0,SELL,3,0.02h,Stop Loss,$3.00,$-169.50,$137787.50,247,$-169.50
2024-12-12,20:17:00,21930.75,BUY,3,0.02h,Stop Loss,$-9.00,$-178.50,$137778.50,247,$-178.50
2024-12-12,20:20:00,21665.0,SELL,3,0.02h,Break Even,$-1.50,$-180.00,$137777.00,247,$-180.00
2024-12-12,20:23:00,21924.75,BUY,3,0.02h,Stop Loss,$-9.00,$-189.00,$137768.00,247,$-189.00
2024-12-12,20:24:00,21659.75,SELL,3,0.02h,Stop Loss,$-9.00,$-198.00,$137759.00,247,$-198.00
2024-12-12,20:25:00,21924.25,BUY,3,0.02h,Stop Loss,$13.50,$-184.50,$137772.50,247,$-184.50
2024-12-12,20:28:00,21651.5,SELL,3,0.02h,Stop Loss,$-9.00,$-193.50,$137763.50,247,$-193.50
2024-12-12,20:30:00,21922.25,BUY,3,0.02h,Stop Loss,$25.50,$-168.00,$137789.00,247,$-168.00
2024-12-12,20:33:00,21664.0,SELL,3,0.02h,Stop Loss,$-9.00,$-177.00,$137780.00,247,$-177.00
2024-12-12,20:35:00,21938.75,BUY,3,0.02h,Stop Loss,$-9.00,$-186.00,$137771.00,247,$-186.00
2024-12-12,20:39:00,21664.0,SELL,3,0.02h,Stop Loss,$-9.00,$-195.00,$137762.00,247,$-195.00
2024-12-12,20:42:00,21925.0,BUY,3,0.02h,Stop Loss,$-9.00,$-204.00,$137753.00,247,$-204.00
2024-12-12,20:43:00,21661.25,SELL,3,0.02h,Stop Loss,$-9.00,$-213.00,$137744.00,247,$-213.00
2024-12-12,20:44:00,21929.75,BUY,3,0.02h,Stop Loss,$-9.00,$-222.00,$137735.00,247,$-222.00
2024-12-12,20:45:00,21664.25,SELL,3,0.02h,Stop Loss,$-9.00,$-231.00,$137726.00,247,$-231.00
2024-12-12,20:47:00,21939.75,BUY,3,0.03h,Break Even,$-1.50,$-232.50,$137724.50,247,$-232.50
2024-12-12,21:00:00,21644.0,SELL,3,0.02h,Stop Loss,$39.00,$-193.50,$137763.50,247,$-193.50
2024-12-12,21:07:00,21885.25,BUY,3,0.02h,Break Even,$-1.50,$-195.00,$137762.00,247,$-195.00
2024-12-12,21:10:00,21623.25,SELL,3,0.02h,Stop Loss,$-9.00,$-204.00,$137753.00,247,$-204.00
2024-12-12,21:11:00,21882.25,BUY,3,0.02h,Stop Loss,$-9.00,$-213.00,$137744.00,247,$-213.00
2024-12-12,21:12:00,21617.0,SELL,3,0.02h,Stop Loss,$7.50,$-205.50,$137751.50,247,$-205.50
2024-12-12,21:18:00,21926.5,BUY,3,0.02h,Stop Loss,$94.50,$-111.00,$137846.00,247,$-111.00
2024-12-12,21:33:00,21677.75,SELL,3,0.02h,Stop Loss,$19.50,$-91.50,$137865.50,247,$-91.50
2024-12-12,21:42:00,21914.0,BUY,3,0.02h,Stop Loss,$6.00,$-85.50,$137871.50,247,$-85.50
2024-12-12,21:44:00,21649.75,SELL,3,0.02h,Stop Loss,$-9.00,$-94.50,$137862.50,247,$-94.50
2024-12-12,21:45:00,21917.5,BUY,3,0.02h,Stop Loss,$-9.00,$-103.50,$137853.50,247,$-103.50
2024-12-12,21:52:00,21641.5,SELL,3,0.02h,Stop Loss,$-9.00,$-112.50,$137844.50,247,$-112.50
,,,,,,,,,,,
2024-12-13,12:00:00,22059.5,BUY,3,0.02h,Break Even,$-1.50,$-1.50,$137843.00,248,$-1.50
2024-12-13,12:19:00,21810.75,SELL,3,0.02h,Break Even,$-1.50,$-3.00,$137841.50,248,$-3.00
2024-12-13,12:23:00,22090.75,BUY,3,0.02h,Stop Loss,$6.00,$3.00,$137847.50,248,$3.00
2024-12-13,12:26:00,21824.0,SELL,3,0.02h,Stop Loss,$4.50,$7.50,$137852.00,248,$7.50
2024-12-13,12:31:00,22090.0,BUY,3,0.02h,Stop Loss,$-9.00,$-1.50,$137843.00,248,$-1.50
2024-12-13,12:37:00,21817.25,SELL,3,0.02h,Stop Loss,$-9.00,$-10.50,$137834.00,248,$-10.50
2024-12-13,12:38:00,22088.75,BUY,3,0.02h,Stop Loss,$-9.00,$-19.50,$137825.00,248,$-19.50
2024-12-13,12:39:00,21818.0,SELL,3,0.02h,Stop Loss,$-9.00,$-28.50,$137816.00,248,$-28.50
2024-12-13,12:40:00,22088.25,BUY,3,0.02h,Break Even,$-1.50,$-30.00,$137814.50,248,$-30.00
2024-12-13,12:48:00,21825.75,SELL,3,0.02h,Stop Loss,$-9.00,$-39.00,$137805.50,248,$-39.00
2024-12-13,12:49:00,22095.25,BUY,3,0.02h,Stop Loss,$-9.00,$-48.00,$137796.50,248,$-48.00
2024-12-13,12:50:00,21823.75,SELL,3,0.02h,Stop Loss,$-9.00,$-57.00,$137787.50,248,$-57.00
2024-12-13,12:52:00,22095.5,BUY,3,0.03h,Break Even,$-1.50,$-58.50,$137786.00,248,$-58.50
2024-12-13,12:54:00,21828.25,SELL,3,0.02h,Stop Loss,$-9.00,$-67.50,$137777.00,248,$-67.50
2024-12-13,13:07:00,22108.75,BUY,3,0.02h,Stop Loss,$-9.00,$-76.50,$137768.00,248,$-76.50
2024-12-13,13:20:00,21836.0,SELL,3,0.02h,Stop Loss,$-9.00,$-85.50,$137759.00,248,$-85.50
2024-12-13,13:28:00,22110.75,BUY,3,0.02h,Stop Loss,$-9.00,$-94.50,$137750.00,248,$-94.50
2024-12-13,13:52:00,21817.75,SELL,3,0.02h,Stop Loss,$-9.00,$-103.50,$137741.00,248,$-103.50
2024-12-13,13:53:00,22086.75,BUY,3,0.02h,Stop Loss,$24.00,$-79.50,$137765.00,248,$-79.50
2024-12-13,13:56:00,21822.5,SELL,3,0.02h,Break Even,$-1.50,$-81.00,$137763.50,248,$-81.00
2024-12-13,14:06:00,22078.25,BUY,3,0.02h,Stop Loss,$-9.00,$-90.00,$137754.50,248,$-90.00
2024-12-13,14:07:00,21804.5,SELL,3,0.02h,Break Even,$-1.50,$-91.50,$137753.00,248,$-91.50
2024-12-13,14:12:00,22069.0,BUY,3,0.02h,Stop Loss,$75.00,$-16.50,$137828.00,248,$-16.50
2024-12-13,14:14:00,21810.5,SELL,3,0.02h,Stop Loss,$-9.00,$-25.50,$137819.00,248,$-25.50
2024-12-13,14:15:00,22076.0,BUY,3,0.02h,Stop Loss,$-9.00,$-34.50,$137810.00,248,$-34.50
2024-12-13,14:16:00,21796.5,SELL,3,0.02h,Stop Loss,$-9.00,$-43.50,$137801.00,248,$-43.50
2024-12-13,14:18:00,22065.0,BUY,3,0.02h,Stop Loss,$-9.00,$-52.50,$137792.00,248,$-52.50
2024-12-13,14:19:00,21794.5,SELL,3,0.02h,Stop Loss,$-9.00,$-61.50,$137783.00,248,$-61.50
2024-12-13,14:30:00,22068.5,BUY,3,0.02h,Stop Loss,$93.00,$31.50,$137876.00,248,$31.50
2024-12-13,14:34:00,21814.25,SELL,3,0.02h,Break Even,$-1.50,$30.00,$137874.50,248,$30.00
2024-12-13,14:36:00,22088.0,BUY,3,0.02h,Stop Loss,$-9.00,$21.00,$137865.50,248,$21.00
2024-12-13,14:37:00,21835.25,SELL,3,0.02h,Stop Loss,$27.00,$48.00,$137892.50,248,$48.00
2024-12-13,14:41:00,22107.5,BUY,3,0.02h,Stop Loss,$-9.00,$39.00,$137883.50,248,$39.00
2024-12-13,14:42:00,21842.5,SELL,3,0.02h,Break Even,$-1.50,$37.50,$137882.00,248,$37.50
2024-12-13,14:45:00,22163.25,BUY,3,0.02h,Stop Loss,$82.50,$120.00,$137964.50,248,$120.00
2024-12-13,14:59:00,21886.5,SELL,3,0.02h,Stop Loss,$-9.00,$111.00,$137955.50,248,$111.00
2024-12-13,15:00:00,22156.0,BUY,3,0.02h,Stop Loss,$-9.00,$102.00,$137946.50,248,$102.00
2024-12-13,15:01:00,21877.5,SELL,3,0.02h,Stop Loss,$66.00,$168.00,$138012.50,248,$168.00
2024-12-13,15:04:00,22149.0,BUY,3,0.02h,Stop Loss,$-9.00,$159.00,$138003.50,248,$159.00
2024-12-13,15:05:00,21863.0,SELL,3,0.02h,Stop Loss,$12.00,$171.00,$138015.50,248,$171.00
2024-12-13,15:15:00,22137.25,BUY,3,0.02h,Break Even,$-1.50,$169.50,$138014.00,248,$169.50
2024-12-13,15:30:00,21803.0,SELL,3,0.02h,Stop Loss,$-9.00,$160.50,$138005.00,248,$160.50
2024-12-13,15:49:00,22045.0,BUY,3,0.02h,Stop Loss,$-9.00,$151.50,$137996.00,248,$151.50
2024-12-13,15:50:00,21772.5,SELL,3,0.02h,Stop Loss,$130.50,$282.00,$138126.50,248,$282.00
2024-12-13,15:58:00,21983.0,BUY,3,0.02h,Stop Loss,$10.50,$292.50,$138137.00,248,$292.50
2024-12-13,16:00:00,21687.75,SELL,3,0.02h,Stop Loss,$22.50,$315.00,$138159.50,248,$315.00
2024-12-13,16:11:00,21965.0,BUY,3,0.02h,Stop Loss,$40.50,$355.50,$138200.00,248,$355.50
2024-12-13,16:15:00,21677.5,SELL,3,0.02h,Stop Loss,$-9.00,$346.50,$138191.00,248,$346.50
2024-12-13,16:16:00,21969.75,BUY,3,0.02h,Stop Loss,$123.00,$469.50,$138314.00,248,$469.50
2024-12-13,16:30:00,21699.0,SELL,3,0.02h,Stop Loss,$-9.00,$460.50,$138305.00,248,$460.50
2024-12-13,16:33:00,22020.75,BUY,3,0.02h,Stop Loss,$-9.00,$451.50,$138296.00,248,$451.50
2024-12-13,16:34:00,21747.25,SELL,3,0.02h,Break Even,$-1.50,$450.00,$138294.50,248,$450.00
2024-12-13,16:44:00,22012.5,BUY,3,0.02h,Break Even,$-1.50,$448.50,$138293.00,248,$448.50
2024-12-13,16:47:00,21703.25,SELL,3,0.02h,Break Even,$-1.50,$447.00,$138291.50,248,$447.00
2024-12-13,16:52:00,21982.5,BUY,3,0.02h,Stop Loss,$4.50,$451.50,$138296.00,248,$451.50
2024-12-13,16:56:00,21686.5,SELL,3,0.02h,Stop Loss,$54.00,$505.50,$138350.00,248,$505.50
2024-12-13,16:59:00,21963.0,BUY,3,0.02h,Stop Loss,$90.00,$595.50,$138440.00,248,$595.50
2024-12-13,17:04:00,21710.25,SELL,3,0.02h,Break Even,$-1.50,$594.00,$138438.50,248,$594.00
2024-12-13,17:12:00,22017.75,BUY,3,0.02h,Stop Loss,$-9.00,$585.00,$138429.50,248,$585.00
2024-12-13,17:13:00,21733.0,SELL,3,0.02h,Stop Loss,$70.50,$655.50,$138500.00,248,$655.50
2024-12-13,17:15:00,21996.75,BUY,3,0.02h,Stop Loss,$-9.00,$646.50,$138491.00,248,$646.50
2024-12-13,17:16:00,21714.5,SELL,3,0.02h,Stop Loss,$-9.00,$637.50,$138482.00,248,$637.50
2024-12-13,17:17:00,21995.0,BUY,3,0.02h,Stop Loss,$30.00,$667.50,$138512.00,248,$667.50
2024-12-13,17:20:00,21728.25,SELL,3,0.02h,Break Even,$-1.50,$666.00,$138510.50,248,$666.00
2024-12-13,17:33:00,21970.75,BUY,3,0.02h,Stop Loss,$-9.00,$657.00,$138501.50,248,$657.00
2024-12-13,17:34:00,21687.0,SELL,3,0.02h,Stop Loss,$-9.00,$648.00,$138492.50,248,$648.00
2024-12-13,17:36:00,21972.5,BUY,3,0.02h,Stop Loss,$-9.00,$639.00,$138483.50,248,$639.00
2024-12-13,17:50:00,21701.0,SELL,3,0.02h,Stop Loss,$-9.00,$630.00,$138474.50,248,$630.00
2024-12-13,17:51:00,21970.0,BUY,3,0.02h,Stop Loss,$-9.00,$621.00,$138465.50,248,$621.00
2024-12-13,17:52:00,21698.75,SELL,3,0.02h,Stop Loss,$-9.00,$612.00,$138456.50,248,$612.00
2024-12-13,17:53:00,21994.5,BUY,3,0.02h,Stop Loss,$16.50,$628.50,$138473.00,248,$628.50
2024-12-13,18:00:00,21684.5,SELL,3,0.02h,Break Even,$-1.50,$627.00,$138471.50,248,$627.00
2024-12-13,18:08:00,21998.25,BUY,3,0.02h,Stop Loss,$-9.00,$618.00,$138462.50,248,$618.00
2024-12-13,18:09:00,21715.0,SELL,3,0.02h,Stop Loss,$30.00,$648.00,$138492.50,248,$648.00
2024-12-13,18:11:00,21996.25,BUY,3,0.02h,Stop Loss,$-9.00,$639.00,$138483.50,248,$639.00
2024-12-13,18:14:00,21722.5,SELL,3,0.02h,Stop Loss,$16.50,$655.50,$138500.00,248,$655.50
2024-12-13,18:16:00,21998.5,BUY,3,0.02h,Break Even,$-1.50,$654.00,$138498.50,248,$654.00
2024-12-13,18:21:00,21724.5,SELL,3,0.02h,Stop Loss,$57.00,$711.00,$138555.50,248,$711.00
2024-12-13,18:29:00,22022.25,BUY,3,0.02h,Stop Loss,$-9.00,$702.00,$138546.50,248,$702.00
2024-12-13,18:38:00,21741.75,SELL,3,0.02h,Stop Loss,$-9.00,$693.00,$138537.50,248,$693.00
2024-12-13,18:39:00,22030.25,BUY,3,0.02h,Stop Loss,$-9.00,$684.00,$138528.50,248,$684.00
2024-12-13,18:40:00,21745.25,SELL,3,0.02h,Break Even,$-1.50,$682.50,$138527.00,248,$682.50
2024-12-13,18:42:00,22031.25,BUY,3,0.02h,Stop Loss,$-9.00,$673.50,$138518.00,248,$673.50
2024-12-13,18:43:00,21744.5,SELL,3,0.02h,Stop Loss,$-9.00,$664.50,$138509.00,248,$664.50
2024-12-13,18:44:00,22030.0,BUY,3,0.02h,Stop Loss,$-9.00,$655.50,$138500.00,248,$655.50
2024-12-13,18:45:00,21749.25,SELL,3,0.02h,Break Even,$-1.50,$654.00,$138498.50,248,$654.00
2024-12-13,18:49:00,22049.5,BUY,3,0.02h,Stop Loss,$15.00,$669.00,$138513.50,248,$669.00
2024-12-13,18:52:00,21767.75,SELL,3,0.02h,Stop Loss,$9.00,$678.00,$138522.50,248,$678.00
2024-12-13,18:54:00,22050.0,BUY,3,0.02h,Stop Loss,$19.50,$697.50,$138542.00,248,$697.50
2024-12-13,19:03:00,21762.25,SELL,3,0.02h,Break Even,$-1.50,$696.00,$138540.50,248,$696.00
2024-12-13,19:11:00,22064.0,BUY,3,0.02h,Stop Loss,$-9.00,$687.00,$138531.50,248,$687.00
2024-12-13,19:20:00,21785.5,SELL,3,0.02h,Stop Loss,$22.50,$709.50,$138554.00,248,$709.50
2024-12-13,19:30:00,22089.5,BUY,3,0.02h,Stop Loss,$28.50,$738.00,$138582.50,248,$738.00
2024-12-13,19:35:00,21810.25,SELL,3,0.02h,Stop Loss,$-9.00,$729.00,$138573.50,248,$729.00
2024-12-13,19:36:00,22088.25,BUY,3,0.02h,Break Even,$-1.50,$727.50,$138572.00,248,$727.50
2024-12-13,19:40:00,21805.0,SELL,3,0.02h,Stop Loss,$6.00,$733.50,$138578.00,248,$733.50
2024-12-13,19:43:00,22090.5,BUY,3,0.02h,Stop Loss,$-9.00,$724.50,$138569.00,248,$724.50
2024-12-13,19:50:00,21805.25,SELL,3,0.02h,Stop Loss,$-9.00,$715.50,$138560.00,248,$715.50
2024-12-13,19:51:00,22087.25,BUY,3,0.02h,Stop Loss,$-9.00,$706.50,$138551.00,248,$706.50
2024-12-13,20:03:00,21805.0,SELL,3,0.02h,Stop Loss,$-9.00,$697.50,$138542.00,248,$697.50
2024-12-13,20:04:00,22089.0,BUY,3,0.02h,Stop Loss,$-9.00,$688.50,$138533.00,248,$688.50
2024-12-13,20:07:00,21801.25,SELL,3,0.02h,Break Even,$-1.50,$687.00,$138531.50,248,$687.00
2024-12-13,20:24:00,22069.25,BUY,3,0.02h,Stop Loss,$3.00,$690.00,$138534.50,248,$690.00
2024-12-13,20:27:00,21799.0,SELL,3,0.02h,Stop Loss,$-9.00,$681.00,$138525.50,248,$681.00
2024-12-13,20:28:00,22085.25,BUY,3,0.02h,Stop Loss,$36.00,$717.00,$138561.50,248,$717.00
2024-12-13,20:32:00,21813.75,SELL,3,0.02h,Stop Loss,$-9.00,$708.00,$138552.50,248,$708.00
2024-12-13,20:33:00,22095.5,BUY,3,0.02h,Stop Loss,$-9.00,$699.00,$138543.50,248,$699.00
2024-12-13,20:34:00,21822.0,SELL,3,0.02h,Break Even,$-1.50,$697.50,$138542.00,248,$697.50
2024-12-13,20:37:00,22104.5,BUY,3,0.02h,Stop Loss,$-9.00,$688.50,$138533.00,248,$688.50
2024-12-13,20:44:00,21798.0,SELL,3,0.02h,Stop Loss,$-9.00,$679.50,$138524.00,248,$679.50
2024-12-13,20:45:00,22081.25,BUY,3,0.02h,Stop Loss,$-9.00,$670.50,$138515.00,248,$670.50
2024-12-13,20:46:00,21803.5,SELL,3,0.02h,Stop Loss,$-9.00,$661.50,$138506.00,248,$661.50
2024-12-13,20:50:00,22093.25,BUY,3,0.02h,Stop Loss,$-9.00,$652.50,$138497.00,248,$652.50
2024-12-13,20:53:00,21794.25,SELL,3,0.02h,Break Even,$-1.50,$651.00,$138495.50,248,$651.00
2024-12-13,20:56:00,22082.75,BUY,3,0.02h,Stop Loss,$-9.00,$642.00,$138486.50,248,$642.00
2024-12-13,20:58:00,21797.0,SELL,3,0.02h,Break Even,$-1.50,$640.50,$138485.00,248,$640.50
2024-12-13,21:12:00,22063.5,BUY,3,0.02h,Break Even,$-1.50,$639.00,$138483.50,248,$639.00
2024-12-13,21:18:00,21773.5,SELL,3,0.02h,Stop Loss,$19.50,$658.50,$138503.00,248,$658.50
2024-12-13,21:24:00,22052.25,BUY,3,0.02h,Stop Loss,$-9.00,$649.50,$138494.00,248,$649.50
2024-12-13,21:26:00,21764.25,SELL,3,0.02h,Stop Loss,$27.00,$676.50,$138521.00,248,$676.50
2024-12-13,21:28:00,22045.5,BUY,3,0.02h,Stop Loss,$-9.00,$667.50,$138512.00,248,$667.50
2024-12-13,21:29:00,21759.5,SELL,3,0.02h,Stop Loss,$-9.00,$658.50,$138503.00,248,$658.50
2024-12-13,21:30:00,22044.25,BUY,3,0.02h,Stop Loss,$-9.00,$649.50,$138494.00,248,$649.50
2024-12-13,21:34:00,21757.75,SELL,3,0.02h,Stop Loss,$-9.00,$640.50,$138485.00,248,$640.50
2024-12-13,21:35:00,22044.0,BUY,3,0.02h,Stop Loss,$-9.00,$631.50,$138476.00,248,$631.50
2024-12-13,21:37:00,21756.25,SELL,3,0.02h,Stop Loss,$-9.00,$622.50,$138467.00,248,$622.50
2024-12-13,21:38:00,22048.75,BUY,3,0.02h,Stop Loss,$-9.00,$613.50,$138458.00,248,$613.50
2024-12-13,21:45:00,21761.5,SELL,3,0.02h,Stop Loss,$-9.00,$604.50,$138449.00,248,$604.50
2024-12-13,21:46:00,22050.5,BUY,3,0.02h,Break Even,$-1.50,$603.00,$138447.50,248,$603.00
2024-12-13,21:48:00,21763.75,SELL,3,0.02h,Break Even,$-1.50,$601.50,$138446.00,248,$601.50
2024-12-13,21:54:00,22051.5,BUY,3,0.02h,Stop Loss,$-9.00,$592.50,$138437.00,248,$592.50
2024-12-13,21:55:00,21763.5,SELL,3,0.02h,Stop Loss,$-9.00,$583.50,$138428.00,248,$583.50
,,,,,,,,,,,
2024-12-16,12:00:00,22160.5,BUY,3,0.02h,Stop Loss,$-9.00,$-9.00,$138419.00,249,$-9.00
2024-12-16,12:51:00,22172.0,SELL,3,0.02h,Stop Loss,$-9.00,$-18.00,$138410.00,249,$-18.00
2024-12-16,12:52:00,22174.0,BUY,3,0.02h,Stop Loss,$-9.00,$-27.00,$138401.00,249,$-27.00
2024-12-16,12:53:00,22170.75,SELL,3,0.02h,Stop Loss,$9.00,$-18.00,$138410.00,249,$-18.00
2024-12-16,13:01:00,22174.75,BUY,3,0.02h,Stop Loss,$-9.00,$-27.00,$138401.00,249,$-27.00
2024-12-16,13:02:00,22172.25,SELL,3,0.03h,Stop Loss,$-9.00,$-36.00,$138392.00,249,$-36.00
2024-12-16,13:13:00,22178.25,BUY,3,0.02h,Stop Loss,$18.00,$-18.00,$138410.00,249,$-18.00
2024-12-16,13:56:00,22199.75,SELL,3,0.02h,Break Even,$-1.50,$-19.50,$138408.50,249,$-19.50
2024-12-16,13:59:00,22207.25,BUY,3,0.02h,Stop Loss,$-9.00,$-28.50,$138399.50,249,$-28.50
2024-12-16,14:06:00,22196.0,SELL,3,0.02h,Stop Loss,$18.00,$-10.50,$138417.50,249,$-10.50
2024-12-16,14:31:00,22218.5,BUY,3,0.02h,Stop Loss,$60.00,$49.50,$138477.50,249,$49.50
2024-12-16,15:19:00,22256.5,SELL,3,0.02h,Stop Loss,$72.00,$121.50,$138549.50,249,$121.50
2024-12-16,15:26:00,22275.25,BUY,3,0.02h,Break Even,$-1.50,$120.00,$138548.00,249,$120.00
2024-12-16,15:54:00,22281.25,SELL,3,0.02h,Break Even,$-1.50,$118.50,$138546.50,249,$118.50
2024-12-16,15:57:00,22301.75,BUY,3,0.02h,Break Even,$-1.50,$117.00,$138545.00,249,$117.00
2024-12-16,16:00:00,22287.25,SELL,3,0.02h,Break Even,$-1.50,$115.50,$138543.50,249,$115.50
2024-12-16,16:01:00,22307.0,BUY,3,0.02h,Break Even,$-1.50,$114.00,$138542.00,249,$114.00
2024-12-16,16:35:00,22314.0,SELL,3,0.02h,Stop Loss,$6.00,$120.00,$138548.00,249,$120.00
2024-12-16,16:52:00,22326.25,BUY,3,0.02h,Break Even,$-1.50,$118.50,$138546.50,249,$118.50
2024-12-16,18:55:00,22412.5,SELL,3,0.02h,Break Even,$-1.50,$117.00,$138545.00,249,$117.00
2024-12-16,18:56:00,22415.75,BUY,3,0.02h,Break Even,$-1.50,$115.50,$138543.50,249,$115.50
2024-12-16,19:01:00,22404.0,SELL,3,0.02h,Break Even,$-1.50,$114.00,$138542.00,249,$114.00
2024-12-16,19:11:00,22417.5,BUY,3,0.02h,Stop Loss,$-9.00,$105.00,$138533.00,249,$105.00
2024-12-16,19:32:00,22422.75,SELL,3,0.02h,Break Even,$-1.50,$103.50,$138531.50,249,$103.50
2024-12-16,19:38:00,22430.5,BUY,3,0.02h,Stop Loss,$4.50,$108.00,$138536.00,249,$108.00
2024-12-16,20:00:00,22421.0,SELL,3,0.02h,Stop Loss,$-9.00,$99.00,$138527.00,249,$99.00
2024-12-16,20:06:00,22439.5,BUY,3,0.02h,Break Even,$-1.50,$97.50,$138525.50,249,$97.50
2024-12-16,20:34:00,22429.25,SELL,3,0.02h,Break Even,$-1.50,$96.00,$138524.00,249,$96.00
2024-12-16,21:37:00,22402.75,BUY,3,0.02h,Break Even,$-1.50,$94.50,$138522.50,249,$94.50
,,,,,,,,,,,
2024-12-17,12:00:00,22389.25,SELL,3,0.02h,Stop Loss,$1794.00,$1794.00,$140316.50,250,$1794.00
2024-12-17,12:28:00,22368.25,BUY,3,0.02h,Stop Loss,$-9.00,$1785.00,$140307.50,250,$1785.00
2024-12-17,12:41:00,22056.25,SELL,3,0.02h,Stop Loss,$-9.00,$1776.00,$140298.50,250,$1776.00
2024-12-17,12:42:00,22358.75,BUY,3,0.02h,Stop Loss,$-9.00,$1767.00,$140289.50,250,$1767.00
2024-12-17,12:43:00,22064.5,SELL,3,0.02h,Stop Loss,$7.50,$1774.50,$140297.00,250,$1774.50
2024-12-17,12:46:00,22363.75,BUY,3,0.02h,Stop Loss,$-9.00,$1765.50,$140288.00,250,$1765.50
2024-12-17,12:47:00,22061.0,SELL,3,0.02h,Break Even,$-1.50,$1764.00,$140286.50,250,$1764.00
2024-12-17,12:50:00,22360.75,BUY,3,0.02h,Stop Loss,$-9.00,$1755.00,$140277.50,250,$1755.00
2024-12-17,12:54:00,22060.25,SELL,3,0.02h,Stop Loss,$-9.00,$1746.00,$140268.50,250,$1746.00
2024-12-17,12:55:00,22360.25,BUY,3,0.02h,Stop Loss,$-9.00,$1737.00,$140259.50,250,$1737.00
2024-12-17,12:56:00,22055.0,SELL,3,0.02h,Stop Loss,$9.00,$1746.00,$140268.50,250,$1746.00
2024-12-17,13:11:00,22330.0,BUY,3,0.02h,Stop Loss,$-9.00,$1737.00,$140259.50,250,$1737.00
2024-12-17,13:12:00,22027.25,SELL,3,0.02h,Stop Loss,$-9.00,$1728.00,$140250.50,250,$1728.00
2024-12-17,13:13:00,22335.75,BUY,3,0.02h,Stop Loss,$-9.00,$1719.00,$140241.50,250,$1719.00
2024-12-17,13:14:00,22036.75,SELL,3,0.02h,Stop Loss,$6.00,$1725.00,$140247.50,250,$1725.00
2024-12-17,13:16:00,22340.25,BUY,3,0.02h,Stop Loss,$15.00,$1740.00,$140262.50,250,$1740.00
2024-12-17,13:19:00,22041.0,SELL,3,0.02h,Stop Loss,$-9.00,$1731.00,$140253.50,250,$1731.00
2024-12-17,13:20:00,22343.75,BUY,3,0.02h,Stop Loss,$-9.00,$1722.00,$140244.50,250,$1722.00
2024-12-17,13:21:00,22041.0,SELL,3,0.02h,Break Even,$-1.50,$1720.50,$140243.00,250,$1720.50
2024-12-17,13:24:00,22354.0,BUY,3,0.02h,Stop Loss,$-9.00,$1711.50,$140234.00,250,$1711.50
2024-12-17,13:27:00,22043.25,SELL,3,0.02h,Stop Loss,$-9.00,$1702.50,$140225.00,250,$1702.50
2024-12-17,13:28:00,22346.75,BUY,3,0.02h,Stop Loss,$-9.00,$1693.50,$140216.00,250,$1693.50
2024-12-17,13:36:00,22044.25,SELL,3,0.02h,Stop Loss,$72.00,$1765.50,$140288.00,250,$1765.50
2024-12-17,13:52:00,22344.5,BUY,3,0.02h,Break Even,$-1.50,$1764.00,$140286.50,250,$1764.00
2024-12-17,14:05:00,22062.75,SELL,3,0.02h,Stop Loss,$-9.00,$1755.00,$140277.50,250,$1755.00
2024-12-17,14:07:00,22365.5,BUY,3,0.02h,Stop Loss,$-9.00,$1746.00,$140268.50,250,$1746.00
2024-12-17,14:08:00,22061.5,SELL,3,0.02h,Stop Loss,$-9.00,$1737.00,$140259.50,250,$1737.00
2024-12-17,14:09:00,22364.0,BUY,3,0.02h,Stop Loss,$-9.00,$1728.00,$140250.50,250,$1728.00
2024-12-17,14:15:00,22052.25,SELL,3,0.02h,Stop Loss,$-9.00,$1719.00,$140241.50,250,$1719.00
2024-12-17,14:20:00,22354.75,BUY,3,0.02h,Stop Loss,$-9.00,$1710.00,$140232.50,250,$1710.00
2024-12-17,14:21:00,22047.5,SELL,3,0.02h,Stop Loss,$-9.00,$1701.00,$140223.50,250,$1701.00
2024-12-17,14:33:00,22324.75,BUY,3,0.02h,Stop Loss,$-9.00,$1692.00,$140214.50,250,$1692.00
2024-12-17,14:35:00,21994.75,SELL,3,0.02h,Stop Loss,$24.00,$1716.00,$140238.50,250,$1716.00
2024-12-17,14:45:00,22360.0,BUY,3,0.02h,Stop Loss,$22.50,$1738.50,$140261.00,250,$1738.50
2024-12-17,14:52:00,22042.25,SELL,3,0.02h,Stop Loss,$54.00,$1792.50,$140315.00,250,$1792.50
2024-12-17,14:55:00,22329.75,BUY,3,0.02h,Stop Loss,$-9.00,$1783.50,$140306.00,250,$1783.50
2024-12-17,14:56:00,22021.75,SELL,3,0.02h,Break Even,$-1.50,$1782.00,$140304.50,250,$1782.00
2024-12-17,14:59:00,22334.5,BUY,3,0.02h,Stop Loss,$-9.00,$1773.00,$140295.50,250,$1773.00
2024-12-17,15:03:00,21991.0,SELL,3,0.02h,Stop Loss,$-9.00,$1764.00,$140286.50,250,$1764.00
2024-12-17,15:04:00,22272.75,BUY,3,0.02h,Stop Loss,$45.00,$1809.00,$140331.50,250,$1809.00
2024-12-17,15:09:00,22002.5,SELL,3,0.02h,Stop Loss,$-9.00,$1800.00,$140322.50,250,$1800.00
2024-12-17,15:10:00,22308.75,BUY,3,0.02h,Stop Loss,$37.50,$1837.50,$140360.00,250,$1837.50
2024-12-17,15:15:00,21976.0,SELL,3,0.02h,Stop Loss,$-9.00,$1828.50,$140351.00,250,$1828.50
2024-12-17,15:17:00,22274.0,BUY,3,0.02h,Stop Loss,$42.00,$1870.50,$140393.00,250,$1870.50
2024-12-17,15:20:00,21956.0,SELL,3,0.02h,Stop Loss,$52.50,$1923.00,$140445.50,250,$1923.00
2024-12-17,15:23:00,22251.25,BUY,3,0.02h,Stop Loss,$-9.00,$1914.00,$140436.50,250,$1914.00
2024-12-17,15:24:00,21954.25,SELL,3,0.02h,Stop Loss,$-9.00,$1905.00,$140427.50,250,$1905.00
2024-12-17,15:26:00,22254.5,BUY,3,0.02h,Stop Loss,$-9.00,$1896.00,$140418.50,250,$1896.00
2024-12-17,15:27:00,21957.25,SELL,3,0.02h,Stop Loss,$19.50,$1915.50,$140438.00,250,$1915.50
2024-12-17,15:34:00,22257.0,BUY,3,0.02h,Stop Loss,$43.50,$1959.00,$140481.50,250,$1959.00
2024-12-17,15:36:00,21953.25,SELL,3,0.02h,Stop Loss,$-9.00,$1950.00,$140472.50,250,$1950.00
2024-12-17,15:37:00,22253.0,BUY,3,0.02h,Stop Loss,$-9.00,$1941.00,$140463.50,250,$1941.00
2024-12-17,15:38:00,21968.0,SELL,3,0.02h,Stop Loss,$-9.00,$1932.00,$140454.50,250,$1932.00
2024-12-17,15:43:00,22268.0,BUY,3,0.02h,Stop Loss,$37.50,$1969.50,$140492.00,250,$1969.50
2024-12-17,15:57:00,21994.0,SELL,3,0.02h,Stop Loss,$-9.00,$1960.50,$140483.00,250,$1960.50
2024-12-17,15:58:00,22307.25,BUY,3,0.02h,Stop Loss,$21.00,$1981.50,$140504.00,250,$1981.50
2024-12-17,16:05:00,22005.5,SELL,3,0.02h,Stop Loss,$51.00,$2032.50,$140555.00,250,$2032.50
2024-12-17,16:16:00,22347.5,BUY,3,0.02h,Stop Loss,$-9.00,$2023.50,$140546.00,250,$2023.50
2024-12-17,16:18:00,22029.25,SELL,3,0.02h,Stop Loss,$7.50,$2031.00,$140553.50,250,$2031.00
2024-12-17,16:20:00,22336.0,BUY,3,0.02h,Stop Loss,$-9.00,$2022.00,$140544.50,250,$2022.00
2024-12-17,16:21:00,22023.5,SELL,3,0.02h,Stop Loss,$-9.00,$2013.00,$140535.50,250,$2013.00
2024-12-17,16:22:00,22337.0,BUY,3,0.02h,Stop Loss,$-9.00,$2004.00,$140526.50,250,$2004.00
2024-12-17,16:24:00,22029.25,SELL,3,0.02h,Break Even,$-1.50,$2002.50,$140525.00,250,$2002.50
2024-12-17,16:27:00,22346.25,BUY,3,0.02h,Stop Loss,$33.00,$2035.50,$140558.00,250,$2035.50
2024-12-17,16:37:00,22073.0,SELL,3,0.02h,Stop Loss,$-9.00,$2026.50,$140549.00,250,$2026.50
2024-12-17,16:38:00,22382.0,BUY,3,0.02h,Stop Loss,$-9.00,$2017.50,$140540.00,250,$2017.50
2024-12-17,16:43:00,22079.25,SELL,3,0.02h,Stop Loss,$15.00,$2032.50,$140555.00,250,$2032.50
2024-12-17,16:46:00,22374.75,BUY,3,0.02h,Stop Loss,$30.00,$2062.50,$140585.00,250,$2062.50
2024-12-17,16:53:00,22050.5,SELL,3,0.02h,Stop Loss,$-9.00,$2053.50,$140576.00,250,$2053.50
2024-12-17,16:54:00,22341.75,BUY,3,0.02h,Stop Loss,$9.00,$2062.50,$140585.00,250,$2062.50
2024-12-17,17:03:00,22006.0,SELL,3,0.02h,Stop Loss,$46.50,$2109.00,$140631.50,250,$2109.00
2024-12-17,17:15:00,22327.75,BUY,3,0.02h,Stop Loss,$-9.00,$2100.00,$140622.50,250,$2100.00
2024-12-17,17:16:00,22029.25,SELL,3,0.02h,Stop Loss,$-9.00,$2091.00,$140613.50,250,$2091.00
2024-12-17,17:17:00,22322.0,BUY,3,0.02h,Stop Loss,$-9.00,$2082.00,$140604.50,250,$2082.00
2024-12-17,17:18:00,22024.5,SELL,3,0.02h,Stop Loss,$-9.00,$2073.00,$140595.50,250,$2073.00
2024-12-17,17:19:00,22324.0,BUY,3,0.02h,Stop Loss,$-9.00,$2064.00,$140586.50,250,$2064.00
2024-12-17,17:20:00,22012.0,SELL,3,0.02h,Stop Loss,$-9.00,$2055.00,$140577.50,250,$2055.00
2024-12-17,17:21:00,22318.5,BUY,3,0.02h,Stop Loss,$27.00,$2082.00,$140604.50,250,$2082.00
2024-12-17,17:24:00,22014.0,SELL,3,0.02h,Stop Loss,$27.00,$2109.00,$140631.50,250,$2109.00
2024-12-17,17:27:00,22319.25,BUY,3,0.02h,Stop Loss,$-9.00,$2100.00,$140622.50,250,$2100.00
2024-12-17,17:28:00,22028.0,SELL,3,0.02h,Stop Loss,$-9.00,$2091.00,$140613.50,250,$2091.00
2024-12-17,17:29:00,22334.25,BUY,3,0.02h,Stop Loss,$-9.00,$2082.00,$140604.50,250,$2082.00
2024-12-17,17:30:00,22036.75,SELL,3,0.02h,Stop Loss,$54.00,$2136.00,$140658.50,250,$2136.00
2024-12-17,17:32:00,22325.5,BUY,3,0.02h,Stop Loss,$39.00,$2175.00,$140697.50,250,$2175.00
2024-12-17,17:35:00,22040.5,SELL,3,0.02h,Stop Loss,$43.50,$2218.50,$140741.00,250,$2218.50
2024-12-17,17:40:00,22348.75,BUY,3,0.02h,Stop Loss,$-9.00,$2209.50,$140732.00,250,$2209.50
2024-12-17,17:51:00,22035.75,SELL,3,0.02h,Break Even,$-1.50,$2208.00,$140730.50,250,$2208.00
2024-12-17,17:56:00,22341.25,BUY,3,0.02h,Stop Loss,$-9.00,$2199.00,$140721.50,250,$2199.00
2024-12-17,17:57:00,22029.25,SELL,3,0.02h,Stop Loss,$-9.00,$2190.00,$140712.50,250,$2190.00
2024-12-17,17:58:00,22338.5,BUY,3,0.02h,Stop Loss,$4.50,$2194.50,$140717.00,250,$2194.50
2024-12-17,18:02:00,22027.75,SELL,3,0.02h,Stop Loss,$-9.00,$2185.50,$140708.00,250,$2185.50
2024-12-17,18:03:00,22331.5,BUY,3,0.02h,Stop Loss,$-9.00,$2176.50,$140699.00,250,$2176.50
2024-12-17,18:04:00,22033.25,SELL,3,0.02h,Stop Loss,$-9.00,$2167.50,$140690.00,250,$2167.50
2024-12-17,18:05:00,22335.5,BUY,3,0.02h,Stop Loss,$6.00,$2173.50,$140696.00,250,$2173.50
2024-12-17,18:14:00,22038.75,SELL,3,0.02h,Stop Loss,$-9.00,$2164.50,$140687.00,250,$2164.50
2024-12-17,18:15:00,22341.75,BUY,3,0.02h,Stop Loss,$-9.00,$2155.50,$140678.00,250,$2155.50
2024-12-17,18:16:00,22033.75,SELL,3,0.02h,Stop Loss,$-9.00,$2146.50,$140669.00,250,$2146.50
2024-12-17,18:27:00,22326.0,BUY,3,0.02h,Stop Loss,$-9.00,$2137.50,$140660.00,250,$2137.50
2024-12-17,18:28:00,22025.25,SELL,3,0.02h,Stop Loss,$45.00,$2182.50,$140705.00,250,$2182.50
2024-12-17,18:31:00,22323.75,BUY,3,0.02h,Stop Loss,$-9.00,$2173.50,$140696.00,250,$2173.50
2024-12-17,18:32:00,22012.75,SELL,3,0.02h,Break Even,$-1.50,$2172.00,$140694.50,250,$2172.00
2024-12-17,18:35:00,22329.25,BUY,3,0.02h,Break Even,$-1.50,$2170.50,$140693.00,250,$2170.50
2024-12-17,18:43:00,22026.25,SELL,3,0.02h,Stop Loss,$-9.00,$2161.50,$140684.00,250,$2161.50
2024-12-17,18:44:00,22330.0,BUY,3,0.02h,Break Even,$-1.50,$2160.00,$140682.50,250,$2160.00
2024-12-17,18:50:00,22000.75,SELL,3,0.02h,Stop Loss,$-9.00,$2151.00,$140673.50,250,$2151.00
2024-12-17,19:04:00,22294.75,BUY,3,0.02h,Stop Loss,$52.50,$2203.50,$140726.00,250,$2203.50
2024-12-17,19:06:00,21990.0,SELL,3,0.02h,Stop Loss,$-9.00,$2194.50,$140717.00,250,$2194.50
2024-12-17,19:07:00,22292.0,BUY,3,0.02h,Break Even,$-1.50,$2193.00,$140715.50,250,$2193.00
2024-12-17,19:09:00,21993.0,SELL,3,0.02h,Stop Loss,$-9.00,$2184.00,$140706.50,250,$2184.00
2024-12-17,19:10:00,22295.0,BUY,3,0.02h,Stop Loss,$-9.00,$2175.00,$140697.50,250,$2175.00
2024-12-17,19:11:00,21999.75,SELL,3,0.02h,Break Even,$-1.50,$2173.50,$140696.00,250,$2173.50
2024-12-17,19:21:00,22285.75,BUY,3,0.02h,Stop Loss,$13.50,$2187.00,$140709.50,250,$2187.00
2024-12-17,19:25:00,21984.0,SELL,3,0.02h,Stop Loss,$-9.00,$2178.00,$140700.50,250,$2178.00
2024-12-17,19:26:00,22283.0,BUY,3,0.02h,Stop Loss,$19.50,$2197.50,$140720.00,250,$2197.50
2024-12-17,19:28:00,21988.75,SELL,3,0.02h,Stop Loss,$16.50,$2214.00,$140736.50,250,$2214.00
2024-12-17,19:32:00,22282.25,BUY,3,0.02h,Stop Loss,$-9.00,$2205.00,$140727.50,250,$2205.00
2024-12-17,19:36:00,21981.0,SELL,3,0.02h,Stop Loss,$-9.00,$2196.00,$140718.50,250,$2196.00
2024-12-17,19:37:00,22274.5,BUY,3,0.02h,Stop Loss,$-9.00,$2187.00,$140709.50,250,$2187.00
2024-12-17,19:38:00,21968.0,SELL,3,0.02h,Break Even,$-1.50,$2185.50,$140708.00,250,$2185.50
2024-12-17,19:48:00,22271.75,BUY,3,0.02h,Stop Loss,$3.00,$2188.50,$140711.00,250,$2188.50
2024-12-17,19:54:00,21974.5,SELL,3,0.02h,Stop Loss,$-9.00,$2179.50,$140702.00,250,$2179.50
2024-12-17,19:56:00,22283.25,BUY,3,0.02h,Stop Loss,$-9.00,$2170.50,$140693.00,250,$2170.50
2024-12-17,19:57:00,21986.75,SELL,3,0.02h,Stop Loss,$-9.00,$2161.50,$140684.00,250,$2161.50
2024-12-17,20:00:00,22281.25,BUY,3,0.02h,Stop Loss,$-9.00,$2152.50,$140675.00,250,$2152.50
2024-12-17,20:01:00,21979.75,SELL,3,0.02h,Stop Loss,$-9.00,$2143.50,$140666.00,250,$2143.50
2024-12-17,20:02:00,22287.5,BUY,3,0.02h,Stop Loss,$-9.00,$2134.50,$140657.00,250,$2134.50
2024-12-17,20:03:00,21984.0,SELL,3,0.02h,Stop Loss,$7.50,$2142.00,$140664.50,250,$2142.00
2024-12-17,20:10:00,22283.0,BUY,3,0.02h,Stop Loss,$15.00,$2157.00,$140679.50,250,$2157.00
2024-12-17,20:22:00,21966.75,SELL,3,0.02h,Break Even,$-1.50,$2155.50,$140678.00,250,$2155.50
2024-12-17,20:29:00,22262.5,BUY,3,0.02h,Stop Loss,$31.50,$2187.00,$140709.50,250,$2187.00
2024-12-17,20:45:00,22007.75,SELL,3,0.02h,Stop Loss,$-9.00,$2178.00,$140700.50,250,$2178.00
2024-12-17,20:46:00,22310.0,BUY,3,0.02h,Stop Loss,$18.00,$2196.00,$140718.50,250,$2196.00
2024-12-17,20:48:00,21995.25,SELL,3,0.02h,Stop Loss,$-9.00,$2187.00,$140709.50,250,$2187.00
2024-12-17,20:49:00,22301.25,BUY,3,0.02h,Stop Loss,$-9.00,$2178.00,$140700.50,250,$2178.00
2024-12-17,20:50:00,21998.5,SELL,3,0.02h,Stop Loss,$-9.00,$2169.00,$140691.50,250,$2169.00
2024-12-17,20:55:00,22322.75,BUY,3,0.02h,Stop Loss,$16.50,$2185.50,$140708.00,250,$2185.50
2024-12-17,20:59:00,22026.5,SELL,3,0.02h,Stop Loss,$85.50,$2271.00,$140793.50,250,$2271.00
2024-12-17,21:03:00,22304.25,BUY,3,0.02h,Stop Loss,$-9.00,$2262.00,$140784.50,250,$2262.00
2024-12-17,21:04:00,21994.75,SELL,3,0.02h,Stop Loss,$-9.00,$2253.00,$140775.50,250,$2253.00
2024-12-17,21:05:00,22288.0,BUY,3,0.02h,Stop Loss,$-9.00,$2244.00,$140766.50,250,$2244.00
2024-12-17,21:06:00,21991.25,SELL,3,0.02h,Stop Loss,$-9.00,$2235.00,$140757.50,250,$2235.00
2024-12-17,21:12:00,22295.25,BUY,3,0.02h,Break Even,$-1.50,$2233.50,$140756.00,250,$2233.50
2024-12-17,21:19:00,21994.0,SELL,3,0.02h,Stop Loss,$-9.00,$2224.50,$140747.00,250,$2224.50
2024-12-17,21:29:00,22314.25,BUY,3,0.02h,Stop Loss,$-9.00,$2215.50,$140738.00,250,$2215.50
2024-12-17,21:30:00,22011.5,SELL,3,0.02h,Stop Loss,$-9.00,$2206.50,$140729.00,250,$2206.50
2024-12-17,21:34:00,22312.75,BUY,3,0.02h,Stop Loss,$-9.00,$2197.50,$140720.00,250,$2197.50
2024-12-17,21:48:00,21997.75,SELL,3,0.02h,Stop Loss,$-9.00,$2188.50,$140711.00,250,$2188.50
2024-12-17,21:53:00,22305.5,BUY,3,0.02h,Stop Loss,$-9.00,$2179.50,$140702.00,250,$2179.50
2024-12-17,21:57:00,22005.0,SELL,3,0.03h,Break Even,$-1.50,$2178.00,$140700.50,250,$2178.00
,,,,,,,,,,,
2024-12-18,12:09:00,22375.75,BUY,3,0.02h,Stop Loss,$-9.00,$-9.00,$140691.50,251,$-9.00
2024-12-18,12:11:00,22076.5,SELL,3,0.02h,Break Even,$-1.50,$-10.50,$140690.00,251,$-10.50
2024-12-18,12:18:00,22384.25,BUY,3,0.02h,Stop Loss,$-9.00,$-19.50,$140681.00,251,$-19.50
2024-12-18,12:25:00,22083.25,SELL,3,0.03h,Stop Loss,$3.00,$-16.50,$140684.00,251,$-16.50
2024-12-18,12:27:00,22378.75,BUY,3,0.02h,Stop Loss,$-9.00,$-25.50,$140675.00,251,$-25.50
2024-12-18,12:30:00,22070.75,SELL,3,0.02h,Stop Loss,$-9.00,$-34.50,$140666.00,251,$-34.50
2024-12-18,12:31:00,22378.25,BUY,3,0.02h,Stop Loss,$-9.00,$-43.50,$140657.00,251,$-43.50
2024-12-18,12:34:00,22071.75,SELL,3,0.03h,Stop Loss,$-9.00,$-52.50,$140648.00,251,$-52.50
2024-12-18,12:36:00,22377.75,BUY,3,0.02h,Stop Loss,$-9.00,$-61.50,$140639.00,251,$-61.50
2024-12-18,12:43:00,22069.75,SELL,3,0.02h,Break Even,$-1.50,$-63.00,$140637.50,251,$-63.00
2024-12-18,12:49:00,22373.75,BUY,3,0.02h,Break Even,$-1.50,$-64.50,$140636.00,251,$-64.50
2024-12-18,13:01:00,22070.5,SELL,3,0.02h,Stop Loss,$13.50,$-51.00,$140649.50,251,$-51.00
2024-12-18,13:03:00,22370.25,BUY,3,0.02h,Break Even,$-1.50,$-52.50,$140648.00,251,$-52.50
2024-12-18,13:08:00,22067.0,SELL,3,0.02h,Break Even,$-1.50,$-54.00,$140646.50,251,$-54.00
2024-12-18,13:10:00,22367.75,BUY,3,0.02h,Stop Loss,$-9.00,$-63.00,$140637.50,251,$-63.00
2024-12-18,13:11:00,22066.25,SELL,3,0.02h,Stop Loss,$-9.00,$-72.00,$140628.50,251,$-72.00
2024-12-18,13:13:00,22364.75,BUY,3,0.02h,Stop Loss,$-9.00,$-81.00,$140619.50,251,$-81.00
2024-12-18,13:14:00,22063.75,SELL,3,0.02h,Break Even,$-1.50,$-82.50,$140618.00,251,$-82.50
2024-12-18,13:20:00,22358.5,BUY,3,0.02h,Stop Loss,$-9.00,$-91.50,$140609.00,251,$-91.50
2024-12-18,13:23:00,22054.5,SELL,3,0.02h,Stop Loss,$-9.00,$-100.50,$140600.00,251,$-100.50
2024-12-18,13:27:00,22368.5,BUY,3,0.02h,Stop Loss,$-9.00,$-109.50,$140591.00,251,$-109.50
2024-12-18,13:38:00,22050.25,SELL,3,0.02h,Stop Loss,$28.50,$-81.00,$140619.50,251,$-81.00
2024-12-18,13:41:00,22341.25,BUY,3,0.02h,Stop Loss,$-9.00,$-90.00,$140610.50,251,$-90.00
2024-12-18,13:42:00,22036.0,SELL,3,0.02h,Stop Loss,$52.50,$-37.50,$140663.00,251,$-37.50
2024-12-18,14:02:00,22297.0,BUY,3,0.02h,Stop Loss,$22.50,$-15.00,$140685.50,251,$-15.00
2024-12-18,14:05:00,21986.75,SELL,3,0.02h,Stop Loss,$-9.00,$-24.00,$140676.50,251,$-24.00
2024-12-18,14:08:00,22282.75,BUY,3,0.02h,Stop Loss,$-9.00,$-33.00,$140667.50,251,$-33.00
2024-12-18,14:09:00,21979.25,SELL,3,0.02h,Stop Loss,$4.50,$-28.50,$140672.00,251,$-28.50
2024-12-18,14:25:00,22281.5,BUY,3,0.02h,Stop Loss,$22.50,$-6.00,$140694.50,251,$-6.00
2024-12-18,14:34:00,21956.25,SELL,3,0.02h,Stop Loss,$166.50,$160.50,$140861.00,251,$160.50
2024-12-18,14:37:00,22233.0,BUY,3,0.02h,Stop Loss,$-9.00,$151.50,$140852.00,251,$151.50
2024-12-18,14:38:00,21935.75,SELL,3,0.02h,Stop Loss,$-9.00,$142.50,$140843.00,251,$142.50
2024-12-18,14:39:00,22232.75,BUY,3,0.02h,Stop Loss,$-9.00,$133.50,$140834.00,251,$133.50
2024-12-18,14:40:00,21954.25,SELL,3,0.02h,Stop Loss,$6.00,$139.50,$140840.00,251,$139.50
2024-12-18,14:42:00,22250.5,BUY,3,0.02h,Stop Loss,$121.50,$261.00,$140961.50,251,$261.00
2024-12-18,14:47:00,21955.5,SELL,3,0.02h,Break Even,$-1.50,$259.50,$140960.00,251,$259.50
2024-12-18,14:57:00,22289.25,BUY,3,0.02h,Stop Loss,$31.50,$291.00,$140991.50,251,$291.00
2024-12-18,15:13:00,22007.5,SELL,3,0.02h,Stop Loss,$28.50,$319.50,$141020.00,251,$319.50
2024-12-18,15:15:00,22310.0,BUY,3,0.02h,Stop Loss,$-9.00,$310.50,$141011.00,251,$310.50
2024-12-18,15:35:00,22007.75,SELL,3,0.02h,Stop Loss,$-9.00,$301.50,$141002.00,251,$301.50
2024-12-18,15:37:00,22298.0,BUY,3,0.02h,Stop Loss,$31.50,$333.00,$141033.50,251,$333.00
2024-12-18,15:39:00,22016.0,SELL,3,0.02h,Stop Loss,$3.00,$336.00,$141036.50,251,$336.00
2024-12-18,15:49:00,22346.0,BUY,3,0.02h,Stop Loss,$-9.00,$327.00,$141027.50,251,$327.00
2024-12-18,15:50:00,22050.0,SELL,3,0.02h,Stop Loss,$16.50,$343.50,$141044.00,251,$343.50
2024-12-18,15:52:00,22337.0,BUY,3,0.02h,Break Even,$-1.50,$342.00,$141042.50,251,$342.00
2024-12-18,15:54:00,22032.75,SELL,3,0.02h,Stop Loss,$-9.00,$333.00,$141033.50,251,$333.00
2024-12-18,15:55:00,22326.25,BUY,3,0.02h,Stop Loss,$39.00,$372.00,$141072.50,251,$372.00
2024-12-18,15:59:00,22031.75,SELL,3,0.02h,Stop Loss,$39.00,$411.00,$141111.50,251,$411.00
2024-12-18,16:10:00,22321.25,BUY,3,0.02h,Stop Loss,$-9.00,$402.00,$141102.50,251,$402.00
2024-12-18,16:11:00,22024.75,SELL,3,0.02h,Stop Loss,$48.00,$450.00,$141150.50,251,$450.00
2024-12-18,16:17:00,22288.25,BUY,3,0.02h,Stop Loss,$-9.00,$441.00,$141141.50,251,$441.00
2024-12-18,16:21:00,21964.5,SELL,3,0.02h,Stop Loss,$-9.00,$432.00,$141132.50,251,$432.00
2024-12-18,16:22:00,22252.5,BUY,3,0.02h,Stop Loss,$-9.00,$423.00,$141123.50,251,$423.00
2024-12-18,16:23:00,21961.5,SELL,3,0.02h,Stop Loss,$-9.00,$414.00,$141114.50,251,$414.00
2024-12-18,16:24:00,22261.25,BUY,3,0.02h,Stop Loss,$16.50,$430.50,$141131.00,251,$430.50
2024-12-18,16:31:00,22013.75,SELL,3,0.02h,Stop Loss,$-9.00,$421.50,$141122.00,251,$421.50
2024-12-18,16:32:00,22308.5,BUY,3,0.02h,Stop Loss,$27.00,$448.50,$141149.00,251,$448.50
2024-12-18,16:38:00,22012.5,SELL,3,0.02h,Break Even,$-1.50,$447.00,$141147.50,251,$447.00
2024-12-18,16:41:00,22315.0,BUY,3,0.02h,Stop Loss,$7.50,$454.50,$141155.00,251,$454.50
2024-12-18,16:44:00,22020.5,SELL,3,0.02h,Break Even,$-1.50,$453.00,$141153.50,251,$453.00
2024-12-18,16:49:00,22313.5,BUY,3,0.02h,Stop Loss,$-9.00,$444.00,$141144.50,251,$444.00
2024-12-18,16:52:00,22021.0,SELL,3,0.02h,Stop Loss,$-9.00,$435.00,$141135.50,251,$435.00
2024-12-18,16:53:00,22323.25,BUY,3,0.02h,Stop Loss,$4.50,$439.50,$141140.00,251,$439.50
2024-12-18,16:56:00,22018.0,SELL,3,0.02h,Stop Loss,$-9.00,$430.50,$141131.00,251,$430.50
2024-12-18,16:57:00,22309.5,BUY,3,0.02h,Stop Loss,$-9.00,$421.50,$141122.00,251,$421.50
2024-12-18,16:59:00,22011.5,SELL,3,0.02h,Stop Loss,$-9.00,$412.50,$141113.00,251,$412.50
2024-12-18,17:00:00,22305.0,BUY,3,0.02h,Stop Loss,$-9.00,$403.50,$141104.00,251,$403.50
2024-12-18,17:03:00,22003.75,SELL,3,0.02h,Break Even,$-1.50,$402.00,$141102.50,251,$402.00
2024-12-18,17:07:00,22305.5,BUY,3,0.02h,Stop Loss,$16.50,$418.50,$141119.00,251,$418.50
2024-12-18,17:13:00,22005.0,SELL,3,0.02h,Stop Loss,$22.50,$441.00,$141141.50,251,$441.00
2024-12-18,17:17:00,22296.25,BUY,3,0.02h,Stop Loss,$48.00,$489.00,$141189.50,251,$489.00
2024-12-18,17:21:00,22016.25,SELL,3,0.02h,Break Even,$-1.50,$487.50,$141188.00,251,$487.50
2024-12-18,17:30:00,22299.5,BUY,3,0.02h,Stop Loss,$-9.00,$478.50,$141179.00,251,$478.50
2024-12-18,17:31:00,22001.0,SELL,3,0.02h,Stop Loss,$-9.00,$469.50,$141170.00,251,$469.50
2024-12-18,17:32:00,22290.75,BUY,3,0.02h,Break Even,$-1.50,$468.00,$141168.50,251,$468.00
2024-12-18,17:34:00,21996.5,SELL,3,0.02h,Stop Loss,$-9.00,$459.00,$141159.50,251,$459.00
2024-12-18,17:35:00,22296.5,BUY,3,0.02h,Stop Loss,$-9.00,$450.00,$141150.50,251,$450.00
2024-12-18,17:36:00,22010.0,SELL,3,0.02h,Stop Loss,$-9.00,$441.00,$141141.50,251,$441.00
2024-12-18,17:38:00,22305.25,BUY,3,0.02h,Stop Loss,$-9.00,$432.00,$141132.50,251,$432.00
2024-12-18,17:39:00,21997.75,SELL,3,0.02h,Stop Loss,$33.00,$465.00,$141165.50,251,$465.00
2024-12-18,17:54:00,22293.5,BUY,3,0.02h,Stop Loss,$-9.00,$456.00,$141156.50,251,$456.00
2024-12-18,17:55:00,22004.25,SELL,3,0.02h,Break Even,$-1.50,$454.50,$141155.00,251,$454.50
2024-12-18,17:57:00,22301.0,BUY,3,0.02h,Break Even,$-1.50,$453.00,$141153.50,251,$453.00
2024-12-18,18:03:00,21999.75,SELL,3,0.02h,Stop Loss,$-9.00,$444.00,$141144.50,251,$444.00
2024-12-18,18:04:00,22300.0,BUY,3,0.02h,Break Even,$-1.50,$442.50,$141143.00,251,$442.50
2024-12-18,18:10:00,22012.25,SELL,3,0.02h,Stop Loss,$-9.00,$433.50,$141134.00,251,$433.50
2024-12-18,18:11:00,22306.25,BUY,3,0.02h,Stop Loss,$-9.00,$424.50,$141125.00,251,$424.50
2024-12-18,18:18:00,22006.25,SELL,3,0.02h,Break Even,$-1.50,$423.00,$141123.50,251,$423.00
2024-12-18,18:24:00,22307.5,BUY,3,0.02h,Stop Loss,$-9.00,$414.00,$141114.50,251,$414.00
2024-12-18,18:25:00,22012.0,SELL,3,0.02h,Stop Loss,$-9.00,$405.00,$141105.50,251,$405.00
2024-12-18,18:26:00,22301.0,BUY,3,0.02h,Stop Loss,$-9.00,$396.00,$141096.50,251,$396.00
2024-12-18,18:27:00,22005.0,SELL,3,0.02h,Break Even,$-1.50,$394.50,$141095.00,251,$394.50
2024-12-18,18:31:00,22290.5,BUY,3,0.02h,Stop Loss,$27.00,$421.50,$141122.00,251,$421.50
2024-12-18,18:41:00,21988.5,SELL,3,0.02h,Stop Loss,$-9.00,$412.50,$141113.00,251,$412.50
2024-12-18,18:42:00,22279.75,BUY,3,0.02h,Stop Loss,$-9.00,$403.50,$141104.00,251,$403.50
2024-12-18,18:43:00,21983.0,SELL,3,0.02h,Stop Loss,$-9.00,$394.50,$141095.00,251,$394.50
2024-12-18,18:44:00,22277.0,BUY,3,0.02h,Break Even,$-1.50,$393.00,$141093.50,251,$393.00
2024-12-18,18:46:00,21980.75,SELL,3,0.02h,Stop Loss,$-9.00,$384.00,$141084.50,251,$384.00
2024-12-18,18:47:00,22278.25,BUY,3,0.02h,Stop Loss,$18.00,$402.00,$141102.50,251,$402.00
2024-12-18,18:49:00,21993.75,SELL,3,0.02h,Stop Loss,$-9.00,$393.00,$141093.50,251,$393.00
2024-12-18,18:50:00,22285.5,BUY,3,0.02h,Stop Loss,$-9.00,$384.00,$141084.50,251,$384.00
2024-12-18,18:51:00,21991.0,SELL,3,0.02h,Break Even,$-1.50,$382.50,$141083.00,251,$382.50
2024-12-18,19:02:00,22229.75,BUY,3,0.02h,Stop Loss,$-9.00,$373.50,$141074.00,251,$373.50
2024-12-18,19:03:00,21963.25,SELL,3,0.02h,Stop Loss,$154.50,$528.00,$141228.50,251,$528.00
2024-12-18,19:15:00,22119.0,BUY,3,0.02h,Stop Loss,$51.00,$579.00,$141279.50,251,$579.00
2024-12-18,19:20:00,21807.75,SELL,3,0.02h,Stop Loss,$-9.00,$570.00,$141270.50,251,$570.00
2024-12-18,19:22:00,22136.25,BUY,3,0.02h,Stop Loss,$121.50,$691.50,$141392.00,251,$691.50
2024-12-18,19:26:00,21860.25,SELL,3,0.02h,Stop Loss,$-9.00,$682.50,$141383.00,251,$682.50
2024-12-18,19:27:00,22137.75,BUY,3,0.02h,Stop Loss,$-9.00,$673.50,$141374.00,251,$673.50
2024-12-18,19:28:00,21842.75,SELL,3,0.02h,Stop Loss,$-9.00,$664.50,$141365.00,251,$664.50
2024-12-18,19:44:00,22050.5,BUY,3,0.02h,Stop Loss,$-9.00,$655.50,$141356.00,251,$655.50
2024-12-18,19:45:00,21758.0,SELL,3,0.02h,Stop Loss,$-9.00,$646.50,$141347.00,251,$646.50
2024-12-18,20:15:00,21832.5,BUY,3,0.02h,Stop Loss,$-9.00,$637.50,$141338.00,251,$637.50
2024-12-18,20:16:00,21512.0,SELL,3,0.02h,Stop Loss,$21.00,$658.50,$141359.00,251,$658.50
2024-12-18,20:54:00,21647.0,BUY,3,0.02h,Stop Loss,$234.00,$892.50,$141593.00,251,$892.50
2024-12-18,20:59:00,21276.75,SELL,3,0.02h,Stop Loss,$493.50,$1386.00,$142086.50,251,$1386.00
2024-12-18,21:17:00,21453.5,BUY,3,0.02h,Break Even,$-1.50,$1384.50,$142085.00,251,$1384.50
2024-12-18,21:20:00,21142.5,SELL,3,0.02h,Stop Loss,$-9.00,$1375.50,$142076.00,251,$1375.50
2024-12-18,21:21:00,21437.5,BUY,3,0.02h,Stop Loss,$-9.00,$1366.50,$142067.00,251,$1366.50
2024-12-18,21:22:00,21179.5,SELL,3,0.02h,Stop Loss,$-9.00,$1357.50,$142058.00,251,$1357.50
2024-12-18,21:25:00,21479.25,BUY,3,0.02h,Break Even,$-1.50,$1356.00,$142056.50,251,$1356.00
2024-12-18,21:29:00,21168.75,SELL,3,0.02h,Stop Loss,$-9.00,$1347.00,$142047.50,251,$1347.00
2024-12-18,21:30:00,21456.0,BUY,3,0.02h,Stop Loss,$-9.00,$1338.00,$142038.50,251,$1338.00
2024-12-18,21:31:00,21181.5,SELL,3,0.02h,Stop Loss,$100.50,$1438.50,$142139.00,251,$1438.50
2024-12-18,21:43:00,21422.5,BUY,3,0.02h,Stop Loss,$-9.00,$1429.50,$142130.00,251,$1429.50
2024-12-18,21:44:00,21152.5,SELL,3,0.02h,Stop Loss,$-9.00,$1420.50,$142121.00,251,$1420.50
2024-12-18,21:49:00,21448.0,BUY,3,0.02h,Stop Loss,$93.00,$1513.50,$142214.00,251,$1513.50
2024-12-18,21:56:00,21184.0,SELL,3,0.02h,Stop Loss,$-9.00,$1504.50,$142205.00,251,$1504.50
2024-12-18,21:57:00,21466.5,BUY,3,0.02h,Stop Loss,$12.00,$1516.50,$142217.00,251,$1516.50
2024-12-18,22:00:00,21186.0,SELL,3,14.00h,Stop Loss,$-9.00,$1507.50,$142208.00,251,$1507.50
,,,,,,,,,,,
2024-12-19,12:00:00,21575.25,BUY,3,0.02h,Stop Loss,$43.50,$43.50,$142251.50,252,$43.50
2024-12-19,12:19:00,21358.25,SELL,3,0.02h,Stop Loss,$12.00,$55.50,$142263.50,252,$55.50
2024-12-19,12:24:00,21656.25,BUY,3,0.02h,Stop Loss,$3.00,$58.50,$142266.50,252,$58.50
2024-12-19,12:37:00,21375.0,SELL,3,0.02h,Stop Loss,$31.50,$90.00,$142298.00,252,$90.00
2024-12-19,12:46:00,21665.0,BUY,3,0.02h,Stop Loss,$-9.00,$81.00,$142289.00,252,$81.00
2024-12-19,12:58:00,21397.5,SELL,3,0.02h,Break Even,$-1.50,$79.50,$142287.50,252,$79.50
2024-12-19,13:03:00,21678.0,BUY,3,0.02h,Break Even,$-1.50,$78.00,$142286.00,252,$78.00
2024-12-19,13:12:00,21392.0,SELL,3,0.02h,Stop Loss,$-9.00,$69.00,$142277.00,252,$69.00
2024-12-19,13:13:00,21671.5,BUY,3,0.02h,Break Even,$-1.50,$67.50,$142275.50,252,$67.50
2024-12-19,13:15:00,21399.0,SELL,3,0.02h,Break Even,$-1.50,$66.00,$142274.00,252,$66.00
2024-12-19,13:23:00,21671.5,BUY,3,0.02h,Stop Loss,$-9.00,$57.00,$142265.00,252,$57.00
2024-12-19,13:24:00,21397.0,SELL,3,0.02h,Break Even,$-1.50,$55.50,$142263.50,252,$55.50
2024-12-19,13:35:00,21659.0,BUY,3,0.02h,Stop Loss,$-9.00,$46.50,$142254.50,252,$46.50
2024-12-19,13:41:00,21391.75,SELL,3,0.02h,Stop Loss,$82.50,$129.00,$142337.00,252,$129.00
2024-12-19,13:44:00,21649.25,BUY,3,0.02h,Stop Loss,$-9.00,$120.00,$142328.00,252,$120.00
2024-12-19,13:45:00,21362.5,SELL,3,0.02h,Stop Loss,$-9.00,$111.00,$142319.00,252,$111.00
2024-12-19,13:46:00,21638.0,BUY,3,0.02h,Stop Loss,$-9.00,$102.00,$142310.00,252,$102.00
2024-12-19,13:47:00,21367.25,SELL,3,0.02h,Break Even,$-1.50,$100.50,$142308.50,252,$100.50
2024-12-19,13:50:00,21649.0,BUY,3,0.02h,Stop Loss,$-9.00,$91.50,$142299.50,252,$91.50
2024-12-19,14:03:00,21341.5,SELL,3,0.02h,Stop Loss,$10.50,$102.00,$142310.00,252,$102.00
2024-12-19,14:09:00,21651.0,BUY,3,0.02h,Stop Loss,$6.00,$108.00,$142316.00,252,$108.00
2024-12-19,14:17:00,21374.0,SELL,3,0.02h,Stop Loss,$-9.00,$99.00,$142307.00,252,$99.00
2024-12-19,14:23:00,21661.25,BUY,3,0.02h,Stop Loss,$-9.00,$90.00,$142298.00,252,$90.00
2024-12-19,14:25:00,21379.5,SELL,3,0.02h,Break Even,$-1.50,$88.50,$142296.50,252,$88.50
2024-12-19,14:33:00,21647.25,BUY,3,0.02h,Stop Loss,$225.00,$313.50,$142521.50,252,$313.50
2024-12-19,14:41:00,21334.75,SELL,3,0.02h,Stop Loss,$126.00,$439.50,$142647.50,252,$439.50
2024-12-19,14:50:00,21603.75,BUY,3,0.02h,Stop Loss,$73.50,$513.00,$142721.00,252,$513.00
2024-12-19,14:54:00,21325.5,SELL,3,0.02h,Stop Loss,$-9.00,$504.00,$142712.00,252,$504.00
2024-12-19,14:58:00,21592.0,BUY,3,0.02h,Break Even,$-1.50,$502.50,$142710.50,252,$502.50
2024-12-19,15:03:00,21304.5,SELL,3,0.02h,Stop Loss,$28.50,$531.00,$142739.00,252,$531.00
2024-12-19,15:12:00,21593.25,BUY,3,0.02h,Stop Loss,$-9.00,$522.00,$142730.00,252,$522.00
2024-12-19,15:13:00,21323.5,SELL,3,0.02h,Stop Loss,$-9.00,$513.00,$142721.00,252,$513.00
2024-12-19,15:15:00,21629.75,BUY,3,0.02h,Stop Loss,$-9.00,$504.00,$142712.00,252,$504.00
2024-12-19,15:16:00,21335.5,SELL,3,0.02h,Stop Loss,$45.00,$549.00,$142757.00,252,$549.00
2024-12-19,15:22:00,21587.75,BUY,3,0.02h,Break Even,$-1.50,$547.50,$142755.50,252,$547.50
2024-12-19,15:24:00,21273.25,SELL,3,0.02h,Stop Loss,$27.00,$574.50,$142782.50,252,$574.50
2024-12-19,15:33:00,21507.75,BUY,3,0.02h,Stop Loss,$34.50,$609.00,$142817.00,252,$609.00
2024-12-19,15:35:00,21217.0,SELL,3,0.02h,Stop Loss,$15.00,$624.00,$142832.00,252,$624.00
2024-12-19,15:38:00,21515.5,BUY,3,0.02h,Stop Loss,$96.00,$720.00,$142928.00,252,$720.00
2024-12-19,15:44:00,21274.0,SELL,3,0.02h,Stop Loss,$21.00,$741.00,$142949.00,252,$741.00
2024-12-19,15:51:00,21576.5,BUY,3,0.02h,Stop Loss,$-9.00,$732.00,$142940.00,252,$732.00
2024-12-19,15:52:00,21280.75,SELL,3,0.02h,Stop Loss,$109.50,$841.50,$143049.50,252,$841.50
2024-12-19,15:57:00,21513.5,BUY,3,0.02h,Stop Loss,$82.50,$924.00,$143132.00,252,$924.00
2024-12-19,16:03:00,21233.0,SELL,3,0.02h,Break Even,$-1.50,$922.50,$143130.50,252,$922.50
2024-12-19,16:08:00,21478.5,BUY,3,0.02h,Stop Loss,$-9.00,$913.50,$143121.50,252,$913.50
2024-12-19,16:09:00,21204.5,SELL,3,0.02h,Stop Loss,$-9.00,$904.50,$143112.50,252,$904.50
2024-12-19,16:10:00,21473.75,BUY,3,0.02h,Stop Loss,$-9.00,$895.50,$143103.50,252,$895.50
2024-12-19,16:11:00,21206.75,SELL,3,0.02h,Stop Loss,$42.00,$937.50,$143145.50,252,$937.50
2024-12-19,16:14:00,21480.0,BUY,3,0.02h,Stop Loss,$-9.00,$928.50,$143136.50,252,$928.50
2024-12-19,16:15:00,21211.0,SELL,3,0.02h,Stop Loss,$-9.00,$919.50,$143127.50,252,$919.50
2024-12-19,16:16:00,21508.25,BUY,3,0.02h,Stop Loss,$-9.00,$910.50,$143118.50,252,$910.50
2024-12-19,16:17:00,21234.0,SELL,3,0.02h,Break Even,$-1.50,$909.00,$143117.00,252,$909.00
2024-12-19,16:22:00,21547.25,BUY,3,0.02h,Stop Loss,$-9.00,$900.00,$143108.00,252,$900.00
2024-12-19,16:24:00,21324.5,SELL,3,0.02h,Stop Loss,$24.00,$924.00,$143132.00,252,$924.00
2024-12-19,16:30:00,21602.0,BUY,3,0.02h,Stop Loss,$-9.00,$915.00,$143123.00,252,$915.00
2024-12-19,16:46:00,21303.25,SELL,3,0.02h,Break Even,$-1.50,$913.50,$143121.50,252,$913.50
2024-12-19,16:48:00,21596.5,BUY,3,0.02h,Stop Loss,$-9.00,$904.50,$143112.50,252,$904.50
2024-12-19,16:49:00,21320.0,SELL,3,0.02h,Break Even,$-1.50,$903.00,$143111.00,252,$903.00
2024-12-19,16:54:00,21552.5,BUY,3,0.02h,Stop Loss,$9.00,$912.00,$143120.00,252,$912.00
2024-12-19,17:01:00,21287.25,SELL,3,0.02h,Stop Loss,$-9.00,$903.00,$143111.00,252,$903.00
2024-12-19,17:02:00,21550.25,BUY,3,0.02h,Stop Loss,$76.50,$979.50,$143187.50,252,$979.50
2024-12-19,17:12:00,21262.5,SELL,3,0.02h,Break Even,$-1.50,$978.00,$143186.00,252,$978.00
2024-12-19,17:21:00,21502.0,BUY,3,0.02h,Break Even,$-1.50,$976.50,$143184.50,252,$976.50
2024-12-19,17:23:00,21207.75,SELL,3,0.02h,Stop Loss,$-9.00,$967.50,$143175.50,252,$967.50
2024-12-19,17:25:00,21485.5,BUY,3,0.02h,Break Even,$-1.50,$966.00,$143174.00,252,$966.00
2024-12-19,17:27:00,21205.75,SELL,3,0.02h,Stop Loss,$-9.00,$957.00,$143165.00,252,$957.00
2024-12-19,17:30:00,21457.5,BUY,3,0.02h,Stop Loss,$88.50,$1045.50,$143253.50,252,$1045.50
2024-12-19,17:32:00,21177.75,SELL,3,0.02h,Stop Loss,$-9.00,$1036.50,$143244.50,252,$1036.50
2024-12-19,17:35:00,21455.0,BUY,3,0.02h,Stop Loss,$45.00,$1081.50,$143289.50,252,$1081.50
2024-12-19,17:38:00,21182.75,SELL,3,0.02h,Break Even,$-1.50,$1080.00,$143288.00,252,$1080.00
2024-12-19,17:58:00,21508.0,BUY,3,0.02h,Stop Loss,$37.50,$1117.50,$143325.50,252,$1117.50
2024-12-19,18:05:00,21182.75,SELL,3,0.02h,Stop Loss,$-9.00,$1108.50,$143316.50,252,$1108.50
2024-12-19,18:06:00,21453.5,BUY,3,0.02h,Break Even,$-1.50,$1107.00,$143315.00,252,$1107.00
2024-12-19,18:08:00,21212.75,SELL,3,0.02h,Stop Loss,$-9.00,$1098.00,$143306.00,252,$1098.00
2024-12-19,18:09:00,21482.0,BUY,3,0.02h,Stop Loss,$75.00,$1173.00,$143381.00,252,$1173.00
2024-12-19,18:15:00,21249.25,SELL,3,0.02h,Stop Loss,$96.00,$1269.00,$143477.00,252,$1269.00
2024-12-19,18:17:00,21513.0,BUY,3,0.02h,Break Even,$-1.50,$1267.50,$143475.50,252,$1267.50
2024-12-19,18:22:00,21229.75,SELL,3,0.02h,Stop Loss,$-9.00,$1258.50,$143466.50,252,$1258.50
2024-12-19,18:23:00,21482.5,BUY,3,0.02h,Stop Loss,$-9.00,$1249.50,$143457.50,252,$1249.50
2024-12-19,18:24:00,21239.25,SELL,3,0.02h,Stop Loss,$-9.00,$1240.50,$143448.50,252,$1240.50
2024-12-19,18:25:00,21514.5,BUY,3,0.02h,Stop Loss,$-9.00,$1231.50,$143439.50,252,$1231.50
2024-12-19,18:26:00,21245.75,SELL,3,0.02h,Stop Loss,$-9.00,$1222.50,$143430.50,252,$1222.50
2024-12-19,18:28:00,21525.0,BUY,3,0.02h,Stop Loss,$-9.00,$1213.50,$143421.50,252,$1213.50
2024-12-19,18:29:00,21260.25,SELL,3,0.02h,Stop Loss,$-9.00,$1204.50,$143412.50,252,$1204.50
2024-12-19,18:30:00,21530.0,BUY,3,0.02h,Stop Loss,$-9.00,$1195.50,$143403.50,252,$1195.50
2024-12-19,18:32:00,21247.5,SELL,3,0.02h,Stop Loss,$-9.00,$1186.50,$143394.50,252,$1186.50
2024-12-19,18:33:00,21527.5,BUY,3,0.02h,Stop Loss,$12.00,$1198.50,$143406.50,252,$1198.50
2024-12-19,18:36:00,21259.5,SELL,3,0.02h,Stop Loss,$-9.00,$1189.50,$143397.50,252,$1189.50
2024-12-19,18:37:00,21522.75,BUY,3,0.02h,Stop Loss,$27.00,$1216.50,$143424.50,252,$1216.50
2024-12-19,18:44:00,21264.5,SELL,3,0.02h,Stop Loss,$-9.00,$1207.50,$143415.50,252,$1207.50
2024-12-19,18:45:00,21526.0,BUY,3,0.02h,Stop Loss,$-9.00,$1198.50,$143406.50,252,$1198.50
2024-12-19,18:46:00,21264.0,SELL,3,0.02h,Break Even,$-1.50,$1197.00,$143405.00,252,$1197.00
2024-12-19,18:53:00,21549.0,BUY,3,0.02h,Stop Loss,$-9.00,$1188.00,$143396.00,252,$1188.00
2024-12-19,18:54:00,21275.5,SELL,3,0.02h,Stop Loss,$60.00,$1248.00,$143456.00,252,$1248.00
2024-12-19,18:59:00,21584.5,BUY,3,0.02h,Stop Loss,$70.50,$1318.50,$143526.50,252,$1318.50
2024-12-19,19:17:00,21247.0,SELL,3,0.02h,Stop Loss,$-9.00,$1309.50,$143517.50,252,$1309.50
2024-12-19,19:18:00,21508.0,BUY,3,0.02h,Stop Loss,$-9.00,$1300.50,$143508.50,252,$1300.50
2024-12-19,19:19:00,21243.0,SELL,3,0.02h,Stop Loss,$-9.00,$1291.50,$143499.50,252,$1291.50
2024-12-19,19:21:00,21501.75,BUY,3,0.02h,Stop Loss,$-9.00,$1282.50,$143490.50,252,$1282.50
2024-12-19,19:22:00,21229.0,SELL,3,0.02h,Stop Loss,$19.50,$1302.00,$143510.00,252,$1302.00
2024-12-19,19:34:00,21487.5,BUY,3,0.02h,Break Even,$-1.50,$1300.50,$143508.50,252,$1300.50
2024-12-19,19:38:00,21207.75,SELL,3,0.02h,Stop Loss,$16.50,$1317.00,$143525.00,252,$1317.00
2024-12-19,19:50:00,21478.0,BUY,3,0.02h,Stop Loss,$-9.00,$1308.00,$143516.00,252,$1308.00
2024-12-19,19:51:00,21218.25,SELL,3,0.02h,Stop Loss,$-9.00,$1299.00,$143507.00,252,$1299.00
2024-12-19,19:52:00,21498.0,BUY,3,0.02h,Stop Loss,$-9.00,$1290.00,$143498.00,252,$1290.00
2024-12-19,19:53:00,21223.25,SELL,3,0.02h,Stop Loss,$6.00,$1296.00,$143504.00,252,$1296.00
2024-12-19,19:55:00,21485.5,BUY,3,0.02h,Stop Loss,$64.50,$1360.50,$143568.50,252,$1360.50
2024-12-19,19:59:00,21205.25,SELL,3,0.02h,Stop Loss,$-9.00,$1351.50,$143559.50,252,$1351.50
2024-12-19,20:00:00,21462.25,BUY,3,0.02h,Stop Loss,$72.00,$1423.50,$143631.50,252,$1423.50
2024-12-19,20:03:00,21192.25,SELL,3,0.02h,Stop Loss,$4.50,$1428.00,$143636.00,252,$1428.00
2024-12-19,20:11:00,21446.0,BUY,3,0.02h,Break Even,$-1.50,$1426.50,$143634.50,252,$1426.50
2024-12-19,20:13:00,21180.75,SELL,3,0.02h,Stop Loss,$-9.00,$1417.50,$143625.50,252,$1417.50
2024-12-19,20:14:00,21454.75,BUY,3,0.02h,Stop Loss,$-9.00,$1408.50,$143616.50,252,$1408.50
2024-12-19,20:15:00,21198.0,SELL,3,0.02h,Stop Loss,$-9.00,$1399.50,$143607.50,252,$1399.50
2024-12-19,20:16:00,21479.0,BUY,3,0.02h,Stop Loss,$-9.00,$1390.50,$143598.50,252,$1390.50
2024-12-19,20:17:00,21206.5,SELL,3,0.02h,Stop Loss,$-9.00,$1381.50,$143589.50,252,$1381.50
2024-12-19,20:24:00,21516.5,BUY,3,0.02h,Stop Loss,$67.50,$1449.00,$143657.00,252,$1449.00
2024-12-19,20:28:00,21227.0,SELL,3,0.02h,Stop Loss,$-9.00,$1440.00,$143648.00,252,$1440.00
2024-12-19,20:29:00,21499.5,BUY,3,0.02h,Stop Loss,$-9.00,$1431.00,$143639.00,252,$1431.00
2024-12-19,20:30:00,21222.25,SELL,3,0.02h,Stop Loss,$-9.00,$1422.00,$143630.00,252,$1422.00
2024-12-19,20:31:00,21505.5,BUY,3,0.02h,Break Even,$-1.50,$1420.50,$143628.50,252,$1420.50
2024-12-19,20:35:00,21173.75,SELL,3,0.02h,Stop Loss,$154.50,$1575.00,$143783.00,252,$1575.00
2024-12-19,20:39:00,21461.75,BUY,3,0.02h,Stop Loss,$-9.00,$1566.00,$143774.00,252,$1566.00
2024-12-19,20:40:00,21211.75,SELL,3,0.02h,Stop Loss,$-9.00,$1557.00,$143765.00,252,$1557.00
2024-12-19,20:41:00,21464.5,BUY,3,0.02h,Stop Loss,$-9.00,$1548.00,$143756.00,252,$1548.00
2024-12-19,20:42:00,21221.25,SELL,3,0.02h,Break Even,$-1.50,$1546.50,$143754.50,252,$1546.50
2024-12-19,20:46:00,21438.75,BUY,3,0.02h,Stop Loss,$151.50,$1698.00,$143906.00,252,$1698.00
2024-12-19,20:52:00,21115.25,SELL,3,0.02h,Stop Loss,$-9.00,$1689.00,$143897.00,252,$1689.00
2024-12-19,21:04:00,21391.25,BUY,3,0.02h,Stop Loss,$9.00,$1698.00,$143906.00,252,$1698.00
2024-12-19,21:06:00,21113.5,SELL,3,0.02h,Stop Loss,$-9.00,$1689.00,$143897.00,252,$1689.00
2024-12-19,21:07:00,21382.0,BUY,3,0.02h,Stop Loss,$-9.00,$1680.00,$143888.00,252,$1680.00
2024-12-19,21:08:00,21117.5,SELL,3,0.02h,Break Even,$-1.50,$1678.50,$143886.50,252,$1678.50
2024-12-19,21:13:00,21373.25,BUY,3,0.02h,Stop Loss,$-9.00,$1669.50,$143877.50,252,$1669.50
2024-12-19,21:14:00,21095.0,SELL,3,0.02h,Stop Loss,$-9.00,$1660.50,$143868.50,252,$1660.50
2024-12-19,21:16:00,21356.0,BUY,3,0.02h,Break Even,$-1.50,$1659.00,$143867.00,252,$1659.00
2024-12-19,21:18:00,21088.25,SELL,3,0.02h,Stop Loss,$-9.00,$1650.00,$143858.00,252,$1650.00
2024-12-19,21:19:00,21377.25,BUY,3,0.02h,Stop Loss,$-9.00,$1641.00,$143849.00,252,$1641.00
2024-12-19,21:20:00,21095.75,SELL,3,0.02h,Break Even,$-1.50,$1639.50,$143847.50,252,$1639.50
2024-12-19,21:24:00,21386.25,BUY,3,0.02h,Stop Loss,$-9.00,$1630.50,$143838.50,252,$1630.50
2024-12-19,21:25:00,21110.25,SELL,3,0.02h,Stop Loss,$-9.00,$1621.50,$143829.50,252,$1621.50
2024-12-19,21:26:00,21376.5,BUY,3,0.02h,Stop Loss,$-9.00,$1612.50,$143820.50,252,$1612.50
2024-12-19,21:27:00,21114.25,SELL,3,0.02h,Break Even,$-1.50,$1611.00,$143819.00,252,$1611.00
2024-12-19,21:29:00,21385.75,BUY,3,0.02h,Stop Loss,$-9.00,$1602.00,$143810.00,252,$1602.00
2024-12-19,21:30:00,21115.75,SELL,3,0.02h,Stop Loss,$-9.00,$1593.00,$143801.00,252,$1593.00
2024-12-19,21:31:00,21392.5,BUY,3,0.02h,Stop Loss,$-9.00,$1584.00,$143792.00,252,$1584.00
2024-12-19,21:32:00,21126.75,SELL,3,0.02h,Stop Loss,$-9.00,$1575.00,$143783.00,252,$1575.00
2024-12-19,21:33:00,21395.25,BUY,3,0.02h,Stop Loss,$-9.00,$1566.00,$143774.00,252,$1566.00
2024-12-19,21:34:00,21131.25,SELL,3,0.02h,Stop Loss,$-9.00,$1557.00,$143765.00,252,$1557.00
2024-12-19,21:36:00,21400.75,BUY,3,0.02h,Stop Loss,$-9.00,$1548.00,$143756.00,252,$1548.00
2024-12-19,21:57:00,21140.0,SELL,3,0.02h,Stop Loss,$22.50,$1570.50,$143778.50,252,$1570.50
,,,,,,,,,,,
2024-12-20,12:31:00,21019.25,BUY,3,0.02h,Stop Loss,$7.50,$7.50,$143786.00,253,$7.50
2024-12-20,12:34:00,20781.75,SELL,3,0.02h,Stop Loss,$-9.00,$-1.50,$143777.00,253,$-1.50
2024-12-20,12:35:00,21037.75,BUY,3,0.02h,Stop Loss,$64.50,$63.00,$143841.50,253,$63.00
2024-12-20,12:37:00,20780.0,SELL,3,0.02h,Stop Loss,$15.00,$78.00,$143856.50,253,$78.00
2024-12-20,12:41:00,21049.25,BUY,3,0.02h,Stop Loss,$58.50,$136.50,$143915.00,253,$136.50
2024-12-20,12:43:00,20803.5,SELL,3,0.02h,Stop Loss,$-9.00,$127.50,$143906.00,253,$127.50
2024-12-20,12:44:00,21066.75,BUY,3,0.02h,Stop Loss,$66.00,$193.50,$143972.00,253,$193.50
2024-12-20,12:47:00,20829.75,SELL,3,0.02h,Stop Loss,$91.50,$285.00,$144063.50,253,$285.00
2024-12-20,12:50:00,21073.75,BUY,3,0.02h,Break Even,$-1.50,$283.50,$144062.00,253,$283.50
2024-12-20,12:59:00,20837.25,SELL,3,0.02h,Stop Loss,$6.00,$289.50,$144068.00,253,$289.50
2024-12-20,13:07:00,21091.0,BUY,3,0.02h,Stop Loss,$-9.00,$280.50,$144059.00,253,$280.50
2024-12-20,13:08:00,20829.0,SELL,3,0.02h,Stop Loss,$-9.00,$271.50,$144050.00,253,$271.50
2024-12-20,13:09:00,21086.75,BUY,3,0.02h,Stop Loss,$40.50,$312.00,$144090.50,253,$312.00
2024-12-20,13:28:00,20834.0,SELL,3,0.02h,Stop Loss,$-9.00,$303.00,$144081.50,253,$303.00
2024-12-20,13:35:00,21188.5,BUY,3,0.02h,Stop Loss,$88.50,$391.50,$144170.00,253,$391.50
2024-12-20,13:46:00,20922.0,SELL,3,0.02h,Stop Loss,$-9.00,$382.50,$144161.00,253,$382.50
2024-12-20,13:49:00,21218.5,BUY,3,0.02h,Break Even,$-1.50,$381.00,$144159.50,253,$381.00
2024-12-20,14:00:00,20956.5,SELL,3,0.02h,Stop Loss,$154.50,$535.50,$144314.00,253,$535.50
2024-12-20,14:05:00,21202.25,BUY,3,0.02h,Stop Loss,$36.00,$571.50,$144350.00,253,$571.50
2024-12-20,14:14:00,20946.0,SELL,3,0.02h,Stop Loss,$-9.00,$562.50,$144341.00,253,$562.50
2024-12-20,14:21:00,21228.0,BUY,3,0.02h,Stop Loss,$42.00,$604.50,$144383.00,253,$604.50
2024-12-20,14:24:00,20937.5,SELL,3,0.02h,Stop Loss,$7.50,$612.00,$144390.50,253,$612.00
2024-12-20,14:30:00,21212.0,BUY,3,0.02h,Stop Loss,$64.50,$676.50,$144455.00,253,$676.50
2024-12-20,17:35:00,21756.5,SELL,3,0.02h,Stop Loss,$10.50,$687.00,$144465.50,253,$687.00
2024-12-20,17:39:00,21782.0,BUY,3,0.02h,Stop Loss,$57.00,$744.00,$144522.50,253,$744.00
2024-12-20,17:59:00,21768.25,SELL,3,0.02h,Stop Loss,$45.00,$789.00,$144567.50,253,$789.00
2024-12-20,18:56:00,21708.0,BUY,3,0.02h,Stop Loss,$9.00,$798.00,$144576.50,253,$798.00
2024-12-20,19:01:00,21665.75,SELL,3,0.02h,Stop Loss,$10.50,$808.50,$144587.00,253,$808.50
2024-12-20,19:19:00,21687.0,BUY,3,0.02h,Break Even,$-1.50,$807.00,$144585.50,253,$807.00
2024-12-20,19:52:00,21702.0,SELL,3,0.02h,Stop Loss,$10.50,$817.50,$144596.00,253,$817.50
2024-12-20,21:05:00,21609.25,BUY,3,0.02h,Break Even,$-1.50,$816.00,$144594.50,253,$816.00
2024-12-20,21:08:00,21569.5,SELL,3,0.02h,Break Even,$-1.50,$814.50,$144593.00,253,$814.50
2024-12-20,21:54:00,21547.5,BUY,3,0.02h,Break Even,$-1.50,$813.00,$144591.50,253,$813.00
,,,,,,,,,,,
2024-12-23,13:05:00,21646.25,SELL,3,0.02h,Stop Loss,$-9.00,$-9.00,$144582.50,254,$-9.00
2024-12-23,13:08:00,21666.25,BUY,3,0.02h,Stop Loss,$-9.00,$-18.00,$144573.50,254,$-18.00
2024-12-23,13:10:00,21656.0,SELL,3,0.02h,Stop Loss,$-9.00,$-27.00,$144564.50,254,$-27.00
2024-12-23,13:11:00,21660.0,BUY,3,0.02h,Break Even,$-1.50,$-28.50,$144563.00,254,$-28.50
2024-12-23,13:12:00,21658.25,SELL,3,0.02h,Stop Loss,$4.50,$-24.00,$144567.50,254,$-24.00
2024-12-23,13:26:00,21661.0,BUY,3,0.02h,Stop Loss,$10.50,$-13.50,$144578.00,254,$-13.50
2024-12-23,13:32:00,21638.0,SELL,3,0.02h,Stop Loss,$40.50,$27.00,$144618.50,254,$27.00
2024-12-23,14:06:00,21591.25,BUY,3,0.02h,Break Even,$-1.50,$25.50,$144617.00,254,$25.50
2024-12-23,14:18:00,21583.0,SELL,3,0.02h,Stop Loss,$36.00,$61.50,$144653.00,254,$61.50
2024-12-23,14:22:00,21593.25,BUY,3,0.02h,Stop Loss,$13.50,$75.00,$144666.50,254,$75.00
2024-12-23,14:47:00,21592.25,SELL,3,0.02h,Stop Loss,$-9.00,$66.00,$144657.50,254,$66.00
2024-12-23,15:00:00,21629.75,BUY,3,0.02h,Stop Loss,$64.50,$130.50,$144722.00,254,$130.50
2024-12-23,15:03:00,21583.75,SELL,3,0.02h,Stop Loss,$-9.00,$121.50,$144713.00,254,$121.50
2024-12-23,15:39:00,21584.75,BUY,3,0.02h,Stop Loss,$24.00,$145.50,$144737.00,254,$145.50
2024-12-23,15:49:00,21551.75,SELL,3,0.02h,Stop Loss,$28.50,$174.00,$144765.50,254,$174.00
2024-12-23,15:56:00,21575.75,BUY,3,0.02h,Stop Loss,$58.50,$232.50,$144824.00,254,$232.50
2024-12-23,17:15:00,21671.5,SELL,3,0.02h,Stop Loss,$48.00,$280.50,$144872.00,254,$280.50
2024-12-23,17:29:00,21687.0,BUY,3,0.02h,Break Even,$-1.50,$279.00,$144870.50,254,$279.00
2024-12-23,17:30:00,21671.75,SELL,3,0.02h,Break Even,$-1.50,$277.50,$144869.00,254,$277.50
2024-12-23,17:33:00,21685.75,BUY,3,0.02h,Stop Loss,$12.00,$289.50,$144881.00,254,$289.50
2024-12-23,17:37:00,21661.5,SELL,3,0.02h,Stop Loss,$-9.00,$280.50,$144872.00,254,$280.50
2024-12-23,17:38:00,21676.75,BUY,3,0.02h,Stop Loss,$58.50,$339.00,$144930.50,254,$339.00
2024-12-23,19:34:00,21752.25,SELL,3,0.02h,Break Even,$-1.50,$337.50,$144929.00,254,$337.50
2024-12-23,20:29:00,21707.25,BUY,3,0.02h,Break Even,$-1.50,$336.00,$144927.50,254,$336.00
2024-12-23,21:05:00,21723.25,SELL,3,0.02h,Stop Loss,$-9.00,$327.00,$144918.50,254,$327.00
2024-12-23,21:12:00,21749.5,BUY,3,0.02h,Stop Loss,$-9.00,$318.00,$144909.50,254,$318.00
2024-12-23,21:19:00,21741.75,SELL,3,0.02h,Stop Loss,$3.00,$321.00,$144912.50,254,$321.00
2024-12-23,21:20:00,21744.5,BUY,3,0.02h,Stop Loss,$-9.00,$312.00,$144903.50,254,$312.00
2024-12-23,21:22:00,21740.75,SELL,3,0.02h,Stop Loss,$33.00,$345.00,$144936.50,254,$345.00
2024-12-23,21:47:00,21741.5,BUY,3,0.02h,Break Even,$-1.50,$343.50,$144935.00,254,$343.50
2024-12-23,21:53:00,21731.0,SELL,3,0.02h,Stop Loss,$-9.00,$334.50,$144926.00,254,$334.50
2024-12-23,21:58:00,21739.5,BUY,3,0.02h,Stop Loss,$-9.00,$325.50,$144917.00,254,$325.50
,,,,,,,,,,,
2024-12-24,12:41:00,21790.5,SELL,3,0.02h,Break Even,$-1.50,$-1.50,$144915.50,255,$-1.50
2024-12-24,12:49:00,21797.0,BUY,3,0.02h,Break Even,$-1.50,$-3.00,$144914.00,255,$-3.00
2024-12-24,13:03:00,21793.75,SELL,3,0.02h,Stop Loss,$-9.00,$-12.00,$144905.00,255,$-12.00
2024-12-24,13:05:00,21794.5,BUY,3,0.02h,Break Even,$-1.50,$-13.50,$144903.50,255,$-13.50
2024-12-24,13:19:00,21795.0,SELL,3,0.02h,Break Even,$-1.50,$-15.00,$144902.00,255,$-15.00
2024-12-24,13:20:00,21798.0,BUY,3,0.02h,Stop Loss,$-9.00,$-24.00,$144893.00,255,$-24.00
2024-12-24,14:25:00,21824.5,SELL,3,0.02h,Stop Loss,$6.00,$-18.00,$144899.00,255,$-18.00
2024-12-24,14:38:00,21843.5,BUY,3,0.02h,Stop Loss,$24.00,$6.00,$144923.00,255,$6.00
2024-12-24,16:54:00,21964.5,SELL,3,0.02h,Stop Loss,$48.00,$54.00,$144971.00,255,$54.00
2024-12-24,17:13:00,21983.75,BUY,3,0.02h,Break Even,$-1.50,$52.50,$144969.50,255,$52.50
2024-12-24,17:35:00,21964.25,SELL,3,0.02h,Stop Loss,$37.50,$90.00,$145007.00,255,$90.00
2024-12-24,17:51:00,21988.25,BUY,3,0.02h,Break Even,$-1.50,$88.50,$145005.50,255,$88.50
,,,,,,,,,,,
2024-12-26,12:01:00,21968.75,SELL,3,0.02h,Break Even,$-1.50,$-1.50,$145004.00,256,$-1.50
2024-12-26,12:55:00,21956.75,BUY,3,0.02h,Stop Loss,$-9.00,$-10.50,$144995.00,256,$-10.50
2024-12-26,13:03:00,21945.5,SELL,3,0.02h,Stop Loss,$7.50,$-3.00,$145002.50,256,$-3.00
2024-12-26,13:08:00,21954.75,BUY,3,0.02h,Stop Loss,$-9.00,$-12.00,$144993.50,256,$-12.00
2024-12-26,13:25:00,21947.0,SELL,3,0.02h,Stop Loss,$18.00,$6.00,$145011.50,256,$6.00
2024-12-26,13:39:00,21955.0,BUY,3,0.02h,Stop Loss,$-9.00,$-3.00,$145002.50,256,$-3.00
2024-12-26,13:43:00,21935.25,SELL,3,0.02h,Break Even,$-1.50,$-4.50,$145001.00,256,$-4.50
2024-12-26,13:50:00,21953.25,BUY,3,0.02h,Stop Loss,$-9.00,$-13.50,$144992.00,256,$-13.50
2024-12-26,13:52:00,21946.5,SELL,3,0.02h,Stop Loss,$3.00,$-10.50,$144995.00,256,$-10.50
2024-12-26,13:54:00,21957.25,BUY,3,0.02h,Break Even,$-1.50,$-12.00,$144993.50,256,$-12.00
2024-12-26,14:21:00,21946.25,SELL,3,0.02h,Stop Loss,$16.50,$4.50,$145010.00,256,$4.50
2024-12-26,14:30:00,21960.75,BUY,3,0.02h,Stop Loss,$130.50,$135.00,$145140.50,256,$135.00
2024-12-26,14:50:00,21953.25,SELL,3,0.02h,Stop Loss,$118.50,$253.50,$145259.00,256,$253.50
2024-12-26,15:04:00,21965.25,BUY,3,0.02h,Stop Loss,$42.00,$295.50,$145301.00,256,$295.50
2024-12-26,15:10:00,21929.5,SELL,3,0.02h,Break Even,$-1.50,$294.00,$145299.50,256,$294.00
2024-12-26,15:23:00,21974.25,BUY,3,0.02h,Stop Loss,$6.00,$300.00,$145305.50,256,$300.00
2024-12-26,16:25:00,21989.5,SELL,3,0.02h,Stop Loss,$43.50,$343.50,$145349.00,256,$343.50
2024-12-26,16:35:00,22006.25,BUY,3,0.02h,Stop Loss,$15.00,$358.50,$145364.00,256,$358.50
2024-12-26,17:28:00,22033.0,SELL,3,0.02h,Stop Loss,$33.00,$391.50,$145397.00,256,$391.50
2024-12-26,18:07:00,22020.25,BUY,3,0.02h,Stop Loss,$18.00,$409.50,$145415.00,256,$409.50
2024-12-26,18:15:00,22010.0,SELL,3,0.02h,Break Even,$-1.50,$408.00,$145413.50,256,$408.00
2024-12-26,18:16:00,22018.5,BUY,3,0.02h,Stop Loss,$24.00,$432.00,$145437.50,256,$432.00
2024-12-26,18:36:00,22025.25,SELL,3,0.02h,Stop Loss,$24.00,$456.00,$145461.50,256,$456.00
2024-12-26,18:55:00,22027.25,BUY,3,0.02h,Stop Loss,$10.50,$466.50,$145472.00,256,$466.50
2024-12-26,18:58:00,22009.0,SELL,3,0.02h,Break Even,$-1.50,$465.00,$145470.50,256,$465.00
2024-12-26,19:28:00,22014.25,BUY,3,0.02h,Stop Loss,$-9.00,$456.00,$145461.50,256,$456.00
2024-12-26,19:37:00,22004.25,SELL,3,0.02h,Break Even,$-1.50,$454.50,$145460.00,256,$454.50
2024-12-26,19:39:00,22011.75,BUY,3,0.02h,Stop Loss,$21.00,$475.50,$145481.00,256,$475.50
2024-12-26,20:17:00,22034.5,SELL,3,0.02h,Break Even,$-1.50,$474.00,$145479.50,256,$474.00
2024-12-26,20:23:00,22044.5,BUY,3,0.02h,Break Even,$-1.50,$472.50,$145478.00,256,$472.50
2024-12-26,20:51:00,22039.75,SELL,3,0.02h,Stop Loss,$22.50,$495.00,$145500.50,256,$495.00
,,,,,,,,,,,
2024-12-27,13:55:00,21914.0,BUY,3,0.02h,Break Even,$-1.50,$-1.50,$145499.00,257,$-1.50
2024-12-27,13:59:00,21904.25,SELL,3,0.02h,Stop Loss,$45.00,$43.50,$145544.00,257,$43.50
2024-12-27,15:43:00,21567.5,BUY,3,0.02h,Stop Loss,$121.50,$165.00,$145665.50,257,$165.00
2024-12-27,16:05:00,21555.75,SELL,3,0.02h,Stop Loss,$30.00,$195.00,$145695.50,257,$195.00
2024-12-27,16:25:00,21573.0,BUY,3,0.02h,Stop Loss,$130.50,$325.50,$145826.00,257,$325.50
2024-12-27,16:45:00,21581.75,SELL,3,0.02h,Break Even,$-1.50,$324.00,$145824.50,257,$324.00
2024-12-27,17:31:00,21547.25,BUY,3,0.02h,Stop Loss,$144.00,$468.00,$145968.50,257,$468.00
2024-12-27,17:39:00,21511.5,SELL,3,0.02h,Stop Loss,$-9.00,$459.00,$145959.50,257,$459.00
2024-12-27,17:43:00,21545.75,BUY,3,0.02h,Stop Loss,$31.50,$490.50,$145991.00,257,$490.50
2024-12-27,19:24:00,21639.75,SELL,3,0.02h,Stop Loss,$-9.00,$481.50,$145982.00,257,$481.50
2024-12-27,19:35:00,21665.75,BUY,3,0.02h,Stop Loss,$64.50,$546.00,$146046.50,257,$546.00
2024-12-27,20:06:00,21678.25,SELL,3,0.02h,Stop Loss,$70.50,$616.50,$146117.00,257,$616.50
2024-12-27,20:51:00,21678.25,BUY,3,0.02h,Stop Loss,$150.00,$766.50,$146267.00,257,$766.50
2024-12-27,21:42:00,21716.75,SELL,3,0.02h,Break Even,$-1.50,$765.00,$146265.50,257,$765.00
2024-12-27,21:57:00,21722.0,BUY,3,0.02h,Stop Loss,$-9.00,$756.00,$146256.50,257,$756.00
,,,,,,,,,,,
2024-12-30,12:00:00,21646.5,SELL,3,0.02h,Stop Loss,$4.50,$4.50,$146261.00,258,$4.50
2024-12-30,14:07:00,21410.25,BUY,3,0.02h,Break Even,$-1.50,$3.00,$146259.50,258,$3.00
2024-12-30,14:25:00,21388.25,SELL,3,0.02h,Stop Loss,$9.00,$12.00,$146268.50,258,$12.00
2024-12-30,14:28:00,21405.25,BUY,3,0.02h,Stop Loss,$42.00,$54.00,$146310.50,258,$54.00
2024-12-30,14:32:00,21392.0,SELL,3,0.02h,Stop Loss,$60.00,$114.00,$146370.50,258,$114.00
2024-12-30,15:14:00,21325.75,BUY,3,0.02h,Stop Loss,$151.50,$265.50,$146522.00,258,$265.50
2024-12-30,15:19:00,21301.0,SELL,3,0.02h,Break Even,$-1.50,$264.00,$146520.50,258,$264.00
2024-12-30,15:39:00,21324.0,BUY,3,0.02h,Stop Loss,$252.00,$516.00,$146772.50,258,$516.00
2024-12-30,17:58:00,21508.75,SELL,3,0.02h,Stop Loss,$12.00,$528.00,$146784.50,258,$528.00
2024-12-30,18:00:00,21552.75,BUY,3,0.02h,Break Even,$-1.50,$526.50,$146783.00,258,$526.50
2024-12-30,18:01:00,21522.0,SELL,3,0.02h,Break Even,$-1.50,$525.00,$146781.50,258,$525.00
2024-12-30,18:02:00,21534.25,BUY,3,0.02h,Break Even,$-1.50,$523.50,$146780.00,258,$523.50
2024-12-30,18:03:00,21516.25,SELL,3,0.02h,Stop Loss,$-9.00,$514.50,$146771.00,258,$514.50
2024-12-30,18:11:00,21536.75,BUY,3,0.02h,Stop Loss,$58.50,$573.00,$146829.50,258,$573.00
2024-12-30,18:25:00,21511.0,SELL,3,0.02h,Break Even,$-1.50,$571.50,$146828.00,258,$571.50
2024-12-30,18:35:00,21547.0,BUY,3,0.02h,Stop Loss,$42.00,$613.50,$146870.00,258,$613.50
2024-12-30,19:02:00,21536.25,SELL,3,0.02h,Stop Loss,$4.50,$618.00,$146874.50,258,$618.00
2024-12-30,19:32:00,21535.25,BUY,3,0.02h,Stop Loss,$-9.00,$609.00,$146865.50,258,$609.00
2024-12-30,20:06:00,21515.5,SELL,3,0.02h,Stop Loss,$67.50,$676.50,$146933.00,258,$676.50
2024-12-30,20:15:00,21527.25,BUY,3,0.02h,Break Even,$-1.50,$675.00,$146931.50,258,$675.00
2024-12-30,20:26:00,21506.75,SELL,3,0.02h,Stop Loss,$37.50,$712.50,$146969.00,258,$712.50
2024-12-30,20:53:00,21493.25,BUY,3,0.02h,Stop Loss,$-9.00,$703.50,$146960.00,258,$703.50
2024-12-30,20:55:00,21466.0,SELL,3,0.02h,Stop Loss,$27.00,$730.50,$146987.00,258,$730.50
2024-12-30,21:46:00,21388.0,BUY,3,0.02h,Stop Loss,$4.50,$735.00,$146991.50,258,$735.00
2024-12-30,22:00:00,21389.0,SELL,3,14.00h,Stop Loss,$-9.00,$726.00,$146982.50,258,$726.00
,,,,,,,,,,,
2024-12-31,12:00:00,21501.75,BUY,3,0.02h,Stop Loss,$22.50,$22.50,$147005.00,259,$22.50
2024-12-31,12:39:00,21500.25,SELL,3,0.02h,Break Even,$-1.50,$21.00,$147003.50,259,$21.00
2024-12-31,12:45:00,21507.5,BUY,3,0.02h,Stop Loss,$-9.00,$12.00,$146994.50,259,$12.00
2024-12-31,12:46:00,21502.25,SELL,3,0.02h,Stop Loss,$22.50,$34.50,$147017.00,259,$34.50
2024-12-31,13:16:00,21482.0,BUY,3,0.02h,Stop Loss,$-9.00,$25.50,$147008.00,259,$25.50
2024-12-31,13:22:00,21459.0,SELL,3,0.02h,Stop Loss,$3.00,$28.50,$147011.00,259,$28.50
2024-12-31,13:25:00,21475.0,BUY,3,0.02h,Stop Loss,$7.50,$36.00,$147018.50,259,$36.00
2024-12-31,13:27:00,21467.0,SELL,3,0.02h,Stop Loss,$-9.00,$27.00,$147009.50,259,$27.00
2024-12-31,13:28:00,21471.75,BUY,3,0.02h,Stop Loss,$12.00,$39.00,$147021.50,259,$39.00
2024-12-31,13:49:00,21469.5,SELL,3,0.02h,Stop Loss,$16.50,$55.50,$147038.00,259,$55.50
2024-12-31,14:12:00,21471.25,BUY,3,0.02h,Stop Loss,$13.50,$69.00,$147051.50,259,$69.00
2024-12-31,14:29:00,21464.25,SELL,3,0.02h,Stop Loss,$39.00,$108.00,$147090.50,259,$108.00
2024-12-31,15:01:00,21432.25,BUY,3,0.02h,Stop Loss,$27.00,$135.00,$147117.50,259,$135.00
2024-12-31,15:07:00,21402.0,SELL,3,0.02h,Stop Loss,$241.50,$376.50,$147359.00,259,$376.50
2024-12-31,15:21:00,21409.25,BUY,3,0.02h,Stop Loss,$78.00,$454.50,$147437.00,259,$454.50
2024-12-31,15:35:00,21386.5,SELL,3,0.02h,Stop Loss,$18.00,$472.50,$147455.00,259,$472.50
2024-12-31,16:44:00,21330.25,BUY,3,0.02h,Stop Loss,$4.50,$477.00,$147459.50,259,$477.00
2024-12-31,17:02:00,21314.25,SELL,3,0.02h,Stop Loss,$63.00,$540.00,$147522.50,259,$540.00
2024-12-31,17:09:00,21338.75,BUY,3,0.02h,Stop Loss,$12.00,$552.00,$147534.50,259,$552.00
2024-12-31,17:13:00,21308.5,SELL,3,0.02h,Stop Loss,$12.00,$564.00,$147546.50,259,$564.00
2024-12-31,17:21:00,21329.0,BUY,3,0.02h,Stop Loss,$-9.00,$555.00,$147537.50,259,$555.00
2024-12-31,17:22:00,21301.0,SELL,3,0.02h,Stop Loss,$4.50,$559.50,$147542.00,259,$559.50
2024-12-31,17:56:00,21271.5,BUY,3,0.02h,Stop Loss,$76.50,$636.00,$147618.50,259,$636.00
2024-12-31,18:20:00,21269.0,SELL,3,0.02h,Stop Loss,$15.00,$651.00,$147633.50,259,$651.00
2024-12-31,18:50:00,21242.25,BUY,3,0.02h,Stop Loss,$123.00,$774.00,$147756.50,259,$774.00
2024-12-31,18:55:00,21233.0,SELL,3,0.02h,Break Even,$-1.50,$772.50,$147755.00,259,$772.50
2024-12-31,19:09:00,21249.5,BUY,3,0.02h,Stop Loss,$24.00,$796.50,$147779.00,259,$796.50
2024-12-31,19:21:00,21215.0,SELL,3,0.02h,Stop Loss,$52.50,$849.00,$147831.50,259,$849.00
2024-12-31,19:51:00,21213.25,BUY,3,0.02h,Stop Loss,$57.00,$906.00,$147888.50,259,$906.00
2024-12-31,20:14:00,21215.0,SELL,3,0.02h,Stop Loss,$-9.00,$897.00,$147879.50,259,$897.00
2024-12-31,20:22:00,21271.25,BUY,3,0.02h,Stop Loss,$82.50,$979.50,$147962.00,259,$979.50
2024-12-31,20:45:00,21267.0,SELL,3,0.02h,Stop Loss,$99.00,$1078.50,$148061.00,259,$1078.50
2024-12-31,21:14:00,21241.25,BUY,3,0.02h,Break Even,$-1.50,$1077.00,$148059.50,259,$1077.00
2024-12-31,21:16:00,21231.5,SELL,3,0.02h,Stop Loss,$-9.00,$1068.00,$148050.50,259,$1068.00
2024-12-31,21:19:00,21245.75,BUY,3,0.02h,Stop Loss,$-9.00,$1059.00,$148041.50,259,$1059.00
2024-12-31,21:25:00,21236.25,SELL,3,0.02h,Break Even,$-1.50,$1057.50,$148040.00,259,$1057.50
2024-12-31,21:38:00,21244.0,BUY,3,0.02h,Stop Loss,$6.00,$1063.50,$148046.00,259,$1063.50
2024-12-31,21:53:00,21237.5,SELL,3,0.02h,Break Even,$-1.50,$1062.00,$148044.50,259,$1062.00
2024-12-31,21:54:00,21239.5,BUY,3,0.02h,Break Even,$-1.50,$1060.50,$148043.00,259,$1060.50
2024-12-31,21:56:00,21233.0,SELL,3,0.02h,Stop Loss,$-9.00,$1051.50,$148034.00,259,$1051.50
,,,,,,,,,,,
2025-01-02,12:00:00,21467.5,BUY,3,0.02h,Break Even,$-1.50,$-1.50,$148032.50,260,$-1.50
2025-01-02,12:43:00,21452.5,SELL,3,0.02h,Stop Loss,$22.50,$21.00,$148055.00,260,$21.00
2025-01-02,13:35:00,21442.5,BUY,3,0.02h,Break Even,$-1.50,$19.50,$148053.50,260,$19.50
2025-01-02,13:51:00,21420.0,SELL,3,0.02h,Stop Loss,$12.00,$31.50,$148065.50,260,$31.50
2025-01-02,14:52:00,21309.5,BUY,3,0.02h,Stop Loss,$130.50,$162.00,$148196.00,260,$162.00
2025-01-02,15:21:00,21324.0,SELL,3,0.02h,Stop Loss,$192.00,$354.00,$148388.00,260,$354.00
2025-01-02,15:52:00,21312.0,BUY,3,0.02h,Stop Loss,$91.50,$445.50,$148479.50,260,$445.50
2025-01-02,16:03:00,21240.0,SELL,3,0.02h,Stop Loss,$129.00,$574.50,$148608.50,260,$574.50
2025-01-02,16:20:00,21271.0,BUY,3,0.02h,Stop Loss,$15.00,$589.50,$148623.50,260,$589.50
2025-01-02,16:23:00,21231.25,SELL,3,0.02h,Break Even,$-1.50,$588.00,$148622.00,260,$588.00
2025-01-02,16:24:00,21264.25,BUY,3,0.02h,Stop Loss,$202.50,$790.50,$148824.50,260,$790.50
2025-01-02,17:08:00,21298.25,SELL,3,0.02h,Stop Loss,$93.00,$883.50,$148917.50,260,$883.50
2025-01-02,17:14:00,21339.0,BUY,3,0.02h,Break Even,$-1.50,$882.00,$148916.00,260,$882.00
2025-01-02,17:18:00,21303.5,SELL,3,0.02h,Stop Loss,$45.00,$927.00,$148961.00,260,$927.00
2025-01-02,18:24:00,21052.25,BUY,3,0.02h,Break Even,$-1.50,$925.50,$148959.50,260,$925.50
2025-01-02,18:27:00,21031.5,SELL,3,0.02h,Break Even,$-1.50,$924.00,$148958.00,260,$924.00
2025-01-02,18:28:00,21052.25,BUY,3,0.02h,Stop Loss,$12.00,$936.00,$148970.00,260,$936.00
2025-01-02,18:32:00,20999.75,SELL,3,0.02h,Stop Loss,$33.00,$969.00,$149003.00,260,$969.00
2025-01-02,18:45:00,21064.25,BUY,3,0.02h,Stop Loss,$-9.00,$960.00,$148994.00,260,$960.00
2025-01-02,18:51:00,21013.0,SELL,3,0.02h,Stop Loss,$9.00,$969.00,$149003.00,260,$969.00
2025-01-02,19:00:00,21048.0,BUY,3,0.02h,Stop Loss,$18.00,$987.00,$149021.00,260,$987.00
2025-01-02,19:47:00,21068.75,SELL,3,0.02h,Stop Loss,$6.00,$993.00,$149027.00,260,$993.00
2025-01-02,19:49:00,21130.25,BUY,3,0.02h,Stop Loss,$48.00,$1041.00,$149075.00,260,$1041.00
2025-01-02,20:00:00,21063.25,SELL,3,0.02h,Stop Loss,$-9.00,$1032.00,$149066.00,260,$1032.00
2025-01-02,20:05:00,21128.5,BUY,3,0.02h,Stop Loss,$-9.00,$1023.00,$149057.00,260,$1023.00
2025-01-02,20:38:00,21134.5,SELL,3,0.02h,Stop Loss,$13.50,$1036.50,$149070.50,260,$1036.50
2025-01-02,20:48:00,21161.25,BUY,3,0.02h,Stop Loss,$28.50,$1065.00,$149099.00,260,$1065.00
2025-01-02,21:40:00,21187.5,SELL,3,0.02h,Break Even,$-1.50,$1063.50,$149097.50,260,$1063.50
,,,,,,,,,,,
2025-01-03,12:00:00,21247.5,BUY,3,0.02h,Stop Loss,$-9.00,$-9.00,$149088.50,261,$-9.00
2025-01-03,12:21:00,21212.25,SELL,3,0.02h,Break Even,$-1.50,$-10.50,$149087.00,261,$-10.50
2025-01-03,12:23:00,21223.25,BUY,3,0.02h,Break Even,$-1.50,$-12.00,$149085.50,261,$-12.00
2025-01-03,13:22:00,21249.5,SELL,3,0.02h,Stop Loss,$-9.00,$-21.00,$149076.50,261,$-21.00
2025-01-03,13:25:00,21258.5,BUY,3,0.02h,Stop Loss,$-9.00,$-30.00,$149067.50,261,$-30.00
2025-01-03,13:47:00,21256.5,SELL,3,0.02h,Stop Loss,$48.00,$18.00,$149115.50,261,$18.00
2025-01-03,14:09:00,21256.75,BUY,3,0.02h,Stop Loss,$-9.00,$9.00,$149106.50,261,$9.00
2025-01-03,15:15:00,21349.0,SELL,3,0.02h,Stop Loss,$69.00,$78.00,$149175.50,261,$78.00
2025-01-03,15:36:00,21366.0,BUY,3,0.02h,Stop Loss,$91.50,$169.50,$149267.00,261,$169.50
2025-01-03,16:09:00,21351.0,SELL,3,0.02h,Stop Loss,$15.00,$184.50,$149282.00,261,$184.50
2025-01-03,16:20:00,21380.0,BUY,3,0.02h,Stop Loss,$64.50,$249.00,$149346.50,261,$249.00
2025-01-03,17:14:00,21469.75,SELL,3,0.02h,Stop Loss,$85.50,$334.50,$149432.00,261,$334.50
2025-01-03,17:52:00,21464.75,BUY,3,0.02h,Break Even,$-1.50,$333.00,$149430.50,261,$333.00
2025-01-03,19:52:00,21537.5,SELL,3,0.02h,Stop Loss,$18.00,$351.00,$149448.50,261,$351.00
2025-01-03,20:59:00,21511.0,BUY,3,0.02h,Stop Loss,$76.50,$427.50,$149525.00,261,$427.50
2025-01-03,21:03:00,21493.5,SELL,3,0.02h,Break Even,$-1.50,$426.00,$149523.50,261,$426.00
2025-01-03,21:39:00,21489.75,BUY,3,0.02h,Stop Loss,$-9.00,$417.00,$149514.50,261,$417.00
2025-01-03,21:46:00,21485.25,SELL,3,0.02h,Break Even,$-1.50,$415.50,$149513.00,261,$415.50
2025-01-03,21:59:00,21489.25,BUY,3,0.02h,Break Even,$-1.50,$414.00,$149511.50,261,$414.00
,,,,,,,,,,,
2025-01-06,13:02:00,21729.75,SELL,3,0.02h,Stop Loss,$-9.00,$-9.00,$149502.50,262,$-9.00
2025-01-06,13:29:00,21735.75,BUY,3,0.02h,Stop Loss,$18.00,$9.00,$149520.50,262,$9.00
2025-01-06,13:41:00,21724.25,SELL,3,0.02h,Stop Loss,$48.00,$57.00,$149568.50,262,$57.00
2025-01-06,13:50:00,21734.25,BUY,3,0.02h,Stop Loss,$-9.00,$48.00,$149559.50,262,$48.00
2025-01-06,14:08:00,21734.0,SELL,3,0.02h,Break Even,$-1.50,$46.50,$149558.00,262,$46.50
2025-01-06,14:30:00,21732.0,BUY,3,0.02h,Stop Loss,$204.00,$250.50,$149762.00,262,$250.50
2025-01-06,16:19:00,21867.75,SELL,3,0.02h,Stop Loss,$-9.00,$241.50,$149753.00,262,$241.50
2025-01-06,16:21:00,21888.75,BUY,3,0.02h,Break Even,$-1.50,$240.00,$149751.50,262,$240.00
2025-01-06,16:22:00,21874.5,SELL,3,0.02h,Break Even,$-1.50,$238.50,$149750.00,262,$238.50
2025-01-06,16:29:00,21889.25,BUY,3,0.02h,Break Even,$-1.50,$237.00,$149748.50,262,$237.00
2025-01-06,16:36:00,21870.5,SELL,3,0.02h,Stop Loss,$21.00,$258.00,$149769.50,262,$258.00
2025-01-06,18:26:00,21783.5,BUY,3,0.02h,Break Even,$-1.50,$256.50,$149768.00,262,$256.50
2025-01-06,18:33:00,21765.0,SELL,3,0.02h,Stop Loss,$3.00,$259.50,$149771.00,262,$259.50
2025-01-06,19:26:00,21715.25,BUY,3,0.02h,Stop Loss,$28.50,$288.00,$149799.50,262,$288.00
2025-01-06,19:32:00,21702.0,SELL,3,0.02h,Stop Loss,$36.00,$324.00,$149835.50,262,$324.00
2025-01-06,19:49:00,21716.25,BUY,3,0.02h,Break Even,$-1.50,$322.50,$149834.00,262,$322.50
2025-01-06,19:52:00,21699.0,SELL,3,0.02h,Stop Loss,$40.50,$363.00,$149874.50,262,$363.00
2025-01-06,20:14:00,21698.5,BUY,3,0.02h,Stop Loss,$-9.00,$354.00,$149865.50,262,$354.00
2025-01-06,20:47:00,21716.5,SELL,3,0.02h,Stop Loss,$88.50,$442.50,$149954.00,262,$442.50
2025-01-06,20:54:00,21733.5,BUY,3,0.02h,Stop Loss,$42.00,$484.50,$149996.00,262,$484.50
,,,,,,,,,,,
2025-01-07,12:00:00,21736.0,SELL,3,0.02h,Stop Loss,$61.50,$61.50,$150057.50,263,$61.50
2025-01-07,12:35:00,21745.25,BUY,3,0.02h,Stop Loss,$3.00,$64.50,$150060.50,263,$64.50
2025-01-07,12:59:00,21740.75,SELL,3,0.02h,Break Even,$-1.50,$63.00,$150059.00,263,$63.00
2025-01-07,13:16:00,21752.75,BUY,3,0.02h,Break Even,$-1.50,$61.50,$150057.50,263,$61.50
2025-01-07,13:27:00,21738.5,SELL,3,0.02h,Stop Loss,$-9.00,$52.50,$150048.50,263,$52.50
2025-01-07,13:35:00,21750.75,BUY,3,0.02h,Stop Loss,$-9.00,$43.50,$150039.50,263,$43.50
2025-01-07,14:23:00,21776.5,SELL,3,0.02h,Stop Loss,$-9.00,$34.50,$150030.50,263,$34.50
2025-01-07,14:28:00,21785.0,BUY,3,0.02h,Stop Loss,$25.50,$60.00,$150056.00,263,$60.00
2025-01-07,14:34:00,21764.25,SELL,3,0.02h,Stop Loss,$84.00,$144.00,$150140.00,263,$144.00
2025-01-07,14:49:00,21775.5,BUY,3,0.02h,Break Even,$-1.50,$142.50,$150138.50,263,$142.50
2025-01-07,14:57:00,21734.5,SELL,3,0.02h,Stop Loss,$108.00,$250.50,$150246.50,263,$250.50
2025-01-07,15:29:00,21611.0,BUY,3,0.02h,Stop Loss,$9.00,$259.50,$150255.50,263,$259.50
2025-01-07,15:30:00,21577.5,SELL,3,0.02h,Stop Loss,$174.00,$433.50,$150429.50,263,$433.50
2025-01-07,15:58:00,21521.75,BUY,3,0.02h,Stop Loss,$90.00,$523.50,$150519.50,263,$523.50
2025-01-07,16:36:00,21499.75,SELL,3,0.02h,Stop Loss,$126.00,$649.50,$150645.50,263,$649.50
2025-01-07,16:41:00,21550.75,BUY,3,0.02h,Stop Loss,$3.00,$652.50,$150648.50,263,$652.50
2025-01-07,16:42:00,21516.75,SELL,3,0.02h,Stop Loss,$48.00,$700.50,$150696.50,263,$700.50
2025-01-07,17:20:00,21462.5,BUY,3,0.02h,Break Even,$-1.50,$699.00,$150695.00,263,$699.00
2025-01-07,17:23:00,21437.25,SELL,3,0.02h,Stop Loss,$19.50,$718.50,$150714.50,263,$718.50
2025-01-07,17:35:00,21454.0,BUY,3,0.02h,Break Even,$-1.50,$717.00,$150713.00,263,$717.00
2025-01-07,17:36:00,21442.5,SELL,3,0.02h,Stop Loss,$7.50,$724.50,$150720.50,263,$724.50
2025-01-07,17:37:00,21445.0,BUY,3,0.02h,Stop Loss,$13.50,$738.00,$150734.00,263,$738.00
2025-01-07,17:38:00,21431.5,SELL,3,0.02h,Stop Loss,$60.00,$798.00,$150794.00,263,$798.00
2025-01-07,18:00:00,21445.0,BUY,3,0.02h,Stop Loss,$33.00,$831.00,$150827.00,263,$831.00
2025-01-07,18:37:00,21475.25,SELL,3,0.02h,Stop Loss,$63.00,$894.00,$150890.00,263,$894.00
2025-01-07,19:09:00,21464.5,BUY,3,0.02h,Break Even,$-1.50,$892.50,$150888.50,263,$892.50
2025-01-07,19:20:00,21449.5,SELL,3,0.02h,Stop Loss,$27.00,$919.50,$150915.50,263,$919.50
2025-01-07,20:49:00,21340.0,BUY,3,0.02h,Stop Loss,$52.50,$972.00,$150968.00,263,$972.00
2025-01-07,21:38:00,21379.0,SELL,3,0.02h,Break Even,$-1.50,$970.50,$150966.50,263,$970.50
2025-01-07,21:50:00,21380.5,BUY,3,0.02h,Stop Loss,$-9.00,$961.50,$150957.50,263,$961.50
2025-01-07,21:53:00,21371.75,SELL,3,0.02h,Break Even,$-1.50,$960.00,$150956.00,263,$960.00
,,,,,,,,,,,
2025-01-08,12:43:00,21281.0,BUY,3,0.02h,Break Even,$-1.50,$-1.50,$150954.50,264,$-1.50
2025-01-08,12:50:00,21263.75,SELL,3,0.02h,Stop Loss,$33.00,$31.50,$150987.50,264,$31.50
2025-01-08,13:01:00,21311.25,BUY,3,0.02h,Stop Loss,$241.50,$273.00,$151229.00,264,$273.00
2025-01-08,13:39:00,21327.75,SELL,3,0.02h,Stop Loss,$18.00,$291.00,$151247.00,264,$291.00
2025-01-08,13:51:00,21349.5,BUY,3,0.02h,Stop Loss,$-9.00,$282.00,$151238.00,264,$282.00
2025-01-08,14:14:00,21349.5,SELL,3,0.02h,Stop Loss,$52.50,$334.50,$151290.50,264,$334.50
2025-01-08,14:29:00,21361.25,BUY,3,0.02h,Stop Loss,$15.00,$349.50,$151305.50,264,$349.50
2025-01-08,14:31:00,21334.0,SELL,3,0.02h,Stop Loss,$82.50,$432.00,$151388.00,264,$432.00
2025-01-08,14:32:00,21363.25,BUY,3,0.02h,Stop Loss,$25.50,$457.50,$151413.50,264,$457.50
2025-01-08,14:34:00,21326.0,SELL,3,0.02h,Stop Loss,$31.50,$489.00,$151445.00,264,$489.00
2025-01-08,14:35:00,21371.75,BUY,3,0.02h,Stop Loss,$57.00,$546.00,$151502.00,264,$546.00
2025-01-08,14:39:00,21324.25,SELL,3,0.02h,Stop Loss,$148.50,$694.50,$151650.50,264,$694.50
2025-01-08,14:50:00,21368.25,BUY,3,0.02h,Stop Loss,$60.00,$754.50,$151710.50,264,$754.50
2025-01-08,14:54:00,21295.5,SELL,3,0.02h,Stop Loss,$42.00,$796.50,$151752.50,264,$796.50
2025-01-08,15:01:00,21369.0,BUY,3,0.02h,Stop Loss,$40.50,$837.00,$151793.00,264,$837.00
2025-01-08,15:11:00,21308.5,SELL,3,0.02h,Stop Loss,$48.00,$885.00,$151841.00,264,$885.00
2025-01-08,15:36:00,21332.75,BUY,3,0.02h,Stop Loss,$114.00,$999.00,$151955.00,264,$999.00
2025-01-08,15:48:00,21299.25,SELL,3,0.02h,Break Even,$-1.50,$997.50,$151953.50,264,$997.50
2025-01-08,15:50:00,21317.25,BUY,3,0.02h,Stop Loss,$84.00,$1081.50,$152037.50,264,$1081.50
2025-01-08,16:06:00,21315.25,SELL,3,0.02h,Stop Loss,$121.50,$1203.00,$152159.00,264,$1203.00
2025-01-08,16:15:00,21335.5,BUY,3,0.02h,Stop Loss,$10.50,$1213.50,$152169.50,264,$1213.50
2025-01-08,17:02:00,21382.0,SELL,3,0.02h,Stop Loss,$135.00,$1348.50,$152304.50,264,$1348.50
2025-01-08,17:53:00,21261.0,BUY,3,0.02h,Stop Loss,$-9.00,$1339.50,$152295.50,264,$1339.50
2025-01-08,18:48:00,21346.5,SELL,3,0.02h,Break Even,$-1.50,$1338.00,$152294.00,264,$1338.00
2025-01-08,19:09:00,21380.75,BUY,3,0.02h,Stop Loss,$57.00,$1395.00,$152351.00,264,$1395.00
2025-01-08,19:37:00,21346.0,SELL,3,0.02h,Break Even,$-1.50,$1393.50,$152349.50,264,$1393.50
2025-01-08,20:05:00,21353.0,BUY,3,0.02h,Break Even,$-1.50,$1392.00,$152348.00,264,$1392.00
2025-01-08,20:07:00,21337.25,SELL,3,0.02h,Stop Loss,$42.00,$1434.00,$152390.00,264,$1434.00
2025-01-08,20:21:00,21343.25,BUY,3,0.02h,Break Even,$-1.50,$1432.50,$152388.50,264,$1432.50
2025-01-08,20:37:00,21332.75,SELL,3,0.02h,Stop Loss,$21.00,$1453.50,$152409.50,264,$1453.50
2025-01-08,20:46:00,21346.25,BUY,3,0.02h,Break Even,$-1.50,$1452.00,$152408.00,264,$1452.00
2025-01-08,21:14:00,21347.0,SELL,3,0.02h,Stop Loss,$-9.00,$1443.00,$152399.00,264,$1443.00
2025-01-08,21:28:00,21360.75,BUY,3,0.02h,Break Even,$-1.50,$1441.50,$152397.50,264,$1441.50
2025-01-08,21:35:00,21336.5,SELL,3,0.02h,Stop Loss,$144.00,$1585.50,$152541.50,264,$1585.50
,,,,,,,,,,,
2025-01-09,12:50:00,21305.25,BUY,3,0.02h,Stop Loss,$6.00,$6.00,$152547.50,265,$6.00
2025-01-09,13:25:00,21309.0,SELL,3,0.02h,Break Even,$-1.50,$4.50,$152546.00,265,$4.50
2025-01-09,13:28:00,21322.0,BUY,3,0.02h,Break Even,$-1.50,$3.00,$152544.50,265,$3.00
2025-01-09,13:31:00,21311.5,SELL,3,0.02h,Break Even,$-1.50,$1.50,$152543.00,265,$1.50
2025-01-09,13:36:00,21327.5,BUY,3,0.02h,Stop Loss,$12.00,$13.50,$152555.00,265,$13.50
2025-01-09,13:50:00,21319.5,SELL,3,0.02h,Stop Loss,$-9.00,$4.50,$152546.00,265,$4.50
2025-01-09,14:22:00,21294.5,BUY,3,0.02h,Break Even,$-1.50,$3.00,$152544.50,265,$3.00
,,,,,,,,,,,
2025-01-10,12:07:00,21282.5,SELL,3,0.02h,Break Even,$-1.50,$-1.50,$152543.00,266,$-1.50
2025-01-10,12:26:00,21291.75,BUY,3,0.02h,Break Even,$-1.50,$-3.00,$152541.50,266,$-3.00
2025-01-10,12:29:00,21281.5,SELL,3,0.02h,Stop Loss,$22.50,$19.50,$152564.00,266,$19.50
2025-01-10,12:33:00,21293.25,BUY,3,0.02h,Stop Loss,$31.50,$51.00,$152595.50,266,$51.00
2025-01-10,13:12:00,21300.0,SELL,3,0.02h,Stop Loss,$19.50,$70.50,$152615.00,266,$70.50
2025-01-10,14:06:00,21146.25,BUY,3,0.02h,Stop Loss,$103.50,$174.00,$152718.50,266,$174.00
2025-01-10,14:32:00,21141.75,SELL,3,0.02h,Stop Loss,$45.00,$219.00,$152763.50,266,$219.00
2025-01-10,15:24:00,20987.0,BUY,3,0.02h,Stop Loss,$79.50,$298.50,$152843.00,266,$298.50
2025-01-10,15:56:00,21014.0,SELL,3,0.02h,Stop Loss,$88.50,$387.00,$152931.50,266,$387.00
2025-01-10,16:45:00,20968.75,BUY,3,0.02h,Stop Loss,$61.50,$448.50,$152993.00,266,$448.50
2025-01-10,16:57:00,20924.25,SELL,3,0.02h,Stop Loss,$27.00,$475.50,$153020.00,266,$475.50
2025-01-10,17:20:00,20929.25,BUY,3,0.02h,Stop Loss,$25.50,$501.00,$153045.50,266,$501.00
2025-01-10,17:24:00,20903.5,SELL,3,0.02h,Break Even,$-1.50,$499.50,$153044.00,266,$499.50
2025-01-10,17:25:00,20918.5,BUY,3,0.02h,Stop Loss,$87.00,$586.50,$153131.00,266,$586.50
2025-01-10,19:06:00,21091.75,SELL,3,0.02h,Stop Loss,$30.00,$616.50,$153161.00,266,$616.50
2025-01-10,19:30:00,21096.0,BUY,3,0.02h,Break Even,$-1.50,$615.00,$153159.50,266,$615.00
2025-01-10,19:31:00,21078.5,SELL,3,0.02h,Stop Loss,$81.00,$696.00,$153240.50,266,$696.00
2025-01-10,19:56:00,21092.25,BUY,3,0.02h,Break Even,$-1.50,$694.50,$153239.00,266,$694.50
2025-01-10,20:12:00,21070.5,SELL,3,0.02h,Stop Loss,$79.50,$774.00,$153318.50,266,$774.00
2025-01-10,20:53:00,21029.75,BUY,3,0.02h,Break Even,$-1.50,$772.50,$153317.00,266,$772.50
2025-01-10,21:07:00,21007.75,SELL,3,0.02h,Stop Loss,$16.50,$789.00,$153333.50,266,$789.00
,,,,,,,,,,,
2025-01-13,12:34:00,20791.0,BUY,3,0.02h,Stop Loss,$24.00,$24.00,$153357.50,267,$24.00
2025-01-13,13:03:00,20810.25,SELL,3,0.02h,Break Even,$-1.50,$22.50,$153356.00,267,$22.50
2025-01-13,13:19:00,20820.5,BUY,3,0.02h,Break Even,$-1.50,$21.00,$153354.50,267,$21.00
2025-01-13,13:51:00,20818.25,SELL,3,0.02h,Break Even,$-1.50,$19.50,$153353.00,267,$19.50
2025-01-13,14:52:00,20774.25,BUY,3,0.02h,Stop Loss,$9.00,$28.50,$153362.00,267,$28.50
2025-01-13,15:15:00,20772.75,SELL,3,0.02h,Stop Loss,$85.50,$114.00,$153447.50,267,$114.00
2025-01-13,15:38:00,20800.25,BUY,3,0.02h,Stop Loss,$81.00,$195.00,$153528.50,267,$195.00
2025-01-13,15:59:00,20799.5,SELL,3,0.02h,Stop Loss,$10.50,$205.50,$153539.00,267,$205.50
2025-01-13,16:36:00,20802.5,BUY,3,0.02h,Stop Loss,$16.50,$222.00,$153555.50,267,$222.00
2025-01-13,16:56:00,20757.25,SELL,3,0.02h,Stop Loss,$48.00,$270.00,$153603.50,267,$270.00
2025-01-13,17:11:00,20788.0,BUY,3,0.02h,Stop Loss,$57.00,$327.00,$153660.50,267,$327.00
2025-01-13,17:44:00,20823.5,SELL,3,0.02h,Stop Loss,$15.00,$342.00,$153675.50,267,$342.00
2025-01-13,17:48:00,20842.5,BUY,3,0.02h,Stop Loss,$27.00,$369.00,$153702.50,267,$369.00
2025-01-13,18:21:00,20866.0,SELL,3,0.02h,Stop Loss,$15.00,$384.00,$153717.50,267,$384.00
2025-01-13,18:30:00,20892.25,BUY,3,0.02h,Stop Loss,$73.50,$457.50,$153791.00,267,$457.50
2025-01-13,18:45:00,20868.25,SELL,3,0.02h,Break Even,$-1.50,$456.00,$153789.50,267,$456.00
2025-01-13,18:48:00,20895.0,BUY,3,0.02h,Stop Loss,$6.00,$462.00,$153795.50,267,$462.00
2025-01-13,18:57:00,20882.25,SELL,3,0.02h,Stop Loss,$-9.00,$453.00,$153786.50,267,$453.00
2025-01-13,19:00:00,20892.25,BUY,3,0.02h,Stop Loss,$6.00,$459.00,$153792.50,267,$459.00
2025-01-13,19:04:00,20877.25,SELL,3,0.02h,Break Even,$-1.50,$457.50,$153791.00,267,$457.50
2025-01-13,19:29:00,20886.25,BUY,3,0.02h,Stop Loss,$31.50,$489.00,$153822.50,267,$489.00
2025-01-13,19:52:00,20881.25,SELL,3,0.02h,Stop Loss,$52.50,$541.50,$153875.00,267,$541.50
2025-01-13,19:57:00,20909.75,BUY,3,0.02h,Stop Loss,$-9.00,$532.50,$153866.00,267,$532.50
2025-01-13,20:05:00,20888.25,SELL,3,0.02h,Break Even,$-1.50,$531.00,$153864.50,267,$531.00
2025-01-13,20:06:00,20898.75,BUY,3,0.02h,Stop Loss,$12.00,$543.00,$153876.50,267,$543.00
2025-01-13,20:15:00,20893.0,SELL,3,0.02h,Stop Loss,$10.50,$553.50,$153887.00,267,$553.50
2025-01-13,20:16:00,20905.0,BUY,3,0.02h,Stop Loss,$7.50,$561.00,$153894.50,267,$561.00
2025-01-13,20:25:00,20879.5,SELL,3,0.02h,Stop Loss,$6.00,$567.00,$153900.50,267,$567.00
2025-01-13,20:38:00,20902.5,BUY,3,0.02h,Stop Loss,$4.50,$571.50,$153905.00,267,$571.50
2025-01-13,20:40:00,20883.5,SELL,3,0.02h,Stop Loss,$-9.00,$562.50,$153896.00,267,$562.50
2025-01-13,20:43:00,20897.75,BUY,3,0.02h,Break Even,$-1.50,$561.00,$153894.50,267,$561.00
2025-01-13,21:56:00,20979.25,SELL,3,0.02h,Stop Loss,$-9.00,$552.00,$153885.50,267,$552.00
2025-01-13,21:57:00,20983.0,BUY,3,0.02h,Break Even,$-1.50,$550.50,$153884.00,267,$550.50
,,,,,,,,,,,
2025-01-14,12:18:00,21011.5,SELL,3,0.02h,Stop Loss,$3.00,$3.00,$153887.00,268,$3.00
2025-01-14,12:33:00,21006.75,BUY,3,0.02h,Stop Loss,$31.50,$34.50,$153918.50,268,$34.50
2025-01-14,12:53:00,21002.5,SELL,3,0.02h,Break Even,$-1.50,$33.00,$153917.00,268,$33.00
2025-01-14,13:31:00,21116.75,BUY,3,0.02h,Stop Loss,$112.50,$145.50,$154029.50,268,$145.50
2025-01-14,14:00:00,21057.0,SELL,3,0.02h,Stop Loss,$9.00,$154.50,$154038.50,268,$154.50
2025-01-14,14:19:00,21071.0,BUY,3,0.02h,Stop Loss,$34.50,$189.00,$154073.00,268,$189.00
2025-01-14,14:32:00,21023.25,SELL,3,0.02h,Stop Loss,$10.50,$199.50,$154083.50,268,$199.50
2025-01-14,14:36:00,21087.25,BUY,3,0.02h,Stop Loss,$64.50,$264.00,$154148.00,268,$264.00
2025-01-14,14:50:00,21075.25,SELL,3,0.02h,Stop Loss,$142.50,$406.50,$154290.50,268,$406.50
2025-01-14,15:10:00,21065.75,BUY,3,0.02h,Break Even,$-1.50,$405.00,$154289.00,268,$405.00
2025-01-14,15:25:00,21040.5,SELL,3,0.02h,Stop Loss,$-9.00,$396.00,$154280.00,268,$396.00
2025-01-14,16:26:00,20933.0,BUY,3,0.02h,Stop Loss,$60.00,$456.00,$154340.00,268,$456.00
2025-01-14,16:33:00,20916.75,SELL,3,0.02h,Stop Loss,$13.50,$469.50,$154353.50,268,$469.50
2025-01-14,17:12:00,20869.0,BUY,3,0.02h,Break Even,$-1.50,$468.00,$154352.00,268,$468.00
2025-01-14,17:23:00,20833.25,SELL,3,0.02h,Break Even,$-1.50,$466.50,$154350.50,268,$466.50
2025-01-14,17:44:00,20871.25,BUY,3,0.02h,Stop Loss,$7.50,$474.00,$154358.00,268,$474.00
2025-01-14,19:30:00,20981.75,SELL,3,0.02h,Stop Loss,$18.00,$492.00,$154376.00,268,$492.00
2025-01-14,19:37:00,21001.75,BUY,3,0.02h,Stop Loss,$-9.00,$483.00,$154367.00,268,$483.00
2025-01-14,19:45:00,20983.0,SELL,3,0.02h,Stop Loss,$28.50,$511.50,$154395.50,268,$511.50
2025-01-14,20:30:00,20834.75,BUY,3,0.02h,Stop Loss,$100.50,$612.00,$154496.00,268,$612.00
2025-01-14,20:40:00,20801.75,SELL,3,0.02h,Break Even,$-1.50,$610.50,$154494.50,268,$610.50
2025-01-14,20:46:00,20836.75,BUY,3,0.02h,Stop Loss,$70.50,$681.00,$154565.00,268,$681.00
2025-01-14,21:49:00,20973.5,SELL,3,0.02h,Break Even,$-1.50,$679.50,$154563.50,268,$679.50
,,,,,,,,,,,
2025-01-15,12:00:00,20997.25,BUY,3,0.02h,Stop Loss,$21.00,$21.00,$154584.50,269,$21.00
2025-01-15,12:24:00,20990.0,SELL,3,0.02h,Break Even,$-1.50,$19.50,$154583.00,269,$19.50
2025-01-15,12:40:00,21000.75,BUY,3,0.02h,Break Even,$-1.50,$18.00,$154581.50,269,$18.00
2025-01-15,12:56:00,20986.0,SELL,3,0.02h,Break Even,$-1.50,$16.50,$154580.00,269,$16.50
2025-01-15,13:03:00,20999.5,BUY,3,0.02h,Stop Loss,$-9.00,$7.50,$154571.00,269,$7.50
2025-01-15,13:12:00,20991.5,SELL,3,0.02h,Break Even,$-1.50,$6.00,$154569.50,269,$6.00
2025-01-15,13:25:00,20999.5,BUY,3,0.02h,Break Even,$-1.50,$4.50,$154568.00,269,$4.50
2025-01-15,14:12:00,21250.75,SELL,3,0.02h,Stop Loss,$-9.00,$-4.50,$154559.00,269,$-4.50
2025-01-15,14:42:00,21282.5,BUY,3,0.02h,Stop Loss,$36.00,$31.50,$154595.00,269,$31.50
2025-01-15,15:36:00,21365.5,SELL,3,0.02h,Stop Loss,$79.50,$111.00,$154674.50,269,$111.00
2025-01-15,15:42:00,21385.75,BUY,3,0.02h,Stop Loss,$15.00,$126.00,$154689.50,269,$126.00
2025-01-15,15:44:00,21375.5,SELL,3,0.02h,Stop Loss,$51.00,$177.00,$154740.50,269,$177.00
2025-01-15,17:06:00,21291.0,BUY,3,0.02h,Stop Loss,$93.00,$270.00,$154833.50,269,$270.00
2025-01-15,17:56:00,21330.25,SELL,3,0.02h,Stop Loss,$-9.00,$261.00,$154824.50,269,$261.00
2025-01-15,18:04:00,21354.5,BUY,3,0.02h,Stop Loss,$-9.00,$252.00,$154815.50,269,$252.00
2025-01-15,19:51:00,21407.0,SELL,3,0.02h,Break Even,$-1.50,$250.50,$154814.00,269,$250.50
2025-01-15,19:53:00,21419.75,BUY,3,0.02h,Stop Loss,$-9.00,$241.50,$154805.00,269,$241.50
2025-01-15,20:38:00,21426.25,SELL,3,0.02h,Stop Loss,$9.00,$250.50,$154814.00,269,$250.50
,,,,,,,,,,,
2025-01-16,12:00:00,21506.75,BUY,3,0.02h,Break Even,$-1.50,$-1.50,$154812.50,270,$-1.50
2025-01-16,12:30:00,21463.0,SELL,3,0.02h,Stop Loss,$3.00,$1.50,$154815.50,270,$1.50
2025-01-16,12:32:00,21473.0,BUY,3,0.02h,Break Even,$-1.50,$0.00,$154814.00,270,$0.00
2025-01-16,12:48:00,21462.25,SELL,3,0.02h,Stop Loss,$18.00,$18.00,$154832.00,270,$18.00
2025-01-16,13:18:00,21444.25,BUY,3,0.02h,Stop Loss,$-9.00,$9.00,$154823.00,270,$9.00
2025-01-16,13:20:00,21429.25,SELL,3,0.02h,Stop Loss,$15.00,$24.00,$154838.00,270,$24.00
2025-01-16,13:24:00,21449.0,BUY,3,0.02h,Stop Loss,$3.00,$27.00,$154841.00,270,$27.00
2025-01-16,14:08:00,21458.5,SELL,3,0.02h,Stop Loss,$12.00,$39.00,$154853.00,270,$39.00
2025-01-16,14:14:00,21479.0,BUY,3,0.02h,Stop Loss,$15.00,$54.00,$154868.00,270,$54.00
2025-01-16,14:32:00,21450.75,SELL,3,0.02h,Stop Loss,$76.50,$130.50,$154944.50,270,$130.50
2025-01-16,15:21:00,21399.25,BUY,3,0.02h,Stop Loss,$72.00,$202.50,$155016.50,270,$202.50
2025-01-16,15:28:00,21371.75,SELL,3,0.02h,Break Even,$-1.50,$201.00,$155015.00,270,$201.00
2025-01-16,15:56:00,21385.0,BUY,3,0.02h,Stop Loss,$72.00,$273.00,$155087.00,270,$273.00
2025-01-16,16:21:00,21395.5,SELL,3,0.02h,Stop Loss,$33.00,$306.00,$155120.00,270,$306.00
2025-01-16,16:59:00,21399.75,BUY,3,0.02h,Stop Loss,$9.00,$315.00,$155129.00,270,$315.00
2025-01-16,17:18:00,21383.0,SELL,3,0.02h,Stop Loss,$43.50,$358.50,$155172.50,270,$358.50
2025-01-16,17:19:00,21397.0,BUY,3,0.02h,Break Even,$-1.50,$357.00,$155171.00,270,$357.00
2025-01-16,17:20:00,21383.75,SELL,3,0.02h,Break Even,$-1.50,$355.50,$155169.50,270,$355.50
2025-01-16,17:25:00,21404.75,BUY,3,0.02h,Stop Loss,$15.00,$370.50,$155184.50,270,$370.50
2025-01-16,17:39:00,21392.0,SELL,3,0.02h,Stop Loss,$15.00,$385.50,$155199.50,270,$385.50
2025-01-16,17:59:00,21399.0,BUY,3,0.02h,Stop Loss,$-9.00,$376.50,$155190.50,270,$376.50
2025-01-16,18:00:00,21385.5,SELL,3,0.02h,Break Even,$-1.50,$375.00,$155189.00,270,$375.00
2025-01-16,18:04:00,21399.75,BUY,3,0.02h,Stop Loss,$18.00,$393.00,$155207.00,270,$393.00
2025-01-16,18:16:00,21388.0,SELL,3,0.02h,Stop Loss,$27.00,$420.00,$155234.00,270,$420.00
2025-01-16,19:06:00,21320.75,BUY,3,0.02h,Stop Loss,$48.00,$468.00,$155282.00,270,$468.00
2025-01-16,20:18:00,21355.75,SELL,3,0.02h,Stop Loss,$49.50,$517.50,$155331.50,270,$517.50
2025-01-16,21:41:00,21208.25,BUY,3,0.02h,Break Even,$-1.50,$516.00,$155330.00,270,$516.00
2025-01-16,21:45:00,21201.5,SELL,3,0.02h,Stop Loss,$-9.00,$507.00,$155321.00,270,$507.00
2025-01-16,21:46:00,21211.0,BUY,3,0.02h,Stop Loss,$-9.00,$498.00,$155312.00,270,$498.00
2025-01-16,21:53:00,21203.0,SELL,3,0.02h,Break Even,$-1.50,$496.50,$155310.50,270,$496.50
2025-01-16,21:56:00,21210.5,BUY,3,0.02h,Stop Loss,$3.00,$499.50,$155313.50,270,$499.50
,,,,,,,,,,,
2025-01-17,14:34:00,21566.75,SELL,3,0.02h,Stop Loss,$90.00,$90.00,$155403.50,271,$90.00
2025-01-17,15:06:00,21563.75,BUY,3,0.02h,Stop Loss,$87.00,$177.00,$155490.50,271,$177.00
2025-01-17,15:23:00,21501.25,SELL,3,0.02h,Break Even,$-1.50,$175.50,$155489.00,271,$175.50
2025-01-17,15:35:00,21549.5,BUY,3,0.02h,Stop Loss,$111.00,$286.50,$155600.00,271,$286.50
2025-01-17,16:44:00,21594.75,SELL,3,0.02h,Stop Loss,$-9.00,$277.50,$155591.00,271,$277.50
2025-01-17,17:11:00,21596.5,BUY,3,0.02h,Stop Loss,$-9.00,$268.50,$155582.00,271,$268.50
2025-01-17,18:34:00,21643.25,SELL,3,0.02h,Break Even,$-1.50,$267.00,$155580.50,271,$267.00
2025-01-17,19:23:00,21639.0,BUY,3,0.02h,Stop Loss,$13.50,$280.50,$155594.00,271,$280.50
2025-01-17,19:34:00,21626.25,SELL,3,0.02h,Break Even,$-1.50,$279.00,$155592.50,271,$279.00
2025-01-17,19:36:00,21636.5,BUY,3,0.02h,Stop Loss,$-9.00,$270.00,$155583.50,271,$270.00
2025-01-17,19:51:00,21629.25,SELL,3,0.02h,Stop Loss,$-9.00,$261.00,$155574.50,271,$261.00
2025-01-17,20:22:00,21616.5,BUY,3,0.02h,Stop Loss,$9.00,$270.00,$155583.50,271,$270.00
2025-01-17,20:29:00,21602.0,SELL,3,0.02h,Break Even,$-1.50,$268.50,$155582.00,271,$268.50
2025-01-17,20:35:00,21618.25,BUY,3,0.02h,Stop Loss,$25.50,$294.00,$155607.50,271,$294.00
2025-01-17,20:52:00,21605.0,SELL,3,0.02h,Stop Loss,$-9.00,$285.00,$155598.50,271,$285.00
2025-01-17,20:54:00,21622.5,BUY,3,0.02h,Stop Loss,$76.50,$361.50,$155675.00,271,$361.50
2025-01-17,20:56:00,21603.25,SELL,3,0.02h,Stop Loss,$85.50,$447.00,$155760.50,271,$447.00
2025-01-17,21:27:00,21592.5,BUY,3,0.02h,Stop Loss,$-9.00,$438.00,$155751.50,271,$438.00
2025-01-17,21:36:00,21585.5,SELL,3,0.02h,Stop Loss,$13.50,$451.50,$155765.00,271,$451.50
2025-01-17,21:45:00,21589.0,BUY,3,0.02h,Stop Loss,$-9.00,$442.50,$155756.00,271,$442.50
2025-01-17,21:46:00,21583.0,SELL,3,0.02h,Break Even,$-1.50,$441.00,$155754.50,271,$441.00
2025-01-17,22:00:00,21590.25,BUY,3,62.00h,Stop Loss,$198.00,$639.00,$155952.50,271,$639.00
,,,,,,,,,,,
2025-01-20,12:19:00,21596.5,SELL,3,0.02h,Stop Loss,$24.00,$24.00,$155976.50,272,$24.00
2025-01-20,13:32:00,21625.25,BUY,3,0.02h,Stop Loss,$52.50,$76.50,$156029.00,272,$76.50
2025-01-20,14:17:00,21661.25,SELL,3,0.02h,Break Even,$-1.50,$75.00,$156027.50,272,$75.00
2025-01-20,14:22:00,21700.0,BUY,3,0.02h,Stop Loss,$27.00,$102.00,$156054.50,272,$102.00
2025-01-20,14:59:00,21736.75,SELL,3,0.02h,Stop Loss,$-9.00,$93.00,$156045.50,272,$93.00
2025-01-20,15:58:00,21683.5,BUY,3,0.02h,Break Even,$-1.50,$91.50,$156044.00,272,$91.50
2025-01-20,15:59:00,21678.25,SELL,3,0.02h,Break Even,$-1.50,$90.00,$156042.50,272,$90.00
2025-01-20,16:00:00,21682.75,BUY,3,0.02h,Stop Loss,$19.50,$109.50,$156062.00,272,$109.50
2025-01-20,16:59:00,21700.0,SELL,3,0.02h,Stop Loss,$57.00,$166.50,$156119.00,272,$166.50
2025-01-20,17:38:00,21693.75,BUY,3,0.02h,Stop Loss,$25.50,$192.00,$156144.50,272,$192.00
2025-01-20,17:44:00,21680.0,SELL,3,0.02h,Break Even,$-1.50,$190.50,$156143.00,272,$190.50
2025-01-20,17:47:00,21692.75,BUY,3,0.02h,Stop Loss,$13.50,$204.00,$156156.50,272,$204.00
2025-01-20,17:53:00,21683.5,SELL,3,0.02h,Break Even,$-1.50,$202.50,$156155.00,272,$202.50
2025-01-20,17:55:00,21702.5,BUY,3,0.02h,Stop Loss,$4.50,$207.00,$156159.50,272,$207.00
2025-01-20,18:00:00,21680.5,SELL,3,18.00h,Stop Loss,$39.00,$246.00,$156198.50,272,$246.00
,,,,,,,,,,,
2025-01-21,12:17:00,21682.5,BUY,3,0.02h,Stop Loss,$-9.00,$-9.00,$156189.50,273,$-9.00
2025-01-21,12:50:00,21687.0,SELL,3,0.02h,Stop Loss,$4.50,$-4.50,$156194.00,273,$-4.50
2025-01-21,13:00:00,21694.5,BUY,3,0.02h,Stop Loss,$-9.00,$-13.50,$156185.00,273,$-13.50
2025-01-21,13:01:00,21685.0,SELL,3,0.02h,Break Even,$-1.50,$-15.00,$156183.50,273,$-15.00
2025-01-21,13:04:00,21694.5,BUY,3,0.02h,Stop Loss,$21.00,$6.00,$156204.50,273,$6.00
2025-01-21,13:29:00,21694.75,SELL,3,0.02h,Stop Loss,$9.00,$15.00,$156213.50,273,$15.00
2025-01-21,13:33:00,21705.0,BUY,3,0.02h,Stop Loss,$15.00,$30.00,$156228.50,273,$30.00
2025-01-21,14:13:00,21718.75,SELL,3,0.02h,Break Even,$-1.50,$28.50,$156227.00,273,$28.50
2025-01-21,14:15:00,21724.5,BUY,3,0.02h,Break Even,$-1.50,$27.00,$156225.50,273,$27.00
2025-01-21,14:19:00,21713.75,SELL,3,0.02h,Stop Loss,$16.50,$43.50,$156242.00,273,$43.50
2025-01-21,15:24:00,21605.75,BUY,3,0.02h,Stop Loss,$51.00,$94.50,$156293.00,273,$94.50
2025-01-21,15:52:00,21604.0,SELL,3,0.02h,Stop Loss,$91.50,$186.00,$156384.50,273,$186.00
2025-01-21,15:58:00,21623.5,BUY,3,0.02h,Stop Loss,$52.50,$238.50,$156437.00,273,$238.50
2025-01-21,16:02:00,21611.25,SELL,3,0.02h,Stop Loss,$18.00,$256.50,$156455.00,273,$256.50
2025-01-21,16:07:00,21638.75,BUY,3,0.02h,Break Even,$-1.50,$255.00,$156453.50,273,$255.00
2025-01-21,16:26:00,21626.0,SELL,3,0.02h,Stop Loss,$4.50,$259.50,$156458.00,273,$259.50
2025-01-21,16:34:00,21638.0,BUY,3,0.02h,Break Even,$-1.50,$258.00,$156456.50,273,$258.00
2025-01-21,16:37:00,21620.75,SELL,3,0.02h,Stop Loss,$49.50,$307.50,$156506.00,273,$307.50
2025-01-21,16:50:00,21637.5,BUY,3,0.02h,Stop Loss,$7.50,$315.00,$156513.50,273,$315.00
2025-01-21,17:20:00,21658.75,SELL,3,0.02h,Break Even,$-1.50,$313.50,$156512.00,273,$313.50
2025-01-21,17:23:00,21673.75,BUY,3,0.02h,Break Even,$-1.50,$312.00,$156510.50,273,$312.00
2025-01-21,18:43:00,21744.25,SELL,3,0.02h,Stop Loss,$-9.00,$303.00,$156501.50,273,$303.00
2025-01-21,18:56:00,21753.0,BUY,3,0.02h,Stop Loss,$15.00,$318.00,$156516.50,273,$318.00
2025-01-21,19:15:00,21745.25,SELL,3,0.02h,Stop Loss,$55.50,$373.50,$156572.00,273,$373.50
2025-01-21,19:59:00,21723.75,BUY,3,0.02h,Break Even,$-1.50,$372.00,$156570.50,273,$372.00
2025-01-21,20:38:00,21718.75,SELL,3,0.02h,Stop Loss,$-9.00,$363.00,$156561.50,273,$363.00
2025-01-21,20:40:00,21735.5,BUY,3,0.02h,Break Even,$-1.50,$361.50,$156560.00,273,$361.50
2025-01-21,20:42:00,21720.5,SELL,3,0.02h,Stop Loss,$-9.00,$352.50,$156551.00,273,$352.50
2025-01-21,21:01:00,21752.75,BUY,3,0.02h,Stop Loss,$112.50,$465.00,$156663.50,273,$465.00
,,,,,,,,,,,
2025-01-22,13:06:00,21907.5,SELL,3,0.02h,Stop Loss,$-9.00,$-9.00,$156654.50,274,$-9.00
2025-01-22,13:07:00,21910.75,BUY,3,0.02h,Break Even,$-1.50,$-10.50,$156653.00,274,$-10.50
2025-01-22,14:04:00,21922.5,SELL,3,0.02h,Break Even,$-1.50,$-12.00,$156651.50,274,$-12.00
2025-01-22,14:32:00,21953.0,BUY,3,0.02h,Stop Loss,$153.00,$141.00,$156804.50,274,$141.00
2025-01-22,15:27:00,22009.5,SELL,3,0.02h,Stop Loss,$22.50,$163.50,$156827.00,274,$163.50
2025-01-22,15:29:00,22018.25,BUY,3,0.02h,Stop Loss,$7.50,$171.00,$156834.50,274,$171.00
2025-01-22,15:30:00,22012.75,SELL,3,0.02h,Stop Loss,$22.50,$193.50,$156857.00,274,$193.50
2025-01-22,15:31:00,22017.5,BUY,3,0.02h,Stop Loss,$37.50,$231.00,$156894.50,274,$231.00
2025-01-22,15:52:00,22014.25,SELL,3,0.02h,Stop Loss,$25.50,$256.50,$156920.00,274,$256.50
2025-01-22,16:09:00,22028.25,BUY,3,0.02h,Stop Loss,$-9.00,$247.50,$156911.00,274,$247.50
2025-01-22,16:11:00,22003.5,SELL,3,0.02h,Break Even,$-1.50,$246.00,$156909.50,274,$246.00
2025-01-22,16:18:00,22020.25,BUY,3,0.02h,Stop Loss,$22.50,$268.50,$156932.00,274,$268.50
2025-01-22,17:16:00,22067.75,SELL,3,0.02h,Break Even,$-1.50,$267.00,$156930.50,274,$267.00
2025-01-22,17:55:00,22067.0,BUY,3,0.02h,Stop Loss,$-9.00,$258.00,$156921.50,274,$258.00
2025-01-22,17:56:00,22061.0,SELL,3,0.02h,Stop Loss,$30.00,$288.00,$156951.50,274,$288.00
2025-01-22,18:41:00,22032.0,BUY,3,0.02h,Stop Loss,$3.00,$291.00,$156954.50,274,$291.00
2025-01-22,18:58:00,22022.5,SELL,3,0.02h,Stop Loss,$-9.00,$282.00,$156945.50,274,$282.00
2025-01-22,19:16:00,22033.0,BUY,3,0.02h,Break Even,$-1.50,$280.50,$156944.00,274,$280.50
2025-01-22,19:27:00,22023.5,SELL,3,0.02h,Break Even,$-1.50,$279.00,$156942.50,274,$279.00
2025-01-22,19:50:00,22029.5,BUY,3,0.02h,Break Even,$-1.50,$277.50,$156941.00,274,$277.50
2025-01-22,20:08:00,22026.5,SELL,3,0.02h,Break Even,$-1.50,$276.00,$156939.50,274,$276.00
2025-01-22,20:36:00,22026.0,BUY,3,0.02h,Stop Loss,$-9.00,$267.00,$156930.50,274,$267.00
2025-01-22,20:37:00,22014.5,SELL,3,0.02h,Stop Loss,$4.50,$271.50,$156935.00,274,$271.50
2025-01-22,21:56:00,21975.25,BUY,3,0.02h,Break Even,$-1.50,$270.00,$156933.50,274,$270.00
,,,,,,,,,,,
2025-01-23,12:00:00,21898.0,SELL,3,0.02h,Stop Loss,$13.50,$13.50,$156947.00,275,$13.50
2025-01-23,12:32:00,21895.5,BUY,3,0.02h,Break Even,$-1.50,$12.00,$156945.50,275,$12.00
2025-01-23,12:50:00,21888.75,SELL,3,0.02h,Stop Loss,$-9.00,$3.00,$156936.50,275,$3.00
2025-01-23,12:52:00,21900.75,BUY,3,0.02h,Stop Loss,$-9.00,$-6.00,$156927.50,275,$-6.00
2025-01-23,13:11:00,21882.5,SELL,3,0.02h,Stop Loss,$-9.00,$-15.00,$156918.50,275,$-15.00
2025-01-23,13:27:00,21898.5,BUY,3,0.02h,Break Even,$-1.50,$-16.50,$156917.00,275,$-16.50
2025-01-23,13:37:00,21890.5,SELL,3,0.02h,Stop Loss,$28.50,$12.00,$156945.50,275,$12.00
2025-01-23,13:47:00,21897.0,BUY,3,0.02h,Break Even,$-1.50,$10.50,$156944.00,275,$10.50
2025-01-23,14:06:00,21892.75,SELL,3,0.02h,Break Even,$-1.50,$9.00,$156942.50,275,$9.00
2025-01-23,14:35:00,21897.75,BUY,3,0.02h,Stop Loss,$34.50,$43.50,$156977.00,275,$43.50
2025-01-23,14:57:00,21881.25,SELL,3,0.02h,Stop Loss,$-9.00,$34.50,$156968.00,275,$34.50
2025-01-23,15:14:00,21898.5,BUY,3,0.02h,Stop Loss,$9.00,$43.50,$156977.00,275,$43.50
2025-01-23,15:20:00,21882.25,SELL,3,0.02h,Break Even,$-1.50,$42.00,$156975.50,275,$42.00
2025-01-23,15:24:00,21907.75,BUY,3,0.02h,Stop Loss,$-9.00,$33.00,$156966.50,275,$33.00
2025-01-23,16:10:00,21919.25,SELL,3,0.02h,Stop Loss,$-9.00,$24.00,$156957.50,275,$24.00
2025-01-23,16:15:00,21939.5,BUY,3,0.02h,Stop Loss,$21.00,$45.00,$156978.50,275,$45.00
2025-01-23,16:18:00,21922.5,SELL,3,0.02h,Stop Loss,$22.50,$67.50,$157001.00,275,$67.50
2025-01-23,16:28:00,21937.75,BUY,3,0.02h,Stop Loss,$22.50,$90.00,$157023.50,275,$90.00
2025-01-23,17:01:00,21935.5,SELL,3,0.02h,Break Even,$-1.50,$88.50,$157022.00,275,$88.50
2025-01-23,17:19:00,21944.75,BUY,3,0.02h,Stop Loss,$-9.00,$79.50,$157013.00,275,$79.50
2025-01-23,17:24:00,21934.5,SELL,3,0.02h,Break Even,$-1.50,$78.00,$157011.50,275,$78.00
2025-01-23,17:49:00,21925.25,BUY,3,0.02h,Break Even,$-1.50,$76.50,$157010.00,275,$76.50
2025-01-23,18:48:00,21960.25,SELL,3,0.02h,Break Even,$-1.50,$75.00,$157008.50,275,$75.00
2025-01-23,19:27:00,21947.5,BUY,3,0.02h,Break Even,$-1.50,$73.50,$157007.00,275,$73.50
2025-01-23,19:55:00,21948.75,SELL,3,0.02h,Stop Loss,$3.00,$76.50,$157010.00,275,$76.50
2025-01-23,19:57:00,21955.75,BUY,3,0.02h,Stop Loss,$18.00,$94.50,$157028.00,275,$94.50
2025-01-23,20:02:00,21945.5,SELL,3,0.02h,Stop Loss,$-9.00,$85.50,$157019.00,275,$85.50
2025-01-23,20:08:00,21958.25,BUY,3,0.02h,Stop Loss,$4.50,$90.00,$157023.50,275,$90.00
2025-01-23,20:36:00,21962.0,SELL,3,0.02h,Break Even,$-1.50,$88.50,$157022.00,275,$88.50
2025-01-23,20:37:00,21970.5,BUY,3,0.02h,Stop Loss,$16.50,$105.00,$157038.50,275,$105.00
2025-01-23,20:42:00,21962.0,SELL,3,0.02h,Break Even,$-1.50,$103.50,$157037.00,275,$103.50
2025-01-23,20:48:00,21976.75,BUY,3,0.02h,Break Even,$-1.50,$102.00,$157035.50,275,$102.00
2025-01-23,21:22:00,22011.25,SELL,3,0.02h,Stop Loss,$-9.00,$93.00,$157026.50,275,$93.00
2025-01-23,21:38:00,22019.0,BUY,3,0.02h,Stop Loss,$-9.00,$84.00,$157017.50,275,$84.00
2025-01-23,21:49:00,22013.75,SELL,3,0.02h,Stop Loss,$-9.00,$75.00,$157008.50,275,$75.00
2025-01-23,21:53:00,22016.75,BUY,3,0.02h,Break Even,$-1.50,$73.50,$157007.00,275,$73.50
,,,,,,,,,,,
2025-01-24,12:02:00,22010.75,SELL,3,0.02h,Stop Loss,$-9.00,$-9.00,$156998.00,276,$-9.00
2025-01-24,12:06:00,22019.0,BUY,3,0.02h,Stop Loss,$12.00,$3.00,$157010.00,276,$3.00
2025-01-24,12:10:00,22015.75,SELL,3,0.02h,Stop Loss,$-9.00,$-6.00,$157001.00,276,$-6.00
2025-01-24,12:12:00,22018.0,BUY,3,0.02h,Break Even,$-1.50,$-7.50,$156999.50,276,$-7.50
2025-01-24,12:40:00,22026.25,SELL,3,0.02h,Stop Loss,$-9.00,$-16.50,$156990.50,276,$-16.50
2025-01-24,13:01:00,22029.0,BUY,3,0.02h,Stop Loss,$-9.00,$-25.50,$156981.50,276,$-25.50
2025-01-24,13:05:00,22023.75,SELL,3,0.02h,Stop Loss,$-9.00,$-34.50,$156972.50,276,$-34.50
2025-01-24,13:07:00,22027.5,BUY,3,0.02h,Stop Loss,$-9.00,$-43.50,$156963.50,276,$-43.50
2025-01-24,13:08:00,22024.25,SELL,3,0.02h,Stop Loss,$12.00,$-31.50,$156975.50,276,$-31.50
2025-01-24,13:57:00,22007.75,BUY,3,0.02h,Break Even,$-1.50,$-33.00,$156974.00,276,$-33.00
2025-01-24,14:33:00,22017.75,SELL,3,0.02h,Stop Loss,$15.00,$-18.00,$156989.00,276,$-18.00
2025-01-24,14:46:00,22048.75,BUY,3,0.02h,Stop Loss,$16.50,$-1.50,$157005.50,276,$-1.50
2025-01-24,15:04:00,22030.25,SELL,3,0.02h,Stop Loss,$58.50,$57.00,$157064.00,276,$57.00
2025-01-24,16:11:00,22000.25,BUY,3,0.02h,Stop Loss,$13.50,$70.50,$157077.50,276,$70.50
2025-01-24,16:18:00,21988.0,SELL,3,0.02h,Break Even,$-1.50,$69.00,$157076.00,276,$69.00
2025-01-24,16:21:00,22003.5,BUY,3,0.02h,Stop Loss,$6.00,$75.00,$157082.00,276,$75.00
2025-01-24,16:57:00,21995.0,SELL,3,0.02h,Break Even,$-1.50,$73.50,$157080.50,276,$73.50
2025-01-24,17:23:00,22001.0,BUY,3,0.02h,Stop Loss,$24.00,$97.50,$157104.50,276,$97.50
2025-01-24,17:29:00,21979.75,SELL,3,0.02h,Stop Loss,$66.00,$163.50,$157170.50,276,$163.50
2025-01-24,18:24:00,21947.75,BUY,3,0.02h,Stop Loss,$-9.00,$154.50,$157161.50,276,$154.50
2025-01-24,18:30:00,21935.0,SELL,3,0.02h,Stop Loss,$13.50,$168.00,$157175.00,276,$168.00
2025-01-24,18:32:00,21943.5,BUY,3,0.02h,Stop Loss,$-9.00,$159.00,$157166.00,276,$159.00
2025-01-24,18:33:00,21937.0,SELL,3,0.02h,Stop Loss,$45.00,$204.00,$157211.00,276,$204.00
2025-01-24,19:27:00,21875.0,BUY,3,0.02h,Stop Loss,$3.00,$207.00,$157214.00,276,$207.00
2025-01-24,20:01:00,21866.5,SELL,3,0.02h,Break Even,$-1.50,$205.50,$157212.50,276,$205.50
2025-01-24,20:04:00,21885.75,BUY,3,0.02h,Break Even,$-1.50,$204.00,$157211.00,276,$204.00
2025-01-24,20:11:00,21874.75,SELL,3,0.02h,Stop Loss,$-9.00,$195.00,$157202.00,276,$195.00
2025-01-24,20:12:00,21885.0,BUY,3,0.02h,Stop Loss,$15.00,$210.00,$157217.00,276,$210.00
2025-01-24,20:20:00,21871.75,SELL,3,0.02h,Break Even,$-1.50,$208.50,$157215.50,276,$208.50
2025-01-24,20:37:00,21875.75,BUY,3,0.02h,Stop Loss,$6.00,$214.50,$157221.50,276,$214.50
2025-01-24,20:40:00,21874.25,SELL,3,0.02h,Stop Loss,$24.00,$238.50,$157245.50,276,$238.50
2025-01-24,20:49:00,21876.5,BUY,3,0.02h,Stop Loss,$7.50,$246.00,$157253.00,276,$246.00
2025-01-24,21:16:00,21897.0,SELL,3,0.02h,Break Even,$-1.50,$244.50,$157251.50,276,$244.50
2025-01-24,21:27:00,21900.75,BUY,3,0.05h,Break Even,$-1.50,$243.00,$157250.00,276,$243.00
2025-01-24,21:42:00,21898.25,SELL,3,0.02h,Stop Loss,$-9.00,$234.00,$157241.00,276,$234.00
2025-01-24,21:47:00,21904.75,BUY,3,0.02h,Stop Loss,$-9.00,$225.00,$157232.00,276,$225.00
,,,,,,,,,,,
2025-01-27,12:00:00,20999.75,SELL,3,0.02h,Break Even,$-1.50,$-1.50,$157230.50,277,$-1.50
2025-01-27,12:47:00,21099.25,BUY,3,0.02h,Stop Loss,$15.00,$13.50,$157245.50,277,$13.50
2025-01-27,12:59:00,21078.75,SELL,3,0.02h,Stop Loss,$30.00,$43.50,$157275.50,277,$43.50
2025-01-27,13:08:00,21105.75,BUY,3,0.02h,Stop Loss,$69.00,$112.50,$157344.50,277,$112.50
2025-01-27,13:44:00,21130.5,SELL,3,0.02h,Break Even,$-1.50,$111.00,$157343.00,277,$111.00
2025-01-27,13:47:00,21144.5,BUY,3,0.02h,Stop Loss,$24.00,$135.00,$157367.00,277,$135.00
2025-01-27,14:08:00,21140.5,SELL,3,0.02h,Stop Loss,$22.50,$157.50,$157389.50,277,$157.50
2025-01-27,14:31:00,21172.5,BUY,3,0.02h,Stop Loss,$478.50,$636.00,$157868.00,277,$636.00
2025-01-27,15:16:00,21282.25,SELL,3,0.02h,Stop Loss,$129.00,$765.00,$157997.00,277,$765.00
2025-01-27,15:26:00,21318.5,BUY,3,0.02h,Stop Loss,$79.50,$844.50,$158076.50,277,$844.50
2025-01-27,15:53:00,21351.5,SELL,3,0.02h,Stop Loss,$90.00,$934.50,$158166.50,277,$934.50
2025-01-27,16:48:00,21268.5,BUY,3,0.02h,Stop Loss,$25.50,$960.00,$158192.00,277,$960.00
2025-01-27,16:55:00,21193.25,SELL,3,0.02h,Stop Loss,$34.50,$994.50,$158226.50,277,$994.50
2025-01-27,17:03:00,21250.25,BUY,3,0.02h,Stop Loss,$82.50,$1077.00,$158309.00,277,$1077.00
2025-01-27,17:10:00,21204.25,SELL,3,0.02h,Stop Loss,$25.50,$1102.50,$158334.50,277,$1102.50
2025-01-27,17:30:00,21227.0,BUY,3,0.02h,Stop Loss,$-9.00,$1093.50,$158325.50,277,$1093.50
2025-01-27,17:46:00,21206.25,SELL,3,0.02h,Stop Loss,$57.00,$1150.50,$158382.50,277,$1150.50
2025-01-27,18:17:00,21186.0,BUY,3,0.02h,Stop Loss,$10.50,$1161.00,$158393.00,277,$1161.00
2025-01-27,18:19:00,21161.25,SELL,3,0.02h,Stop Loss,$19.50,$1180.50,$158412.50,277,$1180.50
2025-01-27,18:21:00,21178.5,BUY,3,0.02h,Break Even,$-1.50,$1179.00,$158411.00,277,$1179.00
2025-01-27,18:22:00,21166.5,SELL,3,0.02h,Stop Loss,$3.00,$1182.00,$158414.00,277,$1182.00
2025-01-27,18:34:00,21194.25,BUY,3,0.02h,Stop Loss,$27.00,$1209.00,$158441.00,277,$1209.00
2025-01-27,18:55:00,21180.25,SELL,3,0.02h,Stop Loss,$57.00,$1266.00,$158498.00,277,$1266.00
2025-01-27,19:14:00,21180.0,BUY,3,0.02h,Stop Loss,$18.00,$1284.00,$158516.00,277,$1284.00
2025-01-27,19:15:00,21171.5,SELL,3,0.02h,Stop Loss,$3.00,$1287.00,$158519.00,277,$1287.00
2025-01-27,19:16:00,21187.75,BUY,3,0.02h,Stop Loss,$16.50,$1303.50,$158535.50,277,$1303.50
2025-01-27,19:41:00,21205.0,SELL,3,0.02h,Stop Loss,$75.00,$1378.50,$158610.50,277,$1378.50
2025-01-27,20:09:00,21172.25,BUY,3,0.02h,Stop Loss,$57.00,$1435.50,$158667.50,277,$1435.50
2025-01-27,21:44:00,21305.0,SELL,3,0.02h,Break Even,$-1.50,$1434.00,$158666.00,277,$1434.00
,,,,,,,,,,,
2025-01-28,12:00:00,21341.5,BUY,3,0.02h,Stop Loss,$19.50,$19.50,$158685.50,278,$19.50
2025-01-28,12:11:00,21291.5,SELL,3,0.02h,Break Even,$-1.50,$18.00,$158684.00,278,$18.00
2025-01-28,12:47:00,21287.75,BUY,3,0.02h,Break Even,$-1.50,$16.50,$158682.50,278,$16.50
2025-01-28,13:36:00,21299.5,SELL,3,0.02h,Stop Loss,$9.00,$25.50,$158691.50,278,$25.50
2025-01-28,14:26:00,21307.25,BUY,3,0.02h,Break Even,$-1.50,$24.00,$158690.00,278,$24.00
2025-01-28,14:32:00,21251.75,SELL,3,0.02h,Stop Loss,$45.00,$69.00,$158735.00,278,$69.00
2025-01-28,14:55:00,21265.0,BUY,3,0.02h,Stop Loss,$27.00,$96.00,$158762.00,278,$96.00
2025-01-28,15:54:00,21415.75,SELL,3,0.02h,Stop Loss,$30.00,$126.00,$158792.00,278,$126.00
2025-01-28,15:59:00,21451.0,BUY,3,0.02h,Stop Loss,$25.50,$151.50,$158817.50,278,$151.50
2025-01-28,16:21:00,21444.25,SELL,3,0.02h,Stop Loss,$31.50,$183.00,$158849.00,278,$183.00
2025-01-28,16:48:00,21436.0,BUY,3,0.02h,Stop Loss,$46.50,$229.50,$158895.50,278,$229.50
2025-01-28,17:44:00,21531.0,SELL,3,0.02h,Break Even,$-1.50,$228.00,$158894.00,278,$228.00
2025-01-28,17:56:00,21552.25,BUY,3,0.02h,Stop Loss,$-9.00,$219.00,$158885.00,278,$219.00
2025-01-28,18:27:00,21551.75,SELL,3,0.02h,Stop Loss,$10.50,$229.50,$158895.50,278,$229.50
2025-01-28,19:19:00,21545.75,BUY,3,0.02h,Stop Loss,$36.00,$265.50,$158931.50,278,$265.50
2025-01-28,20:06:00,21594.75,SELL,3,0.02h,Stop Loss,$18.00,$283.50,$158949.50,278,$283.50
2025-01-28,20:16:00,21608.5,BUY,3,0.02h,Stop Loss,$31.50,$315.00,$158981.00,278,$315.00
2025-01-28,20:38:00,21600.75,SELL,3,0.02h,Stop Loss,$3.00,$318.00,$158984.00,278,$318.00
2025-01-28,21:49:00,21562.25,BUY,3,0.02h,Break Even,$-1.50,$316.50,$158982.50,278,$316.50
2025-01-28,21:57:00,21558.0,SELL,3,0.02h,Break Even,$-1.50,$315.00,$158981.00,278,$315.00
,,,,,,,,,,,
2025-01-29,12:00:00,21681.25,BUY,3,0.02h,Break Even,$-1.50,$-1.50,$158979.50,279,$-1.50
2025-01-29,12:44:00,21655.75,SELL,3,0.02h,Stop Loss,$-9.00,$-10.50,$158970.50,279,$-10.50
2025-01-29,13:58:00,21588.0,BUY,3,0.02h,Stop Loss,$45.00,$34.50,$159015.50,279,$34.50
2025-01-29,14:31:00,21583.5,SELL,3,0.02h,Stop Loss,$93.00,$127.50,$159108.50,279,$127.50
2025-01-29,15:03:00,21556.5,BUY,3,0.02h,Stop Loss,$6.00,$133.50,$159114.50,279,$133.50
2025-01-29,15:05:00,21529.5,SELL,3,0.02h,Break Even,$-1.50,$132.00,$159113.00,279,$132.00
2025-01-29,15:07:00,21547.75,BUY,3,0.02h,Stop Loss,$48.00,$180.00,$159161.00,279,$180.00
2025-01-29,15:14:00,21522.25,SELL,3,0.02h,Stop Loss,$-9.00,$171.00,$159152.00,279,$171.00
2025-01-29,15:23:00,21547.25,BUY,3,0.02h,Break Even,$-1.50,$169.50,$159150.50,279,$169.50
2025-01-29,15:26:00,21507.0,SELL,3,0.02h,Stop Loss,$87.00,$256.50,$159237.50,279,$256.50
2025-01-29,15:54:00,21518.25,BUY,3,0.02h,Stop Loss,$48.00,$304.50,$159285.50,279,$304.50
2025-01-29,16:08:00,21492.25,SELL,3,0.02h,Stop Loss,$28.50,$333.00,$159314.00,279,$333.00
2025-01-29,16:26:00,21509.25,BUY,3,0.02h,Stop Loss,$-9.00,$324.00,$159305.00,279,$324.00
2025-01-29,16:31:00,21488.0,SELL,3,0.02h,Stop Loss,$16.50,$340.50,$159321.50,279,$340.50
2025-01-29,16:36:00,21502.5,BUY,3,0.02h,Stop Loss,$22.50,$363.00,$159344.00,279,$363.00
2025-01-29,16:39:00,21486.75,SELL,3,0.02h,Stop Loss,$78.00,$441.00,$159422.00,279,$441.00
2025-01-29,16:50:00,21505.25,BUY,3,0.02h,Stop Loss,$4.50,$445.50,$159426.50,279,$445.50
2025-01-29,16:57:00,21472.75,SELL,3,0.02h,Stop Loss,$6.00,$451.50,$159432.50,279,$451.50
2025-01-29,17:02:00,21514.0,BUY,3,0.02h,Break Even,$-1.50,$450.00,$159431.00,279,$450.00
2025-01-29,17:46:00,21515.5,SELL,3,0.02h,Stop Loss,$36.00,$486.00,$159467.00,279,$486.00
2025-01-29,18:27:00,21468.5,BUY,3,0.02h,Stop Loss,$18.00,$504.00,$159485.00,279,$504.00
2025-01-29,18:43:00,21458.5,SELL,3,0.02h,Break Even,$-1.50,$502.50,$159483.50,279,$502.50
2025-01-29,18:49:00,21487.75,BUY,3,0.02h,Stop Loss,$18.00,$520.50,$159501.50,279,$520.50
2025-01-29,19:01:00,21416.5,SELL,3,0.02h,Stop Loss,$31.50,$552.00,$159533.00,279,$552.00
2025-01-29,19:33:00,21469.0,BUY,3,0.02h,Stop Loss,$31.50,$583.50,$159564.50,279,$583.50
2025-01-29,19:37:00,21400.0,SELL,3,0.02h,Stop Loss,$9.00,$592.50,$159573.50,279,$592.50
2025-01-29,19:38:00,21445.75,BUY,3,0.02h,Stop Loss,$249.00,$841.50,$159822.50,279,$841.50
2025-01-29,20:05:00,21496.25,SELL,3,0.02h,Stop Loss,$30.00,$871.50,$159852.50,279,$871.50
2025-01-29,20:12:00,21527.25,BUY,3,0.02h,Stop Loss,$16.50,$888.00,$159869.00,279,$888.00
2025-01-29,20:14:00,21499.5,SELL,3,0.02h,Stop Loss,$100.50,$988.50,$159969.50,279,$988.50
2025-01-29,20:23:00,21551.5,BUY,3,0.02h,Stop Loss,$30.00,$1018.50,$159999.50,279,$1018.50
2025-01-29,20:40:00,21521.5,SELL,3,0.02h,Stop Loss,$12.00,$1030.50,$160011.50,279,$1030.50
2025-01-29,21:17:00,21511.25,BUY,3,0.02h,Stop Loss,$4.50,$1035.00,$160016.00,279,$1035.00
2025-01-29,21:19:00,21484.25,SELL,3,0.02h,Break Even,$-1.50,$1033.50,$160014.50,279,$1033.50
2025-01-29,21:20:00,21507.75,BUY,3,0.02h,Stop Loss,$70.50,$1104.00,$160085.00,279,$1104.00
,,,,,,,,,,,
2025-01-30,12:18:00,21586.75,SELL,3,0.02h,Break Even,$-1.50,$-1.50,$160083.50,280,$-1.50
2025-01-30,12:37:00,21605.75,BUY,3,0.02h,Stop Loss,$45.00,$43.50,$160128.50,280,$43.50
2025-01-30,13:25:00,21630.5,SELL,3,0.02h,Stop Loss,$-9.00,$34.50,$160119.50,280,$34.50
2025-01-30,13:31:00,21639.25,BUY,3,0.02h,Stop Loss,$133.50,$168.00,$160253.00,280,$168.00
2025-01-30,13:38:00,21620.5,SELL,3,0.02h,Stop Loss,$27.00,$195.00,$160280.00,280,$195.00
2025-01-30,13:53:00,21636.5,BUY,3,0.02h,Stop Loss,$34.50,$229.50,$160314.50,280,$229.50
2025-01-30,14:17:00,21640.25,SELL,3,0.02h,Stop Loss,$37.50,$267.00,$160352.00,280,$267.00
2025-01-30,14:32:00,21661.75,BUY,3,0.02h,Stop Loss,$21.00,$288.00,$160373.00,280,$288.00
2025-01-30,14:35:00,21619.75,SELL,3,0.02h,Stop Loss,$114.00,$402.00,$160487.00,280,$402.00
2025-01-30,14:41:00,21654.25,BUY,3,0.02h,Break Even,$-1.50,$400.50,$160485.50,280,$400.50
2025-01-30,14:43:00,21627.25,SELL,3,0.02h,Stop Loss,$28.50,$429.00,$160514.00,280,$429.00
2025-01-30,14:44:00,21647.25,BUY,3,0.02h,Stop Loss,$15.00,$444.00,$160529.00,280,$444.00
2025-01-30,15:02:00,21648.0,SELL,3,0.02h,Stop Loss,$325.50,$769.50,$160854.50,280,$769.50
2025-01-30,15:49:00,21579.25,BUY,3,0.02h,Stop Loss,$-9.00,$760.50,$160845.50,280,$760.50
2025-01-30,15:51:00,21557.0,SELL,3,0.02h,Stop Loss,$51.00,$811.50,$160896.50,280,$811.50
2025-01-30,16:23:00,21500.5,BUY,3,0.02h,Stop Loss,$84.00,$895.50,$160980.50,280,$895.50
2025-01-30,17:13:00,21571.25,SELL,3,0.02h,Stop Loss,$105.00,$1000.50,$161085.50,280,$1000.50
2025-01-30,17:49:00,21540.5,BUY,3,0.02h,Stop Loss,$-9.00,$991.50,$161076.50,280,$991.50
2025-01-30,19:32:00,21602.5,SELL,3,0.02h,Stop Loss,$6.00,$997.50,$161082.50,280,$997.50
2025-01-30,19:39:00,21611.75,BUY,3,0.02h,Stop Loss,$9.00,$1006.50,$161091.50,280,$1006.50
2025-01-30,20:37:00,21653.0,SELL,3,0.02h,Stop Loss,$196.50,$1203.00,$161288.00,280,$1203.00
2025-01-30,20:57:00,21648.25,BUY,3,0.02h,Stop Loss,$31.50,$1234.50,$161319.50,280,$1234.50
2025-01-30,21:20:00,21628.75,SELL,3,0.02h,Break Even,$-1.50,$1233.00,$161318.00,280,$1233.00
2025-01-30,21:31:00,21643.75,BUY,3,0.02h,Stop Loss,$82.50,$1315.50,$161400.50,280,$1315.50
2025-01-30,21:34:00,21619.5,SELL,3,0.02h,Stop Loss,$36.00,$1351.50,$161436.50,280,$1351.50
,,,,,,,,,,,
2025-01-31,12:00:00,21804.5,BUY,3,0.02h,Stop Loss,$34.50,$34.50,$161471.00,281,$34.50
2025-01-31,12:57:00,21787.25,SELL,3,0.02h,Stop Loss,$10.50,$45.00,$161481.50,281,$45.00
2025-01-31,13:19:00,21789.0,BUY,3,0.02h,Stop Loss,$3.00,$48.00,$161484.50,281,$48.00
2025-01-31,13:33:00,21780.75,SELL,3,0.02h,Break Even,$-1.50,$46.50,$161483.00,281,$46.50
2025-01-31,13:49:00,21797.75,BUY,3,0.02h,Stop Loss,$3.00,$49.50,$161486.00,281,$49.50
2025-01-31,14:02:00,21780.5,SELL,3,0.02h,Stop Loss,$28.50,$78.00,$161514.50,281,$78.00
2025-01-31,14:30:00,21775.0,BUY,3,0.02h,Stop Loss,$84.00,$162.00,$161598.50,281,$162.00
2025-01-31,16:21:00,21935.5,SELL,3,0.02h,Stop Loss,$48.00,$210.00,$161646.50,281,$210.00
2025-01-31,17:15:00,21912.0,BUY,3,0.02h,Stop Loss,$-9.00,$201.00,$161637.50,281,$201.00
2025-01-31,17:44:00,21917.0,SELL,3,0.02h,Stop Loss,$12.00,$213.00,$161649.50,281,$213.00
2025-01-31,17:51:00,21927.25,BUY,3,0.02h,Stop Loss,$6.00,$219.00,$161655.50,281,$219.00
2025-01-31,17:59:00,21914.0,SELL,3,0.02h,Break Even,$-1.50,$217.50,$161654.00,281,$217.50
2025-01-31,18:07:00,21923.0,BUY,3,0.02h,Break Even,$-1.50,$216.00,$161652.50,281,$216.00
2025-01-31,18:10:00,21911.75,SELL,3,0.02h,Break Even,$-1.50,$214.50,$161651.00,281,$214.50
2025-01-31,20:00:00,21661.75,BUY,3,0.02h,Stop Loss,$-9.00,$205.50,$161642.00,281,$205.50
2025-01-31,20:01:00,21631.0,SELL,3,0.02h,Stop Loss,$60.00,$265.50,$161702.00,281,$265.50
2025-01-31,20:48:00,21593.25,BUY,3,0.02h,Stop Loss,$111.00,$376.50,$161813.00,281,$376.50
2025-01-31,21:03:00,21565.25,SELL,3,0.02h,Stop Loss,$150.00,$526.50,$161963.00,281,$526.50
2025-01-31,21:22:00,21578.75,BUY,3,0.02h,Break Even,$-1.50,$525.00,$161961.50,281,$525.00
2025-01-31,21:31:00,21562.5,SELL,3,0.02h,Stop Loss,$16.50,$541.50,$161978.00,281,$541.50
2025-01-31,21:51:00,21575.5,BUY,3,0.02h,Break Even,$-1.50,$540.00,$161976.50,281,$540.00
2025-01-31,21:56:00,21557.75,SELL,3,0.02h,Stop Loss,$3.00,$543.00,$161979.50,281,$543.00
,,,,,,,,,,,
2025-02-03,13:04:00,21206.75,BUY,3,0.02h,Stop Loss,$3.00,$3.00,$161982.50,282,$3.00
2025-02-03,13:35:00,21203.5,SELL,3,0.02h,Stop Loss,$72.00,$75.00,$162054.50,282,$75.00
2025-02-03,14:00:00,21202.25,BUY,3,0.02h,Stop Loss,$19.50,$94.50,$162074.00,282,$94.50
2025-02-03,14:11:00,21190.0,SELL,3,0.02h,Stop Loss,$16.50,$111.00,$162090.50,282,$111.00
2025-02-03,14:12:00,21206.5,BUY,3,0.02h,Stop Loss,$130.50,$241.50,$162221.00,282,$241.50
2025-02-03,14:27:00,21188.75,SELL,3,0.02h,Stop Loss,$21.00,$262.50,$162242.00,282,$262.50
2025-02-03,14:32:00,21228.75,BUY,3,0.02h,Stop Loss,$138.00,$400.50,$162380.00,282,$400.50
2025-02-03,14:49:00,21214.0,SELL,3,0.02h,Stop Loss,$21.00,$421.50,$162401.00,282,$421.50
2025-02-03,15:24:00,21229.75,BUY,3,0.02h,Stop Loss,$562.50,$984.00,$162963.50,282,$984.00
2025-02-03,16:06:00,21346.25,SELL,3,0.02h,Stop Loss,$9.00,$993.00,$162972.50,282,$993.00
2025-02-03,16:07:00,21411.5,BUY,3,0.02h,Break Even,$-1.50,$991.50,$162971.00,282,$991.50
2025-02-03,16:29:00,21409.25,SELL,3,0.02h,Stop Loss,$85.50,$1077.00,$163056.50,282,$1077.00
2025-02-03,16:40:00,21433.25,BUY,3,0.02h,Stop Loss,$43.50,$1120.50,$163100.00,282,$1120.50
2025-02-03,16:43:00,21408.5,SELL,3,0.02h,Stop Loss,$40.50,$1161.00,$163140.50,282,$1161.00
2025-02-03,16:46:00,21433.5,BUY,3,0.02h,Stop Loss,$76.50,$1237.50,$163217.00,282,$1237.50
2025-02-03,16:58:00,21383.5,SELL,3,0.02h,Stop Loss,$78.00,$1315.50,$163295.00,282,$1315.50
2025-02-03,17:22:00,21414.5,BUY,3,0.02h,Stop Loss,$30.00,$1345.50,$163325.00,282,$1345.50
2025-02-03,17:32:00,21383.0,SELL,3,0.02h,Stop Loss,$34.50,$1380.00,$163359.50,282,$1380.00
2025-02-03,17:52:00,21401.5,BUY,3,0.02h,Stop Loss,$12.00,$1392.00,$163371.50,282,$1392.00
2025-02-03,18:02:00,21371.25,SELL,3,0.02h,Stop Loss,$102.00,$1494.00,$163473.50,282,$1494.00
2025-02-03,18:05:00,21407.0,BUY,3,0.02h,Break Even,$-1.50,$1492.50,$163472.00,282,$1492.50
2025-02-03,18:11:00,21369.0,SELL,3,0.02h,Stop Loss,$45.00,$1537.50,$163517.00,282,$1537.50
2025-02-03,18:14:00,21417.75,BUY,3,0.02h,Stop Loss,$13.50,$1551.00,$163530.50,282,$1551.00
2025-02-03,19:37:00,21486.75,SELL,3,0.02h,Stop Loss,$33.00,$1584.00,$163563.50,282,$1584.00
2025-02-03,19:42:00,21504.75,BUY,3,0.02h,Break Even,$-1.50,$1582.50,$163562.00,282,$1582.50
2025-02-03,19:58:00,21486.0,SELL,3,0.02h,Stop Loss,$33.00,$1615.50,$163595.00,282,$1615.50
2025-02-03,20:22:00,21491.75,BUY,3,0.02h,Break Even,$-1.50,$1614.00,$163593.50,282,$1614.00
2025-02-03,20:27:00,21471.75,SELL,3,0.02h,Stop Loss,$16.50,$1630.50,$163610.00,282,$1630.50
2025-02-03,21:13:00,21434.0,BUY,3,0.02h,Stop Loss,$-9.00,$1621.50,$163601.00,282,$1621.50
,,,,,,,,,,,
2025-02-04,12:00:00,21400.0,SELL,3,0.02h,Stop Loss,$-9.00,$-9.00,$163592.00,283,$-9.00
2025-02-04,12:33:00,21450.5,BUY,3,0.02h,Break Even,$-1.50,$-10.50,$163590.50,283,$-10.50
2025-02-04,12:50:00,21445.0,SELL,3,0.02h,Stop Loss,$21.00,$10.50,$163611.50,283,$10.50
2025-02-04,12:59:00,21477.25,BUY,3,0.02h,Stop Loss,$12.00,$22.50,$163623.50,283,$22.50
2025-02-04,13:01:00,21436.5,SELL,3,0.02h,Stop Loss,$36.00,$58.50,$163659.50,283,$58.50
2025-02-04,13:09:00,21456.75,BUY,3,0.02h,Stop Loss,$55.50,$114.00,$163715.00,283,$114.00
2025-02-04,13:30:00,21459.0,SELL,3,0.02h,Stop Loss,$40.50,$154.50,$163755.50,283,$154.50
2025-02-04,14:08:00,21443.0,BUY,3,0.02h,Stop Loss,$4.50,$159.00,$163760.00,283,$159.00
2025-02-04,14:16:00,21422.25,SELL,3,0.02h,Break Even,$-1.50,$157.50,$163758.50,283,$157.50
2025-02-04,14:34:00,21449.0,BUY,3,0.02h,Stop Loss,$73.50,$231.00,$163832.00,283,$231.00
2025-02-04,15:52:00,21645.75,SELL,3,0.02h,Stop Loss,$9.00,$240.00,$163841.00,283,$240.00
2025-02-04,16:04:00,21657.0,BUY,3,0.02h,Stop Loss,$45.00,$285.00,$163886.00,283,$285.00
2025-02-04,16:24:00,21642.5,SELL,3,0.02h,Stop Loss,$-9.00,$276.00,$163877.00,283,$276.00
2025-02-04,16:28:00,21659.5,BUY,3,0.02h,Stop Loss,$82.50,$358.50,$163959.50,283,$358.50
2025-02-04,16:49:00,21663.5,SELL,3,0.02h,Stop Loss,$90.00,$448.50,$164049.50,283,$448.50
2025-02-04,17:47:00,21595.25,BUY,3,0.02h,Break Even,$-1.50,$447.00,$164048.00,283,$447.00
2025-02-04,17:49:00,21584.0,SELL,3,0.02h,Break Even,$-1.50,$445.50,$164046.50,283,$445.50
2025-02-04,17:51:00,21597.5,BUY,3,0.02h,Stop Loss,$-9.00,$436.50,$164037.50,283,$436.50
2025-02-04,18:06:00,21571.5,SELL,3,0.02h,Stop Loss,$-9.00,$427.50,$164028.50,283,$427.50
2025-02-04,18:14:00,21605.75,BUY,3,0.02h,Break Even,$-1.50,$426.00,$164027.00,283,$426.00
2025-02-04,18:59:00,21626.25,SELL,3,0.02h,Stop Loss,$4.50,$430.50,$164031.50,283,$430.50
2025-02-04,19:06:00,21645.5,BUY,3,0.02h,Stop Loss,$22.50,$453.00,$164054.00,283,$453.00
2025-02-04,19:48:00,21652.5,SELL,3,0.02h,Stop Loss,$6.00,$459.00,$164060.00,283,$459.00
2025-02-04,20:13:00,21651.25,BUY,3,0.02h,Break Even,$-1.50,$457.50,$164058.50,283,$457.50
2025-02-04,20:21:00,21637.0,SELL,3,0.02h,Stop Loss,$3.00,$460.50,$164061.50,283,$460.50
2025-02-04,20:38:00,21650.5,BUY,3,0.02h,Break Even,$-1.50,$459.00,$164060.00,283,$459.00
2025-02-04,21:03:00,21613.5,SELL,3,0.02h,Stop Loss,$111.00,$570.00,$164171.00,283,$570.00
,,,,,,,,,,,
2025-02-05,12:43:00,21497.75,BUY,3,0.02h,Break Even,$-1.50,$-1.50,$164169.50,284,$-1.50
2025-02-05,13:17:00,21497.5,SELL,3,0.02h,Break Even,$-1.50,$-3.00,$164168.00,284,$-3.00
2025-02-05,13:21:00,21511.5,BUY,3,0.02h,Stop Loss,$43.50,$40.50,$164211.50,284,$40.50
2025-02-05,13:57:00,21518.75,SELL,3,0.02h,Stop Loss,$-9.00,$31.50,$164202.50,284,$31.50
2025-02-05,13:59:00,21531.5,BUY,3,0.02h,Stop Loss,$-9.00,$22.50,$164193.50,284,$22.50
2025-02-05,14:03:00,21513.5,SELL,3,0.02h,Break Even,$-1.50,$21.00,$164192.00,284,$21.00
2025-02-05,14:07:00,21531.5,BUY,3,0.02h,Stop Loss,$-9.00,$12.00,$164183.00,284,$12.00
2025-02-05,14:56:00,21554.75,SELL,3,0.02h,Break Even,$-1.50,$10.50,$164181.50,284,$10.50
2025-02-05,15:01:00,21589.25,BUY,3,0.02h,Stop Loss,$4.50,$15.00,$164186.00,284,$15.00
2025-02-05,15:04:00,21520.0,SELL,3,0.02h,Stop Loss,$93.00,$108.00,$164279.00,284,$108.00
2025-02-05,15:26:00,21554.75,BUY,3,0.02h,Stop Loss,$69.00,$177.00,$164348.00,284,$177.00
2025-02-05,16:18:00,21571.75,SELL,3,0.02h,Break Even,$-1.50,$175.50,$164346.50,284,$175.50
2025-02-05,16:29:00,21605.0,BUY,3,0.02h,Stop Loss,$84.00,$259.50,$164430.50,284,$259.50
2025-02-05,17:22:00,21708.0,SELL,3,0.02h,Break Even,$-1.50,$258.00,$164429.00,284,$258.00
2025-02-05,17:49:00,21710.25,BUY,3,0.02h,Break Even,$-1.50,$256.50,$164427.50,284,$256.50
2025-02-05,17:52:00,21689.25,SELL,3,0.02h,Stop Loss,$-9.00,$247.50,$164418.50,284,$247.50
2025-02-05,18:02:00,21713.0,BUY,3,0.02h,Break Even,$-1.50,$246.00,$164417.00,284,$246.00
2025-02-05,18:09:00,21699.75,SELL,3,0.02h,Stop Loss,$4.50,$250.50,$164421.50,284,$250.50
2025-02-05,18:22:00,21705.75,BUY,3,0.02h,Stop Loss,$-9.00,$241.50,$164412.50,284,$241.50
2025-02-05,18:23:00,21701.0,SELL,3,0.02h,Stop Loss,$7.50,$249.00,$164420.00,284,$249.00
2025-02-05,18:37:00,21704.5,BUY,3,0.02h,Stop Loss,$10.50,$259.50,$164430.50,284,$259.50
2025-02-05,18:53:00,21695.0,SELL,3,0.02h,Stop Loss,$33.00,$292.50,$164463.50,284,$292.50
2025-02-05,18:59:00,21709.75,BUY,3,0.02h,Break Even,$-1.50,$291.00,$164462.00,284,$291.00
2025-02-05,19:29:00,21718.75,SELL,3,0.02h,Break Even,$-1.50,$289.50,$164460.50,284,$289.50
2025-02-05,20:02:00,21720.25,BUY,3,0.02h,Stop Loss,$4.50,$294.00,$164465.00,284,$294.00
2025-02-05,20:38:00,21729.25,SELL,3,0.02h,Stop Loss,$19.50,$313.50,$164484.50,284,$313.50
2025-02-05,20:56:00,21743.0,BUY,3,0.02h,Stop Loss,$43.50,$357.00,$164528.00,284,$357.00
2025-02-05,21:31:00,21764.75,SELL,3,0.02h,Stop Loss,$6.00,$363.00,$164534.00,284,$363.00
2025-02-05,21:56:00,21770.25,BUY,3,0.02h,Stop Loss,$-9.00,$354.00,$164525.00,284,$354.00
,,,,,,,,,,,
2025-02-06,12:00:00,21725.75,SELL,3,0.02h,Stop Loss,$55.50,$55.50,$164580.50,285,$55.50
2025-02-06,12:24:00,21734.25,BUY,3,0.02h,Break Even,$-1.50,$54.00,$164579.00,285,$54.00
2025-02-06,13:32:00,21761.0,SELL,3,0.02h,Stop Loss,$3.00,$57.00,$164582.00,285,$57.00
2025-02-06,13:56:00,21771.25,BUY,3,0.02h,Stop Loss,$16.50,$73.50,$164598.50,285,$73.50
2025-02-06,14:16:00,21766.0,SELL,3,0.02h,Break Even,$-1.50,$72.00,$164597.00,285,$72.00
2025-02-06,14:19:00,21772.5,BUY,3,0.02h,Stop Loss,$3.00,$75.00,$164600.00,285,$75.00
2025-02-06,14:32:00,21742.25,SELL,3,0.02h,Stop Loss,$4.50,$79.50,$164604.50,285,$79.50
2025-02-06,14:45:00,21788.75,BUY,3,0.02h,Stop Loss,$96.00,$175.50,$164700.50,285,$175.50
2025-02-06,15:03:00,21779.5,SELL,3,0.02h,Break Even,$-1.50,$174.00,$164699.00,285,$174.00
2025-02-06,15:09:00,21800.75,BUY,3,0.02h,Stop Loss,$102.00,$276.00,$164801.00,285,$276.00
2025-02-06,15:27:00,21791.25,SELL,3,0.02h,Stop Loss,$15.00,$291.00,$164816.00,285,$291.00
2025-02-06,15:39:00,21832.0,BUY,3,0.02h,Break Even,$-1.50,$289.50,$164814.50,285,$289.50
2025-02-06,15:40:00,21763.25,SELL,3,0.02h,Stop Loss,$4.50,$294.00,$164819.00,285,$294.00
2025-02-06,16:04:00,21785.0,BUY,3,0.02h,Break Even,$-1.50,$292.50,$164817.50,285,$292.50
2025-02-06,16:06:00,21775.0,SELL,3,0.02h,Stop Loss,$-9.00,$283.50,$164808.50,285,$283.50
2025-02-06,16:07:00,21777.0,BUY,3,0.02h,Stop Loss,$19.50,$303.00,$164828.00,285,$303.00
2025-02-06,16:08:00,21772.75,SELL,3,0.02h,Stop Loss,$3.00,$306.00,$164831.00,285,$306.00
2025-02-06,16:09:00,21782.0,BUY,3,0.02h,Stop Loss,$30.00,$336.00,$164861.00,285,$336.00
2025-02-06,16:33:00,21793.75,SELL,3,0.02h,Stop Loss,$27.00,$363.00,$164888.00,285,$363.00
2025-02-06,17:10:00,21776.0,BUY,3,0.02h,Stop Loss,$-9.00,$354.00,$164879.00,285,$354.00
2025-02-06,17:11:00,21772.25,SELL,3,0.02h,Stop Loss,$15.00,$369.00,$164894.00,285,$369.00
2025-02-06,17:18:00,21786.0,BUY,3,0.02h,Stop Loss,$7.50,$376.50,$164901.50,285,$376.50
2025-02-06,17:34:00,21784.75,SELL,3,0.02h,Break Even,$-1.50,$375.00,$164900.00,285,$375.00
2025-02-06,17:36:00,21788.75,BUY,3,0.02h,Break Even,$-1.50,$373.50,$164898.50,285,$373.50
2025-02-06,18:17:00,21813.75,SELL,3,0.02h,Stop Loss,$48.00,$421.50,$164946.50,285,$421.50
2025-02-06,18:19:00,21822.5,BUY,3,0.02h,Break Even,$-1.50,$420.00,$164945.00,285,$420.00
2025-02-06,18:39:00,21817.25,SELL,3,0.02h,Break Even,$-1.50,$418.50,$164943.50,285,$418.50
2025-02-06,18:50:00,21828.75,BUY,3,0.02h,Break Even,$-1.50,$417.00,$164942.00,285,$417.00
2025-02-06,18:51:00,21822.5,SELL,3,0.02h,Stop Loss,$3.00,$420.00,$164945.00,285,$420.00
2025-02-06,19:10:00,21823.5,BUY,3,0.02h,Stop Loss,$13.50,$433.50,$164958.50,285,$433.50
2025-02-06,19:23:00,21816.75,SELL,3,0.02h,Stop Loss,$-9.00,$424.50,$164949.50,285,$424.50
2025-02-06,19:54:00,21768.5,BUY,3,0.02h,Break Even,$-1.50,$423.00,$164948.00,285,$423.00
2025-02-06,19:59:00,21750.5,SELL,3,0.02h,Stop Loss,$43.50,$466.50,$164991.50,285,$466.50
2025-02-06,20:14:00,21759.75,BUY,3,0.02h,Break Even,$-1.50,$465.00,$164990.00,285,$465.00
2025-02-06,21:06:00,21819.75,SELL,3,0.02h,Stop Loss,$64.50,$529.50,$165054.50,285,$529.50
2025-02-06,21:20:00,21844.0,BUY,3,0.02h,Stop Loss,$15.00,$544.50,$165069.50,285,$544.50
2025-02-06,21:47:00,21840.25,SELL,3,0.02h,Stop Loss,$15.00,$559.50,$165084.50,285,$559.50
2025-02-06,22:01:00,21844.25,BUY,3,13.98h,Stop Loss,$150.00,$709.50,$165234.50,285,$709.50
,,,,,,,,,,,
2025-02-07,12:31:00,21859.75,SELL,3,0.02h,Break Even,$-1.50,$-1.50,$165233.00,286,$-1.50
2025-02-07,12:46:00,21870.5,BUY,3,0.02h,Stop Loss,$-9.00,$-10.50,$165224.00,286,$-10.50
2025-02-07,13:00:00,21865.0,SELL,3,0.02h,Break Even,$-1.50,$-12.00,$165222.50,286,$-12.00
2025-02-07,13:18:00,21869.5,BUY,3,0.02h,Stop Loss,$-9.00,$-21.00,$165213.50,286,$-21.00
2025-02-07,13:21:00,21853.25,SELL,3,0.02h,Break Even,$-1.50,$-22.50,$165212.00,286,$-22.50
2025-02-07,13:41:00,21878.25,BUY,3,0.02h,Stop Loss,$39.00,$16.50,$165251.00,286,$16.50
2025-02-07,14:58:00,21905.25,SELL,3,0.02h,Stop Loss,$33.00,$49.50,$165284.00,286,$49.50
2025-02-07,15:38:00,21792.0,BUY,3,0.02h,Stop Loss,$16.50,$66.00,$165300.50,286,$66.00
2025-02-07,15:45:00,21751.0,SELL,3,0.02h,Stop Loss,$45.00,$111.00,$165345.50,286,$111.00
2025-02-07,15:48:00,21775.5,BUY,3,0.02h,Stop Loss,$7.50,$118.50,$165353.00,286,$118.50
2025-02-07,15:54:00,21654.5,SELL,3,0.02h,Stop Loss,$213.00,$331.50,$165566.00,286,$331.50
2025-02-07,16:21:00,21730.5,BUY,3,0.02h,Stop Loss,$24.00,$355.50,$165590.00,286,$355.50
2025-02-07,16:27:00,21679.25,SELL,3,0.02h,Stop Loss,$84.00,$439.50,$165674.00,286,$439.50
2025-02-07,17:10:00,21658.25,BUY,3,0.02h,Break Even,$-1.50,$438.00,$165672.50,286,$438.00
2025-02-07,17:19:00,21613.5,SELL,3,0.02h,Stop Loss,$96.00,$534.00,$165768.50,286,$534.00
2025-02-07,17:38:00,21644.75,BUY,3,0.02h,Stop Loss,$82.50,$616.50,$165851.00,286,$616.50
2025-02-07,18:42:00,21688.75,SELL,3,0.02h,Stop Loss,$40.50,$657.00,$165891.50,286,$657.00
2025-02-07,19:41:00,21604.5,BUY,3,0.02h,Stop Loss,$-9.00,$648.00,$165882.50,286,$648.00
2025-02-07,20:02:00,21583.5,SELL,3,0.02h,Stop Loss,$12.00,$660.00,$165894.50,286,$660.00
2025-02-07,20:35:00,21596.0,BUY,3,0.02h,Break Even,$-1.50,$658.50,$165893.00,286,$658.50
2025-02-07,21:06:00,21588.25,SELL,3,0.02h,Stop Loss,$-9.00,$649.50,$165884.00,286,$649.50
,,,,,,,,,,,
2025-02-10,12:00:00,21742.25,BUY,3,0.02h,Stop Loss,$4.50,$4.50,$165888.50,287,$4.50
2025-02-10,14:12:00,21773.0,SELL,3,0.02h,Stop Loss,$6.00,$10.50,$165894.50,287,$10.50
2025-02-10,14:39:00,21777.5,BUY,3,0.02h,Stop Loss,$36.00,$46.50,$165930.50,287,$46.50
2025-02-10,15:58:00,21866.75,SELL,3,0.02h,Stop Loss,$-9.00,$37.50,$165921.50,287,$37.50
2025-02-10,16:01:00,21879.0,BUY,3,0.02h,Stop Loss,$22.50,$60.00,$165944.00,287,$60.00
2025-02-10,16:08:00,21866.0,SELL,3,0.02h,Stop Loss,$36.00,$96.00,$165980.00,287,$96.00
2025-02-10,16:55:00,21855.5,BUY,3,0.02h,Stop Loss,$39.00,$135.00,$166019.00,287,$135.00
2025-02-10,17:06:00,21846.75,SELL,3,0.02h,Break Even,$-1.50,$133.50,$166017.50,287,$133.50
2025-02-10,17:35:00,21841.25,BUY,3,0.02h,Stop Loss,$16.50,$150.00,$166034.00,287,$150.00
2025-02-10,18:36:00,21867.0,SELL,3,0.02h,Break Even,$-1.50,$148.50,$166032.50,287,$148.50
2025-02-10,18:37:00,21869.75,BUY,3,0.02h,Break Even,$-1.50,$147.00,$166031.00,287,$147.00
2025-02-10,18:41:00,21863.5,SELL,3,0.02h,Stop Loss,$3.00,$150.00,$166034.00,287,$150.00
2025-02-10,18:50:00,21870.75,BUY,3,0.02h,Stop Loss,$7.50,$157.50,$166041.50,287,$157.50
2025-02-10,19:03:00,21865.5,SELL,3,0.02h,Stop Loss,$-9.00,$148.50,$166032.50,287,$148.50
2025-02-10,19:13:00,21874.5,BUY,3,0.02h,Stop Loss,$12.00,$160.50,$166044.50,287,$160.50
2025-02-10,19:28:00,21866.0,SELL,3,0.02h,Stop Loss,$9.00,$169.50,$166053.50,287,$169.50
2025-02-10,20:07:00,21864.75,BUY,3,0.02h,Stop Loss,$21.00,$190.50,$166074.50,287,$190.50
2025-02-10,20:25:00,21860.5,SELL,3,0.02h,Stop Loss,$-9.00,$181.50,$166065.50,287,$181.50
2025-02-10,21:32:00,21835.25,BUY,3,0.03h,Break Even,$-1.50,$180.00,$166064.00,287,$180.00
2025-02-10,21:57:00,21834.75,SELL,3,0.02h,Stop Loss,$-9.00,$171.00,$166055.00,287,$171.00
2025-02-10,21:59:00,21837.0,BUY,3,0.02h,Stop Loss,$-9.00,$162.00,$166046.00,287,$162.00
,,,,,,,,,,,
2025-02-11,12:00:00,21763.75,SELL,3,0.02h,Stop Loss,$49.50,$49.50,$166095.50,288,$49.50
2025-02-11,12:46:00,21749.5,BUY,3,0.02h,Stop Loss,$-9.00,$40.50,$166086.50,288,$40.50
2025-02-11,12:56:00,21743.25,SELL,3,0.02h,Break Even,$-1.50,$39.00,$166085.00,288,$39.00
2025-02-11,13:02:00,21750.0,BUY,3,0.02h,Break Even,$-1.50,$37.50,$166083.50,288,$37.50
2025-02-11,13:09:00,21743.75,SELL,3,0.02h,Stop Loss,$-9.00,$28.50,$166074.50,288,$28.50
2025-02-11,14:17:00,21702.25,BUY,3,0.02h,Stop Loss,$-9.00,$19.50,$166065.50,288,$19.50
2025-02-11,14:18:00,21694.75,SELL,3,0.02h,Break Even,$-1.50,$18.00,$166064.00,288,$18.00
2025-02-11,14:19:00,21700.75,BUY,3,0.02h,Break Even,$-1.50,$16.50,$166062.50,288,$16.50
2025-02-11,14:24:00,21695.75,SELL,3,0.02h,Stop Loss,$10.50,$27.00,$166073.00,288,$27.00
2025-02-11,14:28:00,21706.5,BUY,3,0.02h,Break Even,$-1.50,$25.50,$166071.50,288,$25.50
2025-02-11,16:03:00,21837.0,SELL,3,0.02h,Stop Loss,$-9.00,$16.50,$166062.50,288,$16.50
2025-02-11,16:40:00,21836.75,BUY,3,0.02h,Break Even,$-1.50,$15.00,$166061.00,288,$15.00
2025-02-11,16:49:00,21827.75,SELL,3,0.02h,Break Even,$-1.50,$13.50,$166059.50,288,$13.50
2025-02-11,17:24:00,21783.5,BUY,3,0.02h,Stop Loss,$13.50,$27.00,$166073.00,288,$27.00
2025-02-11,17:45:00,21768.25,SELL,3,0.02h,Break Even,$-1.50,$25.50,$166071.50,288,$25.50
2025-02-11,18:19:00,21772.5,BUY,3,0.02h,Break Even,$-1.50,$24.00,$166070.00,288,$24.00
2025-02-11,18:57:00,21802.25,SELL,3,0.02h,Break Even,$-1.50,$22.50,$166068.50,288,$22.50
2025-02-11,19:05:00,21814.25,BUY,3,0.02h,Break Even,$-1.50,$21.00,$166067.00,288,$21.00
2025-02-11,19:12:00,21797.75,SELL,3,0.02h,Stop Loss,$7.50,$28.50,$166074.50,288,$28.50
2025-02-11,19:39:00,21805.0,BUY,3,0.02h,Stop Loss,$24.00,$52.50,$166098.50,288,$52.50
2025-02-11,20:11:00,21823.0,SELL,3,0.02h,Stop Loss,$4.50,$57.00,$166103.00,288,$57.00
2025-02-11,21:05:00,21793.25,BUY,3,0.02h,Stop Loss,$-9.00,$48.00,$166094.00,288,$48.00
2025-02-11,21:07:00,21784.5,SELL,3,0.02h,Break Even,$-1.50,$46.50,$166092.50,288,$46.50
2025-02-11,21:09:00,21788.0,BUY,3,0.02h,Break Even,$-1.50,$45.00,$166091.00,288,$45.00
2025-02-11,21:37:00,21790.5,SELL,3,0.02h,Stop Loss,$-9.00,$36.00,$166082.00,288,$36.00
2025-02-11,21:39:00,21794.75,BUY,3,0.02h,Stop Loss,$-9.00,$27.00,$166073.00,288,$27.00
2025-02-11,21:44:00,21789.5,SELL,3,0.02h,Stop Loss,$-9.00,$18.00,$166064.00,288,$18.00
2025-02-11,21:52:00,21793.25,BUY,3,0.02h,Stop Loss,$-9.00,$9.00,$166055.00,288,$9.00
,,,,,,,,,,,
2025-02-12,12:01:00,21789.0,SELL,3,0.02h,Stop Loss,$-9.00,$-9.00,$166046.00,289,$-9.00
2025-02-12,12:08:00,21794.5,BUY,3,0.02h,Stop Loss,$-9.00,$-18.00,$166037.00,289,$-18.00
2025-02-12,12:10:00,21790.5,SELL,3,0.02h,Stop Loss,$-9.00,$-27.00,$166028.00,289,$-27.00
2025-02-12,12:12:00,21794.75,BUY,3,0.02h,Break Even,$-1.50,$-28.50,$166026.50,289,$-28.50
2025-02-12,13:22:00,21818.75,SELL,3,0.02h,Stop Loss,$12.00,$-16.50,$166038.50,289,$-16.50
2025-02-12,14:23:00,21557.5,BUY,3,0.02h,Break Even,$-1.50,$-18.00,$166037.00,289,$-18.00
2025-02-12,15:05:00,21615.0,SELL,3,0.02h,Stop Loss,$21.00,$3.00,$166058.00,289,$3.00
2025-02-12,15:19:00,21663.5,BUY,3,0.02h,Stop Loss,$45.00,$48.00,$166103.00,289,$48.00
2025-02-12,15:51:00,21700.5,SELL,3,0.02h,Break Even,$-1.50,$46.50,$166101.50,289,$46.50
2025-02-12,15:53:00,21716.0,BUY,3,0.02h,Break Even,$-1.50,$45.00,$166100.00,289,$45.00
2025-02-12,16:08:00,21697.25,SELL,3,0.02h,Stop Loss,$40.50,$85.50,$166140.50,289,$85.50
2025-02-12,16:37:00,21695.5,BUY,3,0.02h,Stop Loss,$48.00,$133.50,$166188.50,289,$133.50
2025-02-12,17:34:00,21773.75,SELL,3,0.02h,Stop Loss,$-9.00,$124.50,$166179.50,289,$124.50
2025-02-12,17:49:00,21791.75,BUY,3,0.02h,Break Even,$-1.50,$123.00,$166178.00,289,$123.00
2025-02-12,18:22:00,21799.25,SELL,3,0.02h,Break Even,$-1.50,$121.50,$166176.50,289,$121.50
2025-02-12,18:34:00,21809.0,BUY,3,0.02h,Break Even,$-1.50,$120.00,$166175.00,289,$120.00
2025-02-12,18:40:00,21798.5,SELL,3,0.02h,Break Even,$-1.50,$118.50,$166173.50,289,$118.50
2025-02-12,18:56:00,21800.0,BUY,3,0.02h,Stop Loss,$9.00,$127.50,$166182.50,289,$127.50
2025-02-12,19:01:00,21790.25,SELL,3,0.02h,Break Even,$-1.50,$126.00,$166181.00,289,$126.00
2025-02-12,19:25:00,21785.5,BUY,3,0.02h,Stop Loss,$-9.00,$117.00,$166172.00,289,$117.00
2025-02-12,20:11:00,21821.5,SELL,3,0.02h,Stop Loss,$-9.00,$108.00,$166163.00,289,$108.00
2025-02-12,20:12:00,21825.75,BUY,3,0.02h,Stop Loss,$12.00,$120.00,$166175.00,289,$120.00
2025-02-12,20:15:00,21819.75,SELL,3,0.02h,Stop Loss,$18.00,$138.00,$166193.00,289,$138.00
2025-02-12,20:22:00,21823.75,BUY,3,0.02h,Break Even,$-1.50,$136.50,$166191.50,289,$136.50
2025-02-12,20:30:00,21815.5,SELL,3,0.02h,Stop Loss,$9.00,$145.50,$166200.50,289,$145.50
2025-02-12,21:01:00,21810.5,BUY,3,0.02h,Break Even,$-1.50,$144.00,$166199.00,289,$144.00
2025-02-12,21:03:00,21792.25,SELL,3,0.02h,Break Even,$-1.50,$142.50,$166197.50,289,$142.50
2025-02-12,21:06:00,21813.75,BUY,3,0.02h,Stop Loss,$21.00,$163.50,$166218.50,289,$163.50
,,,,,,,,,,,
2025-02-13,12:01:00,21815.0,SELL,3,0.02h,Stop Loss,$24.00,$24.00,$166242.50,290,$24.00
2025-02-13,12:28:00,21817.5,BUY,3,0.02h,Stop Loss,$-9.00,$15.00,$166233.50,290,$15.00
2025-02-13,12:49:00,21810.75,SELL,3,0.02h,Stop Loss,$-9.00,$6.00,$166224.50,290,$6.00
2025-02-13,12:58:00,21822.5,BUY,3,0.02h,Break Even,$-1.50,$4.50,$166223.00,290,$4.50
2025-02-13,13:06:00,21813.0,SELL,3,0.02h,Stop Loss,$12.00,$16.50,$166235.00,290,$16.50
2025-02-13,13:22:00,21820.5,BUY,3,0.02h,Break Even,$-1.50,$15.00,$166233.50,290,$15.00
2025-02-13,14:16:00,21866.0,SELL,3,0.02h,Stop Loss,$16.50,$31.50,$166250.00,290,$31.50
2025-02-13,14:24:00,21872.5,BUY,3,0.02h,Stop Loss,$27.00,$58.50,$166277.00,290,$58.50
2025-02-13,14:41:00,21863.5,SELL,3,0.02h,Stop Loss,$78.00,$136.50,$166355.00,290,$136.50
2025-02-13,14:54:00,21889.75,BUY,3,0.02h,Stop Loss,$9.00,$145.50,$166364.00,290,$145.50
2025-02-13,16:21:00,22033.0,SELL,3,0.02h,Stop Loss,$46.50,$192.00,$166410.50,290,$192.00
2025-02-13,17:09:00,21992.25,BUY,3,0.02h,Break Even,$-1.50,$190.50,$166409.00,290,$190.50
2025-02-13,17:13:00,21972.25,SELL,3,0.02h,Stop Loss,$22.50,$213.00,$166431.50,290,$213.00
2025-02-13,17:42:00,21975.5,BUY,3,0.02h,Stop Loss,$7.50,$220.50,$166439.00,290,$220.50
2025-02-13,17:58:00,21961.5,SELL,3,0.02h,Stop Loss,$57.00,$277.50,$166496.00,290,$277.50
2025-02-13,18:36:00,21955.75,BUY,3,0.02h,Stop Loss,$30.00,$307.50,$166526.00,290,$307.50
2025-02-13,18:44:00,21937.5,SELL,3,0.02h,Stop Loss,$30.00,$337.50,$166556.00,290,$337.50
2025-02-13,18:46:00,21956.75,BUY,3,0.02h,Stop Loss,$52.50,$390.00,$166608.50,290,$390.00
2025-02-13,20:32:00,22072.75,SELL,3,0.02h,Stop Loss,$-9.00,$381.00,$166599.50,290,$381.00
2025-02-13,20:47:00,22076.75,BUY,3,0.02h,Stop Loss,$3.00,$384.00,$166602.50,290,$384.00
2025-02-13,21:07:00,22078.5,SELL,3,0.02h,Break Even,$-1.50,$382.50,$166601.00,290,$382.50
2025-02-13,21:42:00,22083.5,BUY,3,0.03h,Stop Loss,$3.00,$385.50,$166604.00,290,$385.50
2025-02-13,21:57:00,22081.0,SELL,3,0.02h,Stop Loss,$-9.00,$376.50,$166595.00,290,$376.50
,,,,,,,,,,,
2025-02-14,12:16:00,22083.25,BUY,3,0.02h,Break Even,$-1.50,$-1.50,$166593.50,291,$-1.50
2025-02-14,12:44:00,22073.25,SELL,3,0.02h,Break Even,$-1.50,$-3.00,$166592.00,291,$-3.00
2025-02-14,12:58:00,22078.5,BUY,3,0.02h,Stop Loss,$7.50,$4.50,$166599.50,291,$4.50
2025-02-14,13:30:00,22081.75,SELL,3,0.02h,Stop Loss,$9.00,$13.50,$166608.50,291,$13.50
2025-02-14,13:32:00,22097.5,BUY,3,0.02h,Stop Loss,$46.50,$60.00,$166655.00,291,$60.00
2025-02-14,14:12:00,22100.5,SELL,3,0.02h,Stop Loss,$16.50,$76.50,$166671.50,291,$76.50
2025-02-14,14:21:00,22106.75,BUY,3,0.02h,Stop Loss,$15.00,$91.50,$166686.50,291,$91.50
2025-02-14,14:36:00,22100.5,SELL,3,0.02h,Stop Loss,$34.50,$126.00,$166721.00,291,$126.00
2025-02-14,14:48:00,22122.25,BUY,3,0.02h,Stop Loss,$30.00,$156.00,$166751.00,291,$156.00
2025-02-14,15:32:00,22133.5,SELL,3,0.02h,Stop Loss,$34.50,$190.50,$166785.50,291,$190.50
2025-02-14,15:51:00,22134.0,BUY,3,0.02h,Stop Loss,$12.00,$202.50,$166797.50,291,$202.50
2025-02-14,16:18:00,22145.0,SELL,3,0.02h,Stop Loss,$43.50,$246.00,$166841.00,291,$246.00
2025-02-14,16:46:00,22138.0,BUY,3,0.02h,Break Even,$-1.50,$244.50,$166839.50,291,$244.50
2025-02-14,16:48:00,22123.75,SELL,3,0.02h,Stop Loss,$16.50,$261.00,$166856.00,291,$261.00
2025-02-14,16:58:00,22134.25,BUY,3,0.02h,Stop Loss,$28.50,$289.50,$166884.50,291,$289.50
2025-02-14,17:08:00,22126.0,SELL,3,0.02h,Stop Loss,$31.50,$321.00,$166916.00,291,$321.00
2025-02-14,17:48:00,22121.5,BUY,3,0.02h,Stop Loss,$28.50,$349.50,$166944.50,291,$349.50
2025-02-14,18:25:00,22155.0,SELL,3,0.02h,Stop Loss,$19.50,$369.00,$166964.00,291,$369.00
2025-02-14,18:32:00,22164.75,BUY,3,0.02h,Stop Loss,$24.00,$393.00,$166988.00,291,$393.00
2025-02-14,19:05:00,22184.5,SELL,3,0.02h,Stop Loss,$-9.00,$384.00,$166979.00,291,$384.00
2025-02-14,19:08:00,22192.5,BUY,3,0.02h,Stop Loss,$-9.00,$375.00,$166970.00,291,$375.00
2025-02-14,19:22:00,22187.5,SELL,3,0.02h,Break Even,$-1.50,$373.50,$166968.50,291,$373.50
2025-02-14,20:00:00,22179.0,BUY,3,0.02h,Stop Loss,$-9.00,$364.50,$166959.50,291,$364.50
2025-02-14,20:01:00,22166.5,SELL,3,0.02h,Break Even,$-1.50,$363.00,$166958.00,291,$363.00
2025-02-14,20:14:00,22176.5,BUY,3,0.02h,Break Even,$-1.50,$361.50,$166956.50,291,$361.50
2025-02-14,21:02:00,22191.25,SELL,3,0.02h,Stop Loss,$-9.00,$352.50,$166947.50,291,$352.50
2025-02-14,21:07:00,22207.5,BUY,3,0.02h,Break Even,$-1.50,$351.00,$166946.00,291,$351.00
2025-02-14,21:34:00,22200.25,SELL,3,0.02h,Break Even,$-1.50,$349.50,$166944.50,291,$349.50
2025-02-14,21:59:00,22206.75,BUY,3,0.02h,Break Even,$-1.50,$348.00,$166943.00,291,$348.00
2025-02-14,22:00:00,22203.0,SELL,3,62.00h,Stop Loss,$-9.00,$339.00,$166934.00,291,$339.00
,,,,,,,,,,,
2025-02-17,12:00:00,22243.5,BUY,3,0.02h,Break Even,$-1.50,$-1.50,$166932.50,292,$-1.50
2025-02-17,12:54:00,22251.25,SELL,3,0.02h,Stop Loss,$3.00,$1.50,$166935.50,292,$1.50
2025-02-17,13:10:00,22252.0,BUY,3,0.02h,Break Even,$-1.50,$0.00,$166934.00,292,$0.00
2025-02-17,13:31:00,22250.25,SELL,3,0.02h,Stop Loss,$4.50,$4.50,$166938.50,292,$4.50
2025-02-17,13:50:00,22249.5,BUY,3,0.02h,Break Even,$-1.50,$3.00,$166937.00,292,$3.00
2025-02-17,14:16:00,22250.25,SELL,3,0.02h,Stop Loss,$-9.00,$-6.00,$166928.00,292,$-6.00
2025-02-17,15:05:00,22216.0,BUY,3,0.02h,Break Even,$-1.50,$-7.50,$166926.50,292,$-7.50
2025-02-17,16:35:00,22239.5,SELL,3,0.02h,Stop Loss,$-9.00,$-16.50,$166917.50,292,$-16.50
2025-02-17,16:51:00,22243.0,BUY,3,0.02h,Stop Loss,$-9.00,$-25.50,$166908.50,292,$-25.50
2025-02-17,16:55:00,22239.25,SELL,3,0.02h,Stop Loss,$4.50,$-21.00,$166913.00,292,$-21.00
2025-02-17,17:30:00,22231.0,BUY,3,0.02h,Break Even,$-1.50,$-22.50,$166911.50,292,$-22.50
2025-02-17,17:48:00,22231.75,SELL,3,0.02h,Stop Loss,$-9.00,$-31.50,$166902.50,292,$-31.50
2025-02-17,17:49:00,22235.75,BUY,3,0.02h,Stop Loss,$3.00,$-28.50,$166905.50,292,$-28.50
2025-02-17,17:59:00,22233.25,SELL,3,0.02h,Break Even,$-1.50,$-30.00,$166904.00,292,$-30.00
,,,,,,,,,,,
2025-02-18,12:00:00,22276.75,BUY,3,0.02h,Stop Loss,$-9.00,$-9.00,$166895.00,293,$-9.00
2025-02-18,12:50:00,22288.75,SELL,3,0.02h,Break Even,$-1.50,$-10.50,$166893.50,293,$-10.50
2025-02-18,13:18:00,22288.0,BUY,3,0.02h,Break Even,$-1.50,$-12.00,$166892.00,293,$-12.00
2025-02-18,14:22:00,22305.5,SELL,3,0.02h,Stop Loss,$-9.00,$-21.00,$166883.00,293,$-21.00
2025-02-18,15:44:00,22170.25,BUY,3,0.02h,Break Even,$-1.50,$-22.50,$166881.50,293,$-22.50
2025-02-18,15:46:00,22154.25,SELL,3,0.02h,Stop Loss,$100.50,$78.00,$166982.00,293,$78.00
2025-02-18,15:53:00,22173.25,BUY,3,0.02h,Stop Loss,$6.00,$84.00,$166988.00,293,$84.00
2025-02-18,16:23:00,22168.75,SELL,3,0.02h,Stop Loss,$3.00,$87.00,$166991.00,293,$87.00
2025-02-18,16:29:00,22199.25,BUY,3,0.02h,Stop Loss,$16.50,$103.50,$167007.50,293,$103.50
2025-02-18,16:34:00,22181.0,SELL,3,0.02h,Break Even,$-1.50,$102.00,$167006.00,293,$102.00
2025-02-18,16:48:00,22203.5,BUY,3,0.02h,Stop Loss,$15.00,$117.00,$167021.00,293,$117.00
2025-02-18,17:01:00,22181.5,SELL,3,0.02h,Break Even,$-1.50,$115.50,$167019.50,293,$115.50
2025-02-18,17:33:00,22183.75,BUY,3,0.02h,Stop Loss,$-9.00,$106.50,$167010.50,293,$106.50
2025-02-18,18:10:00,22182.5,SELL,3,0.02h,Stop Loss,$9.00,$115.50,$167019.50,293,$115.50
2025-02-18,18:52:00,22162.0,BUY,3,0.02h,Stop Loss,$18.00,$133.50,$167037.50,293,$133.50
2025-02-18,19:08:00,22124.0,SELL,3,0.02h,Stop Loss,$105.00,$238.50,$167142.50,293,$238.50
2025-02-18,19:26:00,22151.0,BUY,3,0.02h,Stop Loss,$3.00,$241.50,$167145.50,293,$241.50
2025-02-18,20:17:00,22168.75,SELL,3,0.02h,Stop Loss,$-9.00,$232.50,$167136.50,293,$232.50
2025-02-18,20:26:00,22178.75,BUY,3,0.02h,Break Even,$-1.50,$231.00,$167135.00,293,$231.00
2025-02-18,20:30:00,22170.0,SELL,3,0.02h,Stop Loss,$4.50,$235.50,$167139.50,293,$235.50
2025-02-18,20:33:00,22177.0,BUY,3,0.02h,Stop Loss,$-9.00,$226.50,$167130.50,293,$226.50
2025-02-18,20:35:00,22170.0,SELL,3,0.02h,Stop Loss,$18.00,$244.50,$167148.50,293,$244.50
2025-02-18,20:43:00,22174.75,BUY,3,0.02h,Break Even,$-1.50,$243.00,$167147.00,293,$243.00
2025-02-18,20:44:00,22164.75,SELL,3,0.02h,Break Even,$-1.50,$241.50,$167145.50,293,$241.50
2025-02-18,20:53:00,22176.5,BUY,3,0.02h,Break Even,$-1.50,$240.00,$167144.00,293,$240.00
2025-02-18,21:34:00,22221.5,SELL,3,0.02h,Break Even,$-1.50,$238.50,$167142.50,293,$238.50
2025-02-18,22:00:00,22225.0,BUY,3,14.00h,Stop Loss,$-9.00,$229.50,$167133.50,293,$229.50
,,,,,,,,,,,
2025-02-19,12:00:00,22212.75,SELL,3,0.02h,Break Even,$-1.50,$-1.50,$167132.00,294,$-1.50
2025-02-19,12:02:00,22235.5,BUY,3,0.02h,Break Even,$-1.50,$-3.00,$167130.50,294,$-3.00
2025-02-19,12:35:00,22239.25,SELL,3,0.02h,Stop Loss,$-9.00,$-12.00,$167121.50,294,$-12.00
2025-02-19,12:37:00,22244.25,BUY,3,0.02h,Stop Loss,$-9.00,$-21.00,$167112.50,294,$-21.00
2025-02-19,12:38:00,22238.0,SELL,3,0.02h,Break Even,$-1.50,$-22.50,$167111.00,294,$-22.50
2025-02-19,12:44:00,22243.0,BUY,3,0.02h,Stop Loss,$-9.00,$-31.50,$167102.00,294,$-31.50
2025-02-19,12:46:00,22240.5,SELL,3,0.02h,Stop Loss,$-9.00,$-40.50,$167093.00,294,$-40.50
2025-02-19,12:47:00,22248.25,BUY,3,0.02h,Stop Loss,$16.50,$-24.00,$167109.50,294,$-24.00
2025-02-19,13:00:00,22228.5,SELL,3,0.02h,Stop Loss,$48.00,$24.00,$167157.50,294,$24.00
2025-02-19,13:50:00,22206.5,BUY,3,0.02h,Stop Loss,$-9.00,$15.00,$167148.50,294,$15.00
2025-02-19,14:02:00,22198.5,SELL,3,0.02h,Stop Loss,$-9.00,$6.00,$167139.50,294,$6.00
2025-02-19,14:03:00,22208.0,BUY,3,0.02h,Break Even,$-1.50,$4.50,$167138.00,294,$4.50
2025-02-19,14:18:00,22196.25,SELL,3,0.02h,Break Even,$-1.50,$3.00,$167136.50,294,$3.00
2025-02-19,14:37:00,22215.75,BUY,3,0.02h,Stop Loss,$13.50,$16.50,$167150.00,294,$16.50
2025-02-19,14:42:00,22187.0,SELL,3,0.02h,Stop Loss,$31.50,$48.00,$167181.50,294,$48.00
2025-02-19,15:31:00,22162.0,BUY,3,0.02h,Stop Loss,$141.00,$189.00,$167322.50,294,$189.00
2025-02-19,15:57:00,22157.0,SELL,3,0.02h,Stop Loss,$42.00,$231.00,$167364.50,294,$231.00
2025-02-19,16:03:00,22193.25,BUY,3,0.02h,Stop Loss,$18.00,$249.00,$167382.50,294,$249.00
2025-02-19,17:17:00,22235.25,SELL,3,0.02h,Break Even,$-1.50,$247.50,$167381.00,294,$247.50
2025-02-19,17:44:00,22234.25,BUY,3,0.02h,Stop Loss,$-9.00,$238.50,$167372.00,294,$238.50
2025-02-19,18:06:00,22222.25,SELL,3,0.02h,Stop Loss,$4.50,$243.00,$167376.50,294,$243.00
2025-02-19,18:20:00,22238.75,BUY,3,0.02h,Break Even,$-1.50,$241.50,$167375.00,294,$241.50
2025-02-19,18:50:00,22244.5,SELL,3,0.02h,Stop Loss,$12.00,$253.50,$167387.00,294,$253.50
2025-02-19,19:14:00,22250.25,BUY,3,0.02h,Stop Loss,$100.50,$354.00,$167487.50,294,$354.00
2025-02-19,20:05:00,22277.5,SELL,3,0.02h,Stop Loss,$10.50,$364.50,$167498.00,294,$364.50
2025-02-19,20:56:00,22250.25,BUY,3,0.02h,Stop Loss,$3.00,$367.50,$167501.00,294,$367.50
2025-02-19,21:03:00,22227.5,SELL,3,0.02h,Stop Loss,$40.50,$408.00,$167541.50,294,$408.00
2025-02-19,21:38:00,22226.25,BUY,3,0.02h,Stop Loss,$-9.00,$399.00,$167532.50,294,$399.00
2025-02-19,21:39:00,22221.0,SELL,3,0.02h,Stop Loss,$-9.00,$390.00,$167523.50,294,$390.00
2025-02-19,21:59:00,22223.25,BUY,3,0.02h,Stop Loss,$-9.00,$381.00,$167514.50,294,$381.00
,,,,,,,,,,,
2025-02-20,12:00:00,22186.75,SELL,3,0.02h,Stop Loss,$6.00,$6.00,$167520.50,295,$6.00
2025-02-20,12:35:00,22200.0,BUY,3,0.02h,Break Even,$-1.50,$4.50,$167519.00,295,$4.50
2025-02-20,13:07:00,22199.0,SELL,3,0.02h,Break Even,$-1.50,$3.00,$167517.50,295,$3.00
2025-02-20,13:44:00,22201.75,BUY,3,0.02h,Stop Loss,$4.50,$7.50,$167522.00,295,$7.50
2025-02-20,13:53:00,22193.0,SELL,3,0.02h,Break Even,$-1.50,$6.00,$167520.50,295,$6.00
2025-02-20,13:59:00,22201.25,BUY,3,0.02h,Break Even,$-1.50,$4.50,$167519.00,295,$4.50
2025-02-20,14:27:00,22209.75,SELL,3,0.02h,Stop Loss,$18.00,$22.50,$167537.00,295,$22.50
2025-02-20,15:19:00,22081.25,BUY,3,0.02h,Stop Loss,$16.50,$39.00,$167553.50,295,$39.00
2025-02-20,15:43:00,22073.25,SELL,3,0.02h,Stop Loss,$40.50,$79.50,$167594.00,295,$79.50
2025-02-20,16:10:00,22053.5,BUY,3,0.02h,Stop Loss,$40.50,$120.00,$167634.50,295,$120.00
2025-02-20,16:20:00,22029.0,SELL,3,0.02h,Stop Loss,$-9.00,$111.00,$167625.50,295,$111.00
2025-02-20,16:22:00,22050.0,BUY,3,0.02h,Stop Loss,$-9.00,$102.00,$167616.50,295,$102.00
2025-02-20,16:37:00,22033.5,SELL,3,0.02h,Stop Loss,$73.50,$175.50,$167690.00,295,$175.50
2025-02-20,16:45:00,22055.5,BUY,3,0.02h,Break Even,$-1.50,$174.00,$167688.50,295,$174.00
2025-02-20,16:48:00,22033.0,SELL,3,0.02h,Stop Loss,$6.00,$180.00,$167694.50,295,$180.00
2025-02-20,16:53:00,22055.0,BUY,3,0.02h,Stop Loss,$-9.00,$171.00,$167685.50,295,$171.00
2025-02-20,16:54:00,22038.25,SELL,3,0.02h,Break Even,$-1.50,$169.50,$167684.00,295,$169.50
2025-02-20,17:04:00,22061.25,BUY,3,0.02h,Stop Loss,$22.50,$192.00,$167706.50,295,$192.00
2025-02-20,17:50:00,22068.25,SELL,3,0.02h,Stop Loss,$6.00,$198.00,$167712.50,295,$198.00
2025-02-20,18:14:00,22065.75,BUY,3,0.02h,Break Even,$-1.50,$196.50,$167711.00,295,$196.50
2025-02-20,18:19:00,22052.25,SELL,3,0.02h,Stop Loss,$9.00,$205.50,$167720.00,295,$205.50
2025-02-20,18:34:00,22059.0,BUY,3,0.02h,Stop Loss,$-9.00,$196.50,$167711.00,295,$196.50
2025-02-20,18:52:00,22052.0,SELL,3,0.02h,Stop Loss,$7.50,$204.00,$167718.50,295,$204.00
2025-02-20,18:58:00,22063.5,BUY,3,0.02h,Stop Loss,$48.00,$252.00,$167766.50,295,$252.00
2025-02-20,19:33:00,22083.5,SELL,3,0.02h,Stop Loss,$12.00,$264.00,$167778.50,295,$264.00
2025-02-20,19:48:00,22102.0,BUY,3,0.02h,Stop Loss,$40.50,$304.50,$167819.00,295,$304.50
2025-02-20,20:13:00,22103.25,SELL,3,0.02h,Break Even,$-1.50,$303.00,$167817.50,295,$303.00
2025-02-20,20:23:00,22118.5,BUY,3,0.02h,Stop Loss,$-9.00,$294.00,$167808.50,295,$294.00
2025-02-20,20:28:00,22095.0,SELL,3,0.02h,Stop Loss,$-9.00,$285.00,$167799.50,295,$285.00
2025-02-20,20:44:00,22111.75,BUY,3,0.02h,Stop Loss,$25.50,$310.50,$167825.00,295,$310.50
2025-02-20,21:16:00,22127.5,SELL,3,0.02h,Stop Loss,$-9.00,$301.50,$167816.00,295,$301.50
2025-02-20,21:25:00,22135.0,BUY,3,0.02h,Stop Loss,$-9.00,$292.50,$167807.00,295,$292.50
2025-02-20,21:52:00,22134.0,SELL,3,0.02h,Break Even,$-1.50,$291.00,$167805.50,295,$291.00
,,,,,,,,,,,
2025-02-21,12:00:00,22165.0,BUY,3,0.02h,Stop Loss,$6.00,$6.00,$167811.50,296,$6.00
2025-02-21,13:07:00,22208.25,SELL,3,0.02h,Stop Loss,$-9.00,$-3.00,$167802.50,296,$-3.00
2025-02-21,13:11:00,22216.75,BUY,3,0.02h,Stop Loss,$-9.00,$-12.00,$167793.50,296,$-12.00
2025-02-21,13:58:00,22225.75,SELL,3,0.02h,Break Even,$-1.50,$-13.50,$167792.00,296,$-13.50
2025-02-21,14:19:00,22229.0,BUY,3,0.02h,Stop Loss,$-9.00,$-22.50,$167783.00,296,$-22.50
2025-02-21,14:21:00,22224.75,SELL,3,0.02h,Stop Loss,$-9.00,$-31.50,$167774.00,296,$-31.50
2025-02-21,14:22:00,22226.25,BUY,3,0.02h,Stop Loss,$-9.00,$-40.50,$167765.00,296,$-40.50
2025-02-21,14:23:00,22223.5,SELL,3,0.02h,Stop Loss,$22.50,$-18.00,$167787.50,296,$-18.00
2025-02-21,16:01:00,22015.25,BUY,3,0.02h,Stop Loss,$15.00,$-3.00,$167802.50,296,$-3.00
2025-02-21,16:07:00,21980.75,SELL,3,0.02h,Stop Loss,$31.50,$28.50,$167834.00,296,$28.50
2025-02-21,16:15:00,22015.25,BUY,3,0.02h,Stop Loss,$9.00,$37.50,$167843.00,296,$37.50
2025-02-21,16:30:00,21992.75,SELL,3,0.02h,Stop Loss,$58.50,$96.00,$167901.50,296,$96.00
2025-02-21,16:34:00,22015.0,BUY,3,0.02h,Stop Loss,$25.50,$121.50,$167927.00,296,$121.50
2025-02-21,16:44:00,21990.5,SELL,3,0.02h,Stop Loss,$10.50,$132.00,$167937.50,296,$132.00
2025-02-21,17:06:00,21991.5,BUY,3,0.02h,Break Even,$-1.50,$130.50,$167936.00,296,$130.50
2025-02-21,17:09:00,21978.25,SELL,3,0.02h,Stop Loss,$63.00,$193.50,$167999.00,296,$193.50
2025-02-21,18:39:00,21832.25,BUY,3,0.02h,Stop Loss,$-9.00,$184.50,$167990.00,296,$184.50
2025-02-21,18:42:00,21794.25,SELL,3,0.02h,Stop Loss,$-9.00,$175.50,$167981.00,296,$175.50
2025-02-21,19:54:00,21706.5,BUY,3,0.02h,Stop Loss,$-9.00,$166.50,$167972.00,296,$166.50
2025-02-21,19:55:00,21690.25,SELL,3,0.02h,Stop Loss,$-9.00,$157.50,$167963.00,296,$157.50
2025-02-21,19:56:00,21706.25,BUY,3,0.02h,Break Even,$-1.50,$156.00,$167961.50,296,$156.00
2025-02-21,19:59:00,21692.0,SELL,3,0.02h,Stop Loss,$37.50,$193.50,$167999.00,296,$193.50
2025-02-21,20:16:00,21699.0,BUY,3,0.02h,Break Even,$-1.50,$192.00,$167997.50,296,$192.00
2025-02-21,20:19:00,21691.0,SELL,3,0.02h,Stop Loss,$-9.00,$183.00,$167988.50,296,$183.00
2025-02-21,20:20:00,21699.25,BUY,3,0.02h,Break Even,$-1.50,$181.50,$167987.00,296,$181.50
2025-02-21,20:40:00,21696.5,SELL,3,0.02h,Stop Loss,$4.50,$186.00,$167991.50,296,$186.00
2025-02-21,20:56:00,21695.0,BUY,3,0.02h,Stop Loss,$-9.00,$177.00,$167982.50,296,$177.00
2025-02-21,20:57:00,21682.5,SELL,3,0.02h,Stop Loss,$24.00,$201.00,$168006.50,296,$201.00
2025-02-21,21:02:00,21688.5,BUY,3,0.02h,Stop Loss,$4.50,$205.50,$168011.00,296,$205.50
2025-02-21,21:05:00,21683.75,SELL,3,0.02h,Stop Loss,$9.00,$214.50,$168020.00,296,$214.50
2025-02-21,21:08:00,21690.75,BUY,3,0.02h,Break Even,$-1.50,$213.00,$168018.50,296,$213.00
2025-02-21,21:12:00,21683.0,SELL,3,0.02h,Stop Loss,$10.50,$223.50,$168029.00,296,$223.50
,,,,,,,,,,,
2025-02-24,12:00:00,21777.5,BUY,3,0.02h,Stop Loss,$-9.00,$-9.00,$168020.00,297,$-9.00
2025-02-24,12:47:00,21750.75,SELL,3,0.02h,Stop Loss,$21.00,$12.00,$168041.00,297,$12.00
2025-02-24,13:00:00,21763.25,BUY,3,0.02h,Break Even,$-1.50,$10.50,$168039.50,297,$10.50
2025-02-24,14:07:00,21774.5,SELL,3,0.02h,Stop Loss,$12.00,$22.50,$168051.50,297,$22.50
2025-02-24,16:03:00,21495.75,BUY,3,0.02h,Stop Loss,$72.00,$94.50,$168123.50,297,$94.50
2025-02-24,16:59:00,21572.25,SELL,3,0.02h,Break Even,$-1.50,$93.00,$168122.00,297,$93.00
2025-02-24,17:04:00,21606.25,BUY,3,0.02h,Stop Loss,$6.00,$99.00,$168128.00,297,$99.00
2025-02-24,17:55:00,21614.75,SELL,3,0.02h,Break Even,$-1.50,$97.50,$168126.50,297,$97.50
2025-02-24,18:15:00,21628.25,BUY,3,0.02h,Stop Loss,$18.00,$115.50,$168144.50,297,$115.50
2025-02-24,18:48:00,21630.5,SELL,3,0.02h,Stop Loss,$27.00,$142.50,$168171.50,297,$142.50
2025-02-24,20:16:00,21561.25,BUY,3,0.02h,Stop Loss,$10.50,$153.00,$168182.00,297,$153.00
2025-02-24,20:24:00,21542.25,SELL,3,0.02h,Stop Loss,$52.50,$205.50,$168234.50,297,$205.50
2025-02-24,20:38:00,21551.5,BUY,3,0.02h,Stop Loss,$-9.00,$196.50,$168225.50,297,$196.50
2025-02-24,20:39:00,21538.5,SELL,3,0.02h,Stop Loss,$39.00,$235.50,$168264.50,297,$235.50
2025-02-24,21:59:00,21428.25,BUY,3,0.02h,Stop Loss,$3.00,$238.50,$168267.50,297,$238.50
,,,,,,,,,,,
2025-02-25,12:00:00,21370.5,SELL,3,0.02h,Stop Loss,$22.50,$22.50,$168290.00,298,$22.50
2025-02-25,12:27:00,21397.75,BUY,3,0.02h,Stop Loss,$-9.00,$13.50,$168281.00,298,$13.50
2025-02-25,12:33:00,21378.25,SELL,3,0.02h,Break Even,$-1.50,$12.00,$168279.50,298,$12.00
2025-02-25,12:53:00,21390.25,BUY,3,0.02h,Stop Loss,$6.00,$18.00,$168285.50,298,$18.00
2025-02-25,13:38:00,21414.75,SELL,3,0.02h,Stop Loss,$13.50,$31.50,$168299.00,298,$31.50
2025-02-25,15:44:00,21115.75,BUY,3,0.02h,Break Even,$-1.50,$30.00,$168297.50,298,$30.00
2025-02-25,15:48:00,21088.5,SELL,3,0.02h,Stop Loss,$10.50,$40.50,$168308.00,298,$40.50
2025-02-25,15:50:00,21112.0,BUY,3,0.02h,Stop Loss,$45.00,$85.50,$168353.00,298,$85.50
2025-02-25,16:02:00,21084.0,SELL,3,0.02h,Stop Loss,$106.50,$192.00,$168459.50,298,$192.00
2025-02-25,16:43:00,21057.75,BUY,3,0.02h,Stop Loss,$-9.00,$183.00,$168450.50,298,$183.00
2025-02-25,17:22:00,21120.0,SELL,3,0.02h,Stop Loss,$39.00,$222.00,$168489.50,298,$222.00
2025-02-25,17:27:00,21154.0,BUY,3,0.02h,Stop Loss,$55.50,$277.50,$168545.00,298,$277.50
2025-02-25,18:18:00,21226.0,SELL,3,0.02h,Stop Loss,$81.00,$358.50,$168626.00,298,$358.50
2025-02-25,18:40:00,21243.0,BUY,3,0.02h,Stop Loss,$7.50,$366.00,$168633.50,298,$366.00
2025-02-25,18:56:00,21204.25,SELL,3,0.02h,Break Even,$-1.50,$364.50,$168632.00,298,$364.50
2025-02-25,19:38:00,21173.25,BUY,3,0.02h,Stop Loss,$88.50,$453.00,$168720.50,298,$453.00
2025-02-25,20:13:00,21198.75,SELL,3,0.02h,Stop Loss,$18.00,$471.00,$168738.50,298,$471.00
2025-02-25,20:15:00,21203.5,BUY,3,0.02h,Stop Loss,$21.00,$492.00,$168759.50,298,$492.00
2025-02-25,20:18:00,21196.0,SELL,3,0.02h,Break Even,$-1.50,$490.50,$168758.00,298,$490.50
2025-02-25,20:19:00,21208.75,BUY,3,0.02h,Stop Loss,$108.00,$598.50,$168866.00,298,$598.50
2025-02-25,20:36:00,21211.25,SELL,3,0.02h,Stop Loss,$136.50,$735.00,$169002.50,298,$735.00
2025-02-25,21:05:00,21187.75,BUY,3,0.02h,Stop Loss,$72.00,$807.00,$169074.50,298,$807.00
2025-02-25,21:39:00,21189.0,SELL,3,0.02h,Break Even,$-1.50,$805.50,$169073.00,298,$805.50
2025-02-25,21:46:00,21205.0,BUY,3,0.02h,Break Even,$-1.50,$804.00,$169071.50,298,$804.00
2025-02-25,21:58:00,21191.0,SELL,3,0.02h,Break Even,$-1.50,$802.50,$169070.00,298,$802.50
,,,,,,,,,,,
2025-02-26,12:00:00,21288.0,BUY,3,0.02h,Stop Loss,$13.50,$13.50,$169083.50,299,$13.50
2025-02-26,12:47:00,21294.5,SELL,3,0.02h,Stop Loss,$6.00,$19.50,$169089.50,299,$19.50
2025-02-26,13:14:00,21292.0,BUY,3,0.02h,Stop Loss,$21.00,$40.50,$169110.50,299,$40.50
2025-02-26,13:44:00,21306.75,SELL,3,0.02h,Break Even,$-1.50,$39.00,$169109.00,299,$39.00
2025-02-26,14:40:00,21265.0,BUY,3,0.02h,Stop Loss,$9.00,$48.00,$169118.00,299,$48.00
2025-02-26,14:43:00,21212.5,SELL,3,0.02h,Stop Loss,$79.50,$127.50,$169197.50,299,$127.50
2025-02-26,14:48:00,21256.75,BUY,3,0.02h,Stop Loss,$70.50,$198.00,$169268.00,299,$198.00
2025-02-26,15:30:00,21282.75,SELL,3,0.02h,Stop Loss,$-9.00,$189.00,$169259.00,299,$189.00
2025-02-26,15:38:00,21345.25,BUY,3,0.02h,Stop Loss,$10.50,$199.50,$169269.50,299,$199.50
2025-02-26,16:28:00,21362.0,SELL,3,0.02h,Break Even,$-1.50,$198.00,$169268.00,299,$198.00
2025-02-26,16:38:00,21389.75,BUY,3,0.02h,Stop Loss,$34.50,$232.50,$169302.50,299,$232.50
2025-02-26,16:59:00,21357.75,SELL,3,0.02h,Stop Loss,$91.50,$324.00,$169394.00,299,$324.00
2025-02-26,17:08:00,21391.25,BUY,3,0.02h,Stop Loss,$37.50,$361.50,$169431.50,299,$361.50
2025-02-26,17:23:00,21366.25,SELL,3,0.02h,Stop Loss,$3.00,$364.50,$169434.50,299,$364.50
2025-02-26,19:21:00,21130.0,BUY,3,0.02h,Break Even,$-1.50,$363.00,$169433.00,299,$363.00
2025-02-26,19:56:00,21139.0,SELL,3,0.02h,Stop Loss,$30.00,$393.00,$169463.00,299,$393.00
2025-02-26,20:14:00,21130.0,BUY,3,0.02h,Stop Loss,$-9.00,$384.00,$169454.00,299,$384.00
2025-02-26,20:15:00,21115.75,SELL,3,0.02h,Stop Loss,$27.00,$411.00,$169481.00,299,$411.00
2025-02-26,20:20:00,21131.75,BUY,3,0.02h,Break Even,$-1.50,$409.50,$169479.50,299,$409.50
2025-02-26,21:30:00,21205.0,SELL,3,0.02h,Stop Loss,$48.00,$457.50,$169527.50,299,$457.50
2025-02-26,21:42:00,21224.25,BUY,3,0.02h,Stop Loss,$-9.00,$448.50,$169518.50,299,$448.50
,,,,,,,,,,,
2025-02-27,12:53:00,21356.75,SELL,3,0.02h,Stop Loss,$3.00,$3.00,$169521.50,300,$3.00
2025-02-27,13:18:00,21365.0,BUY,3,0.02h,Stop Loss,$4.50,$7.50,$169526.00,300,$7.50
2025-02-27,13:26:00,21352.0,SELL,3,0.02h,Stop Loss,$4.50,$12.00,$169530.50,300,$12.00
2025-02-27,13:42:00,21363.25,BUY,3,0.02h,Stop Loss,$3.00,$15.00,$169533.50,300,$15.00
2025-02-27,13:47:00,21316.0,SELL,3,0.02h,Stop Loss,$166.50,$181.50,$169700.00,300,$181.50
2025-02-27,14:04:00,21344.75,BUY,3,0.02h,Break Even,$-1.50,$180.00,$169698.50,300,$180.00
2025-02-27,14:30:00,21340.5,SELL,3,0.02h,Stop Loss,$79.50,$259.50,$169778.00,300,$259.50
2025-02-27,14:31:00,21352.25,BUY,3,0.02h,Break Even,$-1.50,$258.00,$169776.50,300,$258.00
2025-02-27,14:32:00,21329.75,SELL,3,0.02h,Stop Loss,$-9.00,$249.00,$169767.50,300,$249.00
2025-02-27,14:34:00,21354.0,BUY,3,0.02h,Stop Loss,$18.00,$267.00,$169785.50,300,$267.00
2025-02-27,14:40:00,21308.25,SELL,3,0.02h,Stop Loss,$196.50,$463.50,$169982.00,300,$463.50
2025-02-27,15:18:00,21069.75,BUY,3,0.02h,Stop Loss,$165.00,$628.50,$170147.00,300,$628.50
2025-02-27,15:35:00,21067.5,SELL,3,0.02h,Stop Loss,$109.50,$738.00,$170256.50,300,$738.00
2025-02-27,15:40:00,21113.5,BUY,3,0.02h,Stop Loss,$7.50,$745.50,$170264.00,300,$745.50
2025-02-27,15:53:00,21058.0,SELL,3,0.02h,Stop Loss,$60.00,$805.50,$170324.00,300,$805.50
2025-02-27,16:12:00,21082.5,BUY,3,0.02h,Stop Loss,$66.00,$871.50,$170390.00,300,$871.50
2025-02-27,16:30:00,21065.0,SELL,3,0.02h,Stop Loss,$30.00,$901.50,$170420.00,300,$901.50
2025-02-27,17:28:00,21039.25,BUY,3,0.02h,Stop Loss,$31.50,$933.00,$170451.50,300,$933.00
2025-02-27,17:44:00,21001.25,SELL,3,0.02h,Stop Loss,$13.50,$946.50,$170465.00,300,$946.50
2025-02-27,18:00:00,21038.25,BUY,3,0.02h,Stop Loss,$103.50,$1050.00,$170568.50,300,$1050.00
2025-02-27,18:44:00,21075.75,SELL,3,0.02h,Break Even,$-1.50,$1048.50,$170567.00,300,$1048.50
2025-02-27,21:20:00,20634.5,BUY,3,0.02h,Break Even,$-1.50,$1047.00,$170565.50,300,$1047.00
2025-02-27,21:54:00,20633.75,SELL,3,0.02h,Stop Loss,$19.50,$1066.50,$170585.00,300,$1066.50
,,,,,,,,,,,
2025-02-28,12:01:00,20651.5,BUY,3,0.02h,Break Even,$-1.50,$-1.50,$170583.50,301,$-1.50
2025-02-28,12:03:00,20632.25,SELL,3,0.02h,Stop Loss,$51.00,$49.50,$170634.50,301,$49.50
2025-02-28,12:22:00,20632.0,BUY,3,0.02h,Stop Loss,$19.50,$69.00,$170654.00,301,$69.00
2025-02-28,12:32:00,20603.25,SELL,3,0.02h,Stop Loss,$-9.00,$60.00,$170645.00,301,$60.00
2025-02-28,12:51:00,20622.0,BUY,3,0.02h,Break Even,$-1.50,$58.50,$170643.50,301,$58.50
2025-02-28,13:11:00,20611.25,SELL,3,0.02h,Stop Loss,$57.00,$115.50,$170700.50,301,$115.50
2025-02-28,13:32:00,20659.75,BUY,3,0.02h,Break Even,$-1.50,$114.00,$170699.00,301,$114.00
2025-02-28,13:53:00,20609.5,SELL,3,0.02h,Stop Loss,$12.00,$126.00,$170711.00,301,$126.00
2025-02-28,14:10:00,20620.5,BUY,3,0.02h,Break Even,$-1.50,$124.50,$170709.50,301,$124.50
2025-02-28,14:12:00,20604.0,SELL,3,0.02h,Stop Loss,$12.00,$136.50,$170721.50,301,$136.50
2025-02-28,14:17:00,20615.0,BUY,3,0.02h,Stop Loss,$-9.00,$127.50,$170712.50,301,$127.50
2025-02-28,14:18:00,20611.5,SELL,3,0.02h,Stop Loss,$-9.00,$118.50,$170703.50,301,$118.50
2025-02-28,14:19:00,20620.25,BUY,3,0.02h,Stop Loss,$30.00,$148.50,$170733.50,301,$148.50
2025-02-28,14:22:00,20603.5,SELL,3,0.02h,Stop Loss,$24.00,$172.50,$170757.50,301,$172.50
2025-02-28,14:44:00,20628.25,BUY,3,0.02h,Break Even,$-1.50,$171.00,$170756.00,301,$171.00
2025-02-28,14:57:00,20550.25,SELL,3,0.02h,Stop Loss,$33.00,$204.00,$170789.00,301,$204.00
2025-02-28,15:01:00,20623.0,BUY,3,0.02h,Stop Loss,$46.50,$250.50,$170835.50,301,$250.50
2025-02-28,15:44:00,20680.25,SELL,3,0.02h,Break Even,$-1.50,$249.00,$170834.00,301,$249.00
2025-02-28,15:47:00,20735.75,BUY,3,0.02h,Stop Loss,$-9.00,$240.00,$170825.00,301,$240.00
2025-02-28,15:49:00,20693.25,SELL,3,0.02h,Stop Loss,$43.50,$283.50,$170868.50,301,$283.50
2025-02-28,15:52:00,20730.75,BUY,3,0.02h,Stop Loss,$36.00,$319.50,$170904.50,301,$319.50
2025-02-28,16:13:00,20702.0,SELL,3,0.02h,Stop Loss,$37.50,$357.00,$170942.00,301,$357.00
2025-02-28,16:38:00,20705.5,BUY,3,0.02h,Stop Loss,$57.00,$414.00,$170999.00,301,$414.00
2025-02-28,16:59:00,20708.5,SELL,3,0.02h,Stop Loss,$96.00,$510.00,$171095.00,301,$510.00
2025-02-28,17:15:00,20712.75,BUY,3,0.02h,Stop Loss,$-9.00,$501.00,$171086.00,301,$501.00
2025-02-28,17:26:00,20695.0,SELL,3,0.02h,Stop Loss,$-9.00,$492.00,$171077.00,301,$492.00
2025-02-28,18:30:00,20593.0,BUY,3,0.02h,Stop Loss,$163.50,$655.50,$171240.50,301,$655.50
2025-02-28,18:57:00,20574.5,SELL,3,0.02h,Stop Loss,$42.00,$697.50,$171282.50,301,$697.50
2025-02-28,19:20:00,20613.25,BUY,3,0.02h,Break Even,$-1.50,$696.00,$171281.00,301,$696.00
2025-02-28,20:22:00,20705.25,SELL,3,0.02h,Stop Loss,$79.50,$775.50,$171360.50,301,$775.50
2025-02-28,20:28:00,20749.5,BUY,3,0.02h,Stop Loss,$84.00,$859.50,$171444.50,301,$859.50
2025-02-28,20:36:00,20689.75,SELL,3,0.02h,Stop Loss,$-9.00,$850.50,$171435.50,301,$850.50
2025-02-28,20:41:00,20756.5,BUY,3,0.02h,Stop Loss,$16.50,$867.00,$171452.00,301,$867.00
,,,,,,,,,,,
2025-03-03,12:39:00,21069.25,SELL,3,0.02h,Stop Loss,$-9.00,$-9.00,$171443.00,302,$-9.00
2025-03-03,12:46:00,21079.5,BUY,3,0.02h,Stop Loss,$-9.00,$-18.00,$171434.00,302,$-18.00
2025-03-03,12:55:00,21068.25,SELL,3,0.02h,Stop Loss,$36.00,$18.00,$171470.00,302,$18.00
2025-03-03,13:25:00,21074.0,BUY,3,0.02h,Stop Loss,$7.50,$25.50,$171477.50,302,$25.50
2025-03-03,13:36:00,21052.75,SELL,3,0.02h,Break Even,$-1.50,$24.00,$171476.00,302,$24.00
2025-03-03,13:54:00,21061.75,BUY,3,0.02h,Stop Loss,$13.50,$37.50,$171489.50,302,$37.50
2025-03-03,14:26:00,21061.75,SELL,3,0.02h,Break Even,$-1.50,$36.00,$171488.00,302,$36.00
2025-03-03,14:35:00,21088.0,BUY,3,0.02h,Stop Loss,$60.00,$96.00,$171548.00,302,$96.00
2025-03-03,14:38:00,21037.75,SELL,3,0.02h,Stop Loss,$301.50,$397.50,$171849.50,302,$397.50
2025-03-03,15:24:00,20909.5,BUY,3,0.02h,Stop Loss,$45.00,$442.50,$171894.50,302,$442.50
2025-03-03,15:51:00,20906.25,SELL,3,0.02h,Break Even,$-1.50,$441.00,$171893.00,302,$441.00
2025-03-03,15:54:00,20938.75,BUY,3,0.02h,Stop Loss,$6.00,$447.00,$171899.00,302,$447.00
2025-03-03,15:56:00,20910.0,SELL,3,0.02h,Stop Loss,$85.50,$532.50,$171984.50,302,$532.50
2025-03-03,16:15:00,20913.0,BUY,3,0.02h,Stop Loss,$25.50,$558.00,$172010.00,302,$558.00
2025-03-03,16:16:00,20892.75,SELL,3,0.02h,Break Even,$-1.50,$556.50,$172008.50,302,$556.50
2025-03-03,16:17:00,20916.0,BUY,3,0.02h,Stop Loss,$111.00,$667.50,$172119.50,302,$667.50
2025-03-03,16:30:00,20886.5,SELL,3,0.02h,Stop Loss,$24.00,$691.50,$172143.50,302,$691.50
2025-03-03,16:51:00,20928.75,BUY,3,0.02h,Break Even,$-1.50,$690.00,$172142.00,302,$690.00
2025-03-03,17:37:00,20919.5,SELL,3,0.02h,Stop Loss,$58.50,$748.50,$172200.50,302,$748.50
2025-03-03,17:42:00,20944.25,BUY,3,0.02h,Stop Loss,$105.00,$853.50,$172305.50,302,$853.50
2025-03-03,17:47:00,20905.75,SELL,3,0.02h,Stop Loss,$123.00,$976.50,$172428.50,302,$976.50
2025-03-03,18:51:00,20734.5,BUY,3,0.02h,Stop Loss,$25.50,$1002.00,$172454.00,302,$1002.00
2025-03-03,19:18:00,20724.0,SELL,3,0.02h,Stop Loss,$109.50,$1111.50,$172563.50,302,$1111.50
2025-03-03,19:33:00,20757.75,BUY,3,0.02h,Stop Loss,$94.50,$1206.00,$172658.00,302,$1206.00
2025-03-03,19:50:00,20721.75,SELL,3,0.02h,Break Even,$-1.50,$1204.50,$172656.50,302,$1204.50
2025-03-03,20:53:00,20418.75,BUY,3,0.02h,Stop Loss,$15.00,$1219.50,$172671.50,302,$1219.50
2025-03-03,21:55:00,20520.25,SELL,3,0.02h,Break Even,$-1.50,$1218.00,$172670.00,302,$1218.00
2025-03-03,21:59:00,20527.0,BUY,3,0.02h,Stop Loss,$7.50,$1225.50,$172677.50,302,$1225.50
,,,,,,,,,,,
2025-03-04,12:00:00,20475.25,SELL,3,0.02h,Stop Loss,$79.50,$79.50,$172757.00,303,$79.50
2025-03-04,13:36:00,20327.25,BUY,3,0.02h,Stop Loss,$60.00,$139.50,$172817.00,303,$139.50
2025-03-04,14:00:00,20325.0,SELL,3,0.02h,Stop Loss,$6.00,$145.50,$172823.00,303,$145.50
2025-03-04,14:01:00,20337.0,BUY,3,0.02h,Stop Loss,$33.00,$178.50,$172856.00,303,$178.50
2025-03-04,14:21:00,20343.0,SELL,3,0.02h,Stop Loss,$34.50,$213.00,$172890.50,303,$213.00
2025-03-04,14:38:00,20399.5,BUY,3,0.02h,Stop Loss,$162.00,$375.00,$173052.50,303,$375.00
2025-03-04,14:43:00,20278.25,SELL,3,0.02h,Stop Loss,$79.50,$454.50,$173132.00,303,$454.50
2025-03-04,14:48:00,20370.5,BUY,3,0.02h,Stop Loss,$231.00,$685.50,$173363.00,303,$685.50
2025-03-04,14:51:00,20305.25,SELL,3,0.02h,Stop Loss,$181.50,$867.00,$173544.50,303,$867.00
2025-03-04,15:33:00,20211.25,BUY,3,0.02h,Stop Loss,$171.00,$1038.00,$173715.50,303,$1038.00
2025-03-04,15:55:00,20175.0,SELL,3,0.02h,Stop Loss,$87.00,$1125.00,$173802.50,303,$1125.00
2025-03-04,16:16:00,20220.75,BUY,3,0.02h,Stop Loss,$37.50,$1162.50,$173840.00,303,$1162.50
2025-03-04,16:22:00,20176.0,SELL,3,0.02h,Stop Loss,$51.00,$1213.50,$173891.00,303,$1213.50
2025-03-04,16:23:00,20186.0,BUY,3,0.02h,Stop Loss,$-9.00,$1204.50,$173882.00,303,$1204.50
2025-03-04,16:24:00,20148.25,SELL,3,0.02h,Stop Loss,$-9.00,$1195.50,$173873.00,303,$1195.50
2025-03-04,16:34:00,20186.0,BUY,3,0.02h,Stop Loss,$45.00,$1240.50,$173918.00,303,$1240.50
2025-03-04,17:53:00,20322.0,SELL,3,0.02h,Stop Loss,$3.00,$1243.50,$173921.00,303,$1243.50
2025-03-04,18:09:00,20407.25,BUY,3,0.02h,Stop Loss,$100.50,$1344.00,$174021.50,303,$1344.00
2025-03-04,18:27:00,20390.5,SELL,3,0.02h,Stop Loss,$31.50,$1375.50,$174053.00,303,$1375.50
2025-03-04,18:38:00,20420.0,BUY,3,0.02h,Stop Loss,$25.50,$1401.00,$174078.50,303,$1401.00
2025-03-04,19:35:00,20549.5,SELL,3,0.02h,Stop Loss,$3.00,$1404.00,$174081.50,303,$1404.00
2025-03-04,19:38:00,20583.0,BUY,3,0.02h,Stop Loss,$13.50,$1417.50,$174095.00,303,$1417.50
2025-03-04,20:32:00,20610.5,SELL,3,0.02h,Stop Loss,$159.00,$1576.50,$174254.00,303,$1576.50
2025-03-04,21:11:00,20453.0,BUY,3,0.02h,Stop Loss,$168.00,$1744.50,$174422.00,303,$1744.50
2025-03-04,21:41:00,20494.5,SELL,3,0.02h,Stop Loss,$19.50,$1764.00,$174441.50,303,$1764.00
2025-03-04,21:48:00,20535.0,BUY,3,0.02h,Break Even,$-1.50,$1762.50,$174440.00,303,$1762.50
,,,,,,,,,,,
2025-03-05,12:00:00,20492.5,SELL,3,0.02h,Stop Loss,$12.00,$12.00,$174452.00,304,$12.00
2025-03-05,12:33:00,20502.0,BUY,3,0.02h,Stop Loss,$18.00,$30.00,$174470.00,304,$30.00
2025-03-05,12:48:00,20488.0,SELL,3,0.02h,Stop Loss,$6.00,$36.00,$174476.00,304,$36.00
2025-03-05,13:12:00,20507.75,BUY,3,0.02h,Break Even,$-1.50,$34.50,$174474.50,304,$34.50
2025-03-05,13:15:00,20485.5,SELL,3,0.02h,Stop Loss,$306.00,$340.50,$174780.50,304,$340.50
2025-03-05,14:15:00,20440.5,BUY,3,0.02h,Stop Loss,$129.00,$469.50,$174909.50,304,$469.50
2025-03-05,14:32:00,20418.0,SELL,3,0.02h,Stop Loss,$154.50,$624.00,$175064.00,304,$624.00
2025-03-05,14:44:00,20443.5,BUY,3,0.02h,Break Even,$-1.50,$622.50,$175062.50,304,$622.50
2025-03-05,14:48:00,20376.25,SELL,3,0.02h,Stop Loss,$106.50,$729.00,$175169.00,304,$729.00
2025-03-05,15:03:00,20421.0,BUY,3,0.02h,Stop Loss,$126.00,$855.00,$175295.00,304,$855.00
2025-03-05,15:19:00,20384.0,SELL,3,0.02h,Stop Loss,$112.50,$967.50,$175407.50,304,$967.50
2025-03-05,15:38:00,20388.5,BUY,3,0.02h,Stop Loss,$175.50,$1143.00,$175583.00,304,$1143.00
2025-03-05,15:52:00,20359.5,SELL,3,0.02h,Stop Loss,$46.50,$1189.50,$175629.50,304,$1189.50
2025-03-05,15:54:00,20401.5,BUY,3,0.02h,Stop Loss,$90.00,$1279.50,$175719.50,304,$1279.50
2025-03-05,16:02:00,20354.75,SELL,3,0.02h,Stop Loss,$42.00,$1321.50,$175761.50,304,$1321.50
2025-03-05,16:57:00,20274.5,BUY,3,0.02h,Stop Loss,$336.00,$1657.50,$176097.50,304,$1657.50
2025-03-05,18:10:00,20469.25,SELL,3,0.02h,Stop Loss,$24.00,$1681.50,$176121.50,304,$1681.50
2025-03-05,18:48:00,20522.0,BUY,3,0.02h,Stop Loss,$157.50,$1839.00,$176279.00,304,$1839.00
2025-03-05,19:37:00,20649.75,SELL,3,0.02h,Stop Loss,$183.00,$2022.00,$176462.00,304,$2022.00
2025-03-05,19:50:00,20668.5,BUY,3,0.02h,Stop Loss,$66.00,$2088.00,$176528.00,304,$2088.00
2025-03-05,20:18:00,20623.5,SELL,3,0.02h,Break Even,$-1.50,$2086.50,$176526.50,304,$2086.50
2025-03-05,20:30:00,20690.0,BUY,3,0.02h,Break Even,$-1.50,$2085.00,$176525.00,304,$2085.00
2025-03-05,20:31:00,20660.0,SELL,3,0.02h,Stop Loss,$25.50,$2110.50,$176550.50,304,$2110.50
2025-03-05,20:42:00,20683.25,BUY,3,0.02h,Stop Loss,$31.50,$2142.00,$176582.00,304,$2142.00
2025-03-05,20:48:00,20662.75,SELL,3,0.02h,Stop Loss,$39.00,$2181.00,$176621.00,304,$2181.00
2025-03-05,20:55:00,20690.0,BUY,3,0.02h,Stop Loss,$-9.00,$2172.00,$176612.00,304,$2172.00
2025-03-05,21:00:00,20659.5,SELL,3,0.02h,Stop Loss,$49.50,$2221.50,$176661.50,304,$2221.50
2025-03-05,21:59:00,20616.75,BUY,3,0.02h,Break Even,$-1.50,$2220.00,$176660.00,304,$2220.00
,,,,,,,,,,,
2025-03-06,12:00:00,20424.5,SELL,3,0.02h,Stop Loss,$21.00,$21.00,$176681.00,305,$21.00
2025-03-06,12:57:00,20387.5,BUY,3,0.02h,Stop Loss,$-9.00,$12.00,$176672.00,305,$12.00
2025-03-06,13:00:00,20370.75,SELL,3,0.02h,Stop Loss,$18.00,$30.00,$176690.00,305,$30.00
2025-03-06,13:34:00,20356.0,BUY,3,0.02h,Stop Loss,$28.50,$58.50,$176718.50,305,$58.50
2025-03-06,13:48:00,20334.75,SELL,3,0.02h,Stop Loss,$3.00,$61.50,$176721.50,305,$61.50
2025-03-06,14:07:00,20351.25,BUY,3,0.02h,Stop Loss,$-9.00,$52.50,$176712.50,305,$52.50
2025-03-06,14:23:00,20331.75,SELL,3,0.02h,Stop Loss,$33.00,$85.50,$176745.50,305,$85.50
2025-03-06,14:52:00,20324.5,BUY,3,0.02h,Stop Loss,$36.00,$121.50,$176781.50,305,$121.50
2025-03-06,14:59:00,20281.0,SELL,3,0.02h,Stop Loss,$6.00,$127.50,$176787.50,305,$127.50
2025-03-06,15:02:00,20304.0,BUY,3,0.02h,Stop Loss,$61.50,$189.00,$176849.00,305,$189.00
2025-03-06,15:53:00,20442.25,SELL,3,0.02h,Stop Loss,$7.50,$196.50,$176856.50,305,$196.50
2025-03-06,16:04:00,20472.5,BUY,3,0.02h,Stop Loss,$6.00,$202.50,$176862.50,305,$202.50
2025-03-06,16:08:00,20434.0,SELL,3,0.02h,Break Even,$-1.50,$201.00,$176861.00,305,$201.00
2025-03-06,16:09:00,20462.0,BUY,3,0.02h,Stop Loss,$150.00,$351.00,$177011.00,305,$351.00
2025-03-06,16:21:00,20425.0,SELL,3,0.02h,Stop Loss,$154.50,$505.50,$177165.50,305,$505.50
2025-03-06,17:59:00,20187.0,BUY,3,0.02h,Stop Loss,$18.00,$523.50,$177183.50,305,$523.50
2025-03-06,18:11:00,20127.0,SELL,3,0.02h,Break Even,$-1.50,$522.00,$177182.00,305,$522.00
2025-03-06,18:13:00,20163.5,BUY,3,0.02h,Break Even,$-1.50,$520.50,$177180.50,305,$520.50
2025-03-06,18:30:00,20135.75,SELL,3,0.02h,Stop Loss,$76.50,$597.00,$177257.00,305,$597.00
2025-03-06,18:54:00,20135.25,BUY,3,0.02h,Break Even,$-1.50,$595.50,$177255.50,305,$595.50
2025-03-06,19:02:00,20088.0,SELL,3,0.02h,Stop Loss,$127.50,$723.00,$177383.00,305,$723.00
2025-03-06,19:43:00,20077.5,BUY,3,0.02h,Stop Loss,$-9.00,$714.00,$177374.00,305,$714.00
2025-03-06,20:01:00,20065.0,SELL,3,0.02h,Stop Loss,$33.00,$747.00,$177407.00,305,$747.00
2025-03-06,20:11:00,20118.25,BUY,3,0.02h,Stop Loss,$63.00,$810.00,$177470.00,305,$810.00
2025-03-06,20:23:00,20081.0,SELL,3,0.02h,Stop Loss,$138.00,$948.00,$177608.00,305,$948.00
2025-03-06,20:32:00,20119.5,BUY,3,0.02h,Stop Loss,$81.00,$1029.00,$177689.00,305,$1029.00
2025-03-06,20:41:00,20090.0,SELL,3,0.02h,Stop Loss,$136.50,$1165.50,$177825.50,305,$1165.50
2025-03-06,20:54:00,20092.5,BUY,3,0.02h,Stop Loss,$117.00,$1282.50,$177942.50,305,$1282.50
2025-03-06,21:41:00,20163.75,SELL,3,0.02h,Stop Loss,$-9.00,$1273.50,$177933.50,305,$1273.50
2025-03-06,21:47:00,20185.25,BUY,3,0.02h,Stop Loss,$12.00,$1285.50,$177945.50,305,$1285.50
,,,,,,,,,,,
2025-03-07,12:01:00,20169.5,SELL,3,0.02h,Stop Loss,$18.00,$18.00,$177963.50,306,$18.00
2025-03-07,12:59:00,20130.0,BUY,3,0.02h,Stop Loss,$-9.00,$9.00,$177954.50,306,$9.00
2025-03-07,13:05:00,20116.5,SELL,3,0.02h,Stop Loss,$27.00,$36.00,$177981.50,306,$36.00
2025-03-07,13:06:00,20123.5,BUY,3,0.02h,Stop Loss,$31.50,$67.50,$178013.00,306,$67.50
2025-03-07,13:13:00,20106.0,SELL,3,0.02h,Stop Loss,$24.00,$91.50,$178037.00,306,$91.50
2025-03-07,13:31:00,20217.5,BUY,3,0.02h,Stop Loss,$298.50,$390.00,$178335.50,306,$390.00
2025-03-07,13:49:00,20152.75,SELL,3,0.02h,Stop Loss,$132.00,$522.00,$178467.50,306,$522.00
2025-03-07,14:35:00,20101.25,BUY,3,0.02h,Stop Loss,$130.50,$652.50,$178598.00,306,$652.50
2025-03-07,14:38:00,20048.75,SELL,3,0.02h,Stop Loss,$12.00,$664.50,$178610.00,306,$664.50
2025-03-07,14:39:00,20098.25,BUY,3,0.02h,Stop Loss,$55.50,$720.00,$178665.50,306,$720.00
2025-03-07,15:02:00,20129.25,SELL,3,0.02h,Stop Loss,$30.00,$750.00,$178695.50,306,$750.00
2025-03-07,15:07:00,20159.5,BUY,3,0.02h,Stop Loss,$124.50,$874.50,$178820.00,306,$874.50
2025-03-07,15:14:00,20118.5,SELL,3,0.02h,Stop Loss,$42.00,$916.50,$178862.00,306,$916.50
2025-03-07,15:52:00,19993.0,BUY,3,0.02h,Stop Loss,$175.50,$1092.00,$179037.50,306,$1092.00
2025-03-07,16:05:00,19986.0,SELL,3,0.02h,Stop Loss,$34.50,$1126.50,$179072.00,306,$1126.50
2025-03-07,16:08:00,20010.25,BUY,3,0.02h,Break Even,$-1.50,$1125.00,$179070.50,306,$1125.00
2025-03-07,16:11:00,19980.75,SELL,3,0.02h,Stop Loss,$48.00,$1173.00,$179118.50,306,$1173.00
2025-03-07,17:02:00,19845.0,BUY,3,0.02h,Stop Loss,$102.00,$1275.00,$179220.50,306,$1275.00
2025-03-07,17:09:00,19808.75,SELL,3,0.02h,Stop Loss,$85.50,$1360.50,$179306.00,306,$1360.50
2025-03-07,17:25:00,19849.25,BUY,3,0.02h,Stop Loss,$76.50,$1437.00,$179382.50,306,$1437.00
2025-03-07,18:30:00,20053.75,SELL,3,0.02h,Stop Loss,$55.50,$1492.50,$179438.00,306,$1492.50
2025-03-07,18:33:00,20077.75,BUY,3,0.02h,Stop Loss,$52.50,$1545.00,$179490.50,306,$1545.00
2025-03-07,19:10:00,20122.5,SELL,3,0.02h,Stop Loss,$-9.00,$1536.00,$179481.50,306,$1536.00
2025-03-07,19:15:00,20168.5,BUY,3,0.02h,Stop Loss,$12.00,$1548.00,$179493.50,306,$1548.00
2025-03-07,19:45:00,20206.5,SELL,3,0.02h,Stop Loss,$208.50,$1756.50,$179702.00,306,$1756.50
2025-03-07,20:09:00,20235.75,BUY,3,0.02h,Stop Loss,$30.00,$1786.50,$179732.00,306,$1786.50
2025-03-07,20:24:00,20205.75,SELL,3,0.02h,Stop Loss,$54.00,$1840.50,$179786.00,306,$1840.50
2025-03-07,20:28:00,20224.25,BUY,3,0.02h,Break Even,$-1.50,$1839.00,$179784.50,306,$1839.00
2025-03-07,20:33:00,20195.5,SELL,3,0.02h,Stop Loss,$-9.00,$1830.00,$179775.50,306,$1830.00
2025-03-07,20:35:00,20230.0,BUY,3,0.02h,Break Even,$-1.50,$1828.50,$179774.00,306,$1828.50
2025-03-07,20:37:00,20194.25,SELL,3,0.02h,Stop Loss,$225.00,$2053.50,$179999.00,306,$2053.50
2025-03-07,20:50:00,20219.25,BUY,3,0.02h,Stop Loss,$-9.00,$2044.50,$179990.00,306,$2044.50
2025-03-07,21:04:00,20159.25,SELL,3,0.02h,Break Even,$-1.50,$2043.00,$179988.50,306,$2043.00
2025-03-07,21:15:00,20208.75,BUY,3,0.02h,Break Even,$-1.50,$2041.50,$179987.00,306,$2041.50
2025-03-07,21:43:00,20201.75,SELL,3,0.02h,Stop Loss,$-9.00,$2032.50,$179978.00,306,$2032.50
2025-03-07,21:50:00,20209.75,BUY,3,0.02h,Break Even,$-1.50,$2031.00,$179976.50,306,$2031.00
,,,,,,,,,,,
2025-03-10,12:00:00,19951.0,SELL,3,0.02h,Stop Loss,$48.00,$48.00,$180024.50,307,$48.00
2025-03-10,12:53:00,19903.75,BUY,3,0.02h,Break Even,$-1.50,$46.50,$180023.00,307,$46.50
2025-03-10,13:06:00,19888.5,SELL,3,0.02h,Stop Loss,$66.00,$112.50,$180089.00,307,$112.50
2025-03-10,13:11:00,19917.5,BUY,3,0.02h,Break Even,$-1.50,$111.00,$180087.50,307,$111.00
2025-03-10,13:22:00,19893.75,SELL,3,0.02h,Break Even,$-1.50,$109.50,$180086.00,307,$109.50
2025-03-10,13:46:00,19880.75,BUY,3,0.02h,Stop Loss,$87.00,$196.50,$180173.00,307,$196.50
2025-03-10,13:48:00,19850.5,SELL,3,0.02h,Stop Loss,$186.00,$382.50,$180359.00,307,$382.50
2025-03-10,15:11:00,19602.0,BUY,3,0.02h,Stop Loss,$6.00,$388.50,$180365.00,307,$388.50
2025-03-10,15:20:00,19569.5,SELL,3,0.02h,Stop Loss,$33.00,$421.50,$180398.00,307,$421.50
2025-03-10,15:24:00,19612.25,BUY,3,0.02h,Stop Loss,$112.50,$534.00,$180510.50,307,$534.00
2025-03-10,15:45:00,19604.25,SELL,3,0.02h,Break Even,$-1.50,$532.50,$180509.00,307,$532.50
2025-03-10,15:50:00,19650.75,BUY,3,0.02h,Stop Loss,$4.50,$537.00,$180513.50,307,$537.00
2025-03-10,15:51:00,19622.25,SELL,3,0.02h,Stop Loss,$-9.00,$528.00,$180504.50,307,$528.00
2025-03-10,16:32:00,19605.5,BUY,3,0.02h,Stop Loss,$34.50,$562.50,$180539.00,307,$562.50
2025-03-10,16:40:00,19538.25,SELL,3,0.02h,Break Even,$-1.50,$561.00,$180537.50,307,$561.00
2025-03-10,17:23:00,19547.5,BUY,3,0.02h,Stop Loss,$9.00,$570.00,$180546.50,307,$570.00
2025-03-10,17:31:00,19503.0,SELL,3,0.02h,Stop Loss,$111.00,$681.00,$180657.50,307,$681.00
2025-03-10,18:15:00,19452.5,BUY,3,0.02h,Stop Loss,$139.50,$820.50,$180797.00,307,$820.50
2025-03-10,18:26:00,19437.25,SELL,3,0.02h,Stop Loss,$129.00,$949.50,$180926.00,307,$949.50
2025-03-10,18:32:00,19467.0,BUY,3,0.02h,Break Even,$-1.50,$948.00,$180924.50,307,$948.00
2025-03-10,18:35:00,19442.0,SELL,3,0.02h,Stop Loss,$52.50,$1000.50,$180977.00,307,$1000.50
2025-03-10,19:18:00,19364.0,BUY,3,0.02h,Stop Loss,$48.00,$1048.50,$181025.00,307,$1048.50
2025-03-10,19:45:00,19393.75,SELL,3,0.02h,Stop Loss,$-9.00,$1039.50,$181016.00,307,$1039.50
2025-03-10,19:52:00,19458.5,BUY,3,0.02h,Stop Loss,$118.50,$1158.00,$181134.50,307,$1158.00
2025-03-10,19:54:00,19427.75,SELL,3,0.02h,Stop Loss,$159.00,$1317.00,$181293.50,307,$1317.00
2025-03-10,19:56:00,19470.25,BUY,3,0.02h,Stop Loss,$28.50,$1345.50,$181322.00,307,$1345.50
2025-03-10,20:38:00,19466.75,SELL,3,0.02h,Break Even,$-1.50,$1344.00,$181320.50,307,$1344.00
2025-03-10,20:46:00,19474.75,BUY,3,0.02h,Stop Loss,$10.50,$1354.50,$181331.00,307,$1354.50
2025-03-10,22:01:00,19440.0,SELL,3,0.02h,Stop Loss,$-9.00,$1345.50,$181322.00,307,$1345.50
2025-03-10,22:30:00,19418.0,BUY,3,0.02h,Stop Loss,$54.00,$1399.50,$181376.00,307,$1399.50
2025-03-10,22:50:00,19418.25,SELL,3,0.02h,Break Even,$-1.50,$1398.00,$181374.50,307,$1398.00
,,,,,,,,,,,
2025-03-11,12:00:00,19577.25,BUY,3,0.02h,Stop Loss,$18.00,$18.00,$181392.50,308,$18.00
2025-03-11,12:32:00,19484.0,SELL,3,0.02h,Stop Loss,$-9.00,$9.00,$181383.50,308,$9.00
2025-03-11,13:22:00,19461.5,BUY,3,0.02h,Break Even,$-1.50,$7.50,$181382.00,308,$7.50
2025-03-11,13:24:00,19450.5,SELL,3,0.02h,Stop Loss,$30.00,$37.50,$181412.00,308,$37.50
2025-03-11,13:38:00,19528.25,BUY,3,0.02h,Stop Loss,$4.50,$42.00,$181416.50,308,$42.00
2025-03-11,14:04:00,19423.5,SELL,3,0.02h,Stop Loss,$399.00,$441.00,$181815.50,308,$441.00
2025-03-11,14:54:00,19388.5,BUY,3,0.02h,Stop Loss,$159.00,$600.00,$181974.50,308,$600.00
2025-03-11,15:01:00,19316.25,SELL,3,0.02h,Stop Loss,$28.50,$628.50,$182003.00,308,$628.50
2025-03-11,15:07:00,19392.75,BUY,3,0.02h,Stop Loss,$334.50,$963.00,$182337.50,308,$963.00
2025-03-11,15:59:00,19440.5,SELL,3,0.02h,Stop Loss,$144.00,$1107.00,$182481.50,308,$1107.00
2025-03-11,16:28:00,19403.5,BUY,3,0.02h,Stop Loss,$34.50,$1141.50,$182516.00,308,$1141.50
2025-03-11,16:30:00,19385.75,SELL,3,0.02h,Stop Loss,$-9.00,$1132.50,$182507.00,308,$1132.50
2025-03-11,16:31:00,19401.25,BUY,3,0.02h,Stop Loss,$9.00,$1141.50,$182516.00,308,$1141.50
2025-03-11,16:40:00,19375.5,SELL,3,0.02h,Stop Loss,$138.00,$1279.50,$182654.00,308,$1279.50
2025-03-11,17:43:00,19276.75,BUY,3,0.02h,Break Even,$-1.50,$1278.00,$182652.50,308,$1278.00
2025-03-11,19:15:00,19577.75,SELL,3,0.02h,Stop Loss,$139.50,$1417.50,$182792.00,308,$1417.50
2025-03-11,20:49:00,19409.75,BUY,3,0.02h,Break Even,$-1.50,$1416.00,$182790.50,308,$1416.00
2025-03-11,20:52:00,19394.0,SELL,3,0.02h,Stop Loss,$39.00,$1455.00,$182829.50,308,$1455.00
2025-03-11,22:01:00,19422.25,BUY,3,0.02h,Stop Loss,$55.50,$1510.50,$182885.00,308,$1510.50
2025-03-11,22:28:00,19426.0,SELL,3,0.02h,Stop Loss,$-9.00,$1501.50,$182876.00,308,$1501.50
2025-03-11,22:30:00,19434.5,BUY,3,0.02h,Break Even,$-1.50,$1500.00,$182874.50,308,$1500.00
2025-03-11,22:36:00,19427.75,SELL,3,0.02h,Break Even,$-1.50,$1498.50,$182873.00,308,$1498.50
2025-03-11,22:37:00,19436.5,BUY,3,0.02h,Stop Loss,$12.00,$1510.50,$182885.00,308,$1510.50
,,,,,,,,,,,
2025-03-12,13:14:00,19681.25,SELL,3,0.02h,Stop Loss,$40.50,$40.50,$182925.50,309,$40.50
2025-03-12,13:31:00,19694.25,BUY,3,0.02h,Stop Loss,$223.50,$264.00,$183149.00,309,$264.00
2025-03-12,13:48:00,19689.75,SELL,3,0.02h,Stop Loss,$300.00,$564.00,$183449.00,309,$564.00
2025-03-12,14:08:00,19693.0,BUY,3,0.02h,Stop Loss,$73.50,$637.50,$183522.50,309,$637.50
2025-03-12,14:15:00,19641.75,SELL,3,0.02h,Stop Loss,$145.50,$783.00,$183668.00,309,$783.00
2025-03-12,15:24:00,19493.5,BUY,3,0.02h,Stop Loss,$147.00,$930.00,$183815.00,309,$930.00
2025-03-12,16:42:00,19638.0,SELL,3,0.02h,Stop Loss,$127.50,$1057.50,$183942.50,309,$1057.50
2025-03-12,16:51:00,19709.0,BUY,3,0.02h,Break Even,$-1.50,$1056.00,$183941.00,309,$1056.00
2025-03-12,16:58:00,19658.25,SELL,3,0.02h,Stop Loss,$82.50,$1138.50,$184023.50,309,$1138.50
2025-03-12,17:15:00,19672.75,BUY,3,0.02h,Stop Loss,$-9.00,$1129.50,$184014.50,309,$1129.50
2025-03-12,17:43:00,19680.75,SELL,3,0.02h,Break Even,$-1.50,$1128.00,$184013.00,309,$1128.00
2025-03-12,18:18:00,19603.5,BUY,3,0.02h,Stop Loss,$69.00,$1197.00,$184082.00,309,$1197.00
2025-03-12,19:02:00,19630.5,SELL,3,0.02h,Break Even,$-1.50,$1195.50,$184080.50,309,$1195.50
2025-03-12,19:56:00,19630.0,BUY,3,0.02h,Stop Loss,$6.00,$1201.50,$184086.50,309,$1201.50
2025-03-12,20:04:00,19595.25,SELL,3,0.02h,Stop Loss,$9.00,$1210.50,$184095.50,309,$1210.50
2025-03-12,20:31:00,19592.75,BUY,3,0.02h,Stop Loss,$-9.00,$1201.50,$184086.50,309,$1201.50
2025-03-12,20:39:00,19580.5,SELL,3,0.02h,Break Even,$-1.50,$1200.00,$184085.00,309,$1200.00
2025-03-12,22:03:00,19585.25,BUY,3,0.02h,Stop Loss,$45.00,$1245.00,$184130.00,309,$1245.00
2025-03-12,22:51:00,19611.5,SELL,3,0.02h,Stop Loss,$24.00,$1269.00,$184154.00,309,$1269.00
2025-03-12,22:59:00,19622.25,BUY,3,0.02h,Stop Loss,$10.50,$1279.50,$184164.50,309,$1279.50
,,,,,,,,,,,
2025-03-13,12:00:00,19531.25,SELL,3,0.02h,Stop Loss,$21.00,$21.00,$184185.50,310,$21.00
2025-03-13,12:11:00,19706.0,BUY,3,0.02h,Stop Loss,$-9.00,$12.00,$184176.50,310,$12.00
2025-03-13,12:15:00,19479.25,SELL,3,0.02h,Stop Loss,$-9.00,$3.00,$184167.50,310,$3.00
2025-03-13,12:16:00,19698.5,BUY,3,0.02h,Round Number,$6.00,$9.00,$184173.50,310,$9.00
2025-03-13,12:30:00,19512.0,SELL,3,0.02h,Stop Loss,$-9.00,$0.00,$184164.50,310,$0.00
2025-03-13,12:31:00,19780.25,BUY,3,0.02h,Stop Loss,$-9.00,$-9.00,$184155.50,310,$-9.00
2025-03-13,12:39:00,19537.5,SELL,3,0.02h,Break Even,$-1.50,$-10.50,$184154.00,310,$-10.50
2025-03-13,12:42:00,19769.0,BUY,3,0.02h,Stop Loss,$-9.00,$-19.50,$184145.00,310,$-19.50
2025-03-13,12:50:00,19519.0,SELL,3,0.02h,Stop Loss,$-9.00,$-28.50,$184136.00,310,$-28.50
2025-03-13,12:51:00,19738.25,BUY,3,0.02h,Stop Loss,$61.50,$33.00,$184197.50,310,$33.00
2025-03-13,12:53:00,19540.75,SELL,3,0.02h,Break Even,$-1.50,$31.50,$184196.00,310,$31.50
2025-03-13,13:02:00,19782.25,BUY,3,0.02h,Stop Loss,$-9.00,$22.50,$184187.00,310,$22.50
2025-03-13,13:03:00,19573.5,SELL,3,0.02h,Break Even,$-1.50,$21.00,$184185.50,310,$21.00
2025-03-13,13:08:00,19792.25,BUY,3,0.02h,Stop Loss,$-9.00,$12.00,$184176.50,310,$12.00
2025-03-13,13:09:00,19581.75,SELL,3,0.02h,Stop Loss,$-9.00,$3.00,$184167.50,310,$3.00
2025-03-13,13:10:00,19787.0,BUY,3,0.02h,Stop Loss,$-9.00,$-6.00,$184158.50,310,$-6.00
2025-03-13,13:23:00,19575.25,SELL,3,0.02h,Stop Loss,$-9.00,$-15.00,$184149.50,310,$-15.00
2025-03-13,13:24:00,19787.25,BUY,3,0.02h,Stop Loss,$-9.00,$-24.00,$184140.50,310,$-24.00
2025-03-13,13:25:00,19578.75,SELL,3,0.02h,Stop Loss,$-9.00,$-33.00,$184131.50,310,$-33.00
2025-03-13,13:26:00,19794.0,BUY,3,0.02h,Stop Loss,$-9.00,$-42.00,$184122.50,310,$-42.00
2025-03-13,13:27:00,19581.75,SELL,3,0.02h,Stop Loss,$46.50,$4.50,$184169.00,310,$4.50
2025-03-13,13:35:00,19769.75,BUY,3,0.02h,Stop Loss,$19.50,$24.00,$184188.50,310,$24.00
2025-03-13,13:41:00,19519.75,SELL,3,0.02h,Stop Loss,$28.50,$52.50,$184217.00,310,$52.50
2025-03-13,14:07:00,19639.25,BUY,3,0.02h,Stop Loss,$31.50,$84.00,$184248.50,310,$84.00
2025-03-13,14:12:00,19405.75,SELL,3,0.02h,Break Even,$-1.50,$82.50,$184247.00,310,$82.50
2025-03-13,14:21:00,19733.25,BUY,3,0.02h,Stop Loss,$-9.00,$73.50,$184238.00,310,$73.50
2025-03-13,14:29:00,19489.25,SELL,3,0.02h,Stop Loss,$93.00,$166.50,$184331.00,310,$166.50
2025-03-13,14:31:00,19717.75,BUY,3,0.02h,Stop Loss,$72.00,$238.50,$184403.00,310,$238.50
2025-03-13,14:34:00,19484.0,SELL,3,0.02h,Stop Loss,$-9.00,$229.50,$184394.00,310,$229.50
2025-03-13,14:35:00,19692.0,BUY,3,0.02h,Stop Loss,$-9.00,$220.50,$184385.00,310,$220.50
2025-03-13,14:36:00,19471.25,SELL,3,0.02h,Stop Loss,$171.00,$391.50,$184556.00,310,$391.50
2025-03-13,14:48:00,19625.75,BUY,3,0.02h,Stop Loss,$4.50,$396.00,$184560.50,310,$396.00
2025-03-13,15:02:00,19460.75,SELL,3,0.02h,Stop Loss,$19.50,$415.50,$184580.00,310,$415.50
2025-03-13,15:26:00,19569.0,BUY,3,0.02h,Stop Loss,$69.00,$484.50,$184649.00,310,$484.50
2025-03-13,15:33:00,19367.0,SELL,3,0.02h,Stop Loss,$9.00,$493.50,$184658.00,310,$493.50
2025-03-13,15:47:00,19541.25,BUY,3,0.02h,Stop Loss,$-9.00,$484.50,$184649.00,310,$484.50
2025-03-13,15:48:00,19354.5,SELL,3,0.02h,Stop Loss,$-9.00,$475.50,$184640.00,310,$475.50
2025-03-13,15:49:00,19550.0,BUY,3,0.02h,Stop Loss,$150.00,$625.50,$184790.00,310,$625.50
2025-03-13,16:03:00,19311.5,SELL,3,0.02h,Stop Loss,$-9.00,$616.50,$184781.00,310,$616.50
2025-03-13,16:05:00,19529.0,BUY,3,0.02h,Stop Loss,$-9.00,$607.50,$184772.00,310,$607.50
2025-03-13,16:06:00,19304.25,SELL,3,0.02h,Stop Loss,$40.50,$648.00,$184812.50,310,$648.00
2025-03-13,16:18:00,19513.0,BUY,3,0.02h,Stop Loss,$37.50,$685.50,$184850.00,310,$685.50
2025-03-13,16:20:00,19312.75,SELL,3,0.02h,Stop Loss,$-9.00,$676.50,$184841.00,310,$676.50
2025-03-13,16:21:00,19517.5,BUY,3,0.02h,Stop Loss,$46.50,$723.00,$184887.50,310,$723.00
2025-03-13,16:27:00,19288.0,SELL,3,0.02h,Break Even,$-1.50,$721.50,$184886.00,310,$721.50
2025-03-13,16:32:00,19547.5,BUY,3,0.02h,Stop Loss,$-9.00,$712.50,$184877.00,310,$712.50
2025-03-13,16:33:00,19329.0,SELL,3,0.02h,Break Even,$-1.50,$711.00,$184875.50,310,$711.00
2025-03-13,16:39:00,19589.0,BUY,3,0.02h,Break Even,$-1.50,$709.50,$184874.00,310,$709.50
2025-03-13,16:45:00,19323.5,SELL,3,0.02h,Stop Loss,$-9.00,$700.50,$184865.00,310,$700.50
2025-03-13,16:46:00,19507.25,BUY,3,0.02h,Stop Loss,$-9.00,$691.50,$184856.00,310,$691.50
2025-03-13,16:51:00,19276.0,SELL,3,0.02h,Stop Loss,$-9.00,$682.50,$184847.00,310,$682.50
2025-03-13,16:52:00,19475.5,BUY,3,0.02h,Stop Loss,$199.50,$882.00,$185046.50,310,$882.00
2025-03-13,16:54:00,19282.75,SELL,3,0.02h,Stop Loss,$-9.00,$873.00,$185037.50,310,$873.00
2025-03-13,16:56:00,19470.5,BUY,3,0.02h,Break Even,$-1.50,$871.50,$185036.00,310,$871.50
2025-03-13,17:02:00,19266.0,SELL,3,0.02h,Break Even,$-1.50,$870.00,$185034.50,310,$870.00
2025-03-13,17:07:00,19463.0,BUY,3,0.02h,Stop Loss,$-9.00,$861.00,$185025.50,310,$861.00
2025-03-13,17:08:00,19263.75,SELL,3,0.02h,Stop Loss,$10.50,$871.50,$185036.00,310,$871.50
2025-03-13,17:40:00,19392.0,BUY,3,0.02h,Stop Loss,$-9.00,$862.50,$185027.00,310,$862.50
2025-03-13,17:41:00,19208.75,SELL,3,0.02h,Stop Loss,$-9.00,$853.50,$185018.00,310,$853.50
2025-03-13,17:42:00,19396.25,BUY,3,0.02h,Stop Loss,$-9.00,$844.50,$185009.00,310,$844.50
2025-03-13,17:43:00,19194.0,SELL,3,0.02h,Break Even,$-1.50,$843.00,$185007.50,310,$843.00
2025-03-13,17:46:00,19383.0,BUY,3,0.02h,Stop Loss,$-9.00,$834.00,$184998.50,310,$834.00
2025-03-13,17:47:00,19178.75,SELL,3,0.02h,Stop Loss,$-9.00,$825.00,$184989.50,310,$825.00
2025-03-13,17:49:00,19379.0,BUY,3,0.02h,Stop Loss,$27.00,$852.00,$185016.50,310,$852.00
2025-03-13,17:54:00,19220.5,SELL,3,0.02h,Stop Loss,$51.00,$903.00,$185067.50,310,$903.00
2025-03-13,18:02:00,19438.25,BUY,3,0.02h,Stop Loss,$-9.00,$894.00,$185058.50,310,$894.00
2025-03-13,18:03:00,19249.75,SELL,3,0.02h,Stop Loss,$-9.00,$885.00,$185049.50,310,$885.00
2025-03-13,18:04:00,19457.0,BUY,3,0.02h,Stop Loss,$-9.00,$876.00,$185040.50,310,$876.00
2025-03-13,18:09:00,19272.5,SELL,3,0.02h,Stop Loss,$63.00,$939.00,$185103.50,310,$939.00
2025-03-13,18:12:00,19486.0,BUY,3,0.02h,Stop Loss,$-9.00,$930.00,$185094.50,310,$930.00
2025-03-13,18:49:00,19375.0,SELL,3,0.02h,Stop Loss,$22.50,$952.50,$185117.00,310,$952.50
2025-03-13,18:52:00,19559.0,BUY,3,0.02h,Break Even,$-1.50,$951.00,$185115.50,310,$951.00
2025-03-13,18:54:00,19317.25,SELL,3,0.02h,Stop Loss,$4.50,$955.50,$185120.00,310,$955.50
2025-03-13,18:56:00,19554.75,BUY,3,0.02h,Stop Loss,$10.50,$966.00,$185130.50,310,$966.00
2025-03-13,19:08:00,19315.75,SELL,3,0.02h,Stop Loss,$-9.00,$957.00,$185121.50,310,$957.00
2025-03-13,19:09:00,19515.25,BUY,3,0.02h,Stop Loss,$49.50,$1006.50,$185171.00,310,$1006.50
2025-03-13,19:11:00,19314.25,SELL,3,0.02h,Stop Loss,$-9.00,$997.50,$185162.00,310,$997.50
2025-03-13,19:13:00,19521.25,BUY,3,0.02h,Stop Loss,$-9.00,$988.50,$185153.00,310,$988.50
2025-03-13,19:14:00,19313.0,SELL,3,0.02h,Stop Loss,$4.50,$993.00,$185157.50,310,$993.00
2025-03-13,19:19:00,19516.5,BUY,3,0.02h,Stop Loss,$96.00,$1089.00,$185253.50,310,$1089.00
2025-03-13,19:22:00,19307.5,SELL,3,0.02h,Break Even,$-1.50,$1087.50,$185252.00,310,$1087.50
2025-03-13,19:42:00,19428.5,BUY,3,0.02h,Break Even,$-1.50,$1086.00,$185250.50,310,$1086.00
2025-03-13,19:45:00,19226.75,SELL,3,0.02h,Stop Loss,$-9.00,$1077.00,$185241.50,310,$1077.00
2025-03-13,19:46:00,19413.5,BUY,3,0.02h,Stop Loss,$159.00,$1236.00,$185400.50,310,$1236.00
2025-03-13,19:48:00,19231.0,SELL,3,0.02h,Stop Loss,$43.50,$1279.50,$185444.00,310,$1279.50
2025-03-13,20:01:00,19472.0,BUY,3,0.02h,Stop Loss,$-9.00,$1270.50,$185435.00,310,$1270.50
2025-03-13,20:03:00,19280.0,SELL,3,0.02h,Stop Loss,$-9.00,$1261.50,$185426.00,310,$1261.50
2025-03-13,20:04:00,19495.25,BUY,3,0.02h,Stop Loss,$-9.00,$1252.50,$185417.00,310,$1252.50
2025-03-13,20:32:00,19317.75,SELL,3,0.02h,Break Even,$-1.50,$1251.00,$185415.50,310,$1251.00
2025-03-13,20:47:00,19504.75,BUY,3,0.02h,Stop Loss,$-9.00,$1242.00,$185406.50,310,$1242.00
2025-03-13,20:48:00,19299.75,SELL,3,0.02h,Stop Loss,$25.50,$1267.50,$185432.00,310,$1267.50
2025-03-13,20:53:00,19504.0,BUY,3,0.02h,Stop Loss,$-9.00,$1258.50,$185423.00,310,$1258.50
2025-03-13,20:55:00,19298.5,SELL,3,0.02h,Break Even,$-1.50,$1257.00,$185421.50,310,$1257.00
2025-03-13,21:00:00,19500.0,BUY,3,1.02h,Stop Loss,$-9.00,$1248.00,$185412.50,310,$1248.00
2025-03-13,22:10:00,19337.75,SELL,3,0.02h,Stop Loss,$9.00,$1257.00,$185421.50,310,$1257.00
2025-03-13,22:14:00,19548.75,BUY,3,0.02h,Stop Loss,$7.50,$1264.50,$185429.00,310,$1264.50
2025-03-13,22:25:00,19323.5,SELL,3,0.02h,Stop Loss,$-9.00,$1255.50,$185420.00,310,$1255.50
2025-03-13,22:26:00,19534.5,BUY,3,0.02h,Stop Loss,$-9.00,$1246.50,$185411.00,310,$1246.50
2025-03-13,22:28:00,19326.25,SELL,3,0.02h,Stop Loss,$-9.00,$1237.50,$185402.00,310,$1237.50
2025-03-13,22:29:00,19540.0,BUY,3,0.02h,Stop Loss,$-9.00,$1228.50,$185393.00,310,$1228.50
2025-03-13,22:30:00,19338.0,SELL,3,0.02h,Stop Loss,$-9.00,$1219.50,$185384.00,310,$1219.50
2025-03-13,22:33:00,19543.25,BUY,3,0.02h,Stop Loss,$-9.00,$1210.50,$185375.00,310,$1210.50
2025-03-13,22:40:00,19367.25,SELL,3,0.02h,Stop Loss,$-9.00,$1201.50,$185366.00,310,$1201.50
2025-03-13,22:45:00,19567.75,BUY,3,0.02h,Stop Loss,$-9.00,$1192.50,$185357.00,310,$1192.50
2025-03-13,22:51:00,19371.0,SELL,3,0.02h,Stop Loss,$4.50,$1197.00,$185361.50,310,$1197.00
2025-03-13,22:53:00,19574.25,BUY,3,0.02h,Stop Loss,$-9.00,$1188.00,$185352.50,310,$1188.00
2025-03-13,22:54:00,19380.0,SELL,3,0.02h,Break Even,$-1.50,$1186.50,$185351.00,310,$1186.50
2025-03-13,22:56:00,19581.25,BUY,3,0.02h,Stop Loss,$-9.00,$1177.50,$185342.00,310,$1177.50
2025-03-13,22:57:00,19378.75,SELL,3,0.02h,Stop Loss,$-9.00,$1168.50,$185333.00,310,$1168.50
2025-03-13,22:58:00,19568.25,BUY,3,0.02h,Break Even,$-1.50,$1167.00,$185331.50,310,$1167.00
,,,,,,,,,,,
2025-03-14,12:22:00,19498.25,SELL,3,0.02h,Stop Loss,$-9.00,$-9.00,$185322.50,311,$-9.00
2025-03-14,12:29:00,19720.0,BUY,3,0.02h,Stop Loss,$-9.00,$-18.00,$185313.50,311,$-18.00
2025-03-14,12:36:00,19515.0,SELL,3,0.02h,Break Even,$-1.50,$-19.50,$185312.00,311,$-19.50
2025-03-14,12:39:00,19717.5,BUY,3,0.02h,Stop Loss,$-9.00,$-28.50,$185303.00,311,$-28.50
2025-03-14,12:56:00,19501.5,SELL,3,0.02h,Stop Loss,$6.00,$-22.50,$185309.00,311,$-22.50
2025-03-14,13:15:00,19685.25,BUY,3,0.02h,Stop Loss,$-9.00,$-31.50,$185300.00,311,$-31.50
2025-03-14,13:16:00,19479.0,SELL,3,0.02h,Stop Loss,$9.00,$-22.50,$185309.00,311,$-22.50
2025-03-14,13:27:00,19679.5,BUY,3,0.02h,Stop Loss,$-9.00,$-31.50,$185300.00,311,$-31.50
2025-03-14,13:33:00,19492.75,SELL,3,0.02h,Stop Loss,$-9.00,$-40.50,$185291.00,311,$-40.50
2025-03-14,13:36:00,19565.25,BUY,3,0.02h,Stop Loss,$1291.50,$1251.00,$186582.50,311,$1251.00
2025-03-14,13:58:00,19555.0,SELL,3,0.02h,Stop Loss,$19.50,$1270.50,$186602.00,311,$1270.50
2025-03-14,14:06:00,19752.75,BUY,3,0.02h,Stop Loss,$196.50,$1467.00,$186798.50,311,$1467.00
2025-03-14,14:11:00,19516.5,SELL,3,0.02h,Stop Loss,$-9.00,$1458.00,$186789.50,311,$1458.00
2025-03-14,14:14:00,19704.5,BUY,3,0.02h,Stop Loss,$-9.00,$1449.00,$186780.50,311,$1449.00
2025-03-14,14:15:00,19478.75,SELL,3,0.02h,Stop Loss,$4.50,$1453.50,$186785.00,311,$1453.50
2025-03-14,14:25:00,19721.25,BUY,3,0.02h,Stop Loss,$-9.00,$1444.50,$186776.00,311,$1444.50
2025-03-14,14:26:00,19501.0,SELL,3,0.02h,Stop Loss,$88.50,$1533.00,$186864.50,311,$1533.00
2025-03-14,14:30:00,19681.5,BUY,3,0.02h,Stop Loss,$-9.00,$1524.00,$186855.50,311,$1524.00
2025-03-14,14:31:00,19490.25,SELL,3,0.02h,Stop Loss,$-9.00,$1515.00,$186846.50,311,$1515.00
2025-03-14,14:32:00,19706.25,BUY,3,0.02h,Stop Loss,$-9.00,$1506.00,$186837.50,311,$1506.00
2025-03-14,14:33:00,19492.25,SELL,3,0.02h,Stop Loss,$52.50,$1558.50,$186890.00,311,$1558.50
2025-03-14,14:36:00,19683.0,BUY,3,0.02h,Stop Loss,$121.50,$1680.00,$187011.50,311,$1680.00
2025-03-14,14:44:00,19539.5,SELL,3,0.02h,Stop Loss,$24.00,$1704.00,$187035.50,311,$1704.00
2025-03-14,14:46:00,19763.5,BUY,3,0.02h,Stop Loss,$31.50,$1735.50,$187067.00,311,$1735.50
2025-03-14,14:54:00,19564.5,SELL,3,0.02h,Stop Loss,$19.50,$1755.00,$187086.50,311,$1755.00
2025-03-14,15:00:00,19817.0,BUY,3,0.02h,Stop Loss,$162.00,$1917.00,$187248.50,311,$1917.00
2025-03-14,15:07:00,19632.5,SELL,3,0.02h,Stop Loss,$30.00,$1947.00,$187278.50,311,$1947.00
2025-03-14,15:09:00,19833.0,BUY,3,0.02h,Stop Loss,$-9.00,$1938.00,$187269.50,311,$1938.00
2025-03-14,15:30:00,19644.75,SELL,3,0.02h,Stop Loss,$3.00,$1941.00,$187272.50,311,$1941.00
2025-03-14,15:36:00,19870.5,BUY,3,0.02h,Stop Loss,$28.50,$1969.50,$187301.00,311,$1969.50
2025-03-14,15:40:00,19681.75,SELL,3,0.02h,Stop Loss,$-9.00,$1960.50,$187292.00,311,$1960.50
2025-03-14,15:41:00,19894.5,BUY,3,0.02h,Stop Loss,$24.00,$1984.50,$187316.00,311,$1984.50
2025-03-14,15:45:00,19696.75,SELL,3,0.02h,Stop Loss,$153.00,$2137.50,$187469.00,311,$2137.50
2025-03-14,15:47:00,19878.0,BUY,3,0.02h,Break Even,$-1.50,$2136.00,$187467.50,311,$2136.00
2025-03-14,15:59:00,19667.5,SELL,3,0.02h,Stop Loss,$-9.00,$2127.00,$187458.50,311,$2127.00
2025-03-14,16:12:00,19845.25,BUY,3,0.02h,Stop Loss,$7.50,$2134.50,$187466.00,311,$2134.50
2025-03-14,16:19:00,19638.5,SELL,3,0.02h,Stop Loss,$39.00,$2173.50,$187505.00,311,$2173.50
2025-03-14,16:36:00,19857.0,BUY,3,0.02h,Stop Loss,$-9.00,$2164.50,$187496.00,311,$2164.50
2025-03-14,16:51:00,19690.5,SELL,3,0.02h,Stop Loss,$-9.00,$2155.50,$187487.00,311,$2155.50
2025-03-14,16:52:00,19900.5,BUY,3,0.02h,Stop Loss,$-9.00,$2146.50,$187478.00,311,$2146.50
2025-03-14,17:05:00,19675.0,SELL,3,0.02h,Stop Loss,$18.00,$2164.50,$187496.00,311,$2164.50
2025-03-14,17:34:00,19845.5,BUY,3,0.02h,Stop Loss,$9.00,$2173.50,$187505.00,311,$2173.50
2025-03-14,17:43:00,19634.5,SELL,3,0.02h,Break Even,$-1.50,$2172.00,$187503.50,311,$2172.00
2025-03-14,17:46:00,19833.0,BUY,3,0.02h,Stop Loss,$39.00,$2211.00,$187542.50,311,$2211.00
2025-03-14,18:07:00,19669.0,SELL,3,0.02h,Stop Loss,$79.50,$2290.50,$187622.00,311,$2290.50
2025-03-14,18:23:00,19838.75,BUY,3,0.02h,Stop Loss,$-9.00,$2281.50,$187613.00,311,$2281.50
2025-03-14,18:24:00,19622.25,SELL,3,0.02h,Stop Loss,$39.00,$2320.50,$187652.00,311,$2320.50
2025-03-14,18:32:00,19867.25,BUY,3,0.02h,Break Even,$-1.50,$2319.00,$187650.50,311,$2319.00
2025-03-14,18:45:00,19687.5,SELL,3,0.02h,Stop Loss,$-9.00,$2310.00,$187641.50,311,$2310.00
2025-03-14,18:46:00,19894.0,BUY,3,0.02h,Stop Loss,$48.00,$2358.00,$187689.50,311,$2358.00
2025-03-14,18:51:00,19693.25,SELL,3,0.02h,Stop Loss,$-9.00,$2349.00,$187680.50,311,$2349.00
2025-03-14,18:52:00,19885.0,BUY,3,0.02h,Stop Loss,$-9.00,$2340.00,$187671.50,311,$2340.00
2025-03-14,18:54:00,19688.25,SELL,3,0.02h,Stop Loss,$52.50,$2392.50,$187724.00,311,$2392.50
2025-03-14,18:58:00,19866.25,BUY,3,0.02h,Stop Loss,$-9.00,$2383.50,$187715.00,311,$2383.50
2025-03-14,18:59:00,19678.25,SELL,3,0.02h,Stop Loss,$28.50,$2412.00,$187743.50,311,$2412.00
2025-03-14,19:06:00,19897.5,BUY,3,0.02h,Stop Loss,$43.50,$2455.50,$187787.00,311,$2455.50
2025-03-14,19:11:00,19700.75,SELL,3,0.02h,Break Even,$-1.50,$2454.00,$187785.50,311,$2454.00
2025-03-14,19:13:00,19917.0,BUY,3,0.02h,Break Even,$-1.50,$2452.50,$187784.00,311,$2452.50
2025-03-14,19:24:00,19679.5,SELL,3,0.02h,Stop Loss,$-9.00,$2443.50,$187775.00,311,$2443.50
2025-03-14,19:27:00,19895.0,BUY,3,0.02h,Break Even,$-1.50,$2442.00,$187773.50,311,$2442.00
2025-03-14,19:35:00,19682.25,SELL,3,0.02h,Stop Loss,$-9.00,$2433.00,$187764.50,311,$2433.00
2025-03-14,19:36:00,19881.25,BUY,3,0.02h,Stop Loss,$-9.00,$2424.00,$187755.50,311,$2424.00
2025-03-14,19:37:00,19673.25,SELL,3,0.02h,Stop Loss,$10.50,$2434.50,$187766.00,311,$2434.50
2025-03-14,19:41:00,19875.25,BUY,3,0.02h,Stop Loss,$-9.00,$2425.50,$187757.00,311,$2425.50
2025-03-14,19:43:00,19665.0,SELL,3,0.02h,Stop Loss,$-9.00,$2416.50,$187748.00,311,$2416.50
2025-03-14,19:44:00,19872.0,BUY,3,0.02h,Stop Loss,$-9.00,$2407.50,$187739.00,311,$2407.50
2025-03-14,19:45:00,19668.5,SELL,3,0.02h,Stop Loss,$31.50,$2439.00,$187770.50,311,$2439.00
2025-03-14,19:50:00,19902.0,BUY,3,0.02h,Stop Loss,$-9.00,$2430.00,$187761.50,311,$2430.00
2025-03-14,19:52:00,19696.25,SELL,3,0.02h,Break Even,$-1.50,$2428.50,$187760.00,311,$2428.50
2025-03-14,19:58:00,19937.5,BUY,3,0.02h,Stop Loss,$-9.00,$2419.50,$187751.00,311,$2419.50
2025-03-14,19:59:00,19731.5,SELL,3,0.02h,Stop Loss,$-9.00,$2410.50,$187742.00,311,$2410.50
2025-03-14,20:00:00,19912.5,BUY,3,0.02h,Stop Loss,$-9.00,$2401.50,$187733.00,311,$2401.50
2025-03-14,20:03:00,19676.5,SELL,3,0.02h,Stop Loss,$37.50,$2439.00,$187770.50,311,$2439.00
2025-03-14,20:13:00,19865.75,BUY,3,0.02h,Stop Loss,$12.00,$2451.00,$187782.50,311,$2451.00
2025-03-14,20:17:00,19659.75,SELL,3,0.02h,Stop Loss,$-9.00,$2442.00,$187773.50,311,$2442.00
2025-03-14,20:22:00,19854.0,BUY,3,0.02h,Stop Loss,$-9.00,$2433.00,$187764.50,311,$2433.00
2025-03-14,20:23:00,19644.75,SELL,3,0.02h,Stop Loss,$4.50,$2437.50,$187769.00,311,$2437.50
2025-03-14,20:31:00,19870.5,BUY,3,0.02h,Stop Loss,$-9.00,$2428.50,$187760.00,311,$2428.50
2025-03-14,20:32:00,19666.5,SELL,3,0.02h,Stop Loss,$-9.00,$2419.50,$187751.00,311,$2419.50
2025-03-14,20:33:00,19865.75,BUY,3,0.02h,Stop Loss,$-9.00,$2410.50,$187742.00,311,$2410.50
2025-03-14,20:53:00,19663.5,SELL,3,0.02h,Stop Loss,$-9.00,$2401.50,$187733.00,311,$2401.50
2025-03-14,20:54:00,19874.0,BUY,3,0.02h,Stop Loss,$-9.00,$2392.50,$187724.00,311,$2392.50
2025-03-14,20:57:00,19668.25,SELL,3,0.02h,Stop Loss,$-9.00,$2383.50,$187715.00,311,$2383.50
,,,,,,,,,,,
2025-03-17,12:01:00,19892.5,BUY,3,0.02h,Break Even,$-1.50,$-1.50,$187713.50,312,$-1.50
2025-03-17,13:02:00,19939.0,SELL,3,0.02h,Break Even,$-1.50,$-3.00,$187712.00,312,$-3.00
2025-03-17,13:34:00,19962.25,BUY,3,0.02h,Stop Loss,$15.00,$12.00,$187727.00,312,$12.00
2025-03-17,14:02:00,19956.25,SELL,3,0.02h,Stop Loss,$49.50,$61.50,$187776.50,312,$61.50
2025-03-17,14:14:00,20010.5,BUY,3,0.02h,Stop Loss,$61.50,$123.00,$187838.00,312,$123.00
2025-03-17,14:27:00,19966.75,SELL,3,0.02h,Stop Loss,$85.50,$208.50,$187923.50,312,$208.50
2025-03-17,14:49:00,19955.0,BUY,3,0.02h,Stop Loss,$19.50,$228.00,$187943.00,312,$228.00
2025-03-17,14:52:00,19932.5,SELL,3,0.02h,Stop Loss,$37.50,$265.50,$187980.50,312,$265.50
2025-03-17,15:18:00,19923.75,BUY,3,0.02h,Stop Loss,$24.00,$289.50,$188004.50,312,$289.50
2025-03-17,15:30:00,19885.75,SELL,3,0.02h,Stop Loss,$24.00,$313.50,$188028.50,312,$313.50
2025-03-17,15:52:00,19894.25,BUY,3,0.02h,Stop Loss,$9.00,$322.50,$188037.50,312,$322.50
2025-03-17,16:02:00,19867.0,SELL,3,0.02h,Stop Loss,$16.50,$339.00,$188054.00,312,$339.00
2025-03-17,16:05:00,19896.75,BUY,3,0.02h,Stop Loss,$30.00,$369.00,$188084.00,312,$369.00
2025-03-17,16:23:00,19894.0,SELL,3,0.02h,Stop Loss,$81.00,$450.00,$188165.00,312,$450.00
2025-03-17,16:39:00,19905.75,BUY,3,0.02h,Break Even,$-1.50,$448.50,$188163.50,312,$448.50
2025-03-17,16:42:00,19871.25,SELL,3,0.02h,Stop Loss,$31.50,$480.00,$188195.00,312,$480.00
2025-03-17,16:52:00,19906.25,BUY,3,0.02h,Stop Loss,$33.00,$513.00,$188228.00,312,$513.00
2025-03-17,17:04:00,19883.75,SELL,3,0.02h,Break Even,$-1.50,$511.50,$188226.50,312,$511.50
2025-03-17,17:07:00,19910.0,BUY,3,0.02h,Stop Loss,$61.50,$573.00,$188288.00,312,$573.00
2025-03-17,19:03:00,20131.75,SELL,3,0.02h,Stop Loss,$15.00,$588.00,$188303.00,312,$588.00
2025-03-17,20:29:00,20036.0,BUY,3,0.02h,Stop Loss,$12.00,$600.00,$188315.00,312,$600.00
2025-03-17,20:49:00,20032.75,SELL,3,0.02h,Stop Loss,$-9.00,$591.00,$188306.00,312,$591.00
2025-03-17,20:52:00,20037.5,BUY,3,0.03h,Break Even,$-1.50,$589.50,$188304.50,312,$589.50
2025-03-17,22:51:00,20058.25,SELL,3,0.02h,Stop Loss,$-9.00,$580.50,$188295.50,312,$580.50
,,,,,,,,,,,
2025-03-18,12:28:00,19960.5,BUY,3,0.02h,Stop Loss,$-9.00,$-9.00,$188286.50,313,$-9.00
2025-03-18,12:29:00,19755.5,SELL,3,0.02h,Break Even,$-1.50,$-10.50,$188285.00,313,$-10.50
2025-03-18,12:43:00,19944.75,BUY,3,0.02h,Stop Loss,$25.50,$15.00,$188310.50,313,$15.00
2025-03-18,12:50:00,19733.75,SELL,3,0.02h,Stop Loss,$10.50,$25.50,$188321.00,313,$25.50
2025-03-18,13:01:00,19893.5,BUY,3,0.02h,Stop Loss,$-9.00,$16.50,$188312.00,313,$16.50
2025-03-18,13:02:00,19691.25,SELL,3,0.02h,Stop Loss,$-9.00,$7.50,$188303.00,313,$7.50
2025-03-18,13:03:00,19905.75,BUY,3,0.02h,Stop Loss,$34.50,$42.00,$188337.50,313,$42.00
2025-03-18,13:16:00,19714.75,SELL,3,0.02h,Stop Loss,$-9.00,$33.00,$188328.50,313,$33.00
2025-03-18,13:17:00,19922.75,BUY,3,0.02h,Stop Loss,$-9.00,$24.00,$188319.50,313,$24.00
2025-03-18,13:18:00,19711.0,SELL,3,0.02h,Stop Loss,$66.00,$90.00,$188385.50,313,$90.00
2025-03-18,13:28:00,19891.5,BUY,3,0.02h,Stop Loss,$19.50,$109.50,$188405.00,313,$109.50
2025-03-18,13:33:00,19666.75,SELL,3,0.02h,Stop Loss,$4.50,$114.00,$188409.50,313,$114.00
2025-03-18,14:08:00,19705.5,BUY,3,0.02h,Stop Loss,$21.00,$135.00,$188430.50,313,$135.00
2025-03-18,14:10:00,19508.5,SELL,3,0.02h,Stop Loss,$-9.00,$126.00,$188421.50,313,$126.00
2025-03-18,14:11:00,19697.0,BUY,3,0.02h,Stop Loss,$73.50,$199.50,$188495.00,313,$199.50
2025-03-18,14:17:00,19464.25,SELL,3,0.02h,Stop Loss,$64.50,$264.00,$188559.50,313,$264.00
2025-03-18,14:28:00,19703.0,BUY,3,0.02h,Stop Loss,$19.50,$283.50,$188579.00,313,$283.50
2025-03-18,14:39:00,19503.5,SELL,3,0.02h,Stop Loss,$4.50,$288.00,$188583.50,313,$288.00
2025-03-18,14:45:00,19689.75,BUY,3,0.02h,Stop Loss,$-9.00,$279.00,$188574.50,313,$279.00
2025-03-18,14:46:00,19473.0,SELL,3,0.02h,Stop Loss,$-9.00,$270.00,$188565.50,313,$270.00
2025-03-18,14:50:00,19660.75,BUY,3,0.02h,Stop Loss,$148.50,$418.50,$188714.00,313,$418.50
2025-03-18,14:56:00,19486.75,SELL,3,0.02h,Stop Loss,$9.00,$427.50,$188723.00,313,$427.50
2025-03-18,15:20:00,19673.75,BUY,3,0.02h,Stop Loss,$4.50,$432.00,$188727.50,313,$432.00
2025-03-18,15:41:00,19479.0,SELL,3,0.02h,Stop Loss,$-9.00,$423.00,$188718.50,313,$423.00
2025-03-18,15:42:00,19668.75,BUY,3,0.02h,Stop Loss,$-9.00,$414.00,$188709.50,313,$414.00
2025-03-18,15:43:00,19462.5,SELL,3,0.02h,Stop Loss,$-9.00,$405.00,$188700.50,313,$405.00
2025-03-18,15:54:00,19656.25,BUY,3,0.02h,Stop Loss,$-9.00,$396.00,$188691.50,313,$396.00
2025-03-18,15:55:00,19447.25,SELL,3,0.02h,Stop Loss,$-9.00,$387.00,$188682.50,313,$387.00
2025-03-18,15:56:00,19649.25,BUY,3,0.02h,Stop Loss,$-9.00,$378.00,$188673.50,313,$378.00
2025-03-18,16:12:00,19505.0,SELL,3,0.02h,Stop Loss,$-9.00,$369.00,$188664.50,313,$369.00
2025-03-18,16:13:00,19717.75,BUY,3,0.02h,Stop Loss,$-9.00,$360.00,$188655.50,313,$360.00
2025-03-18,16:14:00,19509.75,SELL,3,0.02h,Stop Loss,$-9.00,$351.00,$188646.50,313,$351.00
2025-03-18,16:15:00,19724.5,BUY,3,0.02h,Stop Loss,$-9.00,$342.00,$188637.50,313,$342.00
2025-03-18,16:16:00,19522.0,SELL,3,0.02h,Stop Loss,$-9.00,$333.00,$188628.50,313,$333.00
2025-03-18,16:17:00,19726.5,BUY,3,0.02h,Stop Loss,$-9.00,$324.00,$188619.50,313,$324.00
2025-03-18,16:28:00,19523.75,SELL,3,0.02h,Stop Loss,$22.50,$346.50,$188642.00,313,$346.50
2025-03-18,16:36:00,19745.5,BUY,3,0.02h,Stop Loss,$-9.00,$337.50,$188633.00,313,$337.50
2025-03-18,16:37:00,19537.25,SELL,3,0.02h,Stop Loss,$81.00,$418.50,$188714.00,313,$418.50
2025-03-18,16:41:00,19740.5,BUY,3,0.02h,Break Even,$-1.50,$417.00,$188712.50,313,$417.00
2025-03-18,16:45:00,19484.75,SELL,3,0.02h,Stop Loss,$-9.00,$408.00,$188703.50,313,$408.00
2025-03-18,16:57:00,19693.0,BUY,3,0.02h,Stop Loss,$-9.00,$399.00,$188694.50,313,$399.00
2025-03-18,16:58:00,19502.5,SELL,3,0.02h,Stop Loss,$-9.00,$390.00,$188685.50,313,$390.00
2025-03-18,16:59:00,19727.25,BUY,3,0.02h,Stop Loss,$-9.00,$381.00,$188676.50,313,$381.00
2025-03-18,17:01:00,19527.0,SELL,3,0.02h,Stop Loss,$55.50,$436.50,$188732.00,313,$436.50
2025-03-18,17:04:00,19735.0,BUY,3,0.02h,Stop Loss,$-9.00,$427.50,$188723.00,313,$427.50
2025-03-18,17:05:00,19527.0,SELL,3,0.02h,Stop Loss,$67.50,$495.00,$188790.50,313,$495.00
2025-03-18,17:07:00,19700.25,BUY,3,0.02h,Stop Loss,$9.00,$504.00,$188799.50,313,$504.00
2025-03-18,17:19:00,19510.0,SELL,3,0.02h,Stop Loss,$375.00,$879.00,$189174.50,313,$879.00
2025-03-18,17:25:00,19706.75,BUY,3,0.02h,Stop Loss,$91.50,$970.50,$189266.00,313,$970.50
2025-03-18,17:29:00,19492.0,SELL,3,0.02h,Stop Loss,$-9.00,$961.50,$189257.00,313,$961.50
2025-03-18,17:30:00,19701.25,BUY,3,0.02h,Stop Loss,$-9.00,$952.50,$189248.00,313,$952.50
2025-03-18,17:31:00,19485.5,SELL,3,0.02h,Stop Loss,$-9.00,$943.50,$189239.00,313,$943.50
2025-03-18,17:49:00,19724.0,BUY,3,0.02h,Stop Loss,$-9.00,$934.50,$189230.00,313,$934.50
2025-03-18,17:52:00,19525.5,SELL,3,0.02h,Stop Loss,$-9.00,$925.50,$189221.00,313,$925.50
2025-03-18,17:57:00,19706.0,BUY,3,0.02h,Stop Loss,$13.50,$939.00,$189234.50,313,$939.00
2025-03-18,18:02:00,19491.5,SELL,3,0.02h,Stop Loss,$-9.00,$930.00,$189225.50,313,$930.00
2025-03-18,18:09:00,19687.75,BUY,3,0.02h,Stop Loss,$-9.00,$921.00,$189216.50,313,$921.00
2025-03-18,18:10:00,19488.5,SELL,3,0.02h,Stop Loss,$-9.00,$912.00,$189207.50,313,$912.00
2025-03-18,18:11:00,19677.0,BUY,3,0.02h,Stop Loss,$-9.00,$903.00,$189198.50,313,$903.00
2025-03-18,18:14:00,19466.75,SELL,3,0.02h,Stop Loss,$46.50,$949.50,$189245.00,313,$949.50
2025-03-18,18:18:00,19670.75,BUY,3,0.02h,Stop Loss,$-9.00,$940.50,$189236.00,313,$940.50
2025-03-18,18:19:00,19478.75,SELL,3,0.02h,Stop Loss,$37.50,$978.00,$189273.50,313,$978.00
2025-03-18,18:24:00,19721.5,BUY,3,0.02h,Stop Loss,$-9.00,$969.00,$189264.50,313,$969.00
2025-03-18,18:48:00,19522.0,SELL,3,0.02h,Stop Loss,$-9.00,$960.00,$189255.50,313,$960.00
2025-03-18,18:49:00,19730.25,BUY,3,0.02h,Stop Loss,$154.50,$1114.50,$189410.00,313,$1114.50
2025-03-18,18:58:00,19539.0,SELL,3,0.02h,Stop Loss,$39.00,$1153.50,$189449.00,313,$1153.50
2025-03-18,19:01:00,19726.75,BUY,3,0.02h,Stop Loss,$30.00,$1183.50,$189479.00,313,$1183.50
2025-03-18,19:03:00,19536.0,SELL,3,0.02h,Stop Loss,$-9.00,$1174.50,$189470.00,313,$1174.50
2025-03-18,19:04:00,19742.25,BUY,3,0.02h,Stop Loss,$13.50,$1188.00,$189483.50,313,$1188.00
2025-03-18,19:06:00,19524.5,SELL,3,0.02h,Stop Loss,$-9.00,$1179.00,$189474.50,313,$1179.00
2025-03-18,19:08:00,19721.5,BUY,3,0.02h,Stop Loss,$61.50,$1240.50,$189536.00,313,$1240.50
2025-03-18,19:12:00,19510.5,SELL,3,0.02h,Stop Loss,$-9.00,$1231.50,$189527.00,313,$1231.50
2025-03-18,19:21:00,19746.0,BUY,3,0.02h,Stop Loss,$-9.00,$1222.50,$189518.00,313,$1222.50
2025-03-18,19:22:00,19529.25,SELL,3,0.02h,Stop Loss,$52.50,$1275.00,$189570.50,313,$1275.00
2025-03-18,19:27:00,19704.25,BUY,3,0.02h,Stop Loss,$42.00,$1317.00,$189612.50,313,$1317.00
2025-03-18,19:30:00,19503.5,SELL,3,0.02h,Stop Loss,$3.00,$1320.00,$189615.50,313,$1320.00
2025-03-18,19:43:00,19702.75,BUY,3,0.02h,Stop Loss,$22.50,$1342.50,$189638.00,313,$1342.50
2025-03-18,19:52:00,19497.75,SELL,3,0.02h,Stop Loss,$27.00,$1369.50,$189665.00,313,$1369.50
2025-03-18,19:56:00,19694.0,BUY,3,0.02h,Stop Loss,$52.50,$1422.00,$189717.50,313,$1422.00
2025-03-18,20:07:00,19519.5,SELL,3,0.02h,Stop Loss,$9.00,$1431.00,$189726.50,313,$1431.00
2025-03-18,20:09:00,19727.25,BUY,3,0.02h,Break Even,$-1.50,$1429.50,$189725.00,313,$1429.50
2025-03-18,20:14:00,19518.0,SELL,3,0.02h,Stop Loss,$-9.00,$1420.50,$189716.00,313,$1420.50
2025-03-18,20:27:00,19705.0,BUY,3,0.02h,Stop Loss,$-9.00,$1411.50,$189707.00,313,$1411.50
2025-03-18,20:28:00,19498.25,SELL,3,0.02h,Break Even,$-1.50,$1410.00,$189705.50,313,$1410.00
2025-03-18,20:31:00,19710.75,BUY,3,0.02h,Stop Loss,$-9.00,$1401.00,$189696.50,313,$1401.00
2025-03-18,20:32:00,19509.5,SELL,3,0.02h,Break Even,$-1.50,$1399.50,$189695.00,313,$1399.50
2025-03-18,20:35:00,19715.0,BUY,3,0.02h,Break Even,$-1.50,$1398.00,$189693.50,313,$1398.00
2025-03-18,20:47:00,19507.0,SELL,3,0.02h,Stop Loss,$-9.00,$1389.00,$189684.50,313,$1389.00
2025-03-18,20:48:00,19714.5,BUY,3,0.02h,Stop Loss,$-9.00,$1380.00,$189675.50,313,$1380.00
2025-03-18,20:54:00,19502.5,SELL,3,0.02h,Stop Loss,$-9.00,$1371.00,$189666.50,313,$1371.00
2025-03-18,22:01:00,19698.5,BUY,3,0.02h,Stop Loss,$-9.00,$1362.00,$189657.50,313,$1362.00
2025-03-18,22:02:00,19493.0,SELL,3,0.02h,Stop Loss,$-9.00,$1353.00,$189648.50,313,$1353.00
2025-03-18,22:03:00,19698.0,BUY,3,0.02h,Stop Loss,$-9.00,$1344.00,$189639.50,313,$1344.00
2025-03-18,22:04:00,19499.25,SELL,3,0.02h,Stop Loss,$-9.00,$1335.00,$189630.50,313,$1335.00
2025-03-18,22:05:00,19705.25,BUY,3,0.02h,Stop Loss,$-9.00,$1326.00,$189621.50,313,$1326.00
2025-03-18,22:13:00,19487.75,SELL,3,0.02h,Stop Loss,$42.00,$1368.00,$189663.50,313,$1368.00
2025-03-18,22:16:00,19683.75,BUY,3,0.02h,Stop Loss,$-9.00,$1359.00,$189654.50,313,$1359.00
2025-03-18,22:19:00,19484.75,SELL,3,0.02h,Stop Loss,$37.50,$1396.50,$189692.00,313,$1396.50
2025-03-18,22:26:00,19690.0,BUY,3,0.02h,Stop Loss,$-9.00,$1387.50,$189683.00,313,$1387.50
2025-03-18,22:27:00,19485.5,SELL,3,0.02h,Stop Loss,$-9.00,$1378.50,$189674.00,313,$1378.50
2025-03-18,22:28:00,19679.75,BUY,3,0.02h,Break Even,$-1.50,$1377.00,$189672.50,313,$1377.00
2025-03-18,22:31:00,19469.5,SELL,3,0.02h,Stop Loss,$-9.00,$1368.00,$189663.50,313,$1368.00
2025-03-18,22:32:00,19671.25,BUY,3,0.02h,Stop Loss,$9.00,$1377.00,$189672.50,313,$1377.00
2025-03-18,22:41:00,19482.5,SELL,3,0.02h,Stop Loss,$-9.00,$1368.00,$189663.50,313,$1368.00
2025-03-18,22:45:00,19699.5,BUY,3,0.02h,Stop Loss,$18.00,$1386.00,$189681.50,313,$1386.00
2025-03-18,22:52:00,19505.75,SELL,3,0.02h,Stop Loss,$-9.00,$1377.00,$189672.50,313,$1377.00
2025-03-18,22:53:00,19711.25,BUY,3,0.02h,Stop Loss,$30.00,$1407.00,$189702.50,313,$1407.00
2025-03-18,22:55:00,19513.0,SELL,3,0.02h,Stop Loss,$-9.00,$1398.00,$189693.50,313,$1398.00
,,,,,,,,,,,
2025-03-19,12:04:00,19765.25,BUY,3,0.02h,Break Even,$-1.50,$-1.50,$189692.00,314,$-1.50
2025-03-19,12:20:00,19559.75,SELL,3,0.02h,Stop Loss,$16.50,$15.00,$189708.50,314,$15.00
2025-03-19,12:24:00,19758.25,BUY,3,0.02h,Stop Loss,$-9.00,$6.00,$189699.50,314,$6.00
2025-03-19,12:26:00,19550.75,SELL,3,0.02h,Break Even,$-1.50,$4.50,$189698.00,314,$4.50
2025-03-19,12:29:00,19752.5,BUY,3,0.02h,Break Even,$-1.50,$3.00,$189696.50,314,$3.00
2025-03-19,12:34:00,19552.75,SELL,3,0.02h,Stop Loss,$-9.00,$-6.00,$189687.50,314,$-6.00
2025-03-19,12:37:00,19758.0,BUY,3,0.02h,Stop Loss,$-9.00,$-15.00,$189678.50,314,$-15.00
2025-03-19,12:38:00,19551.5,SELL,3,0.02h,Stop Loss,$-9.00,$-24.00,$189669.50,314,$-24.00
2025-03-19,12:39:00,19750.0,BUY,3,0.02h,Stop Loss,$3.00,$-21.00,$189672.50,314,$-21.00
2025-03-19,12:42:00,19541.0,SELL,3,0.02h,Stop Loss,$-9.00,$-30.00,$189663.50,314,$-30.00
2025-03-19,12:43:00,19754.25,BUY,3,0.02h,Break Even,$-1.50,$-31.50,$189662.00,314,$-31.50
2025-03-19,12:45:00,19557.5,SELL,3,0.02h,Break Even,$-1.50,$-33.00,$189660.50,314,$-33.00
2025-03-19,12:48:00,19768.25,BUY,3,0.02h,Stop Loss,$9.00,$-24.00,$189669.50,314,$-24.00
2025-03-19,12:53:00,19562.75,SELL,3,0.02h,Break Even,$-1.50,$-25.50,$189668.00,314,$-25.50
2025-03-19,13:01:00,19763.5,BUY,3,0.02h,Stop Loss,$-9.00,$-34.50,$189659.00,314,$-34.50
2025-03-19,13:02:00,19560.75,SELL,3,0.02h,Stop Loss,$-9.00,$-43.50,$189650.00,314,$-43.50
2025-03-19,13:03:00,19763.5,BUY,3,0.02h,Stop Loss,$-9.00,$-52.50,$189641.00,314,$-52.50
2025-03-19,13:09:00,19561.5,SELL,3,0.02h,Break Even,$-1.50,$-54.00,$189639.50,314,$-54.00
2025-03-19,13:23:00,19758.0,BUY,3,0.02h,Stop Loss,$-9.00,$-63.00,$189630.50,314,$-63.00
2025-03-19,13:24:00,19556.25,SELL,3,0.02h,Break Even,$-1.50,$-64.50,$189629.00,314,$-64.50
2025-03-19,13:29:00,19785.5,BUY,3,0.02h,Stop Loss,$16.50,$-48.00,$189645.50,314,$-48.00
2025-03-19,13:38:00,19554.5,SELL,3,0.02h,Stop Loss,$7.50,$-40.50,$189653.00,314,$-40.50
2025-03-19,13:49:00,19777.75,BUY,3,0.02h,Stop Loss,$27.00,$-13.50,$189680.00,314,$-13.50
2025-03-19,14:10:00,19689.5,SELL,3,0.02h,Stop Loss,$-9.00,$-22.50,$189671.00,314,$-22.50
2025-03-19,14:11:00,19892.25,BUY,3,0.02h,Break Even,$-1.50,$-24.00,$189669.50,314,$-24.00
2025-03-19,14:14:00,19666.75,SELL,3,0.02h,Stop Loss,$28.50,$4.50,$189698.00,314,$4.50
2025-03-19,14:16:00,19883.75,BUY,3,0.02h,Stop Loss,$-9.00,$-4.50,$189689.00,314,$-4.50
2025-03-19,14:17:00,19673.0,SELL,3,0.02h,Stop Loss,$49.50,$45.00,$189738.50,314,$45.00
2025-03-19,14:24:00,19872.25,BUY,3,0.02h,Break Even,$-1.50,$43.50,$189737.00,314,$43.50
2025-03-19,14:28:00,19653.0,SELL,3,0.02h,Stop Loss,$12.00,$55.50,$189749.00,314,$55.50
2025-03-19,14:32:00,19847.5,BUY,3,0.02h,Stop Loss,$-9.00,$46.50,$189740.00,314,$46.50
2025-03-19,14:33:00,19651.5,SELL,3,0.02h,Stop Loss,$31.50,$78.00,$189771.50,314,$78.00
2025-03-19,14:35:00,19852.25,BUY,3,0.02h,Stop Loss,$36.00,$114.00,$189807.50,314,$114.00
2025-03-19,14:37:00,19650.0,SELL,3,0.02h,Stop Loss,$-9.00,$105.00,$189798.50,314,$105.00
2025-03-19,14:38:00,19860.0,BUY,3,0.02h,Stop Loss,$15.00,$120.00,$189813.50,314,$120.00
2025-03-19,14:56:00,19595.25,SELL,3,0.02h,Stop Loss,$27.00,$147.00,$189840.50,314,$147.00
2025-03-19,15:04:00,19815.0,BUY,3,0.02h,Stop Loss,$16.50,$163.50,$189857.00,314,$163.50
2025-03-19,15:06:00,19619.75,SELL,3,0.02h,Break Even,$-1.50,$162.00,$189855.50,314,$162.00
2025-03-19,15:16:00,19860.5,BUY,3,0.02h,Stop Loss,$-9.00,$153.00,$189846.50,314,$153.00
2025-03-19,15:17:00,19646.75,SELL,3,0.02h,Stop Loss,$-9.00,$144.00,$189837.50,314,$144.00
2025-03-19,15:18:00,19836.0,BUY,3,0.02h,Stop Loss,$-9.00,$135.00,$189828.50,314,$135.00
2025-03-19,15:34:00,19680.75,SELL,3,0.02h,Stop Loss,$-9.00,$126.00,$189819.50,314,$126.00
2025-03-19,15:35:00,19883.0,BUY,3,0.02h,Stop Loss,$-9.00,$117.00,$189810.50,314,$117.00
2025-03-19,15:36:00,19671.0,SELL,3,0.02h,Stop Loss,$-9.00,$108.00,$189801.50,314,$108.00
2025-03-19,15:37:00,19877.0,BUY,3,0.02h,Stop Loss,$3.00,$111.00,$189804.50,314,$111.00
2025-03-19,15:41:00,19685.25,SELL,3,0.02h,Stop Loss,$-9.00,$102.00,$189795.50,314,$102.00
2025-03-19,15:42:00,19891.0,BUY,3,0.02h,Stop Loss,$-9.00,$93.00,$189786.50,314,$93.00
2025-03-19,15:43:00,19690.0,SELL,3,0.02h,Stop Loss,$-9.00,$84.00,$189777.50,314,$84.00
2025-03-19,15:45:00,19900.0,BUY,3,0.02h,Stop Loss,$-9.00,$75.00,$189768.50,314,$75.00
2025-03-19,15:46:00,19696.0,SELL,3,0.02h,Stop Loss,$-9.00,$66.00,$189759.50,314,$66.00
2025-03-19,15:47:00,19894.75,BUY,3,0.02h,Stop Loss,$-9.00,$57.00,$189750.50,314,$57.00
2025-03-19,15:48:00,19686.25,SELL,3,0.02h,Break Even,$-1.50,$55.50,$189749.00,314,$55.50
2025-03-19,15:50:00,19903.25,BUY,3,0.02h,Stop Loss,$-9.00,$46.50,$189740.00,314,$46.50
2025-03-19,15:51:00,19710.75,SELL,3,0.02h,Break Even,$-1.50,$45.00,$189738.50,314,$45.00
2025-03-19,15:54:00,19929.25,BUY,3,0.02h,Stop Loss,$-9.00,$36.00,$189729.50,314,$36.00
2025-03-19,15:55:00,19720.0,SELL,3,0.02h,Break Even,$-1.50,$34.50,$189728.00,314,$34.50
2025-03-19,16:00:00,19920.25,BUY,3,0.02h,Stop Loss,$19.50,$54.00,$189747.50,314,$54.00
2025-03-19,16:03:00,19709.75,SELL,3,0.02h,Stop Loss,$-9.00,$45.00,$189738.50,314,$45.00
2025-03-19,16:04:00,19913.25,BUY,3,0.02h,Stop Loss,$4.50,$49.50,$189743.00,314,$49.50
2025-03-19,16:11:00,19698.25,SELL,3,0.02h,Stop Loss,$-9.00,$40.50,$189734.00,314,$40.50
2025-03-19,16:12:00,19907.5,BUY,3,0.02h,Stop Loss,$-9.00,$31.50,$189725.00,314,$31.50
2025-03-19,16:19:00,19688.25,SELL,3,0.02h,Stop Loss,$-9.00,$22.50,$189716.00,314,$22.50
2025-03-19,16:20:00,19892.75,BUY,3,0.02h,Stop Loss,$-9.00,$13.50,$189707.00,314,$13.50
2025-03-19,16:22:00,19684.5,SELL,3,0.02h,Stop Loss,$-9.00,$4.50,$189698.00,314,$4.50
2025-03-19,16:27:00,19894.25,BUY,3,0.02h,Stop Loss,$-9.00,$-4.50,$189689.00,314,$-4.50
2025-03-19,16:28:00,19696.75,SELL,3,0.02h,Break Even,$-1.50,$-6.00,$189687.50,314,$-6.00
2025-03-19,16:32:00,19890.5,BUY,3,0.02h,Stop Loss,$-9.00,$-15.00,$189678.50,314,$-15.00
2025-03-19,16:39:00,19680.25,SELL,3,0.02h,Stop Loss,$19.50,$4.50,$189698.00,314,$4.50
2025-03-19,16:42:00,19874.5,BUY,3,0.02h,Stop Loss,$3.00,$7.50,$189701.00,314,$7.50
2025-03-19,16:44:00,19664.5,SELL,3,0.02h,Stop Loss,$-9.00,$-1.50,$189692.00,314,$-1.50
2025-03-19,16:45:00,19875.25,BUY,3,0.02h,Stop Loss,$-9.00,$-10.50,$189683.00,314,$-10.50
2025-03-19,16:46:00,19666.75,SELL,3,0.02h,Stop Loss,$9.00,$-1.50,$189692.00,314,$-1.50
2025-03-19,16:51:00,19866.75,BUY,3,0.02h,Stop Loss,$-9.00,$-10.50,$189683.00,314,$-10.50
2025-03-19,16:58:00,19662.0,SELL,3,0.02h,Stop Loss,$30.00,$19.50,$189713.00,314,$19.50
2025-03-19,17:01:00,19881.5,BUY,3,0.02h,Stop Loss,$3.00,$22.50,$189716.00,314,$22.50
2025-03-19,17:03:00,19660.5,SELL,3,0.02h,Stop Loss,$-9.00,$13.50,$189707.00,314,$13.50
2025-03-19,17:04:00,19863.0,BUY,3,0.02h,Stop Loss,$22.50,$36.00,$189729.50,314,$36.00
2025-03-19,17:08:00,19647.25,SELL,3,0.02h,Stop Loss,$-9.00,$27.00,$189720.50,314,$27.00
2025-03-19,17:10:00,19839.5,BUY,3,0.02h,Stop Loss,$-9.00,$18.00,$189711.50,314,$18.00
2025-03-19,17:11:00,19640.5,SELL,3,0.02h,Stop Loss,$3.00,$21.00,$189714.50,314,$21.00
2025-03-19,17:29:00,19816.5,BUY,3,0.02h,Break Even,$-1.50,$19.50,$189713.00,314,$19.50
2025-03-19,17:32:00,19594.5,SELL,3,0.02h,Stop Loss,$34.50,$54.00,$189747.50,314,$54.00
2025-03-19,17:42:00,19843.25,BUY,3,0.02h,Stop Loss,$21.00,$75.00,$189768.50,314,$75.00
2025-03-19,17:50:00,19596.0,SELL,3,0.02h,Stop Loss,$-9.00,$66.00,$189759.50,314,$66.00
2025-03-19,17:51:00,19811.25,BUY,3,0.02h,Stop Loss,$-9.00,$57.00,$189750.50,314,$57.00
2025-03-19,17:52:00,19620.75,SELL,3,0.02h,Stop Loss,$-9.00,$48.00,$189741.50,314,$48.00
2025-03-19,17:53:00,19812.75,BUY,3,0.02h,Stop Loss,$-9.00,$39.00,$189732.50,314,$39.00
2025-03-19,17:58:00,19613.0,SELL,3,0.02h,Stop Loss,$-9.00,$30.00,$189723.50,314,$30.00
2025-03-19,18:00:00,19806.0,BUY,3,0.02h,Stop Loss,$517.50,$547.50,$190241.00,314,$547.50
2025-03-19,18:05:00,19656.5,SELL,3,0.02h,Stop Loss,$228.00,$775.50,$190469.00,314,$775.50
2025-03-19,18:09:00,19850.0,BUY,3,0.02h,Stop Loss,$88.50,$864.00,$190557.50,314,$864.00
2025-03-19,18:12:00,19681.5,SELL,3,0.02h,Stop Loss,$-9.00,$855.00,$190548.50,314,$855.00
2025-03-19,18:13:00,19899.5,BUY,3,0.02h,Stop Loss,$43.50,$898.50,$190592.00,314,$898.50
2025-03-19,18:19:00,19700.75,SELL,3,0.02h,Stop Loss,$12.00,$910.50,$190604.00,314,$910.50
2025-03-19,18:22:00,19884.5,BUY,3,0.02h,Stop Loss,$-9.00,$901.50,$190595.00,314,$901.50
2025-03-19,18:23:00,19700.5,SELL,3,0.02h,Stop Loss,$-9.00,$892.50,$190586.00,314,$892.50
2025-03-19,18:24:00,19904.25,BUY,3,0.02h,Stop Loss,$6.00,$898.50,$190592.00,314,$898.50
2025-03-19,18:41:00,19695.0,SELL,3,0.02h,Stop Loss,$-9.00,$889.50,$190583.00,314,$889.50
2025-03-19,18:42:00,19929.0,BUY,3,0.02h,Stop Loss,$132.00,$1021.50,$190715.00,314,$1021.50
2025-03-19,18:48:00,19755.0,SELL,3,0.02h,Stop Loss,$-9.00,$1012.50,$190706.00,314,$1012.50
2025-03-19,18:51:00,19959.25,BUY,3,0.02h,Stop Loss,$16.50,$1029.00,$190722.50,314,$1029.00
2025-03-19,19:20:00,19859.5,SELL,3,0.02h,Stop Loss,$157.50,$1186.50,$190880.00,314,$1186.50
2025-03-19,19:23:00,20023.0,BUY,3,0.02h,Stop Loss,$4.50,$1191.00,$190884.50,314,$1191.00
2025-03-19,19:25:00,19818.5,SELL,3,0.02h,Stop Loss,$102.00,$1293.00,$190986.50,314,$1293.00
2025-03-19,19:47:00,20026.25,BUY,3,0.02h,Break Even,$-1.50,$1291.50,$190985.00,314,$1291.50
2025-03-19,19:51:00,19766.5,SELL,3,0.02h,Stop Loss,$61.50,$1353.00,$191046.50,314,$1353.00
2025-03-19,19:57:00,19948.75,BUY,3,0.02h,Stop Loss,$-9.00,$1344.00,$191037.50,314,$1344.00
2025-03-19,19:58:00,19741.25,SELL,3,0.02h,Stop Loss,$37.50,$1381.50,$191075.00,314,$1381.50
2025-03-19,20:08:00,19976.75,BUY,3,0.02h,Stop Loss,$7.50,$1389.00,$191082.50,314,$1389.00
2025-03-19,20:14:00,19760.75,SELL,3,0.02h,Stop Loss,$-9.00,$1380.00,$191073.50,314,$1380.00
2025-03-19,20:16:00,19970.25,BUY,3,0.02h,Break Even,$-1.50,$1378.50,$191072.00,314,$1378.50
2025-03-19,20:18:00,19758.25,SELL,3,0.02h,Stop Loss,$-9.00,$1369.50,$191063.00,314,$1369.50
2025-03-19,20:19:00,19965.75,BUY,3,0.02h,Stop Loss,$-9.00,$1360.50,$191054.00,314,$1360.50
2025-03-19,20:23:00,19752.5,SELL,3,0.02h,Break Even,$-1.50,$1359.00,$191052.50,314,$1359.00
2025-03-19,20:31:00,19946.25,BUY,3,0.02h,Stop Loss,$-9.00,$1350.00,$191043.50,314,$1350.00
2025-03-19,20:32:00,19744.75,SELL,3,0.02h,Stop Loss,$-9.00,$1341.00,$191034.50,314,$1341.00
2025-03-19,20:33:00,19949.75,BUY,3,0.02h,Stop Loss,$-9.00,$1332.00,$191025.50,314,$1332.00
2025-03-19,20:34:00,19742.0,SELL,3,0.02h,Stop Loss,$-9.00,$1323.00,$191016.50,314,$1323.00
2025-03-19,20:35:00,19951.0,BUY,3,0.02h,Stop Loss,$-9.00,$1314.00,$191007.50,314,$1314.00
2025-03-19,20:50:00,19744.0,SELL,3,0.02h,Stop Loss,$-9.00,$1305.00,$190998.50,314,$1305.00
2025-03-19,20:51:00,19947.0,BUY,3,0.02h,Stop Loss,$-9.00,$1296.00,$190989.50,314,$1296.00
2025-03-19,20:53:00,19737.0,SELL,3,0.02h,Break Even,$-1.50,$1294.50,$190988.00,314,$1294.50
2025-03-19,22:08:00,19968.0,BUY,3,0.02h,Stop Loss,$10.50,$1305.00,$190998.50,314,$1305.00
2025-03-19,22:17:00,19778.75,SELL,3,0.02h,Stop Loss,$-9.00,$1296.00,$190989.50,314,$1296.00
2025-03-19,22:18:00,19982.75,BUY,3,0.02h,Stop Loss,$18.00,$1314.00,$191007.50,314,$1314.00
2025-03-19,22:29:00,19790.75,SELL,3,0.02h,Break Even,$-1.50,$1312.50,$191006.00,314,$1312.50
2025-03-19,22:31:00,19989.25,BUY,3,0.02h,Stop Loss,$-9.00,$1303.50,$190997.00,314,$1303.50
2025-03-19,22:32:00,19787.75,SELL,3,0.02h,Stop Loss,$-9.00,$1294.50,$190988.00,314,$1294.50
2025-03-19,22:33:00,19997.5,BUY,3,0.02h,Stop Loss,$-9.00,$1285.50,$190979.00,314,$1285.50
2025-03-19,22:34:00,19793.0,SELL,3,0.02h,Stop Loss,$7.50,$1293.00,$190986.50,314,$1293.00
2025-03-19,22:42:00,20007.75,BUY,3,0.02h,Stop Loss,$-9.00,$1284.00,$190977.50,314,$1284.00
2025-03-19,22:43:00,19802.5,SELL,3,0.02h,Break Even,$-1.50,$1282.50,$190976.00,314,$1282.50
2025-03-19,22:47:00,20013.25,BUY,3,0.02h,Stop Loss,$25.50,$1308.00,$191001.50,314,$1308.00
2025-03-19,22:51:00,19817.5,SELL,3,0.02h,Break Even,$-1.50,$1306.50,$191000.00,314,$1306.50
2025-03-19,22:54:00,20022.75,BUY,3,0.02h,Stop Loss,$-9.00,$1297.50,$190991.00,314,$1297.50
,,,,,,,,,,,
2025-03-20,12:02:00,19644.5,SELL,3,0.02h,Stop Loss,$-9.00,$-9.00,$190982.00,315,$-9.00
2025-03-20,12:30:00,19836.75,BUY,3,0.02h,Stop Loss,$16.50,$7.50,$190998.50,315,$7.50
2025-03-20,12:35:00,19644.75,SELL,3,0.02h,Stop Loss,$-9.00,$-1.50,$190989.50,315,$-1.50
2025-03-20,12:36:00,19854.75,BUY,3,0.02h,Stop Loss,$-9.00,$-10.50,$190980.50,315,$-10.50
2025-03-20,12:37:00,19651.25,SELL,3,0.02h,Stop Loss,$-9.00,$-19.50,$190971.50,315,$-19.50
2025-03-20,12:38:00,19848.75,BUY,3,0.02h,Stop Loss,$-9.00,$-28.50,$190962.50,315,$-28.50
2025-03-20,12:53:00,19630.75,SELL,3,0.02h,Stop Loss,$-9.00,$-37.50,$190953.50,315,$-37.50
2025-03-20,13:03:00,19809.5,BUY,3,0.02h,Stop Loss,$-9.00,$-46.50,$190944.50,315,$-46.50
2025-03-20,13:04:00,19595.5,SELL,3,0.02h,Break Even,$-1.50,$-48.00,$190943.00,315,$-48.00
2025-03-20,13:14:00,19819.75,BUY,3,0.02h,Break Even,$-1.50,$-49.50,$190941.50,315,$-49.50
2025-03-20,13:17:00,19609.5,SELL,3,0.02h,Break Even,$-1.50,$-51.00,$190940.00,315,$-51.00
2025-03-20,13:22:00,19805.0,BUY,3,0.02h,Break Even,$-1.50,$-52.50,$190938.50,315,$-52.50
2025-03-20,13:38:00,19654.5,SELL,3,0.02h,Break Even,$-1.50,$-54.00,$190937.00,315,$-54.00
2025-03-20,13:40:00,19894.0,BUY,3,0.02h,Stop Loss,$9.00,$-45.00,$190946.00,315,$-45.00
2025-03-20,13:48:00,19701.5,SELL,3,0.02h,Stop Loss,$34.50,$-10.50,$190980.50,315,$-10.50
2025-03-20,13:50:00,19908.5,BUY,3,0.02h,Stop Loss,$-9.00,$-19.50,$190971.50,315,$-19.50
2025-03-20,13:51:00,19712.25,SELL,3,0.02h,Stop Loss,$24.00,$4.50,$190995.50,315,$4.50
2025-03-20,13:54:00,19927.0,BUY,3,0.02h,Break Even,$-1.50,$3.00,$190994.00,315,$3.00
2025-03-20,14:22:00,19819.75,SELL,3,0.02h,Stop Loss,$-9.00,$-6.00,$190985.00,315,$-6.00
2025-03-20,14:23:00,20032.0,BUY,3,0.02h,Stop Loss,$-9.00,$-15.00,$190976.00,315,$-15.00
2025-03-20,14:45:00,19884.5,SELL,3,0.02h,Stop Loss,$-9.00,$-24.00,$190967.00,315,$-24.00
2025-03-20,14:46:00,20090.0,BUY,3,0.02h,Stop Loss,$58.50,$34.50,$191025.50,315,$34.50
2025-03-20,14:52:00,19865.75,SELL,3,0.02h,Stop Loss,$103.50,$138.00,$191129.00,315,$138.00
2025-03-20,15:01:00,20025.25,BUY,3,0.02h,Stop Loss,$31.50,$169.50,$191160.50,315,$169.50
2025-03-20,15:05:00,19820.0,SELL,3,0.02h,Stop Loss,$-9.00,$160.50,$191151.50,315,$160.50
2025-03-20,15:07:00,20040.25,BUY,3,0.02h,Stop Loss,$-9.00,$151.50,$191142.50,315,$151.50
2025-03-20,15:08:00,19836.0,SELL,3,0.02h,Stop Loss,$-9.00,$142.50,$191133.50,315,$142.50
2025-03-20,15:12:00,20045.75,BUY,3,0.02h,Stop Loss,$-9.00,$133.50,$191124.50,315,$133.50
2025-03-20,15:13:00,19845.25,SELL,3,0.02h,Stop Loss,$-9.00,$124.50,$191115.50,315,$124.50
2025-03-20,15:18:00,20031.0,BUY,3,0.02h,Stop Loss,$-9.00,$115.50,$191106.50,315,$115.50
2025-03-20,15:19:00,19834.25,SELL,3,0.02h,Stop Loss,$-9.00,$106.50,$191097.50,315,$106.50
2025-03-20,15:20:00,20026.5,BUY,3,0.02h,Stop Loss,$33.00,$139.50,$191130.50,315,$139.50
2025-03-20,15:26:00,19826.75,SELL,3,0.02h,Stop Loss,$27.00,$166.50,$191157.50,315,$166.50
2025-03-20,15:29:00,20027.0,BUY,3,0.02h,Stop Loss,$-9.00,$157.50,$191148.50,315,$157.50
2025-03-20,15:30:00,19828.0,SELL,3,0.02h,Stop Loss,$-9.00,$148.50,$191139.50,315,$148.50
2025-03-20,15:41:00,20018.5,BUY,3,0.02h,Break Even,$-1.50,$147.00,$191138.00,315,$147.00
2025-03-20,15:44:00,19821.0,SELL,3,0.02h,Stop Loss,$9.00,$156.00,$191147.00,315,$156.00
2025-03-20,15:48:00,20046.5,BUY,3,0.02h,Stop Loss,$34.50,$190.50,$191181.50,315,$190.50
2025-03-20,15:50:00,19841.75,SELL,3,0.02h,Stop Loss,$-9.00,$181.50,$191172.50,315,$181.50
2025-03-20,15:51:00,20033.5,BUY,3,0.02h,Stop Loss,$82.50,$264.00,$191255.00,315,$264.00
2025-03-20,15:57:00,19810.5,SELL,3,0.02h,Stop Loss,$-9.00,$255.00,$191246.00,315,$255.00
2025-03-20,16:12:00,19955.25,BUY,3,0.02h,Break Even,$-1.50,$253.50,$191244.50,315,$253.50
2025-03-20,16:15:00,19771.0,SELL,3,0.02h,Stop Loss,$-9.00,$244.50,$191235.50,315,$244.50
2025-03-20,16:16:00,19964.25,BUY,3,0.02h,Stop Loss,$36.00,$280.50,$191271.50,315,$280.50
2025-03-20,16:19:00,19765.5,SELL,3,0.02h,Stop Loss,$-9.00,$271.50,$191262.50,315,$271.50
2025-03-20,16:20:00,19964.0,BUY,3,0.02h,Stop Loss,$-9.00,$262.50,$191253.50,315,$262.50
2025-03-20,16:29:00,19682.0,SELL,3,0.02h,Stop Loss,$66.00,$328.50,$191319.50,315,$328.50
2025-03-20,16:40:00,19915.25,BUY,3,0.02h,Stop Loss,$-9.00,$319.50,$191310.50,315,$319.50
2025-03-20,16:46:00,19676.5,SELL,3,0.02h,Stop Loss,$-9.00,$310.50,$191301.50,315,$310.50
2025-03-20,17:12:00,19917.25,BUY,3,0.02h,Stop Loss,$64.50,$375.00,$191366.00,315,$375.00
2025-03-20,17:29:00,19637.75,SELL,3,0.02h,Stop Loss,$16.50,$391.50,$191382.50,315,$391.50
2025-03-20,17:35:00,19857.75,BUY,3,0.02h,Stop Loss,$39.00,$430.50,$191421.50,315,$430.50
2025-03-20,17:40:00,19679.5,SELL,3,0.02h,Stop Loss,$-9.00,$421.50,$191412.50,315,$421.50
2025-03-20,17:41:00,19870.75,BUY,3,0.02h,Stop Loss,$-9.00,$412.50,$191403.50,315,$412.50
2025-03-20,17:42:00,19671.25,SELL,3,0.02h,Stop Loss,$64.50,$477.00,$191468.00,315,$477.00
2025-03-20,17:49:00,19876.0,BUY,3,0.02h,Stop Loss,$-9.00,$468.00,$191459.00,315,$468.00
2025-03-20,17:50:00,19676.0,SELL,3,0.02h,Stop Loss,$34.50,$502.50,$191493.50,315,$502.50
2025-03-20,18:00:00,19848.25,BUY,3,0.02h,Stop Loss,$69.00,$571.50,$191562.50,315,$571.50
2025-03-20,18:12:00,19690.5,SELL,3,0.02h,Break Even,$-1.50,$570.00,$191561.00,315,$570.00
2025-03-20,18:30:00,19807.75,BUY,3,0.02h,Stop Loss,$3.00,$573.00,$191564.00,315,$573.00
2025-03-20,18:38:00,19636.75,SELL,3,0.02h,Stop Loss,$27.00,$600.00,$191591.00,315,$600.00
2025-03-20,18:40:00,19835.0,BUY,3,0.02h,Stop Loss,$-9.00,$591.00,$191582.00,315,$591.00
2025-03-20,18:41:00,19632.25,SELL,3,0.02h,Stop Loss,$57.00,$648.00,$191639.00,315,$648.00
2025-03-20,18:50:00,19842.0,BUY,3,0.02h,Stop Loss,$-9.00,$639.00,$191630.00,315,$639.00
2025-03-20,19:04:00,19648.75,SELL,3,0.02h,Stop Loss,$-9.00,$630.00,$191621.00,315,$630.00
2025-03-20,19:05:00,19848.75,BUY,3,0.02h,Stop Loss,$75.00,$705.00,$191696.00,315,$705.00
2025-03-20,19:12:00,19660.5,SELL,3,0.02h,Stop Loss,$-9.00,$696.00,$191687.00,315,$696.00
2025-03-20,19:13:00,19863.0,BUY,3,0.02h,Stop Loss,$-9.00,$687.00,$191678.00,315,$687.00
2025-03-20,19:14:00,19656.25,SELL,3,0.02h,Stop Loss,$4.50,$691.50,$191682.50,315,$691.50
2025-03-20,19:23:00,19889.75,BUY,3,0.02h,Stop Loss,$31.50,$723.00,$191714.00,315,$723.00
2025-03-20,19:51:00,19690.0,SELL,3,0.02h,Stop Loss,$-9.00,$714.00,$191705.00,315,$714.00
2025-03-20,19:56:00,19903.0,BUY,3,0.02h,Break Even,$-1.50,$712.50,$191703.50,315,$712.50
2025-03-20,19:58:00,19696.0,SELL,3,0.02h,Stop Loss,$-9.00,$703.50,$191694.50,315,$703.50
2025-03-20,19:59:00,19886.75,BUY,3,0.02h,Stop Loss,$6.00,$709.50,$191700.50,315,$709.50
2025-03-20,20:02:00,19703.0,SELL,3,0.02h,Stop Loss,$19.50,$729.00,$191720.00,315,$729.00
2025-03-20,20:06:00,19905.75,BUY,3,0.02h,Break Even,$-1.50,$727.50,$191718.50,315,$727.50
2025-03-20,20:14:00,19706.75,SELL,3,0.02h,Stop Loss,$-9.00,$718.50,$191709.50,315,$718.50
2025-03-20,20:15:00,19905.25,BUY,3,0.02h,Break Even,$-1.50,$717.00,$191708.00,315,$717.00
2025-03-20,20:18:00,19708.0,SELL,3,0.02h,Stop Loss,$-9.00,$708.00,$191699.00,315,$708.00
2025-03-20,20:32:00,19903.5,BUY,3,0.02h,Stop Loss,$-9.00,$699.00,$191690.00,315,$699.00
2025-03-20,20:41:00,19692.25,SELL,3,0.02h,Stop Loss,$-9.00,$690.00,$191681.00,315,$690.00
2025-03-20,20:45:00,19896.25,BUY,3,0.02h,Stop Loss,$-9.00,$681.00,$191672.00,315,$681.00
2025-03-20,20:46:00,19695.25,SELL,3,0.02h,Stop Loss,$-9.00,$672.00,$191663.00,315,$672.00
2025-03-20,20:47:00,19896.25,BUY,3,0.02h,Break Even,$-1.50,$670.50,$191661.50,315,$670.50
2025-03-20,20:53:00,19700.0,SELL,3,0.02h,Stop Loss,$-9.00,$661.50,$191652.50,315,$661.50
2025-03-20,20:54:00,19898.0,BUY,3,0.02h,Stop Loss,$-9.00,$652.50,$191643.50,315,$652.50
2025-03-20,20:55:00,19698.25,SELL,3,0.02h,Stop Loss,$-9.00,$643.50,$191634.50,315,$643.50
2025-03-20,20:56:00,19898.75,BUY,3,0.02h,Stop Loss,$-9.00,$634.50,$191625.50,315,$634.50
2025-03-20,20:57:00,19697.0,SELL,3,0.02h,Stop Loss,$-9.00,$625.50,$191616.50,315,$625.50
2025-03-20,20:58:00,19898.5,BUY,3,0.02h,Stop Loss,$-9.00,$616.50,$191607.50,315,$616.50
2025-03-20,20:59:00,19695.75,SELL,3,0.02h,Stop Loss,$-9.00,$607.50,$191598.50,315,$607.50
2025-03-20,21:00:00,19894.25,BUY,3,1.02h,Stop Loss,$-9.00,$598.50,$191589.50,315,$598.50
2025-03-20,22:01:00,19693.5,SELL,3,0.02h,Stop Loss,$-9.00,$589.50,$191580.50,315,$589.50
2025-03-20,22:02:00,19899.5,BUY,3,0.02h,Stop Loss,$-9.00,$580.50,$191571.50,315,$580.50
2025-03-20,22:03:00,19694.0,SELL,3,0.02h,Stop Loss,$-9.00,$571.50,$191562.50,315,$571.50
2025-03-20,22:09:00,19886.5,BUY,3,0.02h,Break Even,$-1.50,$570.00,$191561.00,315,$570.00
2025-03-20,22:15:00,19681.0,SELL,3,0.02h,Stop Loss,$-9.00,$561.00,$191552.00,315,$561.00
2025-03-20,22:18:00,19899.0,BUY,3,0.02h,Stop Loss,$-9.00,$552.00,$191543.00,315,$552.00
2025-03-20,22:19:00,19699.25,SELL,3,0.02h,Stop Loss,$-9.00,$543.00,$191534.00,315,$543.00
2025-03-20,22:20:00,19902.25,BUY,3,0.02h,Stop Loss,$-9.00,$534.00,$191525.00,315,$534.00
2025-03-20,22:21:00,19694.75,SELL,3,0.02h,Stop Loss,$-9.00,$525.00,$191516.00,315,$525.00
2025-03-20,22:22:00,19891.5,BUY,3,0.02h,Break Even,$-1.50,$523.50,$191514.50,315,$523.50
2025-03-20,22:27:00,19690.5,SELL,3,0.02h,Stop Loss,$-9.00,$514.50,$191505.50,315,$514.50
2025-03-20,22:31:00,19899.5,BUY,3,0.02h,Stop Loss,$-9.00,$505.50,$191496.50,315,$505.50
2025-03-20,22:32:00,19692.0,SELL,3,0.02h,Stop Loss,$-9.00,$496.50,$191487.50,315,$496.50
2025-03-20,22:37:00,19905.5,BUY,3,0.02h,Stop Loss,$-9.00,$487.50,$191478.50,315,$487.50
2025-03-20,22:54:00,19687.25,SELL,3,0.02h,Break Even,$-1.50,$486.00,$191477.00,315,$486.00
2025-03-20,22:58:00,19886.25,BUY,3,0.02h,Stop Loss,$-9.00,$477.00,$191468.00,315,$477.00
2025-03-20,22:59:00,19685.25,SELL,3,0.02h,Break Even,$-1.50,$475.50,$191466.50,315,$475.50
,,,,,,,,,,,
2025-03-21,12:14:00,19822.25,BUY,3,0.02h,Stop Loss,$25.50,$25.50,$191492.00,316,$25.50
2025-03-21,12:16:00,19614.5,SELL,3,0.02h,Stop Loss,$-9.00,$16.50,$191483.00,316,$16.50
2025-03-21,12:17:00,19807.5,BUY,3,0.02h,Stop Loss,$4.50,$21.00,$191487.50,316,$21.00
2025-03-21,12:21:00,19599.5,SELL,3,0.02h,Stop Loss,$-9.00,$12.00,$191478.50,316,$12.00
2025-03-21,12:22:00,19802.25,BUY,3,0.02h,Break Even,$-1.50,$10.50,$191477.00,316,$10.50
2025-03-21,12:25:00,19601.5,SELL,3,0.02h,Stop Loss,$-9.00,$1.50,$191468.00,316,$1.50
2025-03-21,12:27:00,19793.0,BUY,3,0.02h,Stop Loss,$-9.00,$-7.50,$191459.00,316,$-7.50
2025-03-21,12:28:00,19596.25,SELL,3,0.02h,Stop Loss,$10.50,$3.00,$191469.50,316,$3.00
2025-03-21,12:35:00,19774.0,BUY,3,0.02h,Stop Loss,$21.00,$24.00,$191490.50,316,$24.00
2025-03-21,12:37:00,19560.5,SELL,3,0.02h,Stop Loss,$114.00,$138.00,$191604.50,316,$138.00
2025-03-21,12:49:00,19711.75,BUY,3,0.02h,Stop Loss,$-9.00,$129.00,$191595.50,316,$129.00
2025-03-21,12:50:00,19511.75,SELL,3,0.02h,Stop Loss,$19.50,$148.50,$191615.00,316,$148.50
2025-03-21,12:59:00,19683.75,BUY,3,0.02h,Break Even,$-1.50,$147.00,$191613.50,316,$147.00
2025-03-21,13:02:00,19477.75,SELL,3,0.02h,Stop Loss,$78.00,$225.00,$191691.50,316,$225.00
2025-03-21,13:10:00,19661.25,BUY,3,0.02h,Stop Loss,$28.50,$253.50,$191720.00,316,$253.50
2025-03-21,13:12:00,19459.5,SELL,3,0.02h,Stop Loss,$18.00,$271.50,$191738.00,316,$271.50
2025-03-21,13:18:00,19669.5,BUY,3,0.02h,Stop Loss,$-9.00,$262.50,$191729.00,316,$262.50
2025-03-21,13:19:00,19469.5,SELL,3,0.02h,Break Even,$-1.50,$261.00,$191727.50,316,$261.00
2025-03-21,13:24:00,19638.5,BUY,3,0.02h,Stop Loss,$-9.00,$252.00,$191718.50,316,$252.00
2025-03-21,13:26:00,19436.25,SELL,3,0.02h,Stop Loss,$25.50,$277.50,$191744.00,316,$277.50
2025-03-21,13:32:00,19654.75,BUY,3,0.02h,Stop Loss,$-9.00,$268.50,$191735.00,316,$268.50
2025-03-21,14:12:00,19669.25,SELL,3,0.02h,Stop Loss,$-9.00,$259.50,$191726.00,316,$259.50
2025-03-21,14:15:00,19717.25,BUY,3,0.02h,Stop Loss,$49.50,$309.00,$191775.50,316,$309.00
2025-03-21,14:41:00,19728.75,SELL,3,0.02h,Stop Loss,$97.50,$406.50,$191873.00,316,$406.50
2025-03-21,14:47:00,19741.0,BUY,3,0.02h,Stop Loss,$10.50,$417.00,$191883.50,316,$417.00
2025-03-21,14:54:00,19730.75,SELL,3,0.02h,Stop Loss,$22.50,$439.50,$191906.00,316,$439.50
2025-03-21,14:55:00,19741.25,BUY,3,0.02h,Stop Loss,$30.00,$469.50,$191936.00,316,$469.50
2025-03-21,15:16:00,19733.75,SELL,3,0.02h,Stop Loss,$10.50,$480.00,$191946.50,316,$480.00
2025-03-21,15:57:00,19736.0,BUY,3,0.02h,Break Even,$-1.50,$478.50,$191945.00,316,$478.50
2025-03-21,16:03:00,19700.5,SELL,3,0.02h,Stop Loss,$-9.00,$469.50,$191936.00,316,$469.50
2025-03-21,16:05:00,19727.0,BUY,3,0.02h,Stop Loss,$30.00,$499.50,$191966.00,316,$499.50
2025-03-21,17:14:00,19851.75,SELL,3,0.02h,Stop Loss,$28.50,$528.00,$191994.50,316,$528.00
2025-03-21,17:40:00,19855.75,BUY,3,0.02h,Stop Loss,$9.00,$537.00,$192003.50,316,$537.00
2025-03-21,18:07:00,19849.75,SELL,3,0.02h,Stop Loss,$-9.00,$528.00,$191994.50,316,$528.00
2025-03-21,18:38:00,19871.5,BUY,3,0.02h,Break Even,$-1.50,$526.50,$191993.00,316,$526.50
2025-03-21,18:52:00,19851.5,SELL,3,0.02h,Stop Loss,$9.00,$535.50,$192002.00,316,$535.50
2025-03-21,18:57:00,19868.25,BUY,3,0.02h,Stop Loss,$21.00,$556.50,$192023.00,316,$556.50
2025-03-21,19:01:00,19849.25,SELL,3,0.02h,Stop Loss,$52.50,$609.00,$192075.50,316,$609.00
2025-03-21,19:30:00,19840.75,BUY,3,0.02h,Stop Loss,$16.50,$625.50,$192092.00,316,$625.50
2025-03-21,20:52:00,19958.25,SELL,3,0.02h,Break Even,$-1.50,$624.00,$192090.50,316,$624.00
2025-03-21,20:56:00,19966.0,BUY,3,0.02h,Stop Loss,$16.50,$640.50,$192107.00,316,$640.50
,,,,,,,,,,,
2025-03-24,13:23:00,20275.0,SELL,3,0.02h,Stop Loss,$37.50,$37.50,$192144.50,317,$37.50
2025-03-24,13:40:00,20282.25,BUY,3,0.02h,Stop Loss,$22.50,$60.00,$192167.00,317,$60.00
2025-03-24,13:45:00,20238.25,SELL,3,0.02h,Stop Loss,$-9.00,$51.00,$192158.00,317,$51.00
2025-03-24,13:46:00,20276.0,BUY,3,0.02h,Stop Loss,$111.00,$162.00,$192269.00,317,$162.00
2025-03-24,14:10:00,20281.5,SELL,3,0.02h,Stop Loss,$-9.00,$153.00,$192260.00,317,$153.00
2025-03-24,14:15:00,20319.0,BUY,3,0.02h,Stop Loss,$40.50,$193.50,$192300.50,317,$193.50
2025-03-24,14:41:00,20327.25,SELL,3,0.02h,Break Even,$-1.50,$192.00,$192299.00,317,$192.00
2025-03-24,14:42:00,20331.25,BUY,3,0.02h,Stop Loss,$16.50,$208.50,$192315.50,317,$208.50
2025-03-24,15:28:00,20351.75,SELL,3,0.02h,Stop Loss,$22.50,$231.00,$192338.00,317,$231.00
2025-03-24,15:55:00,20351.75,BUY,3,0.02h,Stop Loss,$10.50,$241.50,$192348.50,317,$241.50
2025-03-24,16:27:00,20343.0,SELL,3,0.02h,Stop Loss,$37.50,$279.00,$192386.00,317,$279.00
2025-03-24,16:49:00,20355.75,BUY,3,0.02h,Stop Loss,$-9.00,$270.00,$192377.00,317,$270.00
2025-03-24,16:57:00,20339.5,SELL,3,0.02h,Stop Loss,$6.00,$276.00,$192383.00,317,$276.00
2025-03-24,17:30:00,20337.5,BUY,3,0.02h,Stop Loss,$12.00,$288.00,$192395.00,317,$288.00
2025-03-24,17:56:00,20332.5,SELL,3,0.02h,Stop Loss,$10.50,$298.50,$192405.50,317,$298.50
2025-03-24,18:23:00,20329.25,BUY,3,0.02h,Break Even,$-1.50,$297.00,$192404.00,317,$297.00
2025-03-24,18:33:00,20320.75,SELL,3,0.02h,Break Even,$-1.50,$295.50,$192402.50,317,$295.50
2025-03-24,18:40:00,20346.5,BUY,3,0.02h,Stop Loss,$42.00,$337.50,$192444.50,317,$337.50
2025-03-24,19:27:00,20369.75,SELL,3,0.02h,Break Even,$-1.50,$336.00,$192443.00,317,$336.00
2025-03-24,19:47:00,20376.0,BUY,3,0.02h,Stop Loss,$60.00,$396.00,$192503.00,317,$396.00
2025-03-24,20:02:00,20368.75,SELL,3,0.02h,Stop Loss,$7.50,$403.50,$192510.50,317,$403.50
2025-03-24,20:18:00,20375.5,BUY,3,0.02h,Stop Loss,$-9.00,$394.50,$192501.50,317,$394.50
2025-03-24,20:28:00,20368.25,SELL,3,0.02h,Break Even,$-1.50,$393.00,$192500.00,317,$393.00
2025-03-24,22:37:00,20352.75,BUY,3,0.02h,Stop Loss,$-9.00,$384.00,$192491.00,317,$384.00
2025-03-24,22:50:00,20347.0,SELL,3,0.02h,Break Even,$-1.50,$382.50,$192489.50,317,$382.50
,,,,,,,,,,,
2025-03-25,12:00:00,20411.75,BUY,3,0.02h,Stop Loss,$24.00,$24.00,$192513.50,318,$24.00
2025-03-25,12:51:00,20421.75,SELL,3,0.02h,Stop Loss,$33.00,$57.00,$192546.50,318,$57.00
2025-03-25,13:09:00,20425.5,BUY,3,0.02h,Break Even,$-1.50,$55.50,$192545.00,318,$55.50
2025-03-25,13:28:00,20421.75,SELL,3,0.02h,Stop Loss,$115.50,$171.00,$192660.50,318,$171.00
2025-03-25,13:57:00,20410.5,BUY,3,0.02h,Stop Loss,$19.50,$190.50,$192680.00,318,$190.50
2025-03-25,14:03:00,20379.75,SELL,3,0.02h,Stop Loss,$31.50,$222.00,$192711.50,318,$222.00
2025-03-25,14:08:00,20413.0,BUY,3,0.02h,Stop Loss,$21.00,$243.00,$192732.50,318,$243.00
2025-03-25,15:17:00,20472.75,SELL,3,0.02h,Break Even,$-1.50,$241.50,$192731.00,318,$241.50
2025-03-25,15:26:00,20486.25,BUY,3,0.02h,Stop Loss,$-9.00,$232.50,$192722.00,318,$232.50
2025-03-25,15:31:00,20471.75,SELL,3,0.02h,Stop Loss,$15.00,$247.50,$192737.00,318,$247.50
2025-03-25,16:44:00,20438.25,BUY,3,0.02h,Stop Loss,$18.00,$265.50,$192755.00,318,$265.50
2025-03-25,17:18:00,20446.5,SELL,3,0.02h,Stop Loss,$18.00,$283.50,$192773.00,318,$283.50
2025-03-25,18:11:00,20434.25,BUY,3,0.02h,Break Even,$-1.50,$282.00,$192771.50,318,$282.00
2025-03-25,18:32:00,20428.5,SELL,3,0.02h,Stop Loss,$4.50,$286.50,$192776.00,318,$286.50
2025-03-25,18:59:00,20431.5,BUY,3,0.02h,Stop Loss,$-9.00,$277.50,$192767.00,318,$277.50
2025-03-25,19:17:00,20429.5,SELL,3,0.02h,Stop Loss,$-9.00,$268.50,$192758.00,318,$268.50
2025-03-25,19:20:00,20441.5,BUY,3,0.02h,Break Even,$-1.50,$267.00,$192756.50,318,$267.00
2025-03-25,20:54:00,20515.75,SELL,3,0.02h,Stop Loss,$-9.00,$258.00,$192747.50,318,$258.00
2025-03-25,22:10:00,20519.25,BUY,3,0.02h,Stop Loss,$40.50,$298.50,$192788.00,318,$298.50
2025-03-25,22:21:00,20514.5,SELL,3,0.02h,Stop Loss,$-9.00,$289.50,$192779.00,318,$289.50
2025-03-25,22:54:00,20512.25,BUY,3,0.02h,Break Even,$-1.50,$288.00,$192777.50,318,$288.00
2025-03-25,22:59:00,20509.5,SELL,3,0.02h,Break Even,$-1.50,$286.50,$192776.00,318,$286.50
,,,,,,,,,,,
2025-03-26,12:47:00,20468.5,BUY,3,0.02h,Stop Loss,$16.50,$16.50,$192792.50,319,$16.50
2025-03-26,13:15:00,20473.5,SELL,3,0.02h,Break Even,$-1.50,$15.00,$192791.00,319,$15.00
2025-03-26,13:40:00,20458.25,BUY,3,0.02h,Stop Loss,$64.50,$79.50,$192855.50,319,$79.50
2025-03-26,13:43:00,20439.25,SELL,3,0.02h,Stop Loss,$63.00,$142.50,$192918.50,319,$142.50
2025-03-26,14:42:00,20291.75,BUY,3,0.02h,Stop Loss,$-9.00,$133.50,$192909.50,319,$133.50
2025-03-26,14:43:00,20280.75,SELL,3,0.02h,Break Even,$-1.50,$132.00,$192908.00,319,$132.00
2025-03-26,14:54:00,20310.5,BUY,3,0.02h,Stop Loss,$-9.00,$123.00,$192899.00,319,$123.00
2025-03-26,15:25:00,20288.25,SELL,3,0.02h,Stop Loss,$100.50,$223.50,$192999.50,319,$223.50
2025-03-26,16:30:00,20205.0,BUY,3,0.02h,Stop Loss,$55.50,$279.00,$193055.00,319,$279.00
2025-03-26,16:43:00,20189.5,SELL,3,0.02h,Stop Loss,$46.50,$325.50,$193101.50,319,$325.50
2025-03-26,18:11:00,20109.5,BUY,3,0.02h,Stop Loss,$34.50,$360.00,$193136.00,319,$360.00
2025-03-26,18:37:00,20115.0,SELL,3,0.02h,Stop Loss,$3.00,$363.00,$193139.00,319,$363.00
2025-03-26,19:19:00,20079.0,BUY,3,0.02h,Stop Loss,$60.00,$423.00,$193199.00,319,$423.00
2025-03-26,19:32:00,20065.25,SELL,3,0.02h,Stop Loss,$-9.00,$414.00,$193190.00,319,$414.00
2025-03-26,19:36:00,20079.75,BUY,3,0.02h,Break Even,$-1.50,$412.50,$193188.50,319,$412.50
2025-03-26,20:18:00,20105.75,SELL,3,0.02h,Stop Loss,$-9.00,$403.50,$193179.50,319,$403.50
2025-03-26,20:50:00,20099.5,BUY,3,0.02h,Stop Loss,$-9.00,$394.50,$193170.50,319,$394.50
2025-03-26,20:53:00,20093.75,SELL,3,0.02h,Stop Loss,$18.00,$412.50,$193188.50,319,$412.50
,,,,,,,,,,,
2025-03-27,12:00:00,20088.75,BUY,3,0.02h,Break Even,$-1.50,$-1.50,$193187.00,320,$-1.50
2025-03-27,12:27:00,20056.0,SELL,3,0.02h,Stop Loss,$21.00,$19.50,$193208.00,320,$19.50
2025-03-27,12:31:00,20082.25,BUY,3,0.02h,Stop Loss,$79.50,$99.00,$193287.50,320,$99.00
2025-03-27,12:49:00,20065.25,SELL,3,0.02h,Stop Loss,$4.50,$103.50,$193292.00,320,$103.50
2025-03-27,13:08:00,20080.75,BUY,3,0.02h,Stop Loss,$-9.00,$94.50,$193283.00,320,$94.50
2025-03-27,13:11:00,20067.5,SELL,3,0.02h,Stop Loss,$10.50,$105.00,$193293.50,320,$105.00
2025-03-27,13:51:00,20028.25,BUY,3,0.02h,Stop Loss,$39.00,$144.00,$193332.50,320,$144.00
2025-03-27,14:24:00,20050.0,SELL,3,0.02h,Break Even,$-1.50,$142.50,$193331.00,320,$142.50
2025-03-27,14:26:00,20080.25,BUY,3,0.02h,Stop Loss,$9.00,$151.50,$193340.00,320,$151.50
2025-03-27,15:14:00,20157.75,SELL,3,0.02h,Stop Loss,$-9.00,$142.50,$193331.00,320,$142.50
2025-03-27,16:08:00,20085.75,BUY,3,0.02h,Break Even,$-1.50,$141.00,$193329.50,320,$141.00
2025-03-27,16:30:00,20079.5,SELL,3,0.02h,Break Even,$-1.50,$139.50,$193328.00,320,$139.50
2025-03-27,17:13:00,20049.75,BUY,3,0.02h,Stop Loss,$30.00,$169.50,$193358.00,320,$169.50
2025-03-27,17:26:00,20034.25,SELL,3,0.02h,Stop Loss,$13.50,$183.00,$193371.50,320,$183.00
2025-03-27,17:48:00,20050.75,BUY,3,0.02h,Stop Loss,$-9.00,$174.00,$193362.50,320,$174.00
2025-03-27,17:55:00,20011.0,SELL,3,0.02h,Break Even,$-1.50,$172.50,$193361.00,320,$172.50
2025-03-27,18:05:00,20042.5,BUY,3,0.02h,Stop Loss,$39.00,$211.50,$193400.00,320,$211.50
2025-03-27,18:34:00,20058.5,SELL,3,0.02h,Break Even,$-1.50,$210.00,$193398.50,320,$210.00
2025-03-27,18:35:00,20065.0,BUY,3,0.02h,Stop Loss,$24.00,$234.00,$193422.50,320,$234.00
2025-03-27,18:58:00,20061.0,SELL,3,0.02h,Stop Loss,$18.00,$252.00,$193440.50,320,$252.00
2025-03-27,19:15:00,20096.75,BUY,3,0.02h,Stop Loss,$39.00,$291.00,$193479.50,320,$291.00
2025-03-27,19:34:00,20073.25,SELL,3,0.02h,Stop Loss,$13.50,$304.50,$193493.00,320,$304.50
2025-03-27,20:35:00,20004.25,BUY,3,0.02h,Break Even,$-1.50,$303.00,$193491.50,320,$303.00
2025-03-27,20:57:00,20004.0,SELL,3,0.02h,Break Even,$-1.50,$301.50,$193490.00,320,$301.50
2025-03-27,22:25:00,19997.0,BUY,3,0.02h,Stop Loss,$-9.00,$292.50,$193481.00,320,$292.50
2025-03-27,22:30:00,19993.25,SELL,3,0.02h,Stop Loss,$-9.00,$283.50,$193472.00,320,$283.50
2025-03-27,22:31:00,19997.5,BUY,3,0.02h,Stop Loss,$-9.00,$274.50,$193463.00,320,$274.50
2025-03-27,22:32:00,19995.0,SELL,3,0.02h,Stop Loss,$-9.00,$265.50,$193454.00,320,$265.50
2025-03-27,22:33:00,19998.5,BUY,3,0.02h,Break Even,$-1.50,$264.00,$193452.50,320,$264.00
2025-03-27,22:35:00,19992.75,SELL,3,0.02h,Stop Loss,$-9.00,$255.00,$193443.50,320,$255.00
2025-03-27,22:36:00,19997.75,BUY,3,0.02h,Stop Loss,$13.50,$268.50,$193457.00,320,$268.50
2025-03-27,22:52:00,19997.5,SELL,3,0.02h,Stop Loss,$6.00,$274.50,$193463.00,320,$274.50
,,,,,,,,,,,
2025-03-28,13:11:00,19893.75,BUY,3,0.02h,Stop Loss,$94.50,$94.50,$193557.50,321,$94.50
2025-03-28,13:31:00,19889.0,SELL,3,0.02h,Stop Loss,$165.00,$259.50,$193722.50,321,$259.50
2025-03-28,13:43:00,19934.5,BUY,3,0.02h,Stop Loss,$19.50,$279.00,$193742.00,321,$279.00
2025-03-28,13:45:00,19881.75,SELL,3,0.02h,Stop Loss,$25.50,$304.50,$193767.50,321,$304.50
2025-03-28,13:50:00,19909.0,BUY,3,0.02h,Stop Loss,$63.00,$367.50,$193830.50,321,$367.50
2025-03-28,13:52:00,19883.5,SELL,3,0.02h,Stop Loss,$129.00,$496.50,$193959.50,321,$496.50
2025-03-28,15:15:00,19608.5,BUY,3,0.02h,Stop Loss,$19.50,$516.00,$193979.00,321,$516.00
2025-03-28,15:20:00,19587.75,SELL,3,0.02h,Stop Loss,$12.00,$528.00,$193991.00,321,$528.00
2025-03-28,15:31:00,19594.5,BUY,3,0.02h,Stop Loss,$97.50,$625.50,$194088.50,321,$625.50
2025-03-28,15:46:00,19598.75,SELL,3,0.02h,Stop Loss,$12.00,$637.50,$194100.50,321,$637.50
2025-03-28,16:52:00,19525.75,BUY,3,0.02h,Stop Loss,$22.50,$660.00,$194123.00,321,$660.00
2025-03-28,16:57:00,19501.0,SELL,3,0.02h,Stop Loss,$12.00,$672.00,$194135.00,321,$672.00
2025-03-28,17:44:00,19472.75,BUY,3,0.02h,Stop Loss,$-9.00,$663.00,$194126.00,321,$663.00
2025-03-28,17:45:00,19456.5,SELL,3,0.02h,Stop Loss,$4.50,$667.50,$194130.50,321,$667.50
2025-03-28,17:47:00,19464.75,BUY,3,0.02h,Stop Loss,$48.00,$715.50,$194178.50,321,$715.50
2025-03-28,17:52:00,19449.5,SELL,3,0.02h,Stop Loss,$-9.00,$706.50,$194169.50,321,$706.50
2025-03-28,17:58:00,19478.0,BUY,3,0.02h,Stop Loss,$-9.00,$697.50,$194160.50,321,$697.50
2025-03-28,18:24:00,19473.5,SELL,3,0.02h,Stop Loss,$18.00,$715.50,$194178.50,321,$715.50
2025-03-28,18:35:00,19485.75,BUY,3,0.02h,Stop Loss,$7.50,$723.00,$194186.00,321,$723.00
2025-03-28,18:36:00,19477.75,SELL,3,0.02h,Stop Loss,$30.00,$753.00,$194216.00,321,$753.00
2025-03-28,18:58:00,19477.0,BUY,3,0.02h,Break Even,$-1.50,$751.50,$194214.50,321,$751.50
2025-03-28,19:17:00,19471.75,SELL,3,0.02h,Stop Loss,$39.00,$790.50,$194253.50,321,$790.50
2025-03-28,19:55:00,19470.5,BUY,3,0.02h,Stop Loss,$37.50,$828.00,$194291.00,321,$828.00
2025-03-28,20:06:00,19438.75,SELL,3,0.02h,Break Even,$-1.50,$826.50,$194289.50,321,$826.50
,,,,,,,,,,,
2025-03-31,12:35:00,19197.5,BUY,3,0.02h,Stop Loss,$3.00,$3.00,$194292.50,322,$3.00
2025-03-31,13:15:00,19208.5,SELL,3,0.02h,Stop Loss,$16.50,$19.50,$194309.00,322,$19.50
2025-03-31,13:57:00,19099.25,BUY,3,0.02h,Stop Loss,$148.50,$168.00,$194457.50,322,$168.00
2025-03-31,14:20:00,19095.75,SELL,3,0.02h,Stop Loss,$-9.00,$159.00,$194448.50,322,$159.00
2025-03-31,14:35:00,19157.25,BUY,3,0.02h,Stop Loss,$28.50,$187.50,$194477.00,322,$187.50
2025-03-31,15:15:00,19121.0,SELL,3,0.02h,Stop Loss,$22.50,$210.00,$194499.50,322,$210.00
2025-03-31,15:18:00,19150.25,BUY,3,0.02h,Stop Loss,$31.50,$241.50,$194531.00,322,$241.50
2025-03-31,16:07:00,19214.75,SELL,3,0.02h,Stop Loss,$45.00,$286.50,$194576.00,322,$286.50
2025-03-31,16:23:00,19229.75,BUY,3,0.02h,Break Even,$-1.50,$285.00,$194574.50,322,$285.00
2025-03-31,16:49:00,19246.0,SELL,3,0.02h,Break Even,$-1.50,$283.50,$194573.00,322,$283.50
2025-03-31,16:55:00,19264.5,BUY,3,0.02h,Stop Loss,$-9.00,$274.50,$194564.00,322,$274.50
2025-03-31,16:56:00,19249.25,SELL,3,0.02h,Stop Loss,$102.00,$376.50,$194666.00,322,$376.50
2025-03-31,17:07:00,19261.5,BUY,3,0.02h,Stop Loss,$64.50,$441.00,$194730.50,322,$441.00
2025-03-31,17:21:00,19241.0,SELL,3,0.02h,Stop Loss,$69.00,$510.00,$194799.50,322,$510.00
2025-03-31,17:39:00,19266.0,BUY,3,0.02h,Stop Loss,$10.50,$520.50,$194810.00,322,$520.50
2025-03-31,17:44:00,19225.75,SELL,3,0.02h,Stop Loss,$22.50,$543.00,$194832.50,322,$543.00
2025-03-31,17:54:00,19259.25,BUY,3,0.02h,Stop Loss,$31.50,$574.50,$194864.00,322,$574.50
2025-03-31,17:59:00,19227.0,SELL,3,0.02h,Stop Loss,$24.00,$598.50,$194888.00,322,$598.50
2025-03-31,18:02:00,19262.5,BUY,3,0.02h,Stop Loss,$54.00,$652.50,$194942.00,322,$652.50
2025-03-31,18:49:00,19361.25,SELL,3,0.02h,Stop Loss,$4.50,$657.00,$194946.50,322,$657.00
2025-03-31,18:51:00,19396.75,BUY,3,0.02h,Break Even,$-1.50,$655.50,$194945.00,322,$655.50
2025-03-31,19:00:00,19348.25,SELL,3,0.02h,Break Even,$-1.50,$654.00,$194943.50,322,$654.00
2025-03-31,19:06:00,19387.0,BUY,3,0.02h,Stop Loss,$85.50,$739.50,$195029.00,322,$739.50
2025-03-31,19:29:00,19371.0,SELL,3,0.02h,Stop Loss,$66.00,$805.50,$195095.00,322,$805.50
2025-03-31,19:36:00,19422.5,BUY,3,0.02h,Break Even,$-1.50,$804.00,$195093.50,322,$804.00
2025-03-31,20:03:00,19409.5,SELL,3,0.02h,Stop Loss,$7.50,$811.50,$195101.00,322,$811.50
2025-03-31,20:18:00,19429.5,BUY,3,0.02h,Stop Loss,$-9.00,$802.50,$195092.00,322,$802.50
2025-03-31,20:24:00,19421.0,SELL,3,0.02h,Break Even,$-1.50,$801.00,$195090.50,322,$801.00
2025-03-31,20:45:00,19424.0,BUY,3,0.02h,Stop Loss,$-9.00,$792.00,$195081.50,322,$792.00
2025-03-31,20:51:00,19413.75,SELL,3,0.03h,Stop Loss,$-9.00,$783.00,$195072.50,322,$783.00
2025-03-31,22:37:00,19370.0,BUY,3,0.02h,Break Even,$-1.50,$781.50,$195071.00,322,$781.50
,,,,,,,,,,,
2025-04-01,12:00:00,19354.5,SELL,3,0.02h,Stop Loss,$24.00,$24.00,$195095.00,323,$24.00
2025-04-01,12:12:00,19371.5,BUY,3,0.02h,Break Even,$-1.50,$22.50,$195093.50,323,$22.50
2025-04-01,12:13:00,19356.0,SELL,3,0.02h,Stop Loss,$3.00,$25.50,$195096.50,323,$25.50
2025-04-01,12:17:00,19379.0,BUY,3,0.02h,Stop Loss,$-9.00,$16.50,$195087.50,323,$16.50
2025-04-01,12:20:00,19362.25,SELL,3,0.02h,Stop Loss,$16.50,$33.00,$195104.00,323,$33.00
2025-04-01,12:33:00,19372.5,BUY,3,0.02h,Stop Loss,$7.50,$40.50,$195111.50,323,$40.50
2025-04-01,13:29:00,19383.25,SELL,3,0.02h,Stop Loss,$49.50,$90.00,$195161.00,323,$90.00
2025-04-01,13:45:00,19400.75,BUY,3,0.02h,Stop Loss,$81.00,$171.00,$195242.00,323,$171.00
2025-04-01,14:00:00,19367.5,SELL,3,0.02h,Stop Loss,$-9.00,$162.00,$195233.00,323,$162.00
2025-04-01,14:31:00,19352.5,BUY,3,0.02h,Stop Loss,$78.00,$240.00,$195311.00,323,$240.00
2025-04-01,15:37:00,19558.0,SELL,3,0.02h,Stop Loss,$96.00,$336.00,$195407.00,323,$336.00
2025-04-01,15:46:00,19585.0,BUY,3,0.02h,Stop Loss,$55.50,$391.50,$195462.50,323,$391.50
2025-04-01,16:27:00,19570.75,SELL,3,0.02h,Stop Loss,$40.50,$432.00,$195503.00,323,$432.00
2025-04-01,16:53:00,19576.75,BUY,3,0.02h,Stop Loss,$84.00,$516.00,$195587.00,323,$516.00
2025-04-01,17:07:00,19535.0,SELL,3,0.02h,Stop Loss,$6.00,$522.00,$195593.00,323,$522.00
2025-04-01,17:41:00,19560.25,BUY,3,0.02h,Stop Loss,$45.00,$567.00,$195638.00,323,$567.00
2025-04-01,17:56:00,19517.75,SELL,3,0.02h,Break Even,$-1.50,$565.50,$195636.50,323,$565.50
2025-04-01,18:45:00,19432.5,BUY,3,0.02h,Stop Loss,$-9.00,$556.50,$195627.50,323,$556.50
2025-04-01,18:48:00,19408.75,SELL,3,0.02h,Stop Loss,$16.50,$573.00,$195644.00,323,$573.00
2025-04-01,18:56:00,19440.25,BUY,3,0.02h,Stop Loss,$31.50,$604.50,$195675.50,323,$604.50
2025-04-01,20:26:00,19594.0,SELL,3,0.02h,Stop Loss,$4.50,$609.00,$195680.00,323,$609.00
2025-04-01,20:47:00,19597.5,BUY,3,0.02h,Stop Loss,$172.50,$781.50,$195852.50,323,$781.50
2025-04-01,22:35:00,19645.25,SELL,3,0.02h,Stop Loss,$4.50,$786.00,$195857.00,323,$786.00
2025-04-01,22:41:00,19660.5,BUY,3,0.02h,Stop Loss,$-9.00,$777.00,$195848.00,323,$777.00
2025-04-01,22:50:00,19652.25,SELL,3,0.02h,Stop Loss,$-9.00,$768.00,$195839.00,323,$768.00
2025-04-01,22:51:00,19656.0,BUY,3,0.02h,Stop Loss,$-9.00,$759.00,$195830.00,323,$759.00
2025-04-01,22:52:00,19650.5,SELL,3,0.02h,Stop Loss,$7.50,$766.50,$195837.50,323,$766.50
,,,,,,,,,,,
2025-04-02,12:49:00,19393.5,BUY,3,0.02h,Stop Loss,$-9.00,$-9.00,$195828.50,324,$-9.00
2025-04-02,13:03:00,19367.25,SELL,3,0.02h,Stop Loss,$66.00,$57.00,$195894.50,324,$57.00
2025-04-02,13:34:00,19394.5,BUY,3,0.02h,Stop Loss,$127.50,$184.50,$196022.00,324,$184.50
2025-04-02,14:12:00,19517.75,SELL,3,0.02h,Stop Loss,$30.00,$214.50,$196052.00,324,$214.50
2025-04-02,14:19:00,19568.75,BUY,3,0.02h,Stop Loss,$-9.00,$205.50,$196043.00,324,$205.50
2025-04-02,15:15:00,19584.5,SELL,3,0.02h,Stop Loss,$6.00,$211.50,$196049.00,324,$211.50
2025-04-02,15:21:00,19650.25,BUY,3,0.02h,Stop Loss,$79.50,$291.00,$196128.50,324,$291.00
2025-04-02,15:47:00,19655.0,SELL,3,0.02h,Stop Loss,$94.50,$385.50,$196223.00,324,$385.50
2025-04-02,16:02:00,19673.25,BUY,3,0.02h,Stop Loss,$60.00,$445.50,$196283.00,324,$445.50
2025-04-02,17:30:00,19832.25,SELL,3,0.02h,Stop Loss,$49.50,$495.00,$196332.50,324,$495.00
2025-04-02,18:39:00,19693.0,BUY,3,0.02h,Stop Loss,$19.50,$514.50,$196352.00,324,$514.50
2025-04-02,18:55:00,19674.75,SELL,3,0.02h,Stop Loss,$51.00,$565.50,$196403.00,324,$565.50
2025-04-02,19:10:00,19665.5,BUY,3,0.02h,Break Even,$-1.50,$564.00,$196401.50,324,$564.00
2025-04-02,19:11:00,19661.5,SELL,3,0.02h,Stop Loss,$82.50,$646.50,$196484.00,324,$646.50
2025-04-02,19:27:00,19670.25,BUY,3,0.02h,Stop Loss,$60.00,$706.50,$196544.00,324,$706.50
2025-04-02,20:08:00,19740.25,SELL,3,0.02h,Stop Loss,$100.50,$807.00,$196644.50,324,$807.00
2025-04-02,20:14:00,19925.25,BUY,3,0.02h,Stop Loss,$324.00,$1131.00,$196968.50,324,$1131.00
2025-04-02,20:28:00,19606.0,SELL,3,0.02h,Stop Loss,$915.00,$2046.00,$197883.50,324,$2046.00
2025-04-02,22:37:00,18940.0,BUY,3,0.02h,Stop Loss,$168.00,$2214.00,$198051.50,324,$2214.00
2025-04-02,22:45:00,18907.0,SELL,3,0.02h,Stop Loss,$28.50,$2242.50,$198080.00,324,$2242.50
2025-04-02,22:49:00,18929.0,BUY,3,0.02h,Stop Loss,$15.00,$2257.50,$198095.00,324,$2257.50
,,,,,,,,,,,
2025-04-03,12:26:00,18994.5,SELL,3,0.02h,Stop Loss,$3.00,$3.00,$198098.00,325,$3.00
2025-04-03,13:15:00,18882.0,BUY,3,0.02h,Stop Loss,$31.50,$34.50,$198129.50,325,$34.50
2025-04-03,13:22:00,18864.75,SELL,3,0.02h,Stop Loss,$-9.00,$25.50,$198120.50,325,$25.50
2025-04-03,13:26:00,18905.5,BUY,3,0.02h,Stop Loss,$43.50,$69.00,$198164.00,325,$69.00
2025-04-03,14:02:00,18978.25,SELL,3,0.02h,Stop Loss,$75.00,$144.00,$198239.00,325,$144.00
2025-04-03,14:31:00,18929.25,BUY,3,0.02h,Stop Loss,$10.50,$154.50,$198249.50,325,$154.50
2025-04-03,14:35:00,18893.0,SELL,3,0.02h,Stop Loss,$48.00,$202.50,$198297.50,325,$202.50
2025-04-03,15:15:00,18797.75,BUY,3,0.02h,Stop Loss,$189.00,$391.50,$198486.50,325,$391.50
2025-04-03,15:53:00,18844.0,SELL,3,0.02h,Stop Loss,$13.50,$405.00,$198500.00,325,$405.00
2025-04-03,15:55:00,18893.25,BUY,3,0.02h,Stop Loss,$51.00,$456.00,$198551.00,325,$456.00
2025-04-03,16:35:00,18902.25,SELL,3,0.02h,Stop Loss,$10.50,$466.50,$198561.50,325,$466.50
2025-04-03,16:44:00,18958.5,BUY,3,0.02h,Stop Loss,$10.50,$477.00,$198572.00,325,$477.00
2025-04-03,16:45:00,18916.0,SELL,3,0.02h,Stop Loss,$33.00,$510.00,$198605.00,325,$510.00
2025-04-03,17:38:00,18876.5,BUY,3,0.02h,Stop Loss,$96.00,$606.00,$198701.00,325,$606.00
2025-04-03,17:52:00,18846.5,SELL,3,0.02h,Break Even,$-1.50,$604.50,$198699.50,325,$604.50
2025-04-03,18:38:00,18803.25,BUY,3,0.02h,Stop Loss,$39.00,$643.50,$198738.50,325,$643.50
2025-04-03,19:12:00,18817.0,SELL,3,0.02h,Break Even,$-1.50,$642.00,$198737.00,325,$642.00
2025-04-03,20:56:00,18650.0,BUY,3,0.02h,Break Even,$-1.50,$640.50,$198735.50,325,$640.50
2025-04-03,22:15:00,18652.75,SELL,3,0.02h,Break Even,$-1.50,$639.00,$198734.00,325,$639.00
2025-04-03,22:16:00,18669.5,BUY,3,0.02h,Stop Loss,$-9.00,$630.00,$198725.00,325,$630.00
2025-04-03,22:18:00,18651.25,SELL,3,0.02h,Stop Loss,$34.50,$664.50,$198759.50,325,$664.50
2025-04-03,22:42:00,18642.5,BUY,3,0.02h,Break Even,$-1.50,$663.00,$198758.00,325,$663.00
,,,,,,,,,,,
2025-04-04,12:00:00,18127.75,SELL,3,0.02h,Stop Loss,$199.50,$199.50,$198957.50,326,$199.50
2025-04-04,12:34:00,18226.25,BUY,3,0.02h,Break Even,$-1.50,$198.00,$198956.00,326,$198.00
2025-04-04,12:39:00,18072.0,SELL,3,0.02h,Stop Loss,$60.00,$258.00,$199016.00,326,$258.00
2025-04-04,12:45:00,18200.0,BUY,3,0.02h,Stop Loss,$34.50,$292.50,$199050.50,326,$292.50
2025-04-04,13:16:00,18189.75,SELL,3,0.02h,Stop Loss,$213.00,$505.50,$199263.50,326,$505.50
2025-04-04,13:53:00,18144.5,BUY,3,0.02h,Stop Loss,$288.00,$793.50,$199551.50,326,$793.50
2025-04-04,13:56:00,18080.0,SELL,3,0.02h,Stop Loss,$57.00,$850.50,$199608.50,326,$850.50
2025-04-04,13:57:00,18143.5,BUY,3,0.02h,Stop Loss,$312.00,$1162.50,$199920.50,326,$1162.50
2025-04-04,14:08:00,18099.0,SELL,3,0.02h,Stop Loss,$178.50,$1341.00,$200099.00,326,$1341.00
2025-04-04,15:01:00,17876.25,BUY,3,0.02h,Stop Loss,$690.00,$2031.00,$200789.00,326,$2031.00
2025-04-04,15:29:00,17994.0,SELL,3,0.02h,Stop Loss,$351.00,$2382.00,$201140.00,326,$2382.00
2025-04-04,15:50:00,18001.0,BUY,3,0.02h,Break Even,$-1.50,$2380.50,$201138.50,326,$2380.50
2025-04-04,15:59:00,17889.75,SELL,3,0.02h,Stop Loss,$73.50,$2454.00,$201212.00,326,$2454.00
2025-04-04,16:42:00,17823.25,BUY,3,0.02h,Stop Loss,$64.50,$2518.50,$201276.50,326,$2518.50
2025-04-04,16:45:00,17755.75,SELL,3,0.02h,Stop Loss,$79.50,$2598.00,$201356.00,326,$2598.00
2025-04-04,17:03:00,17803.25,BUY,3,0.02h,Stop Loss,$15.00,$2613.00,$201371.00,326,$2613.00
2025-04-04,17:07:00,17732.75,SELL,3,0.02h,Break Even,$-1.50,$2611.50,$201369.50,326,$2611.50
2025-04-04,17:27:00,17735.25,BUY,3,0.02h,Stop Loss,$54.00,$2665.50,$201423.50,326,$2665.50
2025-04-04,17:32:00,17675.25,SELL,3,0.02h,Stop Loss,$22.50,$2688.00,$201446.00,326,$2688.00
2025-04-04,17:34:00,17725.75,BUY,3,0.02h,Stop Loss,$189.00,$2877.00,$201635.00,326,$2877.00
2025-04-04,18:11:00,17797.25,SELL,3,0.02h,Stop Loss,$135.00,$3012.00,$201770.00,326,$3012.00
2025-04-04,18:53:00,17665.0,BUY,3,0.02h,Stop Loss,$61.50,$3073.50,$201831.50,326,$3073.50
2025-04-04,19:01:00,17617.75,SELL,3,0.02h,Stop Loss,$187.50,$3261.00,$202019.00,326,$3261.00
2025-04-04,19:12:00,17661.75,BUY,3,0.02h,Stop Loss,$190.50,$3451.50,$202209.50,326,$3451.50
2025-04-04,19:49:00,17720.75,SELL,3,0.02h,Stop Loss,$88.50,$3540.00,$202298.00,326,$3540.00
2025-04-04,20:40:00,17484.0,BUY,3,0.02h,Stop Loss,$24.00,$3564.00,$202322.00,326,$3564.00
,,,,,,,,,,,
2025-04-07,12:00:00,17063.75,SELL,3,0.02h,Break Even,$-1.50,$-1.50,$202320.50,327,$-1.50
2025-04-07,12:30:00,17179.5,BUY,3,0.02h,Stop Loss,$295.50,$294.00,$202616.00,327,$294.00
2025-04-07,12:46:00,17013.75,SELL,3,0.02h,Stop Loss,$10.50,$304.50,$202626.50,327,$304.50
2025-04-07,12:53:00,17150.5,BUY,3,0.02h,Stop Loss,$175.50,$480.00,$202802.00,327,$480.00
2025-04-07,13:06:00,17114.25,SELL,3,0.02h,Stop Loss,$348.00,$828.00,$203150.00,327,$828.00
2025-04-07,13:51:00,16978.25,BUY,3,0.02h,Stop Loss,$280.50,$1108.50,$203430.50,327,$1108.50
2025-04-07,14:29:00,17392.5,SELL,3,0.02h,Stop Loss,$294.00,$1402.50,$203724.50,327,$1402.50
2025-04-07,14:51:00,17598.75,BUY,3,0.02h,Stop Loss,$43.50,$1446.00,$203768.00,327,$1446.00
2025-04-07,15:11:00,17551.25,SELL,3,0.02h,Stop Loss,$147.00,$1593.00,$203915.00,327,$1593.00
2025-04-07,15:39:00,17426.5,BUY,3,0.02h,Stop Loss,$9.00,$1602.00,$203924.00,327,$1602.00
2025-04-07,16:00:00,17390.75,SELL,3,0.02h,Stop Loss,$360.00,$1962.00,$204284.00,327,$1962.00
2025-04-07,16:27:00,17427.5,BUY,3,0.02h,Stop Loss,$15.00,$1977.00,$204299.00,327,$1977.00
2025-04-07,16:44:00,17327.75,SELL,3,0.02h,Stop Loss,$112.50,$2089.50,$204411.50,327,$2089.50
2025-04-07,17:02:00,17453.5,BUY,3,0.02h,Stop Loss,$3.00,$2092.50,$204414.50,327,$2092.50
2025-04-07,17:07:00,17297.25,SELL,3,0.02h,Stop Loss,$286.50,$2379.00,$204701.00,327,$2379.00
2025-04-07,17:13:00,17386.0,BUY,3,0.02h,Stop Loss,$180.00,$2559.00,$204881.00,327,$2559.00
2025-04-07,18:12:00,17680.0,SELL,3,0.02h,Stop Loss,$379.50,$2938.50,$205260.50,327,$2938.50
2025-04-07,18:19:00,17795.25,BUY,3,0.02h,Stop Loss,$40.50,$2979.00,$205301.00,327,$2979.00
2025-04-07,18:28:00,17652.5,SELL,3,0.02h,Stop Loss,$277.50,$3256.50,$205578.50,327,$3256.50
2025-04-07,18:40:00,17713.25,BUY,3,0.02h,Stop Loss,$172.50,$3429.00,$205751.00,327,$3429.00
2025-04-07,18:46:00,17653.5,SELL,3,0.02h,Stop Loss,$33.00,$3462.00,$205784.00,327,$3462.00
2025-04-07,19:34:00,17608.5,BUY,3,0.02h,Stop Loss,$169.50,$3631.50,$205953.50,327,$3631.50
2025-04-07,19:45:00,17461.5,SELL,3,0.02h,Stop Loss,$24.00,$3655.50,$205977.50,327,$3655.50
2025-04-07,19:58:00,17539.5,BUY,3,0.02h,Stop Loss,$139.50,$3795.00,$206117.00,327,$3795.00
2025-04-07,20:28:00,17652.25,SELL,3,0.02h,Stop Loss,$-9.00,$3786.00,$206108.00,327,$3786.00
2025-04-07,22:02:00,17682.0,BUY,3,0.02h,Stop Loss,$10.50,$3796.50,$206118.50,327,$3796.50
,,,,,,,,,,,
2025-04-08,12:37:00,17967.25,SELL,3,0.02h,Stop Loss,$-9.00,$-9.00,$206109.50,328,$-9.00
2025-04-08,12:59:00,17989.75,BUY,3,0.02h,Stop Loss,$18.00,$9.00,$206127.50,328,$9.00
2025-04-08,13:40:00,18103.25,SELL,3,0.02h,Stop Loss,$159.00,$168.00,$206286.50,328,$168.00
2025-04-08,13:44:00,18145.75,BUY,3,0.02h,Stop Loss,$57.00,$225.00,$206343.50,328,$225.00
2025-04-08,14:33:00,18287.25,SELL,3,0.02h,Stop Loss,$112.50,$337.50,$206456.00,328,$337.50
2025-04-08,14:35:00,18310.75,BUY,3,0.02h,Stop Loss,$67.50,$405.00,$206523.50,328,$405.00
2025-04-08,14:43:00,18274.75,SELL,3,0.02h,Stop Loss,$208.50,$613.50,$206732.00,328,$613.50
2025-04-08,15:39:00,18091.0,BUY,3,0.02h,Stop Loss,$66.00,$679.50,$206798.00,328,$679.50
2025-04-08,15:51:00,17998.25,SELL,3,0.02h,Stop Loss,$67.50,$747.00,$206865.50,328,$747.00
2025-04-08,16:13:00,18052.75,BUY,3,0.02h,Stop Loss,$69.00,$816.00,$206934.50,328,$816.00
2025-04-08,16:15:00,17999.75,SELL,3,0.02h,Stop Loss,$97.50,$913.50,$207032.00,328,$913.50
2025-04-08,17:41:00,17651.25,BUY,3,0.02h,Stop Loss,$166.50,$1080.00,$207198.50,328,$1080.00
2025-04-08,18:07:00,17595.5,SELL,3,0.02h,Stop Loss,$207.00,$1287.00,$207405.50,328,$1287.00
2025-04-08,18:21:00,17626.0,BUY,3,0.02h,Break Even,$-1.50,$1285.50,$207404.00,328,$1285.50
2025-04-08,18:22:00,17592.25,SELL,3,0.02h,Stop Loss,$94.50,$1380.00,$207498.50,328,$1380.00
2025-04-08,19:55:00,17227.5,BUY,3,0.02h,Stop Loss,$-9.00,$1371.00,$207489.50,328,$1371.00
2025-04-08,20:22:00,17214.75,SELL,3,0.02h,Stop Loss,$123.00,$1494.00,$207612.50,328,$1494.00
2025-04-08,20:47:00,17205.5,BUY,3,0.02h,Stop Loss,$63.00,$1557.00,$207675.50,328,$1557.00
2025-04-08,22:02:00,17167.25,SELL,3,0.02h,Stop Loss,$319.50,$1876.50,$207995.00,328,$1876.50
2025-04-08,22:47:00,17054.0,BUY,3,0.02h,Stop Loss,$9.00,$1885.50,$208004.00,328,$1885.50
,,,,,,,,,,,
2025-04-09,12:00:00,16958.0,SELL,3,0.02h,Stop Loss,$67.50,$67.50,$208071.50,329,$67.50
2025-04-09,12:43:00,16997.75,BUY,3,0.02h,Stop Loss,$159.00,$226.50,$208230.50,329,$226.50
2025-04-09,13:28:00,17191.5,SELL,3,0.02h,Stop Loss,$18.00,$244.50,$208248.50,329,$244.50
2025-04-09,13:31:00,17245.25,BUY,3,0.02h,Stop Loss,$481.50,$726.00,$208730.00,329,$726.00
2025-04-09,14:10:00,17399.5,SELL,3,0.02h,Stop Loss,$66.00,$792.00,$208796.00,329,$792.00
2025-04-09,14:25:00,17446.5,BUY,3,0.02h,Stop Loss,$120.00,$912.00,$208916.00,329,$912.00
2025-04-09,14:28:00,17404.75,SELL,3,0.02h,Stop Loss,$189.00,$1101.00,$209105.00,329,$1101.00
2025-04-09,14:31:00,17460.25,BUY,3,0.02h,Stop Loss,$313.50,$1414.50,$209418.50,329,$1414.50
2025-04-09,14:42:00,17431.75,SELL,3,0.02h,Stop Loss,$36.00,$1450.50,$209454.50,329,$1450.50
2025-04-09,15:10:00,17374.0,BUY,3,0.02h,Stop Loss,$63.00,$1513.50,$209517.50,329,$1513.50
2025-04-09,15:35:00,17353.75,SELL,3,0.02h,Stop Loss,$145.50,$1659.00,$209663.00,329,$1659.00
2025-04-09,15:51:00,17395.75,BUY,3,0.02h,Stop Loss,$28.50,$1687.50,$209691.50,329,$1687.50
2025-04-09,15:56:00,17324.75,SELL,3,0.02h,Stop Loss,$169.50,$1857.00,$209861.00,329,$1857.00
2025-04-09,16:09:00,17362.75,BUY,3,0.02h,Stop Loss,$151.50,$2008.50,$210012.50,329,$2008.50
2025-04-09,18:44:00,18914.75,SELL,3,0.02h,Stop Loss,$423.00,$2431.50,$210435.50,329,$2431.50
2025-04-09,19:11:00,18949.0,BUY,3,0.02h,Stop Loss,$156.00,$2587.50,$210591.50,329,$2587.50
2025-04-09,20:15:00,19244.5,SELL,3,0.02h,Break Even,$-1.50,$2586.00,$210590.00,329,$2586.00
2025-04-09,20:19:00,19298.0,BUY,3,0.02h,Break Even,$-1.50,$2584.50,$210588.50,329,$2584.50
2025-04-09,20:34:00,19285.75,SELL,3,0.02h,Stop Loss,$73.50,$2658.00,$210662.00,329,$2658.00
2025-04-09,20:35:00,19300.5,BUY,3,0.02h,Break Even,$-1.50,$2656.50,$210660.50,329,$2656.50
2025-04-09,20:36:00,19287.75,SELL,3,0.02h,Stop Loss,$-9.00,$2647.50,$210651.50,329,$2647.50
2025-04-09,20:37:00,19296.5,BUY,3,0.02h,Break Even,$-1.50,$2646.00,$210650.00,329,$2646.00
2025-04-09,22:02:00,19279.75,SELL,3,0.02h,Stop Loss,$64.50,$2710.50,$210714.50,329,$2710.50
2025-04-09,22:16:00,19316.5,BUY,3,0.02h,Stop Loss,$21.00,$2731.50,$210735.50,329,$2731.50
,,,,,,,,,,,
2025-04-10,12:00:00,18926.75,SELL,3,0.02h,Stop Loss,$139.50,$139.50,$210875.00,330,$139.50
2025-04-10,12:33:00,18926.75,BUY,3,0.02h,Stop Loss,$225.00,$364.50,$211100.00,330,$364.50
2025-04-10,12:38:00,18835.5,SELL,3,0.02h,Stop Loss,$129.00,$493.50,$211229.00,330,$493.50
2025-04-10,13:02:00,18825.25,BUY,3,0.02h,Stop Loss,$96.00,$589.50,$211325.00,330,$589.50
2025-04-10,13:29:00,18785.5,SELL,3,0.02h,Break Even,$-1.50,$588.00,$211323.50,330,$588.00
2025-04-10,13:51:00,18844.25,BUY,3,0.02h,Stop Loss,$15.00,$603.00,$211338.50,330,$603.00
2025-04-10,13:52:00,18767.0,SELL,3,0.02h,Stop Loss,$141.00,$744.00,$211479.50,330,$744.00
2025-04-10,14:25:00,18705.25,BUY,3,0.02h,Stop Loss,$118.50,$862.50,$211598.00,330,$862.50
2025-04-10,14:49:00,18665.5,SELL,3,0.02h,Stop Loss,$138.00,$1000.50,$211736.00,330,$1000.50
2025-04-10,16:36:00,18137.5,BUY,3,0.02h,Stop Loss,$256.50,$1257.00,$211992.50,330,$1257.00
2025-04-10,17:11:00,18168.5,SELL,3,0.02h,Stop Loss,$193.50,$1450.50,$212186.00,330,$1450.50
2025-04-10,17:28:00,18256.5,BUY,3,0.02h,Stop Loss,$148.50,$1599.00,$212334.50,330,$1599.00
2025-04-10,18:12:00,18373.0,SELL,3,0.02h,Stop Loss,$73.50,$1672.50,$212408.00,330,$1672.50
2025-04-10,18:23:00,18544.0,BUY,3,0.02h,Stop Loss,$84.00,$1756.50,$212492.00,330,$1756.50
2025-04-10,18:52:00,18552.25,SELL,3,0.02h,Stop Loss,$330.00,$2086.50,$212822.00,330,$2086.50
2025-04-10,19:02:00,18616.75,BUY,3,0.02h,Stop Loss,$220.50,$2307.00,$213042.50,330,$2307.00
2025-04-10,19:09:00,18489.25,SELL,3,0.02h,Stop Loss,$180.00,$2487.00,$213222.50,330,$2487.00
2025-04-10,19:22:00,18595.5,BUY,3,0.02h,Stop Loss,$39.00,$2526.00,$213261.50,330,$2526.00
2025-04-10,19:26:00,18507.5,SELL,3,0.02h,Stop Loss,$169.50,$2695.50,$213431.00,330,$2695.50
2025-04-10,19:54:00,18468.5,BUY,3,0.02h,Stop Loss,$346.50,$3042.00,$213777.50,330,$3042.00
2025-04-10,20:23:00,18489.75,SELL,3,0.02h,Break Even,$-1.50,$3040.50,$213776.00,330,$3040.50
2025-04-10,20:53:00,18488.5,BUY,3,0.02h,Stop Loss,$-9.00,$3031.50,$213767.00,330,$3031.50
2025-04-10,22:27:00,18512.75,SELL,3,0.02h,Break Even,$-1.50,$3030.00,$213765.50,330,$3030.00
2025-04-10,22:28:00,18530.5,BUY,3,0.02h,Break Even,$-1.50,$3028.50,$213764.00,330,$3028.50
2025-04-10,22:54:00,18547.75,SELL,3,0.02h,Break Even,$-1.50,$3027.00,$213762.50,330,$3027.00
,,,,,,,,,,,
2025-04-11,12:01:00,18576.75,BUY,3,0.02h,Stop Loss,$40.50,$40.50,$213803.00,331,$40.50
2025-04-11,12:22:00,18558.25,SELL,3,0.02h,Stop Loss,$177.00,$217.50,$213980.00,331,$217.50
2025-04-11,12:31:00,18591.75,BUY,3,0.02h,Stop Loss,$91.50,$309.00,$214071.50,331,$309.00
2025-04-11,12:47:00,18572.25,SELL,3,0.02h,Stop Loss,$213.00,$522.00,$214284.50,331,$522.00
2025-04-11,13:40:00,18506.5,BUY,3,0.02h,Stop Loss,$37.50,$559.50,$214322.00,331,$559.50
2025-04-11,14:03:00,18484.5,SELL,3,0.02h,Stop Loss,$292.50,$852.00,$214614.50,331,$852.00
2025-04-11,14:09:00,18568.0,BUY,3,0.02h,Stop Loss,$166.50,$1018.50,$214781.00,331,$1018.50
2025-04-11,14:13:00,18482.75,SELL,3,0.02h,Stop Loss,$42.00,$1060.50,$214823.00,331,$1060.50
2025-04-11,14:16:00,18573.0,BUY,3,0.02h,Stop Loss,$57.00,$1117.50,$214880.00,331,$1117.50
2025-04-11,14:18:00,18475.0,SELL,3,0.02h,Stop Loss,$129.00,$1246.50,$215009.00,331,$1246.50
2025-04-11,14:39:00,18442.0,BUY,3,0.02h,Stop Loss,$178.50,$1425.00,$215187.50,331,$1425.00
2025-04-11,15:00:00,18413.5,SELL,3,0.02h,Stop Loss,$79.50,$1504.50,$215267.00,331,$1504.50
2025-04-11,15:30:00,18414.25,BUY,3,0.02h,Stop Loss,$108.00,$1612.50,$215375.00,331,$1612.50
2025-04-11,16:27:00,18551.75,SELL,3,0.02h,Stop Loss,$12.00,$1624.50,$215387.00,331,$1624.50
2025-04-11,16:32:00,18632.0,BUY,3,0.02h,Stop Loss,$105.00,$1729.50,$215492.00,331,$1729.50
2025-04-11,17:11:00,18715.0,SELL,3,0.02h,Stop Loss,$132.00,$1861.50,$215624.00,331,$1861.50
2025-04-11,17:40:00,18737.5,BUY,3,0.02h,Stop Loss,$312.00,$2173.50,$215936.00,331,$2173.50
2025-04-11,18:10:00,18780.0,SELL,3,0.02h,Stop Loss,$150.00,$2323.50,$216086.00,331,$2323.50
2025-04-11,18:14:00,18804.75,BUY,3,0.02h,Stop Loss,$18.00,$2341.50,$216104.00,331,$2341.50
2025-04-11,18:15:00,18793.0,SELL,3,0.02h,Stop Loss,$6.00,$2347.50,$216110.00,331,$2347.50
2025-04-11,18:16:00,18809.75,BUY,3,0.02h,Stop Loss,$9.00,$2356.50,$216119.00,331,$2356.50
2025-04-11,18:17:00,18791.0,SELL,3,0.02h,Stop Loss,$181.50,$2538.00,$216300.50,331,$2538.00
2025-04-11,18:37:00,18794.75,BUY,3,0.02h,Stop Loss,$63.00,$2601.00,$216363.50,331,$2601.00
2025-04-11,18:54:00,18780.75,SELL,3,0.02h,Break Even,$-1.50,$2599.50,$216362.00,331,$2599.50
2025-04-11,18:55:00,18787.0,BUY,3,0.02h,Stop Loss,$61.50,$2661.00,$216423.50,331,$2661.00
2025-04-11,18:56:00,18773.0,SELL,3,0.02h,Stop Loss,$123.00,$2784.00,$216546.50,331,$2784.00
2025-04-11,19:04:00,18802.5,BUY,3,0.02h,Stop Loss,$60.00,$2844.00,$216606.50,331,$2844.00
2025-04-11,19:36:00,18810.0,SELL,3,0.02h,Break Even,$-1.50,$2842.50,$216605.00,331,$2842.50
2025-04-11,19:45:00,18841.0,BUY,3,0.02h,Stop Loss,$12.00,$2854.50,$216617.00,331,$2854.50
2025-04-11,19:46:00,18815.0,SELL,3,0.02h,Stop Loss,$13.50,$2868.00,$216630.50,331,$2868.00
2025-04-11,19:48:00,18831.25,BUY,3,0.02h,Break Even,$-1.50,$2866.50,$216629.00,331,$2866.50
2025-04-11,19:49:00,18812.0,SELL,3,0.02h,Stop Loss,$46.50,$2913.00,$216675.50,331,$2913.00
2025-04-11,19:56:00,18833.25,BUY,3,0.02h,Stop Loss,$67.50,$2980.50,$216743.00,331,$2980.50
2025-04-11,20:00:00,18808.75,SELL,3,0.02h,Stop Loss,$72.00,$3052.50,$216815.00,331,$3052.50
2025-04-11,20:18:00,18826.25,BUY,3,0.02h,Break Even,$-1.50,$3051.00,$216813.50,331,$3051.00
2025-04-11,20:58:00,18810.75,SELL,3,0.02h,Stop Loss,$-9.00,$3042.00,$216804.50,331,$3042.00
,,,,,,,,,,,
2025-04-14,12:00:00,19072.0,BUY,3,0.02h,Stop Loss,$139.50,$139.50,$216944.00,332,$139.50
2025-04-14,13:34:00,19183.5,SELL,3,0.02h,Stop Loss,$48.00,$187.50,$216992.00,332,$187.50
2025-04-14,14:04:00,19135.0,BUY,3,0.02h,Stop Loss,$129.00,$316.50,$217121.00,332,$316.50
2025-04-14,14:16:00,19068.25,SELL,3,0.02h,Stop Loss,$105.00,$421.50,$217226.00,332,$421.50
2025-04-14,14:26:00,19105.75,BUY,3,0.02h,Stop Loss,$112.50,$534.00,$217338.50,332,$534.00
2025-04-14,14:59:00,19125.75,SELL,3,0.02h,Break Even,$-1.50,$532.50,$217337.00,332,$532.50
2025-04-14,16:21:00,18858.0,BUY,3,0.02h,Stop Loss,$231.00,$763.50,$217568.00,332,$763.50
2025-04-14,16:28:00,18793.0,SELL,3,0.02h,Break Even,$-1.50,$762.00,$217566.50,332,$762.00
2025-04-14,16:34:00,18869.75,BUY,3,0.02h,Stop Loss,$61.50,$823.50,$217628.00,332,$823.50
2025-04-14,16:52:00,18826.25,SELL,3,0.02h,Stop Loss,$54.00,$877.50,$217682.00,332,$877.50
2025-04-14,17:14:00,18852.5,BUY,3,0.02h,Stop Loss,$-9.00,$868.50,$217673.00,332,$868.50
2025-04-14,17:17:00,18815.25,SELL,3,0.02h,Break Even,$-1.50,$867.00,$217671.50,332,$867.00
2025-04-14,17:19:00,18869.75,BUY,3,0.02h,Stop Loss,$16.50,$883.50,$217688.00,332,$883.50
2025-04-14,17:41:00,18856.5,SELL,3,0.02h,Stop Loss,$9.00,$892.50,$217697.00,332,$892.50
2025-04-14,17:43:00,18893.25,BUY,3,0.02h,Stop Loss,$16.50,$909.00,$217713.50,332,$909.00
2025-04-14,17:47:00,18857.75,SELL,3,0.02h,Stop Loss,$91.50,$1000.50,$217805.00,332,$1000.50
2025-04-14,17:51:00,18880.5,BUY,3,0.02h,Stop Loss,$96.00,$1096.50,$217901.00,332,$1096.50
2025-04-14,19:27:00,19034.75,SELL,3,0.02h,Stop Loss,$3.00,$1099.50,$217904.00,332,$1099.50
2025-04-14,19:41:00,19066.5,BUY,3,0.02h,Break Even,$-1.50,$1098.00,$217902.50,332,$1098.00
2025-04-14,19:49:00,19022.5,SELL,3,0.02h,Stop Loss,$82.50,$1180.50,$217985.00,332,$1180.50
2025-04-14,20:39:00,18887.75,BUY,3,0.02h,Stop Loss,$54.00,$1234.50,$218039.00,332,$1234.50
2025-04-14,22:06:00,18881.75,SELL,3,0.02h,Stop Loss,$-9.00,$1225.50,$218030.00,332,$1225.50
2025-04-14,22:27:00,18885.5,BUY,3,0.02h,Stop Loss,$-9.00,$1216.50,$218021.00,332,$1216.50
2025-04-14,22:28:00,18877.25,SELL,3,0.02h,Stop Loss,$15.00,$1231.50,$218036.00,332,$1231.50
,,,,,,,,,,,
2025-04-15,12:01:00,18885.75,BUY,3,0.02h,Stop Loss,$51.00,$51.00,$218087.00,333,$51.00
2025-04-15,12:22:00,18863.5,SELL,3,0.02h,Stop Loss,$10.50,$61.50,$218097.50,333,$61.50
2025-04-15,12:38:00,18890.0,BUY,3,0.02h,Stop Loss,$30.00,$91.50,$218127.50,333,$91.50
2025-04-15,14:18:00,19049.75,SELL,3,0.02h,Stop Loss,$214.50,$306.00,$218342.00,333,$306.00
2025-04-15,14:44:00,19070.0,BUY,3,0.02h,Stop Loss,$25.50,$331.50,$218367.50,333,$331.50
2025-04-15,14:52:00,19023.25,SELL,3,0.02h,Stop Loss,$60.00,$391.50,$218427.50,333,$391.50
2025-04-15,14:55:00,19034.75,BUY,3,0.02h,Stop Loss,$63.00,$454.50,$218490.50,333,$454.50
2025-04-15,15:10:00,19030.75,SELL,3,0.02h,Stop Loss,$94.50,$549.00,$218585.00,333,$549.00
2025-04-15,15:11:00,19042.25,BUY,3,0.02h,Stop Loss,$31.50,$580.50,$218616.50,333,$580.50
2025-04-15,15:12:00,19016.5,SELL,3,0.02h,Break Even,$-1.50,$579.00,$218615.00,333,$579.00
2025-04-15,15:13:00,19054.5,BUY,3,0.02h,Break Even,$-1.50,$577.50,$218613.50,333,$577.50
2025-04-15,15:28:00,19029.75,SELL,3,0.02h,Stop Loss,$58.50,$636.00,$218672.00,333,$636.00
2025-04-15,15:55:00,19048.5,BUY,3,0.02h,Stop Loss,$-9.00,$627.00,$218663.00,333,$627.00
2025-04-15,16:38:00,19053.0,SELL,3,0.02h,Stop Loss,$43.50,$670.50,$218706.50,333,$670.50
2025-04-15,16:48:00,19069.0,BUY,3,0.02h,Stop Loss,$-9.00,$661.50,$218697.50,333,$661.50
2025-04-15,16:49:00,19052.25,SELL,3,0.02h,Stop Loss,$31.50,$693.00,$218729.00,333,$693.00
2025-04-15,17:40:00,18968.0,BUY,3,0.02h,Stop Loss,$97.50,$790.50,$218826.50,333,$790.50
2025-04-15,17:54:00,18920.25,SELL,3,0.02h,Stop Loss,$9.00,$799.50,$218835.50,333,$799.50
2025-04-15,18:32:00,18934.0,BUY,3,0.02h,Stop Loss,$51.00,$850.50,$218886.50,333,$850.50
2025-04-15,19:26:00,18955.0,SELL,3,0.02h,Stop Loss,$31.50,$882.00,$218918.00,333,$882.00
2025-04-15,19:53:00,18979.25,BUY,3,0.02h,Break Even,$-1.50,$880.50,$218916.50,333,$880.50
2025-04-15,20:15:00,18960.25,SELL,3,0.02h,Stop Loss,$9.00,$889.50,$218925.50,333,$889.50
2025-04-15,22:33:00,18776.25,BUY,3,0.02h,Stop Loss,$-9.00,$880.50,$218916.50,333,$880.50
2025-04-15,22:51:00,18752.75,SELL,3,0.02h,Stop Loss,$19.50,$900.00,$218936.00,333,$900.00
,,,,,,,,,,,
2025-04-16,13:33:00,18644.5,BUY,3,0.02h,Stop Loss,$72.00,$72.00,$219008.00,334,$72.00
2025-04-16,13:47:00,18599.25,SELL,3,0.02h,Stop Loss,$31.50,$103.50,$219039.50,334,$103.50
2025-04-16,14:11:00,18596.75,BUY,3,0.02h,Stop Loss,$3.00,$106.50,$219042.50,334,$106.50
2025-04-16,14:15:00,18552.0,SELL,3,0.02h,Stop Loss,$13.50,$120.00,$219056.00,334,$120.00
2025-04-16,14:23:00,18592.0,BUY,3,0.02h,Stop Loss,$3.00,$123.00,$219059.00,334,$123.00
2025-04-16,14:57:00,18601.25,SELL,3,0.02h,Stop Loss,$-9.00,$114.00,$219050.00,334,$114.00
2025-04-16,15:01:00,18639.75,BUY,3,0.02h,Stop Loss,$7.50,$121.50,$219057.50,334,$121.50
2025-04-16,15:03:00,18614.25,SELL,3,0.02h,Stop Loss,$27.00,$148.50,$219084.50,334,$148.50
2025-04-16,15:11:00,18626.25,BUY,3,0.02h,Stop Loss,$46.50,$195.00,$219131.00,334,$195.00
2025-04-16,15:17:00,18613.5,SELL,3,0.02h,Break Even,$-1.50,$193.50,$219129.50,334,$193.50
2025-04-16,15:23:00,18663.75,BUY,3,0.02h,Stop Loss,$49.50,$243.00,$219179.00,334,$243.00
2025-04-16,15:43:00,18654.75,SELL,3,0.02h,Stop Loss,$49.50,$292.50,$219228.50,334,$292.50
2025-04-16,16:27:00,18602.5,BUY,3,0.02h,Break Even,$-1.50,$291.00,$219227.00,334,$291.00
2025-04-16,16:38:00,18573.5,SELL,3,0.02h,Stop Loss,$27.00,$318.00,$219254.00,334,$318.00
2025-04-16,17:19:00,18576.75,BUY,3,0.02h,Stop Loss,$39.00,$357.00,$219293.00,334,$357.00
2025-04-16,17:32:00,18485.5,SELL,3,0.02h,Stop Loss,$84.00,$441.00,$219377.00,334,$441.00
2025-04-16,18:25:00,18363.5,BUY,3,0.02h,Stop Loss,$4.50,$445.50,$219381.50,334,$445.50
2025-04-16,18:33:00,18339.25,SELL,3,0.02h,Stop Loss,$57.00,$502.50,$219438.50,334,$502.50
2025-04-16,19:35:00,18192.5,BUY,3,0.02h,Stop Loss,$63.00,$565.50,$219501.50,334,$565.50
2025-04-16,20:43:00,18401.75,SELL,3,0.02h,Stop Loss,$16.50,$582.00,$219518.00,334,$582.00
2025-04-16,22:03:00,18418.5,BUY,3,0.02h,Stop Loss,$18.00,$600.00,$219536.00,334,$600.00
2025-04-16,22:17:00,18374.0,SELL,3,0.02h,Break Even,$-1.50,$598.50,$219534.50,334,$598.50
2025-04-16,22:30:00,18400.5,BUY,3,0.02h,Stop Loss,$12.00,$610.50,$219546.50,334,$610.50
,,,,,,,,,,,
2025-04-17,12:47:00,18537.75,SELL,3,0.02h,Stop Loss,$18.00,$18.00,$219564.50,335,$18.00
2025-04-17,12:50:00,18553.25,BUY,3,0.02h,Stop Loss,$39.00,$57.00,$219603.50,335,$57.00
2025-04-17,12:57:00,18535.25,SELL,3,0.02h,Stop Loss,$34.50,$91.50,$219638.00,335,$91.50
2025-04-17,13:22:00,18528.25,BUY,3,0.02h,Stop Loss,$61.50,$153.00,$219699.50,335,$153.00
2025-04-17,13:28:00,18486.25,SELL,3,0.02h,Stop Loss,$-9.00,$144.00,$219690.50,335,$144.00
2025-04-17,13:53:00,18485.75,BUY,3,0.02h,Stop Loss,$39.00,$183.00,$219729.50,335,$183.00
2025-04-17,14:07:00,18424.5,SELL,3,0.02h,Stop Loss,$225.00,$408.00,$219954.50,335,$408.00
2025-04-17,14:47:00,18355.0,BUY,3,0.02h,Stop Loss,$22.50,$430.50,$219977.00,335,$430.50
2025-04-17,14:53:00,18315.0,SELL,3,0.02h,Stop Loss,$6.00,$436.50,$219983.00,335,$436.50
2025-04-17,15:07:00,18389.0,BUY,3,0.02h,Stop Loss,$159.00,$595.50,$220142.00,335,$595.50
2025-04-17,15:29:00,18341.75,SELL,3,0.02h,Stop Loss,$60.00,$655.50,$220202.00,335,$655.50
2025-04-17,15:38:00,18416.75,BUY,3,0.02h,Stop Loss,$10.50,$666.00,$220212.50,335,$666.00
2025-04-17,15:44:00,18371.0,SELL,3,0.02h,Stop Loss,$78.00,$744.00,$220290.50,335,$744.00
2025-04-17,16:08:00,18398.75,BUY,3,0.02h,Stop Loss,$175.50,$919.50,$220466.00,335,$919.50
2025-04-17,16:43:00,18412.75,SELL,3,0.02h,Stop Loss,$171.00,$1090.50,$220637.00,335,$1090.50
2025-04-17,16:53:00,18452.25,BUY,3,0.02h,Stop Loss,$25.50,$1116.00,$220662.50,335,$1116.00
2025-04-17,17:12:00,18427.0,SELL,3,0.02h,Stop Loss,$25.50,$1141.50,$220688.00,335,$1141.50
2025-04-17,17:37:00,18421.25,BUY,3,0.02h,Break Even,$-1.50,$1140.00,$220686.50,335,$1140.00
2025-04-17,17:44:00,18398.5,SELL,3,0.02h,Break Even,$-1.50,$1138.50,$220685.00,335,$1138.50
2025-04-17,17:45:00,18410.25,BUY,3,0.02h,Stop Loss,$70.50,$1209.00,$220755.50,335,$1209.00
2025-04-17,18:43:00,18484.75,SELL,3,0.02h,Break Even,$-1.50,$1207.50,$220754.00,335,$1207.50
2025-04-17,19:36:00,18398.5,BUY,3,0.02h,Stop Loss,$57.00,$1264.50,$220811.00,335,$1264.50
2025-04-17,19:47:00,18380.0,SELL,3,0.02h,Stop Loss,$67.50,$1332.00,$220878.50,335,$1332.00
2025-04-17,20:02:00,18408.25,BUY,3,0.02h,Break Even,$-1.50,$1330.50,$220877.00,335,$1330.50
2025-04-17,20:32:00,18404.5,SELL,3,0.02h,Stop Loss,$10.50,$1341.00,$220887.50,335,$1341.00
2025-04-17,20:37:00,18410.5,BUY,3,0.02h,Stop Loss,$10.50,$1351.50,$220898.00,335,$1351.50
,,,,,,,,,,,
2025-04-21,12:00:00,18106.0,SELL,3,0.02h,Stop Loss,$28.50,$28.50,$220926.50,336,$28.50
2025-04-21,12:41:00,18138.0,BUY,3,0.02h,Break Even,$-1.50,$27.00,$220925.00,336,$27.00
2025-04-21,12:48:00,18122.5,SELL,3,0.02h,Break Even,$-1.50,$25.50,$220923.50,336,$25.50
2025-04-21,12:51:00,18131.75,BUY,3,0.02h,Stop Loss,$-9.00,$16.50,$220914.50,336,$16.50
2025-04-21,12:52:00,18123.25,SELL,3,0.02h,Stop Loss,$21.00,$37.50,$220935.50,336,$37.50
2025-04-21,13:29:00,18118.75,BUY,3,0.02h,Stop Loss,$43.50,$81.00,$220979.00,336,$81.00
2025-04-21,13:39:00,18090.0,SELL,3,0.02h,Stop Loss,$42.00,$123.00,$221021.00,336,$123.00
2025-04-21,14:38:00,17963.5,BUY,3,0.02h,Break Even,$-1.50,$121.50,$221019.50,336,$121.50
2025-04-21,14:48:00,17925.25,SELL,3,0.02h,Stop Loss,$36.00,$157.50,$221055.50,336,$157.50
2025-04-21,16:07:00,17826.0,BUY,3,0.02h,Stop Loss,$-9.00,$148.50,$221046.50,336,$148.50
2025-04-21,16:28:00,17812.5,SELL,3,0.02h,Stop Loss,$30.00,$178.50,$221076.50,336,$178.50
2025-04-21,16:32:00,17836.25,BUY,3,0.02h,Stop Loss,$63.00,$241.50,$221139.50,336,$241.50
2025-04-21,16:51:00,17829.0,SELL,3,0.02h,Stop Loss,$33.00,$274.50,$221172.50,336,$274.50
2025-04-21,18:14:00,17725.0,BUY,3,0.02h,Stop Loss,$33.00,$307.50,$221205.50,336,$307.50
2025-04-21,18:43:00,17733.5,SELL,3,0.02h,Stop Loss,$12.00,$319.50,$221217.50,336,$319.50
2025-04-21,19:03:00,17745.25,BUY,3,0.02h,Stop Loss,$6.00,$325.50,$221223.50,336,$325.50
2025-04-21,22:02:00,17903.25,SELL,3,0.02h,Stop Loss,$28.50,$354.00,$221252.00,336,$354.00
2025-04-21,22:36:00,17898.75,BUY,3,0.02h,Stop Loss,$49.50,$403.50,$221301.50,336,$403.50
2025-04-21,22:57:00,17896.5,SELL,3,0.02h,Break Even,$-1.50,$402.00,$221300.00,336,$402.00
,,,,,,,,,,,
2025-04-22,12:00:00,18055.25,BUY,3,0.02h,Stop Loss,$48.00,$48.00,$221348.00,337,$48.00
2025-04-22,13:35:00,18111.25,SELL,3,0.02h,Stop Loss,$45.00,$93.00,$221393.00,337,$93.00
2025-04-22,13:40:00,18153.0,BUY,3,0.02h,Stop Loss,$69.00,$162.00,$221462.00,337,$162.00
2025-04-22,15:30:00,18352.0,SELL,3,0.02h,Stop Loss,$61.50,$223.50,$221523.50,337,$223.50
2025-04-22,16:00:00,18379.0,BUY,3,0.02h,Stop Loss,$325.50,$549.00,$221849.00,337,$549.00
2025-04-22,16:42:00,18451.25,SELL,3,0.02h,Break Even,$-1.50,$547.50,$221847.50,337,$547.50
2025-04-22,17:09:00,18480.75,BUY,3,0.02h,Stop Loss,$52.50,$600.00,$221900.00,337,$600.00
2025-04-22,17:11:00,18415.0,SELL,3,0.02h,Stop Loss,$192.00,$792.00,$222092.00,337,$792.00
2025-04-22,18:06:00,18295.25,BUY,3,0.02h,Stop Loss,$51.00,$843.00,$222143.00,337,$843.00
2025-04-22,19:09:00,18365.0,SELL,3,0.02h,Stop Loss,$15.00,$858.00,$222158.00,337,$858.00
2025-04-22,19:45:00,18324.25,BUY,3,0.02h,Stop Loss,$120.00,$978.00,$222278.00,337,$978.00
2025-04-22,20:19:00,18359.25,SELL,3,0.02h,Stop Loss,$30.00,$1008.00,$222308.00,337,$1008.00
2025-04-22,20:28:00,18367.25,BUY,3,0.02h,Break Even,$-1.50,$1006.50,$222306.50,337,$1006.50
2025-04-22,20:47:00,18361.75,SELL,3,0.02h,Break Even,$-1.50,$1005.00,$222305.00,337,$1005.00
2025-04-22,22:01:00,18684.0,BUY,3,0.02h,Stop Loss,$132.00,$1137.00,$222437.00,337,$1137.00
,,,,,,,,,,,
2025-04-23,13:07:00,18926.5,SELL,3,0.02h,Stop Loss,$6.00,$6.00,$222443.00,338,$6.00
2025-04-23,13:22:00,18945.0,BUY,3,0.02h,Stop Loss,$13.50,$19.50,$222456.50,338,$19.50
2025-04-23,14:18:00,18996.0,SELL,3,0.02h,Stop Loss,$82.50,$102.00,$222539.00,338,$102.00
2025-04-23,14:26:00,19076.25,BUY,3,0.02h,Stop Loss,$160.50,$262.50,$222699.50,338,$262.50
2025-04-23,14:51:00,19076.5,SELL,3,0.02h,Stop Loss,$7.50,$270.00,$222707.00,338,$270.00
2025-04-23,16:32:00,18842.0,BUY,3,0.02h,Stop Loss,$-9.00,$261.00,$222698.00,338,$261.00
2025-04-23,17:33:00,18925.25,SELL,3,0.02h,Stop Loss,$105.00,$366.00,$222803.00,338,$366.00
2025-04-23,17:55:00,18925.5,BUY,3,0.02h,Stop Loss,$36.00,$402.00,$222839.00,338,$402.00
2025-04-23,18:26:00,18893.75,SELL,3,0.02h,Stop Loss,$63.00,$465.00,$222902.00,338,$465.00
2025-04-23,18:59:00,18896.75,BUY,3,0.02h,Break Even,$-1.50,$463.50,$222900.50,338,$463.50
2025-04-23,19:00:00,18869.75,SELL,3,0.02h,Stop Loss,$37.50,$501.00,$222938.00,338,$501.00
2025-04-23,19:51:00,18824.25,BUY,3,0.02h,Break Even,$-1.50,$499.50,$222936.50,338,$499.50
2025-04-23,20:04:00,18779.0,SELL,3,0.02h,Stop Loss,$-9.00,$490.50,$222927.50,338,$490.50
2025-04-23,20:11:00,18812.0,BUY,3,0.02h,Stop Loss,$22.50,$513.00,$222950.00,338,$513.00
2025-04-23,20:45:00,18850.75,SELL,3,0.02h,Break Even,$-1.50,$511.50,$222948.50,338,$511.50
2025-04-23,22:32:00,18781.0,BUY,3,0.02h,Stop Loss,$33.00,$544.50,$222981.50,338,$544.50
,,,,,,,,,,,
2025-04-24,12:00:00,18770.0,SELL,3,0.02h,Break Even,$-1.50,$-1.50,$222980.00,339,$-1.50
2025-04-24,12:16:00,18813.25,BUY,3,0.02h,Break Even,$-1.50,$-3.00,$222978.50,339,$-3.00
2025-04-24,12:29:00,18796.25,SELL,3,0.02h,Stop Loss,$28.50,$25.50,$223007.00,339,$25.50
2025-04-24,12:32:00,18823.0,BUY,3,0.02h,Stop Loss,$19.50,$45.00,$223026.50,339,$45.00
2025-04-24,12:34:00,18799.0,SELL,3,0.02h,Stop Loss,$-9.00,$36.00,$223017.50,339,$36.00
2025-04-24,12:35:00,18816.0,BUY,3,0.02h,Stop Loss,$18.00,$54.00,$223035.50,339,$54.00
2025-04-24,13:07:00,18829.0,SELL,3,0.02h,Stop Loss,$13.50,$67.50,$223049.00,339,$67.50
2025-04-24,13:20:00,18840.0,BUY,3,0.02h,Stop Loss,$-9.00,$58.50,$223040.00,339,$58.50
2025-04-24,14:48:00,19097.5,SELL,3,0.02h,Stop Loss,$39.00,$97.50,$223079.00,339,$97.50
2025-04-24,14:57:00,19143.25,BUY,3,0.02h,Stop Loss,$9.00,$106.50,$223088.00,339,$106.50
2025-04-24,15:26:00,19154.0,SELL,3,0.02h,Stop Loss,$-9.00,$97.50,$223079.00,339,$97.50
2025-04-24,15:39:00,19176.0,BUY,3,0.02h,Break Even,$-1.50,$96.00,$223077.50,339,$96.00
2025-04-24,15:45:00,19153.0,SELL,3,0.02h,Stop Loss,$31.50,$127.50,$223109.00,339,$127.50
2025-04-24,15:50:00,19173.75,BUY,3,0.02h,Break Even,$-1.50,$126.00,$223107.50,339,$126.00
2025-04-24,16:02:00,19158.75,SELL,3,0.02h,Stop Loss,$51.00,$177.00,$223158.50,339,$177.00
2025-04-24,16:14:00,19185.25,BUY,3,0.02h,Stop Loss,$25.50,$202.50,$223184.00,339,$202.50
2025-04-24,17:17:00,19226.75,SELL,3,0.02h,Stop Loss,$61.50,$264.00,$223245.50,339,$264.00
2025-04-24,17:27:00,19255.0,BUY,3,0.02h,Stop Loss,$21.00,$285.00,$223266.50,339,$285.00
2025-04-24,17:38:00,19242.0,SELL,3,0.02h,Stop Loss,$-9.00,$276.00,$223257.50,339,$276.00
2025-04-24,17:39:00,19249.25,BUY,3,0.02h,Stop Loss,$-9.00,$267.00,$223248.50,339,$267.00
2025-04-24,17:41:00,19237.25,SELL,3,0.02h,Stop Loss,$66.00,$333.00,$223314.50,339,$333.00
2025-04-24,17:51:00,19247.25,BUY,3,0.02h,Stop Loss,$6.00,$339.00,$223320.50,339,$339.00
2025-04-24,19:00:00,19292.5,SELL,3,0.02h,Stop Loss,$55.50,$394.50,$223376.00,339,$394.50
2025-04-24,19:38:00,19274.25,BUY,3,0.02h,Stop Loss,$22.50,$417.00,$223398.50,339,$417.00
2025-04-24,20:20:00,19333.25,SELL,3,0.02h,Stop Loss,$10.50,$427.50,$223409.00,339,$427.50
2025-04-24,20:27:00,19344.75,BUY,3,0.02h,Stop Loss,$21.00,$448.50,$223430.00,339,$448.50
2025-04-24,20:31:00,19327.0,SELL,3,0.02h,Stop Loss,$-9.00,$439.50,$223421.00,339,$439.50
2025-04-24,20:36:00,19346.0,BUY,3,0.02h,Stop Loss,$3.00,$442.50,$223424.00,339,$442.50
2025-04-24,20:58:00,19349.0,SELL,3,0.02h,Break Even,$-1.50,$441.00,$223422.50,339,$441.00
2025-04-24,22:01:00,19379.0,BUY,3,0.02h,Stop Loss,$10.50,$451.50,$223433.00,339,$451.50
2025-04-24,22:58:00,19402.75,SELL,3,0.02h,Stop Loss,$21.00,$472.50,$223454.00,339,$472.50
,,,,,,,,,,,
2025-04-25,12:38:00,19278.75,BUY,3,0.02h,Stop Loss,$34.50,$34.50,$223488.50,340,$34.50
2025-04-25,12:46:00,19270.25,SELL,3,0.02h,Stop Loss,$49.50,$84.00,$223538.00,340,$84.00
2025-04-25,13:10:00,19258.5,BUY,3,0.02h,Stop Loss,$4.50,$88.50,$223542.50,340,$88.50
2025-04-25,13:48:00,19275.5,SELL,3,0.02h,Stop Loss,$4.50,$93.00,$223547.00,340,$93.00
2025-04-25,14:02:00,19321.25,BUY,3,0.02h,Stop Loss,$108.00,$201.00,$223655.00,340,$201.00
2025-04-25,14:23:00,19271.5,SELL,3,0.02h,Stop Loss,$91.50,$292.50,$223746.50,340,$292.50
2025-04-25,14:40:00,19331.5,BUY,3,0.02h,Stop Loss,$132.00,$424.50,$223878.50,340,$424.50
2025-04-25,14:59:00,19308.5,SELL,3,0.02h,Break Even,$-1.50,$423.00,$223877.00,340,$423.00
2025-04-25,15:05:00,19347.0,BUY,3,0.02h,Stop Loss,$43.50,$466.50,$223920.50,340,$466.50
2025-04-25,15:33:00,19356.5,SELL,3,0.02h,Stop Loss,$21.00,$487.50,$223941.50,340,$487.50
2025-04-25,15:53:00,19360.0,BUY,3,0.02h,Stop Loss,$-9.00,$478.50,$223932.50,340,$478.50
2025-04-25,17:39:00,19472.0,SELL,3,0.02h,Stop Loss,$154.50,$633.00,$224087.00,340,$633.00
2025-04-25,18:07:00,19458.5,BUY,3,0.02h,Stop Loss,$4.50,$637.50,$224091.50,340,$637.50
2025-04-25,19:00:00,19499.75,SELL,3,0.02h,Stop Loss,$18.00,$655.50,$224109.50,340,$655.50
2025-04-25,19:03:00,19512.5,BUY,3,0.02h,Stop Loss,$42.00,$697.50,$224151.50,340,$697.50
2025-04-25,19:12:00,19493.25,SELL,3,0.02h,Break Even,$-1.50,$696.00,$224150.00,340,$696.00
2025-04-25,19:24:00,19509.25,BUY,3,0.02h,Stop Loss,$10.50,$706.50,$224160.50,340,$706.50
2025-04-25,19:29:00,19488.75,SELL,3,0.02h,Stop Loss,$16.50,$723.00,$224177.00,340,$723.00
2025-04-25,19:51:00,19511.75,BUY,3,0.02h,Stop Loss,$-9.00,$714.00,$224168.00,340,$714.00
2025-04-25,20:45:00,19542.75,SELL,3,0.02h,Break Even,$-1.50,$712.50,$224166.50,340,$712.50
2025-04-25,21:00:00,19554.75,BUY,3,63.00h,Stop Loss,$-9.00,$703.50,$224157.50,340,$703.50
,,,,,,,,,,,
2025-04-28,12:00:00,19514.0,SELL,3,0.02h,Stop Loss,$4.50,$4.50,$224162.00,341,$4.50
2025-04-28,12:27:00,19509.25,BUY,3,0.02h,Stop Loss,$-9.00,$-4.50,$224153.00,341,$-4.50
2025-04-28,13:32:00,19541.25,SELL,3,0.02h,Stop Loss,$6.00,$1.50,$224159.00,341,$1.50
2025-04-28,13:44:00,19580.5,BUY,3,0.02h,Stop Loss,$90.00,$91.50,$224249.00,341,$91.50
2025-04-28,13:56:00,19518.5,SELL,3,0.02h,Stop Loss,$48.00,$139.50,$224297.00,341,$139.50
2025-04-28,14:25:00,19536.0,BUY,3,0.02h,Break Even,$-1.50,$138.00,$224295.50,341,$138.00
2025-04-28,14:28:00,19503.75,SELL,3,0.02h,Stop Loss,$58.50,$196.50,$224354.00,341,$196.50
2025-04-28,14:39:00,19521.75,BUY,3,0.02h,Stop Loss,$4.50,$201.00,$224358.50,341,$201.00
2025-04-28,14:54:00,19485.5,SELL,3,0.02h,Break Even,$-1.50,$199.50,$224357.00,341,$199.50
2025-04-28,15:43:00,19384.75,BUY,3,0.02h,Break Even,$-1.50,$198.00,$224355.50,341,$198.00
2025-04-28,15:45:00,19352.25,SELL,3,0.02h,Stop Loss,$19.50,$217.50,$224375.00,341,$217.50
2025-04-28,16:36:00,19321.5,BUY,3,0.02h,Stop Loss,$27.00,$244.50,$224402.00,341,$244.50
2025-04-28,16:56:00,19303.25,SELL,3,0.02h,Stop Loss,$45.00,$289.50,$224447.00,341,$289.50
2025-04-28,17:02:00,19331.25,BUY,3,0.02h,Stop Loss,$-9.00,$280.50,$224438.00,341,$280.50
2025-04-28,17:03:00,19313.5,SELL,3,0.02h,Break Even,$-1.50,$279.00,$224436.50,341,$279.00
2025-04-28,17:04:00,19325.5,BUY,3,0.02h,Stop Loss,$25.50,$304.50,$224462.00,341,$304.50
2025-04-28,17:05:00,19316.0,SELL,3,0.02h,Stop Loss,$30.00,$334.50,$224492.00,341,$334.50
2025-04-28,17:40:00,19305.25,BUY,3,0.02h,Stop Loss,$40.50,$375.00,$224532.50,341,$375.00
2025-04-28,20:02:00,19501.75,SELL,3,0.02h,Stop Loss,$13.50,$388.50,$224546.00,341,$388.50
2025-04-28,22:10:00,19487.5,BUY,3,0.02h,Break Even,$-1.50,$387.00,$224544.50,341,$387.00
2025-04-28,22:14:00,19467.25,SELL,3,0.02h,Stop Loss,$-9.00,$378.00,$224535.50,341,$378.00
2025-04-28,22:32:00,19478.75,BUY,3,0.02h,Stop Loss,$43.50,$421.50,$224579.00,341,$421.50
2025-04-28,22:43:00,19464.5,SELL,3,0.02h,Stop Loss,$-9.00,$412.50,$224570.00,341,$412.50
2025-04-28,22:51:00,19482.0,BUY,3,0.02h,Break Even,$-1.50,$411.00,$224568.50,341,$411.00
,,,,,,,,,,,
2025-04-29,12:19:00,19488.5,SELL,3,0.02h,Stop Loss,$51.00,$51.00,$224619.50,342,$51.00
2025-04-29,12:32:00,19490.25,BUY,3,0.02h,Break Even,$-1.50,$49.50,$224618.00,342,$49.50
2025-04-29,12:55:00,19497.5,SELL,3,0.02h,Stop Loss,$43.50,$93.00,$224661.50,342,$93.00
2025-04-29,13:30:00,19427.25,BUY,3,0.02h,Stop Loss,$76.50,$169.50,$224738.00,342,$169.50
2025-04-29,14:22:00,19500.5,SELL,3,0.02h,Stop Loss,$21.00,$190.50,$224759.00,342,$190.50
2025-04-29,14:36:00,19556.0,BUY,3,0.02h,Stop Loss,$48.00,$238.50,$224807.00,342,$238.50
2025-04-29,15:13:00,19565.0,SELL,3,0.02h,Stop Loss,$96.00,$334.50,$224903.00,342,$334.50
2025-04-29,15:42:00,19555.0,BUY,3,0.02h,Stop Loss,$81.00,$415.50,$224984.00,342,$415.50
2025-04-29,15:58:00,19539.25,SELL,3,0.02h,Break Even,$-1.50,$414.00,$224982.50,342,$414.00
2025-04-29,16:04:00,19579.5,BUY,3,0.02h,Break Even,$-1.50,$412.50,$224981.00,342,$412.50
2025-04-29,16:20:00,19556.5,SELL,3,0.02h,Stop Loss,$34.50,$447.00,$225015.50,342,$447.00
2025-04-29,16:37:00,19581.25,BUY,3,0.02h,Stop Loss,$-9.00,$438.00,$225006.50,342,$438.00
2025-04-29,16:39:00,19550.0,SELL,3,0.02h,Stop Loss,$9.00,$447.00,$225015.50,342,$447.00
2025-04-29,16:43:00,19577.0,BUY,3,0.02h,Stop Loss,$12.00,$459.00,$225027.50,342,$459.00
2025-04-29,16:47:00,19547.5,SELL,3,0.02h,Stop Loss,$84.00,$543.00,$225111.50,342,$543.00
2025-04-29,17:18:00,19542.25,BUY,3,0.02h,Stop Loss,$40.50,$583.50,$225152.00,342,$583.50
2025-04-29,18:23:00,19644.0,SELL,3,0.02h,Stop Loss,$-9.00,$574.50,$225143.00,342,$574.50
2025-04-29,18:26:00,19663.5,BUY,3,0.02h,Stop Loss,$4.50,$579.00,$225147.50,342,$579.00
2025-04-29,18:27:00,19656.0,SELL,3,0.02h,Stop Loss,$-9.00,$570.00,$225138.50,342,$570.00
2025-04-29,18:28:00,19670.25,BUY,3,0.02h,Stop Loss,$79.50,$649.50,$225218.00,342,$649.50
2025-04-29,18:49:00,19665.25,SELL,3,0.02h,Stop Loss,$7.50,$657.00,$225225.50,342,$657.00
2025-04-29,19:12:00,19671.0,BUY,3,0.02h,Stop Loss,$-9.00,$648.00,$225216.50,342,$648.00
2025-04-29,19:16:00,19643.25,SELL,3,0.02h,Break Even,$-1.50,$646.50,$225215.00,342,$646.50
2025-04-29,19:34:00,19657.25,BUY,3,0.02h,Break Even,$-1.50,$645.00,$225213.50,342,$645.00
2025-04-29,19:37:00,19641.75,SELL,3,0.02h,Stop Loss,$24.00,$669.00,$225237.50,342,$669.00
2025-04-29,19:50:00,19663.0,BUY,3,0.02h,Stop Loss,$93.00,$762.00,$225330.50,342,$762.00
2025-04-29,20:04:00,19645.0,SELL,3,0.02h,Stop Loss,$19.50,$781.50,$225350.00,342,$781.50
2025-04-29,20:27:00,19639.25,BUY,3,0.02h,Stop Loss,$-9.00,$772.50,$225341.00,342,$772.50
2025-04-29,20:29:00,19620.0,SELL,3,0.02h,Stop Loss,$28.50,$801.00,$225369.50,342,$801.00
2025-04-29,20:57:00,19617.25,BUY,3,0.02h,Stop Loss,$19.50,$820.50,$225389.00,342,$820.50
2025-04-29,22:02:00,19580.5,SELL,3,0.02h,Stop Loss,$-9.00,$811.50,$225380.00,342,$811.50
2025-04-29,22:15:00,19603.5,BUY,3,0.02h,Break Even,$-1.50,$810.00,$225378.50,342,$810.00
2025-04-29,22:23:00,19585.0,SELL,3,0.02h,Break Even,$-1.50,$808.50,$225377.00,342,$808.50
,,,,,,,,,,,
2025-04-30,13:24:00,19280.25,BUY,3,0.02h,Break Even,$-1.50,$-1.50,$225375.50,343,$-1.50
2025-04-30,13:32:00,19242.0,SELL,3,0.02h,Stop Loss,$16.50,$15.00,$225392.00,343,$15.00
2025-04-30,13:35:00,19295.5,BUY,3,0.02h,Stop Loss,$27.00,$42.00,$225419.00,343,$42.00
2025-04-30,13:37:00,19256.75,SELL,3,0.02h,Stop Loss,$232.50,$274.50,$225651.50,343,$274.50
2025-04-30,14:09:00,19200.0,BUY,3,0.02h,Stop Loss,$129.00,$403.50,$225780.50,343,$403.50
2025-04-30,16:14:00,19421.0,SELL,3,0.02h,Break Even,$-1.50,$402.00,$225779.00,343,$402.00
2025-04-30,16:40:00,19426.75,BUY,3,0.02h,Stop Loss,$40.50,$442.50,$225819.50,343,$442.50
2025-04-30,17:07:00,19403.25,SELL,3,0.02h,Stop Loss,$7.50,$450.00,$225827.00,343,$450.00
2025-04-30,17:25:00,19405.0,BUY,3,0.02h,Stop Loss,$64.50,$514.50,$225891.50,343,$514.50
2025-04-30,18:02:00,19465.75,SELL,3,0.02h,Stop Loss,$37.50,$552.00,$225929.00,343,$552.00
2025-04-30,18:08:00,19528.75,BUY,3,0.02h,Stop Loss,$25.50,$577.50,$225954.50,343,$577.50
2025-04-30,18:30:00,19494.75,SELL,3,0.02h,Stop Loss,$25.50,$603.00,$225980.00,343,$603.00
2025-04-30,18:50:00,19515.25,BUY,3,0.02h,Stop Loss,$58.50,$661.50,$226038.50,343,$661.50
2025-04-30,18:59:00,19482.5,SELL,3,0.02h,Stop Loss,$48.00,$709.50,$226086.50,343,$709.50
2025-04-30,19:04:00,19504.0,BUY,3,0.02h,Break Even,$-1.50,$708.00,$226085.00,343,$708.00
2025-04-30,19:26:00,19481.75,SELL,3,0.02h,Stop Loss,$30.00,$738.00,$226115.00,343,$738.00
2025-04-30,19:39:00,19513.75,BUY,3,0.02h,Break Even,$-1.50,$736.50,$226113.50,343,$736.50
2025-04-30,22:29:00,19890.0,SELL,3,0.02h,Stop Loss,$9.00,$745.50,$226122.50,343,$745.50
2025-04-30,22:32:00,19913.0,BUY,3,0.02h,Stop Loss,$-9.00,$736.50,$226113.50,343,$736.50
2025-04-30,22:40:00,19894.25,SELL,3,0.02h,Stop Loss,$22.50,$759.00,$226136.00,343,$759.00
2025-04-30,22:58:00,19899.5,BUY,3,0.02h,Stop Loss,$4.50,$763.50,$226140.50,343,$763.50
,,,,,,,,,,,
2025-05-01,12:29:00,19990.0,SELL,3,0.02h,Break Even,$-1.50,$-1.50,$226139.00,344,$-1.50
2025-05-01,13:12:00,19981.0,BUY,3,0.02h,Break Even,$-1.50,$-3.00,$226137.50,344,$-3.00
2025-05-01,13:32:00,19921.75,SELL,3,0.02h,Stop Loss,$31.50,$28.50,$226169.00,344,$28.50
2025-05-01,13:49:00,19979.75,BUY,3,0.02h,Break Even,$-1.50,$27.00,$226167.50,344,$27.00
2025-05-01,13:57:00,19932.75,SELL,3,0.02h,Stop Loss,$96.00,$123.00,$226263.50,344,$123.00
2025-05-01,14:18:00,19956.0,BUY,3,0.02h,Break Even,$-1.50,$121.50,$226262.00,344,$121.50
2025-05-01,15:30:00,20077.5,SELL,3,0.02h,Stop Loss,$69.00,$190.50,$226331.00,344,$190.50
2025-05-01,16:32:00,19974.0,BUY,3,0.02h,Break Even,$-1.50,$189.00,$226329.50,344,$189.00
2025-05-01,16:44:00,19961.25,SELL,3,0.02h,Break Even,$-1.50,$187.50,$226328.00,344,$187.50
2025-05-01,17:03:00,19984.25,BUY,3,0.02h,Stop Loss,$28.50,$216.00,$226356.50,344,$216.00
2025-05-01,17:31:00,19999.25,SELL,3,0.02h,Stop Loss,$6.00,$222.00,$226362.50,344,$222.00
2025-05-01,17:37:00,20012.25,BUY,3,0.02h,Stop Loss,$-9.00,$213.00,$226353.50,344,$213.00
2025-05-01,17:39:00,19998.75,SELL,3,0.02h,Stop Loss,$36.00,$249.00,$226389.50,344,$249.00
2025-05-01,18:01:00,19982.75,BUY,3,0.02h,Stop Loss,$55.50,$304.50,$226445.00,344,$304.50
2025-05-01,18:27:00,19993.5,SELL,3,0.02h,Stop Loss,$10.50,$315.00,$226455.50,344,$315.00
2025-05-01,18:32:00,20028.75,BUY,3,0.02h,Stop Loss,$-9.00,$306.00,$226446.50,344,$306.00
2025-05-01,18:55:00,20012.25,SELL,3,0.02h,Stop Loss,$3.00,$309.00,$226449.50,344,$309.00
2025-05-01,19:20:00,20013.5,BUY,3,0.02h,Stop Loss,$30.00,$339.00,$226479.50,344,$339.00
2025-05-01,19:37:00,19997.0,SELL,3,0.02h,Stop Loss,$-9.00,$330.00,$226470.50,344,$330.00
2025-05-01,19:50:00,20008.75,BUY,3,0.02h,Stop Loss,$81.00,$411.00,$226551.50,344,$411.00
2025-05-01,19:51:00,19966.5,SELL,3,0.02h,Stop Loss,$129.00,$540.00,$226680.50,344,$540.00
2025-05-01,20:24:00,19852.25,BUY,3,0.02h,Break Even,$-1.50,$538.50,$226679.00,344,$538.50
2025-05-01,20:28:00,19834.25,SELL,3,0.02h,Stop Loss,$34.50,$573.00,$226713.50,344,$573.00
2025-05-01,22:17:00,19794.75,BUY,3,0.02h,Break Even,$-1.50,$571.50,$226712.00,344,$571.50
2025-05-01,22:32:00,19776.25,SELL,3,0.02h,Stop Loss,$-9.00,$562.50,$226703.00,344,$562.50
2025-05-01,22:36:00,19788.0,BUY,3,0.02h,Break Even,$-1.50,$561.00,$226701.50,344,$561.00
2025-05-01,22:49:00,19784.5,SELL,3,0.02h,Stop Loss,$-9.00,$552.00,$226692.50,344,$552.00
2025-05-01,22:51:00,19790.0,BUY,3,0.02h,Break Even,$-1.50,$550.50,$226691.00,344,$550.50
,,,,,,,,,,,
2025-05-02,13:26:00,20093.0,SELL,3,0.02h,Stop Loss,$25.50,$25.50,$226716.50,345,$25.50
2025-05-02,13:45:00,20100.25,BUY,3,0.02h,Stop Loss,$70.50,$96.00,$226787.00,345,$96.00
2025-05-02,13:48:00,20071.5,SELL,3,0.02h,Stop Loss,$130.50,$226.50,$226917.50,345,$226.50
2025-05-02,14:03:00,20104.0,BUY,3,0.02h,Stop Loss,$183.00,$409.50,$227100.50,345,$409.50
2025-05-02,14:44:00,20142.75,SELL,3,0.02h,Stop Loss,$10.50,$420.00,$227111.00,345,$420.00
2025-05-02,14:47:00,20159.25,BUY,3,0.02h,Stop Loss,$-9.00,$411.00,$227102.00,345,$411.00
2025-05-02,14:53:00,20141.5,SELL,3,0.02h,Stop Loss,$91.50,$502.50,$227193.50,345,$502.50
2025-05-02,14:57:00,20150.25,BUY,3,0.02h,Stop Loss,$-9.00,$493.50,$227184.50,345,$493.50
2025-05-02,14:58:00,20143.0,SELL,3,0.02h,Stop Loss,$3.00,$496.50,$227187.50,345,$496.50
2025-05-02,15:00:00,20166.0,BUY,3,0.02h,Stop Loss,$54.00,$550.50,$227241.50,345,$550.50
2025-05-02,15:25:00,20161.75,SELL,3,0.02h,Stop Loss,$55.50,$606.00,$227297.00,345,$606.00
2025-05-02,15:39:00,20173.25,BUY,3,0.02h,Break Even,$-1.50,$604.50,$227295.50,345,$604.50
2025-05-02,16:30:00,20224.0,SELL,3,0.02h,Break Even,$-1.50,$603.00,$227294.00,345,$603.00
2025-05-02,16:37:00,20246.0,BUY,3,0.02h,Stop Loss,$99.00,$702.00,$227393.00,345,$702.00
2025-05-02,16:58:00,20243.75,SELL,3,0.02h,Break Even,$-1.50,$700.50,$227391.50,345,$700.50
2025-05-02,17:40:00,20219.0,BUY,3,0.02h,Stop Loss,$-9.00,$691.50,$227382.50,345,$691.50
2025-05-02,17:41:00,20204.25,SELL,3,0.02h,Stop Loss,$-9.00,$682.50,$227373.50,345,$682.50
2025-05-02,17:43:00,20217.25,BUY,3,0.02h,Break Even,$-1.50,$681.00,$227372.00,345,$681.00
2025-05-02,17:52:00,20212.25,SELL,3,0.02h,Stop Loss,$-9.00,$672.00,$227363.00,345,$672.00
2025-05-02,17:54:00,20225.0,BUY,3,0.02h,Break Even,$-1.50,$670.50,$227361.50,345,$670.50
2025-05-02,18:48:00,20242.75,SELL,3,0.02h,Stop Loss,$72.00,$742.50,$227433.50,345,$742.50
2025-05-02,19:22:00,20229.25,BUY,3,0.02h,Stop Loss,$18.00,$760.50,$227451.50,345,$760.50
2025-05-02,19:35:00,20211.5,SELL,3,0.02h,Stop Loss,$99.00,$859.50,$227550.50,345,$859.50
2025-05-02,20:06:00,20211.25,BUY,3,0.02h,Stop Loss,$24.00,$883.50,$227574.50,345,$883.50
2025-05-02,20:18:00,20193.25,SELL,3,0.02h,Stop Loss,$-9.00,$874.50,$227565.50,345,$874.50
2025-05-02,20:56:00,20202.25,BUY,3,0.02h,Break Even,$-1.50,$873.00,$227564.00,345,$873.00
,,,,,,,,,,,
2025-05-05,12:00:00,19980.75,SELL,3,0.02h,Stop Loss,$-9.00,$-9.00,$227555.00,346,$-9.00
2025-05-05,12:54:00,20000.5,BUY,3,0.02h,Stop Loss,$15.00,$6.00,$227570.00,346,$6.00
2025-05-05,13:16:00,19995.25,SELL,3,0.02h,Stop Loss,$-9.00,$-3.00,$227561.00,346,$-3.00
2025-05-05,13:22:00,20005.0,BUY,3,0.02h,Stop Loss,$4.50,$1.50,$227565.50,346,$1.50
2025-05-05,13:28:00,19999.0,SELL,3,0.02h,Stop Loss,$-9.00,$-7.50,$227556.50,346,$-7.50
2025-05-05,13:29:00,20015.75,BUY,3,0.02h,Stop Loss,$-9.00,$-16.50,$227547.50,346,$-16.50
2025-05-05,14:25:00,20050.5,SELL,3,0.02h,Break Even,$-1.50,$-18.00,$227546.00,346,$-18.00
2025-05-05,14:41:00,20073.0,BUY,3,0.02h,Stop Loss,$64.50,$46.50,$227610.50,346,$46.50
2025-05-05,15:16:00,20090.5,SELL,3,0.02h,Stop Loss,$30.00,$76.50,$227640.50,346,$76.50
2025-05-05,15:21:00,20103.0,BUY,3,0.02h,Stop Loss,$66.00,$142.50,$227706.50,346,$142.50
2025-05-05,15:29:00,20095.75,SELL,3,0.02h,Break Even,$-1.50,$141.00,$227705.00,346,$141.00
2025-05-05,15:31:00,20105.75,BUY,3,0.02h,Stop Loss,$-9.00,$132.00,$227696.00,346,$132.00
2025-05-05,15:32:00,20096.5,SELL,3,0.02h,Stop Loss,$60.00,$192.00,$227756.00,346,$192.00
2025-05-05,15:53:00,20100.5,BUY,3,0.02h,Stop Loss,$19.50,$211.50,$227775.50,346,$211.50
2025-05-05,17:01:00,20124.0,SELL,3,0.02h,Break Even,$-1.50,$210.00,$227774.00,346,$210.00
2025-05-05,17:28:00,20129.0,BUY,3,0.02h,Stop Loss,$6.00,$216.00,$227780.00,346,$216.00
2025-05-05,18:55:00,20169.5,SELL,3,0.02h,Stop Loss,$33.00,$249.00,$227813.00,346,$249.00
2025-05-05,19:39:00,20133.5,BUY,3,0.02h,Stop Loss,$-9.00,$240.00,$227804.00,346,$240.00
2025-05-05,19:44:00,20114.0,SELL,3,0.02h,Stop Loss,$70.50,$310.50,$227874.50,346,$310.50
2025-05-05,20:45:00,20028.0,BUY,3,0.02h,Stop Loss,$31.50,$342.00,$227906.00,346,$342.00
2025-05-05,22:03:00,20030.25,SELL,3,0.02h,Stop Loss,$30.00,$372.00,$227936.00,346,$372.00
2025-05-05,22:17:00,20033.75,BUY,3,0.02h,Break Even,$-1.50,$370.50,$227934.50,346,$370.50
2025-05-05,22:29:00,20027.0,SELL,3,0.02h,Stop Loss,$-9.00,$361.50,$227925.50,346,$361.50
2025-05-05,22:37:00,20030.75,BUY,3,0.02h,Stop Loss,$3.00,$364.50,$227928.50,346,$364.50
2025-05-05,22:45:00,20024.0,SELL,3,0.02h,Stop Loss,$-9.00,$355.50,$227919.50,346,$355.50
,,,,,,,,,,,
2025-05-06,12:52:00,19831.75,BUY,3,0.02h,Break Even,$-1.50,$-1.50,$227918.00,347,$-1.50
2025-05-06,13:07:00,19824.0,SELL,3,0.02h,Stop Loss,$36.00,$34.50,$227954.00,347,$34.50
2025-05-06,13:34:00,19828.75,BUY,3,0.02h,Stop Loss,$61.50,$96.00,$228015.50,347,$96.00
2025-05-06,13:50:00,19799.5,SELL,3,0.02h,Stop Loss,$70.50,$166.50,$228086.00,347,$166.50
2025-05-06,14:09:00,19813.5,BUY,3,0.02h,Stop Loss,$57.00,$223.50,$228143.00,347,$223.50
2025-05-06,15:11:00,19896.75,SELL,3,0.02h,Stop Loss,$-9.00,$214.50,$228134.00,347,$214.50
2025-05-06,15:16:00,19915.0,BUY,3,0.02h,Stop Loss,$-9.00,$205.50,$228125.00,347,$205.50
2025-05-06,15:17:00,19905.0,SELL,3,0.02h,Break Even,$-1.50,$204.00,$228123.50,347,$204.00
2025-05-06,15:18:00,19916.75,BUY,3,0.02h,Stop Loss,$31.50,$235.50,$228155.00,347,$235.50
2025-05-06,15:43:00,19911.25,SELL,3,0.02h,Stop Loss,$24.00,$259.50,$228179.00,347,$259.50
2025-05-06,16:13:00,19946.25,BUY,3,0.02h,Stop Loss,$283.50,$543.00,$228462.50,347,$543.00
2025-05-06,16:25:00,19903.25,SELL,3,0.02h,Stop Loss,$4.50,$547.50,$228467.00,347,$547.50
2025-05-06,16:41:00,19932.5,BUY,3,0.02h,Stop Loss,$6.00,$553.50,$228473.00,347,$553.50
2025-05-06,16:44:00,19915.5,SELL,3,0.02h,Stop Loss,$120.00,$673.50,$228593.00,347,$673.50
2025-05-06,17:09:00,19907.5,BUY,3,0.02h,Stop Loss,$52.50,$726.00,$228645.50,347,$726.00
2025-05-06,17:22:00,19876.5,SELL,3,0.02h,Stop Loss,$27.00,$753.00,$228672.50,347,$753.00
2025-05-06,17:34:00,19897.75,BUY,3,0.02h,Stop Loss,$19.50,$772.50,$228692.00,347,$772.50
2025-05-06,17:39:00,19881.0,SELL,3,0.02h,Stop Loss,$78.00,$850.50,$228770.00,347,$850.50
2025-05-06,18:03:00,19884.5,BUY,3,0.02h,Stop Loss,$4.50,$855.00,$228774.50,347,$855.00
2025-05-06,19:09:00,19925.75,SELL,3,0.02h,Break Even,$-1.50,$853.50,$228773.00,347,$853.50
2025-05-06,19:16:00,19940.75,BUY,3,0.02h,Stop Loss,$19.50,$873.00,$228792.50,347,$873.00
2025-05-06,19:21:00,19926.75,SELL,3,0.02h,Break Even,$-1.50,$871.50,$228791.00,347,$871.50
2025-05-06,19:27:00,19938.0,BUY,3,0.02h,Stop Loss,$19.50,$891.00,$228810.50,347,$891.00
2025-05-06,19:52:00,19922.75,SELL,3,0.02h,Stop Loss,$66.00,$957.00,$228876.50,347,$957.00
2025-05-06,20:53:00,19856.75,BUY,3,0.02h,Break Even,$-1.50,$955.50,$228875.00,347,$955.50
2025-05-06,21:00:00,19846.25,SELL,3,1.02h,Stop Loss,$249.00,$1204.50,$229124.00,347,$1204.50
2025-05-06,22:01:00,19953.0,BUY,3,0.02h,Stop Loss,$813.00,$2017.50,$229937.00,347,$2017.50
2025-05-06,22:38:00,20008.5,SELL,3,0.02h,Break Even,$-1.50,$2016.00,$229935.50,347,$2016.00
2025-05-06,22:50:00,20052.75,BUY,3,0.02h,Stop Loss,$93.00,$2109.00,$230028.50,347,$2109.00
,,,,,,,,,,,
2025-05-07,12:00:00,19996.25,SELL,3,0.02h,Break Even,$-1.50,$-1.50,$230027.00,348,$-1.50
2025-05-07,12:45:00,19944.0,BUY,3,0.02h,Stop Loss,$12.00,$10.50,$230039.00,348,$10.50
2025-05-07,12:59:00,19930.25,SELL,3,0.02h,Stop Loss,$-9.00,$1.50,$230030.00,348,$1.50
2025-05-07,13:42:00,19915.0,BUY,3,0.02h,Stop Loss,$34.50,$36.00,$230064.50,348,$36.00
2025-05-07,13:51:00,19877.25,SELL,3,0.02h,Stop Loss,$-9.00,$27.00,$230055.50,348,$27.00
2025-05-07,13:56:00,19921.75,BUY,3,0.02h,Stop Loss,$31.50,$58.50,$230087.00,348,$58.50
2025-05-07,14:47:00,19952.75,SELL,3,0.02h,Stop Loss,$67.50,$126.00,$230154.50,348,$126.00
2025-05-07,15:41:00,19830.5,BUY,3,0.02h,Stop Loss,$52.50,$178.50,$230207.00,348,$178.50
2025-05-07,15:50:00,19796.75,SELL,3,0.02h,Stop Loss,$51.00,$229.50,$230258.00,348,$229.50
2025-05-07,15:54:00,19840.75,BUY,3,0.02h,Stop Loss,$13.50,$243.00,$230271.50,348,$243.00
2025-05-07,16:22:00,19823.0,SELL,3,0.02h,Stop Loss,$52.50,$295.50,$230324.00,348,$295.50
2025-05-07,16:40:00,19841.25,BUY,3,0.02h,Stop Loss,$82.50,$378.00,$230406.50,348,$378.00
2025-05-07,17:22:00,19886.25,SELL,3,0.02h,Break Even,$-1.50,$376.50,$230405.00,348,$376.50
2025-05-07,17:25:00,19908.0,BUY,3,0.02h,Stop Loss,$9.00,$385.50,$230414.00,348,$385.50
2025-05-07,17:34:00,19889.0,SELL,3,0.02h,Break Even,$-1.50,$384.00,$230412.50,348,$384.00
2025-05-07,18:28:00,19781.75,BUY,3,0.02h,Stop Loss,$12.00,$396.00,$230424.50,348,$396.00
2025-05-07,18:50:00,19777.25,SELL,3,0.02h,Stop Loss,$75.00,$471.00,$230499.50,348,$471.00
2025-05-07,18:57:00,19860.25,BUY,3,0.02h,Stop Loss,$240.00,$711.00,$230739.50,348,$711.00
2025-05-07,19:25:00,19832.0,SELL,3,0.02h,Stop Loss,$151.50,$862.50,$230891.00,348,$862.50
2025-05-07,19:42:00,19911.0,BUY,3,0.02h,Stop Loss,$628.50,$1491.00,$231519.50,348,$1491.00
2025-05-07,20:29:00,19943.25,SELL,3,0.02h,Break Even,$-1.50,$1489.50,$231518.00,348,$1489.50
2025-05-07,20:40:00,19958.0,BUY,3,0.02h,Break Even,$-1.50,$1488.00,$231516.50,348,$1488.00
2025-05-07,22:01:00,19933.0,SELL,3,0.02h,Stop Loss,$51.00,$1539.00,$231567.50,348,$1539.00
2025-05-07,22:26:00,19940.0,BUY,3,0.02h,Stop Loss,$3.00,$1542.00,$231570.50,348,$1542.00
2025-05-07,22:50:00,19942.75,SELL,3,0.02h,Break Even,$-1.50,$1540.50,$231569.00,348,$1540.50
,,,,,,,,,,,
2025-05-08,12:00:00,20198.0,BUY,3,0.02h,Stop Loss,$10.50,$10.50,$231579.50,349,$10.50
2025-05-08,12:38:00,20164.25,SELL,3,0.02h,Break Even,$-1.50,$9.00,$231578.00,349,$9.00
2025-05-08,12:51:00,20200.75,BUY,3,0.02h,Stop Loss,$-9.00,$0.00,$231569.00,349,$0.00
2025-05-08,12:59:00,20176.5,SELL,3,0.02h,Break Even,$-1.50,$-1.50,$231567.50,349,$-1.50
2025-05-08,13:22:00,20177.25,BUY,3,0.02h,Break Even,$-1.50,$-3.00,$231566.00,349,$-3.00
2025-05-08,13:25:00,20169.5,SELL,3,0.02h,Stop Loss,$-9.00,$-12.00,$231557.00,349,$-12.00
2025-05-08,14:28:00,20091.0,BUY,3,0.02h,Stop Loss,$9.00,$-3.00,$231566.00,349,$-3.00
2025-05-08,14:40:00,20062.0,SELL,3,0.02h,Stop Loss,$19.50,$16.50,$231585.50,349,$16.50
2025-05-08,15:10:00,20059.25,BUY,3,0.02h,Stop Loss,$55.50,$72.00,$231641.00,349,$72.00
2025-05-08,16:29:00,20288.5,SELL,3,0.02h,Stop Loss,$19.50,$91.50,$231660.50,349,$91.50
2025-05-08,16:39:00,20306.0,BUY,3,0.02h,Stop Loss,$6.00,$97.50,$231666.50,349,$97.50
2025-05-08,17:06:00,20313.0,SELL,3,0.02h,Stop Loss,$39.00,$136.50,$231705.50,349,$136.50
2025-05-08,18:16:00,20276.5,BUY,3,0.02h,Stop Loss,$21.00,$157.50,$231726.50,349,$157.50
2025-05-08,18:56:00,20293.75,SELL,3,0.02h,Stop Loss,$24.00,$181.50,$231750.50,349,$181.50
2025-05-08,19:21:00,20298.5,BUY,3,0.02h,Stop Loss,$165.00,$346.50,$231915.50,349,$346.50
2025-05-08,19:37:00,20280.0,SELL,3,0.02h,Break Even,$-1.50,$345.00,$231914.00,349,$345.00
2025-05-08,20:43:00,20163.0,BUY,3,0.02h,Break Even,$-1.50,$343.50,$231912.50,349,$343.50
2025-05-08,21:00:00,20155.75,SELL,3,1.02h,Stop Loss,$-9.00,$334.50,$231903.50,349,$334.50
2025-05-08,22:01:00,20172.0,BUY,3,0.02h,Break Even,$-1.50,$333.00,$231902.00,349,$333.00
2025-05-08,22:05:00,20150.75,SELL,3,0.02h,Stop Loss,$9.00,$342.00,$231911.00,349,$342.00
2025-05-08,22:17:00,20165.25,BUY,3,0.02h,Break Even,$-1.50,$340.50,$231909.50,349,$340.50
2025-05-08,22:21:00,20153.0,SELL,3,0.02h,Stop Loss,$-9.00,$331.50,$231900.50,349,$331.50
2025-05-08,22:43:00,20158.0,BUY,3,0.02h,Stop Loss,$-9.00,$322.50,$231891.50,349,$322.50
,,,,,,,,,,,
2025-05-09,12:29:00,20197.75,SELL,3,0.02h,Stop Loss,$-9.00,$-9.00,$231882.50,350,$-9.00
2025-05-09,12:32:00,20216.0,BUY,3,0.02h,Stop Loss,$7.50,$-1.50,$231890.00,350,$-1.50
2025-05-09,13:26:00,20237.75,SELL,3,0.02h,Stop Loss,$19.50,$18.00,$231909.50,350,$18.00
2025-05-09,13:35:00,20260.5,BUY,3,0.02h,Stop Loss,$28.50,$46.50,$231938.00,350,$46.50
2025-05-09,13:45:00,20227.0,SELL,3,0.02h,Stop Loss,$21.00,$67.50,$231959.00,350,$67.50
2025-05-09,14:00:00,20254.25,BUY,3,0.02h,Break Even,$-1.50,$66.00,$231957.50,350,$66.00
2025-05-09,14:16:00,20237.25,SELL,3,0.02h,Break Even,$-1.50,$64.50,$231956.00,350,$64.50
2025-05-09,14:58:00,20139.0,BUY,3,0.02h,Stop Loss,$25.50,$90.00,$231981.50,350,$90.00
2025-05-09,15:23:00,20133.5,SELL,3,0.02h,Stop Loss,$60.00,$150.00,$232041.50,350,$150.00
2025-05-09,15:46:00,20144.25,BUY,3,0.02h,Stop Loss,$7.50,$157.50,$232049.00,350,$157.50
2025-05-09,16:05:00,20108.25,SELL,3,0.02h,Break Even,$-1.50,$156.00,$232047.50,350,$156.00
2025-05-09,16:38:00,20131.25,BUY,3,0.02h,Stop Loss,$-9.00,$147.00,$232038.50,350,$147.00
2025-05-09,16:45:00,20107.25,SELL,3,0.02h,Stop Loss,$54.00,$201.00,$232092.50,350,$201.00
2025-05-09,17:11:00,20114.75,BUY,3,0.02h,Stop Loss,$-9.00,$192.00,$232083.50,350,$192.00
2025-05-09,17:32:00,20096.0,SELL,3,0.02h,Break Even,$-1.50,$190.50,$232082.00,350,$190.50
2025-05-09,17:37:00,20113.5,BUY,3,0.02h,Stop Loss,$-9.00,$181.50,$232073.00,350,$181.50
2025-05-09,18:13:00,20139.5,SELL,3,0.02h,Stop Loss,$7.50,$189.00,$232080.50,350,$189.00
2025-05-09,18:34:00,20138.5,BUY,3,0.02h,Break Even,$-1.50,$187.50,$232079.00,350,$187.50
2025-05-09,18:38:00,20130.75,SELL,3,0.02h,Stop Loss,$7.50,$195.00,$232086.50,350,$195.00
2025-05-09,18:41:00,20137.5,BUY,3,0.02h,Break Even,$-1.50,$193.50,$232085.00,350,$193.50
2025-05-09,18:42:00,20128.25,SELL,3,0.02h,Break Even,$-1.50,$192.00,$232083.50,350,$192.00
2025-05-09,18:48:00,20142.75,BUY,3,0.02h,Break Even,$-1.50,$190.50,$232082.00,350,$190.50
2025-05-09,19:24:00,20156.75,SELL,3,0.02h,Stop Loss,$6.00,$196.50,$232088.00,350,$196.50
2025-05-09,19:44:00,20162.75,BUY,3,0.02h,Stop Loss,$-9.00,$187.50,$232079.00,350,$187.50
2025-05-09,19:46:00,20139.5,SELL,3,0.02h,Stop Loss,$6.00,$193.50,$232085.00,350,$193.50
2025-05-09,19:55:00,20164.75,BUY,3,0.02h,Stop Loss,$-9.00,$184.50,$232076.00,350,$184.50
2025-05-09,19:56:00,20138.5,SELL,3,0.02h,Stop Loss,$25.50,$210.00,$232101.50,350,$210.00
2025-05-09,20:42:00,20133.5,BUY,3,0.02h,Stop Loss,$-9.00,$201.00,$232092.50,350,$201.00
,,,,,,,,,,,
2025-05-12,12:47:00,20910.75,SELL,3,0.02h,Stop Loss,$-9.00,$-9.00,$232083.50,351,$-9.00
2025-05-12,12:52:00,20930.5,BUY,3,0.02h,Stop Loss,$-9.00,$-18.00,$232074.50,351,$-18.00
2025-05-12,13:00:00,20916.25,SELL,3,0.02h,Stop Loss,$-9.00,$-27.00,$232065.50,351,$-27.00
2025-05-12,13:01:00,20938.0,BUY,3,0.02h,Break Even,$-1.50,$-28.50,$232064.00,351,$-28.50
2025-05-12,13:06:00,20910.75,SELL,3,0.02h,Stop Loss,$30.00,$1.50,$232094.00,351,$1.50
2025-05-12,13:20:00,20918.75,BUY,3,0.02h,Stop Loss,$18.00,$19.50,$232112.00,351,$19.50
2025-05-12,13:31:00,20865.5,SELL,3,0.02h,Stop Loss,$247.50,$267.00,$232359.50,351,$267.00
2025-05-12,14:08:00,20815.25,BUY,3,0.02h,Break Even,$-1.50,$265.50,$232358.00,351,$265.50
2025-05-12,14:26:00,20799.0,SELL,3,0.02h,Stop Loss,$172.50,$438.00,$232530.50,351,$438.00
2025-05-12,14:45:00,20794.75,BUY,3,0.02h,Stop Loss,$22.50,$460.50,$232553.00,351,$460.50
2025-05-12,15:08:00,20775.25,SELL,3,0.02h,Stop Loss,$9.00,$469.50,$232562.00,351,$469.50
2025-05-12,15:13:00,20790.25,BUY,3,0.02h,Stop Loss,$30.00,$499.50,$232592.00,351,$499.50
2025-05-12,15:23:00,20769.0,SELL,3,0.02h,Stop Loss,$66.00,$565.50,$232658.00,351,$565.50
2025-05-12,15:31:00,20785.0,BUY,3,0.02h,Stop Loss,$52.50,$618.00,$232710.50,351,$618.00
2025-05-12,15:42:00,20765.25,SELL,3,0.02h,Break Even,$-1.50,$616.50,$232709.00,351,$616.50
2025-05-12,15:49:00,20790.5,BUY,3,0.02h,Stop Loss,$-9.00,$607.50,$232700.00,351,$607.50
2025-05-12,15:51:00,20781.5,SELL,3,0.02h,Stop Loss,$118.50,$726.00,$232818.50,351,$726.00
2025-05-12,16:06:00,20785.5,BUY,3,0.02h,Stop Loss,$60.00,$786.00,$232878.50,351,$786.00
2025-05-12,17:25:00,20894.25,SELL,3,0.02h,Stop Loss,$10.50,$796.50,$232889.00,351,$796.50
2025-05-12,17:31:00,20906.75,BUY,3,0.02h,Stop Loss,$40.50,$837.00,$232929.50,351,$837.00
2025-05-12,18:11:00,20905.25,SELL,3,0.02h,Stop Loss,$45.00,$882.00,$232974.50,351,$882.00
2025-05-12,18:19:00,20924.25,BUY,3,0.02h,Stop Loss,$4.50,$886.50,$232979.00,351,$886.50
2025-05-12,18:49:00,20922.75,SELL,3,0.02h,Stop Loss,$22.50,$909.00,$233001.50,351,$909.00
2025-05-12,19:08:00,20921.75,BUY,3,0.02h,Break Even,$-1.50,$907.50,$233000.00,351,$907.50
2025-05-12,19:15:00,20902.75,SELL,3,0.02h,Stop Loss,$46.50,$954.00,$233046.50,351,$954.00
2025-05-12,19:51:00,20908.75,BUY,3,0.02h,Stop Loss,$-9.00,$945.00,$233037.50,351,$945.00
2025-05-12,22:01:00,20934.5,SELL,3,0.02h,Stop Loss,$-9.00,$936.00,$233028.50,351,$936.00
,,,,,,,,,,,
2025-05-13,12:00:00,20941.5,BUY,3,0.02h,Stop Loss,$28.50,$28.50,$233057.00,352,$28.50
2025-05-13,12:48:00,20991.75,SELL,3,0.02h,Break Even,$-1.50,$27.00,$233055.50,352,$27.00
2025-05-13,12:50:00,21006.0,BUY,3,0.02h,Break Even,$-1.50,$25.50,$233054.00,352,$25.50
2025-05-13,13:27:00,20996.75,SELL,3,0.02h,Stop Loss,$10.50,$36.00,$233064.50,352,$36.00
2025-05-13,13:34:00,21033.5,BUY,3,0.02h,Stop Loss,$15.00,$51.00,$233079.50,352,$51.00
2025-05-13,14:45:00,21191.75,SELL,3,0.02h,Stop Loss,$10.50,$61.50,$233090.00,352,$61.50
2025-05-13,14:51:00,21228.0,BUY,3,0.02h,Break Even,$-1.50,$60.00,$233088.50,352,$60.00
2025-05-13,15:54:00,21278.5,SELL,3,0.02h,Break Even,$-1.50,$58.50,$233087.00,352,$58.50
2025-05-13,15:57:00,21290.0,BUY,3,0.02h,Stop Loss,$13.50,$72.00,$233100.50,352,$72.00
2025-05-13,16:01:00,21271.25,SELL,3,0.02h,Stop Loss,$6.00,$78.00,$233106.50,352,$78.00
2025-05-13,16:15:00,21288.5,BUY,3,0.02h,Stop Loss,$-9.00,$69.00,$233097.50,352,$69.00
2025-05-13,17:04:00,21316.0,SELL,3,0.02h,Stop Loss,$-9.00,$60.00,$233088.50,352,$60.00
2025-05-13,17:19:00,21326.25,BUY,3,0.02h,Break Even,$-1.50,$58.50,$233087.00,352,$58.50
2025-05-13,17:22:00,21310.0,SELL,3,0.02h,Stop Loss,$-9.00,$49.50,$233078.00,352,$49.50
2025-05-13,17:28:00,21318.75,BUY,3,0.02h,Stop Loss,$-9.00,$40.50,$233069.00,352,$40.50
2025-05-13,17:29:00,21313.25,SELL,3,0.02h,Stop Loss,$-9.00,$31.50,$233060.00,352,$31.50
2025-05-13,17:31:00,21323.0,BUY,3,0.02h,Stop Loss,$40.50,$72.00,$233100.50,352,$72.00
2025-05-13,17:54:00,21319.5,SELL,3,0.02h,Stop Loss,$45.00,$117.00,$233145.50,352,$117.00
2025-05-13,18:21:00,21313.5,BUY,3,0.02h,Stop Loss,$-9.00,$108.00,$233136.50,352,$108.00
2025-05-13,18:32:00,21299.0,SELL,3,0.02h,Break Even,$-1.50,$106.50,$233135.00,352,$106.50
2025-05-13,18:57:00,21315.25,BUY,3,0.02h,Stop Loss,$46.50,$153.00,$233181.50,352,$153.00
2025-05-13,19:28:00,21323.5,SELL,3,0.02h,Stop Loss,$-9.00,$144.00,$233172.50,352,$144.00
2025-05-13,19:29:00,21328.0,BUY,3,0.02h,Break Even,$-1.50,$142.50,$233171.00,352,$142.50
2025-05-13,19:30:00,21321.0,SELL,3,0.02h,Stop Loss,$3.00,$145.50,$233174.00,352,$145.50
2025-05-13,19:31:00,21327.75,BUY,3,0.02h,Break Even,$-1.50,$144.00,$233172.50,352,$144.00
2025-05-13,19:36:00,21318.75,SELL,3,0.02h,Stop Loss,$-9.00,$135.00,$233163.50,352,$135.00
2025-05-13,19:38:00,21337.75,BUY,3,0.02h,Stop Loss,$10.50,$145.50,$233174.00,352,$145.50
2025-05-13,19:44:00,21323.0,SELL,3,0.02h,Break Even,$-1.50,$144.00,$233172.50,352,$144.00
2025-05-13,20:37:00,21260.5,BUY,3,0.02h,Break Even,$-1.50,$142.50,$233171.00,352,$142.50
2025-05-13,20:56:00,21259.25,SELL,3,0.02h,Break Even,$-1.50,$141.00,$233169.50,352,$141.00
2025-05-13,22:12:00,21260.75,BUY,3,0.02h,Stop Loss,$-9.00,$132.00,$233160.50,352,$132.00
2025-05-13,22:35:00,21259.75,SELL,3,0.02h,Break Even,$-1.50,$130.50,$233159.00,352,$130.50
2025-05-13,22:46:00,21267.25,BUY,3,0.02h,Break Even,$-1.50,$129.00,$233157.50,352,$129.00
2025-05-13,22:55:00,21261.25,SELL,3,0.02h,Stop Loss,$-9.00,$120.00,$233148.50,352,$120.00
2025-05-13,22:58:00,21264.0,BUY,3,0.02h,Stop Loss,$-9.00,$111.00,$233139.50,352,$111.00
2025-05-13,22:59:00,21260.75,SELL,3,0.02h,Break Even,$-1.50,$109.50,$233138.00,352,$109.50
,,,,,,,,,,,
2025-05-14,12:00:00,21344.0,BUY,3,0.02h,Stop Loss,$9.00,$9.00,$233147.00,353,$9.00
2025-05-14,12:39:00,21338.25,SELL,3,0.02h,Stop Loss,$-9.00,$0.00,$233138.00,353,$0.00
2025-05-14,13:14:00,21335.25,BUY,3,0.02h,Stop Loss,$6.00,$6.00,$233144.00,353,$6.00
2025-05-14,13:29:00,21320.5,SELL,3,0.02h,Stop Loss,$36.00,$42.00,$233180.00,353,$42.00
2025-05-14,13:33:00,21361.25,BUY,3,0.02h,Stop Loss,$49.50,$91.50,$233229.50,353,$91.50
2025-05-14,13:47:00,21320.5,SELL,3,0.02h,Stop Loss,$87.00,$178.50,$233316.50,353,$178.50
2025-05-14,14:07:00,21340.25,BUY,3,0.02h,Break Even,$-1.50,$177.00,$233315.00,353,$177.00
2025-05-14,14:21:00,21317.0,SELL,3,0.02h,Stop Loss,$34.50,$211.50,$233349.50,353,$211.50
2025-05-14,14:24:00,21332.5,BUY,3,0.02h,Stop Loss,$19.50,$231.00,$233369.00,353,$231.00
2025-05-14,14:42:00,21323.5,SELL,3,0.02h,Stop Loss,$9.00,$240.00,$233378.00,353,$240.00
2025-05-14,14:50:00,21344.25,BUY,3,0.02h,Stop Loss,$60.00,$300.00,$233438.00,353,$300.00
2025-05-14,15:04:00,21327.0,SELL,3,0.02h,Stop Loss,$178.50,$478.50,$233616.50,353,$478.50
2025-05-14,15:16:00,21344.5,BUY,3,0.02h,Stop Loss,$16.50,$495.00,$233633.00,353,$495.00
2025-05-14,15:52:00,21368.75,SELL,3,0.02h,Stop Loss,$-9.00,$486.00,$233624.00,353,$486.00
2025-05-14,15:54:00,21380.0,BUY,3,0.02h,Break Even,$-1.50,$484.50,$233622.50,353,$484.50
2025-05-14,15:55:00,21368.5,SELL,3,0.02h,Stop Loss,$30.00,$514.50,$233652.50,353,$514.50
2025-05-14,15:57:00,21377.25,BUY,3,0.02h,Break Even,$-1.50,$513.00,$233651.00,353,$513.00
2025-05-14,16:20:00,21370.5,SELL,3,0.02h,Stop Loss,$-9.00,$504.00,$233642.00,353,$504.00
2025-05-14,16:30:00,21384.75,BUY,3,0.02h,Stop Loss,$7.50,$511.50,$233649.50,353,$511.50
2025-05-14,16:42:00,21370.25,SELL,3,0.02h,Stop Loss,$-9.00,$502.50,$233640.50,353,$502.50
2025-05-14,17:39:00,21333.25,BUY,3,0.02h,Stop Loss,$16.50,$519.00,$233657.00,353,$519.00
2025-05-14,18:28:00,21349.25,SELL,3,0.02h,Stop Loss,$63.00,$582.00,$233720.00,353,$582.00
2025-05-14,18:35:00,21390.75,BUY,3,0.02h,Stop Loss,$4.50,$586.50,$233724.50,353,$586.50
2025-05-14,19:01:00,21361.75,SELL,3,0.02h,Stop Loss,$25.50,$612.00,$233750.00,353,$612.00
2025-05-14,19:15:00,21369.0,BUY,3,0.02h,Stop Loss,$24.00,$636.00,$233774.00,353,$636.00
2025-05-14,19:23:00,21354.0,SELL,3,0.02h,Stop Loss,$78.00,$714.00,$233852.00,353,$714.00
2025-05-14,19:51:00,21377.75,BUY,3,0.02h,Stop Loss,$49.50,$763.50,$233901.50,353,$763.50
2025-05-14,20:54:00,21398.5,SELL,3,0.02h,Stop Loss,$-9.00,$754.50,$233892.50,353,$754.50
2025-05-14,22:30:00,21378.25,BUY,3,0.02h,Break Even,$-1.50,$753.00,$233891.00,353,$753.00
2025-05-14,22:46:00,21374.5,SELL,3,0.02h,Break Even,$-1.50,$751.50,$233889.50,353,$751.50
2025-05-14,22:49:00,21380.25,BUY,3,0.02h,Stop Loss,$6.00,$757.50,$233895.50,353,$757.50
,,,,,,,,,,,
2025-05-15,12:00:00,21274.75,SELL,3,0.02h,Break Even,$-1.50,$-1.50,$233894.00,354,$-1.50
2025-05-15,12:33:00,21309.0,BUY,3,0.02h,Stop Loss,$82.50,$81.00,$233976.50,354,$81.00
2025-05-15,12:50:00,21278.25,SELL,3,0.02h,Stop Loss,$49.50,$130.50,$234026.00,354,$130.50
2025-05-15,13:04:00,21301.25,BUY,3,0.02h,Stop Loss,$-9.00,$121.50,$234017.00,354,$121.50
2025-05-15,13:22:00,21294.75,SELL,3,0.02h,Stop Loss,$4.50,$126.00,$234021.50,354,$126.00
2025-05-15,13:30:00,21303.5,BUY,3,0.02h,Stop Loss,$6.00,$132.00,$234027.50,354,$132.00
2025-05-15,13:31:00,21287.25,SELL,3,0.02h,Stop Loss,$7.50,$139.50,$234035.00,354,$139.50
2025-05-15,13:32:00,21313.75,BUY,3,0.02h,Stop Loss,$106.50,$246.00,$234141.50,354,$246.00
2025-05-15,13:42:00,21294.75,SELL,3,0.02h,Stop Loss,$12.00,$258.00,$234153.50,354,$258.00
2025-05-15,13:45:00,21316.75,BUY,3,0.02h,Stop Loss,$6.00,$264.00,$234159.50,354,$264.00
2025-05-15,13:47:00,21269.0,SELL,3,0.02h,Stop Loss,$46.50,$310.50,$234206.00,354,$310.50
2025-05-15,14:01:00,21314.0,BUY,3,0.02h,Stop Loss,$177.00,$487.50,$234383.00,354,$487.50
2025-05-15,14:13:00,21297.5,SELL,3,0.02h,Stop Loss,$28.50,$516.00,$234411.50,354,$516.00
2025-05-15,14:21:00,21324.0,BUY,3,0.02h,Stop Loss,$9.00,$525.00,$234420.50,354,$525.00
2025-05-15,14:30:00,21288.5,SELL,3,0.02h,Stop Loss,$15.00,$540.00,$234435.50,354,$540.00
2025-05-15,14:46:00,21301.5,BUY,3,0.02h,Stop Loss,$16.50,$556.50,$234452.00,354,$556.50
2025-05-15,16:26:00,21432.75,SELL,3,0.02h,Stop Loss,$-9.00,$547.50,$234443.00,354,$547.50
2025-05-15,16:31:00,21441.25,BUY,3,0.02h,Stop Loss,$7.50,$555.00,$234450.50,354,$555.00
2025-05-15,16:33:00,21428.75,SELL,3,0.02h,Stop Loss,$-9.00,$546.00,$234441.50,354,$546.00
2025-05-15,16:37:00,21455.25,BUY,3,0.02h,Stop Loss,$18.00,$564.00,$234459.50,354,$564.00
2025-05-15,17:35:00,21491.5,SELL,3,0.02h,Stop Loss,$40.50,$604.50,$234500.00,354,$604.50
2025-05-15,18:33:00,21435.0,BUY,3,0.02h,Stop Loss,$9.00,$613.50,$234509.00,354,$613.50
2025-05-15,18:48:00,21411.5,SELL,3,0.02h,Stop Loss,$31.50,$645.00,$234540.50,354,$645.00
2025-05-15,19:42:00,21375.5,BUY,3,0.02h,Stop Loss,$18.00,$663.00,$234558.50,354,$663.00
2025-05-15,20:28:00,21403.75,SELL,3,0.02h,Stop Loss,$-9.00,$654.00,$234549.50,354,$654.00
2025-05-15,22:29:00,21398.25,BUY,3,0.02h,Stop Loss,$-9.00,$645.00,$234540.50,354,$645.00
2025-05-15,22:43:00,21394.25,SELL,3,0.02h,Break Even,$-1.50,$643.50,$234539.00,354,$643.50
2025-05-15,22:46:00,21399.5,BUY,3,0.02h,Stop Loss,$-9.00,$634.50,$234530.00,354,$634.50
2025-05-15,22:47:00,21393.0,SELL,3,0.02h,Break Even,$-1.50,$633.00,$234528.50,354,$633.00
,,,,,,,,,,,
2025-05-16,12:00:00,21481.0,BUY,3,0.02h,Stop Loss,$13.50,$13.50,$234542.00,355,$13.50
2025-05-16,12:35:00,21470.0,SELL,3,0.02h,Break Even,$-1.50,$12.00,$234540.50,355,$12.00
2025-05-16,13:09:00,21453.5,BUY,3,0.02h,Stop Loss,$16.50,$28.50,$234557.00,355,$28.50
2025-05-16,13:28:00,21446.5,SELL,3,0.02h,Stop Loss,$-9.00,$19.50,$234548.00,355,$19.50
2025-05-16,13:29:00,21479.5,BUY,3,0.02h,Stop Loss,$4.50,$24.00,$234552.50,355,$24.00
2025-05-16,13:31:00,21435.25,SELL,3,0.02h,Stop Loss,$82.50,$106.50,$234635.00,355,$106.50
2025-05-16,13:57:00,21443.75,BUY,3,0.02h,Stop Loss,$-9.00,$97.50,$234626.00,355,$97.50
2025-05-16,14:01:00,21408.5,SELL,3,0.02h,Stop Loss,$12.00,$109.50,$234638.00,355,$109.50
2025-05-16,14:18:00,21438.0,BUY,3,0.02h,Stop Loss,$81.00,$190.50,$234719.00,355,$190.50
2025-05-16,14:30:00,21412.75,SELL,3,0.02h,Stop Loss,$90.00,$280.50,$234809.00,355,$280.50
2025-05-16,14:56:00,21402.75,BUY,3,0.02h,Stop Loss,$-9.00,$271.50,$234800.00,355,$271.50
2025-05-16,15:22:00,21387.0,SELL,3,0.02h,Stop Loss,$40.50,$312.00,$234840.50,355,$312.00
2025-05-16,15:29:00,21398.25,BUY,3,0.02h,Break Even,$-1.50,$310.50,$234839.00,355,$310.50
2025-05-16,15:58:00,21415.75,SELL,3,0.02h,Stop Loss,$27.00,$337.50,$234866.00,355,$337.50
2025-05-16,16:02:00,21427.5,BUY,3,0.02h,Stop Loss,$16.50,$354.00,$234882.50,355,$354.00
2025-05-16,16:35:00,21425.25,SELL,3,0.02h,Stop Loss,$-9.00,$345.00,$234873.50,355,$345.00
2025-05-16,16:55:00,21438.0,BUY,3,0.02h,Stop Loss,$30.00,$375.00,$234903.50,355,$375.00
2025-05-16,17:01:00,21423.75,SELL,3,0.02h,Stop Loss,$-9.00,$366.00,$234894.50,355,$366.00
2025-05-16,17:05:00,21437.5,BUY,3,0.02h,Stop Loss,$-9.00,$357.00,$234885.50,355,$357.00
2025-05-16,17:46:00,21457.75,SELL,3,0.02h,Stop Loss,$21.00,$378.00,$234906.50,355,$378.00
2025-05-16,18:14:00,21457.5,BUY,3,0.02h,Break Even,$-1.50,$376.50,$234905.00,355,$376.50
2025-05-16,19:32:00,21488.75,SELL,3,0.02h,Break Even,$-1.50,$375.00,$234903.50,355,$375.00
2025-05-16,19:50:00,21493.5,BUY,3,0.02h,Stop Loss,$52.50,$427.50,$234956.00,355,$427.50
2025-05-16,20:17:00,21493.0,SELL,3,0.02h,Break Even,$-1.50,$426.00,$234954.50,355,$426.00
2025-05-16,20:22:00,21501.0,BUY,3,0.02h,Break Even,$-1.50,$424.50,$234953.00,355,$424.50
2025-05-16,20:43:00,21489.25,SELL,3,0.02h,Break Even,$-1.50,$423.00,$234951.50,355,$423.00
,,,,,,,,,,,
2025-05-19,12:43:00,21194.5,BUY,3,0.02h,Stop Loss,$19.50,$19.50,$234971.00,356,$19.50
2025-05-19,13:08:00,21196.25,SELL,3,0.02h,Break Even,$-1.50,$18.00,$234969.50,356,$18.00
2025-05-19,13:12:00,21207.5,BUY,3,0.02h,Stop Loss,$18.00,$36.00,$234987.50,356,$36.00
2025-05-19,13:14:00,21181.0,SELL,3,0.02h,Stop Loss,$129.00,$165.00,$235116.50,356,$165.00
2025-05-19,13:29:00,21196.25,BUY,3,0.02h,Stop Loss,$25.50,$190.50,$235142.00,356,$190.50
2025-05-19,14:29:00,21394.75,SELL,3,0.02h,Stop Loss,$-9.00,$181.50,$235133.00,356,$181.50
2025-05-19,14:41:00,21427.0,BUY,3,0.02h,Break Even,$-1.50,$180.00,$235131.50,356,$180.00
2025-05-19,14:49:00,21396.0,SELL,3,0.02h,Stop Loss,$58.50,$238.50,$235190.00,356,$238.50
2025-05-19,15:12:00,21422.0,BUY,3,0.02h,Stop Loss,$13.50,$252.00,$235203.50,356,$252.00
2025-05-19,15:27:00,21405.0,SELL,3,0.02h,Break Even,$-1.50,$250.50,$235202.00,356,$250.50
2025-05-19,15:33:00,21426.0,BUY,3,0.02h,Stop Loss,$-9.00,$241.50,$235193.00,356,$241.50
2025-05-19,15:52:00,21424.5,SELL,3,0.02h,Stop Loss,$-9.00,$232.50,$235184.00,356,$232.50
2025-05-19,16:04:00,21440.25,BUY,3,0.02h,Stop Loss,$25.50,$258.00,$235209.50,356,$258.00
2025-05-19,16:43:00,21450.5,SELL,3,0.02h,Break Even,$-1.50,$256.50,$235208.00,356,$256.50
2025-05-19,16:48:00,21461.75,BUY,3,0.02h,Stop Loss,$3.00,$259.50,$235211.00,356,$259.50
2025-05-19,17:33:00,21519.25,SELL,3,0.02h,Stop Loss,$6.00,$265.50,$235217.00,356,$265.50
2025-05-19,17:34:00,21530.75,BUY,3,0.02h,Stop Loss,$51.00,$316.50,$235268.00,356,$316.50
2025-05-19,17:41:00,21518.25,SELL,3,0.02h,Break Even,$-1.50,$315.00,$235266.50,356,$315.00
2025-05-19,18:36:00,21483.5,BUY,3,0.02h,Stop Loss,$21.00,$336.00,$235287.50,356,$336.00
2025-05-19,18:48:00,21472.5,SELL,3,0.02h,Stop Loss,$7.50,$343.50,$235295.00,356,$343.50
2025-05-19,18:51:00,21483.0,BUY,3,0.02h,Stop Loss,$19.50,$363.00,$235314.50,356,$363.00
2025-05-19,19:11:00,21474.25,SELL,3,0.02h,Stop Loss,$-9.00,$354.00,$235305.50,356,$354.00
2025-05-19,19:39:00,21475.25,BUY,3,0.02h,Stop Loss,$10.50,$364.50,$235316.00,356,$364.50
2025-05-19,19:45:00,21462.5,SELL,3,0.02h,Break Even,$-1.50,$363.00,$235314.50,356,$363.00
2025-05-19,19:46:00,21473.25,BUY,3,0.02h,Break Even,$-1.50,$361.50,$235313.00,356,$361.50
2025-05-19,20:09:00,21486.75,SELL,3,0.02h,Stop Loss,$-9.00,$352.50,$235304.00,356,$352.50
2025-05-19,20:25:00,21492.25,BUY,3,0.02h,Stop Loss,$4.50,$357.00,$235308.50,356,$357.00
2025-05-19,22:03:00,21499.75,SELL,3,0.02h,Stop Loss,$-9.00,$348.00,$235299.50,356,$348.00
2025-05-19,22:10:00,21509.0,BUY,3,0.02h,Break Even,$-1.50,$346.50,$235298.00,356,$346.50
2025-05-19,22:20:00,21506.25,SELL,3,0.02h,Break Even,$-1.50,$345.00,$235296.50,356,$345.00
2025-05-19,22:22:00,21510.5,BUY,3,0.02h,Break Even,$-1.50,$343.50,$235295.00,356,$343.50
2025-05-19,22:28:00,21505.0,SELL,3,0.02h,Break Even,$-1.50,$342.00,$235293.50,356,$342.00
,,,,,,,,,,,
2025-05-20,13:02:00,21442.5,BUY,3,0.02h,Break Even,$-1.50,$-1.50,$235292.00,357,$-1.50
2025-05-20,13:25:00,21431.0,SELL,3,0.02h,Stop Loss,$9.00,$7.50,$235301.00,357,$7.50
2025-05-20,14:19:00,21407.25,BUY,3,0.02h,Stop Loss,$19.50,$27.00,$235320.50,357,$27.00
2025-05-20,14:33:00,21388.0,SELL,3,0.02h,Stop Loss,$18.00,$45.00,$235338.50,357,$45.00
2025-05-20,14:36:00,21407.5,BUY,3,0.02h,Break Even,$-1.50,$43.50,$235337.00,357,$43.50
2025-05-20,14:59:00,21410.25,SELL,3,0.02h,Stop Loss,$25.50,$69.00,$235362.50,357,$69.00
2025-05-20,15:18:00,21424.5,BUY,3,0.02h,Break Even,$-1.50,$67.50,$235361.00,357,$67.50
2025-05-20,15:25:00,21408.5,SELL,3,0.02h,Stop Loss,$9.00,$76.50,$235370.00,357,$76.50
2025-05-20,15:28:00,21423.25,BUY,3,0.02h,Break Even,$-1.50,$75.00,$235368.50,357,$75.00
2025-05-20,15:36:00,21414.5,SELL,3,0.02h,Stop Loss,$4.50,$79.50,$235373.00,357,$79.50
2025-05-20,15:51:00,21420.75,BUY,3,0.02h,Stop Loss,$-9.00,$70.50,$235364.00,357,$70.50
2025-05-20,16:11:00,21411.75,SELL,3,0.02h,Stop Loss,$31.50,$102.00,$235395.50,357,$102.00
2025-05-20,16:21:00,21430.25,BUY,3,0.02h,Break Even,$-1.50,$100.50,$235394.00,357,$100.50
2025-05-20,16:25:00,21413.5,SELL,3,0.02h,Stop Loss,$28.50,$129.00,$235422.50,357,$129.00
2025-05-20,16:28:00,21434.75,BUY,3,0.02h,Stop Loss,$9.00,$138.00,$235431.50,357,$138.00
2025-05-20,17:18:00,21460.25,SELL,3,0.02h,Stop Loss,$12.00,$150.00,$235443.50,357,$150.00
2025-05-20,18:05:00,21435.5,BUY,3,0.02h,Break Even,$-1.50,$148.50,$235442.00,357,$148.50
2025-05-20,18:17:00,21419.5,SELL,3,0.02h,Stop Loss,$18.00,$166.50,$235460.00,357,$166.50
2025-05-20,19:15:00,21354.5,BUY,3,0.02h,Stop Loss,$-9.00,$157.50,$235451.00,357,$157.50
2025-05-20,20:11:00,21407.0,SELL,3,0.02h,Stop Loss,$-9.00,$148.50,$235442.00,357,$148.50
2025-05-20,20:21:00,21423.75,BUY,3,0.02h,Break Even,$-1.50,$147.00,$235440.50,357,$147.00
2025-05-20,20:41:00,21424.25,SELL,3,0.02h,Break Even,$-1.50,$145.50,$235439.00,357,$145.50
2025-05-20,22:31:00,21385.25,BUY,3,0.02h,Stop Loss,$-9.00,$136.50,$235430.00,357,$136.50
,,,,,,,,,,,
2025-05-21,12:00:00,21339.5,SELL,3,0.02h,Stop Loss,$15.00,$15.00,$235445.00,358,$15.00
2025-05-21,12:28:00,21335.25,BUY,3,0.02h,Break Even,$-1.50,$13.50,$235443.50,358,$13.50
2025-05-21,12:31:00,21303.75,SELL,3,0.02h,Stop Loss,$6.00,$19.50,$235449.50,358,$19.50
2025-05-21,12:58:00,21309.25,BUY,3,0.02h,Stop Loss,$16.50,$36.00,$235466.00,358,$36.00
2025-05-21,13:07:00,21300.25,SELL,3,0.02h,Stop Loss,$27.00,$63.00,$235493.00,358,$63.00
2025-05-21,13:32:00,21324.25,BUY,3,0.02h,Stop Loss,$63.00,$126.00,$235556.00,358,$126.00
2025-05-21,14:30:00,21383.25,SELL,3,0.02h,Stop Loss,$-9.00,$117.00,$235547.00,358,$117.00
2025-05-21,14:31:00,21404.0,BUY,3,0.02h,Stop Loss,$19.50,$136.50,$235566.50,358,$136.50
2025-05-21,14:34:00,21381.25,SELL,3,0.02h,Stop Loss,$28.50,$165.00,$235595.00,358,$165.00
2025-05-21,14:40:00,21403.75,BUY,3,0.02h,Stop Loss,$60.00,$225.00,$235655.00,358,$225.00
2025-05-21,14:47:00,21390.5,SELL,3,0.02h,Stop Loss,$39.00,$264.00,$235694.00,358,$264.00
2025-05-21,14:50:00,21403.75,BUY,3,0.02h,Stop Loss,$51.00,$315.00,$235745.00,358,$315.00
2025-05-21,15:39:00,21505.25,SELL,3,0.02h,Break Even,$-1.50,$313.50,$235743.50,358,$313.50
2025-05-21,15:40:00,21512.0,BUY,3,0.02h,Stop Loss,$34.50,$348.00,$235778.00,358,$348.00
2025-05-21,16:22:00,21520.5,SELL,3,0.02h,Stop Loss,$13.50,$361.50,$235791.50,358,$361.50
2025-05-21,16:31:00,21538.25,BUY,3,0.02h,Break Even,$-1.50,$360.00,$235790.00,358,$360.00
2025-05-21,16:57:00,21521.0,SELL,3,0.02h,Stop Loss,$-9.00,$351.00,$235781.00,358,$351.00
2025-05-21,18:31:00,21244.25,BUY,3,0.02h,Stop Loss,$84.00,$435.00,$235865.00,358,$435.00
2025-05-21,18:49:00,21233.0,SELL,3,0.02h,Stop Loss,$139.50,$574.50,$236004.50,358,$574.50
2025-05-21,19:34:00,21155.25,BUY,3,0.02h,Break Even,$-1.50,$573.00,$236003.00,358,$573.00
2025-05-21,20:00:00,21150.25,SELL,3,0.02h,Stop Loss,$61.50,$634.50,$236064.50,358,$634.50
2025-05-21,20:34:00,21142.25,BUY,3,0.02h,Stop Loss,$10.50,$645.00,$236075.00,358,$645.00
2025-05-21,22:09:00,21122.5,SELL,3,0.02h,Stop Loss,$3.00,$648.00,$236078.00,358,$648.00
2025-05-21,22:25:00,21142.0,BUY,3,0.02h,Stop Loss,$-9.00,$639.00,$236069.00,358,$639.00
2025-05-21,22:46:00,21139.5,SELL,3,0.02h,Stop Loss,$16.50,$655.50,$236085.50,358,$655.50
2025-05-21,22:59:00,21148.0,BUY,3,0.02h,Break Even,$-1.50,$654.00,$236084.00,358,$654.00
,,,,,,,,,,,
2025-05-22,12:00:00,21082.25,SELL,3,0.02h,Break Even,$-1.50,$-1.50,$236082.50,359,$-1.50
2025-05-22,12:36:00,21092.5,BUY,3,0.02h,Stop Loss,$37.50,$36.00,$236120.00,359,$36.00
2025-05-22,13:20:00,21170.0,SELL,3,0.02h,Stop Loss,$6.00,$42.00,$236126.00,359,$42.00
2025-05-22,13:51:00,21199.75,BUY,3,0.02h,Stop Loss,$57.00,$99.00,$236183.00,359,$99.00
2025-05-22,14:20:00,21261.5,SELL,3,0.02h,Stop Loss,$58.50,$157.50,$236241.50,359,$157.50
2025-05-22,15:03:00,21240.5,BUY,3,0.02h,Stop Loss,$6.00,$163.50,$236247.50,359,$163.50
2025-05-22,15:17:00,21215.0,SELL,3,0.02h,Stop Loss,$24.00,$187.50,$236271.50,359,$187.50
2025-05-22,15:22:00,21256.25,BUY,3,0.02h,Break Even,$-1.50,$186.00,$236270.00,359,$186.00
2025-05-22,15:30:00,21207.0,SELL,3,0.02h,Stop Loss,$37.50,$223.50,$236307.50,359,$223.50
2025-05-22,15:36:00,21249.75,BUY,3,0.02h,Break Even,$-1.50,$222.00,$236306.00,359,$222.00
2025-05-22,15:37:00,21233.0,SELL,3,0.02h,Break Even,$-1.50,$220.50,$236304.50,359,$220.50
2025-05-22,15:38:00,21242.0,BUY,3,0.02h,Stop Loss,$75.00,$295.50,$236379.50,359,$295.50
2025-05-22,16:26:00,21278.5,SELL,3,0.02h,Stop Loss,$72.00,$367.50,$236451.50,359,$367.50
2025-05-22,17:19:00,21240.75,BUY,3,0.02h,Break Even,$-1.50,$366.00,$236450.00,359,$366.00
2025-05-22,18:31:00,21286.75,SELL,3,0.02h,Stop Loss,$-9.00,$357.00,$236441.00,359,$357.00
2025-05-22,18:34:00,21298.25,BUY,3,0.02h,Break Even,$-1.50,$355.50,$236439.50,359,$355.50
2025-05-22,18:39:00,21286.25,SELL,3,0.02h,Stop Loss,$21.00,$376.50,$236460.50,359,$376.50
2025-05-22,18:53:00,21305.5,BUY,3,0.02h,Stop Loss,$-9.00,$367.50,$236451.50,359,$367.50
2025-05-22,19:22:00,21307.25,SELL,3,0.02h,Break Even,$-1.50,$366.00,$236450.00,359,$366.00
2025-05-22,19:28:00,21326.0,BUY,3,0.02h,Break Even,$-1.50,$364.50,$236448.50,359,$364.50
2025-05-22,19:34:00,21296.25,SELL,3,0.02h,Break Even,$-1.50,$363.00,$236447.00,359,$363.00
2025-05-22,20:38:00,21191.0,BUY,3,0.02h,Break Even,$-1.50,$361.50,$236445.50,359,$361.50
2025-05-22,22:14:00,21200.5,SELL,3,0.02h,Stop Loss,$-9.00,$352.50,$236436.50,359,$352.50
,,,,,,,,,,,
2025-05-23,12:36:00,20828.75,BUY,3,0.02h,Break Even,$-1.50,$-1.50,$236435.00,360,$-1.50
2025-05-23,12:53:00,20797.25,SELL,3,0.02h,Stop Loss,$16.50,$15.00,$236451.50,360,$15.00
2025-05-23,13:12:00,20805.25,BUY,3,0.02h,Stop Loss,$-9.00,$6.00,$236442.50,360,$6.00
2025-05-23,13:14:00,20779.5,SELL,3,0.02h,Break Even,$-1.50,$4.50,$236441.00,360,$4.50
2025-05-23,13:19:00,20794.0,BUY,3,0.02h,Stop Loss,$75.00,$79.50,$236516.00,360,$79.50
2025-05-23,13:22:00,20779.5,SELL,3,0.02h,Stop Loss,$3.00,$82.50,$236519.00,360,$82.50
2025-05-23,13:26:00,20816.75,BUY,3,0.02h,Stop Loss,$81.00,$163.50,$236600.00,360,$163.50
2025-05-23,13:54:00,20858.25,SELL,3,0.02h,Stop Loss,$40.50,$204.00,$236640.50,360,$204.00
2025-05-23,13:58:00,20877.0,BUY,3,0.02h,Stop Loss,$52.50,$256.50,$236693.00,360,$256.50
2025-05-23,14:52:00,20941.25,SELL,3,0.02h,Stop Loss,$52.50,$309.00,$236745.50,360,$309.00
2025-05-23,15:21:00,20942.75,BUY,3,0.02h,Stop Loss,$58.50,$367.50,$236804.00,360,$367.50
2025-05-23,15:53:00,20945.75,SELL,3,0.02h,Stop Loss,$15.00,$382.50,$236819.00,360,$382.50
2025-05-23,16:22:00,20962.0,BUY,3,0.02h,Stop Loss,$40.50,$423.00,$236859.50,360,$423.00
2025-05-23,16:34:00,20942.75,SELL,3,0.02h,Stop Loss,$16.50,$439.50,$236876.00,360,$439.50
2025-05-23,16:38:00,20978.75,BUY,3,0.02h,Stop Loss,$4.50,$444.00,$236880.50,360,$444.00
2025-05-23,17:41:00,21027.0,SELL,3,0.02h,Stop Loss,$-9.00,$435.00,$236871.50,360,$435.00
2025-05-23,17:52:00,21058.75,BUY,3,0.02h,Stop Loss,$63.00,$498.00,$236934.50,360,$498.00
2025-05-23,18:20:00,21041.75,SELL,3,0.02h,Stop Loss,$133.50,$631.50,$237068.00,360,$631.50
2025-05-23,18:36:00,21064.25,BUY,3,0.02h,Break Even,$-1.50,$630.00,$237066.50,360,$630.00
2025-05-23,18:46:00,21041.75,SELL,3,0.02h,Stop Loss,$63.00,$693.00,$237129.50,360,$693.00
2025-05-23,18:56:00,21052.75,BUY,3,0.02h,Break Even,$-1.50,$691.50,$237128.00,360,$691.50
2025-05-23,18:58:00,21042.0,SELL,3,0.02h,Stop Loss,$34.50,$726.00,$237162.50,360,$726.00
2025-05-23,19:11:00,21048.5,BUY,3,0.02h,Stop Loss,$91.50,$817.50,$237254.00,360,$817.50
2025-05-23,19:20:00,21028.75,SELL,3,0.02h,Stop Loss,$33.00,$850.50,$237287.00,360,$850.50
2025-05-23,19:38:00,21030.75,BUY,3,0.02h,Stop Loss,$58.50,$909.00,$237345.50,360,$909.00
2025-05-23,19:49:00,21013.75,SELL,3,0.02h,Stop Loss,$30.00,$939.00,$237375.50,360,$939.00
2025-05-23,20:58:00,20946.25,BUY,3,0.02h,Stop Loss,$49.50,$988.50,$237425.00,360,$988.50
,,,,,,,,,,,
2025-05-26,12:49:00,21267.75,SELL,3,0.02h,Break Even,$-1.50,$-1.50,$237423.50,361,$-1.50
2025-05-26,12:53:00,21273.25,BUY,3,0.02h,Stop Loss,$-9.00,$-10.50,$237414.50,361,$-10.50
2025-05-26,12:59:00,21264.25,SELL,3,0.02h,Stop Loss,$6.00,$-4.50,$237420.50,361,$-4.50
2025-05-26,13:03:00,21277.25,BUY,3,0.02h,Stop Loss,$-9.00,$-13.50,$237411.50,361,$-13.50
2025-05-26,13:08:00,21268.5,SELL,3,0.02h,Stop Loss,$-9.00,$-22.50,$237402.50,361,$-22.50
2025-05-26,13:12:00,21278.0,BUY,3,0.02h,Break Even,$-1.50,$-24.00,$237401.00,361,$-24.00
2025-05-26,13:21:00,21264.5,SELL,3,0.02h,Break Even,$-1.50,$-25.50,$237399.50,361,$-25.50
2025-05-26,13:33:00,21288.25,BUY,3,0.02h,Stop Loss,$70.50,$45.00,$237470.00,361,$45.00
2025-05-26,13:56:00,21278.25,SELL,3,0.02h,Stop Loss,$3.00,$48.00,$237473.00,361,$48.00
2025-05-26,15:20:00,21236.75,BUY,3,0.02h,Stop Loss,$7.50,$55.50,$237480.50,361,$55.50
2025-05-26,16:26:00,21272.75,SELL,3,0.02h,Break Even,$-1.50,$54.00,$237479.00,361,$54.00
2025-05-26,16:40:00,21277.5,BUY,3,0.02h,Stop Loss,$-9.00,$45.00,$237470.00,361,$45.00
2025-05-26,22:02:00,21270.5,SELL,3,0.02h,Stop Loss,$61.50,$106.50,$237531.50,361,$106.50
2025-05-26,22:17:00,21278.0,BUY,3,0.02h,Stop Loss,$-9.00,$97.50,$237522.50,361,$97.50
2025-05-26,22:20:00,21270.75,SELL,3,0.02h,Stop Loss,$40.50,$138.00,$237563.00,361,$138.00
,,,,,,,,,,,
2025-05-27,12:00:00,21297.0,BUY,3,0.02h,Break Even,$-1.50,$-1.50,$237561.50,362,$-1.50
2025-05-27,12:41:00,21278.25,SELL,3,0.02h,Stop Loss,$16.50,$15.00,$237578.00,362,$15.00
2025-05-27,13:03:00,21281.75,BUY,3,0.02h,Break Even,$-1.50,$13.50,$237576.50,362,$13.50
2025-05-27,13:28:00,21266.0,SELL,3,0.02h,Stop Loss,$34.50,$48.00,$237611.00,362,$48.00
2025-05-27,13:50:00,21265.75,BUY,3,0.02h,Stop Loss,$75.00,$123.00,$237686.00,362,$123.00
2025-05-27,14:57:00,21363.5,SELL,3,0.02h,Break Even,$-1.50,$121.50,$237684.50,362,$121.50
2025-05-27,15:12:00,21373.75,BUY,3,0.02h,Break Even,$-1.50,$120.00,$237683.00,362,$120.00
2025-05-27,15:42:00,21375.5,SELL,3,0.02h,Stop Loss,$-9.00,$111.00,$237674.00,362,$111.00
2025-05-27,15:46:00,21385.5,BUY,3,0.02h,Break Even,$-1.50,$109.50,$237672.50,362,$109.50
2025-05-27,17:34:00,21448.5,SELL,3,0.02h,Break Even,$-1.50,$108.00,$237671.00,362,$108.00
2025-05-27,17:41:00,21456.5,BUY,3,0.02h,Stop Loss,$6.00,$114.00,$237677.00,362,$114.00
2025-05-27,18:19:00,21467.25,SELL,3,0.02h,Stop Loss,$-9.00,$105.00,$237668.00,362,$105.00
2025-05-27,19:25:00,21444.25,BUY,3,0.02h,Stop Loss,$-9.00,$96.00,$237659.00,362,$96.00
2025-05-27,19:28:00,21437.75,SELL,3,0.02h,Break Even,$-1.50,$94.50,$237657.50,362,$94.50
2025-05-27,19:43:00,21442.75,BUY,3,0.02h,Stop Loss,$-9.00,$85.50,$237648.50,362,$85.50
2025-05-27,19:50:00,21426.5,SELL,3,0.02h,Stop Loss,$45.00,$130.50,$237693.50,362,$130.50
2025-05-27,19:54:00,21436.0,BUY,3,0.02h,Stop Loss,$105.00,$235.50,$237798.50,362,$235.50
2025-05-27,20:34:00,21464.0,SELL,3,0.02h,Break Even,$-1.50,$234.00,$237797.00,362,$234.00
2025-05-27,20:36:00,21468.25,BUY,3,0.02h,Stop Loss,$-9.00,$225.00,$237788.00,362,$225.00
2025-05-27,22:03:00,21466.5,SELL,3,0.02h,Stop Loss,$-9.00,$216.00,$237779.00,362,$216.00
2025-05-27,22:42:00,21464.0,BUY,3,0.02h,Stop Loss,$-9.00,$207.00,$237770.00,362,$207.00
,,,,,,,,,,,
2025-05-28,12:52:00,21507.75,SELL,3,0.02h,Break Even,$-1.50,$-1.50,$237768.50,363,$-1.50
2025-05-28,13:14:00,21516.25,BUY,3,0.02h,Break Even,$-1.50,$-3.00,$237767.00,363,$-3.00
2025-05-28,13:18:00,21503.0,SELL,3,0.02h,Stop Loss,$-9.00,$-12.00,$237758.00,363,$-12.00
2025-05-28,13:34:00,21511.75,BUY,3,0.02h,Stop Loss,$67.50,$55.50,$237825.50,363,$55.50
2025-05-28,13:49:00,21491.5,SELL,3,0.02h,Stop Loss,$55.50,$111.00,$237881.00,363,$111.00
2025-05-28,15:05:00,21467.0,BUY,3,0.02h,Break Even,$-1.50,$109.50,$237879.50,363,$109.50
2025-05-28,15:15:00,21438.25,SELL,3,0.02h,Stop Loss,$-9.00,$100.50,$237870.50,363,$100.50
2025-05-28,15:18:00,21454.0,BUY,3,0.02h,Stop Loss,$21.00,$121.50,$237891.50,363,$121.50
2025-05-28,15:35:00,21451.75,SELL,3,0.02h,Stop Loss,$6.00,$127.50,$237897.50,363,$127.50
2025-05-28,15:54:00,21461.75,BUY,3,0.02h,Break Even,$-1.50,$126.00,$237896.00,363,$126.00
2025-05-28,15:57:00,21447.0,SELL,3,0.02h,Break Even,$-1.50,$124.50,$237894.50,363,$124.50
2025-05-28,16:04:00,21462.25,BUY,3,0.02h,Break Even,$-1.50,$123.00,$237893.00,363,$123.00
2025-05-28,16:47:00,21467.75,SELL,3,0.02h,Stop Loss,$-9.00,$114.00,$237884.00,363,$114.00
2025-05-28,16:48:00,21474.0,BUY,3,0.02h,Stop Loss,$-9.00,$105.00,$237875.00,363,$105.00
2025-05-28,16:53:00,21458.0,SELL,3,0.02h,Stop Loss,$9.00,$114.00,$237884.00,363,$114.00
2025-05-28,17:04:00,21475.75,BUY,3,0.02h,Break Even,$-1.50,$112.50,$237882.50,363,$112.50
2025-05-28,17:27:00,21469.5,SELL,3,0.02h,Break Even,$-1.50,$111.00,$237881.00,363,$111.00
2025-05-28,17:56:00,21476.25,BUY,3,0.02h,Break Even,$-1.50,$109.50,$237879.50,363,$109.50
2025-05-28,18:21:00,21473.25,SELL,3,0.02h,Break Even,$-1.50,$108.00,$237878.00,363,$108.00
2025-05-28,18:34:00,21488.75,BUY,3,0.02h,Stop Loss,$-9.00,$99.00,$237869.00,363,$99.00
2025-05-28,18:50:00,21479.0,SELL,3,0.02h,Stop Loss,$3.00,$102.00,$237872.00,363,$102.00
2025-05-28,19:04:00,21480.75,BUY,3,0.02h,Stop Loss,$13.50,$115.50,$237885.50,363,$115.50
2025-05-28,19:18:00,21460.25,SELL,3,0.02h,Break Even,$-1.50,$114.00,$237884.00,363,$114.00
2025-05-28,20:17:00,21393.75,BUY,3,0.02h,Break Even,$-1.50,$112.50,$237882.50,363,$112.50
2025-05-28,22:32:00,21511.75,SELL,3,0.02h,Stop Loss,$-9.00,$103.50,$237873.50,363,$103.50
2025-05-28,22:33:00,21515.75,BUY,3,0.02h,Stop Loss,$-9.00,$94.50,$237864.50,363,$94.50
,,,,,,,,,,,
2025-05-29,12:42:00,21638.5,SELL,3,0.02h,Stop Loss,$40.50,$40.50,$237905.00,364,$40.50
2025-05-29,12:54:00,21660.75,BUY,3,0.02h,Stop Loss,$9.00,$49.50,$237914.00,364,$49.50
2025-05-29,12:59:00,21641.25,SELL,3,0.02h,Stop Loss,$-9.00,$40.50,$237905.00,364,$40.50
2025-05-29,13:06:00,21655.5,BUY,3,0.02h,Stop Loss,$42.00,$82.50,$237947.00,364,$82.50
2025-05-29,13:31:00,21649.5,SELL,3,0.02h,Stop Loss,$204.00,$286.50,$238151.00,364,$286.50
2025-05-29,14:31:00,21457.0,BUY,3,0.02h,Stop Loss,$75.00,$361.50,$238226.00,364,$361.50
2025-05-29,15:14:00,21477.0,SELL,3,0.02h,Stop Loss,$87.00,$448.50,$238313.00,364,$448.50
2025-05-29,15:27:00,21497.0,BUY,3,0.02h,Break Even,$-1.50,$447.00,$238311.50,364,$447.00
2025-05-29,15:33:00,21447.25,SELL,3,0.02h,Stop Loss,$37.50,$484.50,$238349.00,364,$484.50
2025-05-29,16:16:00,21416.75,BUY,3,0.02h,Stop Loss,$34.50,$519.00,$238383.50,364,$519.00
2025-05-29,17:16:00,21440.75,SELL,3,0.02h,Stop Loss,$4.50,$523.50,$238388.00,364,$523.50
2025-05-29,18:14:00,21400.5,BUY,3,0.02h,Stop Loss,$4.50,$528.00,$238392.50,364,$528.00
2025-05-29,18:17:00,21380.25,SELL,3,0.02h,Stop Loss,$48.00,$576.00,$238440.50,364,$576.00
2025-05-29,18:37:00,21380.0,BUY,3,0.02h,Break Even,$-1.50,$574.50,$238439.00,364,$574.50
2025-05-29,19:00:00,21362.75,SELL,3,0.02h,Stop Loss,$15.00,$589.50,$238454.00,364,$589.50
2025-05-29,19:05:00,21382.0,BUY,3,0.02h,Break Even,$-1.50,$588.00,$238452.50,364,$588.00
2025-05-29,19:07:00,21356.0,SELL,3,0.02h,Stop Loss,$51.00,$639.00,$238503.50,364,$639.00
2025-05-29,19:21:00,21385.5,BUY,3,0.02h,Stop Loss,$33.00,$672.00,$238536.50,364,$672.00
2025-05-29,20:06:00,21376.5,SELL,3,0.02h,Stop Loss,$18.00,$690.00,$238554.50,364,$690.00
2025-05-29,20:20:00,21405.0,BUY,3,0.02h,Break Even,$-1.50,$688.50,$238553.00,364,$688.50
2025-05-29,20:44:00,21396.0,SELL,3,0.02h,Stop Loss,$-9.00,$679.50,$238544.00,364,$679.50
2025-05-29,22:13:00,21389.0,BUY,3,0.02h,Stop Loss,$27.00,$706.50,$238571.00,364,$706.50
2025-05-29,22:18:00,21374.25,SELL,3,0.02h,Break Even,$-1.50,$705.00,$238569.50,364,$705.00
,,,,,,,,,,,
2025-05-30,12:00:00,21388.0,BUY,3,0.02h,Break Even,$-1.50,$-1.50,$238568.00,365,$-1.50
2025-05-30,12:12:00,21258.5,SELL,3,0.02h,Stop Loss,$37.50,$36.00,$238605.50,365,$36.00
2025-05-30,12:35:00,21351.0,BUY,3,0.02h,Stop Loss,$30.00,$66.00,$238635.50,365,$66.00
2025-05-30,12:59:00,21335.75,SELL,3,0.02h,Break Even,$-1.50,$64.50,$238634.00,365,$64.50
2025-05-30,13:17:00,21360.25,BUY,3,0.02h,Break Even,$-1.50,$63.00,$238632.50,365,$63.00
2025-05-30,13:34:00,21337.0,SELL,3,0.02h,Stop Loss,$33.00,$96.00,$238665.50,365,$96.00
2025-05-30,14:05:00,21322.75,BUY,3,0.02h,Stop Loss,$118.50,$214.50,$238784.00,365,$214.50
2025-05-30,14:52:00,21369.0,SELL,3,0.02h,Stop Loss,$70.50,$285.00,$238854.50,365,$285.00
2025-05-30,15:28:00,21368.0,BUY,3,0.02h,Break Even,$-1.50,$283.50,$238853.00,365,$283.50
2025-05-30,15:35:00,21326.25,SELL,3,0.02h,Stop Loss,$42.00,$325.50,$238895.00,365,$325.50
2025-05-30,15:56:00,21344.0,BUY,3,0.02h,Break Even,$-1.50,$324.00,$238893.50,365,$324.00
2025-05-30,16:02:00,21305.0,SELL,3,0.02h,Stop Loss,$30.00,$354.00,$238923.50,365,$354.00
2025-05-30,16:10:00,21334.25,BUY,3,0.02h,Break Even,$-1.50,$352.50,$238922.00,365,$352.50
2025-05-30,16:17:00,21293.75,SELL,3,0.02h,Stop Loss,$97.50,$450.00,$239019.50,365,$450.00
2025-05-30,17:06:00,21143.25,BUY,3,0.02h,Stop Loss,$82.50,$532.50,$239102.00,365,$532.50
2025-05-30,19:46:00,21358.5,SELL,3,0.02h,Stop Loss,$57.00,$589.50,$239159.00,365,$589.50
2025-05-30,19:49:00,21382.25,BUY,3,0.02h,Stop Loss,$13.50,$603.00,$239172.50,365,$603.00
2025-05-30,20:04:00,21344.25,SELL,3,0.02h,Stop Loss,$-9.00,$594.00,$239163.50,365,$594.00
2025-05-30,20:21:00,21377.75,BUY,3,0.02h,Stop Loss,$12.00,$606.00,$239175.50,365,$606.00
2025-05-30,20:26:00,21359.25,SELL,3,0.02h,Stop Loss,$13.50,$619.50,$239189.00,365,$619.50
2025-05-30,20:58:00,21363.75,BUY,3,0.02h,Stop Loss,$7.50,$627.00,$239196.50,365,$627.00
,,,,,,,,,,,
2025-06-02,12:00:00,21256.0,SELL,3,0.02h,Break Even,$-1.50,$-1.50,$239195.00,366,$-1.50
2025-06-02,12:41:00,21274.5,BUY,3,0.02h,Stop Loss,$12.00,$10.50,$239207.00,366,$10.50
2025-06-02,12:56:00,21267.0,SELL,3,0.02h,Break Even,$-1.50,$9.00,$239205.50,366,$9.00
2025-06-02,12:59:00,21282.25,BUY,3,0.02h,Stop Loss,$3.00,$12.00,$239208.50,366,$12.00
2025-06-02,13:07:00,21266.75,SELL,3,0.02h,Stop Loss,$9.00,$21.00,$239217.50,366,$21.00
2025-06-02,13:27:00,21280.5,BUY,3,0.02h,Stop Loss,$18.00,$39.00,$239235.50,366,$39.00
2025-06-02,13:53:00,21325.0,SELL,3,0.02h,Stop Loss,$82.50,$121.50,$239318.00,366,$121.50
2025-06-02,14:19:00,21323.5,BUY,3,0.02h,Stop Loss,$76.50,$198.00,$239394.50,366,$198.00
2025-06-02,15:11:00,21369.75,SELL,3,0.02h,Stop Loss,$-9.00,$189.00,$239385.50,366,$189.00
2025-06-02,15:14:00,21404.5,BUY,3,0.02h,Stop Loss,$-9.00,$180.00,$239376.50,366,$180.00
2025-06-02,15:27:00,21368.5,SELL,3,0.02h,Stop Loss,$16.50,$196.50,$239393.00,366,$196.50
2025-06-02,15:42:00,21388.0,BUY,3,0.02h,Stop Loss,$10.50,$207.00,$239403.50,366,$207.00
2025-06-02,16:28:00,21415.25,SELL,3,0.02h,Stop Loss,$3.00,$210.00,$239406.50,366,$210.00
2025-06-02,16:35:00,21432.75,BUY,3,0.02h,Stop Loss,$18.00,$228.00,$239424.50,366,$228.00
2025-06-02,16:37:00,21420.0,SELL,3,0.02h,Break Even,$-1.50,$226.50,$239423.00,366,$226.50
2025-06-02,16:39:00,21435.75,BUY,3,0.02h,Stop Loss,$-9.00,$217.50,$239414.00,366,$217.50
2025-06-02,16:42:00,21425.25,SELL,3,0.02h,Stop Loss,$25.50,$243.00,$239439.50,366,$243.00
2025-06-02,16:54:00,21439.25,BUY,3,0.02h,Stop Loss,$70.50,$313.50,$239510.00,366,$313.50
2025-06-02,17:23:00,21442.0,SELL,3,0.02h,Stop Loss,$-9.00,$304.50,$239501.00,366,$304.50
2025-06-02,18:00:00,21445.5,BUY,3,0.02h,Break Even,$-1.50,$303.00,$239499.50,366,$303.00
2025-06-02,19:20:00,21512.0,SELL,3,0.02h,Stop Loss,$18.00,$321.00,$239517.50,366,$321.00
2025-06-02,19:22:00,21519.75,BUY,3,0.02h,Stop Loss,$15.00,$336.00,$239532.50,366,$336.00
2025-06-02,19:36:00,21515.25,SELL,3,0.02h,Break Even,$-1.50,$334.50,$239531.00,366,$334.50
2025-06-02,19:52:00,21524.75,BUY,3,0.02h,Stop Loss,$-9.00,$325.50,$239522.00,366,$325.50
2025-06-02,19:53:00,21511.25,SELL,3,0.02h,Stop Loss,$34.50,$360.00,$239556.50,366,$360.00
2025-06-02,19:59:00,21525.5,BUY,3,0.02h,Stop Loss,$66.00,$426.00,$239622.50,366,$426.00
2025-06-02,20:35:00,21555.75,SELL,3,0.02h,Break Even,$-1.50,$424.50,$239621.00,366,$424.50
,,,,,,,,,,,
2025-06-03,12:01:00,21530.0,BUY,3,0.02h,Stop Loss,$39.00,$39.00,$239660.00,367,$39.00
2025-06-03,12:05:00,21519.75,SELL,3,0.02h,Stop Loss,$28.50,$67.50,$239688.50,367,$67.50
2025-06-03,12:14:00,21524.75,BUY,3,0.02h,Stop Loss,$-9.00,$58.50,$239679.50,367,$58.50
2025-06-03,12:19:00,21517.0,SELL,3,0.02h,Stop Loss,$-9.00,$49.50,$239670.50,367,$49.50
2025-06-03,12:25:00,21527.25,BUY,3,0.02h,Break Even,$-1.50,$48.00,$239669.00,367,$48.00
2025-06-03,12:38:00,21515.0,SELL,3,0.02h,Break Even,$-1.50,$46.50,$239667.50,367,$46.50
2025-06-03,12:57:00,21528.75,BUY,3,0.02h,Break Even,$-1.50,$45.00,$239666.00,367,$45.00
2025-06-03,13:37:00,21537.25,SELL,3,0.02h,Stop Loss,$28.50,$73.50,$239694.50,367,$73.50
2025-06-03,13:43:00,21569.75,BUY,3,0.02h,Break Even,$-1.50,$72.00,$239693.00,367,$72.00
2025-06-03,14:35:00,21597.0,SELL,3,0.02h,Stop Loss,$57.00,$129.00,$239750.00,367,$129.00
2025-06-03,14:41:00,21609.25,BUY,3,0.02h,Break Even,$-1.50,$127.50,$239748.50,367,$127.50
2025-06-03,15:39:00,21663.75,SELL,3,0.02h,Stop Loss,$-9.00,$118.50,$239739.50,367,$118.50
2025-06-03,15:40:00,21671.25,BUY,3,0.02h,Break Even,$-1.50,$117.00,$239738.00,367,$117.00
2025-06-03,15:51:00,21662.5,SELL,3,0.02h,Stop Loss,$12.00,$129.00,$239750.00,367,$129.00
2025-06-03,15:56:00,21674.75,BUY,3,0.02h,Stop Loss,$19.50,$148.50,$239769.50,367,$148.50
2025-06-03,17:32:00,21743.0,SELL,3,0.02h,Break Even,$-1.50,$147.00,$239768.00,367,$147.00
2025-06-03,18:27:00,21686.0,BUY,3,0.02h,Stop Loss,$60.00,$207.00,$239828.00,367,$207.00
2025-06-03,19:12:00,21696.5,SELL,3,0.02h,Stop Loss,$-9.00,$198.00,$239819.00,367,$198.00
2025-06-03,19:19:00,21710.0,BUY,3,0.02h,Break Even,$-1.50,$196.50,$239817.50,367,$196.50
2025-06-03,19:41:00,21700.25,SELL,3,0.02h,Stop Loss,$7.50,$204.00,$239825.00,367,$204.00
2025-06-03,19:57:00,21714.75,BUY,3,0.02h,Stop Loss,$46.50,$250.50,$239871.50,367,$250.50
2025-06-03,20:02:00,21684.5,SELL,3,0.02h,Stop Loss,$12.00,$262.50,$239883.50,367,$262.50
2025-06-03,20:38:00,21683.0,BUY,3,0.02h,Break Even,$-1.50,$261.00,$239882.00,367,$261.00
2025-06-03,22:51:00,21710.5,SELL,3,0.02h,Stop Loss,$-9.00,$252.00,$239873.00,367,$252.00
2025-06-03,22:52:00,21712.5,BUY,3,0.02h,Break Even,$-1.50,$250.50,$239871.50,367,$250.50
2025-06-03,23:00:00,21709.25,SELL,3,13.00h,Stop Loss,$-9.00,$241.50,$239862.50,367,$241.50
,,,,,,,,,,,
2025-06-04,12:00:00,21747.25,BUY,3,0.02h,Stop Loss,$16.50,$16.50,$239879.00,368,$16.50
2025-06-04,12:17:00,21712.25,SELL,3,0.02h,Stop Loss,$28.50,$45.00,$239907.50,368,$45.00
2025-06-04,12:50:00,21702.0,BUY,3,0.02h,Break Even,$-1.50,$43.50,$239906.00,368,$43.50
2025-06-04,13:54:00,21742.0,SELL,3,0.02h,Break Even,$-1.50,$42.00,$239904.50,368,$42.00
2025-06-04,14:21:00,21728.75,BUY,3,0.02h,Stop Loss,$13.50,$55.50,$239918.00,368,$55.50
2025-06-04,14:25:00,21712.5,SELL,3,0.02h,Break Even,$-1.50,$54.00,$239916.50,368,$54.00
2025-06-04,14:27:00,21731.75,BUY,3,0.02h,Stop Loss,$55.50,$109.50,$239972.00,368,$109.50
2025-06-04,14:44:00,21715.75,SELL,3,0.02h,Break Even,$-1.50,$108.00,$239970.50,368,$108.00
2025-06-04,14:56:00,21738.0,BUY,3,0.02h,Stop Loss,$21.00,$129.00,$239991.50,368,$129.00
2025-06-04,15:29:00,21760.25,SELL,3,0.02h,Stop Loss,$25.50,$154.50,$240017.00,368,$154.50
2025-06-04,15:43:00,21764.75,BUY,3,0.02h,Stop Loss,$39.00,$193.50,$240056.00,368,$193.50
2025-06-04,15:45:00,21740.0,SELL,3,0.02h,Break Even,$-1.50,$192.00,$240054.50,368,$192.00
2025-06-04,16:45:00,21734.5,BUY,3,0.02h,Stop Loss,$30.00,$222.00,$240084.50,368,$222.00
2025-06-04,17:40:00,21766.25,SELL,3,0.02h,Stop Loss,$57.00,$279.00,$240141.50,368,$279.00
2025-06-04,17:46:00,21776.0,BUY,3,0.02h,Break Even,$-1.50,$277.50,$240140.00,368,$277.50
2025-06-04,18:27:00,21782.5,SELL,3,0.02h,Break Even,$-1.50,$276.00,$240138.50,368,$276.00
2025-06-04,18:30:00,21796.0,BUY,3,0.02h,Stop Loss,$19.50,$295.50,$240158.00,368,$295.50
2025-06-04,18:50:00,21786.25,SELL,3,0.02h,Stop Loss,$67.50,$363.00,$240225.50,368,$363.00
2025-06-04,19:04:00,21792.0,BUY,3,0.02h,Break Even,$-1.50,$361.50,$240224.00,368,$361.50
2025-06-04,19:10:00,21777.25,SELL,3,0.02h,Break Even,$-1.50,$360.00,$240222.50,368,$360.00
2025-06-04,19:15:00,21792.5,BUY,3,0.02h,Break Even,$-1.50,$358.50,$240221.00,368,$358.50
2025-06-04,19:18:00,21783.75,SELL,3,0.02h,Break Even,$-1.50,$357.00,$240219.50,368,$357.00
2025-06-04,20:29:00,21761.0,BUY,3,0.02h,Stop Loss,$-9.00,$348.00,$240210.50,368,$348.00
2025-06-04,20:33:00,21758.25,SELL,3,0.02h,Stop Loss,$-9.00,$339.00,$240201.50,368,$339.00
2025-06-04,20:46:00,21763.0,BUY,3,0.02h,Stop Loss,$-9.00,$330.00,$240192.50,368,$330.00
2025-06-04,20:55:00,21751.0,SELL,3,0.02h,Stop Loss,$-9.00,$321.00,$240183.50,368,$321.00
2025-06-04,22:11:00,21754.0,BUY,3,0.02h,Break Even,$-1.50,$319.50,$240182.00,368,$319.50
2025-06-04,22:46:00,21753.0,SELL,3,0.02h,Break Even,$-1.50,$318.00,$240180.50,368,$318.00
,,,,,,,,,,,
2025-06-05,12:01:00,21767.25,BUY,3,0.02h,Stop Loss,$-9.00,$-9.00,$240171.50,369,$-9.00
2025-06-05,12:29:00,21767.5,SELL,3,0.02h,Stop Loss,$9.00,$0.00,$240180.50,369,$0.00
2025-06-05,12:39:00,21775.0,BUY,3,0.02h,Stop Loss,$-9.00,$-9.00,$240171.50,369,$-9.00
2025-06-05,12:49:00,21754.75,SELL,3,0.02h,Stop Loss,$-9.00,$-18.00,$240162.50,369,$-18.00
2025-06-05,12:50:00,21845.25,BUY,3,0.02h,Stop Loss,$46.50,$28.50,$240209.00,369,$28.50
2025-06-05,13:17:00,21794.0,SELL,3,0.02h,Break Even,$-1.50,$27.00,$240207.50,369,$27.00
2025-06-05,13:21:00,21817.5,BUY,3,0.02h,Break Even,$-1.50,$25.50,$240206.00,369,$25.50
2025-06-05,13:27:00,21806.5,SELL,3,0.02h,Stop Loss,$15.00,$40.50,$240221.00,369,$40.50
2025-06-05,13:29:00,21814.25,BUY,3,0.02h,Break Even,$-1.50,$39.00,$240219.50,369,$39.00
2025-06-05,13:33:00,21792.0,SELL,3,0.02h,Stop Loss,$76.50,$115.50,$240296.00,369,$115.50
2025-06-05,14:22:00,21753.75,BUY,3,0.02h,Stop Loss,$22.50,$138.00,$240318.50,369,$138.00
2025-06-05,14:36:00,21727.25,SELL,3,0.02h,Stop Loss,$43.50,$181.50,$240362.00,369,$181.50
2025-06-05,14:38:00,21782.5,BUY,3,0.02h,Stop Loss,$141.00,$322.50,$240503.00,369,$322.50
2025-06-05,16:09:00,21901.5,SELL,3,0.02h,Stop Loss,$94.50,$417.00,$240597.50,369,$417.00
2025-06-05,17:13:00,21755.75,BUY,3,0.02h,Break Even,$-1.50,$415.50,$240596.00,369,$415.50
2025-06-05,17:50:00,21767.0,SELL,3,0.02h,Stop Loss,$27.00,$442.50,$240623.00,369,$442.50
2025-06-05,18:28:00,21703.25,BUY,3,0.02h,Break Even,$-1.50,$441.00,$240621.50,369,$441.00
2025-06-05,18:54:00,21699.5,SELL,3,0.02h,Break Even,$-1.50,$439.50,$240620.00,369,$439.50
2025-06-05,19:35:00,21609.75,BUY,3,0.02h,Stop Loss,$63.00,$502.50,$240683.00,369,$502.50
2025-06-05,19:54:00,21597.5,SELL,3,0.02h,Stop Loss,$63.00,$565.50,$240746.00,369,$565.50
2025-06-05,22:19:00,21523.0,BUY,3,0.02h,Stop Loss,$4.50,$570.00,$240750.50,369,$570.00
,,,,,,,,,,,
2025-06-06,14:04:00,21821.5,SELL,3,0.02h,Stop Loss,$25.50,$25.50,$240776.00,370,$25.50
2025-06-06,14:08:00,21832.75,BUY,3,0.02h,Stop Loss,$46.50,$72.00,$240822.50,370,$72.00
2025-06-06,14:12:00,21817.25,SELL,3,0.02h,Stop Loss,$12.00,$84.00,$240834.50,370,$84.00
2025-06-06,14:16:00,21834.5,BUY,3,0.02h,Break Even,$-1.50,$82.50,$240833.00,370,$82.50
2025-06-06,14:20:00,21818.5,SELL,3,0.02h,Break Even,$-1.50,$81.00,$240831.50,370,$81.00
2025-06-06,14:41:00,21831.75,BUY,3,0.02h,Break Even,$-1.50,$79.50,$240830.00,370,$79.50
2025-06-06,15:17:00,21821.75,SELL,3,0.02h,Stop Loss,$93.00,$172.50,$240923.00,370,$172.50
2025-06-06,15:45:00,21800.0,BUY,3,0.02h,Break Even,$-1.50,$171.00,$240921.50,370,$171.00
2025-06-06,16:21:00,21807.0,SELL,3,0.02h,Stop Loss,$63.00,$234.00,$240984.50,370,$234.00
2025-06-06,17:17:00,21763.75,BUY,3,0.02h,Break Even,$-1.50,$232.50,$240983.00,370,$232.50
2025-06-06,18:30:00,21844.0,SELL,3,0.02h,Stop Loss,$-9.00,$223.50,$240974.00,370,$223.50
2025-06-06,18:31:00,21850.25,BUY,3,0.02h,Stop Loss,$28.50,$252.00,$241002.50,370,$252.00
2025-06-06,18:42:00,21844.0,SELL,3,0.02h,Stop Loss,$36.00,$288.00,$241038.50,370,$288.00
2025-06-06,19:54:00,21809.0,BUY,3,0.02h,Stop Loss,$100.50,$388.50,$241139.00,370,$388.50
2025-06-06,19:57:00,21802.0,SELL,3,0.02h,Stop Loss,$-9.00,$379.50,$241130.00,370,$379.50
2025-06-06,20:17:00,21805.0,BUY,3,0.02h,Break Even,$-1.50,$378.00,$241128.50,370,$378.00
2025-06-06,20:50:00,21804.75,SELL,3,0.02h,Stop Loss,$-9.00,$369.00,$241119.50,370,$369.00
2025-06-06,21:00:00,21809.75,BUY,3,63.00h,Stop Loss,$12.00,$381.00,$241131.50,370,$381.00
,,,,,,,,,,,
2025-06-09,12:04:00,21806.25,SELL,3,0.02h,Stop Loss,$-9.00,$-9.00,$241122.50,371,$-9.00
2025-06-09,12:22:00,21811.5,BUY,3,0.02h,Break Even,$-1.50,$-10.50,$241121.00,371,$-10.50
2025-06-09,12:43:00,21807.5,SELL,3,0.02h,Break Even,$-1.50,$-12.00,$241119.50,371,$-12.00
2025-06-09,12:44:00,21811.75,BUY,3,0.02h,Break Even,$-1.50,$-13.50,$241118.00,371,$-13.50
2025-06-09,12:51:00,21803.75,SELL,3,0.02h,Break Even,$-1.50,$-15.00,$241116.50,371,$-15.00
2025-06-09,13:07:00,21811.5,BUY,3,0.02h,Break Even,$-1.50,$-16.50,$241115.00,371,$-16.50
2025-06-09,13:17:00,21798.5,SELL,3,0.02h,Break Even,$-1.50,$-18.00,$241113.50,371,$-18.00
2025-06-09,13:24:00,21813.0,BUY,3,0.02h,Stop Loss,$-9.00,$-27.00,$241104.50,371,$-27.00
2025-06-09,13:30:00,21797.5,SELL,3,0.02h,Stop Loss,$19.50,$-7.50,$241124.00,371,$-7.50
2025-06-09,13:31:00,21808.75,BUY,3,0.02h,Stop Loss,$16.50,$9.00,$241140.50,371,$9.00
2025-06-09,13:32:00,21787.25,SELL,3,0.02h,Stop Loss,$27.00,$36.00,$241167.50,371,$36.00
2025-06-09,13:50:00,21804.0,BUY,3,0.02h,Stop Loss,$19.50,$55.50,$241187.00,371,$55.50
2025-06-09,14:47:00,21847.25,SELL,3,0.02h,Break Even,$-1.50,$54.00,$241185.50,371,$54.00
2025-06-09,15:07:00,21858.0,BUY,3,0.02h,Stop Loss,$6.00,$60.00,$241191.50,371,$60.00
2025-06-09,15:17:00,21843.5,SELL,3,0.02h,Break Even,$-1.50,$58.50,$241190.00,371,$58.50
2025-06-09,15:40:00,21840.75,BUY,3,0.02h,Stop Loss,$-9.00,$49.50,$241181.00,371,$49.50
2025-06-09,15:41:00,21832.75,SELL,3,0.02h,Break Even,$-1.50,$48.00,$241179.50,371,$48.00
2025-06-09,15:53:00,21839.25,BUY,3,0.02h,Stop Loss,$9.00,$57.00,$241188.50,371,$57.00
2025-06-09,16:09:00,21822.25,SELL,3,0.02h,Stop Loss,$18.00,$75.00,$241206.50,371,$75.00
2025-06-09,16:24:00,21835.75,BUY,3,0.02h,Stop Loss,$13.50,$88.50,$241220.00,371,$88.50
2025-06-09,17:14:00,21862.75,SELL,3,0.02h,Break Even,$-1.50,$87.00,$241218.50,371,$87.00
2025-06-09,17:38:00,21863.0,BUY,3,0.02h,Stop Loss,$3.00,$90.00,$241221.50,371,$90.00
2025-06-09,18:05:00,21862.5,SELL,3,0.02h,Stop Loss,$18.00,$108.00,$241239.50,371,$108.00
2025-06-09,18:23:00,21869.75,BUY,3,0.02h,Stop Loss,$-9.00,$99.00,$241230.50,371,$99.00
2025-06-09,18:33:00,21864.5,SELL,3,0.02h,Break Even,$-1.50,$97.50,$241229.00,371,$97.50
2025-06-09,18:50:00,21863.25,BUY,3,0.02h,Break Even,$-1.50,$96.00,$241227.50,371,$96.00
2025-06-09,19:15:00,21859.75,SELL,3,0.02h,Stop Loss,$3.00,$99.00,$241230.50,371,$99.00
2025-06-09,20:34:00,21809.75,BUY,3,0.02h,Stop Loss,$-9.00,$90.00,$241221.50,371,$90.00
2025-06-09,22:32:00,21829.75,SELL,3,0.02h,Stop Loss,$-9.00,$81.00,$241212.50,371,$81.00
,,,,,,,,,,,
2025-06-10,12:00:00,21857.25,BUY,3,0.02h,Stop Loss,$3.00,$3.00,$241215.50,372,$3.00
2025-06-10,12:34:00,21851.25,SELL,3,0.02h,Stop Loss,$-9.00,$-6.00,$241206.50,372,$-6.00
2025-06-10,12:42:00,21863.0,BUY,3,0.02h,Break Even,$-1.50,$-7.50,$241205.00,372,$-7.50
2025-06-10,12:52:00,21850.0,SELL,3,0.02h,Break Even,$-1.50,$-9.00,$241203.50,372,$-9.00
2025-06-10,13:03:00,21857.75,BUY,3,0.02h,Stop Loss,$-9.00,$-18.00,$241194.50,372,$-18.00
2025-06-10,13:04:00,21854.0,SELL,3,0.02h,Break Even,$-1.50,$-19.50,$241193.00,372,$-19.50
2025-06-10,13:22:00,21854.75,BUY,3,0.02h,Break Even,$-1.50,$-21.00,$241191.50,372,$-21.00
2025-06-10,13:25:00,21851.0,SELL,3,0.02h,Stop Loss,$40.50,$19.50,$241232.00,372,$19.50
2025-06-10,13:40:00,21881.25,BUY,3,0.02h,Stop Loss,$9.00,$28.50,$241241.00,372,$28.50
2025-06-10,13:59:00,21857.75,SELL,3,0.02h,Stop Loss,$16.50,$45.00,$241257.50,372,$45.00
2025-06-10,14:01:00,21865.75,BUY,3,0.02h,Stop Loss,$37.50,$82.50,$241295.00,372,$82.50
2025-06-10,14:05:00,21855.0,SELL,3,0.02h,Stop Loss,$-9.00,$73.50,$241286.00,372,$73.50
2025-06-10,14:06:00,21862.5,BUY,3,0.02h,Stop Loss,$4.50,$78.00,$241290.50,372,$78.00
2025-06-10,14:08:00,21857.75,SELL,3,0.02h,Stop Loss,$39.00,$117.00,$241329.50,372,$117.00
2025-06-10,14:12:00,21873.5,BUY,3,0.02h,Stop Loss,$27.00,$144.00,$241356.50,372,$144.00
2025-06-10,14:41:00,21862.75,SELL,3,0.02h,Break Even,$-1.50,$142.50,$241355.00,372,$142.50
2025-06-10,14:45:00,21881.25,BUY,3,0.02h,Stop Loss,$-9.00,$133.50,$241346.00,372,$133.50
2025-06-10,14:56:00,21860.5,SELL,3,0.02h,Stop Loss,$9.00,$142.50,$241355.00,372,$142.50
2025-06-10,15:17:00,21874.0,BUY,3,0.02h,Stop Loss,$4.50,$147.00,$241359.50,372,$147.00
2025-06-10,15:25:00,21863.0,SELL,3,0.02h,Break Even,$-1.50,$145.50,$241358.00,372,$145.50
2025-06-10,15:26:00,21871.5,BUY,3,0.02h,Break Even,$-1.50,$144.00,$241356.50,372,$144.00
2025-06-10,15:27:00,21866.5,SELL,3,0.02h,Stop Loss,$33.00,$177.00,$241389.50,372,$177.00
2025-06-10,15:47:00,21845.75,BUY,3,0.02h,Stop Loss,$33.00,$210.00,$241422.50,372,$210.00
2025-06-10,16:46:00,21897.25,SELL,3,0.02h,Break Even,$-1.50,$208.50,$241421.00,372,$208.50
2025-06-10,16:48:00,21901.5,BUY,3,0.02h,Stop Loss,$-9.00,$199.50,$241412.00,372,$199.50
2025-06-10,16:49:00,21898.0,SELL,3,0.02h,Stop Loss,$3.00,$202.50,$241415.00,372,$202.50
2025-06-10,16:51:00,21904.25,BUY,3,0.02h,Stop Loss,$31.50,$234.00,$241446.50,372,$234.00
2025-06-10,17:04:00,21899.75,SELL,3,0.02h,Break Even,$-1.50,$232.50,$241445.00,372,$232.50
2025-06-10,17:10:00,21909.5,BUY,3,0.02h,Stop Loss,$40.50,$273.00,$241485.50,372,$273.00
2025-06-10,17:27:00,21899.75,SELL,3,0.02h,Break Even,$-1.50,$271.50,$241484.00,372,$271.50
2025-06-10,18:20:00,21873.75,BUY,3,0.02h,Break Even,$-1.50,$270.00,$241482.50,372,$270.00
2025-06-10,19:32:00,21952.5,SELL,3,0.02h,Stop Loss,$21.00,$291.00,$241503.50,372,$291.00
2025-06-10,19:57:00,21958.0,BUY,3,0.02h,Break Even,$-1.50,$289.50,$241502.00,372,$289.50
2025-06-10,20:07:00,21940.5,SELL,3,0.02h,Break Even,$-1.50,$288.00,$241500.50,372,$288.00
2025-06-10,20:19:00,21964.25,BUY,3,0.02h,Stop Loss,$12.00,$300.00,$241512.50,372,$300.00
2025-06-10,20:34:00,21948.75,SELL,3,0.02h,Stop Loss,$-9.00,$291.00,$241503.50,372,$291.00
2025-06-10,20:37:00,21954.25,BUY,3,0.02h,Stop Loss,$-9.00,$282.00,$241494.50,372,$282.00
2025-06-10,20:51:00,21949.25,SELL,3,0.02h,Break Even,$-1.50,$280.50,$241493.00,372,$280.50
2025-06-10,20:58:00,21953.0,BUY,3,0.02h,Stop Loss,$-9.00,$271.50,$241484.00,372,$271.50
2025-06-10,22:05:00,21950.5,SELL,3,0.02h,Break Even,$-1.50,$270.00,$241482.50,372,$270.00
2025-06-10,22:07:00,21954.75,BUY,3,0.02h,Break Even,$-1.50,$268.50,$241481.00,372,$268.50
2025-06-10,22:31:00,21947.75,SELL,3,0.02h,Break Even,$-1.50,$267.00,$241479.50,372,$267.00
2025-06-10,22:43:00,21954.0,BUY,3,0.02h,Stop Loss,$-9.00,$258.00,$241470.50,372,$258.00
2025-06-10,22:48:00,21951.0,SELL,3,0.02h,Break Even,$-1.50,$256.50,$241469.00,372,$256.50
2025-06-10,22:54:00,21967.75,BUY,3,0.02h,Stop Loss,$73.50,$330.00,$241542.50,372,$330.00
,,,,,,,,,,,
2025-06-11,12:01:00,21935.0,SELL,3,0.02h,Break Even,$-1.50,$-1.50,$241541.00,373,$-1.50
2025-06-11,12:29:00,21948.75,BUY,3,0.02h,Stop Loss,$24.00,$22.50,$241565.00,373,$22.50
2025-06-11,12:54:00,22020.75,SELL,3,0.02h,Break Even,$-1.50,$21.00,$241563.50,373,$21.00
2025-06-11,13:13:00,22033.5,BUY,3,0.02h,Break Even,$-1.50,$19.50,$241562.00,373,$19.50
2025-06-11,13:15:00,22024.0,SELL,3,0.02h,Stop Loss,$15.00,$34.50,$241577.00,373,$34.50
2025-06-11,13:20:00,22030.5,BUY,3,0.02h,Stop Loss,$-9.00,$25.50,$241568.00,373,$25.50
2025-06-11,13:24:00,22021.25,SELL,3,0.02h,Break Even,$-1.50,$24.00,$241566.50,373,$24.00
2025-06-11,13:56:00,21993.5,BUY,3,0.02h,Break Even,$-1.50,$22.50,$241565.00,373,$22.50
2025-06-11,15:10:00,21999.25,SELL,3,0.02h,Stop Loss,$60.00,$82.50,$241625.00,373,$82.50
2025-06-11,16:30:00,21978.25,BUY,3,0.02h,Stop Loss,$25.50,$108.00,$241650.50,373,$108.00
2025-06-11,16:43:00,21961.25,SELL,3,0.02h,Break Even,$-1.50,$106.50,$241649.00,373,$106.50
2025-06-11,16:44:00,21973.5,BUY,3,0.02h,Stop Loss,$-9.00,$97.50,$241640.00,373,$97.50
2025-06-11,16:45:00,21964.75,SELL,3,0.02h,Stop Loss,$22.50,$120.00,$241662.50,373,$120.00
2025-06-11,16:47:00,21973.0,BUY,3,0.02h,Stop Loss,$27.00,$147.00,$241689.50,373,$147.00
2025-06-11,17:35:00,21996.0,SELL,3,0.02h,Stop Loss,$3.00,$150.00,$241692.50,373,$150.00
2025-06-11,18:34:00,21879.5,BUY,3,0.02h,Stop Loss,$22.50,$172.50,$241715.00,373,$172.50
2025-06-11,18:57:00,21855.75,SELL,3,0.02h,Stop Loss,$19.50,$192.00,$241734.50,373,$192.00
2025-06-11,19:26:00,21871.0,BUY,3,0.02h,Break Even,$-1.50,$190.50,$241733.00,373,$190.50
2025-06-11,19:33:00,21844.25,SELL,3,0.02h,Stop Loss,$42.00,$232.50,$241775.00,373,$232.50
2025-06-11,19:41:00,21863.0,BUY,3,0.02h,Stop Loss,$15.00,$247.50,$241790.00,373,$247.50
2025-06-11,20:35:00,21890.5,SELL,3,0.02h,Stop Loss,$21.00,$268.50,$241811.00,373,$268.50
2025-06-11,22:23:00,21875.25,BUY,3,0.02h,Break Even,$-1.50,$267.00,$241809.50,373,$267.00
2025-06-11,22:43:00,21878.0,SELL,3,0.02h,Stop Loss,$-9.00,$258.00,$241800.50,373,$258.00
,,,,,,,,,,,
2025-06-12,12:00:00,21966.5,BUY,3,0.02h,Stop Loss,$-9.00,$-9.00,$241791.50,374,$-9.00
2025-06-12,12:01:00,21744.0,SELL,3,0.02h,Break Even,$-1.50,$-10.50,$241790.00,374,$-10.50
2025-06-12,12:04:00,21975.0,BUY,3,0.02h,Stop Loss,$-9.00,$-19.50,$241781.00,374,$-19.50
2025-06-12,12:05:00,21748.0,SELL,3,0.02h,Break Even,$-1.50,$-21.00,$241779.50,374,$-21.00
2025-06-12,12:14:00,21996.5,BUY,3,0.02h,Stop Loss,$-9.00,$-30.00,$241770.50,374,$-30.00
2025-06-12,12:15:00,21769.75,SELL,3,0.02h,Stop Loss,$-9.00,$-39.00,$241761.50,374,$-39.00
2025-06-12,12:16:00,21989.0,BUY,3,0.02h,Stop Loss,$-9.00,$-48.00,$241752.50,374,$-48.00
2025-06-12,12:20:00,21771.5,SELL,3,0.02h,Stop Loss,$-9.00,$-57.00,$241743.50,374,$-57.00
2025-06-12,12:21:00,21988.5,BUY,3,0.02h,Stop Loss,$18.00,$-39.00,$241761.50,374,$-39.00
2025-06-12,12:30:00,21762.0,SELL,3,0.02h,Stop Loss,$-9.00,$-48.00,$241752.50,374,$-48.00
2025-06-12,12:31:00,21999.75,BUY,3,0.02h,Stop Loss,$-9.00,$-57.00,$241743.50,374,$-57.00
2025-06-12,12:32:00,21775.75,SELL,3,0.02h,Break Even,$-1.50,$-58.50,$241742.00,374,$-58.50
2025-06-12,12:34:00,22008.25,BUY,3,0.02h,Stop Loss,$-9.00,$-67.50,$241733.00,374,$-67.50
2025-06-12,12:35:00,21795.25,SELL,3,0.02h,Stop Loss,$-9.00,$-76.50,$241724.00,374,$-76.50
2025-06-12,12:36:00,22022.25,BUY,3,0.02h,Stop Loss,$153.00,$76.50,$241877.00,374,$76.50
2025-06-12,12:45:00,21839.75,SELL,3,0.02h,Stop Loss,$22.50,$99.00,$241899.50,374,$99.00
2025-06-12,12:49:00,22062.0,BUY,3,0.02h,Stop Loss,$-9.00,$90.00,$241890.50,374,$90.00
2025-06-12,12:50:00,21832.25,SELL,3,0.02h,Stop Loss,$-9.00,$81.00,$241881.50,374,$81.00
2025-06-12,12:51:00,22050.75,BUY,3,0.02h,Stop Loss,$4.50,$85.50,$241886.00,374,$85.50
2025-06-12,12:54:00,21833.5,SELL,3,0.02h,Break Even,$-1.50,$84.00,$241884.50,374,$84.00
2025-06-12,12:57:00,22065.0,BUY,3,0.02h,Stop Loss,$-9.00,$75.00,$241875.50,374,$75.00
2025-06-12,12:58:00,21838.25,SELL,3,0.02h,Stop Loss,$-9.00,$66.00,$241866.50,374,$66.00
2025-06-12,12:59:00,22066.75,BUY,3,0.02h,Stop Loss,$-9.00,$57.00,$241857.50,374,$57.00
2025-06-12,13:08:00,21832.5,SELL,3,0.02h,Stop Loss,$-9.00,$48.00,$241848.50,374,$48.00
2025-06-12,13:09:00,22056.5,BUY,3,0.02h,Break Even,$-1.50,$46.50,$241847.00,374,$46.50
2025-06-12,13:12:00,21841.75,SELL,3,0.02h,Stop Loss,$-9.00,$37.50,$241838.00,374,$37.50
2025-06-12,13:13:00,22066.0,BUY,3,0.02h,Stop Loss,$-9.00,$28.50,$241829.00,374,$28.50
2025-06-12,13:14:00,21839.25,SELL,3,0.02h,Stop Loss,$4.50,$33.00,$241833.50,374,$33.00
2025-06-12,13:16:00,22056.75,BUY,3,0.02h,Stop Loss,$-9.00,$24.00,$241824.50,374,$24.00
2025-06-12,13:20:00,21838.0,SELL,3,0.02h,Stop Loss,$-9.00,$15.00,$241815.50,374,$15.00
2025-06-12,13:21:00,22053.5,BUY,3,0.02h,Stop Loss,$-9.00,$6.00,$241806.50,374,$6.00
2025-06-12,13:22:00,21832.75,SELL,3,0.02h,Stop Loss,$-9.00,$-3.00,$241797.50,374,$-3.00
2025-06-12,13:23:00,22060.0,BUY,3,0.02h,Stop Loss,$-9.00,$-12.00,$241788.50,374,$-12.00
2025-06-12,13:24:00,21832.5,SELL,3,0.02h,Stop Loss,$18.00,$6.00,$241806.50,374,$6.00
2025-06-12,13:29:00,22051.25,BUY,3,0.02h,Stop Loss,$-9.00,$-3.00,$241797.50,374,$-3.00
2025-06-12,13:30:00,21829.0,SELL,3,0.02h,Stop Loss,$-9.00,$-12.00,$241788.50,374,$-12.00
2025-06-12,13:31:00,22086.5,BUY,3,0.02h,Stop Loss,$40.50,$28.50,$241829.00,374,$28.50
2025-06-12,13:44:00,21876.75,SELL,3,0.02h,Stop Loss,$19.50,$48.00,$241848.50,374,$48.00
2025-06-12,13:48:00,22102.5,BUY,3,0.02h,Stop Loss,$-9.00,$39.00,$241839.50,374,$39.00
2025-06-12,13:49:00,21883.75,SELL,3,0.02h,Stop Loss,$-9.00,$30.00,$241830.50,374,$30.00
2025-06-12,13:50:00,22110.5,BUY,3,0.02h,Stop Loss,$-9.00,$21.00,$241821.50,374,$21.00
2025-06-12,13:51:00,21877.75,SELL,3,0.02h,Stop Loss,$-9.00,$12.00,$241812.50,374,$12.00
2025-06-12,13:52:00,22101.0,BUY,3,0.02h,Stop Loss,$33.00,$45.00,$241845.50,374,$45.00
2025-06-12,13:56:00,21850.25,SELL,3,0.02h,Break Even,$-1.50,$43.50,$241844.00,374,$43.50
2025-06-12,14:05:00,22079.5,BUY,3,0.02h,Stop Loss,$-9.00,$34.50,$241835.00,374,$34.50
2025-06-12,14:06:00,21852.5,SELL,3,0.02h,Break Even,$-1.50,$33.00,$241833.50,374,$33.00
2025-06-12,14:08:00,22116.25,BUY,3,0.02h,Stop Loss,$-9.00,$24.00,$241824.50,374,$24.00
2025-06-12,14:09:00,21898.25,SELL,3,0.02h,Stop Loss,$46.50,$70.50,$241871.00,374,$70.50
2025-06-12,14:12:00,22117.75,BUY,3,0.02h,Stop Loss,$58.50,$129.00,$241929.50,374,$129.00
2025-06-12,14:16:00,21920.75,SELL,3,0.02h,Stop Loss,$45.00,$174.00,$241974.50,374,$174.00
2025-06-12,14:21:00,22140.0,BUY,3,0.02h,Stop Loss,$-9.00,$165.00,$241965.50,374,$165.00
2025-06-12,14:35:00,21921.25,SELL,3,0.02h,Stop Loss,$-9.00,$156.00,$241956.50,374,$156.00
2025-06-12,14:36:00,22141.75,BUY,3,0.02h,Stop Loss,$-9.00,$147.00,$241947.50,374,$147.00
2025-06-12,14:46:00,21941.0,SELL,3,0.02h,Stop Loss,$-9.00,$138.00,$241938.50,374,$138.00
2025-06-12,14:47:00,22165.0,BUY,3,0.02h,Break Even,$-1.50,$136.50,$241937.00,374,$136.50
2025-06-12,14:49:00,21943.5,SELL,3,0.02h,Stop Loss,$-9.00,$127.50,$241928.00,374,$127.50
2025-06-12,14:53:00,22160.5,BUY,3,0.02h,Stop Loss,$-9.00,$118.50,$241919.00,374,$118.50
2025-06-12,14:54:00,21937.25,SELL,3,0.02h,Break Even,$-1.50,$117.00,$241917.50,374,$117.00
2025-06-12,15:00:00,22159.5,BUY,3,0.02h,Stop Loss,$34.50,$151.50,$241952.00,374,$151.50
2025-06-12,15:10:00,21952.75,SELL,3,0.02h,Stop Loss,$-9.00,$142.50,$241943.00,374,$142.50
2025-06-12,15:11:00,22173.0,BUY,3,0.02h,Stop Loss,$-9.00,$133.50,$241934.00,374,$133.50
2025-06-12,15:12:00,21954.5,SELL,3,0.02h,Stop Loss,$12.00,$145.50,$241946.00,374,$145.50
2025-06-12,15:19:00,22145.25,BUY,3,0.02h,Stop Loss,$42.00,$187.50,$241988.00,374,$187.50
2025-06-12,15:24:00,21919.75,SELL,3,0.02h,Stop Loss,$111.00,$298.50,$242099.00,374,$298.50
2025-06-12,15:35:00,22135.25,BUY,3,0.02h,Stop Loss,$45.00,$343.50,$242144.00,374,$343.50
2025-06-12,15:43:00,21920.0,SELL,3,0.02h,Stop Loss,$-9.00,$334.50,$242135.00,374,$334.50
2025-06-12,15:44:00,22150.0,BUY,3,0.02h,Stop Loss,$-9.00,$325.50,$242126.00,374,$325.50
2025-06-12,15:49:00,21905.0,SELL,3,0.02h,Stop Loss,$-9.00,$316.50,$242117.00,374,$316.50
2025-06-12,15:50:00,22130.5,BUY,3,0.02h,Break Even,$-1.50,$315.00,$242115.50,374,$315.00
2025-06-12,15:53:00,21910.0,SELL,3,0.02h,Stop Loss,$-9.00,$306.00,$242106.50,374,$306.00
2025-06-12,15:54:00,22136.25,BUY,3,0.02h,Stop Loss,$-9.00,$297.00,$242097.50,374,$297.00
2025-06-12,15:55:00,21914.75,SELL,3,0.02h,Break Even,$-1.50,$295.50,$242096.00,374,$295.50
2025-06-12,15:58:00,22137.0,BUY,3,0.02h,Stop Loss,$-9.00,$286.50,$242087.00,374,$286.50
2025-06-12,15:59:00,21924.0,SELL,3,0.02h,Stop Loss,$-9.00,$277.50,$242078.00,374,$277.50
2025-06-12,16:00:00,22148.5,BUY,3,0.02h,Stop Loss,$51.00,$328.50,$242129.00,374,$328.50
2025-06-12,16:10:00,21932.5,SELL,3,0.02h,Stop Loss,$-9.00,$319.50,$242120.00,374,$319.50
2025-06-12,16:11:00,22155.0,BUY,3,0.02h,Stop Loss,$49.50,$369.00,$242169.50,374,$369.00
2025-06-12,16:13:00,21940.75,SELL,3,0.02h,Stop Loss,$16.50,$385.50,$242186.00,374,$385.50
2025-06-12,16:19:00,22161.0,BUY,3,0.02h,Stop Loss,$-9.00,$376.50,$242177.00,374,$376.50
2025-06-12,16:20:00,21940.75,SELL,3,0.02h,Stop Loss,$-9.00,$367.50,$242168.00,374,$367.50
2025-06-12,16:21:00,22171.0,BUY,3,0.02h,Stop Loss,$-9.00,$358.50,$242159.00,374,$358.50
2025-06-12,16:33:00,21937.25,SELL,3,0.02h,Break Even,$-1.50,$357.00,$242157.50,374,$357.00
2025-06-12,16:37:00,22175.0,BUY,3,0.02h,Stop Loss,$-9.00,$348.00,$242148.50,374,$348.00
2025-06-12,16:38:00,21942.75,SELL,3,0.02h,Stop Loss,$-9.00,$339.00,$242139.50,374,$339.00
2025-06-12,16:56:00,22153.75,BUY,3,0.03h,Stop Loss,$-9.00,$330.00,$242130.50,374,$330.00
2025-06-12,16:59:00,21930.0,SELL,3,0.02h,Stop Loss,$42.00,$372.00,$242172.50,374,$372.00
2025-06-12,17:03:00,22163.0,BUY,3,0.02h,Stop Loss,$34.50,$406.50,$242207.00,374,$406.50
2025-06-12,17:10:00,21948.75,SELL,3,0.02h,Break Even,$-1.50,$405.00,$242205.50,374,$405.00
2025-06-12,17:14:00,22173.75,BUY,3,0.02h,Stop Loss,$-9.00,$396.00,$242196.50,374,$396.00
2025-06-12,17:18:00,21946.25,SELL,3,0.02h,Stop Loss,$-9.00,$387.00,$242187.50,374,$387.00
2025-06-12,17:19:00,22178.0,BUY,3,0.03h,Stop Loss,$-9.00,$378.00,$242178.50,374,$378.00
2025-06-12,17:28:00,21944.75,SELL,3,0.02h,Stop Loss,$40.50,$418.50,$242219.00,374,$418.50
2025-06-12,17:33:00,22189.0,BUY,3,0.02h,Stop Loss,$-9.00,$409.50,$242210.00,374,$409.50
2025-06-12,17:34:00,21960.0,SELL,3,0.02h,Stop Loss,$-9.00,$400.50,$242201.00,374,$400.50
2025-06-12,17:44:00,22182.5,BUY,3,0.02h,Stop Loss,$-9.00,$391.50,$242192.00,374,$391.50
2025-06-12,17:45:00,21953.5,SELL,3,0.02h,Stop Loss,$30.00,$421.50,$242222.00,374,$421.50
2025-06-12,17:48:00,22177.5,BUY,3,0.02h,Stop Loss,$-9.00,$412.50,$242213.00,374,$412.50
2025-06-12,17:49:00,21943.25,SELL,3,0.02h,Break Even,$-1.50,$411.00,$242211.50,374,$411.00
2025-06-12,17:51:00,22174.25,BUY,3,0.02h,Stop Loss,$-9.00,$402.00,$242202.50,374,$402.00
2025-06-12,17:52:00,21946.75,SELL,3,0.02h,Stop Loss,$-9.00,$393.00,$242193.50,374,$393.00
2025-06-12,17:53:00,22172.0,BUY,3,0.02h,Stop Loss,$-9.00,$384.00,$242184.50,374,$384.00
2025-06-12,17:54:00,21944.25,SELL,3,0.02h,Stop Loss,$4.50,$388.50,$242189.00,374,$388.50
2025-06-12,18:00:00,22161.0,BUY,3,0.02h,Stop Loss,$-9.00,$379.50,$242180.00,374,$379.50
2025-06-12,18:01:00,21938.75,SELL,3,0.02h,Break Even,$-1.50,$378.00,$242178.50,374,$378.00
2025-06-12,18:03:00,22162.0,BUY,3,0.02h,Stop Loss,$-9.00,$369.00,$242169.50,374,$369.00
2025-06-12,18:06:00,21942.5,SELL,3,0.02h,Break Even,$-1.50,$367.50,$242168.00,374,$367.50
2025-06-12,18:11:00,22169.75,BUY,3,0.02h,Stop Loss,$-9.00,$358.50,$242159.00,374,$358.50
2025-06-12,18:12:00,21945.25,SELL,3,0.02h,Break Even,$-1.50,$357.00,$242157.50,374,$357.00
2025-06-12,18:16:00,22166.75,BUY,3,0.02h,Stop Loss,$-9.00,$348.00,$242148.50,374,$348.00
2025-06-12,18:34:00,21923.25,SELL,3,0.02h,Stop Loss,$13.50,$361.50,$242162.00,374,$361.50
2025-06-12,18:53:00,22153.75,BUY,3,0.02h,Stop Loss,$-9.00,$352.50,$242153.00,374,$352.50
2025-06-12,18:54:00,21929.0,SELL,3,0.02h,Break Even,$-1.50,$351.00,$242151.50,374,$351.00
2025-06-12,18:59:00,22157.5,BUY,3,0.03h,Stop Loss,$3.00,$354.00,$242154.50,374,$354.00
2025-06-12,19:02:00,21935.5,SELL,3,0.02h,Stop Loss,$-9.00,$345.00,$242145.50,374,$345.00
2025-06-12,19:04:00,22167.75,BUY,3,0.02h,Stop Loss,$-9.00,$336.00,$242136.50,374,$336.00
2025-06-12,19:09:00,21939.75,SELL,3,0.02h,Stop Loss,$-9.00,$327.00,$242127.50,374,$327.00
2025-06-12,19:11:00,22166.25,BUY,3,0.02h,Stop Loss,$-9.00,$318.00,$242118.50,374,$318.00
2025-06-12,19:12:00,21939.0,SELL,3,0.02h,Stop Loss,$-9.00,$309.00,$242109.50,374,$309.00
2025-06-12,19:13:00,22163.75,BUY,3,0.02h,Stop Loss,$-9.00,$300.00,$242100.50,374,$300.00
2025-06-12,19:21:00,21948.75,SELL,3,0.02h,Stop Loss,$-9.00,$291.00,$242091.50,374,$291.00
2025-06-12,19:25:00,22164.75,BUY,3,0.02h,Stop Loss,$-9.00,$282.00,$242082.50,374,$282.00
2025-06-12,19:26:00,21931.0,SELL,3,0.02h,Break Even,$-1.50,$280.50,$242081.00,374,$280.50
2025-06-12,19:30:00,22162.75,BUY,3,0.02h,Stop Loss,$-9.00,$271.50,$242072.00,374,$271.50
2025-06-12,19:34:00,21930.0,SELL,3,0.02h,Stop Loss,$-9.00,$262.50,$242063.00,374,$262.50
2025-06-12,19:35:00,22153.0,BUY,3,0.02h,Stop Loss,$-9.00,$253.50,$242054.00,374,$253.50
2025-06-12,19:36:00,21924.5,SELL,3,0.02h,Stop Loss,$-9.00,$244.50,$242045.00,374,$244.50
2025-06-12,19:37:00,22149.0,BUY,3,0.02h,Stop Loss,$-9.00,$235.50,$242036.00,374,$235.50
2025-06-12,19:38:00,21920.25,SELL,3,0.02h,Stop Loss,$-9.00,$226.50,$242027.00,374,$226.50
2025-06-12,19:42:00,22145.75,BUY,3,0.02h,Stop Loss,$-9.00,$217.50,$242018.00,374,$217.50
2025-06-12,19:46:00,21909.25,SELL,3,0.02h,Stop Loss,$-9.00,$208.50,$242009.00,374,$208.50
2025-06-12,19:48:00,22133.0,BUY,3,0.02h,Break Even,$-1.50,$207.00,$242007.50,374,$207.00
2025-06-12,19:53:00,21906.5,SELL,3,0.02h,Stop Loss,$12.00,$219.00,$242019.50,374,$219.00
2025-06-12,20:02:00,22163.25,BUY,3,0.02h,Stop Loss,$-9.00,$210.00,$242010.50,374,$210.00
2025-06-12,20:03:00,21936.75,SELL,3,0.02h,Stop Loss,$-9.00,$201.00,$242001.50,374,$201.00
2025-06-12,20:04:00,22162.5,BUY,3,0.02h,Stop Loss,$-9.00,$192.00,$241992.50,374,$192.00
2025-06-12,20:05:00,21932.5,SELL,3,0.02h,Stop Loss,$-9.00,$183.00,$241983.50,374,$183.00
2025-06-12,20:06:00,22170.25,BUY,3,0.02h,Stop Loss,$-9.00,$174.00,$241974.50,374,$174.00
2025-06-12,20:17:00,21926.5,SELL,3,0.02h,Break Even,$-1.50,$172.50,$241973.00,374,$172.50
2025-06-12,20:23:00,22143.25,BUY,3,0.02h,Break Even,$-1.50,$171.00,$241971.50,374,$171.00
2025-06-12,20:31:00,21911.5,SELL,3,0.02h,Stop Loss,$-9.00,$162.00,$241962.50,374,$162.00
2025-06-12,20:38:00,22143.75,BUY,3,0.02h,Stop Loss,$-9.00,$153.00,$241953.50,374,$153.00
2025-06-12,20:39:00,21919.5,SELL,3,0.02h,Stop Loss,$-9.00,$144.00,$241944.50,374,$144.00
2025-06-12,20:56:00,22138.5,BUY,3,0.02h,Stop Loss,$-9.00,$135.00,$241935.50,374,$135.00
2025-06-12,21:00:00,21908.25,SELL,3,1.02h,Stop Loss,$43.50,$178.50,$241979.00,374,$178.50
2025-06-12,22:09:00,22114.75,BUY,3,0.02h,Stop Loss,$-9.00,$169.50,$241970.00,374,$169.50
2025-06-12,22:10:00,21892.75,SELL,3,0.02h,Stop Loss,$-9.00,$160.50,$241961.00,374,$160.50
2025-06-12,22:11:00,22119.25,BUY,3,0.02h,Stop Loss,$-9.00,$151.50,$241952.00,374,$151.50
2025-06-12,22:12:00,21897.25,SELL,3,0.02h,Break Even,$-1.50,$150.00,$241950.50,374,$150.00
2025-06-12,22:19:00,22112.75,BUY,3,0.02h,Stop Loss,$-9.00,$141.00,$241941.50,374,$141.00
2025-06-12,22:24:00,21886.5,SELL,3,0.02h,Stop Loss,$-9.00,$132.00,$241932.50,374,$132.00
2025-06-12,22:30:00,22102.0,BUY,3,0.02h,Stop Loss,$-9.00,$123.00,$241923.50,374,$123.00
2025-06-12,22:33:00,21871.5,SELL,3,0.02h,Stop Loss,$-9.00,$114.00,$241914.50,374,$114.00
2025-06-12,22:35:00,22100.5,BUY,3,0.02h,Stop Loss,$-9.00,$105.00,$241905.50,374,$105.00
2025-06-12,22:38:00,21872.25,SELL,3,0.02h,Break Even,$-1.50,$103.50,$241904.00,374,$103.50
2025-06-12,22:42:00,22096.75,BUY,3,0.02h,Stop Loss,$-9.00,$94.50,$241895.00,374,$94.50
2025-06-12,22:43:00,21870.5,SELL,3,0.02h,Break Even,$-1.50,$93.00,$241893.50,374,$93.00
2025-06-12,22:45:00,22095.5,BUY,3,0.02h,Break Even,$-1.50,$91.50,$241892.00,374,$91.50
2025-06-12,22:59:00,21882.5,SELL,3,0.02h,Stop Loss,$-9.00,$82.50,$241883.00,374,$82.50
2025-06-12,23:00:00,22105.75,BUY,3,13.00h,Stop Loss,$-9.00,$73.50,$241874.00,374,$73.50
,,,,,,,,,,,
2025-06-13,12:00:00,21905.5,SELL,3,0.02h,Stop Loss,$1320.00,$1320.00,$243194.00,375,$1320.00
2025-06-13,12:39:00,21913.25,BUY,3,0.02h,Stop Loss,$-9.00,$1311.00,$243185.00,375,$1311.00
2025-06-13,12:40:00,21687.25,SELL,3,0.02h,Stop Loss,$-9.00,$1302.00,$243176.00,375,$1302.00
2025-06-13,12:41:00,21905.5,BUY,3,0.02h,Stop Loss,$-9.00,$1293.00,$243167.00,375,$1293.00
2025-06-13,12:42:00,21684.75,SELL,3,0.02h,Stop Loss,$-9.00,$1284.00,$243158.00,375,$1284.00
2025-06-13,12:43:00,21897.0,BUY,3,0.02h,Stop Loss,$-9.00,$1275.00,$243149.00,375,$1275.00
2025-06-13,12:44:00,21674.75,SELL,3,0.02h,Stop Loss,$46.50,$1321.50,$243195.50,375,$1321.50
2025-06-13,12:46:00,21889.25,BUY,3,0.02h,Break Even,$-1.50,$1320.00,$243194.00,375,$1320.00
2025-06-13,12:52:00,21651.5,SELL,3,0.02h,Break Even,$-1.50,$1318.50,$243192.50,375,$1318.50
2025-06-13,12:55:00,21870.75,BUY,3,0.02h,Stop Loss,$24.00,$1342.50,$243216.50,375,$1342.50
2025-06-13,13:03:00,21649.25,SELL,3,0.02h,Stop Loss,$-9.00,$1333.50,$243207.50,375,$1333.50
2025-06-13,13:05:00,21874.25,BUY,3,0.02h,Stop Loss,$-9.00,$1324.50,$243198.50,375,$1324.50
2025-06-13,13:06:00,21650.0,SELL,3,0.02h,Stop Loss,$7.50,$1332.00,$243206.00,375,$1332.00
2025-06-13,13:20:00,21857.0,BUY,3,0.02h,Stop Loss,$-9.00,$1323.00,$243197.00,375,$1323.00
2025-06-13,13:21:00,21637.25,SELL,3,0.02h,Stop Loss,$-9.00,$1314.00,$243188.00,375,$1314.00
2025-06-13,13:22:00,21861.0,BUY,3,0.02h,Stop Loss,$-9.00,$1305.00,$243179.00,375,$1305.00
2025-06-13,13:23:00,21646.25,SELL,3,0.02h,Break Even,$-1.50,$1303.50,$243177.50,375,$1303.50
2025-06-13,13:26:00,21877.5,BUY,3,0.02h,Stop Loss,$-9.00,$1294.50,$243168.50,375,$1294.50
2025-06-13,13:27:00,21668.5,SELL,3,0.02h,Stop Loss,$39.00,$1333.50,$243207.50,375,$1333.50
2025-06-13,13:30:00,21901.25,BUY,3,0.02h,Stop Loss,$-9.00,$1324.50,$243198.50,375,$1324.50
2025-06-13,13:49:00,21755.25,SELL,3,0.02h,Stop Loss,$58.50,$1383.00,$243257.00,375,$1383.00
2025-06-13,13:53:00,21982.0,BUY,3,0.02h,Stop Loss,$18.00,$1401.00,$243275.00,375,$1401.00
2025-06-13,14:05:00,21731.75,SELL,3,0.02h,Stop Loss,$34.50,$1435.50,$243309.50,375,$1435.50
2025-06-13,14:08:00,21953.0,BUY,3,0.02h,Stop Loss,$6.00,$1441.50,$243315.50,375,$1441.50
2025-06-13,14:10:00,21724.0,SELL,3,0.02h,Stop Loss,$-9.00,$1432.50,$243306.50,375,$1432.50
2025-06-13,14:12:00,21912.25,BUY,3,0.02h,Break Even,$-1.50,$1431.00,$243305.00,375,$1431.00
2025-06-13,14:14:00,21694.0,SELL,3,0.02h,Stop Loss,$6.00,$1437.00,$243311.00,375,$1437.00
2025-06-13,14:26:00,21882.75,BUY,3,0.02h,Stop Loss,$18.00,$1455.00,$243329.00,375,$1455.00
2025-06-13,14:33:00,21658.0,SELL,3,0.02h,Stop Loss,$-9.00,$1446.00,$243320.00,375,$1446.00
2025-06-13,14:35:00,21883.25,BUY,3,0.02h,Stop Loss,$-9.00,$1437.00,$243311.00,375,$1437.00
2025-06-13,14:36:00,21676.25,SELL,3,0.02h,Stop Loss,$54.00,$1491.00,$243365.00,375,$1491.00
2025-06-13,14:44:00,21938.25,BUY,3,0.02h,Stop Loss,$-9.00,$1482.00,$243356.00,375,$1482.00
2025-06-13,14:45:00,21707.25,SELL,3,0.02h,Stop Loss,$13.50,$1495.50,$243369.50,375,$1495.50
2025-06-13,14:47:00,21933.0,BUY,3,0.02h,Stop Loss,$9.00,$1504.50,$243378.50,375,$1504.50
2025-06-13,15:07:00,21750.5,SELL,3,0.02h,Stop Loss,$-9.00,$1495.50,$243369.50,375,$1495.50
2025-06-13,15:08:00,21981.25,BUY,3,0.02h,Break Even,$-1.50,$1494.00,$243368.00,375,$1494.00
2025-06-13,15:11:00,21737.0,SELL,3,0.02h,Stop Loss,$-9.00,$1485.00,$243359.00,375,$1485.00
2025-06-13,15:12:00,21966.0,BUY,3,0.02h,Stop Loss,$-9.00,$1476.00,$243350.00,375,$1476.00
2025-06-13,15:13:00,21751.5,SELL,3,0.02h,Stop Loss,$-9.00,$1467.00,$243341.00,375,$1467.00
2025-06-13,15:15:00,21984.0,BUY,3,0.02h,Stop Loss,$45.00,$1512.00,$243386.00,375,$1512.00
2025-06-13,15:25:00,21780.75,SELL,3,0.02h,Stop Loss,$36.00,$1548.00,$243422.00,375,$1548.00
2025-06-13,15:28:00,22013.75,BUY,3,0.02h,Break Even,$-1.50,$1546.50,$243420.50,375,$1546.50
2025-06-13,15:31:00,21796.0,SELL,3,0.02h,Break Even,$-1.50,$1545.00,$243419.00,375,$1545.00
2025-06-13,15:40:00,22018.25,BUY,3,0.02h,Stop Loss,$-9.00,$1536.00,$243410.00,375,$1536.00
2025-06-13,15:41:00,21792.75,SELL,3,0.02h,Break Even,$-1.50,$1534.50,$243408.50,375,$1534.50
2025-06-13,15:51:00,22053.0,BUY,3,0.02h,Stop Loss,$-9.00,$1525.50,$243399.50,375,$1525.50
2025-06-13,15:52:00,21839.75,SELL,3,0.02h,Stop Loss,$21.00,$1546.50,$243420.50,375,$1546.50
2025-06-13,15:54:00,22056.5,BUY,3,0.02h,Stop Loss,$25.50,$1572.00,$243446.00,375,$1572.00
2025-06-13,16:02:00,21820.25,SELL,3,0.02h,Stop Loss,$-9.00,$1563.00,$243437.00,375,$1563.00
2025-06-13,16:03:00,22049.75,BUY,3,0.02h,Stop Loss,$-9.00,$1554.00,$243428.00,375,$1554.00
2025-06-13,16:05:00,21821.25,SELL,3,0.02h,Stop Loss,$7.50,$1561.50,$243435.50,375,$1561.50
2025-06-13,16:07:00,22052.0,BUY,3,0.02h,Stop Loss,$6.00,$1567.50,$243441.50,375,$1567.50
2025-06-13,16:18:00,21847.5,SELL,3,0.02h,Stop Loss,$-9.00,$1558.50,$243432.50,375,$1558.50
2025-06-13,16:19:00,22071.5,BUY,3,0.02h,Stop Loss,$-9.00,$1549.50,$243423.50,375,$1549.50
2025-06-13,16:20:00,21844.25,SELL,3,0.02h,Stop Loss,$58.50,$1608.00,$243482.00,375,$1608.00
2025-06-13,16:22:00,22060.0,BUY,3,0.02h,Stop Loss,$18.00,$1626.00,$243500.00,375,$1626.00
2025-06-13,16:25:00,21841.75,SELL,3,0.02h,Break Even,$-1.50,$1624.50,$243498.50,375,$1624.50
2025-06-13,16:29:00,22043.0,BUY,3,0.02h,Stop Loss,$-9.00,$1615.50,$243489.50,375,$1615.50
2025-06-13,16:30:00,21820.25,SELL,3,0.02h,Stop Loss,$3.00,$1618.50,$243492.50,375,$1618.50
2025-06-13,16:32:00,22047.75,BUY,3,0.02h,Break Even,$-1.50,$1617.00,$243491.00,375,$1617.00
2025-06-13,16:39:00,21816.75,SELL,3,0.02h,Stop Loss,$-9.00,$1608.00,$243482.00,375,$1608.00
2025-06-13,16:40:00,22028.0,BUY,3,0.02h,Stop Loss,$-9.00,$1599.00,$243473.00,375,$1599.00
2025-06-13,16:41:00,21811.0,SELL,3,0.02h,Break Even,$-1.50,$1597.50,$243471.50,375,$1597.50
2025-06-13,16:44:00,22030.0,BUY,3,0.02h,Stop Loss,$-9.00,$1588.50,$243462.50,375,$1588.50
2025-06-13,16:45:00,21811.25,SELL,3,0.02h,Stop Loss,$-9.00,$1579.50,$243453.50,375,$1579.50
2025-06-13,16:46:00,22029.25,BUY,3,0.02h,Break Even,$-1.50,$1578.00,$243452.00,375,$1578.00
2025-06-13,16:48:00,21800.25,SELL,3,0.02h,Stop Loss,$-9.00,$1569.00,$243443.00,375,$1569.00
2025-06-13,16:51:00,22027.0,BUY,3,0.02h,Stop Loss,$9.00,$1578.00,$243452.00,375,$1578.00
2025-06-13,16:53:00,21821.5,SELL,3,0.02h,Stop Loss,$9.00,$1587.00,$243461.00,375,$1587.00
2025-06-13,17:00:00,22048.0,BUY,3,0.02h,Stop Loss,$4.50,$1591.50,$243465.50,375,$1591.50
2025-06-13,17:09:00,21808.25,SELL,3,0.02h,Stop Loss,$-9.00,$1582.50,$243456.50,375,$1582.50
2025-06-13,17:10:00,22025.75,BUY,3,0.02h,Stop Loss,$-9.00,$1573.50,$243447.50,375,$1573.50
2025-06-13,17:13:00,21792.75,SELL,3,0.02h,Stop Loss,$-9.00,$1564.50,$243438.50,375,$1564.50
2025-06-13,17:17:00,21977.5,BUY,3,0.02h,Stop Loss,$-9.00,$1555.50,$243429.50,375,$1555.50
2025-06-13,17:18:00,21774.75,SELL,3,0.02h,Stop Loss,$-9.00,$1546.50,$243420.50,375,$1546.50
2025-06-13,17:32:00,22007.0,BUY,3,0.02h,Stop Loss,$-9.00,$1537.50,$243411.50,375,$1537.50
2025-06-13,17:44:00,21762.0,SELL,3,0.02h,Stop Loss,$52.50,$1590.00,$243464.00,375,$1590.00
2025-06-13,17:53:00,22013.5,BUY,3,0.02h,Break Even,$-1.50,$1588.50,$243462.50,375,$1588.50
2025-06-13,17:58:00,21785.75,SELL,3,0.02h,Stop Loss,$-9.00,$1579.50,$243453.50,375,$1579.50
2025-06-13,17:59:00,22008.5,BUY,3,0.02h,Stop Loss,$-9.00,$1570.50,$243444.50,375,$1570.50
2025-06-13,18:00:00,21788.0,SELL,3,0.02h,Stop Loss,$-9.00,$1561.50,$243435.50,375,$1561.50
2025-06-13,18:01:00,22020.25,BUY,3,0.02h,Break Even,$-1.50,$1560.00,$243434.00,375,$1560.00
2025-06-13,18:07:00,21751.0,SELL,3,0.02h,Stop Loss,$43.50,$1603.50,$243477.50,375,$1603.50
2025-06-13,18:23:00,21925.5,BUY,3,0.02h,Stop Loss,$-9.00,$1594.50,$243468.50,375,$1594.50
2025-06-13,18:24:00,21722.75,SELL,3,0.02h,Stop Loss,$22.50,$1617.00,$243491.00,375,$1617.00
2025-06-13,18:46:00,21865.75,BUY,3,0.02h,Stop Loss,$-9.00,$1608.00,$243482.00,375,$1608.00
2025-06-13,18:47:00,21645.25,SELL,3,0.02h,Stop Loss,$70.50,$1678.50,$243552.50,375,$1678.50
2025-06-13,18:56:00,21876.5,BUY,3,0.02h,Stop Loss,$16.50,$1695.00,$243569.00,375,$1695.00
2025-06-13,19:04:00,21656.0,SELL,3,0.02h,Stop Loss,$15.00,$1710.00,$243584.00,375,$1710.00
2025-06-13,19:16:00,21898.5,BUY,3,0.02h,Stop Loss,$-9.00,$1701.00,$243575.00,375,$1701.00
2025-06-13,19:23:00,21648.25,SELL,3,0.02h,Stop Loss,$28.50,$1729.50,$243603.50,375,$1729.50
2025-06-13,19:30:00,21850.0,BUY,3,0.02h,Stop Loss,$-9.00,$1720.50,$243594.50,375,$1720.50
2025-06-13,19:31:00,21646.75,SELL,3,0.02h,Stop Loss,$4.50,$1725.00,$243599.00,375,$1725.00
2025-06-13,19:37:00,21872.75,BUY,3,0.02h,Stop Loss,$-9.00,$1716.00,$243590.00,375,$1716.00
2025-06-13,19:38:00,21669.25,SELL,3,0.02h,Stop Loss,$-9.00,$1707.00,$243581.00,375,$1707.00
2025-06-13,19:39:00,21882.0,BUY,3,0.02h,Stop Loss,$-9.00,$1698.00,$243572.00,375,$1698.00
2025-06-13,19:44:00,21632.25,SELL,3,0.02h,Stop Loss,$-9.00,$1689.00,$243563.00,375,$1689.00
2025-06-13,19:45:00,21846.0,BUY,3,0.02h,Stop Loss,$-9.00,$1680.00,$243554.00,375,$1680.00
2025-06-13,19:46:00,21611.5,SELL,3,0.02h,Stop Loss,$-9.00,$1671.00,$243545.00,375,$1671.00
2025-06-13,19:47:00,21834.5,BUY,3,0.02h,Stop Loss,$-9.00,$1662.00,$243536.00,375,$1662.00
2025-06-13,19:48:00,21619.5,SELL,3,0.02h,Break Even,$-1.50,$1660.50,$243534.50,375,$1660.50
2025-06-13,19:50:00,21854.0,BUY,3,0.02h,Stop Loss,$-9.00,$1651.50,$243525.50,375,$1651.50
2025-06-13,19:51:00,21638.0,SELL,3,0.02h,Stop Loss,$-9.00,$1642.50,$243516.50,375,$1642.50
2025-06-13,19:52:00,21851.25,BUY,3,0.02h,Break Even,$-1.50,$1641.00,$243515.00,375,$1641.00
2025-06-13,19:55:00,21624.5,SELL,3,0.02h,Stop Loss,$-9.00,$1632.00,$243506.00,375,$1632.00
2025-06-13,19:56:00,21835.25,BUY,3,0.02h,Stop Loss,$-9.00,$1623.00,$243497.00,375,$1623.00
2025-06-13,19:57:00,21623.75,SELL,3,0.02h,Stop Loss,$22.50,$1645.50,$243519.50,375,$1645.50
2025-06-13,20:00:00,21868.25,BUY,3,0.02h,Stop Loss,$75.00,$1720.50,$243594.50,375,$1720.50
2025-06-13,20:06:00,21658.75,SELL,3,0.02h,Stop Loss,$-9.00,$1711.50,$243585.50,375,$1711.50
2025-06-13,20:07:00,21865.5,BUY,3,0.02h,Stop Loss,$-9.00,$1702.50,$243576.50,375,$1702.50
2025-06-13,20:08:00,21650.5,SELL,3,0.02h,Stop Loss,$-9.00,$1693.50,$243567.50,375,$1693.50
2025-06-13,20:17:00,21879.5,BUY,3,0.02h,Stop Loss,$-9.00,$1684.50,$243558.50,375,$1684.50
2025-06-13,20:18:00,21667.75,SELL,3,0.02h,Stop Loss,$-9.00,$1675.50,$243549.50,375,$1675.50
2025-06-13,20:19:00,21887.0,BUY,3,0.02h,Stop Loss,$-9.00,$1666.50,$243540.50,375,$1666.50
2025-06-13,20:21:00,21665.75,SELL,3,0.02h,Stop Loss,$-9.00,$1657.50,$243531.50,375,$1657.50
2025-06-13,20:22:00,21877.5,BUY,3,0.02h,Stop Loss,$-9.00,$1648.50,$243522.50,375,$1648.50
2025-06-13,20:24:00,21658.5,SELL,3,0.02h,Stop Loss,$-9.00,$1639.50,$243513.50,375,$1639.50
2025-06-13,20:25:00,21875.25,BUY,3,0.02h,Stop Loss,$-9.00,$1630.50,$243504.50,375,$1630.50
2025-06-13,20:28:00,21653.75,SELL,3,0.02h,Stop Loss,$-9.00,$1621.50,$243495.50,375,$1621.50
2025-06-13,20:29:00,21867.0,BUY,3,0.02h,Stop Loss,$-9.00,$1612.50,$243486.50,375,$1612.50
2025-06-13,20:38:00,21672.25,SELL,3,0.02h,Break Even,$-1.50,$1611.00,$243485.00,375,$1611.00
2025-06-13,20:40:00,21882.75,BUY,3,0.02h,Stop Loss,$-9.00,$1602.00,$243476.00,375,$1602.00
2025-06-13,20:41:00,21662.0,SELL,3,0.02h,Stop Loss,$13.50,$1615.50,$243489.50,375,$1615.50
2025-06-13,20:46:00,21875.0,BUY,3,0.02h,Stop Loss,$-9.00,$1606.50,$243480.50,375,$1606.50
2025-06-13,20:52:00,21651.75,SELL,3,0.02h,Stop Loss,$-9.00,$1597.50,$243471.50,375,$1597.50
2025-06-13,20:53:00,21866.75,BUY,3,0.02h,Stop Loss,$-9.00,$1588.50,$243462.50,375,$1588.50
2025-06-13,20:54:00,21647.25,SELL,3,0.02h,Stop Loss,$-9.00,$1579.50,$243453.50,375,$1579.50
2025-06-13,20:55:00,21864.0,BUY,3,0.02h,Stop Loss,$-9.00,$1570.50,$243444.50,375,$1570.50
2025-06-13,20:56:00,21647.75,SELL,3,0.02h,Break Even,$-1.50,$1569.00,$243443.00,375,$1569.00
,,,,,,,,,,,
2025-06-16,12:00:00,22033.25,BUY,3,0.02h,Break Even,$-1.50,$-1.50,$243441.50,376,$-1.50
2025-06-16,12:55:00,22038.75,SELL,3,0.02h,Stop Loss,$-9.00,$-10.50,$243432.50,376,$-10.50
2025-06-16,12:56:00,22041.75,BUY,3,0.02h,Break Even,$-1.50,$-12.00,$243431.00,376,$-12.00
2025-06-16,12:59:00,22035.0,SELL,3,0.02h,Stop Loss,$-9.00,$-21.00,$243422.00,376,$-21.00
2025-06-16,13:02:00,22043.0,BUY,3,0.02h,Stop Loss,$9.00,$-12.00,$243431.00,376,$-12.00
2025-06-16,13:07:00,22035.5,SELL,3,0.02h,Stop Loss,$10.50,$-1.50,$243441.50,376,$-1.50
2025-06-16,13:14:00,22040.75,BUY,3,0.02h,Break Even,$-1.50,$-3.00,$243440.00,376,$-3.00
2025-06-16,13:17:00,22037.5,SELL,3,0.02h,Stop Loss,$19.50,$16.50,$243459.50,376,$16.50
2025-06-16,13:32:00,22079.5,BUY,3,0.02h,Stop Loss,$94.50,$111.00,$243554.00,376,$111.00
2025-06-16,14:52:00,22187.75,SELL,3,0.02h,Stop Loss,$7.50,$118.50,$243561.50,376,$118.50
2025-06-16,15:03:00,22196.25,BUY,3,0.02h,Stop Loss,$-9.00,$109.50,$243552.50,376,$109.50
2025-06-16,15:04:00,22178.75,SELL,3,0.02h,Break Even,$-1.50,$108.00,$243551.00,376,$108.00
2025-06-16,15:08:00,22191.75,BUY,3,0.02h,Break Even,$-1.50,$106.50,$243549.50,376,$106.50
2025-06-16,15:29:00,22190.0,SELL,3,0.02h,Stop Loss,$13.50,$120.00,$243563.00,376,$120.00
2025-06-16,15:47:00,22203.75,BUY,3,0.02h,Stop Loss,$-9.00,$111.00,$243554.00,376,$111.00
2025-06-16,15:52:00,22187.0,SELL,3,0.02h,Stop Loss,$18.00,$129.00,$243572.00,376,$129.00
2025-06-16,16:15:00,22184.0,BUY,3,0.02h,Break Even,$-1.50,$127.50,$243570.50,376,$127.50
2025-06-16,16:26:00,22169.5,SELL,3,0.02h,Stop Loss,$18.00,$145.50,$243588.50,376,$145.50
2025-06-16,16:54:00,22178.5,BUY,3,0.02h,Stop Loss,$-9.00,$136.50,$243579.50,376,$136.50
2025-06-16,17:03:00,22159.75,SELL,3,0.02h,Break Even,$-1.50,$135.00,$243578.00,376,$135.00
2025-06-16,17:20:00,22169.5,BUY,3,0.02h,Stop Loss,$46.50,$181.50,$243624.50,376,$181.50
2025-06-16,17:54:00,22185.25,SELL,3,0.02h,Stop Loss,$40.50,$222.00,$243665.00,376,$222.00
2025-06-16,18:26:00,22173.75,BUY,3,0.02h,Break Even,$-1.50,$220.50,$243663.50,376,$220.50
2025-06-16,18:31:00,22165.5,SELL,3,0.02h,Stop Loss,$9.00,$229.50,$243672.50,376,$229.50
2025-06-16,18:57:00,22171.0,BUY,3,0.02h,Stop Loss,$6.00,$235.50,$243678.50,376,$235.50
2025-06-16,19:08:00,22156.5,SELL,3,0.02h,Break Even,$-1.50,$234.00,$243677.00,376,$234.00
2025-06-16,19:23:00,22176.5,BUY,3,0.02h,Stop Loss,$10.50,$244.50,$243687.50,376,$244.50
2025-06-16,19:34:00,22155.5,SELL,3,0.02h,Stop Loss,$-9.00,$235.50,$243678.50,376,$235.50
2025-06-16,19:46:00,22172.5,BUY,3,0.02h,Stop Loss,$-9.00,$226.50,$243669.50,376,$226.50
2025-06-16,19:52:00,22153.75,SELL,3,0.02h,Break Even,$-1.50,$225.00,$243668.00,376,$225.00
2025-06-16,19:56:00,22173.25,BUY,3,0.02h,Break Even,$-1.50,$223.50,$243666.50,376,$223.50
2025-06-16,19:58:00,22151.25,SELL,3,0.02h,Stop Loss,$21.00,$244.50,$243687.50,376,$244.50
2025-06-16,20:01:00,22172.5,BUY,3,0.02h,Stop Loss,$21.00,$265.50,$243708.50,376,$265.50
2025-06-16,20:22:00,22168.0,SELL,3,0.03h,Break Even,$-1.50,$264.00,$243707.00,376,$264.00
2025-06-16,20:37:00,22172.0,BUY,3,0.02h,Break Even,$-1.50,$262.50,$243705.50,376,$262.50
2025-06-16,20:55:00,22169.5,SELL,3,0.02h,Stop Loss,$7.50,$270.00,$243713.00,376,$270.00
,,,,,,,,,,,
2025-06-17,12:14:00,22082.75,BUY,3,0.02h,Stop Loss,$-9.00,$-9.00,$243704.00,377,$-9.00
2025-06-17,12:15:00,21858.0,SELL,3,0.02h,Stop Loss,$-9.00,$-18.00,$243695.00,377,$-18.00
2025-06-17,12:28:00,22083.75,BUY,3,0.02h,Stop Loss,$-9.00,$-27.00,$243686.00,377,$-27.00
2025-06-17,12:34:00,21848.5,SELL,3,0.02h,Stop Loss,$-9.00,$-36.00,$243677.00,377,$-36.00
2025-06-17,12:35:00,22073.75,BUY,3,0.02h,Break Even,$-1.50,$-37.50,$243675.50,377,$-37.50
2025-06-17,12:38:00,21841.5,SELL,3,0.02h,Stop Loss,$-9.00,$-46.50,$243666.50,377,$-46.50
2025-06-17,12:39:00,22071.25,BUY,3,0.02h,Stop Loss,$66.00,$19.50,$243732.50,377,$19.50
2025-06-17,12:44:00,21855.75,SELL,3,0.02h,Stop Loss,$-9.00,$10.50,$243723.50,377,$10.50
2025-06-17,12:47:00,22074.0,BUY,3,0.02h,Stop Loss,$-9.00,$1.50,$243714.50,377,$1.50
2025-06-17,12:48:00,21842.5,SELL,3,0.02h,Stop Loss,$-9.00,$-7.50,$243705.50,377,$-7.50
2025-06-17,12:50:00,22057.5,BUY,3,0.02h,Stop Loss,$-9.00,$-16.50,$243696.50,377,$-16.50
2025-06-17,12:52:00,21831.0,SELL,3,0.02h,Stop Loss,$4.50,$-12.00,$243701.00,377,$-12.00
2025-06-17,13:02:00,22056.75,BUY,3,0.02h,Stop Loss,$4.50,$-7.50,$243705.50,377,$-7.50
2025-06-17,13:07:00,21825.75,SELL,3,0.02h,Stop Loss,$13.50,$6.00,$243719.00,377,$6.00
2025-06-17,13:11:00,22042.0,BUY,3,0.02h,Stop Loss,$10.50,$16.50,$243729.50,377,$16.50
2025-06-17,13:14:00,21822.5,SELL,3,0.02h,Break Even,$-1.50,$15.00,$243728.00,377,$15.00
2025-06-17,13:30:00,22063.25,BUY,3,0.02h,Stop Loss,$225.00,$240.00,$243953.00,377,$240.00
2025-06-17,13:37:00,21854.75,SELL,3,0.02h,Stop Loss,$-9.00,$231.00,$243944.00,377,$231.00
2025-06-17,13:38:00,22070.25,BUY,3,0.02h,Stop Loss,$-9.00,$222.00,$243935.00,377,$222.00
2025-06-17,13:46:00,21817.5,SELL,3,0.02h,Stop Loss,$-9.00,$213.00,$243926.00,377,$213.00
2025-06-17,13:47:00,22055.0,BUY,3,0.02h,Stop Loss,$63.00,$276.00,$243989.00,377,$276.00
2025-06-17,13:59:00,21862.75,SELL,3,0.02h,Stop Loss,$-9.00,$267.00,$243980.00,377,$267.00
2025-06-17,14:06:00,22079.0,BUY,3,0.02h,Stop Loss,$43.50,$310.50,$244023.50,377,$310.50
2025-06-17,14:16:00,21899.75,SELL,3,0.02h,Break Even,$-1.50,$309.00,$244022.00,377,$309.00
2025-06-17,14:32:00,22104.25,BUY,3,0.02h,Break Even,$-1.50,$307.50,$244020.50,377,$307.50
2025-06-17,14:38:00,21861.5,SELL,3,0.02h,Stop Loss,$-9.00,$298.50,$244011.50,377,$298.50
2025-06-17,14:39:00,22097.75,BUY,3,0.02h,Break Even,$-1.50,$297.00,$244010.00,377,$297.00
2025-06-17,14:42:00,21858.5,SELL,3,0.02h,Stop Loss,$-9.00,$288.00,$244001.00,377,$288.00
2025-06-17,14:43:00,22084.75,BUY,3,0.02h,Stop Loss,$-9.00,$279.00,$243992.00,377,$279.00
2025-06-17,14:44:00,21864.75,SELL,3,0.02h,Stop Loss,$-9.00,$270.00,$243983.00,377,$270.00
2025-06-17,14:45:00,22084.0,BUY,3,0.02h,Stop Loss,$102.00,$372.00,$244085.00,377,$372.00
2025-06-17,14:56:00,21867.0,SELL,3,0.02h,Stop Loss,$-9.00,$363.00,$244076.00,377,$363.00
2025-06-17,14:58:00,22075.75,BUY,3,0.02h,Stop Loss,$39.00,$402.00,$244115.00,377,$402.00
2025-06-17,15:00:00,21849.5,SELL,3,0.02h,Break Even,$-1.50,$400.50,$244113.50,377,$400.50
2025-06-17,15:10:00,22110.25,BUY,3,0.02h,Stop Loss,$18.00,$418.50,$244131.50,377,$418.50
2025-06-17,15:18:00,21884.5,SELL,3,0.02h,Break Even,$-1.50,$417.00,$244130.00,377,$417.00
2025-06-17,15:35:00,22089.0,BUY,3,0.02h,Break Even,$-1.50,$415.50,$244128.50,377,$415.50
2025-06-17,15:42:00,21880.25,SELL,3,0.02h,Stop Loss,$-9.00,$406.50,$244119.50,377,$406.50
2025-06-17,15:45:00,22118.5,BUY,3,0.02h,Stop Loss,$4.50,$411.00,$244124.00,377,$411.00
2025-06-17,15:48:00,21885.25,SELL,3,0.02h,Stop Loss,$100.50,$511.50,$244224.50,377,$511.50
2025-06-17,15:51:00,22102.0,BUY,3,0.02h,Stop Loss,$-9.00,$502.50,$244215.50,377,$502.50
2025-06-17,15:52:00,21889.0,SELL,3,0.02h,Stop Loss,$-9.00,$493.50,$244206.50,377,$493.50
2025-06-17,15:59:00,22105.5,BUY,3,0.02h,Break Even,$-1.50,$492.00,$244205.00,377,$492.00
2025-06-17,16:11:00,21894.0,SELL,3,0.02h,Stop Loss,$-9.00,$483.00,$244196.00,377,$483.00
2025-06-17,16:12:00,22129.5,BUY,3,0.02h,Stop Loss,$-9.00,$474.00,$244187.00,377,$474.00
2025-06-17,16:22:00,21895.25,SELL,3,0.02h,Stop Loss,$-9.00,$465.00,$244178.00,377,$465.00
2025-06-17,16:23:00,22117.0,BUY,3,0.02h,Stop Loss,$-9.00,$456.00,$244169.00,377,$456.00
2025-06-17,16:24:00,21888.25,SELL,3,0.02h,Stop Loss,$4.50,$460.50,$244173.50,377,$460.50
2025-06-17,16:27:00,22111.0,BUY,3,0.02h,Stop Loss,$-9.00,$451.50,$244164.50,377,$451.50
2025-06-17,16:28:00,21885.25,SELL,3,0.02h,Stop Loss,$-9.00,$442.50,$244155.50,377,$442.50
2025-06-17,16:29:00,22117.0,BUY,3,0.02h,Break Even,$-1.50,$441.00,$244154.00,377,$441.00
2025-06-17,16:32:00,21886.5,SELL,3,0.02h,Break Even,$-1.50,$439.50,$244152.50,377,$439.50
2025-06-17,16:35:00,22122.75,BUY,3,0.02h,Stop Loss,$-9.00,$430.50,$244143.50,377,$430.50
2025-06-17,16:36:00,21899.25,SELL,3,0.02h,Stop Loss,$-9.00,$421.50,$244134.50,377,$421.50
2025-06-17,16:37:00,22123.5,BUY,3,0.02h,Break Even,$-1.50,$420.00,$244133.00,377,$420.00
2025-06-17,16:40:00,21885.75,SELL,3,0.02h,Stop Loss,$21.00,$441.00,$244154.00,377,$441.00
2025-06-17,16:50:00,22070.5,BUY,3,0.02h,Stop Loss,$19.50,$460.50,$244173.50,377,$460.50
2025-06-17,16:56:00,21820.25,SELL,3,0.02h,Break Even,$-1.50,$459.00,$244172.00,377,$459.00
2025-06-17,17:15:00,22051.0,BUY,3,0.02h,Stop Loss,$3.00,$462.00,$244175.00,377,$462.00
2025-06-17,17:20:00,21815.25,SELL,3,0.02h,Stop Loss,$46.50,$508.50,$244221.50,377,$508.50
2025-06-17,17:24:00,22033.5,BUY,3,0.02h,Stop Loss,$70.50,$579.00,$244292.00,377,$579.00
2025-06-17,17:28:00,21803.5,SELL,3,0.02h,Stop Loss,$-9.00,$570.00,$244283.00,377,$570.00
2025-06-17,17:29:00,22020.75,BUY,3,0.02h,Stop Loss,$4.50,$574.50,$244287.50,377,$574.50
2025-06-17,17:36:00,21818.75,SELL,3,0.02h,Stop Loss,$-9.00,$565.50,$244278.50,377,$565.50
2025-06-17,17:37:00,22042.75,BUY,3,0.02h,Stop Loss,$10.50,$576.00,$244289.00,377,$576.00
2025-06-17,17:44:00,21793.0,SELL,3,0.02h,Stop Loss,$76.50,$652.50,$244365.50,377,$652.50
2025-06-17,18:08:00,21967.0,BUY,3,0.02h,Break Even,$-1.50,$651.00,$244364.00,377,$651.00
2025-06-17,18:17:00,21721.25,SELL,3,0.02h,Stop Loss,$13.50,$664.50,$244377.50,377,$664.50
2025-06-17,18:24:00,21946.25,BUY,3,0.02h,Stop Loss,$-9.00,$655.50,$244368.50,377,$655.50
2025-06-17,18:25:00,21713.5,SELL,3,0.02h,Stop Loss,$31.50,$687.00,$244400.00,377,$687.00
2025-06-17,18:32:00,21955.5,BUY,3,0.02h,Break Even,$-1.50,$685.50,$244398.50,377,$685.50
2025-06-17,18:53:00,21713.25,SELL,3,0.02h,Stop Loss,$-9.00,$676.50,$244389.50,377,$676.50
2025-06-17,18:57:00,21962.75,BUY,3,0.02h,Stop Loss,$-9.00,$667.50,$244380.50,377,$667.50
2025-06-17,18:58:00,21743.75,SELL,3,0.02h,Stop Loss,$-9.00,$658.50,$244371.50,377,$658.50
2025-06-17,18:59:00,21974.0,BUY,3,0.02h,Stop Loss,$-9.00,$649.50,$244362.50,377,$649.50
2025-06-17,19:00:00,21751.0,SELL,3,0.02h,Stop Loss,$-9.00,$640.50,$244353.50,377,$640.50
2025-06-17,19:01:00,21973.5,BUY,3,0.02h,Stop Loss,$-9.00,$631.50,$244344.50,377,$631.50
2025-06-17,19:02:00,21742.5,SELL,3,0.02h,Stop Loss,$-9.00,$622.50,$244335.50,377,$622.50
2025-06-17,19:03:00,21973.25,BUY,3,0.02h,Stop Loss,$-9.00,$613.50,$244326.50,377,$613.50
2025-06-17,19:04:00,21734.75,SELL,3,0.02h,Stop Loss,$-9.00,$604.50,$244317.50,377,$604.50
2025-06-17,19:05:00,21956.0,BUY,3,0.02h,Stop Loss,$-9.00,$595.50,$244308.50,377,$595.50
2025-06-17,19:11:00,21729.75,SELL,3,0.02h,Stop Loss,$-9.00,$586.50,$244299.50,377,$586.50
2025-06-17,19:12:00,21970.0,BUY,3,0.02h,Stop Loss,$-9.00,$577.50,$244290.50,377,$577.50
2025-06-17,19:13:00,21748.75,SELL,3,0.02h,Stop Loss,$22.50,$600.00,$244313.00,377,$600.00
2025-06-17,19:16:00,21974.75,BUY,3,0.02h,Break Even,$-1.50,$598.50,$244311.50,377,$598.50
2025-06-17,19:18:00,21735.25,SELL,3,0.02h,Stop Loss,$-9.00,$589.50,$244302.50,377,$589.50
2025-06-17,19:21:00,21983.0,BUY,3,0.02h,Stop Loss,$-9.00,$580.50,$244293.50,377,$580.50
2025-06-17,19:22:00,21756.25,SELL,3,0.02h,Stop Loss,$-9.00,$571.50,$244284.50,377,$571.50
2025-06-17,19:23:00,21986.5,BUY,3,0.02h,Stop Loss,$-9.00,$562.50,$244275.50,377,$562.50
2025-06-17,19:24:00,21757.5,SELL,3,0.02h,Break Even,$-1.50,$561.00,$244274.00,377,$561.00
2025-06-17,19:26:00,21986.25,BUY,3,0.02h,Stop Loss,$-9.00,$552.00,$244265.00,377,$552.00
2025-06-17,19:27:00,21760.0,SELL,3,0.02h,Stop Loss,$-9.00,$543.00,$244256.00,377,$543.00
2025-06-17,19:28:00,21982.25,BUY,3,0.02h,Stop Loss,$-9.00,$534.00,$244247.00,377,$534.00
2025-06-17,19:29:00,21757.0,SELL,3,0.02h,Stop Loss,$-9.00,$525.00,$244238.00,377,$525.00
2025-06-17,19:31:00,21987.0,BUY,3,0.02h,Stop Loss,$-9.00,$516.00,$244229.00,377,$516.00
2025-06-17,19:32:00,21751.5,SELL,3,0.02h,Stop Loss,$-9.00,$507.00,$244220.00,377,$507.00
2025-06-17,19:39:00,21987.25,BUY,3,0.02h,Break Even,$-1.50,$505.50,$244218.50,377,$505.50
2025-06-17,19:44:00,21749.25,SELL,3,0.02h,Stop Loss,$12.00,$517.50,$244230.50,377,$517.50
2025-06-17,19:46:00,21986.5,BUY,3,0.02h,Break Even,$-1.50,$516.00,$244229.00,377,$516.00
2025-06-17,19:53:00,21747.75,SELL,3,0.02h,Stop Loss,$15.00,$531.00,$244244.00,377,$531.00
2025-06-17,19:59:00,21954.0,BUY,3,0.02h,Stop Loss,$-9.00,$522.00,$244235.00,377,$522.00
2025-06-17,20:00:00,21730.5,SELL,3,0.02h,Stop Loss,$27.00,$549.00,$244262.00,377,$549.00
2025-06-17,20:03:00,21965.75,BUY,3,0.02h,Break Even,$-1.50,$547.50,$244260.50,377,$547.50
2025-06-17,20:06:00,21735.5,SELL,3,0.02h,Stop Loss,$-9.00,$538.50,$244251.50,377,$538.50
2025-06-17,20:07:00,21963.0,BUY,3,0.02h,Break Even,$-1.50,$537.00,$244250.00,377,$537.00
2025-06-17,20:21:00,21721.75,SELL,3,0.02h,Stop Loss,$-9.00,$528.00,$244241.00,377,$528.00
2025-06-17,20:22:00,21949.5,BUY,3,0.02h,Stop Loss,$-9.00,$519.00,$244232.00,377,$519.00
2025-06-17,20:25:00,21726.25,SELL,3,0.02h,Stop Loss,$-9.00,$510.00,$244223.00,377,$510.00
2025-06-17,20:43:00,21960.0,BUY,3,0.02h,Break Even,$-1.50,$508.50,$244221.50,377,$508.50
2025-06-17,20:53:00,21715.0,SELL,3,0.02h,Break Even,$-1.50,$507.00,$244220.00,377,$507.00
2025-06-17,20:57:00,21957.0,BUY,3,0.02h,Stop Loss,$-9.00,$498.00,$244211.00,377,$498.00
2025-06-17,20:59:00,21731.25,SELL,3,0.02h,Stop Loss,$-9.00,$489.00,$244202.00,377,$489.00
2025-06-17,21:00:00,21953.25,BUY,3,1.02h,Stop Loss,$-9.00,$480.00,$244193.00,377,$480.00
2025-06-17,22:01:00,21712.5,SELL,3,0.02h,Stop Loss,$64.50,$544.50,$244257.50,377,$544.50
2025-06-17,22:07:00,21911.25,BUY,3,0.02h,Break Even,$-1.50,$543.00,$244256.00,377,$543.00
2025-06-17,22:10:00,21702.75,SELL,3,0.02h,Stop Loss,$51.00,$594.00,$244307.00,377,$594.00
2025-06-17,22:13:00,21920.0,BUY,3,0.02h,Stop Loss,$-9.00,$585.00,$244298.00,377,$585.00
2025-06-17,22:14:00,21689.75,SELL,3,0.02h,Stop Loss,$-9.00,$576.00,$244289.00,377,$576.00
2025-06-17,22:15:00,21919.5,BUY,3,0.02h,Break Even,$-1.50,$574.50,$244287.50,377,$574.50
2025-06-17,22:22:00,21685.75,SELL,3,0.02h,Break Even,$-1.50,$573.00,$244286.00,377,$573.00
2025-06-17,22:38:00,21896.5,BUY,3,0.02h,Break Even,$-1.50,$571.50,$244284.50,377,$571.50
2025-06-17,22:43:00,21660.5,SELL,3,0.02h,Break Even,$-1.50,$570.00,$244283.00,377,$570.00
2025-06-17,22:47:00,21887.0,BUY,3,0.02h,Stop Loss,$-9.00,$561.00,$244274.00,377,$561.00
2025-06-17,22:48:00,21660.25,SELL,3,0.02h,Stop Loss,$49.50,$610.50,$244323.50,377,$610.50
2025-06-17,22:50:00,21886.0,BUY,3,0.02h,Stop Loss,$-9.00,$601.50,$244314.50,377,$601.50
2025-06-17,22:51:00,21662.25,SELL,3,0.02h,Stop Loss,$-9.00,$592.50,$244305.50,377,$592.50
2025-06-17,22:52:00,21882.75,BUY,3,0.02h,Break Even,$-1.50,$591.00,$244304.00,377,$591.00
2025-06-17,22:59:00,21646.25,SELL,3,0.02h,Break Even,$-1.50,$589.50,$244302.50,377,$589.50
,,,,,,,,,,,
2025-06-18,12:02:00,22004.0,BUY,3,0.02h,Stop Loss,$-9.00,$-9.00,$244293.50,378,$-9.00
2025-06-18,12:22:00,21784.5,SELL,3,0.02h,Break Even,$-1.50,$-10.50,$244292.00,378,$-10.50
2025-06-18,12:29:00,22001.0,BUY,3,0.02h,Stop Loss,$-9.00,$-19.50,$244283.00,378,$-19.50
2025-06-18,12:30:00,21779.75,SELL,3,0.02h,Stop Loss,$52.50,$33.00,$244335.50,378,$33.00
2025-06-18,12:37:00,22004.75,BUY,3,0.02h,Break Even,$-1.50,$31.50,$244334.00,378,$31.50
2025-06-18,12:44:00,21765.5,SELL,3,0.02h,Break Even,$-1.50,$30.00,$244332.50,378,$30.00
2025-06-18,12:47:00,21992.0,BUY,3,0.02h,Stop Loss,$-9.00,$21.00,$244323.50,378,$21.00
2025-06-18,12:58:00,21769.0,SELL,3,0.02h,Stop Loss,$-9.00,$12.00,$244314.50,378,$12.00
2025-06-18,12:59:00,21988.5,BUY,3,0.02h,Stop Loss,$-9.00,$3.00,$244305.50,378,$3.00
2025-06-18,13:00:00,21763.0,SELL,3,0.02h,Break Even,$-1.50,$1.50,$244304.00,378,$1.50
2025-06-18,13:05:00,21999.25,BUY,3,0.02h,Stop Loss,$-9.00,$-7.50,$244295.00,378,$-7.50
2025-06-18,13:06:00,21778.0,SELL,3,0.02h,Break Even,$-1.50,$-9.00,$244293.50,378,$-9.00
2025-06-18,13:12:00,22008.25,BUY,3,0.02h,Stop Loss,$-9.00,$-18.00,$244284.50,378,$-18.00
2025-06-18,13:16:00,21776.25,SELL,3,0.02h,Stop Loss,$-9.00,$-27.00,$244275.50,378,$-27.00
2025-06-18,13:21:00,22010.0,BUY,3,0.02h,Stop Loss,$-9.00,$-36.00,$244266.50,378,$-36.00
2025-06-18,13:22:00,21789.5,SELL,3,0.02h,Stop Loss,$-9.00,$-45.00,$244257.50,378,$-45.00
2025-06-18,13:23:00,22008.25,BUY,3,0.02h,Stop Loss,$-9.00,$-54.00,$244248.50,378,$-54.00
2025-06-18,13:25:00,21784.75,SELL,3,0.02h,Stop Loss,$-9.00,$-63.00,$244239.50,378,$-63.00
2025-06-18,13:26:00,22006.0,BUY,3,0.02h,Stop Loss,$-9.00,$-72.00,$244230.50,378,$-72.00
2025-06-18,13:28:00,21781.75,SELL,3,0.02h,Stop Loss,$37.50,$-34.50,$244268.00,378,$-34.50
2025-06-18,13:33:00,21947.5,BUY,3,0.02h,Break Even,$-1.50,$-36.00,$244266.50,378,$-36.00
2025-06-18,13:38:00,21729.75,SELL,3,0.02h,Stop Loss,$-9.00,$-45.00,$244257.50,378,$-45.00
2025-06-18,13:39:00,21957.0,BUY,3,0.02h,Stop Loss,$-9.00,$-54.00,$244248.50,378,$-54.00
2025-06-18,13:40:00,21739.5,SELL,3,0.02h,Stop Loss,$13.50,$-40.50,$244262.00,378,$-40.50
2025-06-18,13:42:00,21975.25,BUY,3,0.02h,Stop Loss,$-9.00,$-49.50,$244253.00,378,$-49.50
2025-06-18,13:43:00,21745.25,SELL,3,0.02h,Break Even,$-1.50,$-51.00,$244251.50,378,$-51.00
2025-06-18,13:51:00,22009.5,BUY,3,0.02h,Stop Loss,$16.50,$-34.50,$244268.00,378,$-34.50
2025-06-18,13:59:00,21784.25,SELL,3,0.02h,Stop Loss,$-9.00,$-43.50,$244259.00,378,$-43.50
2025-06-18,14:00:00,22001.25,BUY,3,0.02h,Stop Loss,$18.00,$-25.50,$244277.00,378,$-25.50
2025-06-18,14:26:00,21843.5,SELL,3,0.02h,Stop Loss,$-9.00,$-34.50,$244268.00,378,$-34.50
2025-06-18,14:27:00,22076.5,BUY,3,0.02h,Stop Loss,$10.50,$-24.00,$244278.50,378,$-24.00
2025-06-18,14:36:00,21867.75,SELL,3,0.02h,Stop Loss,$-9.00,$-33.00,$244269.50,378,$-33.00
2025-06-18,14:37:00,22085.5,BUY,3,0.02h,Break Even,$-1.50,$-34.50,$244268.00,378,$-34.50
2025-06-18,14:41:00,21846.75,SELL,3,0.02h,Stop Loss,$16.50,$-18.00,$244284.50,378,$-18.00
2025-06-18,14:48:00,22086.25,BUY,3,0.02h,Stop Loss,$-9.00,$-27.00,$244275.50,378,$-27.00
2025-06-18,14:54:00,21836.0,SELL,3,0.02h,Stop Loss,$-9.00,$-36.00,$244266.50,378,$-36.00
2025-06-18,15:03:00,22076.25,BUY,3,0.02h,Stop Loss,$-9.00,$-45.00,$244257.50,378,$-45.00
2025-06-18,15:04:00,21852.75,SELL,3,0.02h,Stop Loss,$-9.00,$-54.00,$244248.50,378,$-54.00
2025-06-18,15:05:00,22082.0,BUY,3,0.02h,Stop Loss,$-9.00,$-63.00,$244239.50,378,$-63.00
2025-06-18,15:08:00,21842.75,SELL,3,0.02h,Stop Loss,$7.50,$-55.50,$244247.00,378,$-55.50
2025-06-18,15:13:00,22062.25,BUY,3,0.02h,Break Even,$-1.50,$-57.00,$244245.50,378,$-57.00
2025-06-18,15:15:00,21834.75,SELL,3,0.02h,Stop Loss,$-9.00,$-66.00,$244236.50,378,$-66.00
2025-06-18,15:16:00,22055.0,BUY,3,0.02h,Stop Loss,$9.00,$-57.00,$244245.50,378,$-57.00
2025-06-18,15:18:00,21835.25,SELL,3,0.02h,Stop Loss,$-9.00,$-66.00,$244236.50,378,$-66.00
2025-06-18,15:19:00,22060.25,BUY,3,0.02h,Stop Loss,$-9.00,$-75.00,$244227.50,378,$-75.00
2025-06-18,15:23:00,21831.5,SELL,3,0.02h,Stop Loss,$-9.00,$-84.00,$244218.50,378,$-84.00
2025-06-18,15:24:00,22054.5,BUY,3,0.02h,Stop Loss,$-9.00,$-93.00,$244209.50,378,$-93.00
2025-06-18,15:25:00,21828.0,SELL,3,0.02h,Stop Loss,$18.00,$-75.00,$244227.50,378,$-75.00
2025-06-18,15:29:00,22048.5,BUY,3,0.02h,Break Even,$-1.50,$-76.50,$244226.00,378,$-76.50
2025-06-18,15:32:00,21839.5,SELL,3,0.02h,Stop Loss,$-9.00,$-85.50,$244217.00,378,$-85.50
2025-06-18,15:33:00,22053.75,BUY,3,0.02h,Stop Loss,$-9.00,$-94.50,$244208.00,378,$-94.50
2025-06-18,15:34:00,21827.5,SELL,3,0.02h,Stop Loss,$-9.00,$-103.50,$244199.00,378,$-103.50
2025-06-18,15:40:00,22062.25,BUY,3,0.02h,Stop Loss,$4.50,$-99.00,$244203.50,378,$-99.00
2025-06-18,15:50:00,21833.5,SELL,3,0.02h,Stop Loss,$-9.00,$-108.00,$244194.50,378,$-108.00
2025-06-18,15:52:00,22068.5,BUY,3,0.02h,Stop Loss,$13.50,$-94.50,$244208.00,378,$-94.50
2025-06-18,15:55:00,21851.25,SELL,3,0.02h,Stop Loss,$-9.00,$-103.50,$244199.00,378,$-103.50
2025-06-18,15:56:00,22070.75,BUY,3,0.02h,Break Even,$-1.50,$-105.00,$244197.50,378,$-105.00
2025-06-18,15:58:00,21826.75,SELL,3,0.02h,Stop Loss,$-9.00,$-114.00,$244188.50,378,$-114.00
2025-06-18,16:03:00,22048.5,BUY,3,0.02h,Stop Loss,$24.00,$-90.00,$244212.50,378,$-90.00
2025-06-18,16:05:00,21830.75,SELL,3,0.02h,Stop Loss,$-9.00,$-99.00,$244203.50,378,$-99.00
2025-06-18,16:07:00,22046.75,BUY,3,0.02h,Stop Loss,$6.00,$-93.00,$244209.50,378,$-93.00
2025-06-18,16:09:00,21836.75,SELL,3,0.02h,Break Even,$-1.50,$-94.50,$244208.00,378,$-94.50
2025-06-18,16:16:00,22056.0,BUY,3,0.02h,Stop Loss,$-9.00,$-103.50,$244199.00,378,$-103.50
2025-06-18,16:18:00,21820.25,SELL,3,0.02h,Stop Loss,$-9.00,$-112.50,$244190.00,378,$-112.50
2025-06-18,16:23:00,22046.5,BUY,3,0.02h,Break Even,$-1.50,$-114.00,$244188.50,378,$-114.00
2025-06-18,16:27:00,21818.25,SELL,3,0.02h,Stop Loss,$19.50,$-94.50,$244208.00,378,$-94.50
2025-06-18,16:38:00,22037.25,BUY,3,0.02h,Stop Loss,$-9.00,$-103.50,$244199.00,378,$-103.50
2025-06-18,16:44:00,21814.25,SELL,3,0.02h,Break Even,$-1.50,$-105.00,$244197.50,378,$-105.00
2025-06-18,16:52:00,22047.5,BUY,3,0.02h,Stop Loss,$-9.00,$-114.00,$244188.50,378,$-114.00
2025-06-18,16:56:00,21809.0,SELL,3,0.02h,Stop Loss,$-9.00,$-123.00,$244179.50,378,$-123.00
2025-06-18,16:57:00,22033.25,BUY,3,0.02h,Break Even,$-1.50,$-124.50,$244178.00,378,$-124.50
2025-06-18,16:59:00,21814.75,SELL,3,0.02h,Stop Loss,$49.50,$-75.00,$244227.50,378,$-75.00
2025-06-18,17:05:00,22030.5,BUY,3,0.02h,Stop Loss,$-9.00,$-84.00,$244218.50,378,$-84.00
2025-06-18,17:06:00,21804.75,SELL,3,0.02h,Stop Loss,$13.50,$-70.50,$244232.00,378,$-70.50
2025-06-18,17:10:00,22032.0,BUY,3,0.02h,Stop Loss,$19.50,$-51.00,$244251.50,378,$-51.00
2025-06-18,17:13:00,21808.75,SELL,3,0.02h,Stop Loss,$-9.00,$-60.00,$244242.50,378,$-60.00
2025-06-18,17:14:00,22023.5,BUY,3,0.02h,Stop Loss,$-9.00,$-69.00,$244233.50,378,$-69.00
2025-06-18,17:15:00,21803.75,SELL,3,0.02h,Stop Loss,$-9.00,$-78.00,$244224.50,378,$-78.00
2025-06-18,17:16:00,22031.75,BUY,3,0.02h,Stop Loss,$-9.00,$-87.00,$244215.50,378,$-87.00
2025-06-18,17:18:00,21798.75,SELL,3,0.02h,Stop Loss,$-9.00,$-96.00,$244206.50,378,$-96.00
2025-06-18,17:22:00,22002.5,BUY,3,0.02h,Stop Loss,$-9.00,$-105.00,$244197.50,378,$-105.00
2025-06-18,17:23:00,21773.75,SELL,3,0.02h,Stop Loss,$-9.00,$-114.00,$244188.50,378,$-114.00
2025-06-18,17:24:00,21994.0,BUY,3,0.02h,Stop Loss,$-9.00,$-123.00,$244179.50,378,$-123.00
2025-06-18,17:25:00,21772.25,SELL,3,0.02h,Stop Loss,$6.00,$-117.00,$244185.50,378,$-117.00
2025-06-18,17:36:00,21949.0,BUY,3,0.02h,Stop Loss,$64.50,$-52.50,$244250.00,378,$-52.50
2025-06-18,17:38:00,21745.0,SELL,3,0.02h,Stop Loss,$-9.00,$-61.50,$244241.00,378,$-61.50
2025-06-18,17:39:00,21976.25,BUY,3,0.02h,Stop Loss,$3.00,$-58.50,$244244.00,378,$-58.50
2025-06-18,17:54:00,21804.25,SELL,3,0.02h,Stop Loss,$-9.00,$-67.50,$244235.00,378,$-67.50
2025-06-18,17:55:00,22031.5,BUY,3,0.02h,Stop Loss,$-9.00,$-76.50,$244226.00,378,$-76.50
2025-06-18,17:56:00,21805.25,SELL,3,0.02h,Stop Loss,$-9.00,$-85.50,$244217.00,378,$-85.50
2025-06-18,18:02:00,22042.75,BUY,3,0.02h,Stop Loss,$-9.00,$-94.50,$244208.00,378,$-94.50
2025-06-18,18:03:00,21775.75,SELL,3,0.02h,Stop Loss,$-9.00,$-103.50,$244199.00,378,$-103.50
2025-06-18,18:04:00,22011.25,BUY,3,0.02h,Stop Loss,$45.00,$-58.50,$244244.00,378,$-58.50
2025-06-18,18:07:00,21775.0,SELL,3,0.02h,Stop Loss,$39.00,$-19.50,$244283.00,378,$-19.50
2025-06-18,18:12:00,22011.75,BUY,3,0.02h,Stop Loss,$13.50,$-6.00,$244296.50,378,$-6.00
2025-06-18,18:14:00,21780.5,SELL,3,0.02h,Stop Loss,$12.00,$6.00,$244308.50,378,$6.00
2025-06-18,18:33:00,22038.75,BUY,3,0.02h,Stop Loss,$46.50,$52.50,$244355.00,378,$52.50
2025-06-18,18:50:00,21792.75,SELL,3,0.02h,Stop Loss,$-9.00,$43.50,$244346.00,378,$43.50
2025-06-18,18:51:00,22008.5,BUY,3,0.02h,Stop Loss,$-9.00,$34.50,$244337.00,378,$34.50
2025-06-18,18:52:00,21781.25,SELL,3,0.02h,Stop Loss,$-9.00,$25.50,$244328.00,378,$25.50
2025-06-18,18:53:00,21995.25,BUY,3,0.02h,Stop Loss,$-9.00,$16.50,$244319.00,378,$16.50
2025-06-18,18:55:00,21752.5,SELL,3,0.02h,Stop Loss,$144.00,$160.50,$244463.00,378,$160.50
2025-06-18,19:06:00,21954.75,BUY,3,0.02h,Stop Loss,$61.50,$222.00,$244524.50,378,$222.00
2025-06-18,19:08:00,21718.5,SELL,3,0.02h,Stop Loss,$-9.00,$213.00,$244515.50,378,$213.00
2025-06-18,19:09:00,21932.5,BUY,3,0.02h,Stop Loss,$-9.00,$204.00,$244506.50,378,$204.00
2025-06-18,19:10:00,21709.25,SELL,3,0.02h,Stop Loss,$-9.00,$195.00,$244497.50,378,$195.00
2025-06-18,19:11:00,21939.5,BUY,3,0.02h,Stop Loss,$-9.00,$186.00,$244488.50,378,$186.00
2025-06-18,19:12:00,21723.25,SELL,3,0.02h,Stop Loss,$-9.00,$177.00,$244479.50,378,$177.00
2025-06-18,19:13:00,21927.5,BUY,3,0.02h,Stop Loss,$324.00,$501.00,$244803.50,378,$501.00
2025-06-18,19:22:00,21773.5,SELL,3,0.02h,Stop Loss,$-9.00,$492.00,$244794.50,378,$492.00
2025-06-18,19:23:00,22005.0,BUY,3,0.02h,Stop Loss,$27.00,$519.00,$244821.50,378,$519.00
2025-06-18,19:27:00,21750.0,SELL,3,0.02h,Stop Loss,$-9.00,$510.00,$244812.50,378,$510.00
2025-06-18,19:28:00,21952.5,BUY,3,0.02h,Stop Loss,$-9.00,$501.00,$244803.50,378,$501.00
2025-06-18,19:31:00,21713.25,SELL,3,0.02h,Stop Loss,$-9.00,$492.00,$244794.50,378,$492.00
2025-06-18,19:33:00,21957.0,BUY,3,0.02h,Stop Loss,$36.00,$528.00,$244830.50,378,$528.00
2025-06-18,19:36:00,21748.25,SELL,3,0.02h,Stop Loss,$-9.00,$519.00,$244821.50,378,$519.00
2025-06-18,19:37:00,21978.25,BUY,3,0.02h,Stop Loss,$-9.00,$510.00,$244812.50,378,$510.00
2025-06-18,19:38:00,21758.25,SELL,3,0.02h,Stop Loss,$58.50,$568.50,$244871.00,378,$568.50
2025-06-18,19:42:00,21991.5,BUY,3,0.02h,Stop Loss,$-9.00,$559.50,$244862.00,378,$559.50
2025-06-18,19:43:00,21757.25,SELL,3,0.02h,Stop Loss,$-9.00,$550.50,$244853.00,378,$550.50
2025-06-18,19:44:00,21999.0,BUY,3,0.02h,Stop Loss,$-9.00,$541.50,$244844.00,378,$541.50
2025-06-18,19:45:00,21777.25,SELL,3,0.02h,Stop Loss,$102.00,$643.50,$244946.00,378,$643.50
2025-06-18,19:55:00,21949.25,BUY,3,0.02h,Stop Loss,$82.50,$726.00,$245028.50,378,$726.00
2025-06-18,19:58:00,21721.75,SELL,3,0.02h,Stop Loss,$-9.00,$717.00,$245019.50,378,$717.00
2025-06-18,19:59:00,21943.75,BUY,3,0.02h,Stop Loss,$28.50,$745.50,$245048.00,378,$745.50
2025-06-18,20:06:00,21731.5,SELL,3,0.02h,Stop Loss,$-9.00,$736.50,$245039.00,378,$736.50
2025-06-18,20:07:00,21951.75,BUY,3,0.02h,Stop Loss,$28.50,$765.00,$245067.50,378,$765.00
2025-06-18,20:16:00,21738.75,SELL,3,0.02h,Stop Loss,$-9.00,$756.00,$245058.50,378,$756.00
2025-06-18,20:29:00,21954.25,BUY,3,0.02h,Stop Loss,$21.00,$777.00,$245079.50,378,$777.00
2025-06-18,20:45:00,21742.25,SELL,3,0.02h,Stop Loss,$-9.00,$768.00,$245070.50,378,$768.00
2025-06-18,20:46:00,21963.25,BUY,3,0.02h,Break Even,$-1.50,$766.50,$245069.00,378,$766.50
2025-06-18,20:49:00,21739.25,SELL,3,0.02h,Stop Loss,$-9.00,$757.50,$245060.00,378,$757.50
2025-06-18,20:55:00,21974.25,BUY,3,0.02h,Stop Loss,$-9.00,$748.50,$245051.00,378,$748.50
2025-06-18,20:56:00,21748.0,SELL,3,0.02h,Stop Loss,$-9.00,$739.50,$245042.00,378,$739.50
2025-06-18,22:12:00,21932.0,BUY,3,0.02h,Break Even,$-1.50,$738.00,$245040.50,378,$738.00
2025-06-18,22:14:00,21703.0,SELL,3,0.02h,Stop Loss,$-9.00,$729.00,$245031.50,378,$729.00
2025-06-18,22:15:00,21929.75,BUY,3,0.02h,Stop Loss,$-9.00,$720.00,$245022.50,378,$720.00
2025-06-18,22:17:00,21701.5,SELL,3,0.02h,Stop Loss,$-9.00,$711.00,$245013.50,378,$711.00
2025-06-18,22:18:00,21925.75,BUY,3,0.02h,Stop Loss,$-9.00,$702.00,$245004.50,378,$702.00
2025-06-18,22:19:00,21706.0,SELL,3,0.02h,Break Even,$-1.50,$700.50,$245003.00,378,$700.50
2025-06-18,22:23:00,21927.5,BUY,3,0.02h,Stop Loss,$33.00,$733.50,$245036.00,378,$733.50
2025-06-18,22:29:00,21712.0,SELL,3,0.02h,Stop Loss,$-9.00,$724.50,$245027.00,378,$724.50
2025-06-18,22:30:00,21932.25,BUY,3,0.02h,Break Even,$-1.50,$723.00,$245025.50,378,$723.00
2025-06-18,22:33:00,21695.25,SELL,3,0.02h,Stop Loss,$-9.00,$714.00,$245016.50,378,$714.00
2025-06-18,22:34:00,21918.25,BUY,3,0.02h,Break Even,$-1.50,$712.50,$245015.00,378,$712.50
2025-06-18,22:36:00,21687.75,SELL,3,0.02h,Stop Loss,$-9.00,$703.50,$245006.00,378,$703.50
2025-06-18,22:48:00,21921.25,BUY,3,0.02h,Stop Loss,$-9.00,$694.50,$244997.00,378,$694.50
2025-06-18,22:52:00,21700.0,SELL,3,0.02h,Stop Loss,$-9.00,$685.50,$244988.00,378,$685.50
2025-06-18,22:54:00,21930.5,BUY,3,0.02h,Stop Loss,$13.50,$699.00,$245001.50,378,$699.00
2025-06-18,22:59:00,21707.0,SELL,3,0.02h,Stop Loss,$-9.00,$690.00,$244992.50,378,$690.00
,,,,,,,,,,,
2025-06-19,12:22:00,21805.5,BUY,3,0.02h,Stop Loss,$-9.00,$-9.00,$244983.50,379,$-9.00
2025-06-19,12:25:00,21595.75,SELL,3,0.02h,Stop Loss,$24.00,$15.00,$245007.50,379,$15.00
2025-06-19,12:31:00,21806.0,BUY,3,0.02h,Stop Loss,$21.00,$36.00,$245028.50,379,$36.00
2025-06-19,12:35:00,21575.25,SELL,3,0.02h,Stop Loss,$9.00,$45.00,$245037.50,379,$45.00
2025-06-19,12:37:00,21795.0,BUY,3,0.02h,Stop Loss,$-9.00,$36.00,$245028.50,379,$36.00
2025-06-19,12:38:00,21580.0,SELL,3,0.02h,Break Even,$-1.50,$34.50,$245027.00,379,$34.50
2025-06-19,12:40:00,21793.75,BUY,3,0.02h,Stop Loss,$-9.00,$25.50,$245018.00,379,$25.50
2025-06-19,12:41:00,21577.5,SELL,3,0.02h,Stop Loss,$-9.00,$16.50,$245009.00,379,$16.50
2025-06-19,12:42:00,21792.25,BUY,3,0.02h,Stop Loss,$-9.00,$7.50,$245000.00,379,$7.50
2025-06-19,12:43:00,21571.75,SELL,3,0.02h,Stop Loss,$75.00,$82.50,$245075.00,379,$82.50
2025-06-19,12:56:00,21757.0,BUY,3,0.02h,Stop Loss,$-9.00,$73.50,$245066.00,379,$73.50
2025-06-19,13:08:00,21541.25,SELL,3,0.02h,Stop Loss,$22.50,$96.00,$245088.50,379,$96.00
2025-06-19,13:11:00,21762.75,BUY,3,0.02h,Stop Loss,$-9.00,$87.00,$245079.50,379,$87.00
2025-06-19,13:12:00,21547.0,SELL,3,0.02h,Stop Loss,$13.50,$100.50,$245093.00,379,$100.50
2025-06-19,13:15:00,21770.0,BUY,3,0.02h,Break Even,$-1.50,$99.00,$245091.50,379,$99.00
2025-06-19,13:20:00,21555.75,SELL,3,0.02h,Stop Loss,$10.50,$109.50,$245102.00,379,$109.50
2025-06-19,13:22:00,21768.75,BUY,3,0.02h,Break Even,$-1.50,$108.00,$245100.50,379,$108.00
2025-06-19,13:27:00,21563.0,SELL,3,0.02h,Stop Loss,$-9.00,$99.00,$245091.50,379,$99.00
2025-06-19,13:28:00,21781.0,BUY,3,0.02h,Break Even,$-1.50,$97.50,$245090.00,379,$97.50
2025-06-19,13:31:00,21557.25,SELL,3,0.02h,Stop Loss,$19.50,$117.00,$245109.50,379,$117.00
2025-06-19,13:35:00,21755.5,BUY,3,0.02h,Stop Loss,$-9.00,$108.00,$245100.50,379,$108.00
2025-06-19,13:36:00,21532.5,SELL,3,0.02h,Stop Loss,$9.00,$117.00,$245109.50,379,$117.00
2025-06-19,13:43:00,21723.5,BUY,3,0.02h,Stop Loss,$-9.00,$108.00,$245100.50,379,$108.00
2025-06-19,13:44:00,21509.5,SELL,3,0.02h,Break Even,$-1.50,$106.50,$245099.00,379,$106.50
2025-06-19,13:47:00,21708.0,BUY,3,0.02h,Stop Loss,$-9.00,$97.50,$245090.00,379,$97.50
2025-06-19,13:49:00,21438.75,SELL,3,0.02h,Stop Loss,$-9.00,$88.50,$245081.00,379,$88.50
2025-06-19,13:51:00,21685.0,BUY,3,0.02h,Stop Loss,$-9.00,$79.50,$245072.00,379,$79.50
2025-06-19,13:53:00,21465.75,SELL,3,0.02h,Stop Loss,$-9.00,$70.50,$245063.00,379,$70.50
2025-06-19,13:56:00,21695.25,BUY,3,0.02h,Stop Loss,$16.50,$87.00,$245079.50,379,$87.00
2025-06-19,14:01:00,21477.0,SELL,3,0.02h,Stop Loss,$-9.00,$78.00,$245070.50,379,$78.00
2025-06-19,14:02:00,21677.25,BUY,3,0.02h,Stop Loss,$45.00,$123.00,$245115.50,379,$123.00
2025-06-19,14:04:00,21467.25,SELL,3,0.02h,Stop Loss,$-9.00,$114.00,$245106.50,379,$114.00
2025-06-19,14:12:00,21707.75,BUY,3,0.02h,Stop Loss,$22.50,$136.50,$245129.00,379,$136.50
2025-06-19,14:16:00,21496.25,SELL,3,0.02h,Stop Loss,$-9.00,$127.50,$245120.00,379,$127.50
2025-06-19,14:17:00,21711.75,BUY,3,0.02h,Stop Loss,$-9.00,$118.50,$245111.00,379,$118.50
2025-06-19,14:18:00,21496.75,SELL,3,0.02h,Stop Loss,$-9.00,$109.50,$245102.00,379,$109.50
2025-06-19,14:19:00,21710.75,BUY,3,0.02h,Stop Loss,$-9.00,$100.50,$245093.00,379,$100.50
2025-06-19,14:23:00,21500.5,SELL,3,0.02h,Stop Loss,$-9.00,$91.50,$245084.00,379,$91.50
2025-06-19,14:24:00,21717.25,BUY,3,0.02h,Break Even,$-1.50,$90.00,$245082.50,379,$90.00
2025-06-19,14:26:00,21502.5,SELL,3,0.02h,Stop Loss,$-9.00,$81.00,$245073.50,379,$81.00
2025-06-19,14:27:00,21720.5,BUY,3,0.02h,Stop Loss,$4.50,$85.50,$245078.00,379,$85.50
2025-06-19,14:31:00,21495.25,SELL,3,0.02h,Stop Loss,$-9.00,$76.50,$245069.00,379,$76.50
2025-06-19,14:32:00,21703.0,BUY,3,0.02h,Stop Loss,$-9.00,$67.50,$245060.00,379,$67.50
2025-06-19,14:33:00,21485.25,SELL,3,0.02h,Stop Loss,$-9.00,$58.50,$245051.00,379,$58.50
2025-06-19,14:34:00,21698.5,BUY,3,0.02h,Break Even,$-1.50,$57.00,$245049.50,379,$57.00
2025-06-19,14:38:00,21482.25,SELL,3,0.02h,Stop Loss,$-9.00,$48.00,$245040.50,379,$48.00
2025-06-19,14:39:00,21710.5,BUY,3,0.02h,Stop Loss,$16.50,$64.50,$245057.00,379,$64.50
2025-06-19,14:42:00,21490.5,SELL,3,0.02h,Stop Loss,$42.00,$106.50,$245099.00,379,$106.50
2025-06-19,14:45:00,21682.0,BUY,3,0.02h,Stop Loss,$84.00,$190.50,$245183.00,379,$190.50
2025-06-19,14:47:00,21484.0,SELL,3,0.02h,Stop Loss,$15.00,$205.50,$245198.00,379,$205.50
2025-06-19,14:50:00,21697.0,BUY,3,0.02h,Stop Loss,$-9.00,$196.50,$245189.00,379,$196.50
2025-06-19,14:51:00,21485.75,SELL,3,0.02h,Stop Loss,$-9.00,$187.50,$245180.00,379,$187.50
2025-06-19,14:53:00,21707.75,BUY,3,0.02h,Stop Loss,$3.00,$190.50,$245183.00,379,$190.50
2025-06-19,14:55:00,21499.5,SELL,3,0.02h,Stop Loss,$-9.00,$181.50,$245174.00,379,$181.50
2025-06-19,14:59:00,21723.5,BUY,3,0.02h,Stop Loss,$12.00,$193.50,$245186.00,379,$193.50
2025-06-19,15:03:00,21505.75,SELL,3,0.02h,Stop Loss,$12.00,$205.50,$245198.00,379,$205.50
2025-06-19,15:10:00,21702.25,BUY,3,0.02h,Stop Loss,$58.50,$264.00,$245256.50,379,$264.00
2025-06-19,15:20:00,21516.75,SELL,3,0.02h,Stop Loss,$-9.00,$255.00,$245247.50,379,$255.00
2025-06-19,15:21:00,21724.5,BUY,3,0.02h,Stop Loss,$-9.00,$246.00,$245238.50,379,$246.00
2025-06-19,15:22:00,21497.5,SELL,3,0.02h,Stop Loss,$-9.00,$237.00,$245229.50,379,$237.00
2025-06-19,15:24:00,21708.5,BUY,3,0.02h,Stop Loss,$-9.00,$228.00,$245220.50,379,$228.00
2025-06-19,15:25:00,21494.5,SELL,3,0.02h,Stop Loss,$-9.00,$219.00,$245211.50,379,$219.00
2025-06-19,15:27:00,21711.0,BUY,3,0.02h,Stop Loss,$-9.00,$210.00,$245202.50,379,$210.00
2025-06-19,15:30:00,21503.75,SELL,3,0.02h,Stop Loss,$-9.00,$201.00,$245193.50,379,$201.00
2025-06-19,15:31:00,21716.75,BUY,3,0.02h,Break Even,$-1.50,$199.50,$245192.00,379,$199.50
2025-06-19,15:33:00,21493.25,SELL,3,0.02h,Stop Loss,$-9.00,$190.50,$245183.00,379,$190.50
2025-06-19,15:44:00,21703.0,BUY,3,0.02h,Stop Loss,$48.00,$238.50,$245231.00,379,$238.50
2025-06-19,15:46:00,21499.75,SELL,3,0.02h,Stop Loss,$-9.00,$229.50,$245222.00,379,$229.50
2025-06-19,15:47:00,21716.75,BUY,3,0.02h,Stop Loss,$-9.00,$220.50,$245213.00,379,$220.50
2025-06-19,15:48:00,21505.5,SELL,3,0.02h,Stop Loss,$-9.00,$211.50,$245204.00,379,$211.50
2025-06-19,15:49:00,21715.75,BUY,3,0.02h,Stop Loss,$-9.00,$202.50,$245195.00,379,$202.50
2025-06-19,15:50:00,21498.75,SELL,3,0.02h,Stop Loss,$-9.00,$193.50,$245186.00,379,$193.50
2025-06-19,15:51:00,21715.25,BUY,3,0.02h,Stop Loss,$-9.00,$184.50,$245177.00,379,$184.50
2025-06-19,15:52:00,21484.75,SELL,3,0.02h,Stop Loss,$-9.00,$175.50,$245168.00,379,$175.50
2025-06-19,15:54:00,21692.25,BUY,3,0.02h,Stop Loss,$-9.00,$166.50,$245159.00,379,$166.50
2025-06-19,15:55:00,21479.0,SELL,3,0.02h,Stop Loss,$-9.00,$157.50,$245150.00,379,$157.50
2025-06-19,15:56:00,21699.5,BUY,3,0.02h,Break Even,$-1.50,$156.00,$245148.50,379,$156.00
2025-06-19,15:58:00,21480.5,SELL,3,0.02h,Stop Loss,$87.00,$243.00,$245235.50,379,$243.00
2025-06-19,16:01:00,21688.75,BUY,3,0.02h,Stop Loss,$-9.00,$234.00,$245226.50,379,$234.00
2025-06-19,16:02:00,21475.25,SELL,3,0.02h,Stop Loss,$-9.00,$225.00,$245217.50,379,$225.00
2025-06-19,16:04:00,21699.75,BUY,3,0.02h,Break Even,$-1.50,$223.50,$245216.00,379,$223.50
2025-06-19,16:08:00,21497.0,SELL,3,0.02h,Break Even,$-1.50,$222.00,$245214.50,379,$222.00
2025-06-19,16:13:00,21714.25,BUY,3,0.02h,Stop Loss,$-9.00,$213.00,$245205.50,379,$213.00
2025-06-19,16:14:00,21496.75,SELL,3,0.02h,Stop Loss,$3.00,$216.00,$245208.50,379,$216.00
2025-06-19,16:19:00,21718.25,BUY,3,0.02h,Stop Loss,$-9.00,$207.00,$245199.50,379,$207.00
2025-06-19,16:20:00,21500.5,SELL,3,0.02h,Stop Loss,$-9.00,$198.00,$245190.50,379,$198.00
2025-06-19,16:23:00,21724.75,BUY,3,0.02h,Break Even,$-1.50,$196.50,$245189.00,379,$196.50
2025-06-19,16:27:00,21512.25,SELL,3,0.02h,Stop Loss,$-9.00,$187.50,$245180.00,379,$187.50
2025-06-19,16:32:00,21735.25,BUY,3,0.02h,Stop Loss,$-9.00,$178.50,$245171.00,379,$178.50
2025-06-19,16:33:00,21514.5,SELL,3,0.02h,Stop Loss,$42.00,$220.50,$245213.00,379,$220.50
2025-06-19,16:36:00,21738.25,BUY,3,0.02h,Stop Loss,$-9.00,$211.50,$245204.00,379,$211.50
2025-06-19,16:37:00,21515.0,SELL,3,0.02h,Stop Loss,$-9.00,$202.50,$245195.00,379,$202.50
2025-06-19,16:41:00,21730.75,BUY,3,0.02h,Break Even,$-1.50,$201.00,$245193.50,379,$201.00
2025-06-19,16:50:00,21510.25,SELL,3,0.02h,Stop Loss,$49.50,$250.50,$245243.00,379,$250.50
2025-06-19,16:54:00,21719.25,BUY,3,0.02h,Break Even,$-1.50,$249.00,$245241.50,379,$249.00
2025-06-19,22:15:00,21607.25,SELL,3,0.02h,Stop Loss,$-9.00,$240.00,$245232.50,379,$240.00
2025-06-19,22:16:00,21831.5,BUY,3,0.02h,Stop Loss,$30.00,$270.00,$245262.50,379,$270.00
2025-06-19,22:31:00,21624.0,SELL,3,0.02h,Stop Loss,$-9.00,$261.00,$245253.50,379,$261.00
2025-06-19,22:34:00,21871.0,BUY,3,0.02h,Break Even,$-1.50,$259.50,$245252.00,379,$259.50
2025-06-19,22:42:00,21672.5,SELL,3,0.02h,Break Even,$-1.50,$258.00,$245250.50,379,$258.00
2025-06-19,22:44:00,21905.0,BUY,3,0.02h,Stop Loss,$-9.00,$249.00,$245241.50,379,$249.00
2025-06-19,22:45:00,21675.25,SELL,3,0.02h,Break Even,$-1.50,$247.50,$245240.00,379,$247.50
2025-06-19,22:47:00,21909.5,BUY,3,0.02h,Stop Loss,$-9.00,$238.50,$245231.00,379,$238.50
2025-06-19,22:48:00,21700.75,SELL,3,0.02h,Stop Loss,$21.00,$259.50,$245252.00,379,$259.50
2025-06-19,22:56:00,21898.5,BUY,3,0.02h,Stop Loss,$-9.00,$250.50,$245243.00,379,$250.50
2025-06-19,22:57:00,21677.25,SELL,3,0.02h,Stop Loss,$-9.00,$241.50,$245234.00,379,$241.50
2025-06-19,22:58:00,21896.25,BUY,3,0.02h,Break Even,$-1.50,$240.00,$245232.50,379,$240.00
,,,,,,,,,,,
2025-06-20,12:34:00,21769.25,SELL,3,0.02h,Stop Loss,$-9.00,$-9.00,$245223.50,380,$-9.00
2025-06-20,12:35:00,22015.0,BUY,3,0.02h,Stop Loss,$-9.00,$-18.00,$245214.50,380,$-18.00
2025-06-20,12:37:00,21777.0,SELL,3,0.02h,Stop Loss,$24.00,$6.00,$245238.50,380,$6.00
2025-06-20,12:42:00,22000.75,BUY,3,0.02h,Stop Loss,$40.50,$46.50,$245279.00,380,$46.50
2025-06-20,12:44:00,21789.0,SELL,3,0.02h,Stop Loss,$9.00,$55.50,$245288.00,380,$55.50
2025-06-20,12:49:00,22020.75,BUY,3,0.02h,Break Even,$-1.50,$54.00,$245286.50,380,$54.00
2025-06-20,12:52:00,21804.75,SELL,3,0.02h,Stop Loss,$15.00,$69.00,$245301.50,380,$69.00
2025-06-20,12:57:00,22032.5,BUY,3,0.02h,Stop Loss,$3.00,$72.00,$245304.50,380,$72.00
2025-06-20,13:11:00,21802.5,SELL,3,0.02h,Stop Loss,$-9.00,$63.00,$245295.50,380,$63.00
2025-06-20,13:21:00,22051.25,BUY,3,0.02h,Stop Loss,$-9.00,$54.00,$245286.50,380,$54.00
2025-06-20,13:22:00,21830.25,SELL,3,0.02h,Stop Loss,$-9.00,$45.00,$245277.50,380,$45.00
2025-06-20,13:23:00,22058.75,BUY,3,0.02h,Stop Loss,$-9.00,$36.00,$245268.50,380,$36.00
2025-06-20,13:25:00,21835.5,SELL,3,0.02h,Stop Loss,$105.00,$141.00,$245373.50,380,$141.00
2025-06-20,13:31:00,22086.5,BUY,3,0.02h,Stop Loss,$45.00,$186.00,$245418.50,380,$186.00
2025-06-20,13:56:00,22036.5,SELL,3,0.02h,Stop Loss,$18.00,$204.00,$245436.50,380,$204.00
2025-06-20,15:15:00,21853.25,BUY,3,0.02h,Break Even,$-1.50,$202.50,$245435.00,380,$202.50
2025-06-20,15:54:00,21868.5,SELL,3,0.02h,Stop Loss,$58.50,$261.00,$245493.50,380,$261.00
2025-06-20,16:13:00,21872.75,BUY,3,0.02h,Stop Loss,$-9.00,$252.00,$245484.50,380,$252.00
2025-06-20,16:15:00,21857.25,SELL,3,0.02h,Stop Loss,$34.50,$286.50,$245519.00,380,$286.50
2025-06-20,16:28:00,21872.25,BUY,3,0.02h,Break Even,$-1.50,$285.00,$245517.50,380,$285.00
2025-06-20,17:06:00,21855.75,SELL,3,0.02h,Stop Loss,$22.50,$307.50,$245540.00,380,$307.50
2025-06-20,17:15:00,21886.25,BUY,3,0.02h,Stop Loss,$160.50,$468.00,$245700.50,380,$468.00
2025-06-20,17:19:00,21863.25,SELL,3,0.02h,Stop Loss,$7.50,$475.50,$245708.00,380,$475.50
2025-06-20,17:53:00,21818.75,BUY,3,0.02h,Stop Loss,$27.00,$502.50,$245735.00,380,$502.50
2025-06-20,18:44:00,21865.75,SELL,3,0.02h,Stop Loss,$-9.00,$493.50,$245726.00,380,$493.50
2025-06-20,19:55:00,21820.75,BUY,3,0.02h,Stop Loss,$214.50,$708.00,$245940.50,380,$708.00
2025-06-20,20:23:00,21849.5,SELL,3,0.02h,Stop Loss,$-9.00,$699.00,$245931.50,380,$699.00
2025-06-20,20:27:00,21861.5,BUY,3,0.02h,Stop Loss,$-9.00,$690.00,$245922.50,380,$690.00
,,,,,,,,,,,
2025-06-23,12:00:00,21824.75,SELL,3,0.02h,Stop Loss,$-9.00,$-9.00,$245913.50,381,$-9.00
2025-06-23,12:27:00,21849.5,BUY,3,0.02h,Break Even,$-1.50,$-10.50,$245912.00,381,$-10.50
2025-06-23,12:30:00,21837.75,SELL,3,0.02h,Break Even,$-1.50,$-12.00,$245910.50,381,$-12.00
2025-06-23,12:33:00,21848.0,BUY,3,0.02h,Stop Loss,$24.00,$12.00,$245934.50,381,$12.00
2025-06-23,13:12:00,21861.5,SELL,3,0.02h,Break Even,$-1.50,$10.50,$245933.00,381,$10.50
2025-06-23,13:19:00,21883.5,BUY,3,0.02h,Stop Loss,$13.50,$24.00,$245946.50,381,$24.00
2025-06-23,13:28:00,21861.75,SELL,3,0.02h,Break Even,$-1.50,$22.50,$245945.00,381,$22.50
2025-06-23,13:44:00,21874.25,BUY,3,0.02h,Stop Loss,$31.50,$54.00,$245976.50,381,$54.00
2025-06-23,14:53:00,21980.5,SELL,3,0.02h,Stop Loss,$10.50,$64.50,$245987.00,381,$64.50
2025-06-23,15:07:00,21995.25,BUY,3,0.02h,Stop Loss,$19.50,$84.00,$246006.50,381,$84.00
2025-06-23,15:23:00,21977.75,SELL,3,0.02h,Stop Loss,$-9.00,$75.00,$245997.50,381,$75.00
2025-06-23,16:46:00,21902.25,BUY,3,0.02h,Stop Loss,$27.00,$102.00,$246024.50,381,$102.00
2025-06-23,16:59:00,21851.75,SELL,3,0.02h,Stop Loss,$61.50,$163.50,$246086.00,381,$163.50
2025-06-23,17:03:00,21883.5,BUY,3,0.02h,Stop Loss,$34.50,$198.00,$246120.50,381,$198.00
2025-06-23,18:26:00,22054.25,SELL,3,0.02h,Break Even,$-1.50,$196.50,$246119.00,381,$196.50
2025-06-23,19:02:00,22063.25,BUY,3,0.02h,Stop Loss,$16.50,$213.00,$246135.50,381,$213.00
2025-06-23,19:18:00,22029.0,SELL,3,0.02h,Break Even,$-1.50,$211.50,$246134.00,381,$211.50
2025-06-23,19:27:00,22053.5,BUY,3,0.02h,Stop Loss,$13.50,$225.00,$246147.50,381,$225.00
2025-06-23,19:42:00,22047.0,SELL,3,0.02h,Break Even,$-1.50,$223.50,$246146.00,381,$223.50
2025-06-23,19:51:00,22055.0,BUY,3,0.02h,Stop Loss,$30.00,$253.50,$246176.00,381,$253.50
2025-06-23,20:23:00,22064.25,SELL,3,0.02h,Stop Loss,$-9.00,$244.50,$246167.00,381,$244.50
2025-06-23,20:24:00,22068.75,BUY,3,0.02h,Break Even,$-1.50,$243.00,$246165.50,381,$243.00
2025-06-23,20:56:00,22071.25,SELL,3,0.02h,Break Even,$-1.50,$241.50,$246164.00,381,$241.50
2025-06-23,22:03:00,22090.5,BUY,3,0.02h,Stop Loss,$322.50,$564.00,$246486.50,381,$564.00
2025-06-23,22:46:00,22179.25,SELL,3,0.02h,Break Even,$-1.50,$562.50,$246485.00,381,$562.50
2025-06-23,22:58:00,22192.75,BUY,3,0.02h,Stop Loss,$10.50,$573.00,$246495.50,381,$573.00
,,,,,,,,,,,
2025-06-24,12:51:00,22277.25,SELL,3,0.02h,Stop Loss,$6.00,$6.00,$246501.50,382,$6.00
2025-06-24,13:12:00,22287.0,BUY,3,0.02h,Stop Loss,$4.50,$10.50,$246506.00,382,$10.50
2025-06-24,13:31:00,22277.5,SELL,3,0.02h,Break Even,$-1.50,$9.00,$246504.50,382,$9.00
2025-06-24,13:32:00,22303.75,BUY,3,0.02h,Stop Loss,$46.50,$55.50,$246551.00,382,$55.50
2025-06-24,13:34:00,22283.75,SELL,3,0.02h,Stop Loss,$7.50,$63.00,$246558.50,382,$63.00
2025-06-24,13:36:00,22301.5,BUY,3,0.02h,Stop Loss,$28.50,$91.50,$246587.00,382,$91.50
2025-06-24,13:54:00,22296.5,SELL,3,0.02h,Break Even,$-1.50,$90.00,$246585.50,382,$90.00
2025-06-24,14:18:00,22316.75,BUY,3,0.02h,Stop Loss,$28.50,$118.50,$246614.00,382,$118.50
2025-06-24,15:00:00,22315.0,SELL,3,0.02h,Break Even,$-1.50,$117.00,$246612.50,382,$117.00
2025-06-24,15:02:00,22330.0,BUY,3,0.02h,Stop Loss,$90.00,$207.00,$246702.50,382,$207.00
2025-06-24,15:57:00,22365.75,SELL,3,0.02h,Break Even,$-1.50,$205.50,$246701.00,382,$205.50
2025-06-24,16:07:00,22375.5,BUY,3,0.02h,Stop Loss,$6.00,$211.50,$246707.00,382,$211.50
2025-06-24,16:56:00,22398.75,SELL,3,0.02h,Stop Loss,$18.00,$229.50,$246725.00,382,$229.50
2025-06-24,17:02:00,22407.5,BUY,3,0.02h,Break Even,$-1.50,$228.00,$246723.50,382,$228.00
2025-06-24,17:22:00,22381.0,SELL,3,0.02h,Stop Loss,$-9.00,$219.00,$246714.50,382,$219.00
2025-06-24,17:34:00,22402.5,BUY,3,0.02h,Break Even,$-1.50,$217.50,$246713.00,382,$217.50
2025-06-24,18:15:00,22412.75,SELL,3,0.02h,Stop Loss,$-9.00,$208.50,$246704.00,382,$208.50
2025-06-24,18:24:00,22422.0,BUY,3,0.02h,Break Even,$-1.50,$207.00,$246702.50,382,$207.00
2025-06-24,18:30:00,22415.0,SELL,3,0.02h,Break Even,$-1.50,$205.50,$246701.00,382,$205.50
2025-06-24,18:38:00,22426.75,BUY,3,0.02h,Stop Loss,$-9.00,$196.50,$246692.00,382,$196.50
2025-06-24,18:55:00,22417.0,SELL,3,0.02h,Break Even,$-1.50,$195.00,$246690.50,382,$195.00
2025-06-24,18:58:00,22426.75,BUY,3,0.02h,Stop Loss,$-9.00,$186.00,$246681.50,382,$186.00
2025-06-24,19:22:00,22429.0,SELL,3,0.02h,Stop Loss,$-9.00,$177.00,$246672.50,382,$177.00
2025-06-24,20:25:00,22406.0,BUY,3,0.02h,Break Even,$-1.50,$175.50,$246671.00,382,$175.50
2025-06-24,20:59:00,22410.5,SELL,3,0.02h,Break Even,$-1.50,$174.00,$246669.50,382,$174.00
2025-06-24,22:28:00,22400.75,BUY,3,0.02h,Stop Loss,$-9.00,$165.00,$246660.50,382,$165.00
2025-06-24,22:37:00,22394.75,SELL,3,0.02h,Stop Loss,$-9.00,$156.00,$246651.50,382,$156.00
2025-06-24,22:45:00,22399.5,BUY,3,0.02h,Stop Loss,$-9.00,$147.00,$246642.50,382,$147.00
2025-06-24,22:56:00,22396.75,SELL,3,0.02h,Stop Loss,$-9.00,$138.00,$246633.50,382,$138.00
,,,,,,,,,,,
2025-06-25,12:00:00,22490.5,BUY,3,0.02h,Stop Loss,$12.00,$12.00,$246645.50,383,$12.00
2025-06-25,13:11:00,22498.5,SELL,3,0.02h,Break Even,$-1.50,$10.50,$246644.00,383,$10.50
2025-06-25,13:14:00,22506.5,BUY,3,0.02h,Break Even,$-1.50,$9.00,$246642.50,383,$9.00
2025-06-25,13:29:00,22498.5,SELL,3,0.02h,Stop Loss,$-9.00,$0.00,$246633.50,383,$0.00
2025-06-25,13:31:00,22517.75,BUY,3,0.02h,Stop Loss,$54.00,$54.00,$246687.50,383,$54.00
2025-06-25,13:51:00,22501.25,SELL,3,0.02h,Stop Loss,$40.50,$94.50,$246728.00,383,$94.50
2025-06-25,14:00:00,22522.5,BUY,3,0.02h,Stop Loss,$19.50,$114.00,$246747.50,383,$114.00
2025-06-25,14:02:00,22512.0,SELL,3,0.02h,Stop Loss,$60.00,$174.00,$246807.50,383,$174.00
2025-06-25,14:33:00,22494.5,BUY,3,0.02h,Stop Loss,$7.50,$181.50,$246815.00,383,$181.50
2025-06-25,14:51:00,22480.25,SELL,3,0.02h,Stop Loss,$3.00,$184.50,$246818.00,383,$184.50
2025-06-25,15:52:00,22456.75,BUY,3,0.02h,Stop Loss,$-9.00,$175.50,$246809.00,383,$175.50
2025-06-25,16:00:00,22444.25,SELL,3,0.02h,Stop Loss,$-9.00,$166.50,$246800.00,383,$166.50
2025-06-25,16:02:00,22454.25,BUY,3,0.02h,Break Even,$-1.50,$165.00,$246798.50,383,$165.00
2025-06-25,16:05:00,22448.25,SELL,3,0.02h,Stop Loss,$4.50,$169.50,$246803.00,383,$169.50
2025-06-25,16:54:00,22436.75,BUY,3,0.02h,Break Even,$-1.50,$168.00,$246801.50,383,$168.00
2025-06-25,17:09:00,22427.5,SELL,3,0.02h,Stop Loss,$3.00,$171.00,$246804.50,383,$171.00
2025-06-25,17:16:00,22445.5,BUY,3,0.02h,Break Even,$-1.50,$169.50,$246803.00,383,$169.50
2025-06-25,17:34:00,22433.5,SELL,3,0.02h,Stop Loss,$48.00,$217.50,$246851.00,383,$217.50
2025-06-25,18:13:00,22424.75,BUY,3,0.02h,Stop Loss,$-9.00,$208.50,$246842.00,383,$208.50
2025-06-25,18:33:00,22416.75,SELL,3,0.02h,Break Even,$-1.50,$207.00,$246840.50,383,$207.00
2025-06-25,18:58:00,22424.0,BUY,3,0.02h,Stop Loss,$-9.00,$198.00,$246831.50,383,$198.00
2025-06-25,19:32:00,22428.75,SELL,3,0.02h,Stop Loss,$-9.00,$189.00,$246822.50,383,$189.00
2025-06-25,19:45:00,22441.25,BUY,3,0.02h,Break Even,$-1.50,$187.50,$246821.00,383,$187.50
2025-06-25,19:47:00,22434.0,SELL,3,0.02h,Break Even,$-1.50,$186.00,$246819.50,383,$186.00
2025-06-25,19:51:00,22443.25,BUY,3,0.02h,Stop Loss,$10.50,$196.50,$246830.00,383,$196.50
2025-06-25,20:27:00,22461.25,SELL,3,0.02h,Stop Loss,$-9.00,$187.50,$246821.00,383,$187.50
2025-06-25,20:38:00,22464.75,BUY,3,0.02h,Stop Loss,$-9.00,$178.50,$246812.00,383,$178.50
2025-06-25,22:02:00,22460.25,SELL,3,0.02h,Break Even,$-1.50,$177.00,$246810.50,383,$177.00
2025-06-25,22:05:00,22466.75,BUY,3,0.02h,Break Even,$-1.50,$175.50,$246809.00,383,$175.50
2025-06-25,22:06:00,22465.0,SELL,3,0.02h,Stop Loss,$-9.00,$166.50,$246800.00,383,$166.50
2025-06-25,22:08:00,22468.25,BUY,3,0.02h,Stop Loss,$-9.00,$157.50,$246791.00,383,$157.50
2025-06-25,22:24:00,22465.5,SELL,3,0.02h,Break Even,$-1.50,$156.00,$246789.50,383,$156.00
2025-06-25,22:57:00,22461.5,BUY,3,0.02h,Break Even,$-1.50,$154.50,$246788.00,383,$154.50
,,,,,,,,,,,
2025-06-26,12:34:00,22538.25,SELL,3,0.02h,Stop Loss,$88.50,$88.50,$246876.50,384,$88.50
2025-06-26,13:21:00,22552.5,BUY,3,0.02h,Break Even,$-1.50,$87.00,$246875.00,384,$87.00
2025-06-26,13:35:00,22535.75,SELL,3,0.02h,Stop Loss,$3.00,$90.00,$246878.00,384,$90.00
2025-06-26,13:59:00,22538.0,BUY,3,0.02h,Stop Loss,$33.00,$123.00,$246911.00,384,$123.00
2025-06-26,14:45:00,22561.75,SELL,3,0.02h,Stop Loss,$7.50,$130.50,$246918.50,384,$130.50
2025-06-26,14:48:00,22573.0,BUY,3,0.02h,Break Even,$-1.50,$129.00,$246917.00,384,$129.00
2025-06-26,15:30:00,22565.0,SELL,3,0.02h,Stop Loss,$70.50,$199.50,$246987.50,384,$199.50
2025-06-26,15:40:00,22597.5,BUY,3,0.02h,Break Even,$-1.50,$198.00,$246986.00,384,$198.00
2025-06-26,16:30:00,22614.0,SELL,3,0.02h,Break Even,$-1.50,$196.50,$246984.50,384,$196.50
2025-06-26,17:04:00,22613.75,BUY,3,0.02h,Stop Loss,$9.00,$205.50,$246993.50,384,$205.50
2025-06-26,18:01:00,22635.5,SELL,3,0.02h,Stop Loss,$-9.00,$196.50,$246984.50,384,$196.50
2025-06-26,18:02:00,22643.75,BUY,3,0.02h,Stop Loss,$-9.00,$187.50,$246975.50,384,$187.50
2025-06-26,18:40:00,22668.5,SELL,3,0.02h,Break Even,$-1.50,$186.00,$246974.00,384,$186.00
2025-06-26,19:03:00,22672.75,BUY,3,0.02h,Stop Loss,$-9.00,$177.00,$246965.00,384,$177.00
2025-06-26,19:08:00,22663.75,SELL,3,0.02h,Break Even,$-1.50,$175.50,$246963.50,384,$175.50
2025-06-26,19:12:00,22670.5,BUY,3,0.02h,Stop Loss,$-9.00,$166.50,$246954.50,384,$166.50
2025-06-26,19:13:00,22665.25,SELL,3,0.02h,Break Even,$-1.50,$165.00,$246953.00,384,$165.00
2025-06-26,19:21:00,22669.25,BUY,3,0.02h,Stop Loss,$-9.00,$156.00,$246944.00,384,$156.00
2025-06-26,19:38:00,22664.0,SELL,3,0.02h,Break Even,$-1.50,$154.50,$246942.50,384,$154.50
2025-06-26,19:51:00,22683.75,BUY,3,0.02h,Stop Loss,$12.00,$166.50,$246954.50,384,$166.50
2025-06-26,20:02:00,22655.25,SELL,3,0.02h,Stop Loss,$24.00,$190.50,$246978.50,384,$190.50
2025-06-26,20:23:00,22664.75,BUY,3,0.02h,Stop Loss,$24.00,$214.50,$247002.50,384,$214.50
2025-06-26,20:57:00,22667.25,SELL,3,0.02h,Stop Loss,$-9.00,$205.50,$246993.50,384,$205.50
2025-06-26,22:01:00,22677.0,BUY,3,0.02h,Break Even,$-1.50,$204.00,$246992.00,384,$204.00
2025-06-26,22:59:00,22694.5,SELL,3,0.02h,Stop Loss,$-9.00,$195.00,$246983.00,384,$195.00
,,,,,,,,,,,
2025-06-27,12:00:00,22779.5,BUY,3,0.02h,Stop Loss,$27.00,$27.00,$247010.00,385,$27.00
2025-06-27,12:33:00,22748.25,SELL,3,0.02h,Stop Loss,$-9.00,$18.00,$247001.00,385,$18.00
2025-06-27,13:27:00,22720.5,BUY,3,0.02h,Stop Loss,$18.00,$36.00,$247019.00,385,$36.00
2025-06-27,13:29:00,22709.5,SELL,3,0.02h,Stop Loss,$16.50,$52.50,$247035.50,385,$52.50
2025-06-27,13:38:00,22733.5,BUY,3,0.02h,Break Even,$-1.50,$51.00,$247034.00,385,$51.00
2025-06-27,14:28:00,22774.5,SELL,3,0.02h,Stop Loss,$-9.00,$42.00,$247025.00,385,$42.00
2025-06-27,14:39:00,22811.25,BUY,3,0.02h,Break Even,$-1.50,$40.50,$247023.50,385,$40.50
2025-06-27,14:52:00,22765.75,SELL,3,0.02h,Stop Loss,$66.00,$106.50,$247089.50,385,$106.50
2025-06-27,15:11:00,22776.25,BUY,3,0.02h,Stop Loss,$7.50,$114.00,$247097.00,385,$114.00
2025-06-27,15:18:00,22765.75,SELL,3,0.02h,Stop Loss,$21.00,$135.00,$247118.00,385,$135.00
2025-06-27,15:22:00,22781.25,BUY,3,0.02h,Stop Loss,$31.50,$166.50,$247149.50,385,$166.50
2025-06-27,16:02:00,22798.25,SELL,3,0.02h,Stop Loss,$-9.00,$157.50,$247140.50,385,$157.50
2025-06-27,16:57:00,22794.5,BUY,3,0.02h,Stop Loss,$3.00,$160.50,$247143.50,385,$160.50
2025-06-27,17:05:00,22783.0,SELL,3,0.02h,Break Even,$-1.50,$159.00,$247142.00,385,$159.00
2025-06-27,17:10:00,22789.5,BUY,3,0.02h,Stop Loss,$15.00,$174.00,$247157.00,385,$174.00
2025-06-27,17:21:00,22782.5,SELL,3,0.02h,Break Even,$-1.50,$172.50,$247155.50,385,$172.50
2025-06-27,19:07:00,22645.25,BUY,3,0.02h,Stop Loss,$31.50,$204.00,$247187.00,385,$204.00
2025-06-27,20:29:00,22734.75,SELL,3,0.02h,Stop Loss,$-9.00,$195.00,$247178.00,385,$195.00
2025-06-27,20:31:00,22740.0,BUY,3,0.02h,Stop Loss,$-9.00,$186.00,$247169.00,385,$186.00
2025-06-27,20:36:00,22735.75,SELL,3,0.02h,Break Even,$-1.50,$184.50,$247167.50,385,$184.50
2025-06-27,20:53:00,22743.25,BUY,3,0.02h,Stop Loss,$-9.00,$175.50,$247158.50,385,$175.50
,,,,,,,,,,,
2025-06-30,12:37:00,22871.25,SELL,3,0.02h,Stop Loss,$4.50,$4.50,$247163.00,386,$4.50
2025-06-30,13:02:00,22873.5,BUY,3,0.02h,Break Even,$-1.50,$3.00,$247161.50,386,$3.00
2025-06-30,13:31:00,22870.0,SELL,3,0.02h,Stop Loss,$114.00,$117.00,$247275.50,386,$117.00
2025-06-30,14:03:00,22829.0,BUY,3,0.02h,Stop Loss,$7.50,$124.50,$247283.00,386,$124.50
2025-06-30,14:21:00,22821.5,SELL,3,0.02h,Stop Loss,$61.50,$186.00,$247344.50,386,$186.00
2025-06-30,14:31:00,22838.0,BUY,3,0.02h,Break Even,$-1.50,$184.50,$247343.00,386,$184.50
2025-06-30,14:37:00,22827.0,SELL,3,0.02h,Stop Loss,$49.50,$234.00,$247392.50,386,$234.00
2025-06-30,14:49:00,22832.75,BUY,3,0.02h,Break Even,$-1.50,$232.50,$247391.00,386,$232.50
2025-06-30,14:53:00,22823.0,SELL,3,0.02h,Stop Loss,$19.50,$252.00,$247410.50,386,$252.00
2025-06-30,15:05:00,22829.75,BUY,3,0.02h,Stop Loss,$21.00,$273.00,$247431.50,386,$273.00
2025-06-30,15:14:00,22812.0,SELL,3,0.02h,Stop Loss,$3.00,$276.00,$247434.50,386,$276.00
2025-06-30,15:34:00,22832.5,BUY,3,0.02h,Stop Loss,$24.00,$300.00,$247458.50,386,$300.00
2025-06-30,16:19:00,22842.0,SELL,3,0.02h,Stop Loss,$46.50,$346.50,$247505.00,386,$346.50
2025-06-30,16:37:00,22850.25,BUY,3,0.02h,Stop Loss,$6.00,$352.50,$247511.00,386,$352.50
2025-06-30,16:59:00,22844.5,SELL,3,0.02h,Stop Loss,$16.50,$369.00,$247527.50,386,$369.00
2025-06-30,17:54:00,22828.25,BUY,3,0.02h,Stop Loss,$-9.00,$360.00,$247518.50,386,$360.00
2025-06-30,17:58:00,22812.75,SELL,3,0.02h,Break Even,$-1.50,$358.50,$247517.00,386,$358.50
2025-06-30,18:02:00,22833.5,BUY,3,0.02h,Break Even,$-1.50,$357.00,$247515.50,386,$357.00
2025-06-30,18:10:00,22817.5,SELL,3,0.02h,Stop Loss,$42.00,$399.00,$247557.50,386,$399.00
2025-06-30,18:18:00,22828.25,BUY,3,0.02h,Break Even,$-1.50,$397.50,$247556.00,386,$397.50
2025-06-30,18:30:00,22819.5,SELL,3,0.02h,Stop Loss,$3.00,$400.50,$247559.00,386,$400.50
2025-06-30,18:52:00,22819.5,BUY,3,0.02h,Stop Loss,$4.50,$405.00,$247563.50,386,$405.00
2025-06-30,20:03:00,22879.5,SELL,3,0.02h,Break Even,$-1.50,$403.50,$247562.00,386,$403.50
2025-06-30,20:34:00,22877.5,BUY,3,0.02h,Break Even,$-1.50,$402.00,$247560.50,386,$402.00
2025-06-30,20:50:00,22874.25,SELL,3,0.02h,Stop Loss,$-9.00,$393.00,$247551.50,386,$393.00
2025-06-30,20:51:00,22876.5,BUY,3,0.02h,Stop Loss,$-9.00,$384.00,$247542.50,386,$384.00
2025-06-30,20:52:00,22874.75,SELL,3,0.02h,Stop Loss,$-9.00,$375.00,$247533.50,386,$375.00
2025-06-30,20:53:00,22877.25,BUY,3,0.02h,Stop Loss,$-9.00,$366.00,$247524.50,386,$366.00
2025-06-30,20:55:00,22872.5,SELL,3,0.02h,Break Even,$-1.50,$364.50,$247523.00,386,$364.50
2025-06-30,22:09:00,22884.0,BUY,3,0.02h,Break Even,$-1.50,$363.00,$247521.50,386,$363.00
2025-06-30,22:27:00,22872.0,SELL,3,0.02h,Break Even,$-1.50,$361.50,$247520.00,386,$361.50
,,,,,,,,,,,
2025-07-01,12:49:00,22795.5,BUY,3,0.02h,Stop Loss,$-9.00,$-9.00,$247511.00,387,$-9.00
2025-07-01,13:22:00,22795.75,SELL,3,0.02h,Stop Loss,$7.50,$-1.50,$247518.50,387,$-1.50
2025-07-01,13:33:00,22814.5,BUY,3,0.02h,Stop Loss,$7.50,$6.00,$247526.00,387,$6.00
2025-07-01,13:44:00,22789.25,SELL,3,0.02h,Stop Loss,$36.00,$42.00,$247562.00,387,$42.00
2025-07-01,13:49:00,22813.5,BUY,3,0.02h,Stop Loss,$37.50,$79.50,$247599.50,387,$79.50
2025-07-01,14:00:00,22782.25,SELL,3,0.02h,Stop Loss,$-9.00,$70.50,$247590.50,387,$70.50
2025-07-01,14:14:00,22828.75,BUY,3,0.02h,Break Even,$-1.50,$69.00,$247589.00,387,$69.00
2025-07-01,14:23:00,22790.75,SELL,3,0.02h,Stop Loss,$25.50,$94.50,$247614.50,387,$94.50
2025-07-01,15:26:00,22684.5,BUY,3,0.02h,Stop Loss,$30.00,$124.50,$247644.50,387,$124.50
2025-07-01,15:41:00,22638.5,SELL,3,0.02h,Stop Loss,$75.00,$199.50,$247719.50,387,$199.50
2025-07-01,15:54:00,22668.25,BUY,3,0.02h,Stop Loss,$4.50,$204.00,$247724.00,387,$204.00
2025-07-01,16:03:00,22652.5,SELL,3,0.02h,Break Even,$-1.50,$202.50,$247722.50,387,$202.50
2025-07-01,16:12:00,22674.75,BUY,3,0.02h,Stop Loss,$51.00,$253.50,$247773.50,387,$253.50
2025-07-01,17:31:00,22718.25,SELL,3,0.02h,Stop Loss,$25.50,$279.00,$247799.00,387,$279.00
2025-07-01,17:44:00,22725.5,BUY,3,0.02h,Stop Loss,$6.00,$285.00,$247805.00,387,$285.00
2025-07-01,18:18:00,22735.5,SELL,3,0.02h,Stop Loss,$18.00,$303.00,$247823.00,387,$303.00
2025-07-01,18:35:00,22741.0,BUY,3,0.02h,Break Even,$-1.50,$301.50,$247821.50,387,$301.50
2025-07-01,18:38:00,22729.25,SELL,3,0.02h,Stop Loss,$16.50,$318.00,$247838.00,387,$318.00
2025-07-01,19:20:00,22704.25,BUY,3,0.02h,Break Even,$-1.50,$316.50,$247836.50,387,$316.50
2025-07-01,19:37:00,22701.25,SELL,3,0.02h,Stop Loss,$52.50,$369.00,$247889.00,387,$369.00
2025-07-01,19:46:00,22715.75,BUY,3,0.02h,Break Even,$-1.50,$367.50,$247887.50,387,$367.50
2025-07-01,19:59:00,22702.5,SELL,3,0.02h,Stop Loss,$76.50,$444.00,$247964.00,387,$444.00
2025-07-01,20:32:00,22683.75,BUY,3,0.02h,Break Even,$-1.50,$442.50,$247962.50,387,$442.50
2025-07-01,22:32:00,22697.5,SELL,3,0.02h,Stop Loss,$-9.00,$433.50,$247953.50,387,$433.50
2025-07-01,22:33:00,22704.25,BUY,3,0.02h,Stop Loss,$6.00,$439.50,$247959.50,387,$439.50
,,,,,,,,,,,
2025-07-02,12:00:00,22662.5,SELL,3,0.02h,Stop Loss,$63.00,$63.00,$248022.50,388,$63.00
2025-07-02,13:02:00,22629.0,BUY,3,0.02h,Break Even,$-1.50,$61.50,$248021.00,388,$61.50
2025-07-02,15:21:00,22821.0,SELL,3,0.02h,Stop Loss,$27.00,$88.50,$248048.00,388,$88.50
2025-07-02,15:23:00,22827.0,BUY,3,0.02h,Break Even,$-1.50,$87.00,$248046.50,388,$87.00
2025-07-02,15:25:00,22815.75,SELL,3,0.02h,Stop Loss,$6.00,$93.00,$248052.50,388,$93.00
2025-07-02,15:38:00,22824.25,BUY,3,0.02h,Stop Loss,$-9.00,$84.00,$248043.50,388,$84.00
2025-07-02,15:39:00,22814.0,SELL,3,0.02h,Stop Loss,$28.50,$112.50,$248072.00,388,$112.50
2025-07-02,15:48:00,22823.0,BUY,3,0.02h,Break Even,$-1.50,$111.00,$248070.50,388,$111.00
2025-07-02,16:03:00,22810.25,SELL,3,0.02h,Stop Loss,$-9.00,$102.00,$248061.50,388,$102.00
2025-07-02,16:07:00,22825.0,BUY,3,0.02h,Stop Loss,$-9.00,$93.00,$248052.50,388,$93.00
2025-07-02,16:32:00,22822.5,SELL,3,0.02h,Stop Loss,$-9.00,$84.00,$248043.50,388,$84.00
2025-07-02,16:35:00,22833.25,BUY,3,0.02h,Stop Loss,$4.50,$88.50,$248048.00,388,$88.50
2025-07-02,16:53:00,22829.25,SELL,3,0.02h,Stop Loss,$-9.00,$79.50,$248039.00,388,$79.50
2025-07-02,16:57:00,22837.5,BUY,3,0.02h,Stop Loss,$6.00,$85.50,$248045.00,388,$85.50
2025-07-02,17:09:00,22831.75,SELL,3,0.02h,Stop Loss,$3.00,$88.50,$248048.00,388,$88.50
2025-07-02,17:51:00,22825.75,BUY,3,0.02h,Stop Loss,$19.50,$108.00,$248067.50,388,$108.00
2025-07-02,18:03:00,22815.25,SELL,3,0.02h,Break Even,$-1.50,$106.50,$248066.00,388,$106.50
2025-07-02,18:06:00,22828.25,BUY,3,0.02h,Stop Loss,$-9.00,$97.50,$248057.00,388,$97.50
2025-07-02,18:18:00,22819.75,SELL,3,0.02h,Stop Loss,$-9.00,$88.50,$248048.00,388,$88.50
2025-07-02,18:19:00,22828.75,BUY,3,0.02h,Stop Loss,$22.50,$111.00,$248070.50,388,$111.00
2025-07-02,18:46:00,22825.5,SELL,3,0.02h,Stop Loss,$3.00,$114.00,$248073.50,388,$114.00
2025-07-02,18:49:00,22836.0,BUY,3,0.02h,Stop Loss,$-9.00,$105.00,$248064.50,388,$105.00
2025-07-02,18:50:00,22828.75,SELL,3,0.02h,Stop Loss,$15.00,$120.00,$248079.50,388,$120.00
2025-07-02,19:01:00,22833.5,BUY,3,0.02h,Stop Loss,$12.00,$132.00,$248091.50,388,$132.00
2025-07-02,19:14:00,22827.75,SELL,3,0.02h,Break Even,$-1.50,$130.50,$248090.00,388,$130.50
2025-07-02,19:35:00,22831.0,BUY,3,0.02h,Stop Loss,$-9.00,$121.50,$248081.00,388,$121.50
2025-07-02,19:37:00,22824.75,SELL,3,0.02h,Stop Loss,$-9.00,$112.50,$248072.00,388,$112.50
2025-07-02,19:54:00,22831.25,BUY,3,0.02h,Stop Loss,$84.00,$196.50,$248156.00,388,$196.50
2025-07-02,20:17:00,22830.75,SELL,3,0.02h,Stop Loss,$-9.00,$187.50,$248147.00,388,$187.50
2025-07-02,20:30:00,22835.25,BUY,3,0.02h,Break Even,$-1.50,$186.00,$248145.50,388,$186.00
2025-07-02,22:08:00,22843.25,SELL,3,0.02h,Stop Loss,$-9.00,$177.00,$248136.50,388,$177.00
2025-07-02,22:38:00,22839.25,BUY,3,0.03h,Break Even,$-1.50,$175.50,$248135.00,388,$175.50
,,,,,,,,,,,
2025-07-03,12:21:00,22857.25,SELL,3,0.02h,Stop Loss,$4.50,$4.50,$248139.50,389,$4.50
2025-07-03,12:31:00,22901.25,BUY,3,0.02h,Stop Loss,$70.50,$75.00,$248210.00,389,$75.00
2025-07-03,12:49:00,22879.25,SELL,3,0.02h,Stop Loss,$-9.00,$66.00,$248201.00,389,$66.00
2025-07-03,12:56:00,22900.25,BUY,3,0.02h,Stop Loss,$-9.00,$57.00,$248192.00,389,$57.00
2025-07-03,14:45:00,23045.5,SELL,3,0.02h,Stop Loss,$-9.00,$48.00,$248183.00,389,$48.00
2025-07-03,14:59:00,23051.0,BUY,3,0.02h,Stop Loss,$-9.00,$39.00,$248174.00,389,$39.00
2025-07-03,16:00:00,23083.25,SELL,3,0.02h,Stop Loss,$-9.00,$30.00,$248165.00,389,$30.00
2025-07-03,16:01:00,23089.0,BUY,3,0.02h,Break Even,$-1.50,$28.50,$248163.50,389,$28.50
2025-07-03,16:16:00,23079.25,SELL,3,0.02h,Stop Loss,$-9.00,$19.50,$248154.50,389,$19.50
2025-07-03,22:11:00,23052.5,BUY,3,0.02h,Stop Loss,$-9.00,$10.50,$248145.50,389,$10.50
2025-07-03,22:13:00,23042.75,SELL,3,0.02h,Break Even,$-1.50,$9.00,$248144.00,389,$9.00
2025-07-03,22:19:00,23054.0,BUY,3,0.02h,Break Even,$-1.50,$7.50,$248142.50,389,$7.50
2025-07-03,22:47:00,23049.5,SELL,3,0.03h,Break Even,$-1.50,$6.00,$248141.00,389,$6.00
,,,,,,,,,,,
2025-07-04,12:44:00,22932.0,BUY,3,0.02h,Stop Loss,$-9.00,$-9.00,$248132.00,390,$-9.00
2025-07-04,12:46:00,22926.0,SELL,3,0.02h,Stop Loss,$-9.00,$-18.00,$248123.00,390,$-18.00
2025-07-04,13:31:00,22920.0,BUY,3,0.02h,Stop Loss,$3.00,$-15.00,$248126.00,390,$-15.00
2025-07-04,13:36:00,22901.0,SELL,3,0.02h,Stop Loss,$22.50,$7.50,$248148.50,390,$7.50
2025-07-04,13:43:00,22926.25,BUY,3,0.02h,Break Even,$-1.50,$6.00,$248147.00,390,$6.00
2025-07-04,14:05:00,22916.75,SELL,3,0.02h,Stop Loss,$12.00,$18.00,$248159.00,390,$18.00
2025-07-04,14:20:00,22922.25,BUY,3,0.02h,Stop Loss,$-9.00,$9.00,$248150.00,390,$9.00
2025-07-04,14:57:00,22934.5,SELL,3,0.02h,Break Even,$-1.50,$7.50,$248148.50,390,$7.50
2025-07-04,15:01:00,22940.5,BUY,3,0.02h,Stop Loss,$-9.00,$-1.50,$248139.50,390,$-1.50
2025-07-04,15:06:00,22935.5,SELL,3,0.02h,Stop Loss,$-9.00,$-10.50,$248130.50,390,$-10.50
2025-07-04,15:32:00,22932.0,BUY,3,0.02h,Break Even,$-1.50,$-12.00,$248129.00,390,$-12.00
2025-07-04,16:03:00,22928.5,SELL,3,0.02h,Stop Loss,$-9.00,$-21.00,$248120.00,390,$-21.00
2025-07-04,16:05:00,22932.5,BUY,3,0.02h,Break Even,$-1.50,$-22.50,$248118.50,390,$-22.50
2025-07-04,16:09:00,22928.0,SELL,3,0.02h,Break Even,$-1.50,$-24.00,$248117.00,390,$-24.00
,,,,,,,,,,,
2025-07-07,12:00:00,22981.25,BUY,3,0.02h,Stop Loss,$-9.00,$-9.00,$248108.00,391,$-9.00
2025-07-07,12:39:00,22975.0,SELL,3,0.02h,Stop Loss,$-9.00,$-18.00,$248099.00,391,$-18.00
2025-07-07,13:31:00,22970.5,BUY,3,0.02h,Break Even,$-1.50,$-19.50,$248097.50,391,$-19.50
2025-07-07,13:35:00,22926.5,SELL,3,0.02h,Stop Loss,$4.50,$-15.00,$248102.00,391,$-15.00
2025-07-07,13:43:00,22947.25,BUY,3,0.02h,Break Even,$-1.50,$-16.50,$248100.50,391,$-16.50
2025-07-07,13:46:00,22926.0,SELL,3,0.02h,Stop Loss,$7.50,$-9.00,$248108.00,391,$-9.00
2025-07-07,13:50:00,22951.5,BUY,3,0.02h,Stop Loss,$40.50,$31.50,$248148.50,391,$31.50
2025-07-07,14:02:00,22925.25,SELL,3,0.02h,Stop Loss,$121.50,$153.00,$248270.00,391,$153.00
2025-07-07,14:24:00,22941.75,BUY,3,0.02h,Stop Loss,$24.00,$177.00,$248294.00,391,$177.00
2025-07-07,14:33:00,22926.5,SELL,3,0.02h,Break Even,$-1.50,$175.50,$248292.50,391,$175.50
2025-07-07,15:16:00,22915.25,BUY,3,0.02h,Stop Loss,$-9.00,$166.50,$248283.50,391,$166.50
2025-07-07,15:20:00,22904.75,SELL,3,0.02h,Stop Loss,$6.00,$172.50,$248289.50,391,$172.50
2025-07-07,15:26:00,22907.75,BUY,3,0.02h,Stop Loss,$55.50,$228.00,$248345.00,391,$228.00
2025-07-07,15:47:00,22906.0,SELL,3,0.02h,Stop Loss,$21.00,$249.00,$248366.00,391,$249.00
2025-07-07,15:57:00,22923.25,BUY,3,0.02h,Stop Loss,$52.50,$301.50,$248418.50,391,$301.50
2025-07-07,16:21:00,22879.75,SELL,3,0.02h,Stop Loss,$204.00,$505.50,$248622.50,391,$505.50
2025-07-07,16:38:00,22917.5,BUY,3,0.02h,Break Even,$-1.50,$504.00,$248621.00,391,$504.00
2025-07-07,16:39:00,22894.0,SELL,3,0.02h,Break Even,$-1.50,$502.50,$248619.50,391,$502.50
2025-07-07,17:11:00,22890.75,BUY,3,0.02h,Stop Loss,$16.50,$519.00,$248636.00,391,$519.00
2025-07-07,17:28:00,22869.25,SELL,3,0.02h,Break Even,$-1.50,$517.50,$248634.50,391,$517.50
2025-07-07,17:33:00,22891.5,BUY,3,0.02h,Stop Loss,$-9.00,$508.50,$248625.50,391,$508.50
2025-07-07,17:35:00,22883.0,SELL,3,0.02h,Stop Loss,$79.50,$588.00,$248705.00,391,$588.00
2025-07-07,18:00:00,22871.0,BUY,3,0.02h,Stop Loss,$10.50,$598.50,$248715.50,391,$598.50
2025-07-07,18:16:00,22859.0,SELL,3,0.02h,Stop Loss,$183.00,$781.50,$248898.50,391,$781.50
2025-07-07,18:42:00,22835.75,BUY,3,0.02h,Stop Loss,$63.00,$844.50,$248961.50,391,$844.50
2025-07-07,19:10:00,22851.5,SELL,3,0.02h,Break Even,$-1.50,$843.00,$248960.00,391,$843.00
2025-07-07,19:14:00,22862.75,BUY,3,0.02h,Stop Loss,$7.50,$850.50,$248967.50,391,$850.50
2025-07-07,19:15:00,22857.0,SELL,3,0.02h,Break Even,$-1.50,$849.00,$248966.00,391,$849.00
2025-07-07,19:34:00,22858.25,BUY,3,0.02h,Stop Loss,$9.00,$858.00,$248975.00,391,$858.00
2025-07-07,19:39:00,22849.5,SELL,3,0.02h,Break Even,$-1.50,$856.50,$248973.50,391,$856.50
2025-07-07,19:51:00,22869.75,BUY,3,0.02h,Break Even,$-1.50,$855.00,$248972.00,391,$855.00
2025-07-07,20:06:00,22856.75,SELL,3,0.02h,Break Even,$-1.50,$853.50,$248970.50,391,$853.50
2025-07-07,20:20:00,22863.75,BUY,3,0.03h,Break Even,$-1.50,$852.00,$248969.00,391,$852.00
2025-07-07,20:30:00,22858.5,SELL,3,0.02h,Stop Loss,$-9.00,$843.00,$248960.00,391,$843.00
2025-07-07,22:01:00,22848.0,BUY,3,0.02h,Stop Loss,$9.00,$852.00,$248969.00,391,$852.00
2025-07-07,22:05:00,22832.25,SELL,3,0.02h,Stop Loss,$-9.00,$843.00,$248960.00,391,$843.00
2025-07-07,22:08:00,22840.0,BUY,3,0.02h,Stop Loss,$10.50,$853.50,$248970.50,391,$853.50
2025-07-07,22:13:00,22834.75,SELL,3,0.02h,Break Even,$-1.50,$852.00,$248969.00,391,$852.00
2025-07-07,22:34:00,22835.25,BUY,3,0.02h,Break Even,$-1.50,$850.50,$248967.50,391,$850.50
,,,,,,,,,,,
2025-07-08,12:34:00,22932.0,SELL,3,0.02h,Break Even,$-1.50,$-1.50,$248966.00,392,$-1.50
2025-07-08,12:57:00,22934.0,BUY,3,0.02h,Stop Loss,$6.00,$4.50,$248972.00,392,$4.50
2025-07-08,13:21:00,22937.25,SELL,3,0.02h,Stop Loss,$-9.00,$-4.50,$248963.00,392,$-4.50
2025-07-08,13:57:00,22919.0,BUY,3,0.02h,Break Even,$-1.50,$-6.00,$248961.50,392,$-6.00
2025-07-08,13:58:00,22907.75,SELL,3,0.02h,Stop Loss,$73.50,$67.50,$249035.00,392,$67.50
2025-07-08,14:33:00,22909.25,BUY,3,0.02h,Break Even,$-1.50,$66.00,$249033.50,392,$66.00
2025-07-08,14:52:00,22894.0,SELL,3,0.02h,Stop Loss,$223.50,$289.50,$249257.00,392,$289.50
2025-07-08,15:04:00,22902.0,BUY,3,0.02h,Stop Loss,$-9.00,$280.50,$249248.00,392,$280.50
2025-07-08,15:20:00,22888.0,SELL,3,0.02h,Stop Loss,$27.00,$307.50,$249275.00,392,$307.50
2025-07-08,15:39:00,22889.5,BUY,3,0.02h,Break Even,$-1.50,$306.00,$249273.50,392,$306.00
2025-07-08,16:36:00,22897.75,SELL,3,0.02h,Stop Loss,$36.00,$342.00,$249309.50,392,$342.00
2025-07-08,17:29:00,22913.75,BUY,3,0.02h,Stop Loss,$-9.00,$333.00,$249300.50,392,$333.00
2025-07-08,17:36:00,22899.75,SELL,3,0.02h,Stop Loss,$3.00,$336.00,$249303.50,392,$336.00
2025-07-08,17:49:00,22907.75,BUY,3,0.02h,Stop Loss,$4.50,$340.50,$249308.00,392,$340.50
2025-07-08,18:22:00,22921.25,SELL,3,0.02h,Break Even,$-1.50,$339.00,$249306.50,392,$339.00
2025-07-08,19:34:00,22890.25,BUY,3,0.02h,Break Even,$-1.50,$337.50,$249305.00,392,$337.50
2025-07-08,19:40:00,22879.5,SELL,3,0.02h,Break Even,$-1.50,$336.00,$249303.50,392,$336.00
2025-07-08,19:49:00,22892.75,BUY,3,0.02h,Stop Loss,$4.50,$340.50,$249308.00,392,$340.50
2025-07-08,20:36:00,22900.75,SELL,3,0.02h,Stop Loss,$-9.00,$331.50,$249299.00,392,$331.50
2025-07-08,20:44:00,22904.0,BUY,3,0.02h,Break Even,$-1.50,$330.00,$249297.50,392,$330.00
2025-07-08,20:47:00,22902.25,SELL,3,0.02h,Stop Loss,$-9.00,$321.00,$249288.50,392,$321.00
2025-07-08,20:48:00,22903.0,BUY,3,0.02h,Stop Loss,$-9.00,$312.00,$249279.50,392,$312.00
2025-07-08,20:49:00,22901.5,SELL,3,0.02h,Stop Loss,$-9.00,$303.00,$249270.50,392,$303.00
2025-07-08,20:55:00,22904.0,BUY,3,0.02h,Stop Loss,$-9.00,$294.00,$249261.50,392,$294.00
2025-07-08,20:56:00,22901.25,SELL,3,0.03h,Break Even,$-1.50,$292.50,$249260.00,392,$292.50
2025-07-08,22:01:00,22915.75,BUY,3,0.02h,Stop Loss,$12.00,$304.50,$249272.00,392,$304.50
2025-07-08,22:23:00,22910.0,SELL,3,0.02h,Break Even,$-1.50,$303.00,$249270.50,392,$303.00
2025-07-08,22:29:00,22913.0,BUY,3,0.02h,Stop Loss,$-9.00,$294.00,$249261.50,392,$294.00
2025-07-08,22:30:00,22909.25,SELL,3,0.02h,Stop Loss,$-9.00,$285.00,$249252.50,392,$285.00
2025-07-08,22:31:00,22912.25,BUY,3,0.02h,Stop Loss,$-9.00,$276.00,$249243.50,392,$276.00
2025-07-08,22:32:00,22905.75,SELL,3,0.02h,Stop Loss,$7.50,$283.50,$249251.00,392,$283.50
2025-07-08,22:50:00,22910.0,BUY,3,0.03h,Break Even,$-1.50,$282.00,$249249.50,392,$282.00
,,,,,,,,,,,
2025-07-09,12:38:00,22937.0,SELL,3,0.02h,Break Even,$-1.50,$-1.50,$249248.00,393,$-1.50
2025-07-09,12:43:00,22941.5,BUY,3,0.02h,Break Even,$-1.50,$-3.00,$249246.50,393,$-3.00
2025-07-09,12:58:00,22936.5,SELL,3,0.02h,Stop Loss,$39.00,$36.00,$249285.50,393,$36.00
2025-07-09,13:08:00,22951.0,BUY,3,0.02h,Break Even,$-1.50,$34.50,$249284.00,393,$34.50
2025-07-09,14:20:00,23077.0,SELL,3,0.02h,Stop Loss,$16.50,$51.00,$249300.50,393,$51.00
2025-07-09,15:23:00,22970.5,BUY,3,0.02h,Break Even,$-1.50,$49.50,$249299.00,393,$49.50
2025-07-09,15:53:00,22951.5,SELL,3,0.02h,Break Even,$-1.50,$48.00,$249297.50,393,$48.00
2025-07-09,16:19:00,22972.25,BUY,3,0.02h,Stop Loss,$3.00,$51.00,$249300.50,393,$51.00
2025-07-09,17:01:00,22976.75,SELL,3,0.02h,Stop Loss,$66.00,$117.00,$249366.50,393,$117.00
2025-07-09,17:11:00,22991.75,BUY,3,0.02h,Stop Loss,$-9.00,$108.00,$249357.50,393,$108.00
2025-07-09,17:13:00,22980.75,SELL,3,0.02h,Stop Loss,$6.00,$114.00,$249363.50,393,$114.00
2025-07-09,17:27:00,22987.25,BUY,3,0.02h,Stop Loss,$-9.00,$105.00,$249354.50,393,$105.00
2025-07-09,17:28:00,22977.75,SELL,3,0.02h,Stop Loss,$13.50,$118.50,$249368.00,393,$118.50
2025-07-09,17:35:00,22987.75,BUY,3,0.02h,Stop Loss,$34.50,$153.00,$249402.50,393,$153.00
2025-07-09,17:46:00,22982.75,SELL,3,0.02h,Stop Loss,$73.50,$226.50,$249476.00,393,$226.50
2025-07-09,17:52:00,22992.75,BUY,3,0.02h,Stop Loss,$9.00,$235.50,$249485.00,393,$235.50
2025-07-09,17:54:00,22976.0,SELL,3,0.02h,Stop Loss,$45.00,$280.50,$249530.00,393,$280.50
2025-07-09,18:02:00,22993.5,BUY,3,0.02h,Break Even,$-1.50,$279.00,$249528.50,393,$279.00
2025-07-09,18:46:00,23009.75,SELL,3,0.02h,Stop Loss,$-9.00,$270.00,$249519.50,393,$270.00
2025-07-09,18:47:00,23015.5,BUY,3,0.02h,Stop Loss,$-9.00,$261.00,$249510.50,393,$261.00
2025-07-09,18:49:00,23011.5,SELL,3,0.02h,Break Even,$-1.50,$259.50,$249509.00,393,$259.50
2025-07-09,18:51:00,23016.25,BUY,3,0.02h,Stop Loss,$10.50,$270.00,$249519.50,393,$270.00
2025-07-09,19:36:00,23033.75,SELL,3,0.02h,Break Even,$-1.50,$268.50,$249518.00,393,$268.50
2025-07-09,19:38:00,23040.5,BUY,3,0.02h,Break Even,$-1.50,$267.00,$249516.50,393,$267.00
2025-07-09,19:52:00,23031.75,SELL,3,0.02h,Break Even,$-1.50,$265.50,$249515.00,393,$265.50
2025-07-09,19:56:00,23052.5,BUY,3,0.02h,Stop Loss,$-9.00,$256.50,$249506.00,393,$256.50
2025-07-09,20:21:00,23034.25,SELL,3,0.02h,Stop Loss,$-9.00,$247.50,$249497.00,393,$247.50
2025-07-09,20:41:00,23042.75,BUY,3,0.02h,Break Even,$-1.50,$246.00,$249495.50,393,$246.00
2025-07-09,20:45:00,23039.5,SELL,3,0.02h,Break Even,$-1.50,$244.50,$249494.00,393,$244.50
2025-07-09,20:51:00,23042.75,BUY,3,0.02h,Stop Loss,$-9.00,$235.50,$249485.00,393,$235.50
2025-07-09,22:01:00,23035.25,SELL,3,0.02h,Stop Loss,$-9.00,$226.50,$249476.00,393,$226.50
2025-07-09,22:04:00,23045.25,BUY,3,0.02h,Stop Loss,$-9.00,$217.50,$249467.00,393,$217.50
2025-07-09,22:43:00,23056.75,SELL,3,0.02h,Stop Loss,$-9.00,$208.50,$249458.00,393,$208.50
2025-07-09,22:44:00,23059.0,BUY,3,0.02h,Stop Loss,$-9.00,$199.50,$249449.00,393,$199.50
2025-07-09,22:45:00,23057.0,SELL,3,0.02h,Stop Loss,$-9.00,$190.50,$249440.00,393,$190.50
2025-07-09,22:58:00,23058.25,BUY,3,0.03h,Stop Loss,$-9.00,$181.50,$249431.00,393,$181.50
,,,,,,,,,,,
2025-07-10,12:18:00,23057.25,SELL,3,0.02h,Stop Loss,$-9.00,$-9.00,$249422.00,394,$-9.00
2025-07-10,12:21:00,23061.25,BUY,3,0.02h,Break Even,$-1.50,$-10.50,$249420.50,394,$-10.50
2025-07-10,12:22:00,23058.5,SELL,3,0.02h,Stop Loss,$-9.00,$-19.50,$249411.50,394,$-19.50
2025-07-10,13:00:00,23049.25,BUY,3,0.02h,Break Even,$-1.50,$-21.00,$249410.00,394,$-21.00
2025-07-10,13:14:00,23042.25,SELL,3,0.02h,Break Even,$-1.50,$-22.50,$249408.50,394,$-22.50
2025-07-10,13:16:00,23055.0,BUY,3,0.02h,Stop Loss,$-9.00,$-31.50,$249399.50,394,$-31.50
2025-07-10,13:34:00,23035.25,SELL,3,0.02h,Stop Loss,$58.50,$27.00,$249458.00,394,$27.00
2025-07-10,14:20:00,22964.0,BUY,3,0.02h,Break Even,$-1.50,$25.50,$249456.50,394,$25.50
2025-07-10,14:21:00,22945.0,SELL,3,0.02h,Stop Loss,$70.50,$96.00,$249527.00,394,$96.00
2025-07-10,14:37:00,22956.0,BUY,3,0.02h,Stop Loss,$24.00,$120.00,$249551.00,394,$120.00
2025-07-10,15:01:00,22962.25,SELL,3,0.02h,Break Even,$-1.50,$118.50,$249549.50,394,$118.50
2025-07-10,15:02:00,22971.25,BUY,3,0.02h,Stop Loss,$12.00,$130.50,$249561.50,394,$130.50
2025-07-10,15:10:00,22965.75,SELL,3,0.02h,Stop Loss,$85.50,$216.00,$249647.00,394,$216.00
2025-07-10,15:24:00,22971.75,BUY,3,0.02h,Stop Loss,$31.50,$247.50,$249678.50,394,$247.50
2025-07-10,16:07:00,23003.0,SELL,3,0.02h,Break Even,$-1.50,$246.00,$249677.00,394,$246.00
2025-07-10,16:26:00,23005.75,BUY,3,0.02h,Stop Loss,$3.00,$249.00,$249680.00,394,$249.00
2025-07-10,16:37:00,22989.25,SELL,3,0.02h,Stop Loss,$-9.00,$240.00,$249671.00,394,$240.00
2025-07-10,16:41:00,23003.5,BUY,3,0.02h,Break Even,$-1.50,$238.50,$249669.50,394,$238.50
2025-07-10,16:50:00,22990.0,SELL,3,0.02h,Stop Loss,$-9.00,$229.50,$249660.50,394,$229.50
2025-07-10,16:51:00,23002.75,BUY,3,0.02h,Stop Loss,$-9.00,$220.50,$249651.50,394,$220.50
2025-07-10,16:52:00,22997.5,SELL,3,0.02h,Break Even,$-1.50,$219.00,$249650.00,394,$219.00
2025-07-10,16:58:00,23000.0,BUY,3,0.02h,Stop Loss,$-9.00,$210.00,$249641.00,394,$210.00
2025-07-10,17:00:00,22992.25,SELL,3,0.02h,Break Even,$-1.50,$208.50,$249639.50,394,$208.50
2025-07-10,17:02:00,23002.0,BUY,3,0.02h,Stop Loss,$10.50,$219.00,$249650.00,394,$219.00
2025-07-10,17:03:00,22998.25,SELL,3,0.02h,Break Even,$-1.50,$217.50,$249648.50,394,$217.50
2025-07-10,17:04:00,23000.75,BUY,3,0.02h,Break Even,$-1.50,$216.00,$249647.00,394,$216.00
2025-07-10,17:09:00,22998.0,SELL,3,0.02h,Stop Loss,$-9.00,$207.00,$249638.00,394,$207.00
2025-07-10,17:10:00,23000.25,BUY,3,0.02h,Stop Loss,$16.50,$223.50,$249654.50,394,$223.50
2025-07-10,17:15:00,22996.75,SELL,3,0.02h,Stop Loss,$6.00,$229.50,$249660.50,394,$229.50
2025-07-10,17:21:00,23002.25,BUY,3,0.02h,Stop Loss,$3.00,$232.50,$249663.50,394,$232.50
2025-07-10,18:29:00,23033.75,SELL,3,0.02h,Break Even,$-1.50,$231.00,$249662.00,394,$231.00
2025-07-10,18:59:00,23042.25,BUY,3,0.02h,Stop Loss,$-9.00,$222.00,$249653.00,394,$222.00
2025-07-10,19:16:00,23036.0,SELL,3,0.02h,Break Even,$-1.50,$220.50,$249651.50,394,$220.50
2025-07-10,19:18:00,23038.75,BUY,3,0.02h,Stop Loss,$-9.00,$211.50,$249642.50,394,$211.50
2025-07-10,19:20:00,23034.25,SELL,3,0.02h,Stop Loss,$-9.00,$202.50,$249633.50,394,$202.50
2025-07-10,19:37:00,23037.25,BUY,3,0.02h,Stop Loss,$-9.00,$193.50,$249624.50,394,$193.50
2025-07-10,19:47:00,23028.5,SELL,3,0.02h,Break Even,$-1.50,$192.00,$249623.00,394,$192.00
2025-07-10,20:31:00,23012.75,BUY,3,0.02h,Break Even,$-1.50,$190.50,$249621.50,394,$190.50
2025-07-10,20:53:00,23011.0,SELL,3,0.02h,Stop Loss,$-9.00,$181.50,$249612.50,394,$181.50
2025-07-10,22:05:00,23022.5,BUY,3,0.02h,Break Even,$-1.50,$180.00,$249611.00,394,$180.00
2025-07-10,22:35:00,23026.75,SELL,3,0.02h,Stop Loss,$-9.00,$171.00,$249602.00,394,$171.00
2025-07-10,22:45:00,23028.75,BUY,3,0.02h,Break Even,$-1.50,$169.50,$249600.50,394,$169.50
,,,,,,,,,,,
2025-07-11,12:00:00,22908.75,SELL,3,0.02h,Stop Loss,$18.00,$18.00,$249618.50,395,$18.00
2025-07-11,12:49:00,22906.0,BUY,3,0.02h,Stop Loss,$16.50,$34.50,$249635.00,395,$34.50
2025-07-11,13:09:00,22901.5,SELL,3,0.02h,Break Even,$-1.50,$33.00,$249633.50,395,$33.00
2025-07-11,13:29:00,22907.75,BUY,3,0.02h,Stop Loss,$54.00,$87.00,$249687.50,395,$87.00
2025-07-11,13:40:00,22892.75,SELL,3,0.02h,Stop Loss,$48.00,$135.00,$249735.50,395,$135.00
2025-07-11,13:50:00,22936.0,BUY,3,0.02h,Stop Loss,$27.00,$162.00,$249762.50,395,$162.00
2025-07-11,14:44:00,22984.25,SELL,3,0.02h,Stop Loss,$7.50,$169.50,$249770.00,395,$169.50
2025-07-11,15:31:00,22957.25,BUY,3,0.02h,Stop Loss,$9.00,$178.50,$249779.00,395,$178.50
2025-07-11,15:57:00,22964.25,SELL,3,0.02h,Stop Loss,$-9.00,$169.50,$249770.00,395,$169.50
2025-07-11,16:01:00,22994.25,BUY,3,0.02h,Stop Loss,$-9.00,$160.50,$249761.00,395,$160.50
2025-07-11,16:05:00,22972.25,SELL,3,0.02h,Stop Loss,$9.00,$169.50,$249770.00,395,$169.50
2025-07-11,16:17:00,22992.25,BUY,3,0.02h,Stop Loss,$-9.00,$160.50,$249761.00,395,$160.50
2025-07-11,16:44:00,22974.75,SELL,3,0.02h,Break Even,$-1.50,$159.00,$249759.50,395,$159.00
2025-07-11,16:54:00,22989.75,BUY,3,0.02h,Stop Loss,$9.00,$168.00,$249768.50,395,$168.00
2025-07-11,17:32:00,23000.0,SELL,3,0.02h,Stop Loss,$21.00,$189.00,$249789.50,395,$189.00
2025-07-11,17:54:00,22996.0,BUY,3,0.02h,Break Even,$-1.50,$187.50,$249788.00,395,$187.50
2025-07-11,18:21:00,22996.5,SELL,3,0.02h,Break Even,$-1.50,$186.00,$249786.50,395,$186.00
2025-07-11,18:23:00,23001.25,BUY,3,0.02h,Break Even,$-1.50,$184.50,$249785.00,395,$184.50
2025-07-11,18:24:00,22999.25,SELL,3,0.02h,Break Even,$-1.50,$183.00,$249783.50,395,$183.00
2025-07-11,18:25:00,23003.0,BUY,3,0.02h,Break Even,$-1.50,$181.50,$249782.00,395,$181.50
2025-07-11,18:31:00,22999.25,SELL,3,0.02h,Break Even,$-1.50,$180.00,$249780.50,395,$180.00
2025-07-11,18:32:00,23004.75,BUY,3,0.02h,Break Even,$-1.50,$178.50,$249779.00,395,$178.50
2025-07-11,18:50:00,23002.25,SELL,3,0.02h,Break Even,$-1.50,$177.00,$249777.50,395,$177.00
2025-07-11,19:19:00,22983.75,BUY,3,0.02h,Break Even,$-1.50,$175.50,$249776.00,395,$175.50
2025-07-11,19:35:00,22979.0,SELL,3,0.02h,Break Even,$-1.50,$174.00,$249774.50,395,$174.00
2025-07-11,20:52:00,22941.5,BUY,3,0.02h,Break Even,$-1.50,$172.50,$249773.00,395,$172.50
,,,,,,,,,,,
2025-07-14,12:00:00,22887.0,SELL,3,0.02h,Stop Loss,$19.50,$19.50,$249792.50,396,$19.50
2025-07-14,12:26:00,22907.75,BUY,3,0.02h,Break Even,$-1.50,$18.00,$249791.00,396,$18.00
2025-07-14,12:34:00,22889.75,SELL,3,0.02h,Stop Loss,$-9.00,$9.00,$249782.00,396,$9.00
2025-07-14,12:42:00,22901.0,BUY,3,0.02h,Break Even,$-1.50,$7.50,$249780.50,396,$7.50
2025-07-14,12:43:00,22898.75,SELL,3,0.02h,Stop Loss,$-9.00,$-1.50,$249771.50,396,$-1.50
2025-07-14,12:44:00,22905.25,BUY,3,0.02h,Break Even,$-1.50,$-3.00,$249770.00,396,$-3.00
2025-07-14,12:59:00,22895.25,SELL,3,0.02h,Stop Loss,$-9.00,$-12.00,$249761.00,396,$-12.00
2025-07-14,13:15:00,22904.75,BUY,3,0.02h,Break Even,$-1.50,$-13.50,$249759.50,396,$-13.50
2025-07-14,13:43:00,22878.75,SELL,3,0.02h,Stop Loss,$127.50,$114.00,$249887.00,396,$114.00
2025-07-14,13:53:00,22921.75,BUY,3,0.02h,Stop Loss,$21.00,$135.00,$249908.00,396,$135.00
2025-07-14,14:32:00,22937.75,SELL,3,0.02h,Stop Loss,$70.50,$205.50,$249978.50,396,$205.50
2025-07-14,14:44:00,22956.0,BUY,3,0.02h,Break Even,$-1.50,$204.00,$249977.00,396,$204.00
2025-07-14,15:36:00,23000.25,SELL,3,0.02h,Stop Loss,$-9.00,$195.00,$249968.00,396,$195.00
2025-07-14,15:37:00,23009.75,BUY,3,0.02h,Stop Loss,$4.50,$199.50,$249972.50,396,$199.50
2025-07-14,15:47:00,22996.0,SELL,3,0.02h,Stop Loss,$-9.00,$190.50,$249963.50,396,$190.50
2025-07-14,15:52:00,23008.25,BUY,3,0.02h,Stop Loss,$-9.00,$181.50,$249954.50,396,$181.50
2025-07-14,15:56:00,22996.75,SELL,3,0.02h,Stop Loss,$-9.00,$172.50,$249945.50,396,$172.50
2025-07-14,16:00:00,23008.75,BUY,3,0.02h,Stop Loss,$-9.00,$163.50,$249936.50,396,$163.50
2025-07-14,16:03:00,23004.25,SELL,3,0.02h,Stop Loss,$6.00,$169.50,$249942.50,396,$169.50
2025-07-14,16:08:00,23016.0,BUY,3,0.02h,Break Even,$-1.50,$168.00,$249941.00,396,$168.00
2025-07-14,16:30:00,23015.25,SELL,3,0.02h,Stop Loss,$3.00,$171.00,$249944.00,396,$171.00
2025-07-14,16:42:00,23027.0,BUY,3,0.02h,Stop Loss,$-9.00,$162.00,$249935.00,396,$162.00
2025-07-14,17:43:00,23047.25,SELL,3,0.02h,Stop Loss,$-9.00,$153.00,$249926.00,396,$153.00
2025-07-14,17:54:00,23054.75,BUY,3,0.02h,Stop Loss,$-9.00,$144.00,$249917.00,396,$144.00
2025-07-14,17:57:00,23047.5,SELL,3,0.02h,Break Even,$-1.50,$142.50,$249915.50,396,$142.50
2025-07-14,18:28:00,23048.5,BUY,3,0.02h,Break Even,$-1.50,$141.00,$249914.00,396,$141.00
2025-07-14,19:09:00,23045.25,SELL,3,0.02h,Break Even,$-1.50,$139.50,$249912.50,396,$139.50
2025-07-14,19:59:00,23039.25,BUY,3,0.02h,Break Even,$-1.50,$138.00,$249911.00,396,$138.00
2025-07-14,20:01:00,23023.75,SELL,3,0.02h,Break Even,$-1.50,$136.50,$249909.50,396,$136.50
2025-07-14,20:02:00,23032.5,BUY,3,0.02h,Break Even,$-1.50,$135.00,$249908.00,396,$135.00
2025-07-14,20:03:00,23029.75,SELL,3,0.02h,Break Even,$-1.50,$133.50,$249906.50,396,$133.50
2025-07-14,20:21:00,23031.0,BUY,3,0.02h,Stop Loss,$-9.00,$124.50,$249897.50,396,$124.50
2025-07-14,20:27:00,23025.25,SELL,3,0.02h,Break Even,$-1.50,$123.00,$249896.00,396,$123.00
2025-07-14,20:41:00,23028.75,BUY,3,0.03h,Break Even,$-1.50,$121.50,$249894.50,396,$121.50
2025-07-14,22:02:00,23022.0,SELL,3,0.02h,Stop Loss,$-9.00,$112.50,$249885.50,396,$112.50
2025-07-14,22:53:00,23011.5,BUY,3,0.03h,Stop Loss,$-9.00,$103.50,$249876.50,396,$103.50
2025-07-14,22:58:00,23002.25,SELL,3,0.02h,Break Even,$-1.50,$102.00,$249875.00,396,$102.00
,,,,,,,,,,,
2025-07-15,12:00:00,23167.0,BUY,3,0.02h,Stop Loss,$12.00,$12.00,$249887.00,397,$12.00
2025-07-15,13:33:00,23191.75,SELL,3,0.02h,Stop Loss,$105.00,$117.00,$249992.00,397,$117.00
2025-07-15,14:10:00,23162.75,BUY,3,0.02h,Stop Loss,$31.50,$148.50,$250023.50,397,$148.50
2025-07-15,14:33:00,23165.0,SELL,3,0.02h,Stop Loss,$15.00,$163.50,$250038.50,397,$163.50
2025-07-15,15:12:00,23140.75,BUY,3,0.02h,Stop Loss,$13.50,$177.00,$250052.00,397,$177.00
2025-07-15,15:57:00,23156.0,SELL,3,0.02h,Break Even,$-1.50,$175.50,$250050.50,397,$175.50
2025-07-15,16:33:00,23154.0,BUY,3,0.02h,Break Even,$-1.50,$174.00,$250049.00,397,$174.00
2025-07-15,16:35:00,23140.75,SELL,3,0.02h,Break Even,$-1.50,$172.50,$250047.50,397,$172.50
2025-07-15,16:53:00,23144.0,BUY,3,0.02h,Stop Loss,$-9.00,$163.50,$250038.50,397,$163.50
2025-07-15,16:54:00,23138.5,SELL,3,0.02h,Stop Loss,$69.00,$232.50,$250107.50,397,$232.50
2025-07-15,17:28:00,23115.5,BUY,3,0.02h,Stop Loss,$3.00,$235.50,$250110.50,397,$235.50
2025-07-15,18:35:00,23168.75,SELL,3,0.02h,Stop Loss,$63.00,$298.50,$250173.50,397,$298.50
2025-07-15,19:42:00,23109.0,BUY,3,0.02h,Stop Loss,$3.00,$301.50,$250176.50,397,$301.50
2025-07-15,19:54:00,23094.0,SELL,3,0.02h,Stop Loss,$13.50,$315.00,$250190.00,397,$315.00
2025-07-15,22:01:00,23027.0,BUY,3,0.02h,Break Even,$-1.50,$313.50,$250188.50,397,$313.50
2025-07-15,22:11:00,23011.5,SELL,3,0.02h,Stop Loss,$-9.00,$304.50,$250179.50,397,$304.50
2025-07-15,22:51:00,23002.75,BUY,3,0.02h,Stop Loss,$-9.00,$295.50,$250170.50,397,$295.50
,,,,,,,,,,,
2025-07-16,13:04:00,23060.5,SELL,3,0.02h,Stop Loss,$-9.00,$-9.00,$250161.50,398,$-9.00
2025-07-16,13:11:00,23071.25,BUY,3,0.02h,Break Even,$-1.50,$-10.50,$250160.00,398,$-10.50
2025-07-16,13:17:00,23065.5,SELL,3,0.02h,Break Even,$-1.50,$-12.00,$250158.50,398,$-12.00
2025-07-16,13:19:00,23069.75,BUY,3,0.02h,Break Even,$-1.50,$-13.50,$250157.00,398,$-13.50
2025-07-16,13:32:00,23048.5,SELL,3,0.02h,Stop Loss,$69.00,$55.50,$250226.00,398,$55.50
2025-07-16,14:14:00,22992.25,BUY,3,0.02h,Stop Loss,$-9.00,$46.50,$250217.00,398,$46.50
2025-07-16,14:15:00,22975.5,SELL,3,0.02h,Stop Loss,$48.00,$94.50,$250265.00,398,$94.50
2025-07-16,14:20:00,22993.5,BUY,3,0.02h,Break Even,$-1.50,$93.00,$250263.50,398,$93.00
2025-07-16,14:56:00,22993.25,SELL,3,0.02h,Stop Loss,$55.50,$148.50,$250319.00,398,$148.50
2025-07-16,14:57:00,23010.75,BUY,3,0.02h,Break Even,$-1.50,$147.00,$250317.50,398,$147.00
2025-07-16,14:58:00,22992.0,SELL,3,0.02h,Stop Loss,$156.00,$303.00,$250473.50,398,$303.00
2025-07-16,15:05:00,23016.75,BUY,3,0.02h,Break Even,$-1.50,$301.50,$250472.00,398,$301.50
2025-07-16,15:18:00,22983.0,SELL,3,0.02h,Stop Loss,$57.00,$358.50,$250529.00,398,$358.50
2025-07-16,15:48:00,22946.25,BUY,3,0.02h,Break Even,$-1.50,$357.00,$250527.50,398,$357.00
2025-07-16,16:24:00,22971.0,SELL,3,0.02h,Break Even,$-1.50,$355.50,$250526.00,398,$355.50
2025-07-16,16:30:00,22983.0,BUY,3,0.02h,Break Even,$-1.50,$354.00,$250524.50,398,$354.00
2025-07-16,16:48:00,22978.25,SELL,3,0.02h,Stop Loss,$-9.00,$345.00,$250515.50,398,$345.00
2025-07-16,16:49:00,22996.75,BUY,3,0.02h,Stop Loss,$36.00,$381.00,$250551.50,398,$381.00
2025-07-16,17:30:00,23040.0,SELL,3,0.02h,Stop Loss,$4.50,$385.50,$250556.00,398,$385.50
2025-07-16,18:17:00,23042.0,BUY,3,0.02h,Stop Loss,$-9.00,$376.50,$250547.00,398,$376.50
2025-07-16,18:20:00,23026.5,SELL,3,0.02h,Stop Loss,$40.50,$417.00,$250587.50,398,$417.00
2025-07-16,18:23:00,23037.75,BUY,3,0.02h,Break Even,$-1.50,$415.50,$250586.00,398,$415.50
2025-07-16,19:17:00,23062.75,SELL,3,0.02h,Break Even,$-1.50,$414.00,$250584.50,398,$414.00
2025-07-16,19:27:00,23071.0,BUY,3,0.02h,Stop Loss,$-9.00,$405.00,$250575.50,398,$405.00
2025-07-16,20:00:00,23075.0,SELL,3,0.02h,Stop Loss,$46.50,$451.50,$250622.00,398,$451.50
2025-07-16,20:40:00,23065.0,BUY,3,0.02h,Stop Loss,$-9.00,$442.50,$250613.00,398,$442.50
2025-07-16,20:53:00,23060.75,SELL,3,0.02h,Stop Loss,$-9.00,$433.50,$250604.00,398,$433.50
2025-07-16,22:01:00,23064.5,BUY,3,0.02h,Stop Loss,$-9.00,$424.50,$250595.00,398,$424.50
2025-07-16,22:02:00,23061.5,SELL,3,0.02h,Stop Loss,$6.00,$430.50,$250601.00,398,$430.50
,,,,,,,,,,,
2025-07-17,12:00:00,23086.75,BUY,3,0.02h,Stop Loss,$31.50,$31.50,$250632.50,399,$31.50
2025-07-17,13:17:00,23129.5,SELL,3,0.02h,Stop Loss,$19.50,$51.00,$250652.00,399,$51.00
2025-07-17,13:44:00,23118.75,BUY,3,0.02h,Stop Loss,$22.50,$73.50,$250674.50,399,$73.50
2025-07-17,14:18:00,23145.0,SELL,3,0.02h,Stop Loss,$28.50,$102.00,$250703.00,399,$102.00
2025-07-17,14:31:00,23154.0,BUY,3,0.02h,Stop Loss,$-9.00,$93.00,$250694.00,399,$93.00
2025-07-17,15:35:00,23219.75,SELL,3,0.02h,Break Even,$-1.50,$91.50,$250692.50,399,$91.50
2025-07-17,15:37:00,23225.75,BUY,3,0.02h,Break Even,$-1.50,$90.00,$250691.00,399,$90.00
2025-07-17,16:40:00,23250.25,SELL,3,0.02h,Break Even,$-1.50,$88.50,$250689.50,399,$88.50
2025-07-17,16:49:00,23259.75,BUY,3,0.02h,Break Even,$-1.50,$87.00,$250688.00,399,$87.00
2025-07-17,16:57:00,23252.0,SELL,3,0.02h,Stop Loss,$-9.00,$78.00,$250679.00,399,$78.00
2025-07-17,17:15:00,23259.0,BUY,3,0.02h,Break Even,$-1.50,$76.50,$250677.50,399,$76.50
2025-07-17,17:28:00,23249.0,SELL,3,0.02h,Stop Loss,$30.00,$106.50,$250707.50,399,$106.50
2025-07-17,17:32:00,23260.0,BUY,3,0.02h,Break Even,$-1.50,$105.00,$250706.00,399,$105.00
2025-07-17,17:34:00,23255.0,SELL,3,0.02h,Stop Loss,$-9.00,$96.00,$250697.00,399,$96.00
2025-07-17,17:35:00,23258.0,BUY,3,0.02h,Break Even,$-1.50,$94.50,$250695.50,399,$94.50
2025-07-17,18:07:00,23256.0,SELL,3,0.02h,Stop Loss,$15.00,$109.50,$250710.50,399,$109.50
2025-07-17,18:30:00,23256.0,BUY,3,0.02h,Break Even,$-1.50,$108.00,$250709.00,399,$108.00
2025-07-17,18:37:00,23249.5,SELL,3,0.02h,Break Even,$-1.50,$106.50,$250707.50,399,$106.50
2025-07-17,18:39:00,23256.5,BUY,3,0.02h,Break Even,$-1.50,$105.00,$250706.00,399,$105.00
2025-07-17,19:00:00,23252.5,SELL,3,0.02h,Break Even,$-1.50,$103.50,$250704.50,399,$103.50
2025-07-17,19:02:00,23258.5,BUY,3,0.02h,Stop Loss,$27.00,$130.50,$250731.50,399,$130.50
2025-07-17,19:19:00,23259.5,SELL,3,0.02h,Stop Loss,$-9.00,$121.50,$250722.50,399,$121.50
2025-07-17,19:20:00,23261.75,BUY,3,0.02h,Break Even,$-1.50,$120.00,$250721.00,399,$120.00
2025-07-17,19:27:00,23259.75,SELL,3,0.02h,Stop Loss,$-9.00,$111.00,$250712.00,399,$111.00
2025-07-17,19:30:00,23261.75,BUY,3,0.02h,Stop Loss,$10.50,$121.50,$250722.50,399,$121.50
2025-07-17,19:44:00,23257.25,SELL,3,0.02h,Break Even,$-1.50,$120.00,$250721.00,399,$120.00
2025-07-17,19:54:00,23270.25,BUY,3,0.02h,Stop Loss,$27.00,$147.00,$250748.00,399,$147.00
2025-07-17,19:56:00,23256.0,SELL,3,0.02h,Stop Loss,$30.00,$177.00,$250778.00,399,$177.00
2025-07-17,20:15:00,23255.5,BUY,3,0.02h,Break Even,$-1.50,$175.50,$250776.50,399,$175.50
2025-07-17,20:52:00,23264.0,SELL,3,0.02h,Stop Loss,$-9.00,$166.50,$250767.50,399,$166.50
2025-07-17,20:57:00,23267.0,BUY,3,0.03h,Break Even,$-1.50,$165.00,$250766.00,399,$165.00
2025-07-17,21:00:00,23265.5,SELL,3,1.02h,Stop Loss,$99.00,$264.00,$250865.00,399,$264.00
2025-07-17,22:22:00,23261.0,BUY,3,0.02h,Stop Loss,$-9.00,$255.00,$250856.00,399,$255.00
2025-07-17,22:23:00,23256.0,SELL,3,0.02h,Stop Loss,$-9.00,$246.00,$250847.00,399,$246.00
2025-07-17,22:24:00,23258.25,BUY,3,0.02h,Stop Loss,$-9.00,$237.00,$250838.00,399,$237.00
2025-07-17,22:32:00,23254.0,SELL,3,0.02h,Break Even,$-1.50,$235.50,$250836.50,399,$235.50
2025-07-17,22:55:00,23257.0,BUY,3,0.02h,Stop Loss,$-9.00,$226.50,$250827.50,399,$226.50
,,,,,,,,,,,
2025-07-18,12:32:00,23258.5,SELL,3,0.02h,Stop Loss,$-9.00,$-9.00,$250818.50,400,$-9.00
2025-07-18,12:33:00,23263.25,BUY,3,0.02h,Break Even,$-1.50,$-10.50,$250817.00,400,$-10.50
2025-07-18,12:34:00,23260.25,SELL,3,0.02h,Break Even,$-1.50,$-12.00,$250815.50,400,$-12.00
2025-07-18,12:40:00,23267.0,BUY,3,0.02h,Stop Loss,$-9.00,$-21.00,$250806.50,400,$-21.00
2025-07-18,12:44:00,23260.25,SELL,3,0.02h,Stop Loss,$-9.00,$-30.00,$250797.50,400,$-30.00
2025-07-18,12:45:00,23265.25,BUY,3,0.02h,Stop Loss,$-9.00,$-39.00,$250788.50,400,$-39.00
2025-07-18,13:18:00,23264.5,SELL,3,0.02h,Stop Loss,$6.00,$-33.00,$250794.50,400,$-33.00
2025-07-18,13:27:00,23278.0,BUY,3,0.02h,Stop Loss,$90.00,$57.00,$250884.50,400,$57.00
2025-07-18,13:39:00,23261.25,SELL,3,0.02h,Stop Loss,$3.00,$60.00,$250887.50,400,$60.00
2025-07-18,13:48:00,23292.75,BUY,3,0.02h,Stop Loss,$9.00,$69.00,$250896.50,400,$69.00
2025-07-18,13:54:00,23269.25,SELL,3,0.02h,Stop Loss,$12.00,$81.00,$250908.50,400,$81.00
2025-07-18,14:45:00,23223.75,BUY,3,0.02h,Stop Loss,$22.50,$103.50,$250931.00,400,$103.50
2025-07-18,14:50:00,23209.75,SELL,3,0.02h,Break Even,$-1.50,$102.00,$250929.50,400,$102.00
2025-07-18,14:51:00,23215.5,BUY,3,0.02h,Stop Loss,$6.00,$108.00,$250935.50,400,$108.00
2025-07-18,15:00:00,23205.0,SELL,3,0.02h,Stop Loss,$31.50,$139.50,$250967.00,400,$139.50
2025-07-18,15:17:00,23215.75,BUY,3,0.02h,Break Even,$-1.50,$138.00,$250965.50,400,$138.00
2025-07-18,15:24:00,23202.25,SELL,3,0.02h,Stop Loss,$-9.00,$129.00,$250956.50,400,$129.00
2025-07-18,15:28:00,23213.5,BUY,3,0.02h,Stop Loss,$4.50,$133.50,$250961.00,400,$133.50
2025-07-18,16:08:00,23230.75,SELL,3,0.02h,Break Even,$-1.50,$132.00,$250959.50,400,$132.00
2025-07-18,16:46:00,23212.5,BUY,3,0.02h,Break Even,$-1.50,$130.50,$250958.00,400,$130.50
2025-07-18,16:49:00,23191.5,SELL,3,0.02h,Stop Loss,$-9.00,$121.50,$250949.00,400,$121.50
2025-07-18,16:52:00,23211.25,BUY,3,0.02h,Stop Loss,$-9.00,$112.50,$250940.00,400,$112.50
2025-07-18,16:54:00,23194.75,SELL,3,0.02h,Stop Loss,$-9.00,$103.50,$250931.00,400,$103.50
2025-07-18,17:15:00,23204.5,BUY,3,0.02h,Break Even,$-1.50,$102.00,$250929.50,400,$102.00
2025-07-18,17:47:00,23199.25,SELL,3,0.02h,Stop Loss,$15.00,$117.00,$250944.50,400,$117.00
2025-07-18,18:03:00,23213.75,BUY,3,0.02h,Stop Loss,$-9.00,$108.00,$250935.50,400,$108.00
2025-07-18,18:13:00,23200.0,SELL,3,0.02h,Break Even,$-1.50,$106.50,$250934.00,400,$106.50
2025-07-18,18:21:00,23211.0,BUY,3,0.02h,Stop Loss,$-9.00,$97.50,$250925.00,400,$97.50
2025-07-18,18:53:00,23210.5,SELL,3,0.02h,Stop Loss,$22.50,$120.00,$250947.50,400,$120.00
2025-07-18,19:13:00,23211.25,BUY,3,0.02h,Stop Loss,$-9.00,$111.00,$250938.50,400,$111.00
2025-07-18,19:31:00,23213.25,SELL,3,0.02h,Stop Loss,$24.00,$135.00,$250962.50,400,$135.00
2025-07-18,19:49:00,23213.25,BUY,3,0.02h,Break Even,$-1.50,$133.50,$250961.00,400,$133.50
2025-07-18,20:26:00,23219.75,SELL,3,0.02h,Break Even,$-1.50,$132.00,$250959.50,400,$132.00
2025-07-18,20:35:00,23225.25,BUY,3,0.03h,Break Even,$-1.50,$130.50,$250958.00,400,$130.50
2025-07-18,20:46:00,23221.5,SELL,3,0.02h,Break Even,$-1.50,$129.00,$250956.50,400,$129.00
2025-07-18,20:54:00,23224.0,BUY,3,0.02h,Stop Loss,$-9.00,$120.00,$250947.50,400,$120.00
,,,,,,,,,,,
2025-07-21,12:42:00,23267.5,SELL,3,0.02h,Break Even,$-1.50,$-1.50,$250946.00,401,$-1.50
2025-07-21,13:23:00,23244.25,BUY,3,0.02h,Break Even,$-1.50,$-3.00,$250944.50,401,$-3.00
2025-07-21,14:46:00,23397.75,SELL,3,0.02h,Stop Loss,$-9.00,$-12.00,$250935.50,401,$-12.00
2025-07-21,15:27:00,23396.5,BUY,3,0.02h,Break Even,$-1.50,$-13.50,$250934.00,401,$-13.50
2025-07-21,15:56:00,23394.75,SELL,3,0.02h,Stop Loss,$25.50,$12.00,$250959.50,401,$12.00
2025-07-21,16:32:00,23384.5,BUY,3,0.02h,Break Even,$-1.50,$10.50,$250958.00,401,$10.50
2025-07-21,17:43:00,23411.75,SELL,3,0.02h,Stop Loss,$-9.00,$1.50,$250949.00,401,$1.50
2025-07-21,17:49:00,23417.75,BUY,3,0.02h,Break Even,$-1.50,$0.00,$250947.50,401,$0.00
2025-07-21,18:00:00,23411.75,SELL,3,0.02h,Stop Loss,$10.50,$10.50,$250958.00,401,$10.50
2025-07-21,18:24:00,23416.5,BUY,3,0.02h,Stop Loss,$-9.00,$1.50,$250949.00,401,$1.50
2025-07-21,18:31:00,23409.25,SELL,3,0.02h,Stop Loss,$6.00,$7.50,$250955.00,401,$7.50
2025-07-21,20:18:00,23352.25,BUY,3,0.02h,Break Even,$-1.50,$6.00,$250953.50,401,$6.00
2025-07-21,20:27:00,23343.75,SELL,3,0.02h,Break Even,$-1.50,$4.50,$250952.00,401,$4.50
2025-07-21,20:55:00,23346.5,BUY,3,0.02h,Stop Loss,$-9.00,$-4.50,$250943.00,401,$-4.50
2025-07-21,20:58:00,23345.0,SELL,3,0.03h,Stop Loss,$-9.00,$-13.50,$250934.00,401,$-13.50
2025-07-21,21:00:00,23346.75,BUY,3,1.02h,Stop Loss,$-9.00,$-22.50,$250925.00,401,$-22.50
2025-07-21,22:08:00,23345.0,SELL,3,0.02h,Stop Loss,$-9.00,$-31.50,$250916.00,401,$-31.50
2025-07-21,22:26:00,23349.0,BUY,3,0.02h,Stop Loss,$-9.00,$-40.50,$250907.00,401,$-40.50
2025-07-21,22:39:00,23344.25,SELL,3,0.02h,Stop Loss,$-9.00,$-49.50,$250898.00,401,$-49.50
2025-07-21,22:50:00,23346.5,BUY,3,0.02h,Stop Loss,$-9.00,$-58.50,$250889.00,401,$-58.50
2025-07-21,22:53:00,23343.75,SELL,3,0.02h,Stop Loss,$-9.00,$-67.50,$250880.00,401,$-67.50
,,,,,,,,,,,
2025-07-22,12:29:00,23338.0,BUY,3,0.02h,Break Even,$-1.50,$-1.50,$250878.50,402,$-1.50
2025-07-22,12:44:00,23329.0,SELL,3,0.02h,Break Even,$-1.50,$-3.00,$250877.00,402,$-3.00
2025-07-22,12:52:00,23333.75,BUY,3,0.02h,Break Even,$-1.50,$-4.50,$250875.50,402,$-4.50
2025-07-22,13:23:00,23334.25,SELL,3,0.02h,Break Even,$-1.50,$-6.00,$250874.00,402,$-6.00
2025-07-22,13:27:00,23339.5,BUY,3,0.02h,Stop Loss,$-9.00,$-15.00,$250865.00,402,$-15.00
2025-07-22,13:28:00,23333.75,SELL,3,0.02h,Stop Loss,$-9.00,$-24.00,$250856.00,402,$-24.00
2025-07-22,13:29:00,23341.5,BUY,3,0.02h,Stop Loss,$12.00,$-12.00,$250868.00,402,$-12.00
2025-07-22,13:31:00,23319.25,SELL,3,0.02h,Stop Loss,$139.50,$127.50,$251007.50,402,$127.50
2025-07-22,14:16:00,23195.5,BUY,3,0.02h,Break Even,$-1.50,$126.00,$251006.00,402,$126.00
2025-07-22,14:25:00,23163.5,SELL,3,0.02h,Stop Loss,$-9.00,$117.00,$250997.00,402,$117.00
2025-07-22,14:32:00,23197.5,BUY,3,0.02h,Stop Loss,$-9.00,$108.00,$250988.00,402,$108.00
2025-07-22,15:16:00,23209.0,SELL,3,0.02h,Stop Loss,$48.00,$156.00,$251036.00,402,$156.00
2025-07-22,15:34:00,23223.0,BUY,3,0.02h,Stop Loss,$52.50,$208.50,$251088.50,402,$208.50
2025-07-22,15:56:00,23217.5,SELL,3,0.02h,Stop Loss,$48.00,$256.50,$251136.50,402,$256.50
2025-07-22,16:18:00,23222.75,BUY,3,0.02h,Break Even,$-1.50,$255.00,$251135.00,402,$255.00
2025-07-22,16:25:00,23202.75,SELL,3,0.02h,Stop Loss,$79.50,$334.50,$251214.50,402,$334.50
2025-07-22,16:53:00,23195.25,BUY,3,0.02h,Break Even,$-1.50,$333.00,$251213.00,402,$333.00
2025-07-22,17:44:00,23223.5,SELL,3,0.02h,Break Even,$-1.50,$331.50,$251211.50,402,$331.50
2025-07-22,18:03:00,23226.75,BUY,3,0.02h,Break Even,$-1.50,$330.00,$251210.00,402,$330.00
2025-07-22,18:07:00,23218.5,SELL,3,0.02h,Stop Loss,$-9.00,$321.00,$251201.00,402,$321.00
2025-07-22,18:08:00,23224.0,BUY,3,0.02h,Break Even,$-1.50,$319.50,$251199.50,402,$319.50
2025-07-22,18:16:00,23215.0,SELL,3,0.02h,Stop Loss,$6.00,$325.50,$251205.50,402,$325.50
2025-07-22,18:28:00,23221.75,BUY,3,0.02h,Stop Loss,$-9.00,$316.50,$251196.50,402,$316.50
2025-07-22,19:10:00,23242.0,SELL,3,0.02h,Stop Loss,$-9.00,$307.50,$251187.50,402,$307.50
2025-07-22,19:27:00,23243.5,BUY,3,0.02h,Stop Loss,$-9.00,$298.50,$251178.50,402,$298.50
2025-07-22,19:31:00,23235.75,SELL,3,0.02h,Stop Loss,$-9.00,$289.50,$251169.50,402,$289.50
2025-07-22,19:34:00,23246.0,BUY,3,0.02h,Break Even,$-1.50,$288.00,$251168.00,402,$288.00
2025-07-22,19:46:00,23240.0,SELL,3,0.02h,Stop Loss,$13.50,$301.50,$251181.50,402,$301.50
2025-07-22,20:49:00,23197.5,BUY,3,0.02h,Stop Loss,$-9.00,$292.50,$251172.50,402,$292.50
2025-07-22,20:50:00,23195.75,SELL,3,0.02h,Break Even,$-1.50,$291.00,$251171.00,402,$291.00
2025-07-22,22:01:00,23203.0,BUY,3,0.02h,Break Even,$-1.50,$289.50,$251169.50,402,$289.50
2025-07-22,22:10:00,23192.0,SELL,3,0.02h,Stop Loss,$19.50,$309.00,$251189.00,402,$309.00
2025-07-22,22:59:00,23181.0,BUY,3,0.02h,Break Even,$-1.50,$307.50,$251187.50,402,$307.50
,,,,,,,,,,,
2025-07-23,12:33:00,23241.0,SELL,3,0.02h,Break Even,$-1.50,$-1.50,$251186.00,403,$-1.50
2025-07-23,12:49:00,23247.75,BUY,3,0.02h,Break Even,$-1.50,$-3.00,$251184.50,403,$-3.00
2025-07-23,12:51:00,23236.75,SELL,3,0.02h,Stop Loss,$16.50,$13.50,$251201.00,403,$13.50
2025-07-23,13:10:00,23242.5,BUY,3,0.02h,Stop Loss,$-9.00,$4.50,$251192.00,403,$4.50
2025-07-23,13:16:00,23237.75,SELL,3,0.02h,Break Even,$-1.50,$3.00,$251190.50,403,$3.00
2025-07-23,13:19:00,23244.75,BUY,3,0.02h,Stop Loss,$-9.00,$-6.00,$251181.50,403,$-6.00
2025-07-23,13:32:00,23197.0,SELL,3,0.02h,Stop Loss,$63.00,$57.00,$251244.50,403,$57.00
2025-07-23,14:23:00,23181.75,BUY,3,0.02h,Break Even,$-1.50,$55.50,$251243.00,403,$55.50
2025-07-23,14:35:00,23151.25,SELL,3,0.02h,Break Even,$-1.50,$54.00,$251241.50,403,$54.00
2025-07-23,14:47:00,23178.0,BUY,3,0.02h,Break Even,$-1.50,$52.50,$251240.00,403,$52.50
2025-07-23,15:17:00,23192.0,SELL,3,0.02h,Break Even,$-1.50,$51.00,$251238.50,403,$51.00
2025-07-23,15:20:00,23196.75,BUY,3,0.02h,Stop Loss,$33.00,$84.00,$251271.50,403,$84.00
2025-07-23,16:15:00,23230.0,SELL,3,0.02h,Stop Loss,$-9.00,$75.00,$251262.50,403,$75.00
2025-07-23,16:44:00,23225.0,BUY,3,0.02h,Break Even,$-1.50,$73.50,$251261.00,403,$73.50
2025-07-23,17:13:00,23222.25,SELL,3,0.02h,Break Even,$-1.50,$72.00,$251259.50,403,$72.00
2025-07-23,17:24:00,23232.75,BUY,3,0.02h,Break Even,$-1.50,$70.50,$251258.00,403,$70.50
2025-07-23,18:57:00,23294.5,SELL,3,0.02h,Stop Loss,$-9.00,$61.50,$251249.00,403,$61.50
2025-07-23,18:59:00,23299.25,BUY,3,0.02h,Break Even,$-1.50,$60.00,$251247.50,403,$60.00
2025-07-23,19:05:00,23293.5,SELL,3,0.02h,Break Even,$-1.50,$58.50,$251246.00,403,$58.50
2025-07-23,19:13:00,23298.75,BUY,3,0.02h,Break Even,$-1.50,$57.00,$251244.50,403,$57.00
2025-07-23,19:14:00,23294.25,SELL,3,0.02h,Stop Loss,$7.50,$64.50,$251252.00,403,$64.50
2025-07-23,19:53:00,23295.25,BUY,3,0.02h,Stop Loss,$6.00,$70.50,$251258.00,403,$70.50
2025-07-23,22:04:00,23391.75,SELL,3,0.02h,Stop Loss,$-9.00,$61.50,$251249.00,403,$61.50
2025-07-23,22:28:00,23397.0,BUY,3,0.02h,Stop Loss,$-9.00,$52.50,$251240.00,403,$52.50
2025-07-23,22:32:00,23393.0,SELL,3,0.02h,Break Even,$-1.50,$51.00,$251238.50,403,$51.00
2025-07-23,22:33:00,23396.25,BUY,3,0.02h,Break Even,$-1.50,$49.50,$251237.00,403,$49.50
2025-07-23,22:37:00,23393.25,SELL,3,0.02h,Stop Loss,$4.50,$54.00,$251241.50,403,$54.00
,,,,,,,,,,,
2025-07-24,12:09:00,23391.25,BUY,3,0.02h,Stop Loss,$-9.00,$-9.00,$251232.50,404,$-9.00
2025-07-24,12:17:00,23382.75,SELL,3,0.02h,Break Even,$-1.50,$-10.50,$251231.00,404,$-10.50
2025-07-24,13:00:00,23360.5,BUY,3,0.02h,Stop Loss,$-9.00,$-19.50,$251222.00,404,$-19.50
2025-07-24,13:12:00,23349.25,SELL,3,0.02h,Break Even,$-1.50,$-21.00,$251220.50,404,$-21.00
2025-07-24,13:14:00,23357.75,BUY,3,0.02h,Break Even,$-1.50,$-22.50,$251219.00,404,$-22.50
2025-07-24,13:17:00,23349.5,SELL,3,0.02h,Break Even,$-1.50,$-24.00,$251217.50,404,$-24.00
2025-07-24,13:18:00,23357.75,BUY,3,0.02h,Stop Loss,$-9.00,$-33.00,$251208.50,404,$-33.00
2025-07-24,13:37:00,23352.0,SELL,3,0.02h,Stop Loss,$16.50,$-16.50,$251225.00,404,$-16.50
2025-07-24,13:47:00,23373.75,BUY,3,0.02h,Stop Loss,$130.50,$114.00,$251355.50,404,$114.00
2025-07-24,13:57:00,23362.25,SELL,3,0.02h,Break Even,$-1.50,$112.50,$251354.00,404,$112.50
2025-07-24,13:58:00,23369.25,BUY,3,0.02h,Break Even,$-1.50,$111.00,$251352.50,404,$111.00
2025-07-24,13:59:00,23359.5,SELL,3,0.02h,Break Even,$-1.50,$109.50,$251351.00,404,$109.50
2025-07-24,14:32:00,23340.75,BUY,3,0.02h,Break Even,$-1.50,$108.00,$251349.50,404,$108.00
2025-07-24,15:33:00,23375.75,SELL,3,0.02h,Stop Loss,$9.00,$117.00,$251358.50,404,$117.00
2025-07-24,15:47:00,23382.0,BUY,3,0.02h,Break Even,$-1.50,$115.50,$251357.00,404,$115.50
2025-07-24,15:48:00,23376.5,SELL,3,0.02h,Stop Loss,$-9.00,$106.50,$251348.00,404,$106.50
2025-07-24,15:49:00,23387.25,BUY,3,0.02h,Stop Loss,$-9.00,$97.50,$251339.00,404,$97.50
2025-07-24,16:02:00,23369.75,SELL,3,0.02h,Break Even,$-1.50,$96.00,$251337.50,404,$96.00
2025-07-24,16:42:00,23368.25,BUY,3,0.02h,Stop Loss,$-9.00,$87.00,$251328.50,404,$87.00
2025-07-24,17:36:00,23397.25,SELL,3,0.02h,Break Even,$-1.50,$85.50,$251327.00,404,$85.50
2025-07-24,17:39:00,23398.25,BUY,3,0.02h,Stop Loss,$-9.00,$76.50,$251318.00,404,$76.50
2025-07-24,17:40:00,23397.0,SELL,3,0.02h,Stop Loss,$25.50,$102.00,$251343.50,404,$102.00
2025-07-24,17:53:00,23399.5,BUY,3,0.02h,Break Even,$-1.50,$100.50,$251342.00,404,$100.50
2025-07-24,17:57:00,23390.0,SELL,3,0.02h,Stop Loss,$25.50,$126.00,$251367.50,404,$126.00
2025-07-24,18:05:00,23398.25,BUY,3,0.02h,Stop Loss,$-9.00,$117.00,$251358.50,404,$117.00
2025-07-24,18:40:00,23408.5,SELL,3,0.02h,Break Even,$-1.50,$115.50,$251357.00,404,$115.50
2025-07-24,19:02:00,23404.0,BUY,3,0.02h,Break Even,$-1.50,$114.00,$251355.50,404,$114.00
2025-07-24,19:41:00,23405.0,SELL,3,0.02h,Break Even,$-1.50,$112.50,$251354.00,404,$112.50
2025-07-24,20:17:00,23390.25,BUY,3,0.02h,Stop Loss,$-9.00,$103.50,$251345.00,404,$103.50
2025-07-24,20:28:00,23386.75,SELL,3,0.02h,Break Even,$-1.50,$102.00,$251343.50,404,$102.00
2025-07-24,20:29:00,23390.5,BUY,3,0.02h,Break Even,$-1.50,$100.50,$251342.00,404,$100.50
2025-07-24,20:58:00,23393.25,SELL,3,0.02h,Stop Loss,$-9.00,$91.50,$251333.00,404,$91.50
2025-07-24,22:06:00,23398.75,BUY,3,0.02h,Stop Loss,$-9.00,$82.50,$251324.00,404,$82.50
2025-07-24,22:35:00,23403.0,SELL,3,0.02h,Stop Loss,$-9.00,$73.50,$251315.00,404,$73.50
2025-07-24,22:37:00,23406.75,BUY,3,0.03h,Break Even,$-1.50,$72.00,$251313.50,404,$72.00
2025-07-24,22:51:00,23404.25,SELL,3,0.02h,Break Even,$-1.50,$70.50,$251312.00,404,$70.50
,,,,,,,,,,,
2025-07-25,12:25:00,23379.0,BUY,3,0.02h,Break Even,$-1.50,$-1.50,$251310.50,405,$-1.50
2025-07-25,12:43:00,23371.0,SELL,3,0.02h,Stop Loss,$-9.00,$-10.50,$251301.50,405,$-10.50
2025-07-25,13:21:00,23369.5,BUY,3,0.02h,Break Even,$-1.50,$-12.00,$251300.00,405,$-12.00
2025-07-25,13:30:00,23360.25,SELL,3,0.02h,Stop Loss,$73.50,$61.50,$251373.50,405,$61.50
2025-07-25,13:36:00,23374.75,BUY,3,0.02h,Break Even,$-1.50,$60.00,$251372.00,405,$60.00
2025-07-25,13:37:00,23362.25,SELL,3,0.02h,Stop Loss,$117.00,$177.00,$251489.00,405,$177.00
2025-07-25,13:47:00,23368.75,BUY,3,0.02h,Stop Loss,$33.00,$210.00,$251522.00,405,$210.00
2025-07-25,14:56:00,23401.0,SELL,3,0.02h,Stop Loss,$43.50,$253.50,$251565.50,405,$253.50
2025-07-25,15:13:00,23407.0,BUY,3,0.02h,Break Even,$-1.50,$252.00,$251564.00,405,$252.00
2025-07-25,15:40:00,23408.25,SELL,3,0.02h,Stop Loss,$-9.00,$243.00,$251555.00,405,$243.00
2025-07-25,15:50:00,23415.75,BUY,3,0.02h,Stop Loss,$28.50,$271.50,$251583.50,405,$271.50
2025-07-25,16:47:00,23450.25,SELL,3,0.02h,Stop Loss,$-9.00,$262.50,$251574.50,405,$262.50
2025-07-25,16:55:00,23458.75,BUY,3,0.02h,Stop Loss,$-9.00,$253.50,$251565.50,405,$253.50
2025-07-25,17:00:00,23450.25,SELL,3,0.02h,Stop Loss,$6.00,$259.50,$251571.50,405,$259.50
2025-07-25,17:28:00,23449.0,BUY,3,0.02h,Stop Loss,$6.00,$265.50,$251577.50,405,$265.50
2025-07-25,17:44:00,23444.75,SELL,3,0.02h,Stop Loss,$-9.00,$256.50,$251568.50,405,$256.50
2025-07-25,18:15:00,23445.25,BUY,3,0.02h,Stop Loss,$12.00,$268.50,$251580.50,405,$268.50
2025-07-25,18:53:00,23447.0,SELL,3,0.02h,Stop Loss,$-9.00,$259.50,$251571.50,405,$259.50
2025-07-25,19:15:00,23447.25,BUY,3,0.02h,Stop Loss,$4.50,$264.00,$251576.00,405,$264.00
2025-07-25,19:27:00,23444.25,SELL,3,0.02h,Break Even,$-1.50,$262.50,$251574.50,405,$262.50
2025-07-25,19:39:00,23449.0,BUY,3,0.02h,Stop Loss,$-9.00,$253.50,$251565.50,405,$253.50
2025-07-25,19:42:00,23443.75,SELL,3,0.02h,Break Even,$-1.50,$252.00,$251564.00,405,$252.00
2025-07-25,20:15:00,23434.5,BUY,3,0.02h,Break Even,$-1.50,$250.50,$251562.50,405,$250.50
,,,,,,,,,,,
2025-07-28,13:04:00,23502.5,SELL,3,0.02h,Stop Loss,$16.50,$16.50,$251579.00,406,$16.50
2025-07-28,13:35:00,23494.0,BUY,3,0.02h,Stop Loss,$15.00,$31.50,$251594.00,406,$31.50
2025-07-28,14:21:00,23507.5,SELL,3,0.02h,Stop Loss,$226.50,$258.00,$251820.50,406,$258.00
2025-07-28,14:42:00,23517.0,BUY,3,0.02h,Break Even,$-1.50,$256.50,$251819.00,406,$256.50
2025-07-28,14:47:00,23500.5,SELL,3,0.02h,Break Even,$-1.50,$255.00,$251817.50,406,$255.00
2025-07-28,15:33:00,23482.0,BUY,3,0.02h,Break Even,$-1.50,$253.50,$251816.00,406,$253.50
2025-07-28,16:05:00,23488.0,SELL,3,0.02h,Break Even,$-1.50,$252.00,$251814.50,406,$252.00
2025-07-28,16:18:00,23498.75,BUY,3,0.02h,Stop Loss,$3.00,$255.00,$251817.50,406,$255.00
2025-07-28,16:32:00,23485.25,SELL,3,0.02h,Break Even,$-1.50,$253.50,$251816.00,406,$253.50
2025-07-28,17:15:00,23484.75,BUY,3,0.02h,Stop Loss,$-9.00,$244.50,$251807.00,406,$244.50
2025-07-28,17:16:00,23478.25,SELL,3,0.02h,Stop Loss,$-9.00,$235.50,$251798.00,406,$235.50
2025-07-28,17:33:00,23481.5,BUY,3,0.02h,Break Even,$-1.50,$234.00,$251796.50,406,$234.00
2025-07-28,17:52:00,23469.5,SELL,3,0.02h,Stop Loss,$-9.00,$225.00,$251787.50,406,$225.00
2025-07-28,18:18:00,23469.5,BUY,3,0.02h,Break Even,$-1.50,$223.50,$251786.00,406,$223.50
2025-07-28,18:22:00,23455.75,SELL,3,0.02h,Break Even,$-1.50,$222.00,$251784.50,406,$222.00
2025-07-28,18:48:00,23459.25,BUY,3,0.02h,Break Even,$-1.50,$220.50,$251783.00,406,$220.50
2025-07-28,19:06:00,23454.75,SELL,3,0.02h,Break Even,$-1.50,$219.00,$251781.50,406,$219.00
2025-07-28,19:22:00,23463.0,BUY,3,0.02h,Break Even,$-1.50,$217.50,$251780.00,406,$217.50
2025-07-28,22:45:00,23521.5,SELL,3,0.02h,Break Even,$-1.50,$216.00,$251778.50,406,$216.00
2025-07-28,22:47:00,23523.25,BUY,3,0.02h,Break Even,$-1.50,$214.50,$251777.00,406,$214.50
,,,,,,,,,,,
2025-07-29,12:43:00,23588.25,SELL,3,0.02h,Break Even,$-1.50,$-1.50,$251775.50,407,$-1.50
2025-07-29,13:20:00,23587.0,BUY,3,0.02h,Stop Loss,$-9.00,$-10.50,$251766.50,407,$-10.50
2025-07-29,13:49:00,23606.0,SELL,3,0.02h,Stop Loss,$162.00,$151.50,$251928.50,407,$151.50
2025-07-29,14:41:00,23573.75,BUY,3,0.02h,Break Even,$-1.50,$150.00,$251927.00,407,$150.00
2025-07-29,14:45:00,23554.25,SELL,3,0.02h,Break Even,$-1.50,$148.50,$251925.50,407,$148.50
2025-07-29,15:50:00,23498.0,BUY,3,0.02h,Stop Loss,$34.50,$183.00,$251960.00,407,$183.00
2025-07-29,16:10:00,23489.25,SELL,3,0.02h,Break Even,$-1.50,$181.50,$251958.50,407,$181.50
2025-07-29,16:48:00,23482.25,BUY,3,0.02h,Break Even,$-1.50,$180.00,$251957.00,407,$180.00
2025-07-29,17:33:00,23506.0,SELL,3,0.02h,Stop Loss,$7.50,$187.50,$251964.50,407,$187.50
2025-07-29,17:59:00,23494.5,BUY,3,0.02h,Stop Loss,$-9.00,$178.50,$251955.50,407,$178.50
2025-07-29,18:21:00,23481.5,SELL,3,0.02h,Stop Loss,$-9.00,$169.50,$251946.50,407,$169.50
2025-07-29,18:34:00,23491.0,BUY,3,0.02h,Break Even,$-1.50,$168.00,$251945.00,407,$168.00
2025-07-29,18:50:00,23486.25,SELL,3,0.02h,Break Even,$-1.50,$166.50,$251943.50,407,$166.50
2025-07-29,19:54:00,23460.25,BUY,3,0.02h,Break Even,$-1.50,$165.00,$251942.00,407,$165.00
2025-07-29,19:57:00,23439.0,SELL,3,0.02h,Stop Loss,$6.00,$171.00,$251948.00,407,$171.00
2025-07-29,20:02:00,23457.5,BUY,3,0.02h,Break Even,$-1.50,$169.50,$251946.50,407,$169.50
2025-07-29,20:24:00,23447.75,SELL,3,0.02h,Stop Loss,$-9.00,$160.50,$251937.50,407,$160.50
2025-07-29,20:29:00,23455.25,BUY,3,0.02h,Stop Loss,$-9.00,$151.50,$251928.50,407,$151.50
2025-07-29,20:44:00,23450.5,SELL,3,0.02h,Break Even,$-1.50,$150.00,$251927.00,407,$150.00
2025-07-29,22:01:00,23460.0,BUY,3,0.02h,Stop Loss,$13.50,$163.50,$251940.50,407,$163.50
2025-07-29,22:29:00,23460.0,SELL,3,0.02h,Break Even,$-1.50,$162.00,$251939.00,407,$162.00
2025-07-29,22:31:00,23465.75,BUY,3,0.02h,Stop Loss,$-9.00,$153.00,$251930.00,407,$153.00
2025-07-29,22:38:00,23460.25,SELL,3,0.02h,Stop Loss,$-9.00,$144.00,$251921.00,407,$144.00
2025-07-29,22:40:00,23462.5,BUY,3,0.02h,Stop Loss,$-9.00,$135.00,$251912.00,407,$135.00
,,,,,,,,,,,
2025-07-30,12:21:00,23480.5,SELL,3,0.02h,Stop Loss,$6.00,$6.00,$251918.00,408,$6.00
2025-07-30,12:27:00,23487.75,BUY,3,0.02h,Stop Loss,$-9.00,$-3.00,$251909.00,408,$-3.00
2025-07-30,12:28:00,23483.0,SELL,3,0.02h,Stop Loss,$-9.00,$-12.00,$251900.00,408,$-12.00
2025-07-30,12:31:00,23487.25,BUY,3,0.02h,Stop Loss,$24.00,$12.00,$251924.00,408,$12.00
2025-07-30,12:32:00,23483.25,SELL,3,0.02h,Stop Loss,$7.50,$19.50,$251931.50,408,$19.50
2025-07-30,12:39:00,23496.25,BUY,3,0.02h,Break Even,$-1.50,$18.00,$251930.00,408,$18.00
2025-07-30,13:01:00,23485.5,SELL,3,0.02h,Break Even,$-1.50,$16.50,$251928.50,408,$16.50
2025-07-30,13:20:00,23486.75,BUY,3,0.02h,Break Even,$-1.50,$15.00,$251927.00,408,$15.00
2025-07-30,13:24:00,23483.5,SELL,3,0.02h,Stop Loss,$-9.00,$6.00,$251918.00,408,$6.00
2025-07-30,13:37:00,23496.0,BUY,3,0.02h,Stop Loss,$42.00,$48.00,$251960.00,408,$48.00
2025-07-30,13:53:00,23486.5,SELL,3,0.02h,Stop Loss,$12.00,$60.00,$251972.00,408,$60.00
2025-07-30,14:09:00,23495.25,BUY,3,0.02h,Stop Loss,$-9.00,$51.00,$251963.00,408,$51.00
2025-07-30,14:11:00,23477.5,SELL,3,0.02h,Stop Loss,$34.50,$85.50,$251997.50,408,$85.50
2025-07-30,14:19:00,23490.0,BUY,3,0.02h,Stop Loss,$45.00,$130.50,$252042.50,408,$130.50
2025-07-30,15:03:00,23517.25,SELL,3,0.02h,Stop Loss,$55.50,$186.00,$252098.00,408,$186.00
2025-07-30,15:42:00,23501.0,BUY,3,0.02h,Stop Loss,$-9.00,$177.00,$252089.00,408,$177.00
2025-07-30,16:37:00,23530.0,SELL,3,0.02h,Break Even,$-1.50,$175.50,$252087.50,408,$175.50
2025-07-30,16:53:00,23535.75,BUY,3,0.02h,Stop Loss,$-9.00,$166.50,$252078.50,408,$166.50
2025-07-30,17:11:00,23528.0,SELL,3,0.02h,Stop Loss,$-9.00,$157.50,$252069.50,408,$157.50
2025-07-30,17:17:00,23535.25,BUY,3,0.02h,Stop Loss,$-9.00,$148.50,$252060.50,408,$148.50
2025-07-30,17:24:00,23526.0,SELL,3,0.02h,Stop Loss,$-9.00,$139.50,$252051.50,408,$139.50
2025-07-30,17:36:00,23533.75,BUY,3,0.02h,Stop Loss,$-9.00,$130.50,$252042.50,408,$130.50
2025-07-30,17:52:00,23529.5,SELL,3,0.02h,Break Even,$-1.50,$129.00,$252041.00,408,$129.00
2025-07-30,17:57:00,23543.5,BUY,3,0.02h,Break Even,$-1.50,$127.50,$252039.50,408,$127.50
2025-07-30,18:03:00,23522.25,SELL,3,0.02h,Break Even,$-1.50,$126.00,$252038.00,408,$126.00
2025-07-30,18:08:00,23544.75,BUY,3,0.02h,Break Even,$-1.50,$124.50,$252036.50,408,$124.50
2025-07-30,18:20:00,23537.0,SELL,3,0.02h,Break Even,$-1.50,$123.00,$252035.00,408,$123.00
2025-07-30,18:24:00,23545.5,BUY,3,0.02h,Break Even,$-1.50,$121.50,$252033.50,408,$121.50
2025-07-30,18:41:00,23530.25,SELL,3,0.02h,Stop Loss,$78.00,$199.50,$252111.50,408,$199.50
2025-07-30,19:47:00,23427.75,BUY,3,0.02h,Break Even,$-1.50,$198.00,$252110.00,408,$198.00
,,,,,,,,,,,
2025-07-31,13:11:00,23795.0,SELL,3,0.02h,Stop Loss,$-9.00,$-9.00,$252101.00,409,$-9.00
2025-07-31,13:57:00,23692.0,BUY,3,0.02h,Stop Loss,$30.00,$21.00,$252131.00,409,$21.00
2025-07-31,14:13:00,23658.75,SELL,3,0.02h,Break Even,$-1.50,$19.50,$252129.50,409,$19.50
2025-07-31,15:32:00,23547.75,BUY,3,0.02h,Stop Loss,$40.50,$60.00,$252170.00,409,$60.00
2025-07-31,16:39:00,23588.25,SELL,3,0.02h,Break Even,$-1.50,$58.50,$252168.50,409,$58.50
2025-07-31,18:26:00,23390.0,BUY,3,0.02h,Stop Loss,$31.50,$90.00,$252200.00,409,$90.00
2025-07-31,18:58:00,23415.75,SELL,3,0.02h,Stop Loss,$13.50,$103.50,$252213.50,409,$103.50
2025-07-31,19:07:00,23441.0,BUY,3,0.02h,Stop Loss,$-9.00,$94.50,$252204.50,409,$94.50
2025-07-31,19:08:00,23429.75,SELL,3,0.02h,Stop Loss,$31.50,$126.00,$252236.00,409,$126.00
2025-07-31,19:44:00,23402.0,BUY,3,0.02h,Stop Loss,$31.50,$157.50,$252267.50,409,$157.50
2025-07-31,19:48:00,23386.25,SELL,3,0.02h,Stop Loss,$118.50,$276.00,$252386.00,409,$276.00
2025-07-31,20:32:00,23349.5,BUY,3,0.02h,Stop Loss,$28.50,$304.50,$252414.50,409,$304.50
2025-07-31,20:56:00,23334.75,SELL,3,0.02h,Stop Loss,$24.00,$328.50,$252438.50,409,$328.50
2025-07-31,22:09:00,23344.25,BUY,3,0.02h,Stop Loss,$-9.00,$319.50,$252429.50,409,$319.50
2025-07-31,22:11:00,23329.0,SELL,3,0.02h,Stop Loss,$25.50,$345.00,$252455.00,409,$345.00
,,,,,,,,,,,
2025-08-01,12:42:00,23159.75,BUY,3,0.02h,Stop Loss,$24.00,$24.00,$252479.00,410,$24.00
2025-08-01,12:51:00,23103.0,SELL,3,0.02h,Stop Loss,$51.00,$75.00,$252530.00,410,$75.00
2025-08-01,14:13:00,22919.0,BUY,3,0.02h,Stop Loss,$31.50,$106.50,$252561.50,410,$106.50
2025-08-01,14:50:00,22955.25,SELL,3,0.02h,Stop Loss,$60.00,$166.50,$252621.50,410,$166.50
2025-08-01,15:39:00,22940.0,BUY,3,0.02h,Stop Loss,$79.50,$246.00,$252701.00,410,$246.00
2025-08-01,16:31:00,23004.25,SELL,3,0.02h,Stop Loss,$22.50,$268.50,$252723.50,410,$268.50
2025-08-01,17:51:00,22871.5,BUY,3,0.02h,Break Even,$-1.50,$267.00,$252722.00,410,$267.00
2025-08-01,17:56:00,22833.0,SELL,3,0.02h,Stop Loss,$15.00,$282.00,$252737.00,410,$282.00
2025-08-01,18:24:00,22848.0,BUY,3,0.02h,Stop Loss,$54.00,$336.00,$252791.00,410,$336.00
2025-08-01,18:53:00,22864.75,SELL,3,0.02h,Stop Loss,$46.50,$382.50,$252837.50,410,$382.50
2025-08-01,19:18:00,22879.25,BUY,3,0.02h,Stop Loss,$67.50,$450.00,$252905.00,410,$450.00
2025-08-01,19:23:00,22870.0,SELL,3,0.02h,Break Even,$-1.50,$448.50,$252903.50,410,$448.50
2025-08-01,19:24:00,22894.0,BUY,3,0.02h,Stop Loss,$-9.00,$439.50,$252894.50,410,$439.50
2025-08-01,19:31:00,22874.5,SELL,3,0.02h,Stop Loss,$19.50,$459.00,$252914.00,410,$459.00
2025-08-01,19:34:00,22885.25,BUY,3,0.02h,Break Even,$-1.50,$457.50,$252912.50,410,$457.50
2025-08-01,19:39:00,22871.5,SELL,3,0.02h,Stop Loss,$6.00,$463.50,$252918.50,410,$463.50
2025-08-01,19:42:00,22887.25,BUY,3,0.02h,Break Even,$-1.50,$462.00,$252917.00,410,$462.00
2025-08-01,20:01:00,22883.75,SELL,3,0.02h,Stop Loss,$9.00,$471.00,$252926.00,410,$471.00
2025-08-01,20:17:00,22891.5,BUY,3,0.02h,Break Even,$-1.50,$469.50,$252924.50,410,$469.50
2025-08-01,20:18:00,22884.5,SELL,3,0.02h,Stop Loss,$22.50,$492.00,$252947.00,410,$492.00
2025-08-01,20:23:00,22889.25,BUY,3,0.02h,Stop Loss,$-9.00,$483.00,$252938.00,410,$483.00
2025-08-01,20:25:00,22884.75,SELL,3,0.02h,Break Even,$-1.50,$481.50,$252936.50,410,$481.50
,,,,,,,,,,,
2025-08-04,12:00:00,23043.75,BUY,3,0.02h,Stop Loss,$30.00,$30.00,$252966.50,411,$30.00
2025-08-04,14:32:00,23230.25,SELL,3,0.02h,Stop Loss,$-9.00,$21.00,$252957.50,411,$21.00
2025-08-04,14:36:00,23250.0,BUY,3,0.02h,Stop Loss,$3.00,$24.00,$252960.50,411,$24.00
2025-08-04,14:42:00,23225.75,SELL,3,0.02h,Stop Loss,$-9.00,$15.00,$252951.50,411,$15.00
2025-08-04,15:27:00,23219.0,BUY,3,0.02h,Stop Loss,$4.50,$19.50,$252956.00,411,$19.50
2025-08-04,15:43:00,23201.5,SELL,3,0.02h,Break Even,$-1.50,$18.00,$252954.50,411,$18.00
2025-08-04,15:50:00,23220.0,BUY,3,0.02h,Stop Loss,$46.50,$64.50,$253001.00,411,$64.50
2025-08-04,16:41:00,23259.5,SELL,3,0.02h,Stop Loss,$-9.00,$55.50,$252992.00,411,$55.50
2025-08-04,16:48:00,23270.0,BUY,3,0.02h,Break Even,$-1.50,$54.00,$252990.50,411,$54.00
2025-08-04,17:38:00,23273.5,SELL,3,0.02h,Break Even,$-1.50,$52.50,$252989.00,411,$52.50
2025-08-04,18:01:00,23274.0,BUY,3,0.02h,Stop Loss,$7.50,$60.00,$252996.50,411,$60.00
2025-08-04,18:15:00,23263.5,SELL,3,0.02h,Stop Loss,$-9.00,$51.00,$252987.50,411,$51.00
2025-08-04,18:34:00,23272.25,BUY,3,0.02h,Stop Loss,$-9.00,$42.00,$252978.50,411,$42.00
2025-08-04,18:41:00,23262.75,SELL,3,0.02h,Break Even,$-1.50,$40.50,$252977.00,411,$40.50
2025-08-04,19:02:00,23266.25,BUY,3,0.02h,Stop Loss,$-9.00,$31.50,$252968.00,411,$31.50
2025-08-04,19:04:00,23261.5,SELL,3,0.02h,Break Even,$-1.50,$30.00,$252966.50,411,$30.00
2025-08-04,19:10:00,23264.75,BUY,3,0.02h,Break Even,$-1.50,$28.50,$252965.00,411,$28.50
2025-08-04,19:30:00,23266.5,SELL,3,0.02h,Break Even,$-1.50,$27.00,$252963.50,411,$27.00
2025-08-04,19:45:00,23268.75,BUY,3,0.02h,Break Even,$-1.50,$25.50,$252962.00,411,$25.50
2025-08-04,22:03:00,23340.75,SELL,3,0.02h,Break Even,$-1.50,$24.00,$252960.50,411,$24.00
2025-08-04,22:53:00,23328.75,BUY,3,0.02h,Stop Loss,$-9.00,$15.00,$252951.50,411,$15.00
,,,,,,,,,,,
2025-08-05,12:24:00,23364.25,SELL,3,0.02h,Stop Loss,$4.50,$4.50,$252956.00,412,$4.50
2025-08-05,12:44:00,23369.75,BUY,3,0.02h,Stop Loss,$13.50,$18.00,$252969.50,412,$18.00
2025-08-05,12:53:00,23361.0,SELL,3,0.02h,Break Even,$-1.50,$16.50,$252968.00,412,$16.50
2025-08-05,13:20:00,23365.0,BUY,3,0.02h,Stop Loss,$-9.00,$7.50,$252959.00,412,$7.50
2025-08-05,13:22:00,23354.5,SELL,3,0.02h,Break Even,$-1.50,$6.00,$252957.50,412,$6.00
2025-08-05,13:41:00,23356.0,BUY,3,0.02h,Stop Loss,$7.50,$13.50,$252965.00,412,$13.50
2025-08-05,14:02:00,23337.0,SELL,3,0.02h,Stop Loss,$10.50,$24.00,$252975.50,412,$24.00
2025-08-05,15:07:00,23200.5,BUY,3,0.02h,Stop Loss,$60.00,$84.00,$253035.50,412,$84.00
2025-08-05,15:12:00,23177.5,SELL,3,0.02h,Break Even,$-1.50,$82.50,$253034.00,412,$82.50
2025-08-05,15:14:00,23206.5,BUY,3,0.02h,Stop Loss,$54.00,$136.50,$253088.00,412,$136.50
2025-08-05,15:22:00,23186.0,SELL,3,0.02h,Stop Loss,$12.00,$148.50,$253100.00,412,$148.50
2025-08-05,16:00:00,23156.25,BUY,3,0.02h,Stop Loss,$46.50,$195.00,$253146.50,412,$195.00
2025-08-05,16:41:00,23168.5,SELL,3,0.02h,Stop Loss,$24.00,$219.00,$253170.50,412,$219.00
2025-08-05,16:55:00,23189.5,BUY,3,0.02h,Stop Loss,$9.00,$228.00,$253179.50,412,$228.00
2025-08-05,17:06:00,23174.25,SELL,3,0.02h,Stop Loss,$-9.00,$219.00,$253170.50,412,$219.00
2025-08-05,17:07:00,23182.75,BUY,3,0.02h,Stop Loss,$18.00,$237.00,$253188.50,412,$237.00
2025-08-05,18:13:00,23228.5,SELL,3,0.02h,Stop Loss,$16.50,$253.50,$253205.00,412,$253.50
2025-08-05,19:13:00,23157.0,BUY,3,0.02h,Break Even,$-1.50,$252.00,$253203.50,412,$252.00
2025-08-05,19:38:00,23153.75,SELL,3,0.02h,Stop Loss,$13.50,$265.50,$253217.00,412,$265.50
2025-08-05,20:12:00,23148.5,BUY,3,0.02h,Stop Loss,$-9.00,$256.50,$253208.00,412,$256.50
2025-08-05,20:24:00,23127.0,SELL,3,0.02h,Stop Loss,$108.00,$364.50,$253316.00,412,$364.50
2025-08-05,22:32:00,23076.0,BUY,3,0.02h,Break Even,$-1.50,$363.00,$253314.50,412,$363.00
,,,,,,,,,,,
2025-08-06,13:24:00,23170.0,SELL,3,0.02h,Break Even,$-1.50,$-1.50,$253313.00,413,$-1.50
2025-08-06,13:33:00,23211.5,BUY,3,0.02h,Stop Loss,$27.00,$25.50,$253340.00,413,$25.50
2025-08-06,13:40:00,23159.5,SELL,3,0.02h,Stop Loss,$42.00,$67.50,$253382.00,413,$67.50
2025-08-06,13:46:00,23194.0,BUY,3,0.02h,Stop Loss,$42.00,$109.50,$253424.00,413,$109.50
2025-08-06,14:17:00,23219.75,SELL,3,0.02h,Stop Loss,$67.50,$177.00,$253491.50,413,$177.00
2025-08-06,14:37:00,23246.0,BUY,3,0.02h,Break Even,$-1.50,$175.50,$253490.00,413,$175.50
2025-08-06,16:28:00,23360.75,SELL,3,0.02h,Break Even,$-1.50,$174.00,$253488.50,413,$174.00
2025-08-06,16:37:00,23389.25,BUY,3,0.02h,Stop Loss,$-9.00,$165.00,$253479.50,413,$165.00
2025-08-06,16:43:00,23362.0,SELL,3,0.02h,Stop Loss,$48.00,$213.00,$253527.50,413,$213.00
2025-08-06,16:52:00,23378.5,BUY,3,0.02h,Stop Loss,$4.50,$217.50,$253532.00,413,$217.50
2025-08-06,17:08:00,23365.75,SELL,3,0.02h,Stop Loss,$-9.00,$208.50,$253523.00,413,$208.50
2025-08-06,17:12:00,23375.0,BUY,3,0.02h,Stop Loss,$-9.00,$199.50,$253514.00,413,$199.50
2025-08-06,17:13:00,23366.5,SELL,3,0.02h,Stop Loss,$6.00,$205.50,$253520.00,413,$205.50
2025-08-06,17:23:00,23373.0,BUY,3,0.02h,Stop Loss,$3.00,$208.50,$253523.00,413,$208.50
2025-08-06,17:51:00,23371.0,SELL,3,0.02h,Stop Loss,$19.50,$228.00,$253542.50,413,$228.00
2025-08-06,18:03:00,23395.25,BUY,3,0.02h,Stop Loss,$-9.00,$219.00,$253533.50,413,$219.00
2025-08-06,18:59:00,23413.0,SELL,3,0.02h,Break Even,$-1.50,$217.50,$253532.00,413,$217.50
2025-08-06,19:05:00,23429.0,BUY,3,0.02h,Stop Loss,$-9.00,$208.50,$253523.00,413,$208.50
2025-08-06,19:07:00,23420.75,SELL,3,0.02h,Break Even,$-1.50,$207.00,$253521.50,413,$207.00
2025-08-06,19:19:00,23427.25,BUY,3,0.02h,Stop Loss,$13.50,$220.50,$253535.00,413,$220.50
2025-08-06,19:43:00,23424.5,SELL,3,0.02h,Break Even,$-1.50,$219.00,$253533.50,413,$219.00
2025-08-06,20:28:00,23415.75,BUY,3,0.02h,Break Even,$-1.50,$217.50,$253532.00,413,$217.50
2025-08-06,20:37:00,23408.75,SELL,3,0.02h,Break Even,$-1.50,$216.00,$253530.50,413,$216.00
2025-08-06,20:50:00,23412.75,BUY,3,0.02h,Stop Loss,$-9.00,$207.00,$253521.50,413,$207.00
2025-08-06,20:51:00,23407.0,SELL,3,0.02h,Break Even,$-1.50,$205.50,$253520.00,413,$205.50
2025-08-06,21:00:00,23413.0,BUY,3,1.02h,Stop Loss,$123.00,$328.50,$253643.00,413,$328.50
2025-08-06,22:01:00,23403.25,SELL,3,0.02h,Stop Loss,$58.50,$387.00,$253701.50,413,$387.00
2025-08-06,22:12:00,23418.5,BUY,3,0.02h,Break Even,$-1.50,$385.50,$253700.00,413,$385.50
,,,,,,,,,,,
2025-08-07,13:01:00,23598.75,SELL,3,0.02h,Stop Loss,$-9.00,$-9.00,$253691.00,414,$-9.00
2025-08-07,13:03:00,23604.25,BUY,3,0.02h,Stop Loss,$16.50,$7.50,$253707.50,414,$7.50
2025-08-07,13:27:00,23604.0,SELL,3,0.02h,Stop Loss,$15.00,$22.50,$253722.50,414,$22.50
2025-08-07,13:34:00,23624.75,BUY,3,0.02h,Stop Loss,$18.00,$40.50,$253740.50,414,$40.50
2025-08-07,13:46:00,23580.75,SELL,3,0.02h,Stop Loss,$46.50,$87.00,$253787.00,414,$87.00
2025-08-07,13:54:00,23615.5,BUY,3,0.02h,Stop Loss,$27.00,$114.00,$253814.00,414,$114.00
2025-08-07,14:11:00,23592.75,SELL,3,0.02h,Break Even,$-1.50,$112.50,$253812.50,414,$112.50
2025-08-07,14:46:00,23589.75,BUY,3,0.02h,Stop Loss,$-9.00,$103.50,$253803.50,414,$103.50
2025-08-07,14:47:00,23560.0,SELL,3,0.02h,Stop Loss,$25.50,$129.00,$253829.00,414,$129.00
2025-08-07,15:21:00,23555.25,BUY,3,0.02h,Break Even,$-1.50,$127.50,$253827.50,414,$127.50
2025-08-07,15:27:00,23512.75,SELL,3,0.02h,Stop Loss,$49.50,$177.00,$253877.00,414,$177.00
2025-08-07,15:57:00,23517.5,BUY,3,0.02h,Stop Loss,$9.00,$186.00,$253886.00,414,$186.00
2025-08-07,16:00:00,23497.75,SELL,3,0.02h,Break Even,$-1.50,$184.50,$253884.50,414,$184.50
2025-08-07,16:17:00,23513.25,BUY,3,0.02h,Stop Loss,$-9.00,$175.50,$253875.50,414,$175.50
2025-08-07,16:37:00,23495.5,SELL,3,0.02h,Stop Loss,$88.50,$264.00,$253964.00,414,$264.00
2025-08-07,16:56:00,23477.5,BUY,3,0.02h,Stop Loss,$21.00,$285.00,$253985.00,414,$285.00
2025-08-07,17:05:00,23446.5,SELL,3,0.02h,Stop Loss,$33.00,$318.00,$254018.00,414,$318.00
2025-08-07,17:49:00,23422.0,BUY,3,0.02h,Break Even,$-1.50,$316.50,$254016.50,414,$316.50
2025-08-07,17:51:00,23404.75,SELL,3,0.02h,Break Even,$-1.50,$315.00,$254015.00,414,$315.00
2025-08-07,17:54:00,23427.25,BUY,3,0.02h,Stop Loss,$-9.00,$306.00,$254006.00,414,$306.00
2025-08-07,18:03:00,23405.25,SELL,3,0.02h,Stop Loss,$-9.00,$297.00,$253997.00,414,$297.00
2025-08-07,18:04:00,23425.0,BUY,3,0.02h,Stop Loss,$3.00,$300.00,$254000.00,414,$300.00
2025-08-07,18:05:00,23413.25,SELL,3,0.02h,Stop Loss,$7.50,$307.50,$254007.50,414,$307.50
2025-08-07,18:37:00,23367.25,BUY,3,0.02h,Stop Loss,$27.00,$334.50,$254034.50,414,$334.50
2025-08-07,18:45:00,23351.0,SELL,3,0.02h,Break Even,$-1.50,$333.00,$254033.00,414,$333.00
2025-08-07,18:48:00,23378.0,BUY,3,0.02h,Stop Loss,$-9.00,$324.00,$254024.00,414,$324.00
2025-08-07,19:21:00,23395.25,SELL,3,0.02h,Break Even,$-1.50,$322.50,$254022.50,414,$322.50
2025-08-07,19:22:00,23397.5,BUY,3,0.02h,Stop Loss,$6.00,$328.50,$254028.50,414,$328.50
2025-08-07,19:23:00,23394.25,SELL,3,0.02h,Stop Loss,$16.50,$345.00,$254045.00,414,$345.00
2025-08-07,19:31:00,23409.5,BUY,3,0.02h,Stop Loss,$67.50,$412.50,$254112.50,414,$412.50
2025-08-07,20:33:00,23505.0,SELL,3,0.02h,Stop Loss,$-9.00,$403.50,$254103.50,414,$403.50
2025-08-07,20:52:00,23512.0,BUY,3,0.02h,Stop Loss,$-9.00,$394.50,$254094.50,414,$394.50
2025-08-07,22:42:00,23546.5,SELL,3,0.02h,Stop Loss,$-9.00,$385.50,$254085.50,414,$385.50
2025-08-07,22:52:00,23555.5,BUY,3,0.02h,Break Even,$-1.50,$384.00,$254084.00,414,$384.00
,,,,,,,,,,,
2025-08-08,12:11:00,23552.25,SELL,3,0.02h,Break Even,$-1.50,$-1.50,$254082.50,415,$-1.50
2025-08-08,12:48:00,23537.75,BUY,3,0.02h,Break Even,$-1.50,$-3.00,$254081.00,415,$-3.00
2025-08-08,12:58:00,23531.25,SELL,3,0.02h,Stop Loss,$-9.00,$-12.00,$254072.00,415,$-12.00
2025-08-08,13:01:00,23542.25,BUY,3,0.02h,Stop Loss,$10.50,$-1.50,$254082.50,415,$-1.50
2025-08-08,13:07:00,23530.25,SELL,3,0.02h,Break Even,$-1.50,$-3.00,$254081.00,415,$-3.00
2025-08-08,13:25:00,23534.0,BUY,3,0.02h,Stop Loss,$18.00,$15.00,$254099.00,415,$15.00
2025-08-08,14:52:00,23670.75,SELL,3,0.02h,Stop Loss,$15.00,$30.00,$254114.00,415,$30.00
2025-08-08,15:10:00,23673.25,BUY,3,0.02h,Break Even,$-1.50,$28.50,$254112.50,415,$28.50
2025-08-08,15:12:00,23656.0,SELL,3,0.02h,Stop Loss,$-9.00,$19.50,$254103.50,415,$19.50
2025-08-08,15:15:00,23679.5,BUY,3,0.02h,Break Even,$-1.50,$18.00,$254102.00,415,$18.00
2025-08-08,15:30:00,23666.0,SELL,3,0.02h,Stop Loss,$82.50,$100.50,$254184.50,415,$100.50
2025-08-08,15:52:00,23651.5,BUY,3,0.02h,Stop Loss,$19.50,$120.00,$254204.00,415,$120.00
2025-08-08,16:38:00,23685.75,SELL,3,0.02h,Stop Loss,$-9.00,$111.00,$254195.00,415,$111.00
2025-08-08,16:39:00,23692.25,BUY,3,0.02h,Break Even,$-1.50,$109.50,$254193.50,415,$109.50
2025-08-08,16:50:00,23687.5,SELL,3,0.02h,Stop Loss,$6.00,$115.50,$254199.50,415,$115.50
2025-08-08,17:25:00,23677.0,BUY,3,0.02h,Stop Loss,$-9.00,$106.50,$254190.50,415,$106.50
2025-08-08,17:26:00,23665.25,SELL,3,0.02h,Stop Loss,$24.00,$130.50,$254214.50,415,$130.50
2025-08-08,17:34:00,23676.75,BUY,3,0.02h,Stop Loss,$-9.00,$121.50,$254205.50,415,$121.50
2025-08-08,18:26:00,23696.25,SELL,3,0.02h,Stop Loss,$19.50,$141.00,$254225.00,415,$141.00
2025-08-08,18:33:00,23710.0,BUY,3,0.02h,Stop Loss,$3.00,$144.00,$254228.00,415,$144.00
2025-08-08,18:42:00,23707.25,SELL,3,0.02h,Break Even,$-1.50,$142.50,$254226.50,415,$142.50
2025-08-08,18:49:00,23711.75,BUY,3,0.02h,Break Even,$-1.50,$141.00,$254225.00,415,$141.00
2025-08-08,19:03:00,23704.5,SELL,3,0.02h,Stop Loss,$-9.00,$132.00,$254216.00,415,$132.00
2025-08-08,19:19:00,23711.5,BUY,3,0.02h,Stop Loss,$18.00,$150.00,$254234.00,415,$150.00
2025-08-08,19:28:00,23707.75,SELL,3,0.02h,Break Even,$-1.50,$148.50,$254232.50,415,$148.50
2025-08-08,19:55:00,23712.0,BUY,3,0.02h,Stop Loss,$-9.00,$139.50,$254223.50,415,$139.50
2025-08-08,20:49:00,23748.5,SELL,3,0.02h,Break Even,$-1.50,$138.00,$254222.00,415,$138.00
2025-08-08,20:56:00,23753.25,BUY,3,0.02h,Stop Loss,$13.50,$151.50,$254235.50,415,$151.50
,,,,,,,,,,,
2025-08-11,12:01:00,23745.5,SELL,3,0.02h,Break Even,$-1.50,$-1.50,$254234.00,416,$-1.50
2025-08-11,13:16:00,23723.5,BUY,3,0.02h,Break Even,$-1.50,$-3.00,$254232.50,416,$-3.00
2025-08-11,13:26:00,23714.0,SELL,3,0.02h,Break Even,$-1.50,$-4.50,$254231.00,416,$-4.50
2025-08-11,13:43:00,23727.75,BUY,3,0.02h,Stop Loss,$40.50,$36.00,$254271.50,416,$36.00
2025-08-11,14:37:00,23748.75,SELL,3,0.02h,Break Even,$-1.50,$34.50,$254270.00,416,$34.50
2025-08-11,14:38:00,23751.5,BUY,3,0.02h,Stop Loss,$30.00,$64.50,$254300.00,416,$64.50
2025-08-11,14:41:00,23743.75,SELL,3,0.02h,Break Even,$-1.50,$63.00,$254298.50,416,$63.00
2025-08-11,14:42:00,23755.5,BUY,3,0.02h,Stop Loss,$-9.00,$54.00,$254289.50,416,$54.00
2025-08-11,14:43:00,23747.5,SELL,3,0.02h,Stop Loss,$-9.00,$45.00,$254280.50,416,$45.00
2025-08-11,14:46:00,23755.5,BUY,3,0.02h,Break Even,$-1.50,$43.50,$254279.00,416,$43.50
2025-08-11,14:47:00,23742.25,SELL,3,0.02h,Stop Loss,$54.00,$97.50,$254333.00,416,$97.50
2025-08-11,15:15:00,23747.25,BUY,3,0.02h,Break Even,$-1.50,$96.00,$254331.50,416,$96.00
2025-08-11,15:28:00,23736.5,SELL,3,0.02h,Break Even,$-1.50,$94.50,$254330.00,416,$94.50
2025-08-11,15:35:00,23742.5,BUY,3,0.02h,Stop Loss,$-9.00,$85.50,$254321.00,416,$85.50
2025-08-11,15:38:00,23733.75,SELL,3,0.02h,Stop Loss,$39.00,$124.50,$254360.00,416,$124.50
2025-08-11,15:50:00,23739.75,BUY,3,0.02h,Stop Loss,$33.00,$157.50,$254393.00,416,$157.50
2025-08-11,16:37:00,23771.25,SELL,3,0.02h,Break Even,$-1.50,$156.00,$254391.50,416,$156.00
2025-08-11,18:33:00,23695.5,BUY,3,0.02h,Break Even,$-1.50,$154.50,$254390.00,416,$154.50
2025-08-11,18:44:00,23680.5,SELL,3,0.02h,Stop Loss,$123.00,$277.50,$254513.00,416,$277.50
2025-08-11,18:59:00,23691.75,BUY,3,0.02h,Stop Loss,$-9.00,$268.50,$254504.00,416,$268.50
2025-08-11,19:04:00,23678.5,SELL,3,0.02h,Stop Loss,$-9.00,$259.50,$254495.00,416,$259.50
2025-08-11,20:06:00,23639.5,BUY,3,0.02h,Stop Loss,$6.00,$265.50,$254501.00,416,$265.50
2025-08-11,20:16:00,23628.5,SELL,3,0.02h,Stop Loss,$12.00,$277.50,$254513.00,416,$277.50
2025-08-11,20:43:00,23626.5,BUY,3,0.02h,Stop Loss,$-9.00,$268.50,$254504.00,416,$268.50
2025-08-11,20:58:00,23624.25,SELL,3,0.02h,Stop Loss,$-9.00,$259.50,$254495.00,416,$259.50
2025-08-11,21:00:00,23630.0,BUY,3,1.02h,Stop Loss,$60.00,$319.50,$254555.00,416,$319.50
2025-08-11,22:19:00,23626.0,SELL,3,0.02h,Stop Loss,$24.00,$343.50,$254579.00,416,$343.50
2025-08-11,22:45:00,23625.5,BUY,3,0.02h,Stop Loss,$-9.00,$334.50,$254570.00,416,$334.50
2025-08-11,22:46:00,23618.25,SELL,3,0.02h,Stop Loss,$-9.00,$325.50,$254561.00,416,$325.50
2025-08-11,22:50:00,23626.25,BUY,3,0.02h,Stop Loss,$12.00,$337.50,$254573.00,416,$337.50
,,,,,,,,,,,
2025-08-12,13:03:00,23755.5,SELL,3,0.02h,Stop Loss,$39.00,$39.00,$254612.00,417,$39.00
2025-08-12,13:35:00,23780.0,BUY,3,0.02h,Stop Loss,$51.00,$90.00,$254663.00,417,$90.00
2025-08-12,13:49:00,23705.25,SELL,3,0.02h,Stop Loss,$115.50,$205.50,$254778.50,417,$205.50
2025-08-12,14:15:00,23721.75,BUY,3,0.02h,Stop Loss,$109.50,$315.00,$254888.00,417,$315.00
2025-08-12,16:08:00,23849.75,SELL,3,0.02h,Stop Loss,$-9.00,$306.00,$254879.00,417,$306.00
2025-08-12,16:15:00,23857.25,BUY,3,0.02h,Stop Loss,$24.00,$330.00,$254903.00,417,$330.00
2025-08-12,17:28:00,23892.0,SELL,3,0.02h,Stop Loss,$-9.00,$321.00,$254894.00,417,$321.00
2025-08-12,17:35:00,23906.25,BUY,3,0.02h,Stop Loss,$-9.00,$312.00,$254885.00,417,$312.00
2025-08-12,18:32:00,23911.75,SELL,3,0.02h,Stop Loss,$-9.00,$303.00,$254876.00,417,$303.00
2025-08-12,19:08:00,23916.0,BUY,3,0.02h,Stop Loss,$-9.00,$294.00,$254867.00,417,$294.00
2025-08-12,19:12:00,23903.0,SELL,3,0.02h,Stop Loss,$-9.00,$285.00,$254858.00,417,$285.00
2025-08-12,19:19:00,23916.0,BUY,3,0.02h,Break Even,$-1.50,$283.50,$254856.50,417,$283.50
2025-08-12,19:47:00,23921.5,SELL,3,0.02h,Stop Loss,$-9.00,$274.50,$254847.50,417,$274.50
2025-08-12,19:51:00,23932.75,BUY,3,0.02h,Stop Loss,$13.50,$288.00,$254861.00,417,$288.00
2025-08-12,20:13:00,23929.25,SELL,3,0.02h,Stop Loss,$-9.00,$279.00,$254852.00,417,$279.00
2025-08-12,20:16:00,23933.75,BUY,3,0.02h,Stop Loss,$-9.00,$270.00,$254843.00,417,$270.00
2025-08-12,20:43:00,23934.75,SELL,3,0.02h,Stop Loss,$-9.00,$261.00,$254834.00,417,$261.00
2025-08-12,20:48:00,23938.0,BUY,3,0.02h,Break Even,$-1.50,$259.50,$254832.50,417,$259.50
2025-08-12,22:03:00,23932.25,SELL,3,0.02h,Stop Loss,$-9.00,$250.50,$254823.50,417,$250.50
2025-08-12,22:46:00,23931.0,BUY,3,0.02h,Stop Loss,$-9.00,$241.50,$254814.50,417,$241.50
2025-08-12,22:47:00,23928.5,SELL,3,0.02h,Stop Loss,$-9.00,$232.50,$254805.50,417,$232.50
2025-08-12,22:48:00,23930.5,BUY,3,0.02h,Stop Loss,$-9.00,$223.50,$254796.50,417,$223.50
2025-08-12,22:49:00,23927.75,SELL,3,0.03h,Stop Loss,$-9.00,$214.50,$254787.50,417,$214.50
2025-08-12,22:58:00,23930.0,BUY,3,0.02h,Stop Loss,$-9.00,$205.50,$254778.50,417,$205.50
,,,,,,,,,,,
2025-08-13,13:46:00,24032.0,SELL,3,0.02h,Stop Loss,$3.00,$3.00,$254781.50,418,$3.00
2025-08-13,13:51:00,24057.5,BUY,3,0.02h,Break Even,$-1.50,$1.50,$254780.00,418,$1.50
2025-08-13,13:56:00,24015.75,SELL,3,0.02h,Stop Loss,$43.50,$45.00,$254823.50,418,$45.00
2025-08-13,15:24:00,23945.0,BUY,3,0.02h,Stop Loss,$-9.00,$36.00,$254814.50,418,$36.00
2025-08-13,15:40:00,23930.5,SELL,3,0.02h,Stop Loss,$-9.00,$27.00,$254805.50,418,$27.00
2025-08-13,15:41:00,23939.5,BUY,3,0.02h,Stop Loss,$28.50,$55.50,$254834.00,418,$55.50
2025-08-13,15:54:00,23923.25,SELL,3,0.02h,Stop Loss,$12.00,$67.50,$254846.00,418,$67.50
2025-08-13,16:16:00,23936.75,BUY,3,0.02h,Break Even,$-1.50,$66.00,$254844.50,418,$66.00
2025-08-13,16:19:00,23927.5,SELL,3,0.02h,Stop Loss,$19.50,$85.50,$254864.00,418,$85.50
2025-08-13,17:04:00,23920.0,BUY,3,0.02h,Break Even,$-1.50,$84.00,$254862.50,418,$84.00
2025-08-13,17:10:00,23904.0,SELL,3,0.02h,Stop Loss,$3.00,$87.00,$254865.50,418,$87.00
2025-08-13,17:19:00,23915.25,BUY,3,0.02h,Stop Loss,$25.50,$112.50,$254891.00,418,$112.50
2025-08-13,17:35:00,23903.75,SELL,3,0.02h,Stop Loss,$-9.00,$103.50,$254882.00,418,$103.50
2025-08-13,17:54:00,23923.75,BUY,3,0.02h,Stop Loss,$-9.00,$94.50,$254873.00,418,$94.50
2025-08-13,18:27:00,23932.0,SELL,3,0.02h,Stop Loss,$9.00,$103.50,$254882.00,418,$103.50
2025-08-13,18:50:00,23928.25,BUY,3,0.02h,Break Even,$-1.50,$102.00,$254880.50,418,$102.00
2025-08-13,19:08:00,23926.25,SELL,3,0.02h,Break Even,$-1.50,$100.50,$254879.00,418,$100.50
2025-08-13,19:14:00,23934.0,BUY,3,0.02h,Stop Loss,$9.00,$109.50,$254888.00,418,$109.50
2025-08-13,19:31:00,23932.0,SELL,3,0.02h,Break Even,$-1.50,$108.00,$254886.50,418,$108.00
2025-08-13,19:52:00,23936.5,BUY,3,0.02h,Stop Loss,$42.00,$150.00,$254928.50,418,$150.00
2025-08-13,20:10:00,23931.5,SELL,3,0.02h,Stop Loss,$-9.00,$141.00,$254919.50,418,$141.00
2025-08-13,20:51:00,23929.5,BUY,3,0.02h,Stop Loss,$-9.00,$132.00,$254910.50,418,$132.00
2025-08-13,22:02:00,23923.5,SELL,3,0.02h,Break Even,$-1.50,$130.50,$254909.00,418,$130.50
2025-08-13,22:22:00,23926.25,BUY,3,0.02h,Stop Loss,$-9.00,$121.50,$254900.00,418,$121.50
,,,,,,,,,,,
2025-08-14,12:27:00,23946.5,SELL,3,0.02h,Break Even,$-1.50,$-1.50,$254898.50,419,$-1.50
2025-08-14,13:14:00,23850.0,BUY,3,0.02h,Stop Loss,$-9.00,$-10.50,$254889.50,419,$-10.50
2025-08-14,13:20:00,23828.75,SELL,3,0.02h,Stop Loss,$6.00,$-4.50,$254895.50,419,$-4.50
2025-08-14,13:29:00,23853.25,BUY,3,0.02h,Stop Loss,$25.50,$21.00,$254921.00,419,$21.00
2025-08-14,14:12:00,23914.5,SELL,3,0.02h,Stop Loss,$27.00,$48.00,$254948.00,419,$48.00
2025-08-14,14:18:00,23933.75,BUY,3,0.02h,Stop Loss,$60.00,$108.00,$255008.00,419,$108.00
2025-08-14,14:58:00,23948.0,SELL,3,0.02h,Stop Loss,$22.50,$130.50,$255030.50,419,$130.50
2025-08-14,15:49:00,23919.0,BUY,3,0.02h,Stop Loss,$21.00,$151.50,$255051.50,419,$151.50
2025-08-14,16:07:00,23900.0,SELL,3,0.02h,Break Even,$-1.50,$150.00,$255050.00,419,$150.00
2025-08-14,16:26:00,23903.75,BUY,3,0.02h,Stop Loss,$-9.00,$141.00,$255041.00,419,$141.00
2025-08-14,16:28:00,23887.25,SELL,3,0.02h,Stop Loss,$28.50,$169.50,$255069.50,419,$169.50
2025-08-14,16:34:00,23898.5,BUY,3,0.02h,Stop Loss,$73.50,$243.00,$255143.00,419,$243.00
2025-08-14,17:40:00,23958.0,SELL,3,0.02h,Stop Loss,$91.50,$334.50,$255234.50,419,$334.50
2025-08-14,18:00:00,23962.5,BUY,3,0.02h,Stop Loss,$-9.00,$325.50,$255225.50,419,$325.50
2025-08-14,18:02:00,23951.0,SELL,3,0.02h,Stop Loss,$37.50,$363.00,$255263.00,419,$363.00
2025-08-14,18:45:00,23917.5,BUY,3,0.02h,Stop Loss,$-9.00,$354.00,$255254.00,419,$354.00
2025-08-14,19:31:00,23922.75,SELL,3,0.02h,Stop Loss,$-9.00,$345.00,$255245.00,419,$345.00
2025-08-14,19:38:00,23936.75,BUY,3,0.02h,Stop Loss,$16.50,$361.50,$255261.50,419,$361.50
2025-08-14,20:00:00,23921.25,SELL,3,0.02h,Stop Loss,$72.00,$433.50,$255333.50,419,$433.50
2025-08-14,20:38:00,23892.5,BUY,3,0.02h,Break Even,$-1.50,$432.00,$255332.00,419,$432.00
2025-08-14,20:43:00,23884.25,SELL,3,0.02h,Break Even,$-1.50,$430.50,$255330.50,419,$430.50
2025-08-14,20:48:00,23889.75,BUY,3,0.02h,Stop Loss,$-9.00,$421.50,$255321.50,419,$421.50
2025-08-14,20:50:00,23885.0,SELL,3,0.02h,Stop Loss,$-9.00,$412.50,$255312.50,419,$412.50
2025-08-14,20:51:00,23887.5,BUY,3,0.02h,Break Even,$-1.50,$411.00,$255311.00,419,$411.00
2025-08-14,20:53:00,23885.25,SELL,3,0.02h,Stop Loss,$-9.00,$402.00,$255302.00,419,$402.00
2025-08-14,21:00:00,23891.0,BUY,3,1.02h,Stop Loss,$-9.00,$393.00,$255293.00,419,$393.00
2025-08-14,22:01:00,23882.5,SELL,3,0.02h,Stop Loss,$34.50,$427.50,$255327.50,419,$427.50
2025-08-14,22:07:00,23891.25,BUY,3,0.02h,Break Even,$-1.50,$426.00,$255326.00,419,$426.00
2025-08-14,22:20:00,23883.25,SELL,3,0.02h,Stop Loss,$-9.00,$417.00,$255317.00,419,$417.00
2025-08-14,22:46:00,23891.5,BUY,3,0.02h,Stop Loss,$-9.00,$408.00,$255308.00,419,$408.00
,,,,,,,,,,,
2025-08-15,12:25:00,23893.25,SELL,3,0.02h,Stop Loss,$6.00,$6.00,$255314.00,420,$6.00
2025-08-15,12:33:00,23908.25,BUY,3,0.02h,Stop Loss,$-9.00,$-3.00,$255305.00,420,$-3.00
2025-08-15,12:34:00,23902.0,SELL,3,0.02h,Stop Loss,$-9.00,$-12.00,$255296.00,420,$-12.00
2025-08-15,12:35:00,23906.5,BUY,3,0.02h,Stop Loss,$-9.00,$-21.00,$255287.00,420,$-21.00
2025-08-15,12:39:00,23894.5,SELL,3,0.02h,Break Even,$-1.50,$-22.50,$255285.50,420,$-22.50
2025-08-15,12:47:00,23907.25,BUY,3,0.02h,Stop Loss,$6.00,$-16.50,$255291.50,420,$-16.50
2025-08-15,13:01:00,23901.75,SELL,3,0.02h,Stop Loss,$-9.00,$-25.50,$255282.50,420,$-25.50
2025-08-15,13:20:00,23907.75,BUY,3,0.02h,Break Even,$-1.50,$-27.00,$255281.00,420,$-27.00
2025-08-15,13:26:00,23888.5,SELL,3,0.02h,Stop Loss,$-9.00,$-36.00,$255272.00,420,$-36.00
2025-08-15,13:29:00,23912.25,BUY,3,0.02h,Stop Loss,$39.00,$3.00,$255311.00,420,$3.00
2025-08-15,13:31:00,23861.25,SELL,3,0.02h,Stop Loss,$46.50,$49.50,$255357.50,420,$49.50
2025-08-15,14:05:00,23853.75,BUY,3,0.02h,Stop Loss,$33.00,$82.50,$255390.50,420,$82.50
2025-08-15,14:34:00,23837.75,SELL,3,0.02h,Break Even,$-1.50,$81.00,$255389.00,420,$81.00
2025-08-15,15:17:00,23815.75,BUY,3,0.02h,Stop Loss,$10.50,$91.50,$255399.50,420,$91.50
2025-08-15,15:27:00,23806.25,SELL,3,0.02h,Break Even,$-1.50,$90.00,$255398.00,420,$90.00
2025-08-15,15:54:00,23812.25,BUY,3,0.02h,Stop Loss,$6.00,$96.00,$255404.00,420,$96.00
2025-08-15,16:03:00,23773.0,SELL,3,0.02h,Stop Loss,$13.50,$109.50,$255417.50,420,$109.50
2025-08-15,16:09:00,23792.75,BUY,3,0.02h,Stop Loss,$4.50,$114.00,$255422.00,420,$114.00
2025-08-15,16:19:00,23778.5,SELL,3,0.02h,Stop Loss,$-9.00,$105.00,$255413.00,420,$105.00
2025-08-15,16:41:00,23790.75,BUY,3,0.02h,Break Even,$-1.50,$103.50,$255411.50,420,$103.50
2025-08-15,17:13:00,23802.75,SELL,3,0.02h,Break Even,$-1.50,$102.00,$255410.00,420,$102.00
2025-08-15,17:31:00,23815.5,BUY,3,0.02h,Stop Loss,$37.50,$139.50,$255447.50,420,$139.50
2025-08-15,17:48:00,23805.0,SELL,3,0.02h,Stop Loss,$-9.00,$130.50,$255438.50,420,$130.50
2025-08-15,17:56:00,23827.25,BUY,3,0.02h,Stop Loss,$25.50,$156.00,$255464.00,420,$156.00
2025-08-15,18:16:00,23811.25,SELL,3,0.02h,Break Even,$-1.50,$154.50,$255462.50,420,$154.50
2025-08-15,18:31:00,23823.75,BUY,3,0.02h,Stop Loss,$3.00,$157.50,$255465.50,420,$157.50
2025-08-15,18:37:00,23810.5,SELL,3,0.02h,Stop Loss,$-9.00,$148.50,$255456.50,420,$148.50
2025-08-15,18:56:00,23819.25,BUY,3,0.02h,Break Even,$-1.50,$147.00,$255455.00,420,$147.00
2025-08-15,18:59:00,23810.5,SELL,3,0.02h,Stop Loss,$7.50,$154.50,$255462.50,420,$154.50
2025-08-15,19:15:00,23807.75,BUY,3,0.02h,Stop Loss,$9.00,$163.50,$255471.50,420,$163.50
2025-08-15,19:19:00,23793.5,SELL,3,0.02h,Stop Loss,$-9.00,$154.50,$255462.50,420,$154.50
2025-08-15,19:23:00,23809.25,BUY,3,0.02h,Stop Loss,$9.00,$163.50,$255471.50,420,$163.50
2025-08-15,19:53:00,23805.25,SELL,3,0.02h,Break Even,$-1.50,$162.00,$255470.00,420,$162.00
2025-08-15,20:15:00,23809.0,BUY,3,0.02h,Break Even,$-1.50,$160.50,$255468.50,420,$160.50
2025-08-15,20:25:00,23796.5,SELL,3,0.02h,Stop Loss,$6.00,$166.50,$255474.50,420,$166.50
2025-08-15,20:55:00,23795.25,BUY,3,0.02h,Break Even,$-1.50,$165.00,$255473.00,420,$165.00
,,,,,,,,,,,
2025-08-18,12:00:00,23770.75,SELL,3,0.02h,Stop Loss,$7.50,$7.50,$255480.50,421,$7.50
2025-08-18,12:30:00,23770.75,BUY,3,0.02h,Stop Loss,$-9.00,$-1.50,$255471.50,421,$-1.50
2025-08-18,12:32:00,23758.75,SELL,3,0.02h,Stop Loss,$-9.00,$-10.50,$255462.50,421,$-10.50
2025-08-18,12:45:00,23765.75,BUY,3,0.02h,Stop Loss,$7.50,$-3.00,$255470.00,421,$-3.00
2025-08-18,13:13:00,23758.0,SELL,3,0.02h,Stop Loss,$-9.00,$-12.00,$255461.00,421,$-12.00
2025-08-18,13:31:00,23801.75,BUY,3,0.02h,Stop Loss,$13.50,$1.50,$255474.50,421,$1.50
2025-08-18,13:45:00,23776.75,SELL,3,0.02h,Stop Loss,$7.50,$9.00,$255482.00,421,$9.00
2025-08-18,13:46:00,23790.75,BUY,3,0.02h,Break Even,$-1.50,$7.50,$255480.50,421,$7.50
2025-08-18,13:52:00,23752.0,SELL,3,0.02h,Stop Loss,$19.50,$27.00,$255500.00,421,$27.00
2025-08-18,14:06:00,23780.0,BUY,3,0.02h,Stop Loss,$16.50,$43.50,$255516.50,421,$43.50
2025-08-18,14:16:00,23766.5,SELL,3,0.02h,Break Even,$-1.50,$42.00,$255515.00,421,$42.00
2025-08-18,14:17:00,23778.25,BUY,3,0.02h,Stop Loss,$4.50,$46.50,$255519.50,421,$46.50
2025-08-18,14:35:00,23778.75,SELL,3,0.02h,Stop Loss,$9.00,$55.50,$255528.50,421,$55.50
2025-08-18,14:56:00,23775.5,BUY,3,0.02h,Stop Loss,$-9.00,$46.50,$255519.50,421,$46.50
2025-08-18,15:14:00,23764.25,SELL,3,0.02h,Stop Loss,$16.50,$63.00,$255536.00,421,$63.00
2025-08-18,15:48:00,23753.5,BUY,3,0.02h,Stop Loss,$15.00,$78.00,$255551.00,421,$78.00
2025-08-18,15:56:00,23741.25,SELL,3,0.02h,Break Even,$-1.50,$76.50,$255549.50,421,$76.50
2025-08-18,16:02:00,23754.5,BUY,3,0.02h,Break Even,$-1.50,$75.00,$255548.00,421,$75.00
2025-08-18,16:37:00,23748.25,SELL,3,0.02h,Stop Loss,$57.00,$132.00,$255605.00,421,$132.00
2025-08-18,17:05:00,23752.0,BUY,3,0.02h,Stop Loss,$-9.00,$123.00,$255596.00,421,$123.00
2025-08-18,17:42:00,23755.25,SELL,3,0.02h,Stop Loss,$7.50,$130.50,$255603.50,421,$130.50
2025-08-18,18:08:00,23767.0,BUY,3,0.02h,Stop Loss,$-9.00,$121.50,$255594.50,421,$121.50
2025-08-18,18:19:00,23756.25,SELL,3,0.02h,Stop Loss,$-9.00,$112.50,$255585.50,421,$112.50
2025-08-18,18:24:00,23767.5,BUY,3,0.02h,Break Even,$-1.50,$111.00,$255584.00,421,$111.00
2025-08-18,19:25:00,23792.5,SELL,3,0.02h,Break Even,$-1.50,$109.50,$255582.50,421,$109.50
2025-08-18,19:38:00,23803.0,BUY,3,0.02h,Stop Loss,$-9.00,$100.50,$255573.50,421,$100.50
2025-08-18,20:03:00,23793.0,SELL,3,0.02h,Stop Loss,$-9.00,$91.50,$255564.50,421,$91.50
2025-08-18,20:50:00,23792.25,BUY,3,0.07h,Break Even,$-1.50,$90.00,$255563.00,421,$90.00
2025-08-18,22:27:00,23814.0,SELL,3,0.02h,Break Even,$-1.50,$88.50,$255561.50,421,$88.50
2025-08-18,22:49:00,23816.5,BUY,3,0.02h,Stop Loss,$-9.00,$79.50,$255552.50,421,$79.50
,,,,,,,,,,,
2025-08-19,12:00:00,23774.75,SELL,3,0.02h,Stop Loss,$16.50,$16.50,$255569.00,422,$16.50
2025-08-19,12:28:00,23780.75,BUY,3,0.02h,Stop Loss,$-9.00,$7.50,$255560.00,422,$7.50
2025-08-19,12:43:00,23771.5,SELL,3,0.02h,Break Even,$-1.50,$6.00,$255558.50,422,$6.00
2025-08-19,13:24:00,23752.0,BUY,3,0.02h,Break Even,$-1.50,$4.50,$255557.00,422,$4.50
2025-08-19,13:33:00,23692.75,SELL,3,0.02h,Stop Loss,$88.50,$93.00,$255645.50,422,$93.00
2025-08-19,14:05:00,23721.5,BUY,3,0.02h,Break Even,$-1.50,$91.50,$255644.00,422,$91.50
2025-08-19,14:24:00,23688.0,SELL,3,0.02h,Stop Loss,$-9.00,$82.50,$255635.00,422,$82.50
2025-08-19,15:19:00,23567.5,BUY,3,0.02h,Stop Loss,$16.50,$99.00,$255651.50,422,$99.00
2025-08-19,15:26:00,23557.25,SELL,3,0.02h,Stop Loss,$-9.00,$90.00,$255642.50,422,$90.00
2025-08-19,15:27:00,23573.0,BUY,3,0.02h,Stop Loss,$46.50,$136.50,$255689.00,422,$136.50
2025-08-19,15:51:00,23560.5,SELL,3,0.02h,Stop Loss,$22.50,$159.00,$255711.50,422,$159.00
2025-08-19,17:26:00,23475.5,BUY,3,0.02h,Break Even,$-1.50,$157.50,$255710.00,422,$157.50
2025-08-19,18:03:00,23483.25,SELL,3,0.02h,Stop Loss,$49.50,$207.00,$255759.50,422,$207.00
2025-08-19,18:58:00,23466.5,BUY,3,0.02h,Stop Loss,$6.00,$213.00,$255765.50,422,$213.00
2025-08-19,19:01:00,23447.0,SELL,3,0.02h,Stop Loss,$88.50,$301.50,$255854.00,422,$301.50
2025-08-19,19:24:00,23454.0,BUY,3,0.02h,Stop Loss,$33.00,$334.50,$255887.00,422,$334.50
2025-08-19,19:52:00,23452.75,SELL,3,0.02h,Stop Loss,$-9.00,$325.50,$255878.00,422,$325.50
2025-08-19,20:01:00,23481.5,BUY,3,0.02h,Stop Loss,$15.00,$340.50,$255893.00,422,$340.50
2025-08-19,20:21:00,23470.5,SELL,3,0.02h,Stop Loss,$-9.00,$331.50,$255884.00,422,$331.50
2025-08-19,20:23:00,23472.75,BUY,3,0.02h,Stop Loss,$-9.00,$322.50,$255875.00,422,$322.50
2025-08-19,20:24:00,23471.25,SELL,3,0.02h,Stop Loss,$15.00,$337.50,$255890.00,422,$337.50
2025-08-19,20:30:00,23473.25,BUY,3,0.02h,Break Even,$-1.50,$336.00,$255888.50,422,$336.00
2025-08-19,20:37:00,23468.0,SELL,3,0.02h,Break Even,$-1.50,$334.50,$255887.00,422,$334.50
2025-08-19,20:51:00,23472.5,BUY,3,0.02h,Stop Loss,$-9.00,$325.50,$255878.00,422,$325.50
2025-08-19,22:14:00,23469.25,SELL,3,0.02h,Stop Loss,$19.50,$345.00,$255897.50,422,$345.00
2025-08-19,22:39:00,23466.5,BUY,3,0.02h,Stop Loss,$-9.00,$336.00,$255888.50,422,$336.00
2025-08-19,22:40:00,23465.25,SELL,3,0.02h,Break Even,$-1.50,$334.50,$255887.00,422,$334.50
2025-08-19,22:52:00,23468.25,BUY,3,0.02h,Stop Loss,$-9.00,$325.50,$255878.00,422,$325.50
2025-08-19,22:59:00,23461.25,SELL,3,0.02h,Stop Loss,$9.00,$334.50,$255887.00,422,$334.50
,,,,,,,,,,,
