Date,Time,MNQ Price,Operation type,Contracts,Trade duration,Close Reason,Net P&L,Daily P&L,Balance,Day,Daily P&L Total
2024-01-02,12:01:00,16874.25,SELL,1,0.02h,Stop Loss,$11.50,$11.50,$50011.50,1,$11.50
2024-01-02,13:30:00,16828.25,BUY,1,0.02h,Stop Loss,$-6.00,$5.50,$50005.50,1,$5.50
2024-01-02,14:07:00,16841.5,SELL,1,0.02h,Stop Loss,$-6.00,$-0.50,$49999.50,1,$-0.50
2024-01-02,14:08:00,16851.75,BUY,1,0.02h,Break Even,$0.25,$-0.25,$49999.75,1,$-0.25
2024-01-02,14:35:00,16832.0,SELL,1,0.02h,Stop Loss,$12.75,$12.50,$50012.50,1,$12.50
2024-01-02,16:02:00,16715.5,BUY,1,0.02h,Stop Loss,$21.50,$34.00,$50034.00,1,$34.00
2024-01-02,17:17:00,16772.5,SELL,1,0.02h,Stop Loss,$81.50,$115.50,$50115.50,1,$115.50
2024-01-02,17:37:00,16772.25,BUY,1,0.02h,Stop Loss,$-6.00,$109.50,$50109.50,1,$109.50
2024-01-02,17:48:00,16758.25,SELL,1,0.02h,Stop Loss,$54.00,$163.50,$50163.50,1,$163.50
2024-01-02,18:22:00,16730.5,BUY,1,0.02h,Stop Loss,$-6.00,$157.50,$50157.50,1,$157.50
2024-01-02,18:49:00,16729.75,SELL,1,0.02h,Stop Loss,$14.00,$171.50,$50171.50,1,$171.50
2024-01-02,19:29:00,16695.5,BUY,1,0.02h,Stop Loss,$14.00,$185.50,$50185.50,1,$185.50
2024-01-02,19:40:00,16684.75,SELL,1,0.02h,Stop Loss,$6.50,$192.00,$50192.00,1,$192.00
2024-01-02,20:31:00,16651.25,BUY,1,0.02h,Stop Loss,$20.25,$212.25,$50212.25,1,$212.25
2024-01-02,20:40:00,16640.25,SELL,1,0.02h,Break Even,$0.25,$212.50,$50212.50,1,$212.50
2024-01-02,20:44:00,16649.0,BUY,1,0.02h,Stop Loss,$14.00,$226.50,$50226.50,1,$226.50
Final P&L Day: 226.50,,,,,,,,,,,
2024-01-03,12:00:00,16648.5,SELL,1,0.02h,Break Even,$0.25,$0.25,$50226.75,2,$0.25
2024-01-03,13:12:00,16614.25,BUY,1,0.02h,Stop Loss,$-6.00,$-5.75,$50220.75,2,$-5.75
2024-01-03,13:50:00,16631.5,SELL,1,0.02h,Stop Loss,$-6.00,$-11.75,$50214.75,2,$-11.75
2024-01-03,13:52:00,16640.25,BUY,1,0.02h,Stop Loss,$-6.00,$-17.75,$50208.75,2,$-17.75
2024-01-03,13:54:00,16631.5,SELL,1,0.02h,Stop Loss,$-6.00,$-23.75,$50202.75,2,$-23.75
2024-01-03,14:32:00,16617.25,BUY,1,0.02h,Break Even,$0.25,$-23.50,$50203.00,2,$-23.50
2024-01-03,14:33:00,16593.0,SELL,1,0.02h,Stop Loss,$41.50,$18.00,$50244.50,2,$18.00
2024-01-03,14:36:00,16630.5,BUY,1,0.02h,Break Even,$0.25,$18.25,$50244.75,2,$18.25
2024-01-03,14:57:00,16607.0,SELL,1,0.02h,Stop Loss,$51.50,$69.75,$50296.25,2,$69.75
2024-01-03,15:04:00,16640.0,BUY,1,0.02h,Stop Loss,$17.75,$87.50,$50314.00,2,$87.50
2024-01-03,15:10:00,16608.0,SELL,1,0.02h,Stop Loss,$77.75,$165.25,$50391.75,2,$165.25
2024-01-03,15:53:00,16577.75,BUY,1,0.02h,Break Even,$0.25,$165.50,$50392.00,2,$165.50
2024-01-03,16:23:00,16585.5,SELL,1,0.02h,Stop Loss,$-6.00,$159.50,$50386.00,2,$159.50
2024-01-03,16:34:00,16600.25,BUY,1,0.02h,Stop Loss,$-6.00,$153.50,$50380.00,2,$153.50
2024-01-03,16:36:00,16589.25,SELL,1,0.02h,Stop Loss,$19.00,$172.50,$50399.00,2,$172.50
2024-01-03,17:28:00,16571.0,BUY,1,0.02h,Stop Loss,$14.00,$186.50,$50413.00,2,$186.50
2024-01-03,18:21:00,16590.5,SELL,1,0.02h,Break Even,$0.25,$186.75,$50413.25,2,$186.75
2024-01-03,19:26:00,16590.75,BUY,1,0.02h,Stop Loss,$81.50,$268.25,$50494.75,2,$268.25
2024-01-03,19:53:00,16596.25,SELL,1,0.02h,Stop Loss,$-6.00,$262.25,$50488.75,2,$262.25
2024-01-03,20:34:00,16572.5,BUY,1,0.02h,Stop Loss,$21.50,$283.75,$50510.25,2,$283.75
2024-01-03,20:44:00,16555.25,SELL,1,0.02h,Stop Loss,$36.50,$320.25,$50546.75,2,$320.25
2024-01-03,21:32:00,16536.25,BUY,1,0.02h,Stop Loss,$-6.00,$314.25,$50540.75,2,$314.25
2024-01-03,21:33:00,16535.0,SELL,1,0.03h,Stop Loss,$-6.00,$308.25,$50534.75,2,$308.25
2024-01-03,21:36:00,16536.75,BUY,1,0.02h,Stop Loss,$-6.00,$302.25,$50528.75,2,$302.25
2024-01-03,21:37:00,16535.0,SELL,1,0.03h,Stop Loss,$-6.00,$296.25,$50522.75,2,$296.25
2024-01-03,21:39:00,16536.5,BUY,1,0.03h,Stop Loss,$-6.00,$290.25,$50516.75,2,$290.25
Final P&L Day: 290.25,,,,,,,,,,,
2024-01-04,12:00:00,16529.25,SELL,1,0.02h,Stop Loss,$-6.00,$-6.00,$50510.75,3,$-6.00
2024-01-04,12:29:00,16525.25,BUY,1,0.02h,Break Even,$0.25,$-5.75,$50511.00,3,$-5.75
2024-01-04,12:42:00,16521.75,SELL,1,0.02h,Break Even,$0.25,$-5.50,$50511.25,3,$-5.50
2024-01-04,12:43:00,16527.75,BUY,1,0.02h,Stop Loss,$-6.00,$-11.50,$50505.25,3,$-11.50
2024-01-04,12:54:00,16523.75,SELL,1,0.02h,Break Even,$0.25,$-11.25,$50505.50,3,$-11.25
2024-01-04,14:14:00,16466.75,BUY,1,0.02h,Stop Loss,$5.25,$-6.00,$50510.75,3,$-6.00
2024-01-04,14:23:00,16461.25,SELL,1,0.02h,Break Even,$0.25,$-5.75,$50511.00,3,$-5.75
2024-01-04,14:33:00,16488.25,BUY,1,0.02h,Stop Loss,$-6.00,$-11.75,$50505.00,3,$-11.75
2024-01-04,14:49:00,16460.25,SELL,1,0.02h,Stop Loss,$25.25,$13.50,$50530.25,3,$13.50
2024-01-04,14:53:00,16485.75,BUY,1,0.02h,Stop Loss,$5.25,$18.75,$50535.50,3,$18.75
2024-01-04,14:59:00,16458.5,SELL,1,0.02h,Stop Loss,$17.75,$36.50,$50553.25,3,$36.50
2024-01-04,15:02:00,16491.25,BUY,1,0.02h,Stop Loss,$-6.00,$30.50,$50547.25,3,$30.50
2024-01-04,16:33:00,16551.75,SELL,1,0.02h,Stop Loss,$-6.00,$24.50,$50541.25,3,$24.50
2024-01-04,16:38:00,16571.25,BUY,1,0.02h,Stop Loss,$-6.00,$18.50,$50535.25,3,$18.50
2024-01-04,16:40:00,16558.5,SELL,1,0.02h,Stop Loss,$4.00,$22.50,$50539.25,3,$22.50
2024-01-04,17:30:00,16523.75,BUY,1,0.02h,Break Even,$0.25,$22.75,$50539.50,3,$22.75
2024-01-04,17:32:00,16516.5,SELL,1,0.02h,Stop Loss,$20.25,$43.00,$50559.75,3,$43.00
2024-01-04,17:42:00,16520.5,BUY,1,0.02h,Stop Loss,$-6.00,$37.00,$50553.75,3,$37.00
2024-01-04,17:44:00,16510.25,SELL,1,0.02h,Stop Loss,$52.75,$89.75,$50606.50,3,$89.75
2024-01-04,18:05:00,16509.5,BUY,1,0.02h,Break Even,$0.25,$90.00,$50606.75,3,$90.00
2024-01-04,18:13:00,16495.75,SELL,1,0.02h,Break Even,$0.25,$90.25,$50607.00,3,$90.25
2024-01-04,18:15:00,16506.75,BUY,1,0.02h,Stop Loss,$-6.00,$84.25,$50601.00,3,$84.25
2024-01-04,18:16:00,16501.0,SELL,1,0.02h,Stop Loss,$14.00,$98.25,$50615.00,3,$98.25
2024-01-04,18:18:00,16509.5,BUY,1,0.02h,Break Even,$0.25,$98.50,$50615.25,3,$98.50
2024-01-04,18:54:00,16514.75,SELL,1,0.02h,Stop Loss,$19.00,$117.50,$50634.25,3,$117.50
2024-01-04,19:52:00,16492.25,BUY,1,0.02h,Stop Loss,$9.00,$126.50,$50643.25,3,$126.50
2024-01-04,20:17:00,16478.5,SELL,1,0.02h,Break Even,$0.25,$126.75,$50643.50,3,$126.75
2024-01-04,20:33:00,16494.0,BUY,1,0.02h,Stop Loss,$11.50,$138.25,$50655.00,3,$138.25
2024-01-04,20:44:00,16482.25,SELL,1,0.02h,Stop Loss,$-6.00,$132.25,$50649.00,3,$132.25
2024-01-04,21:28:00,16450.5,BUY,1,0.02h,Break Even,$0.25,$132.50,$50649.25,3,$132.50
2024-01-04,21:54:00,16449.25,SELL,1,0.02h,Break Even,$0.25,$132.75,$50649.50,3,$132.75
Final P&L Day: 132.75,,,,,,,,,,,
2024-01-05,12:37:00,16399.0,BUY,1,0.02h,Break Even,$0.25,$0.25,$50649.75,4,$0.25
2024-01-05,12:49:00,16395.5,SELL,1,0.02h,Break Even,$0.25,$0.50,$50650.00,4,$0.50
2024-01-05,13:15:00,16399.25,BUY,1,0.02h,Break Even,$0.25,$0.75,$50650.25,4,$0.75
2024-01-05,13:31:00,16362.75,SELL,1,0.02h,Stop Loss,$126.50,$127.25,$50776.75,4,$127.25
2024-01-05,13:52:00,16388.75,BUY,1,0.02h,Break Even,$0.25,$127.50,$50777.00,4,$127.50
2024-01-05,16:19:00,16541.25,SELL,1,0.02h,Stop Loss,$10.25,$137.75,$50787.25,4,$137.75
2024-01-05,17:42:00,16476.5,BUY,1,0.02h,Break Even,$0.25,$138.00,$50787.50,4,$138.00
2024-01-05,18:01:00,16468.0,SELL,1,0.02h,Stop Loss,$30.25,$168.25,$50817.75,4,$168.25
2024-01-05,18:28:00,16457.25,BUY,1,0.02h,Stop Loss,$34.00,$202.25,$50851.75,4,$202.25
2024-01-05,19:17:00,16486.5,SELL,1,0.02h,Stop Loss,$5.25,$207.50,$50857.00,4,$207.50
2024-01-05,20:39:00,16430.25,BUY,1,0.02h,Stop Loss,$-6.00,$201.50,$50851.00,4,$201.50
2024-01-05,21:31:00,16461.25,SELL,1,0.02h,Stop Loss,$-6.00,$195.50,$50845.00,4,$195.50
2024-01-05,21:51:00,16463.5,BUY,1,0.03h,Stop Loss,$-6.00,$189.50,$50839.00,4,$189.50
Final P&L Day: 189.50,,,,,,,,,,,
2024-01-08,12:01:00,16453.75,SELL,1,0.02h,Stop Loss,$-6.00,$-6.00,$50833.00,5,$-6.00
2024-01-08,12:08:00,16468.25,BUY,1,0.02h,Break Even,$0.25,$-5.75,$50833.25,5,$-5.75
2024-01-08,12:32:00,16463.75,SELL,1,0.02h,Break Even,$0.25,$-5.50,$50833.50,5,$-5.50
2024-01-08,12:57:00,16462.0,BUY,1,0.02h,Stop Loss,$54.00,$48.50,$50887.50,5,$48.50
2024-01-08,13:48:00,16486.25,SELL,1,0.02h,Break Even,$0.25,$48.75,$50887.75,5,$48.75
2024-01-08,14:12:00,16490.25,BUY,1,0.02h,Stop Loss,$6.50,$55.25,$50894.25,5,$55.25
2024-01-08,16:12:00,16645.5,SELL,1,0.02h,Stop Loss,$9.00,$64.25,$50903.25,5,$64.25
2024-01-08,16:22:00,16661.75,BUY,1,0.02h,Break Even,$0.25,$64.50,$50903.50,5,$64.50
2024-01-08,16:24:00,16650.0,SELL,1,0.02h,Break Even,$0.25,$64.75,$50903.75,5,$64.75
2024-01-08,16:34:00,16658.5,BUY,1,0.02h,Stop Loss,$11.50,$76.25,$50915.25,5,$76.25
2024-01-08,16:49:00,16655.5,SELL,1,0.02h,Break Even,$0.25,$76.50,$50915.50,5,$76.50
2024-01-08,16:53:00,16658.75,BUY,1,0.02h,Break Even,$0.25,$76.75,$50915.75,5,$76.75
2024-01-08,17:26:00,16682.25,SELL,1,0.02h,Break Even,$0.25,$77.00,$50916.00,5,$77.00
2024-01-08,17:32:00,16685.75,BUY,1,0.02h,Break Even,$0.25,$77.25,$50916.25,5,$77.25
2024-01-08,18:33:00,16714.25,SELL,1,0.02h,Break Even,$0.25,$77.50,$50916.50,5,$77.50
2024-01-08,18:34:00,16715.75,BUY,1,0.02h,Break Even,$0.25,$77.75,$50916.75,5,$77.75
2024-01-08,20:15:00,16776.25,SELL,1,0.02h,Break Even,$0.25,$78.00,$50917.00,5,$78.00
2024-01-08,20:16:00,16779.75,BUY,1,0.02h,Break Even,$0.25,$78.25,$50917.25,5,$78.25
2024-01-08,20:17:00,16777.0,SELL,1,0.02h,Stop Loss,$-6.00,$72.25,$50911.25,5,$72.25
2024-01-08,20:18:00,16784.25,BUY,1,0.02h,Stop Loss,$15.25,$87.50,$50926.50,5,$87.50
2024-01-08,20:30:00,16778.0,SELL,1,0.02h,Stop Loss,$6.50,$94.00,$50933.00,5,$94.00
2024-01-08,20:35:00,16786.0,BUY,1,0.02h,Stop Loss,$-6.00,$88.00,$50927.00,5,$88.00
2024-01-08,20:48:00,16777.0,SELL,1,0.02h,Break Even,$0.25,$88.25,$50927.25,5,$88.25
2024-01-08,20:52:00,16801.0,BUY,1,0.02h,Stop Loss,$11.50,$99.75,$50938.75,5,$99.75
2024-01-08,21:11:00,16792.5,SELL,1,0.02h,Break Even,$0.25,$100.00,$50939.00,5,$100.00
Final P&L Day: 100.00,,,,,,,,,,,
2024-01-09,12:38:00,16716.0,BUY,1,0.02h,Break Even,$0.25,$0.25,$50939.25,6,$0.25
2024-01-09,13:04:00,16711.0,SELL,1,0.02h,Stop Loss,$9.00,$9.25,$50948.25,6,$9.25
2024-01-09,14:11:00,16677.5,BUY,1,0.02h,Break Even,$0.25,$9.50,$50948.50,6,$9.50
2024-01-09,14:22:00,16670.0,SELL,1,0.02h,Stop Loss,$-6.00,$3.50,$50942.50,6,$3.50
2024-01-09,14:24:00,16674.25,BUY,1,0.02h,Stop Loss,$-6.00,$-2.50,$50936.50,6,$-2.50
2024-01-09,14:25:00,16667.75,SELL,1,0.02h,Stop Loss,$-6.00,$-8.50,$50930.50,6,$-8.50
2024-01-09,14:27:00,16676.0,BUY,1,0.02h,Stop Loss,$5.25,$-3.25,$50935.75,6,$-3.25
2024-01-09,14:46:00,16676.0,SELL,1,0.02h,Stop Loss,$5.25,$2.00,$50941.00,6,$2.00
2024-01-09,14:57:00,16687.5,BUY,1,0.02h,Stop Loss,$29.00,$31.00,$50970.00,6,$31.00
2024-01-09,15:33:00,16713.0,SELL,1,0.02h,Stop Loss,$-6.00,$25.00,$50964.00,6,$25.00
2024-01-09,15:36:00,16731.25,BUY,1,0.02h,Stop Loss,$14.00,$39.00,$50978.00,6,$39.00
2024-01-09,15:59:00,16729.5,SELL,1,0.02h,Stop Loss,$-6.00,$33.00,$50972.00,6,$33.00
2024-01-09,16:02:00,16750.0,BUY,1,0.02h,Stop Loss,$24.00,$57.00,$50996.00,6,$57.00
2024-01-09,17:34:00,16816.25,SELL,1,0.02h,Break Even,$0.25,$57.25,$50996.25,6,$57.25
2024-01-09,17:41:00,16828.75,BUY,1,0.02h,Break Even,$0.25,$57.50,$50996.50,6,$57.50
2024-01-09,18:25:00,16837.0,SELL,1,0.02h,Stop Loss,$30.25,$87.75,$51026.75,6,$87.75
2024-01-09,18:50:00,16830.5,BUY,1,0.02h,Stop Loss,$40.25,$128.00,$51067.00,6,$128.00
2024-01-09,19:15:00,16832.25,SELL,1,0.02h,Stop Loss,$45.25,$173.25,$51112.25,6,$173.25
2024-01-09,19:55:00,16826.75,BUY,1,0.02h,Stop Loss,$-6.00,$167.25,$51106.25,6,$167.25
2024-01-09,19:56:00,16819.75,SELL,1,0.02h,Break Even,$0.25,$167.50,$51106.50,6,$167.50
2024-01-09,19:57:00,16822.0,BUY,1,0.02h,Break Even,$0.25,$167.75,$51106.75,6,$167.75
2024-01-09,20:08:00,16814.0,SELL,1,0.02h,Stop Loss,$50.25,$218.00,$51157.00,6,$218.00
2024-01-09,20:18:00,16829.5,BUY,1,0.02h,Stop Loss,$-6.00,$212.00,$51151.00,6,$212.00
2024-01-09,20:19:00,16821.25,SELL,1,0.02h,Break Even,$0.25,$212.25,$51151.25,6,$212.25
2024-01-09,20:20:00,16825.5,BUY,1,0.02h,Stop Loss,$12.75,$225.00,$51164.00,6,$225.00
2024-01-09,20:32:00,16820.75,SELL,1,0.02h,Stop Loss,$4.00,$229.00,$51168.00,6,$229.00
2024-01-09,20:55:00,16829.5,BUY,1,0.02h,Stop Loss,$44.00,$273.00,$51212.00,6,$273.00
2024-01-09,21:29:00,16828.75,SELL,1,0.07h,Break Even,$0.25,$273.25,$51212.25,6,$273.25
2024-01-09,21:42:00,16831.25,BUY,1,0.02h,Stop Loss,$-6.00,$267.25,$51206.25,6,$267.25
2024-01-09,21:57:00,16828.75,SELL,1,0.02h,Break Even,$0.25,$267.50,$51206.50,6,$267.50
Final P&L Day: 267.50,,,,,,,,,,,
2024-01-10,12:00:00,16847.5,BUY,1,0.02h,Stop Loss,$21.50,$21.50,$51228.00,7,$21.50
2024-01-10,12:38:00,16856.5,SELL,1,0.02h,Break Even,$0.25,$21.75,$51228.25,7,$21.75
2024-01-10,13:16:00,16845.25,BUY,1,0.02h,Stop Loss,$-6.00,$15.75,$51222.25,7,$15.75
2024-01-10,13:19:00,16840.25,SELL,1,0.02h,Break Even,$0.25,$16.00,$51222.50,7,$16.00
2024-01-10,13:29:00,16847.5,BUY,1,0.02h,Break Even,$0.25,$16.25,$51222.75,7,$16.25
2024-01-10,13:30:00,16839.0,SELL,1,0.02h,Stop Loss,$19.00,$35.25,$51241.75,7,$35.25
2024-01-10,14:13:00,16825.5,BUY,1,0.02h,Break Even,$0.25,$35.50,$51242.00,7,$35.50
2024-01-10,14:51:00,16831.75,SELL,1,0.02h,Stop Loss,$64.00,$99.50,$51306.00,7,$99.50
2024-01-10,15:13:00,16843.0,BUY,1,0.02h,Stop Loss,$39.00,$138.50,$51345.00,7,$138.50
2024-01-10,16:12:00,16876.5,SELL,1,0.02h,Stop Loss,$31.50,$170.00,$51376.50,7,$170.00
2024-01-10,16:42:00,16878.75,BUY,1,0.02h,Break Even,$0.25,$170.25,$51376.75,7,$170.25
2024-01-10,16:53:00,16863.75,SELL,1,0.02h,Break Even,$0.25,$170.50,$51377.00,7,$170.50
2024-01-10,16:57:00,16878.75,BUY,1,0.02h,Stop Loss,$4.00,$174.50,$51381.00,7,$174.50
2024-01-10,18:12:00,16893.0,SELL,1,0.02h,Stop Loss,$12.75,$187.25,$51393.75,7,$187.25
2024-01-10,18:19:00,16909.5,BUY,1,0.02h,Stop Loss,$-6.00,$181.25,$51387.75,7,$181.25
2024-01-10,18:22:00,16899.0,SELL,1,0.02h,Stop Loss,$9.00,$190.25,$51396.75,7,$190.25
2024-01-10,18:26:00,16910.25,BUY,1,0.02h,Break Even,$0.25,$190.50,$51397.00,7,$190.50
2024-01-10,19:39:00,16944.25,SELL,1,0.02h,Stop Loss,$-6.00,$184.50,$51391.00,7,$184.50
2024-01-10,19:42:00,16952.0,BUY,1,0.02h,Break Even,$0.25,$184.75,$51391.25,7,$184.75
2024-01-10,20:16:00,16962.5,SELL,1,0.02h,Break Even,$0.25,$185.00,$51391.50,7,$185.00
2024-01-10,20:59:00,16946.0,BUY,1,0.02h,Stop Loss,$12.75,$197.75,$51404.25,7,$197.75
2024-01-10,21:42:00,16951.75,SELL,1,0.02h,Stop Loss,$-6.00,$191.75,$51398.25,7,$191.75
2024-01-10,21:43:00,16952.75,BUY,1,0.03h,Break Even,$0.25,$192.00,$51398.50,7,$192.00
Final P&L Day: 192.00,,,,,,,,,,,
2024-01-11,12:56:00,17007.25,SELL,1,0.02h,Stop Loss,$-6.00,$-6.00,$51392.50,8,$-6.00
2024-01-11,13:17:00,17008.25,BUY,1,0.02h,Break Even,$0.25,$-5.75,$51392.75,8,$-5.75
2024-01-11,13:31:00,16956.25,SELL,1,0.02h,Stop Loss,$251.50,$245.75,$51644.25,8,$245.75
2024-01-11,14:10:00,16943.0,BUY,1,0.02h,Stop Loss,$10.25,$256.00,$51654.50,8,$256.00
2024-01-11,14:47:00,16972.5,SELL,1,0.02h,Stop Loss,$46.50,$302.50,$51701.00,8,$302.50
2024-01-11,15:29:00,16890.0,BUY,1,0.02h,Break Even,$0.25,$302.75,$51701.25,8,$302.75
2024-01-11,15:50:00,16874.75,SELL,1,0.02h,Stop Loss,$61.50,$364.25,$51762.75,8,$364.25
2024-01-11,17:05:00,16794.25,BUY,1,0.02h,Stop Loss,$24.00,$388.25,$51786.75,8,$388.25
2024-01-11,17:29:00,16793.0,SELL,1,0.02h,Stop Loss,$46.50,$434.75,$51833.25,8,$434.75
2024-01-11,17:41:00,16811.0,BUY,1,0.02h,Stop Loss,$54.00,$488.75,$51887.25,8,$488.75
2024-01-11,19:25:00,16924.0,SELL,1,0.02h,Stop Loss,$-6.00,$482.75,$51881.25,8,$482.75
2024-01-11,19:26:00,16931.25,BUY,1,0.02h,Stop Loss,$10.25,$493.00,$51891.50,8,$493.00
2024-01-11,20:06:00,16949.75,SELL,1,0.02h,Stop Loss,$-6.00,$487.00,$51885.50,8,$487.00
2024-01-11,20:26:00,16957.25,BUY,1,0.02h,Stop Loss,$4.00,$491.00,$51889.50,8,$491.00
2024-01-11,20:38:00,16944.5,SELL,1,0.02h,Break Even,$0.25,$491.25,$51889.75,8,$491.25
2024-01-11,20:50:00,16953.5,BUY,1,0.02h,Stop Loss,$4.00,$495.25,$51893.75,8,$495.25
2024-01-11,20:52:00,16941.75,SELL,1,0.02h,Stop Loss,$45.25,$540.50,$51939.00,8,$540.50
2024-01-11,20:55:00,16955.25,BUY,1,0.02h,Stop Loss,$17.75,$558.25,$51956.75,8,$558.25
2024-01-11,21:28:00,16961.5,SELL,1,0.02h,Stop Loss,$-6.00,$552.25,$51950.75,8,$552.25
Final P&L Day: 552.25,,,,,,,,,,,
2024-01-12,12:31:00,16912.0,BUY,1,0.02h,Break Even,$0.25,$0.25,$51951.00,9,$0.25
2024-01-12,12:53:00,16909.25,SELL,1,0.02h,Break Even,$0.25,$0.50,$51951.25,9,$0.50
2024-01-12,12:55:00,16917.5,BUY,1,0.02h,Break Even,$0.25,$0.75,$51951.50,9,$0.75
2024-01-12,12:57:00,16911.0,SELL,1,0.02h,Stop Loss,$4.00,$4.75,$51955.50,9,$4.75
2024-01-12,13:04:00,16925.0,BUY,1,0.02h,Break Even,$0.25,$5.00,$51955.75,9,$5.00
2024-01-12,13:10:00,16909.0,SELL,1,0.02h,Break Even,$0.25,$5.25,$51956.00,9,$5.25
2024-01-12,13:31:00,16952.5,BUY,1,0.02h,Stop Loss,$80.25,$85.50,$52036.25,9,$85.50
2024-01-12,15:00:00,16986.25,SELL,1,0.02h,Stop Loss,$162.75,$248.25,$52199.00,9,$248.25
2024-01-12,15:32:00,16984.0,BUY,1,0.02h,Stop Loss,$12.75,$261.00,$52211.75,9,$261.00
2024-01-12,15:40:00,16956.25,SELL,1,0.02h,Break Even,$0.25,$261.25,$52212.00,9,$261.25
2024-01-12,16:07:00,16958.0,BUY,1,0.02h,Stop Loss,$35.25,$296.50,$52247.25,9,$296.50
2024-01-12,16:37:00,16963.5,SELL,1,0.02h,Stop Loss,$126.50,$423.00,$52373.75,9,$423.00
2024-01-12,17:15:00,16940.0,BUY,1,0.02h,Stop Loss,$7.75,$430.75,$52381.50,9,$430.75
2024-01-12,17:28:00,16936.0,SELL,1,0.02h,Stop Loss,$16.50,$447.25,$52398.00,9,$447.25
2024-01-12,17:31:00,16949.75,BUY,1,0.02h,Stop Loss,$9.00,$456.25,$52407.00,9,$456.25
2024-01-12,17:38:00,16935.25,SELL,1,0.02h,Stop Loss,$-6.00,$450.25,$52401.00,9,$450.25
2024-01-12,17:54:00,16957.5,BUY,1,0.02h,Stop Loss,$9.00,$459.25,$52410.00,9,$459.25
2024-01-12,19:23:00,16969.25,SELL,1,0.02h,Stop Loss,$-6.00,$453.25,$52404.00,9,$453.25
2024-01-12,20:30:00,16953.75,BUY,1,0.02h,Stop Loss,$9.00,$462.25,$52413.00,9,$462.25
2024-01-12,21:05:00,16959.75,SELL,1,0.02h,Stop Loss,$-6.00,$456.25,$52407.00,9,$456.25
2024-01-12,21:58:00,16955.25,BUY,1,0.02h,Break Even,$0.25,$456.50,$52407.25,9,$456.50
Final P&L Day: 456.50,,,,,,,,,,,
2024-01-15,12:36:00,16971.5,SELL,1,0.02h,Break Even,$0.25,$0.25,$52407.50,10,$0.25
2024-01-15,13:22:00,16964.25,BUY,1,0.02h,Stop Loss,$-6.00,$-5.75,$52401.50,10,$-5.75
2024-01-15,13:41:00,16959.0,SELL,1,0.02h,Break Even,$0.25,$-5.50,$52401.75,10,$-5.50
2024-01-15,14:27:00,16954.75,BUY,1,0.03h,Stop Loss,$10.25,$4.75,$52412.00,10,$4.75
2024-01-15,14:47:00,16951.25,SELL,1,0.02h,Break Even,$0.25,$5.00,$52412.25,10,$5.00
2024-01-15,15:03:00,16956.25,BUY,1,0.02h,Stop Loss,$-6.00,$-1.00,$52406.25,10,$-1.00
2024-01-15,15:05:00,16949.0,SELL,1,0.02h,Stop Loss,$-6.00,$-7.00,$52400.25,10,$-7.00
2024-01-15,15:26:00,16954.25,BUY,1,0.02h,Stop Loss,$-6.00,$-13.00,$52394.25,10,$-13.00
2024-01-15,16:11:00,16968.5,SELL,1,0.02h,Stop Loss,$-6.00,$-19.00,$52388.25,10,$-19.00
2024-01-15,16:28:00,16972.25,BUY,1,0.03h,Break Even,$0.25,$-18.75,$52388.50,10,$-18.75
2024-01-15,16:47:00,16970.5,SELL,1,0.03h,Stop Loss,$-6.00,$-24.75,$52382.50,10,$-24.75
2024-01-15,17:09:00,16970.25,BUY,1,0.02h,Break Even,$0.25,$-24.50,$52382.75,10,$-24.50
2024-01-15,17:22:00,16965.25,SELL,1,0.02h,Stop Loss,$-6.00,$-30.50,$52376.75,10,$-30.50
2024-01-15,17:27:00,16971.0,BUY,1,0.02h,Break Even,$0.25,$-30.25,$52377.00,10,$-30.25
2024-01-15,17:39:00,16965.5,SELL,1,0.03h,Break Even,$0.25,$-30.00,$52377.25,10,$-30.00
2024-01-15,17:50:00,16969.5,BUY,1,0.02h,Stop Loss,$-6.00,$-36.00,$52371.25,10,$-36.00
2024-01-15,17:52:00,16966.5,SELL,1,0.02h,Stop Loss,$-6.00,$-42.00,$52365.25,10,$-42.00
2024-01-15,17:56:00,16969.0,BUY,1,0.03h,Stop Loss,$-6.00,$-48.00,$52359.25,10,$-48.00
Final P&L Day: -48.00,,,,,,,,,,,
2024-01-16,12:00:00,16881.25,SELL,1,0.02h,Stop Loss,$-6.00,$-6.00,$52353.25,11,$-6.00
2024-01-16,12:34:00,16894.5,BUY,1,0.02h,Stop Loss,$-6.00,$-12.00,$52347.25,11,$-12.00
2024-01-16,12:36:00,16889.0,SELL,1,0.02h,Stop Loss,$-6.00,$-18.00,$52341.25,11,$-18.00
2024-01-16,12:37:00,16894.75,BUY,1,0.02h,Stop Loss,$4.00,$-14.00,$52345.25,11,$-14.00
2024-01-16,13:07:00,16905.5,SELL,1,0.02h,Stop Loss,$5.25,$-8.75,$52350.50,11,$-8.75
2024-01-16,13:34:00,16909.0,BUY,1,0.02h,Stop Loss,$52.75,$44.00,$52403.25,11,$44.00
2024-01-16,13:52:00,16901.25,SELL,1,0.02h,Stop Loss,$12.75,$56.75,$52416.00,11,$56.75
2024-01-16,14:27:00,16905.75,BUY,1,0.02h,Break Even,$0.25,$57.00,$52416.25,11,$57.00
2024-01-16,14:42:00,16884.0,SELL,1,0.02h,Stop Loss,$52.75,$109.75,$52469.00,11,$109.75
2024-01-16,14:59:00,16903.75,BUY,1,0.02h,Stop Loss,$64.00,$173.75,$52533.00,11,$173.75
2024-01-16,16:01:00,16977.75,SELL,1,0.02h,Stop Loss,$201.50,$375.25,$52734.50,11,$375.25
2024-01-16,16:20:00,16989.75,BUY,1,0.02h,Stop Loss,$24.00,$399.25,$52758.50,11,$399.25
2024-01-16,16:43:00,16997.0,SELL,1,0.02h,Stop Loss,$66.50,$465.75,$52825.00,11,$465.75
2024-01-16,18:12:00,16911.5,BUY,1,0.02h,Stop Loss,$-6.00,$459.75,$52819.00,11,$459.75
2024-01-16,18:43:00,16921.0,SELL,1,0.02h,Stop Loss,$14.00,$473.75,$52833.00,11,$473.75
2024-01-16,19:29:00,16894.75,BUY,1,0.02h,Break Even,$0.25,$474.00,$52833.25,11,$474.00
2024-01-16,19:32:00,16882.0,SELL,1,0.02h,Break Even,$0.25,$474.25,$52833.50,11,$474.25
2024-01-16,19:35:00,16898.0,BUY,1,0.02h,Break Even,$0.25,$474.50,$52833.75,11,$474.50
2024-01-16,20:32:00,16929.0,SELL,1,0.02h,Break Even,$0.25,$474.75,$52834.00,11,$474.75
2024-01-16,20:41:00,16936.0,BUY,1,0.02h,Break Even,$0.25,$475.00,$52834.25,11,$475.00
Final P&L Day: 475.00,,,,,,,,,,,
2024-01-17,12:00:00,16891.75,SELL,1,0.02h,Stop Loss,$-6.00,$-6.00,$52828.25,12,$-6.00
2024-01-17,12:56:00,16899.25,BUY,1,0.02h,Break Even,$0.25,$-5.75,$52828.50,12,$-5.75
2024-01-17,13:01:00,16882.5,SELL,1,0.02h,Break Even,$0.25,$-5.50,$52828.75,12,$-5.50
2024-01-17,14:11:00,16834.0,BUY,1,0.02h,Break Even,$0.25,$-5.25,$52829.00,12,$-5.25
2024-01-17,14:25:00,16821.5,SELL,1,0.02h,Stop Loss,$4.00,$-1.25,$52833.00,12,$-1.25
2024-01-17,15:10:00,16735.5,BUY,1,0.02h,Stop Loss,$-6.00,$-7.25,$52827.00,12,$-7.25
2024-01-17,15:22:00,16722.75,SELL,1,0.02h,Stop Loss,$15.25,$8.00,$52842.25,12,$8.00
2024-01-17,15:26:00,16745.75,BUY,1,0.02h,Stop Loss,$32.75,$40.75,$52875.00,12,$40.75
2024-01-17,15:58:00,16757.25,SELL,1,0.02h,Stop Loss,$9.00,$49.75,$52884.00,12,$49.75
2024-01-17,16:00:00,16769.25,BUY,1,0.02h,Stop Loss,$36.50,$86.25,$52920.50,12,$86.25
2024-01-17,16:52:00,16803.0,SELL,1,0.02h,Stop Loss,$-6.00,$80.25,$52914.50,12,$80.25
2024-01-17,17:15:00,16817.0,BUY,1,0.02h,Stop Loss,$12.75,$93.00,$52927.25,12,$93.00
2024-01-17,17:22:00,16806.5,SELL,1,0.02h,Stop Loss,$25.25,$118.25,$52952.50,12,$118.25
2024-01-17,17:52:00,16800.0,BUY,1,0.02h,Stop Loss,$12.75,$131.00,$52965.25,12,$131.00
2024-01-17,18:12:00,16792.75,SELL,1,0.02h,Break Even,$0.25,$131.25,$52965.50,12,$131.25
2024-01-17,18:59:00,16763.25,BUY,1,0.02h,Stop Loss,$-6.00,$125.25,$52959.50,12,$125.25
2024-01-17,20:04:00,16811.25,SELL,1,0.02h,Break Even,$0.25,$125.50,$52959.75,12,$125.50
2024-01-17,20:34:00,16818.75,BUY,1,0.02h,Stop Loss,$25.25,$150.75,$52985.00,12,$150.75
2024-01-17,21:13:00,16857.75,SELL,1,0.02h,Stop Loss,$-6.00,$144.75,$52979.00,12,$144.75
2024-01-17,21:16:00,16861.75,BUY,1,0.02h,Stop Loss,$-6.00,$138.75,$52973.00,12,$138.75
2024-01-17,21:58:00,16860.25,SELL,1,0.02h,Stop Loss,$-6.00,$132.75,$52967.00,12,$132.75
Final P&L Day: 132.75,,,,,,,,,,,
2024-01-18,12:00:00,16992.75,BUY,1,0.02h,Break Even,$0.25,$0.25,$52967.25,13,$0.25
2024-01-18,13:00:00,17006.5,SELL,1,0.02h,Stop Loss,$-6.00,$-5.75,$52961.25,13,$-5.75
2024-01-18,13:07:00,17014.5,BUY,1,0.02h,Stop Loss,$4.00,$-1.75,$52965.25,13,$-1.75
2024-01-18,13:31:00,17000.75,SELL,1,0.02h,Stop Loss,$-6.00,$-7.75,$52959.25,13,$-7.75
2024-01-18,13:36:00,17038.25,BUY,1,0.02h,Stop Loss,$16.50,$8.75,$52975.75,13,$8.75
2024-01-18,13:41:00,17006.5,SELL,1,0.02h,Stop Loss,$52.75,$61.50,$53028.50,13,$61.50
2024-01-18,14:07:00,17001.75,BUY,1,0.02h,Stop Loss,$-6.00,$55.50,$53022.50,13,$55.50
2024-01-18,14:24:00,16997.0,SELL,1,0.02h,Stop Loss,$-6.00,$49.50,$53016.50,13,$49.50
2024-01-18,14:31:00,17029.75,BUY,1,0.02h,Stop Loss,$72.75,$122.25,$53089.25,13,$122.25
2024-01-18,14:53:00,17016.0,SELL,1,0.02h,Stop Loss,$31.50,$153.75,$53120.75,13,$153.75
2024-01-18,14:59:00,17029.25,BUY,1,0.02h,Stop Loss,$11.50,$165.25,$53132.25,13,$165.25
2024-01-18,15:03:00,17000.25,SELL,1,0.02h,Stop Loss,$49.00,$214.25,$53181.25,13,$214.25
2024-01-18,15:17:00,17020.75,BUY,1,0.02h,Stop Loss,$61.50,$275.75,$53242.75,13,$275.75
2024-01-18,15:22:00,17007.75,SELL,1,0.02h,Stop Loss,$-6.00,$269.75,$53236.75,13,$269.75
2024-01-18,15:23:00,17027.5,BUY,1,0.02h,Stop Loss,$4.00,$273.75,$53240.75,13,$273.75
2024-01-18,16:01:00,17041.5,SELL,1,0.02h,Stop Loss,$20.25,$294.00,$53261.00,13,$294.00
2024-01-18,16:14:00,17063.0,BUY,1,0.02h,Break Even,$0.25,$294.25,$53261.25,13,$294.25
2024-01-18,16:46:00,17076.75,SELL,1,0.02h,Stop Loss,$16.50,$310.75,$53277.75,13,$310.75
2024-01-18,16:54:00,17088.25,BUY,1,0.02h,Stop Loss,$-6.00,$304.75,$53271.75,13,$304.75
2024-01-18,16:58:00,17079.25,SELL,1,0.02h,Stop Loss,$-6.00,$298.75,$53265.75,13,$298.75
2024-01-18,17:45:00,17020.25,BUY,1,0.02h,Stop Loss,$20.25,$319.00,$53286.00,13,$319.00
2024-01-18,17:53:00,17005.75,SELL,1,0.02h,Stop Loss,$39.00,$358.00,$53325.00,13,$358.00
2024-01-18,18:34:00,16982.75,BUY,1,0.02h,Break Even,$0.25,$358.25,$53325.25,13,$358.25
2024-01-18,19:48:00,17071.0,SELL,1,0.02h,Stop Loss,$-6.00,$352.25,$53319.25,13,$352.25
2024-01-18,19:50:00,17094.5,BUY,1,0.02h,Stop Loss,$12.75,$365.00,$53332.00,13,$365.00
2024-01-18,20:40:00,17093.0,SELL,1,0.02h,Stop Loss,$20.25,$385.25,$53352.25,13,$385.25
2024-01-18,20:47:00,17107.5,BUY,1,0.02h,Stop Loss,$7.75,$393.00,$53360.00,13,$393.00
2024-01-18,21:01:00,17095.5,SELL,1,0.02h,Break Even,$0.25,$393.25,$53360.25,13,$393.25
2024-01-18,21:16:00,17107.25,BUY,1,0.02h,Stop Loss,$15.25,$408.50,$53375.50,13,$408.50
2024-01-18,21:47:00,17114.75,SELL,1,0.02h,Stop Loss,$-6.00,$402.50,$53369.50,13,$402.50
2024-01-18,21:53:00,17119.5,BUY,1,0.02h,Stop Loss,$-6.00,$396.50,$53363.50,13,$396.50
2024-01-18,21:57:00,17115.5,SELL,1,0.02h,Stop Loss,$-6.00,$390.50,$53357.50,13,$390.50
Final P&L Day: 390.50,,,,,,,,,,,
2024-01-19,12:00:00,17247.0,BUY,1,0.02h,Stop Loss,$-6.00,$-6.00,$53351.50,14,$-6.00
2024-01-19,12:41:00,17218.75,SELL,1,0.02h,Break Even,$0.25,$-5.75,$53351.75,14,$-5.75
2024-01-19,12:52:00,17226.0,BUY,1,0.02h,Stop Loss,$10.25,$4.50,$53362.00,14,$4.50
2024-01-19,13:27:00,17234.75,SELL,1,0.02h,Break Even,$0.25,$4.75,$53362.25,14,$4.75
2024-01-19,14:25:00,17221.5,BUY,1,0.02h,Stop Loss,$-6.00,$-1.25,$53356.25,14,$-1.25
2024-01-19,14:26:00,17207.0,SELL,1,0.02h,Stop Loss,$-6.00,$-7.25,$53350.25,14,$-7.25
2024-01-19,14:54:00,17207.0,BUY,1,0.02h,Stop Loss,$14.00,$6.75,$53364.25,14,$6.75
2024-01-19,15:08:00,17182.0,SELL,1,0.02h,Stop Loss,$50.25,$57.00,$53414.50,14,$57.00
2024-01-19,15:19:00,17209.5,BUY,1,0.02h,Stop Loss,$20.25,$77.25,$53434.75,14,$77.25
2024-01-19,16:36:00,17245.25,SELL,1,0.02h,Stop Loss,$27.75,$105.00,$53462.50,14,$105.00
2024-01-19,16:53:00,17250.0,BUY,1,0.02h,Stop Loss,$10.25,$115.25,$53472.75,14,$115.25
2024-01-19,17:12:00,17241.25,SELL,1,0.02h,Stop Loss,$-6.00,$109.25,$53466.75,14,$109.25
2024-01-19,17:15:00,17258.75,BUY,1,0.02h,Stop Loss,$11.50,$120.75,$53478.25,14,$120.75
2024-01-19,19:34:00,17406.25,SELL,1,0.02h,Stop Loss,$49.00,$169.75,$53527.25,14,$169.75
2024-01-19,19:42:00,17420.75,BUY,1,0.02h,Stop Loss,$-6.00,$163.75,$53521.25,14,$163.75
2024-01-19,20:22:00,17423.0,SELL,1,0.02h,Break Even,$0.25,$164.00,$53521.50,14,$164.00
2024-01-19,20:35:00,17435.5,BUY,1,0.02h,Stop Loss,$7.75,$171.75,$53529.25,14,$171.75
2024-01-19,20:41:00,17427.5,SELL,1,0.02h,Stop Loss,$-6.00,$165.75,$53523.25,14,$165.75
2024-01-19,20:42:00,17433.0,BUY,1,0.02h,Stop Loss,$4.00,$169.75,$53527.25,14,$169.75
2024-01-19,20:45:00,17426.0,SELL,1,0.02h,Break Even,$0.25,$170.00,$53527.50,14,$170.00
2024-01-19,20:46:00,17435.25,BUY,1,0.02h,Stop Loss,$6.50,$176.50,$53534.00,14,$176.50
2024-01-19,22:00:00,17463.25,SELL,1,62.00h,Stop Loss,$-6.00,$170.50,$53528.00,14,$170.50
Final P&L Day: 170.50,,,,,,,,,,,
2024-01-22,12:00:00,17535.75,BUY,1,0.02h,Break Even,$0.25,$0.25,$53528.25,15,$0.25
2024-01-22,13:02:00,17567.0,SELL,1,0.02h,Stop Loss,$21.50,$21.75,$53549.75,15,$21.75
2024-01-22,13:30:00,17560.0,BUY,1,0.02h,Stop Loss,$-6.00,$15.75,$53543.75,15,$15.75
2024-01-22,13:31:00,17551.75,SELL,1,0.02h,Stop Loss,$15.25,$31.00,$53559.00,15,$31.00
2024-01-22,14:24:00,17530.75,BUY,1,0.02h,Stop Loss,$-6.00,$25.00,$53553.00,15,$25.00
2024-01-22,14:43:00,17514.0,SELL,1,0.02h,Stop Loss,$89.00,$114.00,$53642.00,15,$114.00
2024-01-22,14:54:00,17541.0,BUY,1,0.02h,Stop Loss,$7.75,$121.75,$53649.75,15,$121.75
2024-01-22,15:04:00,17522.0,SELL,1,0.02h,Stop Loss,$90.25,$212.00,$53740.00,15,$212.00
2024-01-22,15:15:00,17538.25,BUY,1,0.02h,Stop Loss,$10.25,$222.25,$53750.25,15,$222.25
2024-01-22,15:20:00,17514.5,SELL,1,0.02h,Stop Loss,$19.00,$241.25,$53769.25,15,$241.25
2024-01-22,16:11:00,17472.5,BUY,1,0.02h,Break Even,$0.25,$241.50,$53769.50,15,$241.50
2024-01-22,17:07:00,17479.75,SELL,1,0.02h,Stop Loss,$66.50,$308.00,$53836.00,15,$308.00
2024-01-22,17:23:00,17493.75,BUY,1,0.02h,Stop Loss,$7.75,$315.75,$53843.75,15,$315.75
2024-01-22,17:35:00,17477.0,SELL,1,0.02h,Stop Loss,$21.50,$337.25,$53865.25,15,$337.25
2024-01-22,17:54:00,17490.75,BUY,1,0.02h,Break Even,$0.25,$337.50,$53865.50,15,$337.50
2024-01-22,18:01:00,17470.75,SELL,1,0.02h,Stop Loss,$11.50,$349.00,$53877.00,15,$349.00
2024-01-22,18:39:00,17466.0,BUY,1,0.02h,Break Even,$0.25,$349.25,$53877.25,15,$349.25
2024-01-22,19:14:00,17473.0,SELL,1,0.02h,Stop Loss,$12.75,$362.00,$53890.00,15,$362.00
2024-01-22,19:38:00,17466.0,BUY,1,0.02h,Stop Loss,$11.50,$373.50,$53901.50,15,$373.50
2024-01-22,19:49:00,17458.5,SELL,1,0.02h,Stop Loss,$-6.00,$367.50,$53895.50,15,$367.50
2024-01-22,19:57:00,17466.0,BUY,1,0.02h,Stop Loss,$-6.00,$361.50,$53889.50,15,$361.50
2024-01-22,20:03:00,17459.25,SELL,1,0.02h,Break Even,$0.25,$361.75,$53889.75,15,$361.75
2024-01-22,20:11:00,17473.25,BUY,1,0.02h,Stop Loss,$5.25,$367.00,$53895.00,15,$367.00
2024-01-22,20:43:00,17470.75,SELL,1,0.02h,Break Even,$0.25,$367.25,$53895.25,15,$367.25
2024-01-22,21:30:00,17454.5,BUY,1,0.02h,Stop Loss,$-6.00,$361.25,$53889.25,15,$361.25
2024-01-22,21:57:00,17456.25,SELL,1,0.03h,Stop Loss,$-6.00,$355.25,$53883.25,15,$355.25
Final P&L Day: 355.25,,,,,,,,,,,
2024-01-23,12:00:00,17474.25,BUY,1,0.02h,Break Even,$0.25,$0.25,$53883.50,16,$0.25
2024-01-23,12:28:00,17469.0,SELL,1,0.03h,Break Even,$0.25,$0.50,$53883.75,16,$0.50
2024-01-23,12:37:00,17473.75,BUY,1,0.02h,Break Even,$0.25,$0.75,$53884.00,16,$0.75
2024-01-23,12:49:00,17470.25,SELL,1,0.02h,Break Even,$0.25,$1.00,$53884.25,16,$1.00
2024-01-23,12:57:00,17479.5,BUY,1,0.02h,Break Even,$0.25,$1.25,$53884.50,16,$1.25
2024-01-23,13:52:00,17503.25,SELL,1,0.02h,Stop Loss,$-6.00,$-4.75,$53878.50,16,$-4.75
2024-01-23,14:51:00,17476.0,BUY,1,0.02h,Stop Loss,$7.75,$3.00,$53886.25,16,$3.00
2024-01-23,15:07:00,17467.5,SELL,1,0.02h,Break Even,$0.25,$3.25,$53886.50,16,$3.25
2024-01-23,15:08:00,17473.25,BUY,1,0.02h,Stop Loss,$15.25,$18.50,$53901.75,16,$18.50
2024-01-23,15:10:00,17466.75,SELL,1,0.02h,Stop Loss,$12.75,$31.25,$53914.50,16,$31.25
2024-01-23,15:12:00,17479.5,BUY,1,0.02h,Stop Loss,$10.25,$41.50,$53924.75,16,$41.50
2024-01-23,15:19:00,17455.75,SELL,1,0.02h,Stop Loss,$9.00,$50.50,$53933.75,16,$50.50
2024-01-23,15:39:00,17466.75,BUY,1,0.02h,Stop Loss,$20.25,$70.75,$53954.00,16,$70.75
2024-01-23,15:51:00,17457.75,SELL,1,0.02h,Stop Loss,$17.75,$88.50,$53971.75,16,$88.50
2024-01-23,16:04:00,17466.0,BUY,1,0.02h,Stop Loss,$15.25,$103.75,$53987.00,16,$103.75
2024-01-23,16:17:00,17448.75,SELL,1,0.02h,Stop Loss,$26.50,$130.25,$54013.50,16,$130.25
2024-01-23,16:46:00,17450.75,BUY,1,0.02h,Stop Loss,$19.00,$149.25,$54032.50,16,$149.25
2024-01-23,17:17:00,17453.25,SELL,1,0.02h,Break Even,$0.25,$149.50,$54032.75,16,$149.50
2024-01-23,17:43:00,17454.75,BUY,1,0.02h,Stop Loss,$-6.00,$143.50,$54026.75,16,$143.50
2024-01-23,18:30:00,17476.5,SELL,1,0.02h,Stop Loss,$-6.00,$137.50,$54020.75,16,$137.50
2024-01-23,18:49:00,17480.25,BUY,1,0.02h,Break Even,$0.25,$137.75,$54021.00,16,$137.75
2024-01-23,19:07:00,17473.75,SELL,1,0.02h,Stop Loss,$11.50,$149.25,$54032.50,16,$149.25
2024-01-23,19:39:00,17478.0,BUY,1,0.02h,Stop Loss,$-6.00,$143.25,$54026.50,16,$143.25
2024-01-23,20:36:00,17503.25,SELL,1,0.02h,Break Even,$0.25,$143.50,$54026.75,16,$143.50
2024-01-23,20:47:00,17513.0,BUY,1,0.02h,Stop Loss,$-6.00,$137.50,$54020.75,16,$137.50
2024-01-23,20:50:00,17503.5,SELL,1,0.02h,Break Even,$0.25,$137.75,$54021.00,16,$137.75
2024-01-23,20:51:00,17519.0,BUY,1,0.02h,Stop Loss,$10.25,$148.00,$54031.25,16,$148.00
2024-01-23,21:11:00,17520.25,SELL,1,0.02h,Break Even,$0.25,$148.25,$54031.50,16,$148.25
2024-01-23,21:15:00,17531.5,BUY,1,0.02h,Break Even,$0.25,$148.50,$54031.75,16,$148.50
Final P&L Day: 148.50,,,,,,,,,,,
2024-01-24,13:40:00,17678.75,SELL,1,0.02h,Break Even,$0.25,$0.25,$54032.00,17,$0.25
2024-01-24,14:15:00,17670.5,BUY,1,0.02h,Break Even,$0.25,$0.50,$54032.25,17,$0.50
2024-01-24,14:33:00,17667.75,SELL,1,0.02h,Stop Loss,$-6.00,$-5.50,$54026.25,17,$-5.50
2024-01-24,14:54:00,17668.25,BUY,1,0.02h,Break Even,$0.25,$-5.25,$54026.50,17,$-5.25
2024-01-24,15:02:00,17648.25,SELL,1,0.02h,Break Even,$0.25,$-5.00,$54026.75,17,$-5.00
2024-01-24,15:09:00,17681.25,BUY,1,0.02h,Stop Loss,$-6.00,$-11.00,$54020.75,17,$-11.00
2024-01-24,15:57:00,17732.25,SELL,1,0.02h,Break Even,$0.25,$-10.75,$54021.00,17,$-10.75
2024-01-24,16:01:00,17740.5,BUY,1,0.02h,Stop Loss,$-6.00,$-16.75,$54015.00,17,$-16.75
2024-01-24,16:07:00,17717.75,SELL,1,0.02h,Stop Loss,$79.00,$62.25,$54094.00,17,$62.25
2024-01-24,16:38:00,17718.0,BUY,1,0.02h,Stop Loss,$-6.00,$56.25,$54088.00,17,$56.25
2024-01-24,16:46:00,17708.75,SELL,1,0.02h,Break Even,$0.25,$56.50,$54088.25,17,$56.50
2024-01-24,16:49:00,17722.25,BUY,1,0.02h,Stop Loss,$15.25,$71.75,$54103.50,17,$71.75
2024-01-24,17:20:00,17740.75,SELL,1,0.02h,Stop Loss,$12.75,$84.50,$54116.25,17,$84.50
2024-01-24,17:23:00,17748.75,BUY,1,0.02h,Stop Loss,$6.50,$91.00,$54122.75,17,$91.00
2024-01-24,18:02:00,17758.5,SELL,1,0.02h,Stop Loss,$39.00,$130.00,$54161.75,17,$130.00
2024-01-24,18:29:00,17763.75,BUY,1,0.02h,Stop Loss,$-6.00,$124.00,$54155.75,17,$124.00
2024-01-24,18:34:00,17739.75,SELL,1,0.02h,Stop Loss,$-6.00,$118.00,$54149.75,17,$118.00
2024-01-24,19:44:00,17675.25,BUY,1,0.02h,Stop Loss,$17.75,$135.75,$54167.50,17,$135.75
2024-01-24,19:58:00,17662.0,SELL,1,0.02h,Break Even,$0.25,$136.00,$54167.75,17,$136.00
2024-01-24,20:07:00,17679.25,BUY,1,0.02h,Stop Loss,$4.00,$140.00,$54171.75,17,$140.00
2024-01-24,20:12:00,17660.0,SELL,1,0.02h,Break Even,$0.25,$140.25,$54172.00,17,$140.25
2024-01-24,20:39:00,17649.5,BUY,1,0.02h,Break Even,$0.25,$140.50,$54172.25,17,$140.50
2024-01-24,20:51:00,17621.0,SELL,1,0.02h,Break Even,$0.25,$140.75,$54172.50,17,$140.75
2024-01-24,21:33:00,17604.75,BUY,1,0.02h,Stop Loss,$-6.00,$134.75,$54166.50,17,$134.75
Final P&L Day: 134.75,,,,,,,,,,,
2024-01-25,12:24:00,17640.5,SELL,1,0.02h,Break Even,$0.25,$0.25,$54166.75,18,$0.25
2024-01-25,12:34:00,17648.5,BUY,1,0.02h,Stop Loss,$-6.00,$-5.75,$54160.75,18,$-5.75
2024-01-25,12:36:00,17642.5,SELL,1,0.02h,Stop Loss,$-6.00,$-11.75,$54154.75,18,$-11.75
2024-01-25,12:37:00,17646.75,BUY,1,0.02h,Break Even,$0.25,$-11.50,$54155.00,18,$-11.50
2024-01-25,12:56:00,17643.75,SELL,1,0.02h,Stop Loss,$6.50,$-5.00,$54161.50,18,$-5.00
2024-01-25,13:17:00,17649.0,BUY,1,0.02h,Stop Loss,$6.50,$1.50,$54168.00,18,$1.50
2024-01-25,14:31:00,17687.75,SELL,1,0.02h,Stop Loss,$20.25,$21.75,$54188.25,18,$21.75
2024-01-25,15:10:00,17698.25,BUY,1,0.02h,Stop Loss,$31.50,$53.25,$54219.75,18,$53.25
2024-01-25,15:37:00,17694.5,SELL,1,0.02h,Stop Loss,$6.50,$59.75,$54226.25,18,$59.75
2024-01-25,15:45:00,17720.75,BUY,1,0.02h,Break Even,$0.25,$60.00,$54226.50,18,$60.00
2024-01-25,15:50:00,17697.75,SELL,1,0.02h,Stop Loss,$21.50,$81.50,$54248.00,18,$81.50
2024-01-25,16:13:00,17709.75,BUY,1,0.02h,Stop Loss,$35.25,$116.75,$54283.25,18,$116.75
2024-01-25,16:43:00,17705.0,SELL,1,0.02h,Stop Loss,$-6.00,$110.75,$54277.25,18,$110.75
2024-01-25,16:48:00,17722.5,BUY,1,0.02h,Stop Loss,$50.25,$161.00,$54327.50,18,$161.00
2024-01-25,17:02:00,17720.0,SELL,1,0.02h,Stop Loss,$24.00,$185.00,$54351.50,18,$185.00
2024-01-25,18:03:00,17670.75,BUY,1,0.02h,Stop Loss,$17.75,$202.75,$54369.25,18,$202.75
2024-01-25,18:16:00,17646.5,SELL,1,0.02h,Stop Loss,$49.00,$251.75,$54418.25,18,$251.75
2024-01-25,18:45:00,17634.75,BUY,1,0.02h,Stop Loss,$6.50,$258.25,$54424.75,18,$258.25
2024-01-25,18:54:00,17620.75,SELL,1,0.02h,Stop Loss,$36.50,$294.75,$54461.25,18,$294.75
2024-01-25,19:31:00,17576.0,BUY,1,0.02h,Stop Loss,$15.25,$310.00,$54476.50,18,$310.00
2024-01-25,19:39:00,17565.5,SELL,1,0.02h,Stop Loss,$-6.00,$304.00,$54470.50,18,$304.00
2024-01-25,19:43:00,17574.5,BUY,1,0.02h,Stop Loss,$4.00,$308.00,$54474.50,18,$308.00
2024-01-25,20:25:00,17590.5,SELL,1,0.02h,Stop Loss,$-6.00,$302.00,$54468.50,18,$302.00
2024-01-25,20:33:00,17614.25,BUY,1,0.02h,Stop Loss,$47.75,$349.75,$54516.25,18,$349.75
2024-01-25,20:45:00,17604.25,SELL,1,0.02h,Break Even,$0.25,$350.00,$54516.50,18,$350.00
2024-01-25,20:48:00,17610.0,BUY,1,0.02h,Break Even,$0.25,$350.25,$54516.75,18,$350.25
2024-01-25,21:08:00,17606.5,SELL,1,0.02h,Break Even,$0.25,$350.50,$54517.00,18,$350.50
2024-01-25,21:33:00,17606.25,BUY,1,0.02h,Stop Loss,$-6.00,$344.50,$54511.00,18,$344.50
2024-01-25,21:39:00,17598.25,SELL,1,0.02h,Break Even,$0.25,$344.75,$54511.25,18,$344.75
2024-01-25,21:41:00,17605.0,BUY,1,0.02h,Stop Loss,$11.50,$356.25,$54522.75,18,$356.25
2024-01-25,21:47:00,17596.25,SELL,1,0.02h,Break Even,$0.25,$356.50,$54523.00,18,$356.50
Final P&L Day: 356.50,,,,,,,,,,,
2024-01-26,12:19:00,17577.25,BUY,1,0.02h,Break Even,$0.25,$0.25,$54523.25,19,$0.25
2024-01-26,12:52:00,17573.0,SELL,1,0.02h,Stop Loss,$-6.00,$-5.75,$54517.25,19,$-5.75
2024-01-26,13:08:00,17580.75,BUY,1,0.02h,Stop Loss,$4.00,$-1.75,$54521.25,19,$-1.75
2024-01-26,13:20:00,17573.25,SELL,1,0.02h,Stop Loss,$-6.00,$-7.75,$54515.25,19,$-7.75
2024-01-26,13:21:00,17580.75,BUY,1,0.02h,Break Even,$0.25,$-7.50,$54515.50,19,$-7.50
2024-01-26,13:24:00,17575.5,SELL,1,0.02h,Break Even,$0.25,$-7.25,$54515.75,19,$-7.25
2024-01-26,13:43:00,17586.25,BUY,1,0.02h,Stop Loss,$-6.00,$-13.25,$54509.75,19,$-13.25
2024-01-26,14:04:00,17578.0,SELL,1,0.02h,Stop Loss,$45.25,$32.00,$54555.00,19,$32.00
2024-01-26,14:34:00,17567.25,BUY,1,0.02h,Stop Loss,$5.25,$37.25,$54560.25,19,$37.25
2024-01-26,14:36:00,17549.25,SELL,1,0.02h,Stop Loss,$72.75,$110.00,$54633.00,19,$110.00
2024-01-26,15:15:00,17541.5,BUY,1,0.02h,Stop Loss,$-6.00,$104.00,$54627.00,19,$104.00
2024-01-26,15:17:00,17528.5,SELL,1,0.02h,Stop Loss,$42.75,$146.75,$54669.75,19,$146.75
2024-01-26,15:22:00,17553.25,BUY,1,0.02h,Stop Loss,$27.75,$174.50,$54697.50,19,$174.50
2024-01-26,16:15:00,17595.0,SELL,1,0.02h,Stop Loss,$-6.00,$168.50,$54691.50,19,$168.50
2024-01-26,16:24:00,17612.75,BUY,1,0.02h,Stop Loss,$-6.00,$162.50,$54685.50,19,$162.50
2024-01-26,16:38:00,17595.75,SELL,1,0.02h,Stop Loss,$47.75,$210.25,$54733.25,19,$210.25
2024-01-26,16:53:00,17602.25,BUY,1,0.02h,Break Even,$0.25,$210.50,$54733.50,19,$210.50
2024-01-26,17:26:00,17604.5,SELL,1,0.02h,Stop Loss,$32.75,$243.25,$54766.25,19,$243.25
2024-01-26,18:13:00,17540.25,BUY,1,0.02h,Stop Loss,$-6.00,$237.25,$54760.25,19,$237.25
2024-01-26,18:16:00,17528.0,SELL,1,0.02h,Stop Loss,$10.25,$247.50,$54770.50,19,$247.50
2024-01-26,18:24:00,17541.0,BUY,1,0.02h,Stop Loss,$-6.00,$241.50,$54764.50,19,$241.50
2024-01-26,18:42:00,17521.25,SELL,1,0.02h,Stop Loss,$31.50,$273.00,$54796.00,19,$273.00
2024-01-26,19:03:00,17530.75,BUY,1,0.02h,Stop Loss,$15.25,$288.25,$54811.25,19,$288.25
2024-01-26,19:24:00,17527.75,SELL,1,0.02h,Stop Loss,$9.00,$297.25,$54820.25,19,$297.25
2024-01-26,19:38:00,17539.75,BUY,1,0.02h,Break Even,$0.25,$297.50,$54820.50,19,$297.50
2024-01-26,20:10:00,17551.5,SELL,1,0.02h,Stop Loss,$-6.00,$291.50,$54814.50,19,$291.50
2024-01-26,20:11:00,17557.25,BUY,1,0.02h,Stop Loss,$-6.00,$285.50,$54808.50,19,$285.50
2024-01-26,20:12:00,17552.0,SELL,1,0.02h,Break Even,$0.25,$285.75,$54808.75,19,$285.75
2024-01-26,20:14:00,17558.25,BUY,1,0.02h,Stop Loss,$9.00,$294.75,$54817.75,19,$294.75
2024-01-26,20:22:00,17547.75,SELL,1,0.02h,Stop Loss,$21.50,$316.25,$54839.25,19,$316.25
2024-01-26,22:00:00,17504.75,BUY,1,62.00h,Stop Loss,$309.00,$625.25,$55148.25,19,$625.25
Final P&L Day: 625.25,,,,,,,,,,,
2024-01-29,12:37:00,17561.25,SELL,1,0.02h,Stop Loss,$17.75,$17.75,$55166.00,20,$17.75
2024-01-29,13:09:00,17564.0,BUY,1,0.02h,Stop Loss,$-6.00,$11.75,$55160.00,20,$11.75
2024-01-29,13:20:00,17552.0,SELL,1,0.02h,Break Even,$0.25,$12.00,$55160.25,20,$12.00
2024-01-29,13:55:00,17548.75,BUY,1,0.02h,Stop Loss,$-6.00,$6.00,$55154.25,20,$6.00
2024-01-29,14:02:00,17541.25,SELL,1,0.02h,Break Even,$0.25,$6.25,$55154.50,20,$6.25
2024-01-29,14:07:00,17548.25,BUY,1,0.02h,Break Even,$0.25,$6.50,$55154.75,20,$6.50
2024-01-29,14:16:00,17543.25,SELL,1,0.02h,Stop Loss,$6.50,$13.00,$55161.25,20,$13.00
2024-01-29,14:23:00,17551.25,BUY,1,0.02h,Break Even,$0.25,$13.25,$55161.50,20,$13.25
2024-01-29,14:31:00,17537.5,SELL,1,0.02h,Stop Loss,$22.75,$36.00,$55184.25,20,$36.00
2024-01-29,14:35:00,17553.25,BUY,1,0.02h,Stop Loss,$27.75,$63.75,$55212.00,20,$63.75
2024-01-29,14:58:00,17557.25,SELL,1,0.02h,Stop Loss,$12.75,$76.50,$55224.75,20,$76.50
2024-01-29,15:15:00,17560.25,BUY,1,0.02h,Stop Loss,$25.25,$101.75,$55250.00,20,$101.75
2024-01-29,15:23:00,17538.75,SELL,1,0.02h,Stop Loss,$7.75,$109.50,$55257.75,20,$109.50
2024-01-29,15:32:00,17560.5,BUY,1,0.02h,Break Even,$0.25,$109.75,$55258.00,20,$109.75
2024-01-29,15:33:00,17550.25,SELL,1,0.02h,Stop Loss,$82.75,$192.50,$55340.75,20,$192.50
2024-01-29,16:12:00,17543.0,BUY,1,0.02h,Break Even,$0.25,$192.75,$55341.00,20,$192.75
2024-01-29,17:47:00,17583.75,SELL,1,0.02h,Stop Loss,$-6.00,$186.75,$55335.00,20,$186.75
2024-01-29,17:57:00,17603.5,BUY,1,0.02h,Break Even,$0.25,$187.00,$55335.25,20,$187.00
2024-01-29,18:02:00,17585.25,SELL,1,0.02h,Break Even,$0.25,$187.25,$55335.50,20,$187.25
2024-01-29,18:22:00,17592.75,BUY,1,0.02h,Stop Loss,$-6.00,$181.25,$55329.50,20,$181.25
2024-01-29,18:23:00,17587.75,SELL,1,0.02h,Stop Loss,$-6.00,$175.25,$55323.50,20,$175.25
2024-01-29,18:26:00,17597.25,BUY,1,0.02h,Break Even,$0.25,$175.50,$55323.75,20,$175.50
2024-01-29,18:53:00,17592.5,SELL,1,0.02h,Break Even,$0.25,$175.75,$55324.00,20,$175.75
2024-01-29,19:08:00,17596.75,BUY,1,0.02h,Break Even,$0.25,$176.00,$55324.25,20,$176.00
2024-01-29,19:54:00,17621.25,SELL,1,0.02h,Break Even,$0.25,$176.25,$55324.50,20,$176.25
2024-01-29,19:56:00,17626.75,BUY,1,0.02h,Break Even,$0.25,$176.50,$55324.75,20,$176.50
2024-01-29,20:45:00,17692.75,SELL,1,0.02h,Stop Loss,$37.75,$214.25,$55362.50,20,$214.25
2024-01-29,20:58:00,17698.5,BUY,1,0.02h,Stop Loss,$20.25,$234.50,$55382.75,20,$234.50
2024-01-29,21:07:00,17689.75,SELL,1,0.02h,Stop Loss,$-6.00,$228.50,$55376.75,20,$228.50
2024-01-29,21:16:00,17703.25,BUY,1,0.02h,Stop Loss,$7.75,$236.25,$55384.50,20,$236.25
2024-01-29,21:46:00,17701.5,SELL,1,0.02h,Stop Loss,$-6.00,$230.25,$55378.50,20,$230.25
Final P&L Day: 230.25,,,,,,,,,,,
2024-01-30,12:23:00,17698.75,BUY,1,0.02h,Stop Loss,$-6.00,$-6.00,$55372.50,21,$-6.00
2024-01-30,12:27:00,17693.0,SELL,1,0.02h,Stop Loss,$4.00,$-2.00,$55376.50,21,$-2.00
2024-01-30,13:31:00,17668.5,BUY,1,0.02h,Break Even,$0.25,$-1.75,$55376.75,21,$-1.75
2024-01-30,13:37:00,17660.0,SELL,1,0.02h,Stop Loss,$-6.00,$-7.75,$55370.75,21,$-7.75
2024-01-30,14:02:00,17664.0,BUY,1,0.02h,Break Even,$0.25,$-7.50,$55371.00,21,$-7.50
2024-01-30,14:15:00,17657.75,SELL,1,0.02h,Break Even,$0.25,$-7.25,$55371.25,21,$-7.25
2024-01-30,14:27:00,17664.75,BUY,1,0.02h,Stop Loss,$5.25,$-2.00,$55376.50,21,$-2.00
2024-01-30,14:56:00,17668.25,SELL,1,0.02h,Stop Loss,$20.25,$18.25,$55396.75,21,$18.25
2024-01-30,15:21:00,17657.0,BUY,1,0.02h,Break Even,$0.25,$18.50,$55397.00,21,$18.50
2024-01-30,15:22:00,17651.25,SELL,1,0.02h,Stop Loss,$14.00,$32.50,$55411.00,21,$32.50
2024-01-30,15:24:00,17657.0,BUY,1,0.02h,Stop Loss,$-6.00,$26.50,$55405.00,21,$26.50
2024-01-30,15:26:00,17644.75,SELL,1,0.02h,Stop Loss,$52.75,$79.25,$55457.75,21,$79.25
2024-01-30,15:32:00,17658.25,BUY,1,0.02h,Stop Loss,$22.75,$102.00,$55480.50,21,$102.00
2024-01-30,15:43:00,17650.0,SELL,1,0.02h,Stop Loss,$42.75,$144.75,$55523.25,21,$144.75
2024-01-30,16:24:00,17639.0,BUY,1,0.02h,Stop Loss,$10.25,$155.00,$55533.50,21,$155.00
2024-01-30,16:55:00,17636.5,SELL,1,0.02h,Stop Loss,$10.25,$165.25,$55543.75,21,$165.25
2024-01-30,18:14:00,17575.5,BUY,1,0.02h,Stop Loss,$6.50,$171.75,$55550.25,21,$171.75
2024-01-30,18:45:00,17583.5,SELL,1,0.02h,Stop Loss,$22.75,$194.50,$55573.00,21,$194.50
2024-01-30,19:24:00,17577.5,BUY,1,0.02h,Break Even,$0.25,$194.75,$55573.25,21,$194.75
2024-01-30,20:06:00,17579.75,SELL,1,0.02h,Break Even,$0.25,$195.00,$55573.50,21,$195.00
2024-01-30,20:21:00,17590.5,BUY,1,0.02h,Stop Loss,$4.00,$199.00,$55577.50,21,$199.00
2024-01-30,20:35:00,17580.5,SELL,1,0.02h,Break Even,$0.25,$199.25,$55577.75,21,$199.25
2024-01-30,20:48:00,17593.5,BUY,1,0.02h,Stop Loss,$4.00,$203.25,$55581.75,21,$203.25
2024-01-30,20:55:00,17582.0,SELL,1,0.02h,Stop Loss,$-6.00,$197.25,$55575.75,21,$197.25
2024-01-30,21:01:00,17594.75,BUY,1,0.02h,Stop Loss,$45.25,$242.50,$55621.00,21,$242.50
2024-01-30,21:02:00,17578.75,SELL,1,0.02h,Stop Loss,$227.75,$470.25,$55848.75,21,$470.25
Final P&L Day: 470.25,,,,,,,,,,,
2024-01-31,12:47:00,17404.0,BUY,1,0.02h,Stop Loss,$5.25,$5.25,$55854.00,22,$5.25
2024-01-31,13:28:00,17425.25,SELL,1,0.02h,Stop Loss,$-6.00,$-0.75,$55848.00,22,$-0.75
2024-01-31,13:31:00,17435.75,BUY,1,0.02h,Stop Loss,$-6.00,$-6.75,$55842.00,22,$-6.75
2024-01-31,13:36:00,17422.0,SELL,1,0.02h,Stop Loss,$45.25,$38.50,$55887.25,22,$38.50
2024-01-31,14:34:00,17408.0,BUY,1,0.02h,Stop Loss,$75.25,$113.75,$55962.50,22,$113.75
2024-01-31,14:40:00,17389.5,SELL,1,0.02h,Stop Loss,$92.75,$206.50,$56055.25,22,$206.50
2024-01-31,16:02:00,17319.75,BUY,1,0.02h,Stop Loss,$15.25,$221.75,$56070.50,22,$221.75
2024-01-31,16:34:00,17327.0,SELL,1,0.02h,Stop Loss,$6.50,$228.25,$56077.00,22,$228.25
2024-01-31,16:38:00,17337.0,BUY,1,0.02h,Break Even,$0.25,$228.50,$56077.25,22,$228.50
2024-01-31,16:42:00,17329.75,SELL,1,0.02h,Break Even,$0.25,$228.75,$56077.50,22,$228.75
2024-01-31,16:45:00,17336.0,BUY,1,0.02h,Stop Loss,$26.50,$255.25,$56104.00,22,$255.25
2024-01-31,16:54:00,17321.25,SELL,1,0.02h,Stop Loss,$-6.00,$249.25,$56098.00,22,$249.25
2024-01-31,16:57:00,17340.75,BUY,1,0.02h,Stop Loss,$4.00,$253.25,$56102.00,22,$253.25
2024-01-31,17:24:00,17347.5,SELL,1,0.02h,Stop Loss,$-6.00,$247.25,$56096.00,22,$247.25
2024-01-31,17:27:00,17359.0,BUY,1,0.02h,Break Even,$0.25,$247.50,$56096.25,22,$247.50
2024-01-31,17:36:00,17349.0,SELL,1,0.02h,Stop Loss,$24.00,$271.50,$56120.25,22,$271.50
2024-01-31,17:52:00,17360.75,BUY,1,0.02h,Stop Loss,$-6.00,$265.50,$56114.25,22,$265.50
2024-01-31,18:29:00,17375.5,SELL,1,0.02h,Stop Loss,$4.00,$269.50,$56118.25,22,$269.50
2024-01-31,18:47:00,17391.25,BUY,1,0.02h,Break Even,$0.25,$269.75,$56118.50,22,$269.75
2024-01-31,19:00:00,17381.0,SELL,1,0.02h,Stop Loss,$236.50,$506.25,$56355.00,22,$506.25
2024-01-31,19:33:00,17363.5,BUY,1,0.02h,Stop Loss,$24.00,$530.25,$56379.00,22,$530.25
2024-01-31,20:00:00,17379.0,SELL,1,0.02h,Stop Loss,$92.75,$623.00,$56471.75,22,$623.00
2024-01-31,21:11:00,17263.0,BUY,1,0.02h,Stop Loss,$11.50,$634.50,$56483.25,22,$634.50
2024-01-31,21:25:00,17255.25,SELL,1,0.02h,Break Even,$0.25,$634.75,$56483.50,22,$634.75
2024-01-31,21:38:00,17262.75,BUY,1,0.02h,Break Even,$0.25,$635.00,$56483.75,22,$635.00
2024-01-31,21:41:00,17249.75,SELL,1,0.02h,Break Even,$0.25,$635.25,$56484.00,22,$635.25
2024-01-31,21:51:00,17259.0,BUY,1,0.02h,Stop Loss,$10.25,$645.50,$56494.25,22,$645.50
Final P&L Day: 645.50,,,,,,,,,,,
2024-02-01,12:59:00,17344.25,SELL,1,0.02h,Stop Loss,$-6.00,$-6.00,$56488.25,23,$-6.00
2024-02-01,13:31:00,17343.75,BUY,1,0.02h,Break Even,$0.25,$-5.75,$56488.50,23,$-5.75
2024-02-01,14:01:00,17339.25,SELL,1,0.02h,Stop Loss,$-6.00,$-11.75,$56482.50,23,$-11.75
2024-02-01,14:02:00,17347.25,BUY,1,0.02h,Break Even,$0.25,$-11.50,$56482.75,23,$-11.50
2024-02-01,14:05:00,17326.25,SELL,1,0.02h,Stop Loss,$5.25,$-6.25,$56488.00,23,$-6.25
2024-02-01,14:43:00,17332.25,BUY,1,0.02h,Break Even,$0.25,$-6.00,$56488.25,23,$-6.00
2024-02-01,14:49:00,17310.25,SELL,1,0.02h,Stop Loss,$19.00,$13.00,$56507.25,23,$13.00
2024-02-01,15:08:00,17327.25,BUY,1,0.02h,Stop Loss,$77.75,$90.75,$56585.00,23,$90.75
2024-02-01,15:45:00,17343.25,SELL,1,0.02h,Break Even,$0.25,$91.00,$56585.25,23,$91.00
2024-02-01,16:24:00,17295.0,BUY,1,0.02h,Stop Loss,$5.25,$96.25,$56590.50,23,$96.25
2024-02-01,16:26:00,17283.25,SELL,1,0.02h,Break Even,$0.25,$96.50,$56590.75,23,$96.50
2024-02-01,16:33:00,17296.25,BUY,1,0.02h,Stop Loss,$51.50,$148.00,$56642.25,23,$148.00
2024-02-01,17:28:00,17353.0,SELL,1,0.02h,Stop Loss,$17.75,$165.75,$56660.00,23,$165.75
2024-02-01,17:47:00,17367.5,BUY,1,0.02h,Break Even,$0.25,$166.00,$56660.25,23,$166.00
2024-02-01,18:04:00,17354.75,SELL,1,0.02h,Stop Loss,$65.25,$231.25,$56725.50,23,$231.25
2024-02-01,18:17:00,17369.5,BUY,1,0.02h,Stop Loss,$4.00,$235.25,$56729.50,23,$235.25
2024-02-01,18:39:00,17355.75,SELL,1,0.02h,Stop Loss,$25.25,$260.50,$56754.75,23,$260.50
2024-02-01,18:50:00,17374.75,BUY,1,0.02h,Stop Loss,$27.75,$288.25,$56782.50,23,$288.25
2024-02-01,19:35:00,17383.25,SELL,1,0.02h,Stop Loss,$-6.00,$282.25,$56776.50,23,$282.25
2024-02-01,19:40:00,17397.25,BUY,1,0.02h,Stop Loss,$34.00,$316.25,$56810.50,23,$316.25
2024-02-01,20:48:00,17434.0,SELL,1,0.02h,Stop Loss,$36.50,$352.75,$56847.00,23,$352.75
2024-02-01,21:02:00,17462.0,BUY,1,0.02h,Stop Loss,$39.00,$391.75,$56886.00,23,$391.75
Final P&L Day: 391.75,,,,,,,,,,,
2024-02-02,12:09:00,17607.75,SELL,1,0.02h,Stop Loss,$-6.00,$-6.00,$56880.00,24,$-6.00
2024-02-02,12:17:00,17617.75,BUY,1,0.02h,Break Even,$0.25,$-5.75,$56880.25,24,$-5.75
2024-02-02,12:51:00,17626.0,SELL,1,0.02h,Break Even,$0.25,$-5.50,$56880.50,24,$-5.50
2024-02-02,13:05:00,17631.25,BUY,1,0.02h,Break Even,$0.25,$-5.25,$56880.75,24,$-5.25
2024-02-02,13:10:00,17623.75,SELL,1,0.02h,Break Even,$0.25,$-5.00,$56881.00,24,$-5.00
2024-02-02,14:36:00,17524.75,BUY,1,0.02h,Stop Loss,$25.25,$20.25,$56906.25,24,$20.25
2024-02-02,15:13:00,17571.0,SELL,1,0.02h,Stop Loss,$4.00,$24.25,$56910.25,24,$24.25
2024-02-02,15:15:00,17592.0,BUY,1,0.02h,Stop Loss,$27.75,$52.00,$56938.00,24,$52.00
2024-02-02,15:30:00,17584.75,SELL,1,0.02h,Stop Loss,$14.00,$66.00,$56952.00,24,$66.00
2024-02-02,15:40:00,17616.5,BUY,1,0.02h,Stop Loss,$62.75,$128.75,$57014.75,24,$128.75
2024-02-02,16:04:00,17613.75,SELL,1,0.02h,Stop Loss,$22.75,$151.50,$57037.50,24,$151.50
2024-02-02,16:11:00,17643.25,BUY,1,0.02h,Break Even,$0.25,$151.75,$57037.75,24,$151.75
2024-02-02,17:45:00,17682.5,SELL,1,0.02h,Stop Loss,$36.50,$188.25,$57074.25,24,$188.25
2024-02-02,18:02:00,17721.5,BUY,1,0.02h,Break Even,$0.25,$188.50,$57074.50,24,$188.50
2024-02-02,18:27:00,17696.5,SELL,1,0.02h,Stop Loss,$4.00,$192.50,$57078.50,24,$192.50
2024-02-02,18:45:00,17719.0,BUY,1,0.02h,Stop Loss,$36.50,$229.00,$57115.00,24,$229.00
2024-02-02,19:54:00,17752.75,SELL,1,0.02h,Stop Loss,$-6.00,$223.00,$57109.00,24,$223.00
2024-02-02,20:08:00,17762.75,BUY,1,0.02h,Break Even,$0.25,$223.25,$57109.25,24,$223.25
2024-02-02,20:19:00,17756.25,SELL,1,0.02h,Stop Loss,$-6.00,$217.25,$57103.25,24,$217.25
2024-02-02,20:20:00,17762.75,BUY,1,0.02h,Break Even,$0.25,$217.50,$57103.50,24,$217.50
2024-02-02,20:23:00,17754.25,SELL,1,0.02h,Stop Loss,$80.25,$297.75,$57183.75,24,$297.75
2024-02-02,20:30:00,17766.25,BUY,1,0.02h,Stop Loss,$-6.00,$291.75,$57177.75,24,$291.75
2024-02-02,20:33:00,17751.75,SELL,1,0.02h,Stop Loss,$10.25,$302.00,$57188.00,24,$302.00
2024-02-02,20:51:00,17760.75,BUY,1,0.02h,Stop Loss,$22.75,$324.75,$57210.75,24,$324.75
2024-02-02,20:58:00,17746.75,SELL,1,0.02h,Stop Loss,$22.75,$347.50,$57233.50,24,$347.50
Final P&L Day: 347.50,,,,,,,,,,,
2024-02-05,12:04:00,17706.5,BUY,1,0.02h,Stop Loss,$5.25,$5.25,$57238.75,25,$5.25
2024-02-05,12:49:00,17721.25,SELL,1,0.02h,Stop Loss,$-6.00,$-0.75,$57232.75,25,$-0.75
2024-02-05,12:52:00,17728.0,BUY,1,0.02h,Break Even,$0.25,$-0.50,$57233.00,25,$-0.50
2024-02-05,13:11:00,17727.5,SELL,1,0.02h,Stop Loss,$-6.00,$-6.50,$57227.00,25,$-6.50
2024-02-05,13:15:00,17732.5,BUY,1,0.02h,Stop Loss,$-6.00,$-12.50,$57221.00,25,$-12.50
2024-02-05,13:17:00,17726.75,SELL,1,0.02h,Break Even,$0.25,$-12.25,$57221.25,25,$-12.25
2024-02-05,14:12:00,17707.5,BUY,1,0.02h,Break Even,$0.25,$-12.00,$57221.50,25,$-12.00
2024-02-05,14:41:00,17699.25,SELL,1,0.02h,Break Even,$0.25,$-11.75,$57221.75,25,$-11.75
2024-02-05,16:02:00,17595.75,BUY,1,0.02h,Stop Loss,$4.00,$-7.75,$57225.75,25,$-7.75
2024-02-05,17:54:00,17693.25,SELL,1,0.02h,Stop Loss,$-6.00,$-13.75,$57219.75,25,$-13.75
2024-02-05,18:08:00,17702.0,BUY,1,0.02h,Stop Loss,$20.25,$6.50,$57240.00,25,$6.50
2024-02-05,18:23:00,17696.5,SELL,1,0.02h,Break Even,$0.25,$6.75,$57240.25,25,$6.75
2024-02-05,18:48:00,17695.75,BUY,1,0.02h,Break Even,$0.25,$7.00,$57240.50,25,$7.00
2024-02-05,18:54:00,17688.75,SELL,1,0.02h,Break Even,$0.25,$7.25,$57240.75,25,$7.25
2024-02-05,18:59:00,17695.75,BUY,1,0.02h,Stop Loss,$17.75,$25.00,$57258.50,25,$25.00
2024-02-05,19:02:00,17688.0,SELL,1,0.02h,Break Even,$0.25,$25.25,$57258.75,25,$25.25
2024-02-05,19:08:00,17700.75,BUY,1,0.02h,Stop Loss,$20.25,$45.50,$57279.00,25,$45.50
2024-02-05,20:03:00,17720.25,SELL,1,0.02h,Stop Loss,$22.75,$68.25,$57301.75,25,$68.25
2024-02-05,20:29:00,17715.5,BUY,1,0.02h,Break Even,$0.25,$68.50,$57302.00,25,$68.50
2024-02-05,20:41:00,17703.0,SELL,1,0.02h,Break Even,$0.25,$68.75,$57302.25,25,$68.75
2024-02-05,20:48:00,17709.25,BUY,1,0.02h,Stop Loss,$4.00,$72.75,$57306.25,25,$72.75
2024-02-05,20:50:00,17702.25,SELL,1,0.02h,Break Even,$0.25,$73.00,$57306.50,25,$73.00
2024-02-05,20:51:00,17722.75,BUY,1,0.02h,Break Even,$0.25,$73.25,$57306.75,25,$73.25
2024-02-05,21:01:00,17685.0,SELL,1,0.02h,Break Even,$0.25,$73.50,$57307.00,25,$73.50
2024-02-05,21:52:00,17698.0,BUY,1,0.02h,Break Even,$0.25,$73.75,$57307.25,25,$73.75
Final P&L Day: 73.75,,,,,,,,,,,
2024-02-06,12:01:00,17693.5,SELL,1,0.02h,Stop Loss,$-6.00,$-6.00,$57301.25,26,$-6.00
2024-02-06,12:40:00,17690.5,BUY,1,0.02h,Stop Loss,$9.00,$3.00,$57310.25,26,$3.00
2024-02-06,14:30:00,17741.25,SELL,1,0.02h,Break Even,$0.25,$3.25,$57310.50,26,$3.25
2024-02-06,14:31:00,17764.25,BUY,1,0.02h,Break Even,$0.25,$3.50,$57310.75,26,$3.50
2024-02-06,14:35:00,17729.25,SELL,1,0.02h,Stop Loss,$86.50,$90.00,$57397.25,26,$90.00
2024-02-06,15:36:00,17655.25,BUY,1,0.02h,Stop Loss,$-6.00,$84.00,$57391.25,26,$84.00
2024-02-06,15:43:00,17627.5,SELL,1,0.02h,Stop Loss,$20.25,$104.25,$57411.50,26,$104.25
2024-02-06,15:48:00,17643.5,BUY,1,0.02h,Break Even,$0.25,$104.50,$57411.75,26,$104.50
2024-02-06,15:50:00,17626.0,SELL,1,0.02h,Stop Loss,$21.50,$126.00,$57433.25,26,$126.00
2024-02-06,15:58:00,17637.75,BUY,1,0.02h,Stop Loss,$14.00,$140.00,$57447.25,26,$140.00
2024-02-06,16:15:00,17627.5,SELL,1,0.02h,Break Even,$0.25,$140.25,$57447.50,26,$140.25
2024-02-06,16:21:00,17647.75,BUY,1,0.02h,Stop Loss,$-6.00,$134.25,$57441.50,26,$134.25
2024-02-06,16:40:00,17644.0,SELL,1,0.02h,Stop Loss,$61.50,$195.75,$57503.00,26,$195.75
2024-02-06,17:29:00,17599.0,BUY,1,0.02h,Stop Loss,$14.00,$209.75,$57517.00,26,$209.75
2024-02-06,17:54:00,17594.25,SELL,1,0.02h,Stop Loss,$16.50,$226.25,$57533.50,26,$226.25
2024-02-06,18:03:00,17604.25,BUY,1,0.02h,Stop Loss,$-6.00,$220.25,$57527.50,26,$220.25
2024-02-06,18:15:00,17595.75,SELL,1,0.02h,Break Even,$0.25,$220.50,$57527.75,26,$220.50
2024-02-06,18:17:00,17607.25,BUY,1,0.02h,Stop Loss,$16.50,$237.00,$57544.25,26,$237.00
2024-02-06,18:20:00,17595.0,SELL,1,0.02h,Stop Loss,$6.50,$243.50,$57550.75,26,$243.50
2024-02-06,18:30:00,17608.75,BUY,1,0.02h,Stop Loss,$14.00,$257.50,$57564.75,26,$257.50
2024-02-06,19:06:00,17610.0,SELL,1,0.02h,Stop Loss,$49.00,$306.50,$57613.75,26,$306.50
2024-02-06,19:30:00,17594.25,BUY,1,0.02h,Stop Loss,$17.75,$324.25,$57631.50,26,$324.25
2024-02-06,20:30:00,17635.5,SELL,1,0.02h,Stop Loss,$15.25,$339.50,$57646.75,26,$339.50
2024-02-06,20:51:00,17626.5,BUY,1,0.02h,Stop Loss,$26.50,$366.00,$57673.25,26,$366.00
2024-02-06,21:20:00,17642.25,SELL,1,0.02h,Stop Loss,$-6.00,$360.00,$57667.25,26,$360.00
2024-02-06,21:23:00,17646.75,BUY,1,0.02h,Stop Loss,$5.25,$365.25,$57672.50,26,$365.25
2024-02-06,21:44:00,17647.0,SELL,1,0.03h,Break Even,$0.25,$365.50,$57672.75,26,$365.50
2024-02-06,22:00:00,17649.5,BUY,1,14.00h,Stop Loss,$145.25,$510.75,$57818.00,26,$510.75
Final P&L Day: 510.75,,,,,,,,,,,
2024-02-07,12:23:00,17658.75,SELL,1,0.02h,Stop Loss,$4.00,$4.00,$57822.00,27,$4.00
2024-02-07,12:29:00,17674.25,BUY,1,0.02h,Break Even,$0.25,$4.25,$57822.25,27,$4.25
2024-02-07,13:56:00,17733.25,SELL,1,0.02h,Stop Loss,$-6.00,$-1.75,$57816.25,27,$-1.75
2024-02-07,13:59:00,17738.5,BUY,1,0.02h,Stop Loss,$-6.00,$-7.75,$57810.25,27,$-7.75
2024-02-07,14:35:00,17750.5,SELL,1,0.02h,Break Even,$0.25,$-7.50,$57810.50,27,$-7.50
2024-02-07,14:52:00,17760.75,BUY,1,0.02h,Stop Loss,$20.25,$12.75,$57830.75,27,$12.75
2024-02-07,14:56:00,17724.75,SELL,1,0.02h,Stop Loss,$16.50,$29.25,$57847.25,27,$29.25
2024-02-07,15:10:00,17757.75,BUY,1,0.02h,Stop Loss,$29.00,$58.25,$57876.25,27,$58.25
2024-02-07,15:59:00,17839.75,SELL,1,0.02h,Stop Loss,$29.00,$87.25,$57905.25,27,$87.25
2024-02-07,16:12:00,17850.5,BUY,1,0.02h,Break Even,$0.25,$87.50,$57905.50,27,$87.50
2024-02-07,16:18:00,17834.75,SELL,1,0.02h,Stop Loss,$20.25,$107.75,$57925.75,27,$107.75
2024-02-07,16:46:00,17828.5,BUY,1,0.02h,Stop Loss,$9.00,$116.75,$57934.75,27,$116.75
2024-02-07,17:13:00,17827.5,SELL,1,0.02h,Stop Loss,$-6.00,$110.75,$57928.75,27,$110.75
2024-02-07,17:18:00,17849.75,BUY,1,0.02h,Stop Loss,$-6.00,$104.75,$57922.75,27,$104.75
2024-02-07,17:23:00,17833.5,SELL,1,0.02h,Stop Loss,$6.50,$111.25,$57929.25,27,$111.25
2024-02-07,17:55:00,17813.75,BUY,1,0.02h,Stop Loss,$4.00,$115.25,$57933.25,27,$115.25
2024-02-07,18:06:00,17801.75,SELL,1,0.02h,Stop Loss,$-6.00,$109.25,$57927.25,27,$109.25
2024-02-07,18:11:00,17822.0,BUY,1,0.02h,Stop Loss,$14.00,$123.25,$57941.25,27,$123.25
2024-02-07,19:11:00,17846.0,SELL,1,0.02h,Break Even,$0.25,$123.50,$57941.50,27,$123.50
2024-02-07,19:12:00,17849.0,BUY,1,0.02h,Break Even,$0.25,$123.75,$57941.75,27,$123.75
2024-02-07,19:14:00,17843.75,SELL,1,0.02h,Break Even,$0.25,$124.00,$57942.00,27,$124.00
2024-02-07,19:16:00,17854.25,BUY,1,0.02h,Stop Loss,$-6.00,$118.00,$57936.00,27,$118.00
2024-02-07,19:18:00,17846.0,SELL,1,0.02h,Break Even,$0.25,$118.25,$57936.25,27,$118.25
2024-02-07,19:25:00,17851.75,BUY,1,0.02h,Stop Loss,$-6.00,$112.25,$57930.25,27,$112.25
2024-02-07,19:27:00,17845.25,SELL,1,0.02h,Break Even,$0.25,$112.50,$57930.50,27,$112.50
2024-02-07,19:43:00,17844.5,BUY,1,0.02h,Stop Loss,$-6.00,$106.50,$57924.50,27,$106.50
2024-02-07,19:44:00,17839.0,SELL,1,0.02h,Break Even,$0.25,$106.75,$57924.75,27,$106.75
2024-02-07,19:48:00,17852.75,BUY,1,0.02h,Break Even,$0.25,$107.00,$57925.00,27,$107.00
2024-02-07,20:24:00,17852.0,SELL,1,0.02h,Break Even,$0.25,$107.25,$57925.25,27,$107.25
2024-02-07,20:26:00,17857.75,BUY,1,0.02h,Break Even,$0.25,$107.50,$57925.50,27,$107.50
2024-02-07,20:28:00,17854.0,SELL,1,0.02h,Break Even,$0.25,$107.75,$57925.75,27,$107.75
2024-02-07,21:13:00,17851.0,BUY,1,0.02h,Break Even,$0.25,$108.00,$57926.00,27,$108.00
Final P&L Day: 108.00,,,,,,,,,,,
2024-02-08,12:00:00,17811.5,SELL,1,0.02h,Break Even,$0.25,$0.25,$57926.25,28,$0.25
2024-02-08,12:46:00,17820.0,BUY,1,0.02h,Stop Loss,$-6.00,$-5.75,$57920.25,28,$-5.75
2024-02-08,12:47:00,17814.25,SELL,1,0.02h,Stop Loss,$-6.00,$-11.75,$57914.25,28,$-11.75
2024-02-08,12:48:00,17819.75,BUY,1,0.02h,Break Even,$0.25,$-11.50,$57914.50,28,$-11.50
2024-02-08,12:56:00,17809.0,SELL,1,0.02h,Stop Loss,$4.00,$-7.50,$57918.50,28,$-7.50
2024-02-08,13:07:00,17815.25,BUY,1,0.02h,Stop Loss,$-6.00,$-13.50,$57912.50,28,$-13.50
2024-02-08,13:09:00,17809.5,SELL,1,0.02h,Stop Loss,$-6.00,$-19.50,$57906.50,28,$-19.50
2024-02-08,13:34:00,17812.5,BUY,1,0.02h,Stop Loss,$-6.00,$-25.50,$57900.50,28,$-25.50
2024-02-08,14:43:00,17812.25,SELL,1,0.02h,Stop Loss,$7.75,$-17.75,$57908.25,28,$-17.75
2024-02-08,14:51:00,17835.5,BUY,1,0.02h,Stop Loss,$12.75,$-5.00,$57921.00,28,$-5.00
2024-02-08,15:26:00,17837.5,SELL,1,0.02h,Break Even,$0.25,$-4.75,$57921.25,28,$-4.75
2024-02-08,15:36:00,17857.5,BUY,1,0.02h,Break Even,$0.25,$-4.50,$57921.50,28,$-4.50
2024-02-08,16:27:00,17867.5,SELL,1,0.02h,Break Even,$0.25,$-4.25,$57921.75,28,$-4.25
2024-02-08,16:38:00,17881.5,BUY,1,0.02h,Break Even,$0.25,$-4.00,$57922.00,28,$-4.00
2024-02-08,16:45:00,17867.5,SELL,1,0.02h,Break Even,$0.25,$-3.75,$57922.25,28,$-3.75
2024-02-08,16:54:00,17880.0,BUY,1,0.02h,Break Even,$0.25,$-3.50,$57922.50,28,$-3.50
2024-02-08,17:07:00,17872.25,SELL,1,0.02h,Stop Loss,$16.50,$13.00,$57939.00,28,$13.00
2024-02-08,17:15:00,17884.0,BUY,1,0.02h,Break Even,$0.25,$13.25,$57939.25,28,$13.25
2024-02-08,17:40:00,17882.5,SELL,1,0.02h,Stop Loss,$6.50,$19.75,$57945.75,28,$19.75
2024-02-08,18:03:00,17877.75,BUY,1,0.02h,Stop Loss,$7.75,$27.50,$57953.50,28,$27.50
2024-02-08,18:17:00,17862.5,SELL,1,0.02h,Break Even,$0.25,$27.75,$57953.75,28,$27.75
2024-02-08,18:26:00,17877.75,BUY,1,0.02h,Break Even,$0.25,$28.00,$57954.00,28,$28.00
2024-02-08,18:47:00,17878.0,SELL,1,0.02h,Break Even,$0.25,$28.25,$57954.25,28,$28.25
2024-02-08,19:46:00,17851.25,BUY,1,0.02h,Stop Loss,$-6.00,$22.25,$57948.25,28,$22.25
2024-02-08,20:37:00,17866.25,SELL,1,0.02h,Stop Loss,$-6.00,$16.25,$57942.25,28,$16.25
2024-02-08,21:18:00,17861.5,BUY,1,0.02h,Break Even,$0.25,$16.50,$57942.50,28,$16.50
2024-02-08,22:00:00,17861.0,SELL,1,14.00h,Stop Loss,$-6.00,$10.50,$57936.50,28,$10.50
Final P&L Day: 10.50,,,,,,,,,,,
2024-02-09,12:00:00,17918.5,BUY,1,0.02h,Break Even,$0.25,$0.25,$57936.75,29,$0.25
2024-02-09,12:42:00,17925.5,SELL,1,0.02h,Stop Loss,$-6.00,$-5.75,$57930.75,29,$-5.75
2024-02-09,12:46:00,17929.25,BUY,1,0.02h,Stop Loss,$-6.00,$-11.75,$57924.75,29,$-11.75
2024-02-09,12:47:00,17927.5,SELL,1,0.02h,Break Even,$0.25,$-11.50,$57925.00,29,$-11.50
2024-02-09,12:48:00,17928.25,BUY,1,0.02h,Stop Loss,$-6.00,$-17.50,$57919.00,29,$-17.50
2024-02-09,12:49:00,17926.25,SELL,1,0.02h,Stop Loss,$-6.00,$-23.50,$57913.00,29,$-23.50
2024-02-09,13:27:00,17916.25,BUY,1,0.02h,Stop Loss,$-6.00,$-29.50,$57907.00,29,$-29.50
2024-02-09,13:30:00,17912.5,SELL,1,0.02h,Stop Loss,$35.25,$5.75,$57942.25,29,$5.75
2024-02-09,13:31:00,17918.25,BUY,1,0.02h,Stop Loss,$156.50,$162.25,$58098.75,29,$162.25
2024-02-09,14:01:00,17925.5,SELL,1,0.02h,Break Even,$0.25,$162.50,$58099.00,29,$162.50
2024-02-09,14:14:00,17931.0,BUY,1,0.02h,Break Even,$0.25,$162.75,$58099.25,29,$162.75
2024-02-09,14:21:00,17923.5,SELL,1,0.02h,Break Even,$0.25,$163.00,$58099.50,29,$163.00
2024-02-09,14:49:00,17908.75,BUY,1,0.02h,Break Even,$0.25,$163.25,$58099.75,29,$163.25
2024-02-09,16:19:00,17989.75,SELL,1,0.02h,Stop Loss,$-6.00,$157.25,$58093.75,29,$157.25
2024-02-09,16:22:00,17999.5,BUY,1,0.02h,Break Even,$0.25,$157.50,$58094.00,29,$157.50
2024-02-09,16:25:00,17990.5,SELL,1,0.02h,Break Even,$0.25,$157.75,$58094.25,29,$157.75
2024-02-09,16:43:00,17993.25,BUY,1,0.02h,Break Even,$0.25,$158.00,$58094.50,29,$158.00
2024-02-09,17:02:00,17987.25,SELL,1,0.02h,Stop Loss,$-6.00,$152.00,$58088.50,29,$152.00
2024-02-09,17:26:00,17993.25,BUY,1,0.02h,Break Even,$0.25,$152.25,$58088.75,29,$152.25
2024-02-09,18:49:00,18032.25,SELL,1,0.02h,Stop Loss,$-6.00,$146.25,$58082.75,29,$146.25
2024-02-09,18:57:00,18038.25,BUY,1,0.02h,Stop Loss,$4.00,$150.25,$58086.75,29,$150.25
2024-02-09,19:10:00,18032.0,SELL,1,0.02h,Stop Loss,$-6.00,$144.25,$58080.75,29,$144.25
2024-02-09,19:15:00,18037.5,BUY,1,0.02h,Stop Loss,$-6.00,$138.25,$58074.75,29,$138.25
2024-02-09,19:16:00,18035.5,SELL,1,0.02h,Stop Loss,$-6.00,$132.25,$58068.75,29,$132.25
2024-02-09,19:17:00,18036.75,BUY,1,0.02h,Break Even,$0.25,$132.50,$58069.00,29,$132.50
2024-02-09,19:18:00,18035.25,SELL,1,0.02h,Stop Loss,$-6.00,$126.50,$58063.00,29,$126.50
2024-02-09,19:19:00,18038.25,BUY,1,0.02h,Break Even,$0.25,$126.75,$58063.25,29,$126.75
2024-02-09,20:01:00,18051.75,SELL,1,0.02h,Stop Loss,$37.75,$164.50,$58101.00,29,$164.50
2024-02-09,20:19:00,18052.75,BUY,1,0.02h,Stop Loss,$-6.00,$158.50,$58095.00,29,$158.50
2024-02-09,20:24:00,18043.25,SELL,1,0.02h,Break Even,$0.25,$158.75,$58095.25,29,$158.75
2024-02-09,20:56:00,18046.25,BUY,1,0.02h,Stop Loss,$-6.00,$152.75,$58089.25,29,$152.75
2024-02-09,20:58:00,18037.0,SELL,1,0.02h,Break Even,$0.25,$153.00,$58089.50,29,$153.00
2024-02-09,21:36:00,18034.25,BUY,1,0.07h,Stop Loss,$-6.00,$147.00,$58083.50,29,$147.00
2024-02-09,21:44:00,18032.75,SELL,1,0.02h,Stop Loss,$-6.00,$141.00,$58077.50,29,$141.00
2024-02-09,21:46:00,18033.5,BUY,1,0.02h,Break Even,$0.25,$141.25,$58077.75,29,$141.25
Final P&L Day: 141.25,,,,,,,,,,,
2024-02-12,12:27:00,18041.5,SELL,1,0.02h,Stop Loss,$-6.00,$-6.00,$58071.75,30,$-6.00
2024-02-12,12:48:00,18039.5,BUY,1,0.02h,Stop Loss,$-6.00,$-12.00,$58065.75,30,$-12.00
2024-02-12,12:51:00,18036.0,SELL,1,0.02h,Stop Loss,$-6.00,$-18.00,$58059.75,30,$-18.00
2024-02-12,13:01:00,18038.25,BUY,1,0.02h,Stop Loss,$-6.00,$-24.00,$58053.75,30,$-24.00
2024-02-12,13:02:00,18035.75,SELL,1,0.02h,Break Even,$0.25,$-23.75,$58054.00,30,$-23.75
2024-02-12,13:05:00,18039.25,BUY,1,0.02h,Stop Loss,$-6.00,$-29.75,$58048.00,30,$-29.75
2024-02-12,13:32:00,18037.0,SELL,1,0.02h,Stop Loss,$7.75,$-22.00,$58055.75,30,$-22.00
2024-02-12,14:07:00,18034.25,BUY,1,0.02h,Stop Loss,$-6.00,$-28.00,$58049.75,30,$-28.00
2024-02-12,14:15:00,18023.25,SELL,1,0.02h,Stop Loss,$-6.00,$-34.00,$58043.75,30,$-34.00
2024-02-12,14:35:00,18045.25,BUY,1,0.02h,Stop Loss,$11.50,$-22.50,$58055.25,30,$-22.50
2024-02-12,14:48:00,18028.75,SELL,1,0.02h,Stop Loss,$40.25,$17.75,$58095.50,30,$17.75
2024-02-12,14:57:00,18035.5,BUY,1,0.02h,Break Even,$0.25,$18.00,$58095.75,30,$18.00
2024-02-12,15:04:00,18027.5,SELL,1,0.02h,Stop Loss,$-6.00,$12.00,$58089.75,30,$12.00
2024-02-12,15:27:00,18032.25,BUY,1,0.02h,Stop Loss,$11.50,$23.50,$58101.25,30,$23.50
2024-02-12,16:50:00,18084.25,SELL,1,0.02h,Stop Loss,$-6.00,$17.50,$58095.25,30,$17.50
2024-02-12,16:56:00,18105.5,BUY,1,0.02h,Break Even,$0.25,$17.75,$58095.50,30,$17.75
2024-02-12,17:02:00,18092.75,SELL,1,0.02h,Stop Loss,$7.75,$25.50,$58103.25,30,$25.50
2024-02-12,17:06:00,18104.25,BUY,1,0.02h,Break Even,$0.25,$25.75,$58103.50,30,$25.75
2024-02-12,17:17:00,18095.75,SELL,1,0.02h,Break Even,$0.25,$26.00,$58103.75,30,$26.00
2024-02-12,17:50:00,18093.0,BUY,1,0.02h,Stop Loss,$-6.00,$20.00,$58097.75,30,$20.00
2024-02-12,18:23:00,18084.5,SELL,1,0.02h,Stop Loss,$42.75,$62.75,$58140.50,30,$62.75
2024-02-12,19:43:00,17984.0,BUY,1,0.02h,Stop Loss,$-6.00,$56.75,$58134.50,30,$56.75
2024-02-12,19:46:00,17976.25,SELL,1,0.02h,Stop Loss,$19.00,$75.75,$58153.50,30,$75.75
2024-02-12,20:08:00,17973.25,BUY,1,0.02h,Break Even,$0.25,$76.00,$58153.75,30,$76.00
2024-02-12,20:34:00,17972.5,SELL,1,0.02h,Stop Loss,$5.25,$81.25,$58159.00,30,$81.25
2024-02-12,20:53:00,17978.75,BUY,1,0.02h,Break Even,$0.25,$81.50,$58159.25,30,$81.50
2024-02-12,20:56:00,17953.0,SELL,1,0.02h,Stop Loss,$-6.00,$75.50,$58153.25,30,$75.50
2024-02-12,21:56:00,17923.5,BUY,1,0.03h,Stop Loss,$14.00,$89.50,$58167.25,30,$89.50
Final P&L Day: 89.50,,,,,,,,,,,
2024-02-13,12:00:00,17841.25,SELL,1,0.02h,Stop Loss,$9.00,$9.00,$58176.25,31,$9.00
2024-02-13,12:58:00,17835.5,BUY,1,0.02h,Break Even,$0.25,$9.25,$58176.50,31,$9.25
2024-02-13,13:31:00,17731.5,SELL,1,0.02h,Stop Loss,$66.50,$75.75,$58243.00,31,$75.75
2024-02-13,14:37:00,17654.25,BUY,1,0.02h,Break Even,$0.25,$76.00,$58243.25,31,$76.00
2024-02-13,14:53:00,17634.5,SELL,1,0.02h,Stop Loss,$7.75,$83.75,$58251.00,31,$83.75
2024-02-13,14:54:00,17659.75,BUY,1,0.02h,Stop Loss,$102.75,$186.50,$58353.75,31,$186.50
2024-02-13,15:15:00,17649.75,SELL,1,0.02h,Stop Loss,$52.75,$239.25,$58406.50,31,$239.25
2024-02-13,15:21:00,17689.0,BUY,1,0.02h,Stop Loss,$20.25,$259.50,$58426.75,31,$259.50
2024-02-13,15:58:00,17735.75,SELL,1,0.02h,Stop Loss,$16.50,$276.00,$58443.25,31,$276.00
2024-02-13,16:07:00,17761.0,BUY,1,0.02h,Stop Loss,$14.00,$290.00,$58457.25,31,$290.00
2024-02-13,16:18:00,17744.25,SELL,1,0.02h,Stop Loss,$25.25,$315.25,$58482.50,31,$315.25
2024-02-13,16:38:00,17757.0,BUY,1,0.02h,Break Even,$0.25,$315.50,$58482.75,31,$315.50
2024-02-13,16:54:00,17725.25,SELL,1,0.02h,Break Even,$0.25,$315.75,$58483.00,31,$315.75
2024-02-13,17:34:00,17721.25,BUY,1,0.02h,Stop Loss,$-6.00,$309.75,$58477.00,31,$309.75
2024-02-13,17:50:00,17700.5,SELL,1,0.02h,Break Even,$0.25,$310.00,$58477.25,31,$310.00
2024-02-13,18:16:00,17696.5,BUY,1,0.02h,Stop Loss,$-6.00,$304.00,$58471.25,31,$304.00
2024-02-13,18:21:00,17673.0,SELL,1,0.02h,Break Even,$0.25,$304.25,$58471.50,31,$304.25
2024-02-13,18:26:00,17685.0,BUY,1,0.02h,Stop Loss,$15.25,$319.50,$58486.75,31,$319.50
2024-02-13,18:33:00,17680.25,SELL,1,0.02h,Break Even,$0.25,$319.75,$58487.00,31,$319.75
2024-02-13,19:33:00,17626.25,BUY,1,0.02h,Stop Loss,$-6.00,$313.75,$58481.00,31,$313.75
2024-02-13,19:49:00,17608.25,SELL,1,0.02h,Break Even,$0.25,$314.00,$58481.25,31,$314.00
2024-02-13,20:33:00,17571.0,BUY,1,0.02h,Stop Loss,$41.50,$355.50,$58522.75,31,$355.50
Final P&L Day: 355.50,,,,,,,,,,,
2024-02-14,12:39:00,17784.25,SELL,1,0.02h,Stop Loss,$-6.00,$-6.00,$58516.75,32,$-6.00
2024-02-14,12:47:00,17793.0,BUY,1,0.02h,Stop Loss,$-6.00,$-12.00,$58510.75,32,$-12.00
2024-02-14,12:58:00,17787.25,SELL,1,0.02h,Stop Loss,$-6.00,$-18.00,$58504.75,32,$-18.00
2024-02-14,13:02:00,17796.75,BUY,1,0.02h,Stop Loss,$7.75,$-10.25,$58512.50,32,$-10.25
2024-02-14,13:19:00,17793.75,SELL,1,0.02h,Break Even,$0.25,$-10.00,$58512.75,32,$-10.00
2024-02-14,13:43:00,17794.5,BUY,1,0.02h,Break Even,$0.25,$-9.75,$58513.00,32,$-9.75
2024-02-14,13:50:00,17783.5,SELL,1,0.02h,Stop Loss,$7.75,$-2.00,$58520.75,32,$-2.00
2024-02-14,14:26:00,17785.75,BUY,1,0.02h,Break Even,$0.25,$-1.75,$58521.00,32,$-1.75
2024-02-14,14:39:00,17767.0,SELL,1,0.02h,Stop Loss,$64.00,$62.25,$58585.00,32,$62.25
2024-02-14,14:48:00,17790.0,BUY,1,0.02h,Break Even,$0.25,$62.50,$58585.25,32,$62.50
2024-02-14,14:51:00,17761.5,SELL,1,0.02h,Stop Loss,$37.75,$100.25,$58623.00,32,$100.25
2024-02-14,15:00:00,17789.25,BUY,1,0.02h,Stop Loss,$41.50,$141.75,$58664.50,32,$141.75
2024-02-14,15:40:00,17810.0,SELL,1,0.02h,Stop Loss,$47.75,$189.50,$58712.25,32,$189.50
2024-02-14,16:26:00,17755.0,BUY,1,0.02h,Break Even,$0.25,$189.75,$58712.50,32,$189.75
2024-02-14,16:45:00,17728.75,SELL,1,0.02h,Stop Loss,$6.50,$196.25,$58719.00,32,$196.25
2024-02-14,17:15:00,17732.0,BUY,1,0.02h,Break Even,$0.25,$196.50,$58719.25,32,$196.50
2024-02-14,18:11:00,17755.75,SELL,1,0.02h,Break Even,$0.25,$196.75,$58719.50,32,$196.75
2024-02-14,18:33:00,17774.25,BUY,1,0.02h,Break Even,$0.25,$197.00,$58719.75,32,$197.00
2024-02-14,18:58:00,17781.25,SELL,1,0.02h,Break Even,$0.25,$197.25,$58720.00,32,$197.25
2024-02-14,19:26:00,17772.25,BUY,1,0.02h,Break Even,$0.25,$197.50,$58720.25,32,$197.50
2024-02-14,21:46:00,17872.25,SELL,1,0.03h,Stop Loss,$-6.00,$191.50,$58714.25,32,$191.50
Final P&L Day: 191.50,,,,,,,,,,,
2024-02-15,12:00:00,17901.0,BUY,1,0.02h,Stop Loss,$-6.00,$-6.00,$58708.25,33,$-6.00
2024-02-15,12:54:00,17908.5,SELL,1,0.02h,Stop Loss,$4.00,$-2.00,$58712.25,33,$-2.00
2024-02-15,13:32:00,17904.5,BUY,1,0.02h,Stop Loss,$71.50,$69.50,$58783.75,33,$69.50
2024-02-15,13:49:00,17894.75,SELL,1,0.02h,Stop Loss,$47.75,$117.25,$58831.50,33,$117.25
2024-02-15,14:23:00,17897.25,BUY,1,0.02h,Break Even,$0.25,$117.50,$58831.75,33,$117.50
2024-02-15,14:29:00,17883.0,SELL,1,0.02h,Break Even,$0.25,$117.75,$58832.00,33,$117.75
2024-02-15,15:13:00,17850.25,BUY,1,0.02h,Stop Loss,$19.00,$136.75,$58851.00,33,$136.75
2024-02-15,15:29:00,17813.0,SELL,1,0.02h,Stop Loss,$-6.00,$130.75,$58845.00,33,$130.75
2024-02-15,15:46:00,17840.5,BUY,1,0.02h,Break Even,$0.25,$131.00,$58845.25,33,$131.00
2024-02-15,16:03:00,17826.75,SELL,1,0.02h,Break Even,$0.25,$131.25,$58845.50,33,$131.25
2024-02-15,16:25:00,17816.5,BUY,1,0.02h,Stop Loss,$9.00,$140.25,$58854.50,33,$140.25
2024-02-15,16:53:00,17822.5,SELL,1,0.02h,Break Even,$0.25,$140.50,$58854.75,33,$140.50
2024-02-15,17:02:00,17837.25,BUY,1,0.02h,Stop Loss,$-6.00,$134.50,$58848.75,33,$134.50
2024-02-15,17:03:00,17825.0,SELL,1,0.02h,Break Even,$0.25,$134.75,$58849.00,33,$134.75
2024-02-15,17:11:00,17840.75,BUY,1,0.02h,Stop Loss,$5.25,$140.00,$58854.25,33,$140.00
2024-02-15,17:55:00,17866.5,SELL,1,0.02h,Stop Loss,$7.75,$147.75,$58862.00,33,$147.75
2024-02-15,18:08:00,17874.75,BUY,1,0.02h,Stop Loss,$55.25,$203.00,$58917.25,33,$203.00
2024-02-15,18:45:00,17905.25,SELL,1,0.02h,Stop Loss,$5.25,$208.25,$58922.50,33,$208.25
2024-02-15,19:05:00,17913.0,BUY,1,0.02h,Stop Loss,$-6.00,$202.25,$58916.50,33,$202.25
2024-02-15,19:06:00,17906.0,SELL,1,0.02h,Break Even,$0.25,$202.50,$58916.75,33,$202.50
2024-02-15,19:07:00,17914.75,BUY,1,0.02h,Stop Loss,$14.00,$216.50,$58930.75,33,$216.50
2024-02-15,19:12:00,17896.75,SELL,1,0.02h,Stop Loss,$60.25,$276.75,$58991.00,33,$276.75
2024-02-15,19:23:00,17906.5,BUY,1,0.02h,Stop Loss,$14.00,$290.75,$59005.00,33,$290.75
2024-02-15,20:00:00,17906.75,SELL,1,0.02h,Stop Loss,$35.25,$326.00,$59040.25,33,$326.00
2024-02-15,20:52:00,17908.5,BUY,1,0.02h,Break Even,$0.25,$326.25,$59040.50,33,$326.25
2024-02-15,21:44:00,17950.0,SELL,1,0.02h,Break Even,$0.25,$326.50,$59040.75,33,$326.50
2024-02-15,21:53:00,17958.5,BUY,1,0.02h,Stop Loss,$-6.00,$320.50,$59034.75,33,$320.50
Final P&L Day: 320.50,,,,,,,,,,,
2024-02-16,12:55:00,17997.5,SELL,1,0.02h,Break Even,$0.25,$0.25,$59035.00,34,$0.25
2024-02-16,13:03:00,18006.25,BUY,1,0.02h,Break Even,$0.25,$0.50,$59035.25,34,$0.50
2024-02-16,13:06:00,17996.25,SELL,1,0.02h,Break Even,$0.25,$0.75,$59035.50,34,$0.75
2024-02-16,13:11:00,18003.5,BUY,1,0.02h,Break Even,$0.25,$1.00,$59035.75,34,$1.00
2024-02-16,13:22:00,17997.5,SELL,1,0.02h,Break Even,$0.25,$1.25,$59036.00,34,$1.25
2024-02-16,14:01:00,17944.75,BUY,1,0.02h,Stop Loss,$-6.00,$-4.75,$59030.00,34,$-4.75
2024-02-16,14:19:00,17933.25,SELL,1,0.02h,Break Even,$0.25,$-4.50,$59030.25,34,$-4.50
2024-02-16,15:39:00,17789.5,BUY,1,0.02h,Stop Loss,$74.00,$69.50,$59104.25,34,$69.50
2024-02-16,16:50:00,17852.25,SELL,1,0.02h,Stop Loss,$26.50,$96.00,$59130.75,34,$96.00
2024-02-16,16:55:00,17866.25,BUY,1,0.02h,Stop Loss,$7.75,$103.75,$59138.50,34,$103.75
2024-02-16,17:11:00,17856.0,SELL,1,0.02h,Break Even,$0.25,$104.00,$59138.75,34,$104.00
2024-02-16,17:26:00,17872.0,BUY,1,0.02h,Break Even,$0.25,$104.25,$59139.00,34,$104.25
2024-02-16,17:39:00,17861.5,SELL,1,0.02h,Stop Loss,$-6.00,$98.25,$59133.00,34,$98.25
2024-02-16,18:26:00,17839.5,BUY,1,0.02h,Break Even,$0.25,$98.50,$59133.25,34,$98.50
2024-02-16,19:29:00,17885.25,SELL,1,0.02h,Stop Loss,$-6.00,$92.50,$59127.25,34,$92.50
2024-02-16,20:25:00,17791.25,BUY,1,0.02h,Break Even,$0.25,$92.75,$59127.50,34,$92.75
2024-02-16,20:34:00,17783.5,SELL,1,0.02h,Break Even,$0.25,$93.00,$59127.75,34,$93.00
2024-02-16,20:35:00,17786.5,BUY,1,0.02h,Break Even,$0.25,$93.25,$59128.00,34,$93.25
2024-02-16,20:36:00,17784.0,SELL,1,0.02h,Stop Loss,$9.00,$102.25,$59137.00,34,$102.25
Final P&L Day: 102.25,,,,,,,,,,,
2024-02-19,12:00:00,17763.5,BUY,1,0.02h,Stop Loss,$4.00,$4.00,$59141.00,35,$4.00
2024-02-19,13:04:00,17759.5,SELL,1,0.02h,Stop Loss,$-6.00,$-2.00,$59135.00,35,$-2.00
2024-02-19,13:12:00,17766.25,BUY,1,0.02h,Break Even,$0.25,$-1.75,$59135.25,35,$-1.75
2024-02-19,13:45:00,17775.75,SELL,1,0.02h,Break Even,$0.25,$-1.50,$59135.50,35,$-1.50
2024-02-19,14:00:00,17778.25,BUY,1,0.02h,Break Even,$0.25,$-1.25,$59135.75,35,$-1.25
2024-02-19,14:07:00,17776.25,SELL,1,0.03h,Break Even,$0.25,$-1.00,$59136.00,35,$-1.00
2024-02-19,14:12:00,17780.25,BUY,1,0.02h,Stop Loss,$-6.00,$-7.00,$59130.00,35,$-7.00
2024-02-19,14:58:00,17793.25,SELL,1,0.02h,Break Even,$0.25,$-6.75,$59130.25,35,$-6.75
2024-02-19,15:07:00,17798.25,BUY,1,0.02h,Stop Loss,$-6.00,$-12.75,$59124.25,35,$-12.75
2024-02-19,15:08:00,17792.25,SELL,1,0.02h,Break Even,$0.25,$-12.50,$59124.50,35,$-12.50
2024-02-19,15:40:00,17785.5,BUY,1,0.02h,Stop Loss,$-6.00,$-18.50,$59118.50,35,$-18.50
2024-02-19,15:41:00,17783.25,SELL,1,0.02h,Break Even,$0.25,$-18.25,$59118.75,35,$-18.25
2024-02-19,16:04:00,17783.5,BUY,1,0.02h,Stop Loss,$-6.00,$-24.25,$59112.75,35,$-24.25
2024-02-19,16:10:00,17775.25,SELL,1,0.02h,Break Even,$0.25,$-24.00,$59113.00,35,$-24.00
2024-02-19,16:19:00,17783.75,BUY,1,0.03h,Break Even,$0.25,$-23.75,$59113.25,35,$-23.75
2024-02-19,16:43:00,17780.25,SELL,1,0.02h,Break Even,$0.25,$-23.50,$59113.50,35,$-23.50
2024-02-19,16:58:00,17784.25,BUY,1,0.02h,Break Even,$0.25,$-23.25,$59113.75,35,$-23.25
2024-02-19,17:27:00,17783.25,SELL,1,0.03h,Stop Loss,$-6.00,$-29.25,$59107.75,35,$-29.25
2024-02-19,17:29:00,17784.0,BUY,1,0.02h,Break Even,$0.25,$-29.00,$59108.00,35,$-29.00
Final P&L Day: -29.00,,,,,,,,,,,
2024-02-20,12:00:00,17654.25,SELL,1,0.02h,Stop Loss,$-6.00,$-6.00,$59102.00,36,$-6.00
2024-02-20,12:39:00,17683.5,BUY,1,0.02h,Stop Loss,$-6.00,$-12.00,$59096.00,36,$-12.00
2024-02-20,12:44:00,17677.25,SELL,1,0.02h,Stop Loss,$10.25,$-1.75,$59106.25,36,$-1.75
2024-02-20,13:01:00,17676.25,BUY,1,0.02h,Break Even,$0.25,$-1.50,$59106.50,36,$-1.50
2024-02-20,13:06:00,17665.5,SELL,1,0.02h,Stop Loss,$-6.00,$-7.50,$59100.50,36,$-7.50
2024-02-20,13:08:00,17675.5,BUY,1,0.02h,Stop Loss,$-6.00,$-13.50,$59094.50,36,$-13.50
2024-02-20,13:09:00,17669.5,SELL,1,0.02h,Break Even,$0.25,$-13.25,$59094.75,36,$-13.25
2024-02-20,13:12:00,17677.75,BUY,1,0.02h,Break Even,$0.25,$-13.00,$59095.00,36,$-13.00
2024-02-20,13:21:00,17667.75,SELL,1,0.02h,Break Even,$0.25,$-12.75,$59095.25,36,$-12.75
2024-02-20,13:41:00,17688.5,BUY,1,0.02h,Stop Loss,$16.50,$3.75,$59111.75,36,$3.75
2024-02-20,13:54:00,17676.0,SELL,1,0.02h,Stop Loss,$-6.00,$-2.25,$59105.75,36,$-2.25
2024-02-20,13:55:00,17682.5,BUY,1,0.02h,Stop Loss,$-6.00,$-8.25,$59099.75,36,$-8.25
2024-02-20,13:57:00,17676.25,SELL,1,0.02h,Stop Loss,$7.75,$-0.50,$59107.50,36,$-0.50
2024-02-20,14:16:00,17677.25,BUY,1,0.02h,Break Even,$0.25,$-0.25,$59107.75,36,$-0.25
2024-02-20,14:23:00,17666.0,SELL,1,0.02h,Stop Loss,$-6.00,$-6.25,$59101.75,36,$-6.25
2024-02-20,14:32:00,17711.75,BUY,1,0.02h,Stop Loss,$45.25,$39.00,$59147.00,36,$39.00
2024-02-20,14:38:00,17641.0,SELL,1,0.02h,Stop Loss,$95.25,$134.25,$59242.25,36,$134.25
2024-02-20,15:45:00,17525.5,BUY,1,0.02h,Stop Loss,$47.75,$182.00,$59290.00,36,$182.00
2024-02-20,16:23:00,17562.5,SELL,1,0.02h,Stop Loss,$5.25,$187.25,$59295.25,36,$187.25
2024-02-20,16:26:00,17570.75,BUY,1,0.02h,Break Even,$0.25,$187.50,$59295.50,36,$187.50
2024-02-20,16:27:00,17565.5,SELL,1,0.02h,Break Even,$0.25,$187.75,$59295.75,36,$187.75
2024-02-20,16:29:00,17574.75,BUY,1,0.02h,Break Even,$0.25,$188.00,$59296.00,36,$188.00
2024-02-20,16:32:00,17549.0,SELL,1,0.02h,Stop Loss,$15.25,$203.25,$59311.25,36,$203.25
2024-02-20,17:34:00,17489.75,BUY,1,0.02h,Stop Loss,$5.25,$208.50,$59316.50,36,$208.50
2024-02-20,17:39:00,17467.25,SELL,1,0.02h,Stop Loss,$57.75,$266.25,$59374.25,36,$266.25
2024-02-20,17:44:00,17491.25,BUY,1,0.02h,Stop Loss,$35.25,$301.50,$59409.50,36,$301.50
2024-02-20,18:08:00,17492.5,SELL,1,0.02h,Stop Loss,$-6.00,$295.50,$59403.50,36,$295.50
2024-02-20,18:09:00,17498.0,BUY,1,0.02h,Stop Loss,$12.75,$308.25,$59416.25,36,$308.25
2024-02-20,18:12:00,17492.5,SELL,1,0.02h,Break Even,$0.25,$308.50,$59416.50,36,$308.50
2024-02-20,18:14:00,17502.5,BUY,1,0.02h,Break Even,$0.25,$308.75,$59416.75,36,$308.75
2024-02-20,18:16:00,17490.5,SELL,1,0.02h,Stop Loss,$35.25,$344.00,$59452.00,36,$344.00
2024-02-20,18:20:00,17510.5,BUY,1,0.02h,Stop Loss,$25.25,$369.25,$59477.25,36,$369.25
2024-02-20,18:30:00,17492.75,SELL,1,0.02h,Stop Loss,$10.25,$379.50,$59487.50,36,$379.50
2024-02-20,18:43:00,17513.25,BUY,1,0.02h,Break Even,$0.25,$379.75,$59487.75,36,$379.75
2024-02-20,19:18:00,17509.0,SELL,1,0.02h,Break Even,$0.25,$380.00,$59488.00,36,$380.00
2024-02-20,19:20:00,17543.25,BUY,1,0.02h,Stop Loss,$-6.00,$374.00,$59482.00,36,$374.00
2024-02-20,19:25:00,17519.5,SELL,1,0.02h,Stop Loss,$34.00,$408.00,$59516.00,36,$408.00
2024-02-20,19:28:00,17533.75,BUY,1,0.02h,Stop Loss,$10.25,$418.25,$59526.25,36,$418.25
2024-02-20,20:33:00,17557.0,SELL,1,0.02h,Stop Loss,$110.25,$528.50,$59636.50,36,$528.50
2024-02-20,20:46:00,17584.0,BUY,1,0.02h,Stop Loss,$4.00,$532.50,$59640.50,36,$532.50
2024-02-20,21:12:00,17586.25,SELL,1,0.02h,Break Even,$0.25,$532.75,$59640.75,36,$532.75
2024-02-20,21:27:00,17587.25,BUY,1,0.02h,Stop Loss,$-6.00,$526.75,$59634.75,36,$526.75
2024-02-20,21:55:00,17588.5,SELL,1,0.02h,Break Even,$0.25,$527.00,$59635.00,36,$527.00
Final P&L Day: 527.00,,,,,,,,,,,
2024-02-21,13:06:00,17507.5,BUY,1,0.02h,Stop Loss,$-6.00,$-6.00,$59629.00,37,$-6.00
2024-02-21,13:14:00,17496.0,SELL,1,0.02h,Break Even,$0.25,$-5.75,$59629.25,37,$-5.75
2024-02-21,13:40:00,17500.0,BUY,1,0.02h,Break Even,$0.25,$-5.50,$59629.50,37,$-5.50
2024-02-21,14:18:00,17498.75,SELL,1,0.02h,Stop Loss,$-6.00,$-11.50,$59623.50,37,$-11.50
2024-02-21,14:40:00,17500.0,BUY,1,0.02h,Stop Loss,$7.75,$-3.75,$59631.25,37,$-3.75
2024-02-21,14:41:00,17494.5,SELL,1,0.02h,Stop Loss,$76.50,$72.75,$59707.75,37,$72.75
2024-02-21,15:04:00,17501.0,BUY,1,0.02h,Stop Loss,$107.75,$180.50,$59815.50,37,$180.50
2024-02-21,15:27:00,17476.75,SELL,1,0.02h,Break Even,$0.25,$180.75,$59815.75,37,$180.75
2024-02-21,15:59:00,17478.5,BUY,1,0.02h,Break Even,$0.25,$181.00,$59816.00,37,$181.00
2024-02-21,16:00:00,17469.25,SELL,1,0.02h,Break Even,$0.25,$181.25,$59816.25,37,$181.25
2024-02-21,16:02:00,17485.5,BUY,1,0.02h,Break Even,$0.25,$181.50,$59816.50,37,$181.50
2024-02-21,16:30:00,17490.0,SELL,1,0.02h,Stop Loss,$4.00,$185.50,$59820.50,37,$185.50
2024-02-21,16:52:00,17497.0,BUY,1,0.02h,Stop Loss,$6.50,$192.00,$59827.00,37,$192.00
2024-02-21,17:05:00,17483.25,SELL,1,0.02h,Stop Loss,$105.25,$297.25,$59932.25,37,$297.25
2024-02-21,17:41:00,17455.25,BUY,1,0.02h,Stop Loss,$10.25,$307.50,$59942.50,37,$307.50
2024-02-21,17:44:00,17448.0,SELL,1,0.02h,Stop Loss,$47.75,$355.25,$59990.25,37,$355.25
2024-02-21,17:47:00,17459.25,BUY,1,0.02h,Break Even,$0.25,$355.50,$59990.50,37,$355.50
2024-02-21,18:03:00,17431.0,SELL,1,0.02h,Stop Loss,$-6.00,$349.50,$59984.50,37,$349.50
2024-02-21,18:12:00,17469.0,BUY,1,0.02h,Stop Loss,$21.50,$371.00,$60006.00,37,$371.00
2024-02-21,18:28:00,17460.5,SELL,1,0.02h,Stop Loss,$22.75,$393.75,$60028.75,37,$393.75
2024-02-21,18:46:00,17468.0,BUY,1,0.02h,Stop Loss,$-6.00,$387.75,$60022.75,37,$387.75
2024-02-21,18:48:00,17459.75,SELL,1,0.02h,Stop Loss,$12.75,$400.50,$60035.50,37,$400.50
2024-02-21,18:51:00,17463.5,BUY,1,0.02h,Stop Loss,$-6.00,$394.50,$60029.50,37,$394.50
2024-02-21,18:52:00,17458.5,SELL,1,0.02h,Stop Loss,$4.00,$398.50,$60033.50,37,$398.50
2024-02-21,19:07:00,17462.5,BUY,1,0.02h,Stop Loss,$25.25,$423.75,$60058.75,37,$423.75
2024-02-21,19:17:00,17455.75,SELL,1,0.02h,Stop Loss,$20.25,$444.00,$60079.00,37,$444.00
2024-02-21,19:18:00,17466.75,BUY,1,0.02h,Stop Loss,$4.00,$448.00,$60083.00,37,$448.00
2024-02-21,19:19:00,17455.75,SELL,1,0.02h,Stop Loss,$51.50,$499.50,$60134.50,37,$499.50
2024-02-21,19:57:00,17409.0,BUY,1,0.02h,Stop Loss,$-6.00,$493.50,$60128.50,37,$493.50
2024-02-21,20:08:00,17394.75,SELL,1,0.02h,Break Even,$0.25,$493.75,$60128.75,37,$493.75
2024-02-21,20:19:00,17408.75,BUY,1,0.02h,Stop Loss,$-6.00,$487.75,$60122.75,37,$487.75
2024-02-21,20:22:00,17388.75,SELL,1,0.02h,Break Even,$0.25,$488.00,$60123.00,37,$488.00
2024-02-21,20:25:00,17401.5,BUY,1,0.02h,Stop Loss,$41.50,$529.50,$60164.50,37,$529.50
2024-02-21,21:22:00,17426.0,SELL,1,0.02h,Stop Loss,$9.00,$538.50,$60173.50,37,$538.50
2024-02-21,21:27:00,17544.0,BUY,1,0.02h,Stop Loss,$87.75,$626.25,$60261.25,37,$626.25
Final P&L Day: 626.25,,,,,,,,,,,
2024-02-22,12:59:00,17890.0,SELL,1,0.02h,Break Even,$0.25,$0.25,$60261.50,38,$0.25
2024-02-22,13:13:00,17895.0,BUY,1,0.02h,Stop Loss,$22.75,$23.00,$60284.25,38,$23.00
2024-02-22,13:28:00,17891.25,SELL,1,0.02h,Break Even,$0.25,$23.25,$60284.50,38,$23.25
2024-02-22,13:37:00,17900.25,BUY,1,0.02h,Stop Loss,$-6.00,$17.25,$60278.50,38,$17.25
2024-02-22,13:43:00,17889.25,SELL,1,0.02h,Stop Loss,$-6.00,$11.25,$60272.50,38,$11.25
2024-02-22,13:46:00,17898.75,BUY,1,0.02h,Stop Loss,$-6.00,$5.25,$60266.50,38,$5.25
2024-02-22,13:47:00,17893.0,SELL,1,0.02h,Break Even,$0.25,$5.50,$60266.75,38,$5.50
2024-02-22,13:50:00,17897.75,BUY,1,0.02h,Stop Loss,$5.25,$10.75,$60272.00,38,$10.75
2024-02-22,14:04:00,17891.25,SELL,1,0.02h,Break Even,$0.25,$11.00,$60272.25,38,$11.00
2024-02-22,14:30:00,17896.0,BUY,1,0.02h,Stop Loss,$101.50,$112.50,$60373.75,38,$112.50
2024-02-22,14:32:00,17870.75,SELL,1,0.02h,Stop Loss,$14.00,$126.50,$60387.75,38,$126.50
2024-02-22,14:33:00,17883.5,BUY,1,0.02h,Stop Loss,$22.75,$149.25,$60410.50,38,$149.25
2024-02-22,14:34:00,17868.5,SELL,1,0.02h,Stop Loss,$6.50,$155.75,$60417.00,38,$155.75
2024-02-22,14:40:00,17892.75,BUY,1,0.02h,Stop Loss,$56.50,$212.25,$60473.50,38,$212.25
2024-02-22,15:44:00,17936.0,SELL,1,0.02h,Stop Loss,$7.75,$220.00,$60481.25,38,$220.00
2024-02-22,16:07:00,17941.0,BUY,1,0.02h,Break Even,$0.25,$220.25,$60481.50,38,$220.25
2024-02-22,16:49:00,17952.0,SELL,1,0.02h,Break Even,$0.25,$220.50,$60481.75,38,$220.50
2024-02-22,17:07:00,17968.5,BUY,1,0.02h,Stop Loss,$-6.00,$214.50,$60475.75,38,$214.50
2024-02-22,19:36:00,18068.25,SELL,1,0.02h,Break Even,$0.25,$214.75,$60476.00,38,$214.75
2024-02-22,20:06:00,18071.5,BUY,1,0.02h,Stop Loss,$17.75,$232.50,$60493.75,38,$232.50
2024-02-22,20:31:00,18058.25,SELL,1,0.02h,Stop Loss,$36.50,$269.00,$60530.25,38,$269.00
2024-02-22,20:40:00,18075.25,BUY,1,0.02h,Break Even,$0.25,$269.25,$60530.50,38,$269.25
2024-02-22,20:48:00,18061.75,SELL,1,0.02h,Stop Loss,$5.25,$274.50,$60535.75,38,$274.50
2024-02-22,21:41:00,18020.25,BUY,1,0.03h,Break Even,$0.25,$274.75,$60536.00,38,$274.75
2024-02-22,21:45:00,18018.25,SELL,1,0.02h,Break Even,$0.25,$275.00,$60536.25,38,$275.00
2024-02-22,21:47:00,18020.75,BUY,1,0.02h,Stop Loss,$-6.00,$269.00,$60530.25,38,$269.00
Final P&L Day: 269.00,,,,,,,,,,,
2024-02-23,12:18:00,18024.5,SELL,1,0.02h,Break Even,$0.25,$0.25,$60530.50,39,$0.25
2024-02-23,12:27:00,18033.5,BUY,1,0.02h,Stop Loss,$10.25,$10.50,$60540.75,39,$10.50
2024-02-23,12:47:00,18035.0,SELL,1,0.02h,Break Even,$0.25,$10.75,$60541.00,39,$10.75
2024-02-23,12:50:00,18042.5,BUY,1,0.02h,Stop Loss,$-6.00,$4.75,$60535.00,39,$4.75
2024-02-23,13:03:00,18036.0,SELL,1,0.02h,Stop Loss,$-6.00,$-1.25,$60529.00,39,$-1.25
2024-02-23,13:06:00,18042.0,BUY,1,0.02h,Stop Loss,$4.00,$2.75,$60533.00,39,$2.75
2024-02-23,14:51:00,18110.5,SELL,1,0.02h,Stop Loss,$24.00,$26.75,$60557.00,39,$26.75
2024-02-23,16:26:00,17996.75,BUY,1,0.02h,Stop Loss,$22.75,$49.50,$60579.75,39,$49.50
2024-02-23,17:20:00,18035.75,SELL,1,0.02h,Stop Loss,$-6.00,$43.50,$60573.75,39,$43.50
2024-02-23,17:48:00,18033.0,BUY,1,0.02h,Break Even,$0.25,$43.75,$60574.00,39,$43.75
2024-02-23,18:39:00,18043.25,SELL,1,0.02h,Stop Loss,$-6.00,$37.75,$60568.00,39,$37.75
2024-02-23,19:37:00,18016.25,BUY,1,0.02h,Stop Loss,$4.00,$41.75,$60572.00,39,$41.75
2024-02-23,19:51:00,18007.0,SELL,1,0.02h,Stop Loss,$6.50,$48.25,$60578.50,39,$48.25
2024-02-23,19:53:00,18018.5,BUY,1,0.02h,Break Even,$0.25,$48.50,$60578.75,39,$48.50
2024-02-23,20:08:00,18001.0,SELL,1,0.02h,Stop Loss,$34.00,$82.50,$60612.75,39,$82.50
2024-02-23,20:39:00,18001.5,BUY,1,0.02h,Stop Loss,$-6.00,$76.50,$60606.75,39,$76.50
2024-02-23,21:01:00,17977.25,SELL,1,0.02h,Break Even,$0.25,$76.75,$60607.00,39,$76.75
2024-02-23,21:34:00,17969.75,BUY,1,0.02h,Stop Loss,$-6.00,$70.75,$60601.00,39,$70.75
2024-02-23,21:52:00,17968.25,SELL,1,0.03h,Break Even,$0.25,$71.00,$60601.25,39,$71.00
Final P&L Day: 71.00,,,,,,,,,,,
2024-02-26,12:00:00,17989.0,BUY,1,0.02h,Break Even,$0.25,$0.25,$60601.50,40,$0.25
2024-02-26,12:43:00,17980.75,SELL,1,0.02h,Break Even,$0.25,$0.50,$60601.75,40,$0.50
2024-02-26,13:08:00,17987.25,BUY,1,0.02h,Break Even,$0.25,$0.75,$60602.00,40,$0.75
2024-02-26,13:56:00,18013.25,SELL,1,0.02h,Break Even,$0.25,$1.00,$60602.25,40,$1.00
2024-02-26,13:59:00,18016.75,BUY,1,0.02h,Stop Loss,$-6.00,$-5.00,$60596.25,40,$-5.00
2024-02-26,14:01:00,18012.75,SELL,1,0.02h,Stop Loss,$-6.00,$-11.00,$60590.25,40,$-11.00
2024-02-26,14:30:00,18017.0,BUY,1,0.02h,Stop Loss,$91.50,$80.50,$60681.75,40,$80.50
2024-02-26,14:45:00,17992.25,SELL,1,0.02h,Stop Loss,$16.50,$97.00,$60698.25,40,$97.00
2024-02-26,15:08:00,18006.75,BUY,1,0.02h,Stop Loss,$26.50,$123.50,$60724.75,40,$123.50
2024-02-26,15:58:00,18019.75,SELL,1,0.02h,Stop Loss,$-6.00,$117.50,$60718.75,40,$117.50
2024-02-26,16:32:00,18025.5,BUY,1,0.02h,Stop Loss,$9.00,$126.50,$60727.75,40,$126.50
2024-02-26,17:03:00,18020.0,SELL,1,0.02h,Stop Loss,$-6.00,$120.50,$60721.75,40,$120.50
2024-02-26,17:16:00,18037.0,BUY,1,0.02h,Break Even,$0.25,$120.75,$60722.00,40,$120.75
2024-02-26,17:39:00,18037.25,SELL,1,0.02h,Break Even,$0.25,$121.00,$60722.25,40,$121.00
2024-02-26,18:09:00,18035.5,BUY,1,0.02h,Break Even,$0.25,$121.25,$60722.50,40,$121.25
2024-02-26,18:20:00,18015.5,SELL,1,0.02h,Stop Loss,$17.75,$139.00,$60740.25,40,$139.00
2024-02-26,18:58:00,18006.25,BUY,1,0.02h,Stop Loss,$14.00,$153.00,$60754.25,40,$153.00
2024-02-26,19:16:00,18009.75,SELL,1,0.02h,Stop Loss,$-6.00,$147.00,$60748.25,40,$147.00
2024-02-26,19:23:00,18025.75,BUY,1,0.02h,Stop Loss,$21.50,$168.50,$60769.75,40,$168.50
2024-02-26,19:43:00,18020.75,SELL,1,0.02h,Stop Loss,$17.75,$186.25,$60787.50,40,$186.25
2024-02-26,20:12:00,18024.75,BUY,1,0.02h,Stop Loss,$4.00,$190.25,$60791.50,40,$190.25
2024-02-26,20:21:00,18010.75,SELL,1,0.02h,Stop Loss,$-6.00,$184.25,$60785.50,40,$184.25
Final P&L Day: 184.25,,,,,,,,,,,
2024-02-27,12:00:00,18004.75,BUY,1,0.02h,Stop Loss,$5.25,$5.25,$60790.75,41,$5.25
2024-02-27,12:55:00,18029.75,SELL,1,0.02h,Break Even,$0.25,$5.50,$60791.00,41,$5.50
2024-02-27,13:37:00,18014.25,BUY,1,0.02h,Stop Loss,$-6.00,$-0.50,$60785.00,41,$-0.50
2024-02-27,14:10:00,18017.25,SELL,1,0.02h,Break Even,$0.25,$-0.25,$60785.25,41,$-0.25
2024-02-27,15:00:00,17990.25,BUY,1,0.02h,Stop Loss,$122.75,$122.50,$60908.00,41,$122.50
2024-02-27,15:40:00,17998.25,SELL,1,0.02h,Stop Loss,$17.75,$140.25,$60925.75,41,$140.25
2024-02-27,15:49:00,18023.25,BUY,1,0.02h,Break Even,$0.25,$140.50,$60926.00,41,$140.50
2024-02-27,16:05:00,18006.25,SELL,1,0.02h,Stop Loss,$49.00,$189.50,$60975.00,41,$189.50
2024-02-27,16:51:00,17992.0,BUY,1,0.02h,Stop Loss,$20.25,$209.75,$60995.25,41,$209.75
2024-02-27,17:18:00,17988.5,SELL,1,0.02h,Break Even,$0.25,$210.00,$60995.50,41,$210.00
2024-02-27,18:13:00,17951.75,BUY,1,0.02h,Break Even,$0.25,$210.25,$60995.75,41,$210.25
2024-02-27,18:30:00,17941.25,SELL,1,0.02h,Stop Loss,$7.75,$218.00,$61003.50,41,$218.00
2024-02-27,18:40:00,17952.5,BUY,1,0.02h,Break Even,$0.25,$218.25,$61003.75,41,$218.25
2024-02-27,20:18:00,18017.5,SELL,1,0.02h,Stop Loss,$12.75,$231.00,$61016.50,41,$231.00
2024-02-27,20:25:00,18023.75,BUY,1,0.02h,Stop Loss,$-6.00,$225.00,$61010.50,41,$225.00
2024-02-27,20:33:00,18010.0,SELL,1,0.02h,Break Even,$0.25,$225.25,$61010.75,41,$225.25
2024-02-27,20:49:00,18015.5,BUY,1,0.02h,Stop Loss,$5.25,$230.50,$61016.00,41,$230.50
2024-02-27,21:03:00,18010.5,SELL,1,0.02h,Break Even,$0.25,$230.75,$61016.25,41,$230.75
2024-02-27,21:12:00,18016.25,BUY,1,0.02h,Break Even,$0.25,$231.00,$61016.50,41,$231.00
2024-02-27,21:50:00,18020.5,SELL,1,0.02h,Stop Loss,$-6.00,$225.00,$61010.50,41,$225.00
Final P&L Day: 225.00,,,,,,,,,,,
2024-02-28,13:10:00,17935.25,BUY,1,0.02h,Stop Loss,$-6.00,$-6.00,$61004.50,42,$-6.00
2024-02-28,13:11:00,17934.0,SELL,1,0.02h,Stop Loss,$4.00,$-2.00,$61008.50,42,$-2.00
2024-02-28,13:20:00,17937.0,BUY,1,0.02h,Stop Loss,$9.00,$7.00,$61017.50,42,$7.00
2024-02-28,13:42:00,17926.25,SELL,1,0.02h,Stop Loss,$22.75,$29.75,$61040.25,42,$29.75
2024-02-28,13:48:00,17944.5,BUY,1,0.02h,Stop Loss,$7.75,$37.50,$61048.00,42,$37.50
2024-02-28,13:54:00,17931.5,SELL,1,0.02h,Break Even,$0.25,$37.75,$61048.25,42,$37.75
2024-02-28,14:00:00,17944.75,BUY,1,0.02h,Stop Loss,$-6.00,$31.75,$61042.25,42,$31.75
2024-02-28,14:05:00,17933.75,SELL,1,0.02h,Stop Loss,$14.00,$45.75,$61056.25,42,$45.75
2024-02-28,14:31:00,17937.0,BUY,1,0.02h,Stop Loss,$-6.00,$39.75,$61050.25,42,$39.75
2024-02-28,14:32:00,17924.5,SELL,1,0.02h,Stop Loss,$60.25,$100.00,$61110.50,42,$100.00
2024-02-28,14:37:00,17940.25,BUY,1,0.02h,Break Even,$0.25,$100.25,$61110.75,42,$100.25
2024-02-28,14:46:00,17913.5,SELL,1,0.02h,Stop Loss,$11.50,$111.75,$61122.25,42,$111.75
2024-02-28,15:11:00,17914.75,BUY,1,0.02h,Stop Loss,$26.50,$138.25,$61148.75,42,$138.25
2024-02-28,15:27:00,17904.5,SELL,1,0.02h,Stop Loss,$64.00,$202.25,$61212.75,42,$202.25
2024-02-28,15:33:00,17918.25,BUY,1,0.02h,Break Even,$0.25,$202.50,$61213.00,42,$202.50
2024-02-28,15:57:00,17916.0,SELL,1,0.02h,Break Even,$0.25,$202.75,$61213.25,42,$202.75
2024-02-28,15:58:00,17923.0,BUY,1,0.02h,Stop Loss,$24.00,$226.75,$61237.25,42,$226.75
2024-02-28,17:01:00,17955.75,SELL,1,0.02h,Break Even,$0.25,$227.00,$61237.50,42,$227.00
2024-02-28,17:55:00,17922.0,BUY,1,0.02h,Break Even,$0.25,$227.25,$61237.75,42,$227.25
2024-02-28,18:01:00,17911.0,SELL,1,0.02h,Stop Loss,$-6.00,$221.25,$61231.75,42,$221.25
2024-02-28,18:17:00,17919.75,BUY,1,0.02h,Stop Loss,$17.75,$239.00,$61249.50,42,$239.00
2024-02-28,18:52:00,17934.5,SELL,1,0.02h,Stop Loss,$-6.00,$233.00,$61243.50,42,$233.00
2024-02-28,18:59:00,17945.75,BUY,1,0.02h,Stop Loss,$4.00,$237.00,$61247.50,42,$237.00
2024-02-28,19:07:00,17935.25,SELL,1,0.02h,Stop Loss,$14.00,$251.00,$61261.50,42,$251.00
2024-02-28,19:57:00,17915.5,BUY,1,0.02h,Stop Loss,$-6.00,$245.00,$61255.50,42,$245.00
2024-02-28,20:11:00,17899.5,SELL,1,0.02h,Break Even,$0.25,$245.25,$61255.75,42,$245.25
2024-02-28,20:21:00,17909.5,BUY,1,0.02h,Stop Loss,$-6.00,$239.25,$61249.75,42,$239.25
2024-02-28,20:46:00,17906.0,SELL,1,0.02h,Stop Loss,$12.75,$252.00,$61262.50,42,$252.00
2024-02-28,21:01:00,17912.0,BUY,1,0.02h,Break Even,$0.25,$252.25,$61262.75,42,$252.25
2024-02-28,21:02:00,17909.25,SELL,1,0.02h,Stop Loss,$77.75,$330.00,$61340.50,42,$330.00
2024-02-28,21:58:00,17864.5,BUY,1,0.02h,Stop Loss,$-6.00,$324.00,$61334.50,42,$324.00
Final P&L Day: 324.00,,,,,,,,,,,
2024-02-29,12:21:00,17868.25,SELL,1,0.02h,Stop Loss,$7.75,$7.75,$61342.25,43,$7.75
2024-02-29,12:28:00,17874.5,BUY,1,0.02h,Stop Loss,$-6.00,$1.75,$61336.25,43,$1.75
2024-02-29,12:29:00,17869.0,SELL,1,0.02h,Stop Loss,$-6.00,$-4.25,$61330.25,43,$-4.25
2024-02-29,12:33:00,17874.0,BUY,1,0.02h,Break Even,$0.25,$-4.00,$61330.50,43,$-4.00
2024-02-29,12:40:00,17869.5,SELL,1,0.02h,Break Even,$0.25,$-3.75,$61330.75,43,$-3.75
2024-02-29,12:57:00,17874.75,BUY,1,0.02h,Stop Loss,$-6.00,$-9.75,$61324.75,43,$-9.75
2024-02-29,13:03:00,17865.25,SELL,1,0.02h,Stop Loss,$-6.00,$-15.75,$61318.75,43,$-15.75
2024-02-29,13:06:00,17874.25,BUY,1,0.02h,Stop Loss,$7.75,$-8.00,$61326.50,43,$-8.00
2024-02-29,13:24:00,17866.0,SELL,1,0.02h,Stop Loss,$-6.00,$-14.00,$61320.50,43,$-14.00
2024-02-29,13:31:00,17936.5,BUY,1,0.02h,Stop Loss,$111.50,$97.50,$61432.00,43,$97.50
2024-02-29,15:11:00,18011.5,SELL,1,0.02h,Stop Loss,$46.50,$144.00,$61478.50,43,$144.00
2024-02-29,15:37:00,18022.5,BUY,1,0.02h,Stop Loss,$-6.00,$138.00,$61472.50,43,$138.00
2024-02-29,15:44:00,18005.25,SELL,1,0.02h,Break Even,$0.25,$138.25,$61472.75,43,$138.25
2024-02-29,15:51:00,18025.25,BUY,1,0.02h,Stop Loss,$-6.00,$132.25,$61466.75,43,$132.25
2024-02-29,15:53:00,18016.0,SELL,1,0.02h,Stop Loss,$37.75,$170.00,$61504.50,43,$170.00
2024-02-29,16:16:00,18011.25,BUY,1,0.02h,Break Even,$0.25,$170.25,$61504.75,43,$170.25
2024-02-29,16:23:00,17996.0,SELL,1,0.02h,Stop Loss,$5.25,$175.50,$61510.00,43,$175.50
2024-02-29,16:54:00,17970.25,BUY,1,0.02h,Stop Loss,$12.75,$188.25,$61522.75,43,$188.25
2024-02-29,17:29:00,17983.75,SELL,1,0.02h,Stop Loss,$57.75,$246.00,$61580.50,43,$246.00
2024-02-29,17:43:00,17987.25,BUY,1,0.02h,Break Even,$0.25,$246.25,$61580.75,43,$246.25
2024-02-29,18:41:00,18031.25,SELL,1,0.02h,Stop Loss,$20.25,$266.50,$61601.00,43,$266.50
2024-02-29,18:53:00,18041.0,BUY,1,0.02h,Stop Loss,$-6.00,$260.50,$61595.00,43,$260.50
2024-02-29,19:06:00,18028.25,SELL,1,0.02h,Break Even,$0.25,$260.75,$61595.25,43,$260.75
2024-02-29,19:12:00,18041.5,BUY,1,0.02h,Break Even,$0.25,$261.00,$61595.50,43,$261.00
2024-02-29,19:27:00,18027.75,SELL,1,0.02h,Stop Loss,$10.25,$271.25,$61605.75,43,$271.25
2024-02-29,20:00:00,18037.0,BUY,1,0.02h,Stop Loss,$9.00,$280.25,$61614.75,43,$280.25
2024-02-29,21:05:00,18055.0,SELL,1,0.02h,Stop Loss,$80.25,$360.50,$61695.00,43,$360.50
2024-02-29,21:19:00,18066.25,BUY,1,0.02h,Break Even,$0.25,$360.75,$61695.25,43,$360.75
2024-02-29,21:46:00,18067.0,SELL,1,0.02h,Stop Loss,$-6.00,$354.75,$61689.25,43,$354.75
Final P&L Day: 354.75,,,,,,,,,,,
2024-03-01,12:00:00,18092.5,BUY,1,0.02h,Break Even,$0.25,$0.25,$61689.50,44,$0.25
2024-03-01,12:25:00,18076.75,SELL,1,0.02h,Stop Loss,$-6.00,$-5.75,$61683.50,44,$-5.75
2024-03-01,12:38:00,18086.5,BUY,1,0.02h,Break Even,$0.25,$-5.50,$61683.75,44,$-5.50
2024-03-01,13:24:00,18093.25,SELL,1,0.02h,Stop Loss,$14.00,$8.50,$61697.75,44,$8.50
2024-03-01,13:32:00,18102.0,BUY,1,0.02h,Stop Loss,$-6.00,$2.50,$61691.75,44,$2.50
2024-03-01,13:33:00,18096.25,SELL,1,0.02h,Stop Loss,$-6.00,$-3.50,$61685.75,44,$-3.50
2024-03-01,13:50:00,18098.75,BUY,1,0.02h,Stop Loss,$-6.00,$-9.50,$61679.75,44,$-9.50
2024-03-01,13:55:00,18084.25,SELL,1,0.02h,Break Even,$0.25,$-9.25,$61680.00,44,$-9.25
2024-03-01,14:17:00,18091.0,BUY,1,0.02h,Stop Loss,$-6.00,$-15.25,$61674.00,44,$-15.25
2024-03-01,15:33:00,18158.0,SELL,1,0.02h,Stop Loss,$9.00,$-6.25,$61683.00,44,$-6.25
2024-03-01,15:46:00,18182.25,BUY,1,0.02h,Stop Loss,$15.25,$9.00,$61698.25,44,$9.00
2024-03-01,16:36:00,18215.0,SELL,1,0.02h,Stop Loss,$-6.00,$3.00,$61692.25,44,$3.00
2024-03-01,16:38:00,18230.5,BUY,1,0.02h,Stop Loss,$-6.00,$-3.00,$61686.25,44,$-3.00
2024-03-01,17:04:00,18229.0,SELL,1,0.02h,Break Even,$0.25,$-2.75,$61686.50,44,$-2.75
2024-03-01,17:13:00,18244.0,BUY,1,0.02h,Break Even,$0.25,$-2.50,$61686.75,44,$-2.50
2024-03-01,19:35:00,18352.75,SELL,1,0.02h,Stop Loss,$32.75,$30.25,$61719.50,44,$30.25
2024-03-01,19:51:00,18360.75,BUY,1,0.02h,Break Even,$0.25,$30.50,$61719.75,44,$30.50
2024-03-01,20:04:00,18346.25,SELL,1,0.02h,Break Even,$0.25,$30.75,$61720.00,44,$30.75
2024-03-01,20:29:00,18346.0,BUY,1,0.02h,Stop Loss,$-6.00,$24.75,$61714.00,44,$24.75
2024-03-01,20:33:00,18333.5,SELL,1,0.02h,Stop Loss,$-6.00,$18.75,$61708.00,44,$18.75
2024-03-01,20:46:00,18344.5,BUY,1,0.02h,Break Even,$0.25,$19.00,$61708.25,44,$19.00
2024-03-01,21:00:00,18335.0,SELL,1,0.02h,Stop Loss,$47.75,$66.75,$61756.00,44,$66.75
Final P&L Day: 66.75,,,,,,,,,,,
2024-03-04,12:00:00,18334.5,BUY,1,0.03h,Break Even,$0.25,$0.25,$61756.25,45,$0.25
2024-03-04,12:40:00,18339.25,SELL,1,0.02h,Stop Loss,$-6.00,$-5.75,$61750.25,45,$-5.75
2024-03-04,12:43:00,18345.0,BUY,1,0.02h,Break Even,$0.25,$-5.50,$61750.50,45,$-5.50
2024-03-04,12:53:00,18342.5,SELL,1,0.02h,Break Even,$0.25,$-5.25,$61750.75,45,$-5.25
2024-03-04,13:13:00,18346.75,BUY,1,0.02h,Stop Loss,$-6.00,$-11.25,$61744.75,45,$-11.25
2024-03-04,13:27:00,18340.0,SELL,1,0.02h,Stop Loss,$19.00,$7.75,$61763.75,45,$7.75
2024-03-04,13:43:00,18344.75,BUY,1,0.02h,Stop Loss,$-6.00,$1.75,$61757.75,45,$1.75
2024-03-04,13:50:00,18335.0,SELL,1,0.02h,Break Even,$0.25,$2.00,$61758.00,45,$2.00
2024-03-04,15:19:00,18300.25,BUY,1,0.02h,Stop Loss,$-6.00,$-4.00,$61752.00,45,$-4.00
2024-03-04,15:20:00,18298.25,SELL,1,0.02h,Stop Loss,$44.00,$40.00,$61796.00,45,$40.00
2024-03-04,15:34:00,18301.75,BUY,1,0.02h,Stop Loss,$26.50,$66.50,$61822.50,45,$66.50
2024-03-04,16:06:00,18312.0,SELL,1,0.02h,Stop Loss,$35.25,$101.75,$61857.75,45,$101.75
2024-03-04,16:49:00,18307.75,BUY,1,0.02h,Stop Loss,$-6.00,$95.75,$61851.75,45,$95.75
2024-03-04,17:07:00,18306.25,SELL,1,0.02h,Stop Loss,$21.50,$117.25,$61873.25,45,$117.25
2024-03-04,17:14:00,18310.0,BUY,1,0.02h,Stop Loss,$-6.00,$111.25,$61867.25,45,$111.25
2024-03-04,17:36:00,18309.75,SELL,1,0.02h,Stop Loss,$14.00,$125.25,$61881.25,45,$125.25
2024-03-04,18:03:00,18309.25,BUY,1,0.02h,Stop Loss,$-6.00,$119.25,$61875.25,45,$119.25
2024-03-04,18:07:00,18300.75,SELL,1,0.02h,Break Even,$0.25,$119.50,$61875.50,45,$119.50
2024-03-04,18:39:00,18294.25,BUY,1,0.02h,Stop Loss,$-6.00,$113.50,$61869.50,45,$113.50
2024-03-04,19:08:00,18292.75,SELL,1,0.02h,Stop Loss,$4.00,$117.50,$61873.50,45,$117.50
2024-03-04,19:16:00,18302.0,BUY,1,0.02h,Stop Loss,$-6.00,$111.50,$61867.50,45,$111.50
2024-03-04,19:17:00,18298.0,SELL,1,0.02h,Break Even,$0.25,$111.75,$61867.75,45,$111.75
2024-03-04,19:18:00,18301.0,BUY,1,0.02h,Stop Loss,$27.75,$139.50,$61895.50,45,$139.50
2024-03-04,19:29:00,18297.75,SELL,1,0.02h,Break Even,$0.25,$139.75,$61895.75,45,$139.75
2024-03-04,19:34:00,18307.25,BUY,1,0.02h,Stop Loss,$12.75,$152.50,$61908.50,45,$152.50
2024-03-04,20:08:00,18327.75,SELL,1,0.02h,Stop Loss,$-6.00,$146.50,$61902.50,45,$146.50
2024-03-04,20:09:00,18335.25,BUY,1,0.02h,Stop Loss,$5.25,$151.75,$61907.75,45,$151.75
2024-03-04,20:29:00,18334.75,SELL,1,0.02h,Stop Loss,$76.50,$228.25,$61984.25,45,$228.25
2024-03-04,21:59:00,18242.0,BUY,1,0.02h,Stop Loss,$5.25,$233.50,$61989.50,45,$233.50
Final P&L Day: 233.50,,,,,,,,,,,
2024-03-05,12:00:00,18157.75,SELL,1,0.02h,Stop Loss,$-6.00,$-6.00,$61983.50,46,$-6.00
2024-03-05,13:04:00,18161.75,BUY,1,0.02h,Stop Loss,$-6.00,$-12.00,$61977.50,46,$-12.00
2024-03-05,13:23:00,18160.0,SELL,1,0.02h,Stop Loss,$-6.00,$-18.00,$61971.50,46,$-18.00
2024-03-05,15:04:00,18078.75,BUY,1,0.02h,Stop Loss,$10.25,$-7.75,$61981.75,46,$-7.75
2024-03-05,15:07:00,18050.75,SELL,1,0.02h,Stop Loss,$101.50,$93.75,$62083.25,46,$93.75
2024-03-05,16:07:00,17942.75,BUY,1,0.02h,Stop Loss,$6.50,$100.25,$62089.75,46,$100.25
2024-03-05,16:11:00,17931.0,SELL,1,0.02h,Stop Loss,$57.75,$158.00,$62147.50,46,$158.00
2024-03-05,16:19:00,17949.25,BUY,1,0.02h,Break Even,$0.25,$158.25,$62147.75,46,$158.25
2024-03-05,16:37:00,17937.75,SELL,1,0.02h,Break Even,$0.25,$158.50,$62148.00,46,$158.50
2024-03-05,17:01:00,17943.25,BUY,1,0.02h,Break Even,$0.25,$158.75,$62148.25,46,$158.75
2024-03-05,17:40:00,17951.25,SELL,1,0.02h,Stop Loss,$34.00,$192.75,$62182.25,46,$192.75
2024-03-05,17:47:00,17966.25,BUY,1,0.02h,Break Even,$0.25,$193.00,$62182.50,46,$193.00
2024-03-05,17:52:00,17948.5,SELL,1,0.02h,Break Even,$0.25,$193.25,$62182.75,46,$193.25
2024-03-05,17:56:00,17965.25,BUY,1,0.02h,Break Even,$0.25,$193.50,$62183.00,46,$193.50
2024-03-05,18:01:00,17946.25,SELL,1,0.02h,Break Even,$0.25,$193.75,$62183.25,46,$193.75
2024-03-05,19:11:00,17899.5,BUY,1,0.02h,Break Even,$0.25,$194.00,$62183.50,46,$194.00
2024-03-05,19:21:00,17881.75,SELL,1,0.02h,Stop Loss,$-6.00,$188.00,$62177.50,46,$188.00
2024-03-05,19:24:00,17898.25,BUY,1,0.02h,Break Even,$0.25,$188.25,$62177.75,46,$188.25
2024-03-05,19:31:00,17888.75,SELL,1,0.02h,Stop Loss,$42.75,$231.00,$62220.50,46,$231.00
2024-03-05,20:05:00,17872.75,BUY,1,0.02h,Stop Loss,$36.50,$267.50,$62257.00,46,$267.50
2024-03-05,20:09:00,17861.25,SELL,1,0.02h,Stop Loss,$5.25,$272.75,$62262.25,46,$272.75
2024-03-05,20:36:00,17858.25,BUY,1,0.02h,Break Even,$0.25,$273.00,$62262.50,46,$273.00
Final P&L Day: 273.00,,,,,,,,,,,
2024-03-06,13:32:00,18076.0,SELL,1,0.02h,Stop Loss,$47.75,$47.75,$62310.25,47,$47.75
2024-03-06,13:49:00,18083.0,BUY,1,0.02h,Stop Loss,$17.75,$65.50,$62328.00,47,$65.50
2024-03-06,14:37:00,18074.25,SELL,1,0.02h,Break Even,$0.25,$65.75,$62328.25,47,$65.75
2024-03-06,14:46:00,18108.75,BUY,1,0.02h,Break Even,$0.25,$66.00,$62328.50,47,$66.00
2024-03-06,14:47:00,18086.0,SELL,1,0.02h,Stop Loss,$49.00,$115.00,$62377.50,47,$115.00
2024-03-06,15:23:00,18030.0,BUY,1,0.02h,Stop Loss,$9.00,$124.00,$62386.50,47,$124.00
2024-03-06,15:25:00,18013.0,SELL,1,0.02h,Break Even,$0.25,$124.25,$62386.75,47,$124.25
2024-03-06,15:34:00,18034.75,BUY,1,0.02h,Stop Loss,$55.25,$179.50,$62442.00,47,$179.50
2024-03-06,16:33:00,18078.0,SELL,1,0.02h,Stop Loss,$56.50,$236.00,$62498.50,47,$236.00
2024-03-06,16:41:00,18093.75,BUY,1,0.02h,Break Even,$0.25,$236.25,$62498.75,47,$236.25
2024-03-06,17:42:00,18146.75,SELL,1,0.02h,Stop Loss,$15.25,$251.50,$62514.00,47,$251.50
2024-03-06,18:16:00,18142.25,BUY,1,0.02h,Stop Loss,$-6.00,$245.50,$62508.00,47,$245.50
2024-03-06,18:34:00,18082.0,SELL,1,0.02h,Stop Loss,$10.25,$255.75,$62518.25,47,$255.75
2024-03-06,19:25:00,18066.25,BUY,1,0.02h,Break Even,$0.25,$256.00,$62518.50,47,$256.00
2024-03-06,19:35:00,18053.0,SELL,1,0.02h,Stop Loss,$80.25,$336.25,$62598.75,47,$336.25
2024-03-06,20:11:00,18044.75,BUY,1,0.02h,Stop Loss,$6.50,$342.75,$62605.25,47,$342.75
2024-03-06,20:14:00,18021.5,SELL,1,0.02h,Stop Loss,$107.75,$450.50,$62713.00,47,$450.50
2024-03-06,20:41:00,18034.5,BUY,1,0.02h,Stop Loss,$5.25,$455.75,$62718.25,47,$455.75
2024-03-06,21:09:00,18034.0,SELL,1,0.02h,Break Even,$0.25,$456.00,$62718.50,47,$456.00
2024-03-06,21:14:00,18039.5,BUY,1,0.02h,Stop Loss,$-6.00,$450.00,$62712.50,47,$450.00
2024-03-06,21:51:00,18041.75,SELL,1,0.02h,Stop Loss,$-6.00,$444.00,$62706.50,47,$444.00
Final P&L Day: 444.00,,,,,,,,,,,
2024-03-07,12:00:00,18352.75,BUY,1,0.02h,Stop Loss,$-6.00,$-6.00,$62700.50,48,$-6.00
2024-03-07,12:27:00,18121.5,SELL,1,0.02h,Stop Loss,$-6.00,$-12.00,$62694.50,48,$-12.00
2024-03-07,12:28:00,18370.75,BUY,1,0.02h,Stop Loss,$-6.00,$-18.00,$62688.50,48,$-18.00
2024-03-07,12:32:00,18124.75,SELL,1,0.02h,Break Even,$0.25,$-17.75,$62688.75,48,$-17.75
2024-03-07,12:50:00,18371.25,BUY,1,0.02h,Stop Loss,$-6.00,$-23.75,$62682.75,48,$-23.75
2024-03-07,12:52:00,18125.25,SELL,1,0.02h,Stop Loss,$-6.00,$-29.75,$62676.75,48,$-29.75
2024-03-07,12:53:00,18362.0,BUY,1,0.03h,Stop Loss,$-6.00,$-35.75,$62670.75,48,$-35.75
2024-03-07,12:58:00,18120.5,SELL,1,0.02h,Break Even,$0.25,$-35.50,$62671.00,48,$-35.50
2024-03-07,13:03:00,18361.5,BUY,1,0.03h,Stop Loss,$-6.00,$-41.50,$62665.00,48,$-41.50
2024-03-07,13:23:00,18139.25,SELL,1,0.02h,Break Even,$0.25,$-41.25,$62665.25,48,$-41.25
2024-03-07,13:27:00,18384.5,BUY,1,0.02h,Break Even,$0.25,$-41.00,$62665.50,48,$-41.00
2024-03-07,13:30:00,18138.75,SELL,1,0.02h,Stop Loss,$7.75,$-33.25,$62673.25,48,$-33.25
2024-03-07,13:36:00,18396.75,BUY,1,0.02h,Break Even,$0.25,$-33.00,$62673.50,48,$-33.00
2024-03-07,13:39:00,18146.75,SELL,1,0.02h,Stop Loss,$-6.00,$-39.00,$62667.50,48,$-39.00
2024-03-07,13:42:00,18392.75,BUY,1,0.02h,Break Even,$0.25,$-38.75,$62667.75,48,$-38.75
2024-03-07,13:48:00,18158.0,SELL,1,0.02h,Stop Loss,$5.25,$-33.50,$62673.00,48,$-33.50
2024-03-07,13:59:00,18398.0,BUY,1,0.02h,Stop Loss,$-6.00,$-39.50,$62667.00,48,$-39.50
2024-03-07,14:14:00,18150.5,SELL,1,0.02h,Break Even,$0.25,$-39.25,$62667.25,48,$-39.25
2024-03-07,14:16:00,18400.0,BUY,1,0.02h,Stop Loss,$-6.00,$-45.25,$62661.25,48,$-45.25
2024-03-07,14:17:00,18153.75,SELL,1,0.02h,Break Even,$0.25,$-45.00,$62661.50,48,$-45.00
2024-03-07,14:20:00,18420.75,BUY,1,0.02h,Stop Loss,$10.25,$-34.75,$62671.75,48,$-34.75
2024-03-07,14:26:00,18172.25,SELL,1,0.02h,Stop Loss,$-6.00,$-40.75,$62665.75,48,$-40.75
2024-03-07,14:27:00,18417.75,BUY,1,0.02h,Stop Loss,$-6.00,$-46.75,$62659.75,48,$-46.75
2024-03-07,14:28:00,18172.5,SELL,1,0.02h,Stop Loss,$-6.00,$-52.75,$62653.75,48,$-52.75
2024-03-07,14:29:00,18419.25,BUY,1,0.02h,Stop Loss,$52.75,$0.00,$62706.50,48,$0.00
2024-03-07,14:43:00,18180.5,SELL,1,0.02h,Stop Loss,$-6.00,$-6.00,$62700.50,48,$-6.00
2024-03-07,14:44:00,18425.0,BUY,1,0.02h,Stop Loss,$-6.00,$-12.00,$62694.50,48,$-12.00
2024-03-07,14:45:00,18163.25,SELL,1,0.02h,Stop Loss,$94.00,$82.00,$62788.50,48,$82.00
2024-03-07,14:54:00,18438.75,BUY,1,0.02h,Stop Loss,$-6.00,$76.00,$62782.50,48,$76.00
2024-03-07,14:55:00,18194.0,SELL,1,0.02h,Break Even,$0.25,$76.25,$62782.75,48,$76.25
2024-03-07,14:57:00,18453.5,BUY,1,0.02h,Stop Loss,$-6.00,$70.25,$62776.75,48,$70.25
2024-03-07,14:58:00,18184.5,SELL,1,0.02h,Break Even,$0.25,$70.50,$62777.00,48,$70.50
2024-03-07,15:10:00,18435.5,BUY,1,0.02h,Stop Loss,$62.75,$133.25,$62839.75,48,$133.25
2024-03-07,15:20:00,18216.75,SELL,1,0.02h,Stop Loss,$-6.00,$127.25,$62833.75,48,$127.25
2024-03-07,15:24:00,18460.75,BUY,1,0.02h,Stop Loss,$-6.00,$121.25,$62827.75,48,$121.25
2024-03-07,15:26:00,18229.5,SELL,1,0.02h,Stop Loss,$5.25,$126.50,$62833.00,48,$126.50
2024-03-07,15:36:00,18478.5,BUY,1,0.02h,Stop Loss,$-6.00,$120.50,$62827.00,48,$120.50
2024-03-07,15:55:00,18242.5,SELL,1,0.02h,Stop Loss,$21.50,$142.00,$62848.50,48,$142.00
2024-03-07,16:00:00,18498.5,BUY,1,0.02h,Stop Loss,$-6.00,$136.00,$62842.50,48,$136.00
2024-03-07,16:01:00,18246.25,SELL,1,0.02h,Stop Loss,$7.75,$143.75,$62850.25,48,$143.75
2024-03-07,16:04:00,18496.75,BUY,1,0.02h,Stop Loss,$41.50,$185.25,$62891.75,48,$185.25
2024-03-07,16:08:00,18261.75,SELL,1,0.02h,Stop Loss,$-6.00,$179.25,$62885.75,48,$179.25
2024-03-07,16:09:00,18514.75,BUY,1,0.02h,Stop Loss,$-6.00,$173.25,$62879.75,48,$173.25
2024-03-07,16:22:00,18271.0,SELL,1,0.02h,Stop Loss,$-6.00,$167.25,$62873.75,48,$167.25
2024-03-07,16:30:00,18536.0,BUY,1,0.02h,Stop Loss,$-6.00,$161.25,$62867.75,48,$161.25
2024-03-07,16:32:00,18274.25,SELL,1,0.02h,Stop Loss,$-6.00,$155.25,$62861.75,48,$155.25
2024-03-07,16:33:00,18523.5,BUY,1,0.02h,Stop Loss,$-6.00,$149.25,$62855.75,48,$149.25
2024-03-07,16:34:00,18269.75,SELL,1,0.02h,Stop Loss,$-6.00,$143.25,$62849.75,48,$143.25
2024-03-07,16:35:00,18522.75,BUY,1,0.02h,Stop Loss,$-6.00,$137.25,$62843.75,48,$137.25
2024-03-07,16:37:00,18268.5,SELL,1,0.02h,Stop Loss,$-6.00,$131.25,$62837.75,48,$131.25
2024-03-07,16:38:00,18527.75,BUY,1,0.02h,Stop Loss,$-6.00,$125.25,$62831.75,48,$125.25
2024-03-07,16:40:00,18284.0,SELL,1,0.02h,Break Even,$0.25,$125.50,$62832.00,48,$125.50
2024-03-07,16:43:00,18540.25,BUY,1,0.02h,Stop Loss,$-6.00,$119.50,$62826.00,48,$119.50
2024-03-07,16:50:00,18282.75,SELL,1,0.02h,Stop Loss,$-6.00,$113.50,$62820.00,48,$113.50
2024-03-07,16:51:00,18536.25,BUY,1,0.02h,Stop Loss,$-6.00,$107.50,$62814.00,48,$107.50
2024-03-07,16:52:00,18283.75,SELL,1,0.02h,Stop Loss,$-6.00,$101.50,$62808.00,48,$101.50
2024-03-07,16:53:00,18534.5,BUY,1,0.02h,Break Even,$0.25,$101.75,$62808.25,48,$101.75
2024-03-07,17:01:00,18302.0,SELL,1,0.02h,Stop Loss,$6.50,$108.25,$62814.75,48,$108.25
2024-03-07,17:03:00,18546.0,BUY,1,0.02h,Stop Loss,$-6.00,$102.25,$62808.75,48,$102.25
2024-03-07,17:04:00,18298.25,SELL,1,0.02h,Stop Loss,$-6.00,$96.25,$62802.75,48,$96.25
2024-03-07,17:09:00,18551.5,BUY,1,0.02h,Stop Loss,$36.50,$132.75,$62839.25,48,$132.75
2024-03-07,17:18:00,18322.25,SELL,1,0.02h,Stop Loss,$-6.00,$126.75,$62833.25,48,$126.75
2024-03-07,17:19:00,18570.0,BUY,1,0.02h,Stop Loss,$-6.00,$120.75,$62827.25,48,$120.75
2024-03-07,17:20:00,18320.75,SELL,1,0.02h,Stop Loss,$-6.00,$114.75,$62821.25,48,$114.75
2024-03-07,17:21:00,18573.25,BUY,1,0.02h,Stop Loss,$-6.00,$108.75,$62815.25,48,$108.75
2024-03-07,17:24:00,18306.75,SELL,1,0.02h,Stop Loss,$-6.00,$102.75,$62809.25,48,$102.75
2024-03-07,17:28:00,18566.0,BUY,1,0.02h,Stop Loss,$-6.00,$96.75,$62803.25,48,$96.75
2024-03-07,17:29:00,18317.75,SELL,1,0.02h,Stop Loss,$37.75,$134.50,$62841.00,48,$134.50
2024-03-07,17:36:00,18559.5,BUY,1,0.02h,Stop Loss,$20.25,$154.75,$62861.25,48,$154.75
2024-03-07,17:52:00,18305.75,SELL,1,0.02h,Stop Loss,$-6.00,$148.75,$62855.25,48,$148.75
2024-03-07,17:53:00,18562.25,BUY,1,0.02h,Stop Loss,$-6.00,$142.75,$62849.25,48,$142.75
2024-03-07,17:59:00,18306.25,SELL,1,0.02h,Stop Loss,$-6.00,$136.75,$62843.25,48,$136.75
2024-03-07,18:04:00,18562.5,BUY,1,0.02h,Stop Loss,$-6.00,$130.75,$62837.25,48,$130.75
2024-03-07,18:05:00,18306.5,SELL,1,0.02h,Stop Loss,$37.75,$168.50,$62875.00,48,$168.50
2024-03-07,18:19:00,18564.0,BUY,1,0.02h,Stop Loss,$7.75,$176.25,$62882.75,48,$176.25
2024-03-07,18:23:00,18312.25,SELL,1,0.02h,Stop Loss,$-6.00,$170.25,$62876.75,48,$170.25
2024-03-07,18:28:00,18570.5,BUY,1,0.02h,Break Even,$0.25,$170.50,$62877.00,48,$170.50
2024-03-07,18:33:00,18329.75,SELL,1,0.02h,Stop Loss,$5.25,$175.75,$62882.25,48,$175.75
2024-03-07,18:35:00,18585.0,BUY,1,0.02h,Stop Loss,$-6.00,$169.75,$62876.25,48,$169.75
2024-03-07,18:36:00,18336.25,SELL,1,0.02h,Stop Loss,$-6.00,$163.75,$62870.25,48,$163.75
2024-03-07,18:37:00,18589.5,BUY,1,0.02h,Stop Loss,$9.00,$172.75,$62879.25,48,$172.75
2024-03-07,18:44:00,18340.5,SELL,1,0.02h,Stop Loss,$-6.00,$166.75,$62873.25,48,$166.75
2024-03-07,18:45:00,18593.5,BUY,1,0.02h,Stop Loss,$-6.00,$160.75,$62867.25,48,$160.75
2024-03-07,18:52:00,18351.75,SELL,1,0.02h,Stop Loss,$-6.00,$154.75,$62861.25,48,$154.75
2024-03-07,19:07:00,18597.5,BUY,1,0.02h,Stop Loss,$-6.00,$148.75,$62855.25,48,$148.75
2024-03-07,19:08:00,18350.5,SELL,1,0.02h,Stop Loss,$-6.00,$142.75,$62849.25,48,$142.75
2024-03-07,19:09:00,18591.5,BUY,1,0.02h,Stop Loss,$-6.00,$136.75,$62843.25,48,$136.75
2024-03-07,19:10:00,18340.0,SELL,1,0.02h,Stop Loss,$-6.00,$130.75,$62837.25,48,$130.75
2024-03-07,19:11:00,18600.0,BUY,1,0.02h,Break Even,$0.25,$131.00,$62837.50,48,$131.00
2024-03-07,19:22:00,18341.25,SELL,1,0.02h,Stop Loss,$-6.00,$125.00,$62831.50,48,$125.00
2024-03-07,19:23:00,18593.5,BUY,1,0.02h,Stop Loss,$-6.00,$119.00,$62825.50,48,$119.00
2024-03-07,19:24:00,18336.0,SELL,1,0.02h,Stop Loss,$-6.00,$113.00,$62819.50,48,$113.00
2024-03-07,19:26:00,18588.5,BUY,1,0.02h,Break Even,$0.25,$113.25,$62819.75,48,$113.25
2024-03-07,19:28:00,18341.75,SELL,1,0.02h,Stop Loss,$15.25,$128.50,$62835.00,48,$128.50
2024-03-07,19:49:00,18597.5,BUY,1,0.02h,Stop Loss,$20.25,$148.75,$62855.25,48,$148.75
2024-03-07,19:58:00,18335.75,SELL,1,0.02h,Stop Loss,$-6.00,$142.75,$62849.25,48,$142.75
2024-03-07,19:59:00,18578.0,BUY,1,0.02h,Break Even,$0.25,$143.00,$62849.50,48,$143.00
2024-03-07,20:05:00,18313.25,SELL,1,0.02h,Stop Loss,$29.00,$172.00,$62878.50,48,$172.00
2024-03-07,20:07:00,18571.25,BUY,1,0.02h,Stop Loss,$-6.00,$166.00,$62872.50,48,$166.00
2024-03-07,20:16:00,18314.0,SELL,1,0.02h,Break Even,$0.25,$166.25,$62872.75,48,$166.25
2024-03-07,20:21:00,18554.25,BUY,1,0.02h,Break Even,$0.25,$166.50,$62873.00,48,$166.50
2024-03-07,20:29:00,18303.25,SELL,1,0.02h,Stop Loss,$-6.00,$160.50,$62867.00,48,$160.50
2024-03-07,20:30:00,18554.0,BUY,1,0.02h,Stop Loss,$-6.00,$154.50,$62861.00,48,$154.50
2024-03-07,20:31:00,18307.5,SELL,1,0.02h,Break Even,$0.25,$154.75,$62861.25,48,$154.75
2024-03-07,20:36:00,18563.75,BUY,1,0.02h,Stop Loss,$-6.00,$148.75,$62855.25,48,$148.75
2024-03-07,20:37:00,18314.75,SELL,1,0.02h,Stop Loss,$5.25,$154.00,$62860.50,48,$154.00
2024-03-07,20:41:00,18573.75,BUY,1,0.02h,Stop Loss,$6.50,$160.50,$62867.00,48,$160.50
2024-03-07,20:53:00,18321.0,SELL,1,0.02h,Stop Loss,$12.75,$173.25,$62879.75,48,$173.25
2024-03-07,21:04:00,18536.75,BUY,1,0.02h,Stop Loss,$-6.00,$167.25,$62873.75,48,$167.25
2024-03-07,21:05:00,18292.75,SELL,1,0.02h,Stop Loss,$-6.00,$161.25,$62867.75,48,$161.25
2024-03-07,21:07:00,18518.0,BUY,1,0.02h,Stop Loss,$-6.00,$155.25,$62861.75,48,$155.25
2024-03-07,21:08:00,18268.75,SELL,1,0.02h,Stop Loss,$-6.00,$149.25,$62855.75,48,$149.25
2024-03-07,21:20:00,18466.75,BUY,1,0.02h,Stop Loss,$-6.00,$143.25,$62849.75,48,$143.25
2024-03-07,21:21:00,18224.0,SELL,1,0.02h,Stop Loss,$10.25,$153.50,$62860.00,48,$153.50
2024-03-07,21:28:00,18467.5,BUY,1,0.02h,Stop Loss,$57.75,$211.25,$62917.75,48,$211.25
2024-03-07,21:35:00,18217.25,SELL,1,0.02h,Stop Loss,$40.25,$251.50,$62958.00,48,$251.50
2024-03-07,21:38:00,18491.0,BUY,1,0.02h,Stop Loss,$-6.00,$245.50,$62952.00,48,$245.50
2024-03-07,21:39:00,18240.5,SELL,1,0.02h,Stop Loss,$-6.00,$239.50,$62946.00,48,$239.50
2024-03-07,21:40:00,18496.5,BUY,1,0.02h,Stop Loss,$-6.00,$233.50,$62940.00,48,$233.50
2024-03-07,21:43:00,18244.0,SELL,1,0.02h,Stop Loss,$35.25,$268.75,$62975.25,48,$268.75
2024-03-07,21:54:00,18507.0,BUY,1,0.02h,Break Even,$0.25,$269.00,$62975.50,48,$269.00
Final P&L Day: 269.00,,,,,,,,,,,
2024-03-08,12:11:00,18293.0,SELL,1,0.02h,Break Even,$0.25,$0.25,$62975.75,49,$0.25
2024-03-08,12:25:00,18530.0,BUY,1,0.02h,Stop Loss,$-6.00,$-5.75,$62969.75,49,$-5.75
2024-03-08,12:27:00,18278.0,SELL,1,0.02h,Break Even,$0.25,$-5.50,$62970.00,49,$-5.50
2024-03-08,12:36:00,18529.25,BUY,1,0.02h,Stop Loss,$-6.00,$-11.50,$62964.00,49,$-11.50
2024-03-08,12:37:00,18274.5,SELL,1,0.02h,Stop Loss,$-6.00,$-17.50,$62958.00,49,$-17.50
2024-03-08,12:38:00,18522.0,BUY,1,0.02h,Stop Loss,$-6.00,$-23.50,$62952.00,49,$-23.50
2024-03-08,12:47:00,18261.5,SELL,1,0.02h,Stop Loss,$-6.00,$-29.50,$62946.00,49,$-29.50
2024-03-08,12:48:00,18520.25,BUY,1,0.02h,Break Even,$0.25,$-29.25,$62946.25,49,$-29.25
2024-03-08,12:51:00,18260.75,SELL,1,0.02h,Stop Loss,$-6.00,$-35.25,$62940.25,49,$-35.25
2024-03-08,12:52:00,18510.5,BUY,1,0.02h,Stop Loss,$-6.00,$-41.25,$62934.25,49,$-41.25
2024-03-08,12:53:00,18254.75,SELL,1,0.02h,Stop Loss,$-6.00,$-47.25,$62928.25,49,$-47.25
2024-03-08,12:55:00,18516.25,BUY,1,0.02h,Stop Loss,$-6.00,$-53.25,$62922.25,49,$-53.25
2024-03-08,12:56:00,18262.75,SELL,1,0.02h,Stop Loss,$-6.00,$-59.25,$62916.25,49,$-59.25
2024-03-08,12:57:00,18516.25,BUY,1,0.02h,Stop Loss,$-6.00,$-65.25,$62910.25,49,$-65.25
2024-03-08,12:58:00,18267.75,SELL,1,0.02h,Break Even,$0.25,$-65.00,$62910.50,49,$-65.00
2024-03-08,13:01:00,18523.25,BUY,1,0.02h,Stop Loss,$21.50,$-43.50,$62932.00,49,$-43.50
2024-03-08,13:18:00,18291.0,SELL,1,0.02h,Stop Loss,$-6.00,$-49.50,$62926.00,49,$-49.50
2024-03-08,13:19:00,18542.5,BUY,1,0.02h,Stop Loss,$-6.00,$-55.50,$62920.00,49,$-55.50
2024-03-08,13:20:00,18287.25,SELL,1,0.02h,Stop Loss,$19.00,$-36.50,$62939.00,49,$-36.50
2024-03-08,13:23:00,18544.5,BUY,1,0.02h,Stop Loss,$17.75,$-18.75,$62956.75,49,$-18.75
2024-03-08,13:29:00,18283.75,SELL,1,0.02h,Stop Loss,$127.75,$109.00,$63084.50,49,$109.00
2024-03-08,13:32:00,18621.0,BUY,1,0.02h,Stop Loss,$-6.00,$103.00,$63078.50,49,$103.00
2024-03-08,13:33:00,18342.25,SELL,1,0.02h,Stop Loss,$-6.00,$97.00,$63072.50,49,$97.00
2024-03-08,13:34:00,18587.5,BUY,1,0.02h,Stop Loss,$-6.00,$91.00,$63066.50,49,$91.00
2024-03-08,13:35:00,18317.75,SELL,1,0.02h,Stop Loss,$-6.00,$85.00,$63060.50,49,$85.00
2024-03-08,13:36:00,18581.25,BUY,1,0.02h,Stop Loss,$10.25,$95.25,$63070.75,49,$95.25
2024-03-08,13:43:00,18348.5,SELL,1,0.02h,Stop Loss,$-6.00,$89.25,$63064.75,49,$89.25
2024-03-08,13:44:00,18599.25,BUY,1,0.02h,Stop Loss,$17.75,$107.00,$63082.50,49,$107.00
2024-03-08,13:47:00,18364.25,SELL,1,0.02h,Stop Loss,$9.00,$116.00,$63091.50,49,$116.00
2024-03-08,13:50:00,18597.75,BUY,1,0.02h,Stop Loss,$-6.00,$110.00,$63085.50,49,$110.00
2024-03-08,13:56:00,18364.5,SELL,1,0.02h,Stop Loss,$15.25,$125.25,$63100.75,49,$125.25
2024-03-08,14:00:00,18604.75,BUY,1,0.02h,Stop Loss,$27.75,$153.00,$63128.50,49,$153.00
2024-03-08,14:09:00,18340.75,SELL,1,0.02h,Stop Loss,$20.25,$173.25,$63148.75,49,$173.25
2024-03-08,14:16:00,18577.25,BUY,1,0.02h,Break Even,$0.25,$173.50,$63149.00,49,$173.50
2024-03-08,14:18:00,18330.5,SELL,1,0.02h,Stop Loss,$-6.00,$167.50,$63143.00,49,$167.50
2024-03-08,14:19:00,18576.0,BUY,1,0.02h,Stop Loss,$10.25,$177.75,$63153.25,49,$177.75
2024-03-08,14:21:00,18331.5,SELL,1,0.02h,Stop Loss,$-6.00,$171.75,$63147.25,49,$171.75
2024-03-08,14:22:00,18585.25,BUY,1,0.02h,Break Even,$0.25,$172.00,$63147.50,49,$172.00
2024-03-08,14:31:00,18311.5,SELL,1,0.02h,Stop Loss,$-6.00,$166.00,$63141.50,49,$166.00
2024-03-08,14:32:00,18572.5,BUY,1,0.02h,Stop Loss,$-6.00,$160.00,$63135.50,49,$160.00
2024-03-08,14:33:00,18323.75,SELL,1,0.02h,Stop Loss,$26.50,$186.50,$63162.00,49,$186.50
2024-03-08,14:39:00,18561.25,BUY,1,0.02h,Stop Loss,$-6.00,$180.50,$63156.00,49,$180.50
2024-03-08,14:40:00,18300.0,SELL,1,0.02h,Stop Loss,$-6.00,$174.50,$63150.00,49,$174.50
2024-03-08,14:42:00,18572.25,BUY,1,0.02h,Stop Loss,$-6.00,$168.50,$63144.00,49,$168.50
2024-03-08,14:43:00,18318.75,SELL,1,0.02h,Stop Loss,$-6.00,$162.50,$63138.00,49,$162.50
2024-03-08,14:54:00,18619.0,BUY,1,0.02h,Stop Loss,$26.50,$189.00,$63164.50,49,$189.00
2024-03-08,15:03:00,18386.0,SELL,1,0.02h,Stop Loss,$5.25,$194.25,$63169.75,49,$194.25
2024-03-08,15:08:00,18664.5,BUY,1,0.02h,Stop Loss,$-6.00,$188.25,$63163.75,49,$188.25
2024-03-08,15:09:00,18411.25,SELL,1,0.02h,Stop Loss,$7.75,$196.00,$63171.50,49,$196.00
2024-03-08,15:12:00,18665.0,BUY,1,0.02h,Stop Loss,$-6.00,$190.00,$63165.50,49,$190.00
2024-03-08,15:17:00,18416.5,SELL,1,0.02h,Stop Loss,$-6.00,$184.00,$63159.50,49,$184.00
2024-03-08,15:18:00,18675.25,BUY,1,0.02h,Stop Loss,$-6.00,$178.00,$63153.50,49,$178.00
2024-03-08,15:25:00,18408.25,SELL,1,0.02h,Stop Loss,$-6.00,$172.00,$63147.50,49,$172.00
2024-03-08,15:29:00,18676.5,BUY,1,0.02h,Stop Loss,$46.50,$218.50,$63194.00,49,$218.50
2024-03-08,15:39:00,18383.25,SELL,1,0.02h,Stop Loss,$-6.00,$212.50,$63188.00,49,$212.50
2024-03-08,15:40:00,18633.5,BUY,1,0.02h,Stop Loss,$-6.00,$206.50,$63182.00,49,$206.50
2024-03-08,15:41:00,18380.0,SELL,1,0.02h,Stop Loss,$-6.00,$200.50,$63176.00,49,$200.50
2024-03-08,15:59:00,18649.75,BUY,1,0.02h,Stop Loss,$-6.00,$194.50,$63170.00,49,$194.50
2024-03-08,16:00:00,18380.5,SELL,1,0.02h,Stop Loss,$107.75,$302.25,$63277.75,49,$302.25
2024-03-08,16:02:00,18611.0,BUY,1,0.02h,Stop Loss,$-6.00,$296.25,$63271.75,49,$296.25
2024-03-08,16:03:00,18334.0,SELL,1,0.02h,Stop Loss,$112.75,$409.00,$63384.50,49,$409.00
2024-03-08,16:16:00,18519.5,BUY,1,0.02h,Stop Loss,$40.25,$449.25,$63424.75,49,$449.25
2024-03-08,16:18:00,18244.0,SELL,1,0.02h,Stop Loss,$37.75,$487.00,$63462.50,49,$487.00
2024-03-08,16:30:00,18451.0,BUY,1,0.02h,Stop Loss,$35.25,$522.25,$63497.75,49,$522.25
2024-03-08,16:35:00,18206.25,SELL,1,0.02h,Stop Loss,$6.50,$528.75,$63504.25,49,$528.75
2024-03-08,16:42:00,18461.5,BUY,1,0.02h,Stop Loss,$62.75,$591.50,$63567.00,49,$591.50
2024-03-08,16:48:00,18170.25,SELL,1,0.02h,Stop Loss,$-6.00,$585.50,$63561.00,49,$585.50
2024-03-08,16:49:00,18431.0,BUY,1,0.02h,Stop Loss,$30.25,$615.75,$63591.25,49,$615.75
2024-03-08,16:51:00,18198.75,SELL,1,0.02h,Stop Loss,$14.00,$629.75,$63605.25,49,$629.75
2024-03-08,17:07:00,18443.25,BUY,1,0.02h,Stop Loss,$-6.00,$623.75,$63599.25,49,$623.75
2024-03-08,17:08:00,18193.25,SELL,1,0.02h,Stop Loss,$-6.00,$617.75,$63593.25,49,$617.75
2024-03-08,17:09:00,18420.5,BUY,1,0.02h,Stop Loss,$-6.00,$611.75,$63587.25,49,$611.75
2024-03-08,17:10:00,18151.25,SELL,1,0.02h,Stop Loss,$100.25,$712.00,$63687.50,49,$712.00
2024-03-08,17:13:00,18414.5,BUY,1,0.02h,Stop Loss,$-6.00,$706.00,$63681.50,49,$706.00
2024-03-08,17:14:00,18183.0,SELL,1,0.02h,Stop Loss,$-6.00,$700.00,$63675.50,49,$700.00
2024-03-08,17:15:00,18424.5,BUY,1,0.02h,Stop Loss,$-6.00,$694.00,$63669.50,49,$694.00
2024-03-08,17:16:00,18165.75,SELL,1,0.02h,Stop Loss,$17.75,$711.75,$63687.25,49,$711.75
2024-03-08,17:19:00,18403.75,BUY,1,0.02h,Stop Loss,$-6.00,$705.75,$63681.25,49,$705.75
2024-03-08,17:20:00,18141.5,SELL,1,0.02h,Stop Loss,$-6.00,$699.75,$63675.25,49,$699.75
2024-03-08,17:21:00,18411.75,BUY,1,0.02h,Stop Loss,$4.00,$703.75,$63679.25,49,$703.75
2024-03-08,17:28:00,18180.75,SELL,1,0.02h,Stop Loss,$-6.00,$697.75,$63673.25,49,$697.75
2024-03-08,17:31:00,18437.75,BUY,1,0.02h,Stop Loss,$39.00,$736.75,$63712.25,49,$736.75
2024-03-08,17:40:00,18176.5,SELL,1,0.02h,Stop Loss,$29.00,$765.75,$63741.25,49,$765.75
2024-03-08,18:00:00,18314.5,BUY,1,0.02h,Break Even,$0.25,$766.00,$63741.50,49,$766.00
2024-03-08,18:03:00,18070.0,SELL,1,0.02h,Stop Loss,$-6.00,$760.00,$63735.50,49,$760.00
2024-03-08,18:20:00,18327.25,BUY,1,0.02h,Stop Loss,$-6.00,$754.00,$63729.50,49,$754.00
2024-03-08,18:21:00,18078.5,SELL,1,0.02h,Stop Loss,$47.75,$801.75,$63777.25,49,$801.75
2024-03-08,18:29:00,18310.5,BUY,1,0.02h,Break Even,$0.25,$802.00,$63777.50,49,$802.00
2024-03-08,18:35:00,18034.25,SELL,1,0.02h,Break Even,$0.25,$802.25,$63777.75,49,$802.25
2024-03-08,18:47:00,18285.5,BUY,1,0.02h,Stop Loss,$-6.00,$796.25,$63771.75,49,$796.25
2024-03-08,18:48:00,18036.5,SELL,1,0.02h,Stop Loss,$10.25,$806.50,$63782.00,49,$806.50
2024-03-08,18:52:00,18282.0,BUY,1,0.02h,Stop Loss,$20.25,$826.75,$63802.25,49,$826.75
2024-03-08,19:00:00,18046.0,SELL,1,0.02h,Stop Loss,$16.50,$843.25,$63818.75,49,$843.25
2024-03-08,19:02:00,18311.25,BUY,1,0.02h,Stop Loss,$-6.00,$837.25,$63812.75,49,$837.25
2024-03-08,19:03:00,18074.5,SELL,1,0.02h,Stop Loss,$-6.00,$831.25,$63806.75,49,$831.25
2024-03-08,19:04:00,18337.0,BUY,1,0.02h,Stop Loss,$-6.00,$825.25,$63800.75,49,$825.25
2024-03-08,19:06:00,18077.25,SELL,1,0.02h,Break Even,$0.25,$825.50,$63801.00,49,$825.50
2024-03-08,19:09:00,18339.25,BUY,1,0.02h,Stop Loss,$21.50,$847.00,$63822.50,49,$847.00
2024-03-08,19:16:00,18085.75,SELL,1,0.02h,Stop Loss,$17.75,$864.75,$63840.25,49,$864.75
2024-03-08,19:19:00,18344.25,BUY,1,0.02h,Stop Loss,$-6.00,$858.75,$63834.25,49,$858.75
2024-03-08,19:20:00,18091.25,SELL,1,0.02h,Stop Loss,$-6.00,$852.75,$63828.25,49,$852.75
2024-03-08,19:21:00,18354.0,BUY,1,0.02h,Stop Loss,$-6.00,$846.75,$63822.25,49,$846.75
2024-03-08,19:23:00,18119.25,SELL,1,0.02h,Stop Loss,$17.75,$864.50,$63840.00,49,$864.50
2024-03-08,19:29:00,18372.0,BUY,1,0.02h,Stop Loss,$6.50,$871.00,$63846.50,49,$871.00
2024-03-08,19:43:00,18161.0,SELL,1,0.02h,Break Even,$0.25,$871.25,$63846.75,49,$871.25
2024-03-08,19:45:00,18420.75,BUY,1,0.02h,Stop Loss,$5.25,$876.50,$63852.00,49,$876.50
2024-03-08,19:57:00,18140.75,SELL,1,0.02h,Stop Loss,$-6.00,$870.50,$63846.00,49,$870.50
2024-03-08,19:58:00,18387.75,BUY,1,0.02h,Stop Loss,$-6.00,$864.50,$63840.00,49,$864.50
2024-03-08,19:59:00,18146.25,SELL,1,0.02h,Stop Loss,$-6.00,$858.50,$63834.00,49,$858.50
2024-03-08,20:00:00,18393.25,BUY,1,0.02h,Stop Loss,$76.50,$935.00,$63910.50,49,$935.00
2024-03-08,20:04:00,18164.5,SELL,1,0.02h,Stop Loss,$24.00,$959.00,$63934.50,49,$959.00
2024-03-08,20:07:00,18378.25,BUY,1,0.02h,Stop Loss,$-6.00,$953.00,$63928.50,49,$953.00
2024-03-08,20:08:00,18131.75,SELL,1,0.02h,Stop Loss,$-6.00,$947.00,$63922.50,49,$947.00
2024-03-08,20:09:00,18384.0,BUY,1,0.02h,Stop Loss,$-6.00,$941.00,$63916.50,49,$941.00
2024-03-08,20:12:00,18106.75,SELL,1,0.02h,Stop Loss,$-6.00,$935.00,$63910.50,49,$935.00
2024-03-08,20:13:00,18363.5,BUY,1,0.02h,Stop Loss,$-6.00,$929.00,$63904.50,49,$929.00
2024-03-08,20:14:00,18107.25,SELL,1,0.02h,Stop Loss,$6.50,$935.50,$63911.00,49,$935.50
2024-03-08,20:19:00,18345.5,BUY,1,0.02h,Stop Loss,$-6.00,$929.50,$63905.00,49,$929.50
2024-03-08,20:20:00,18094.25,SELL,1,0.02h,Stop Loss,$41.50,$971.00,$63946.50,49,$971.00
2024-03-08,20:25:00,18353.25,BUY,1,0.02h,Stop Loss,$41.50,$1012.50,$63988.00,49,$1012.50
2024-03-08,20:28:00,18089.5,SELL,1,0.02h,Stop Loss,$142.75,$1155.25,$64130.75,49,$1155.25
2024-03-08,20:34:00,18331.0,BUY,1,0.02h,Stop Loss,$-6.00,$1149.25,$64124.75,49,$1149.25
2024-03-08,20:35:00,18079.25,SELL,1,0.02h,Stop Loss,$35.25,$1184.50,$64160.00,49,$1184.50
2024-03-08,20:42:00,18304.5,BUY,1,0.02h,Stop Loss,$9.00,$1193.50,$64169.00,49,$1193.50
2024-03-08,20:44:00,18064.25,SELL,1,0.02h,Stop Loss,$-6.00,$1187.50,$64163.00,49,$1187.50
2024-03-08,20:45:00,18304.5,BUY,1,0.02h,Stop Loss,$-6.00,$1181.50,$64157.00,49,$1181.50
2024-03-08,20:46:00,18066.5,SELL,1,0.02h,Stop Loss,$12.75,$1194.25,$64169.75,49,$1194.25
2024-03-08,20:50:00,18318.25,BUY,1,0.02h,Stop Loss,$40.25,$1234.50,$64210.00,49,$1234.50
2024-03-08,20:52:00,18060.75,SELL,1,0.02h,Stop Loss,$-6.00,$1228.50,$64204.00,49,$1228.50
2024-03-08,20:53:00,18304.75,BUY,1,0.02h,Stop Loss,$-6.00,$1222.50,$64198.00,49,$1222.50
2024-03-08,20:54:00,18054.25,SELL,1,0.02h,Stop Loss,$-6.00,$1216.50,$64192.00,49,$1216.50
2024-03-08,20:55:00,18316.75,BUY,1,0.02h,Stop Loss,$-6.00,$1210.50,$64186.00,49,$1210.50
2024-03-08,20:56:00,18049.5,SELL,1,0.02h,Stop Loss,$-6.00,$1204.50,$64180.00,49,$1204.50
2024-03-08,21:06:00,18320.25,BUY,1,0.02h,Stop Loss,$-6.00,$1198.50,$64174.00,49,$1198.50
2024-03-08,21:12:00,18065.5,SELL,1,0.02h,Stop Loss,$-6.00,$1192.50,$64168.00,49,$1192.50
2024-03-08,21:13:00,18315.25,BUY,1,0.02h,Stop Loss,$-6.00,$1186.50,$64162.00,49,$1186.50
2024-03-08,21:14:00,18066.5,SELL,1,0.02h,Stop Loss,$54.00,$1240.50,$64216.00,49,$1240.50
2024-03-08,21:37:00,18305.5,BUY,1,0.02h,Stop Loss,$-6.00,$1234.50,$64210.00,49,$1234.50
2024-03-08,21:38:00,18054.0,SELL,1,0.02h,Stop Loss,$-6.00,$1228.50,$64204.00,49,$1228.50
2024-03-08,21:41:00,18304.0,BUY,1,0.02h,Stop Loss,$-6.00,$1222.50,$64198.00,49,$1222.50
2024-03-08,21:43:00,18053.25,SELL,1,0.03h,Stop Loss,$-6.00,$1216.50,$64192.00,49,$1216.50
2024-03-08,21:45:00,18303.0,BUY,1,0.02h,Break Even,$0.25,$1216.75,$64192.25,49,$1216.75
2024-03-08,21:56:00,18055.5,SELL,1,0.02h,Stop Loss,$-6.00,$1210.75,$64186.25,49,$1210.75
2024-03-08,21:57:00,18304.0,BUY,1,0.02h,Stop Loss,$-6.00,$1204.75,$64180.25,49,$1204.75
2024-03-08,21:58:00,18053.5,SELL,1,0.02h,Stop Loss,$-6.00,$1198.75,$64174.25,49,$1198.75
2024-03-08,21:59:00,18303.75,BUY,1,0.02h,Stop Loss,$-6.00,$1192.75,$64168.25,49,$1192.75
2024-03-08,22:00:00,18055.25,SELL,1,62.00h,Stop Loss,$-6.00,$1186.75,$64162.25,49,$1186.75
Final P&L Day: 1186.75,,,,,,,,,,,
2024-03-11,12:00:00,18235.25,BUY,1,0.02h,Stop Loss,$-6.00,$-6.00,$64156.25,50,$-6.00
2024-03-11,12:17:00,18186.5,SELL,1,0.02h,Stop Loss,$12.75,$6.75,$64169.00,50,$6.75
2024-03-11,12:20:00,18201.0,BUY,1,0.02h,Stop Loss,$47.75,$54.50,$64216.75,50,$54.50
2024-03-11,12:44:00,18190.25,SELL,1,0.02h,Stop Loss,$35.25,$89.75,$64252.00,50,$89.75
2024-03-11,12:55:00,18201.0,BUY,1,0.02h,Break Even,$0.25,$90.00,$64252.25,50,$90.00
2024-03-11,13:32:00,18185.25,SELL,1,0.02h,Stop Loss,$100.25,$190.25,$64352.50,50,$190.25
2024-03-11,13:41:00,18229.0,BUY,1,0.02h,Stop Loss,$76.50,$266.75,$64429.00,50,$266.75
2024-03-11,13:53:00,18202.5,SELL,1,0.02h,Stop Loss,$71.50,$338.25,$64500.50,50,$338.25
2024-03-11,14:21:00,18169.25,BUY,1,0.02h,Break Even,$0.25,$338.50,$64500.75,50,$338.50
2024-03-11,14:22:00,18162.25,SELL,1,0.02h,Stop Loss,$24.00,$362.50,$64524.75,50,$362.50
2024-03-11,14:30:00,18175.25,BUY,1,0.02h,Stop Loss,$130.25,$492.75,$64655.00,50,$492.75
2024-03-11,15:11:00,18214.0,SELL,1,0.02h,Stop Loss,$121.50,$614.25,$64776.50,50,$614.25
2024-03-11,15:46:00,18200.25,BUY,1,0.02h,Stop Loss,$71.50,$685.75,$64848.00,50,$685.75
2024-03-11,16:10:00,18213.25,SELL,1,0.02h,Stop Loss,$44.00,$729.75,$64892.00,50,$729.75
2024-03-11,16:19:00,18231.5,BUY,1,0.02h,Break Even,$0.25,$730.00,$64892.25,50,$730.00
2024-03-11,16:47:00,18220.25,SELL,1,0.02h,Stop Loss,$11.50,$741.50,$64903.75,50,$741.50
2024-03-11,16:55:00,18234.0,BUY,1,0.02h,Break Even,$0.25,$741.75,$64904.00,50,$741.75
2024-03-11,17:05:00,18225.5,SELL,1,0.02h,Stop Loss,$-6.00,$735.75,$64898.00,50,$735.75
2024-03-11,17:24:00,18231.0,BUY,1,0.02h,Break Even,$0.25,$736.00,$64898.25,50,$736.00
2024-03-11,17:41:00,18223.75,SELL,1,0.02h,Stop Loss,$92.75,$828.75,$64991.00,50,$828.75
2024-03-11,17:59:00,18218.75,BUY,1,0.02h,Stop Loss,$14.00,$842.75,$65005.00,50,$842.75
2024-03-11,18:37:00,18223.75,SELL,1,0.02h,Stop Loss,$-6.00,$836.75,$64999.00,50,$836.75
2024-03-11,18:43:00,18239.5,BUY,1,0.02h,Break Even,$0.25,$837.00,$64999.25,50,$837.00
2024-03-11,19:02:00,18231.0,SELL,1,0.02h,Break Even,$0.25,$837.25,$64999.50,50,$837.25
2024-03-11,19:43:00,18223.75,BUY,1,0.02h,Stop Loss,$17.75,$855.00,$65017.25,50,$855.00
2024-03-11,19:51:00,18209.5,SELL,1,0.02h,Stop Loss,$34.00,$889.00,$65051.25,50,$889.00
2024-03-11,20:01:00,18225.25,BUY,1,0.02h,Stop Loss,$9.00,$898.00,$65060.25,50,$898.00
2024-03-11,22:39:00,18275.0,SELL,1,0.02h,Stop Loss,$-6.00,$892.00,$65054.25,50,$892.00
2024-03-11,22:41:00,18281.0,BUY,1,0.02h,Stop Loss,$4.00,$896.00,$65058.25,50,$896.00
2024-03-11,22:54:00,18278.25,SELL,1,0.02h,Break Even,$0.25,$896.25,$65058.50,50,$896.25
Final P&L Day: 896.25,,,,,,,,,,,
2024-03-12,12:20:00,18295.5,BUY,1,0.02h,Stop Loss,$26.50,$26.50,$65085.00,51,$26.50
2024-03-12,12:26:00,18051.75,SELL,1,0.02h,Stop Loss,$-6.00,$20.50,$65079.00,51,$20.50
2024-03-12,12:28:00,18300.5,BUY,1,0.02h,Stop Loss,$-6.00,$14.50,$65073.00,51,$14.50
2024-03-12,12:45:00,18109.0,SELL,1,0.02h,Stop Loss,$-6.00,$8.50,$65067.00,51,$8.50
2024-03-12,12:46:00,18375.0,BUY,1,0.02h,Break Even,$0.25,$8.75,$65067.25,51,$8.75
2024-03-12,12:59:00,18075.75,SELL,1,0.02h,Stop Loss,$42.75,$51.50,$65110.00,51,$51.50
2024-03-12,13:16:00,18280.25,BUY,1,0.02h,Stop Loss,$-6.00,$45.50,$65104.00,51,$45.50
2024-03-12,13:17:00,18045.5,SELL,1,0.02h,Stop Loss,$-6.00,$39.50,$65098.00,51,$39.50
2024-03-12,13:18:00,18292.75,BUY,1,0.02h,Break Even,$0.25,$39.75,$65098.25,51,$39.75
2024-03-12,13:25:00,18047.0,SELL,1,0.02h,Stop Loss,$-6.00,$33.75,$65092.25,51,$33.75
2024-03-12,13:28:00,18300.5,BUY,1,0.02h,Stop Loss,$-6.00,$27.75,$65086.25,51,$27.75
2024-03-12,13:29:00,18062.5,SELL,1,0.02h,Stop Loss,$-6.00,$21.75,$65080.25,51,$21.75
2024-03-12,13:30:00,18311.5,BUY,1,0.02h,Stop Loss,$121.50,$143.25,$65201.75,51,$143.25
2024-03-12,13:37:00,17997.25,SELL,1,0.02h,Stop Loss,$82.75,$226.00,$65284.50,51,$226.00
2024-03-12,13:57:00,18269.75,BUY,1,0.02h,Break Even,$0.25,$226.25,$65284.75,51,$226.25
2024-03-12,14:12:00,18069.75,SELL,1,0.02h,Stop Loss,$-6.00,$220.25,$65278.75,51,$220.25
2024-03-12,14:13:00,18314.5,BUY,1,0.02h,Stop Loss,$-6.00,$214.25,$65272.75,51,$214.25
2024-03-12,14:16:00,18075.75,SELL,1,0.02h,Stop Loss,$40.25,$254.50,$65313.00,51,$254.50
2024-03-12,14:24:00,18344.75,BUY,1,0.02h,Stop Loss,$50.25,$304.75,$65363.25,51,$304.75
2024-03-12,14:43:00,18152.5,SELL,1,0.02h,Stop Loss,$10.25,$315.00,$65373.50,51,$315.00
2024-03-12,14:45:00,18407.5,BUY,1,0.02h,Stop Loss,$-6.00,$309.00,$65367.50,51,$309.00
2024-03-12,14:46:00,18159.5,SELL,1,0.02h,Stop Loss,$14.00,$323.00,$65381.50,51,$323.00
2024-03-12,14:51:00,18425.0,BUY,1,0.02h,Stop Loss,$76.50,$399.50,$65458.00,51,$399.50
2024-03-12,15:02:00,18168.5,SELL,1,0.02h,Stop Loss,$15.25,$414.75,$65473.25,51,$414.75
2024-03-12,15:04:00,18422.5,BUY,1,0.02h,Stop Loss,$-6.00,$408.75,$65467.25,51,$408.75
2024-03-12,15:05:00,18157.25,SELL,1,0.02h,Stop Loss,$-6.00,$402.75,$65461.25,51,$402.75
2024-03-12,15:06:00,18405.5,BUY,1,0.02h,Stop Loss,$26.50,$429.25,$65487.75,51,$429.25
2024-03-12,15:08:00,18172.5,SELL,1,0.02h,Stop Loss,$-6.00,$423.25,$65481.75,51,$423.25
2024-03-12,15:09:00,18431.0,BUY,1,0.02h,Stop Loss,$-6.00,$417.25,$65475.75,51,$417.25
2024-03-12,15:10:00,18177.0,SELL,1,0.02h,Stop Loss,$-6.00,$411.25,$65469.75,51,$411.25
2024-03-12,15:12:00,18435.0,BUY,1,0.02h,Break Even,$0.25,$411.50,$65470.00,51,$411.50
2024-03-12,15:16:00,18190.5,SELL,1,0.02h,Break Even,$0.25,$411.75,$65470.25,51,$411.75
2024-03-12,15:20:00,18436.75,BUY,1,0.02h,Stop Loss,$-6.00,$405.75,$65464.25,51,$405.75
2024-03-12,15:21:00,18189.0,SELL,1,0.02h,Stop Loss,$26.50,$432.25,$65490.75,51,$432.25
2024-03-12,15:23:00,18437.75,BUY,1,0.02h,Stop Loss,$61.50,$493.75,$65552.25,51,$493.75
2024-03-12,15:26:00,18202.0,SELL,1,0.02h,Break Even,$0.25,$494.00,$65552.50,51,$494.00
2024-03-12,15:35:00,18447.5,BUY,1,0.02h,Stop Loss,$-6.00,$488.00,$65546.50,51,$488.00
2024-03-12,15:42:00,18159.25,SELL,1,0.02h,Stop Loss,$-6.00,$482.00,$65540.50,51,$482.00
2024-03-12,15:43:00,18405.5,BUY,1,0.02h,Stop Loss,$-6.00,$476.00,$65534.50,51,$476.00
2024-03-12,15:44:00,18161.5,SELL,1,0.02h,Break Even,$0.25,$476.25,$65534.75,51,$476.25
2024-03-12,15:47:00,18390.0,BUY,1,0.02h,Stop Loss,$89.00,$565.25,$65623.75,51,$565.25
2024-03-12,15:53:00,18175.25,SELL,1,0.02h,Break Even,$0.25,$565.50,$65624.00,51,$565.50
2024-03-12,16:03:00,18391.75,BUY,1,0.02h,Stop Loss,$-6.00,$559.50,$65618.00,51,$559.50
2024-03-12,16:04:00,18147.25,SELL,1,0.02h,Stop Loss,$25.25,$584.75,$65643.25,51,$584.75
2024-03-12,16:12:00,18396.0,BUY,1,0.02h,Stop Loss,$-6.00,$578.75,$65637.25,51,$578.75
2024-03-12,16:13:00,18157.0,SELL,1,0.02h,Stop Loss,$-6.00,$572.75,$65631.25,51,$572.75
2024-03-12,16:22:00,18392.5,BUY,1,0.02h,Stop Loss,$-6.00,$566.75,$65625.25,51,$566.75
2024-03-12,16:23:00,18140.25,SELL,1,0.02h,Stop Loss,$-6.00,$560.75,$65619.25,51,$560.75
2024-03-12,16:24:00,18382.0,BUY,1,0.02h,Break Even,$0.25,$561.00,$65619.50,51,$561.00
2024-03-12,16:28:00,18131.75,SELL,1,0.02h,Stop Loss,$-6.00,$555.00,$65613.50,51,$555.00
2024-03-12,16:29:00,18385.5,BUY,1,0.02h,Stop Loss,$-6.00,$549.00,$65607.50,51,$549.00
2024-03-12,16:32:00,18133.0,SELL,1,0.02h,Break Even,$0.25,$549.25,$65607.75,51,$549.25
2024-03-12,16:45:00,18354.25,BUY,1,0.02h,Stop Loss,$-6.00,$543.25,$65601.75,51,$543.25
2024-03-12,16:49:00,18093.5,SELL,1,0.02h,Break Even,$0.25,$543.50,$65602.00,51,$543.50
2024-03-12,16:51:00,18347.5,BUY,1,0.02h,Stop Loss,$46.50,$590.00,$65648.50,51,$590.00
2024-03-12,16:54:00,18104.75,SELL,1,0.02h,Stop Loss,$-6.00,$584.00,$65642.50,51,$584.00
2024-03-12,16:55:00,18358.75,BUY,1,0.02h,Stop Loss,$-6.00,$578.00,$65636.50,51,$578.00
2024-03-12,16:56:00,18114.5,SELL,1,0.02h,Stop Loss,$-6.00,$572.00,$65630.50,51,$572.00
2024-03-12,16:57:00,18342.25,BUY,1,0.02h,Stop Loss,$-6.00,$566.00,$65624.50,51,$566.00
2024-03-12,16:58:00,18099.0,SELL,1,0.02h,Stop Loss,$-6.00,$560.00,$65618.50,51,$560.00
2024-03-12,16:59:00,18350.0,BUY,1,0.02h,Stop Loss,$26.50,$586.50,$65645.00,51,$586.50
2024-03-12,17:03:00,18085.0,SELL,1,0.02h,Stop Loss,$-6.00,$580.50,$65639.00,51,$580.50
2024-03-12,17:11:00,18328.75,BUY,1,0.02h,Stop Loss,$26.50,$607.00,$65665.50,51,$607.00
2024-03-12,17:21:00,18142.5,SELL,1,0.02h,Stop Loss,$-6.00,$601.00,$65659.50,51,$601.00
2024-03-12,17:24:00,18396.0,BUY,1,0.02h,Stop Loss,$15.25,$616.25,$65674.75,51,$616.25
2024-03-12,17:29:00,18140.25,SELL,1,0.02h,Stop Loss,$37.75,$654.00,$65712.50,51,$654.00
2024-03-12,17:31:00,18391.25,BUY,1,0.02h,Stop Loss,$-6.00,$648.00,$65706.50,51,$648.00
2024-03-12,17:32:00,18146.75,SELL,1,0.02h,Stop Loss,$-6.00,$642.00,$65700.50,51,$642.00
2024-03-12,17:33:00,18393.0,BUY,1,0.02h,Stop Loss,$-6.00,$636.00,$65694.50,51,$636.00
2024-03-12,17:34:00,18145.5,SELL,1,0.02h,Break Even,$0.25,$636.25,$65694.75,51,$636.25
2024-03-12,17:38:00,18391.5,BUY,1,0.02h,Stop Loss,$-6.00,$630.25,$65688.75,51,$630.25
2024-03-12,17:39:00,18152.25,SELL,1,0.02h,Stop Loss,$10.25,$640.50,$65699.00,51,$640.50
2024-03-12,17:42:00,18400.5,BUY,1,0.02h,Stop Loss,$-6.00,$634.50,$65693.00,51,$634.50
2024-03-12,17:43:00,18153.25,SELL,1,0.02h,Break Even,$0.25,$634.75,$65693.25,51,$634.75
2024-03-12,17:49:00,18404.0,BUY,1,0.02h,Break Even,$0.25,$635.00,$65693.50,51,$635.00
2024-03-12,18:06:00,18175.5,SELL,1,0.02h,Stop Loss,$27.75,$662.75,$65721.25,51,$662.75
2024-03-12,18:08:00,18412.5,BUY,1,0.02h,Stop Loss,$-6.00,$656.75,$65715.25,51,$656.75
2024-03-12,18:09:00,18167.0,SELL,1,0.02h,Stop Loss,$-6.00,$650.75,$65709.25,51,$650.75
2024-03-12,18:18:00,18424.75,BUY,1,0.02h,Stop Loss,$-6.00,$644.75,$65703.25,51,$644.75
2024-03-12,18:19:00,18173.25,SELL,1,0.02h,Break Even,$0.25,$645.00,$65703.50,51,$645.00
2024-03-12,18:26:00,18432.5,BUY,1,0.02h,Stop Loss,$-6.00,$639.00,$65697.50,51,$639.00
2024-03-12,18:34:00,18201.5,SELL,1,0.02h,Stop Loss,$-6.00,$633.00,$65691.50,51,$633.00
2024-03-12,18:35:00,18452.0,BUY,1,0.02h,Stop Loss,$-6.00,$627.00,$65685.50,51,$627.00
2024-03-12,18:37:00,18206.25,SELL,1,0.02h,Stop Loss,$42.75,$669.75,$65728.25,51,$669.75
2024-03-12,18:40:00,18446.0,BUY,1,0.02h,Break Even,$0.25,$670.00,$65728.50,51,$670.00
2024-03-12,18:43:00,18178.75,SELL,1,0.02h,Stop Loss,$-6.00,$664.00,$65722.50,51,$664.00
2024-03-12,18:44:00,18411.25,BUY,1,0.02h,Stop Loss,$31.50,$695.50,$65754.00,51,$695.50
2024-03-12,18:53:00,18209.5,SELL,1,0.02h,Stop Loss,$-6.00,$689.50,$65748.00,51,$689.50
2024-03-12,18:54:00,18460.25,BUY,1,0.02h,Break Even,$0.25,$689.75,$65748.25,51,$689.75
2024-03-12,18:59:00,18213.5,SELL,1,0.02h,Stop Loss,$-6.00,$683.75,$65742.25,51,$683.75
2024-03-12,19:00:00,18454.75,BUY,1,0.02h,Break Even,$0.25,$684.00,$65742.50,51,$684.00
2024-03-12,19:05:00,18205.75,SELL,1,0.02h,Stop Loss,$5.25,$689.25,$65747.75,51,$689.25
2024-03-12,19:07:00,18450.25,BUY,1,0.02h,Stop Loss,$-6.00,$683.25,$65741.75,51,$683.25
2024-03-12,19:08:00,18204.0,SELL,1,0.02h,Break Even,$0.25,$683.50,$65742.00,51,$683.50
2024-03-12,19:11:00,18460.25,BUY,1,0.02h,Stop Loss,$-6.00,$677.50,$65736.00,51,$677.50
2024-03-12,19:12:00,18207.0,SELL,1,0.02h,Stop Loss,$-6.00,$671.50,$65730.00,51,$671.50
2024-03-12,19:15:00,18459.25,BUY,1,0.02h,Break Even,$0.25,$671.75,$65730.25,51,$671.75
2024-03-12,19:29:00,18213.25,SELL,1,0.02h,Break Even,$0.25,$672.00,$65730.50,51,$672.00
2024-03-12,19:38:00,18469.75,BUY,1,0.02h,Stop Loss,$7.75,$679.75,$65738.25,51,$679.75
2024-03-12,19:43:00,18230.25,SELL,1,0.02h,Stop Loss,$14.00,$693.75,$65752.25,51,$693.75
2024-03-12,19:45:00,18467.0,BUY,1,0.02h,Stop Loss,$-6.00,$687.75,$65746.25,51,$687.75
2024-03-12,19:46:00,18224.25,SELL,1,0.02h,Stop Loss,$4.00,$691.75,$65750.25,51,$691.75
2024-03-12,19:59:00,18480.0,BUY,1,0.02h,Break Even,$0.25,$692.00,$65750.50,51,$692.00
2024-03-12,20:16:00,18220.0,SELL,1,0.02h,Break Even,$0.25,$692.25,$65750.75,51,$692.25
2024-03-12,20:24:00,18467.5,BUY,1,0.02h,Stop Loss,$-6.00,$686.25,$65744.75,51,$686.25
2024-03-12,20:25:00,18218.5,SELL,1,0.02h,Stop Loss,$-6.00,$680.25,$65738.75,51,$680.25
2024-03-12,20:26:00,18469.25,BUY,1,0.02h,Break Even,$0.25,$680.50,$65739.00,51,$680.50
2024-03-12,20:31:00,18226.0,SELL,1,0.02h,Stop Loss,$-6.00,$674.50,$65733.00,51,$674.50
2024-03-12,20:33:00,18475.0,BUY,1,0.02h,Stop Loss,$-6.00,$668.50,$65727.00,51,$668.50
2024-03-12,20:37:00,18226.75,SELL,1,0.02h,Stop Loss,$-6.00,$662.50,$65721.00,51,$662.50
2024-03-12,20:38:00,18474.75,BUY,1,0.02h,Stop Loss,$-6.00,$656.50,$65715.00,51,$656.50
2024-03-12,20:39:00,18226.5,SELL,1,0.02h,Break Even,$0.25,$656.75,$65715.25,51,$656.75
2024-03-12,20:52:00,18475.75,BUY,1,0.02h,Stop Loss,$-6.00,$650.75,$65709.25,51,$650.75
2024-03-12,20:57:00,18229.25,SELL,1,0.02h,Stop Loss,$-6.00,$644.75,$65703.25,51,$644.75
2024-03-12,20:58:00,18474.5,BUY,1,0.02h,Stop Loss,$-6.00,$638.75,$65697.25,51,$638.75
2024-03-12,22:01:00,18219.75,SELL,1,0.02h,Stop Loss,$-6.00,$632.75,$65691.25,51,$632.75
2024-03-12,22:02:00,18468.75,BUY,1,0.02h,Stop Loss,$-6.00,$626.75,$65685.25,51,$626.75
2024-03-12,22:09:00,18220.25,SELL,1,0.02h,Stop Loss,$-6.00,$620.75,$65679.25,51,$620.75
2024-03-12,22:10:00,18467.5,BUY,1,0.02h,Break Even,$0.25,$621.00,$65679.50,51,$621.00
2024-03-12,22:12:00,18219.0,SELL,1,0.02h,Stop Loss,$-6.00,$615.00,$65673.50,51,$615.00
2024-03-12,22:14:00,18469.75,BUY,1,0.03h,Break Even,$0.25,$615.25,$65673.75,51,$615.25
2024-03-12,22:29:00,18223.25,SELL,1,0.03h,Stop Loss,$-6.00,$609.25,$65667.75,51,$609.25
2024-03-12,22:41:00,18474.0,BUY,1,0.02h,Stop Loss,$-6.00,$603.25,$65661.75,51,$603.25
2024-03-12,22:42:00,18223.5,SELL,1,0.03h,Stop Loss,$-6.00,$597.25,$65655.75,51,$597.25
2024-03-12,22:46:00,18474.0,BUY,1,0.02h,Stop Loss,$-6.00,$591.25,$65649.75,51,$591.25
2024-03-12,22:47:00,18225.5,SELL,1,0.02h,Stop Loss,$-6.00,$585.25,$65643.75,51,$585.25
2024-03-12,22:48:00,18475.25,BUY,1,0.03h,Stop Loss,$-6.00,$579.25,$65637.75,51,$579.25
2024-03-12,22:51:00,18227.0,SELL,1,0.02h,Stop Loss,$-6.00,$573.25,$65631.75,51,$573.25
2024-03-12,22:53:00,18479.75,BUY,1,0.02h,Stop Loss,$-6.00,$567.25,$65625.75,51,$567.25
2024-03-12,22:54:00,18229.75,SELL,1,0.02h,Break Even,$0.25,$567.50,$65626.00,51,$567.50
Final P&L Day: 567.50,,,,,,,,,,,
2024-03-13,12:04:00,18458.0,BUY,1,0.02h,Stop Loss,$-6.00,$-6.00,$65620.00,52,$-6.00
2024-03-13,12:05:00,18201.25,SELL,1,0.02h,Stop Loss,$-6.00,$-12.00,$65614.00,52,$-12.00
2024-03-13,12:07:00,18453.25,BUY,1,0.02h,Stop Loss,$-6.00,$-18.00,$65608.00,52,$-18.00
2024-03-13,12:10:00,18202.5,SELL,1,0.02h,Break Even,$0.25,$-17.75,$65608.25,52,$-17.75
2024-03-13,12:12:00,18447.0,BUY,1,0.02h,Stop Loss,$20.25,$2.50,$65628.50,52,$2.50
2024-03-13,12:18:00,18199.0,SELL,1,0.02h,Stop Loss,$4.00,$6.50,$65632.50,52,$6.50
2024-03-13,12:22:00,18443.0,BUY,1,0.02h,Stop Loss,$-6.00,$0.50,$65626.50,52,$0.50
2024-03-13,12:26:00,18187.25,SELL,1,0.02h,Break Even,$0.25,$0.75,$65626.75,52,$0.75
2024-03-13,12:30:00,18430.5,BUY,1,0.02h,Stop Loss,$-6.00,$-5.25,$65620.75,52,$-5.25
2024-03-13,12:32:00,18177.75,SELL,1,0.02h,Stop Loss,$-6.00,$-11.25,$65614.75,52,$-11.25
2024-03-13,12:33:00,18426.75,BUY,1,0.02h,Stop Loss,$-6.00,$-17.25,$65608.75,52,$-17.25
2024-03-13,12:34:00,18172.25,SELL,1,0.02h,Stop Loss,$-6.00,$-23.25,$65602.75,52,$-23.25
2024-03-13,12:35:00,18415.0,BUY,1,0.02h,Stop Loss,$25.25,$2.00,$65628.00,52,$2.00
2024-03-13,12:37:00,18167.75,SELL,1,0.02h,Stop Loss,$-6.00,$-4.00,$65622.00,52,$-4.00
2024-03-13,12:48:00,18423.0,BUY,1,0.02h,Break Even,$0.25,$-3.75,$65622.25,52,$-3.75
2024-03-13,12:53:00,18170.25,SELL,1,0.02h,Stop Loss,$-6.00,$-9.75,$65616.25,52,$-9.75
2024-03-13,12:54:00,18414.5,BUY,1,0.02h,Stop Loss,$4.00,$-5.75,$65620.25,52,$-5.75
2024-03-13,13:02:00,18177.0,SELL,1,0.02h,Stop Loss,$-6.00,$-11.75,$65614.25,52,$-11.75
2024-03-13,13:03:00,18427.75,BUY,1,0.02h,Stop Loss,$-6.00,$-17.75,$65608.25,52,$-17.75
2024-03-13,13:04:00,18182.0,SELL,1,0.02h,Stop Loss,$-6.00,$-23.75,$65602.25,52,$-23.75
2024-03-13,13:05:00,18434.0,BUY,1,0.02h,Stop Loss,$-6.00,$-29.75,$65596.25,52,$-29.75
2024-03-13,13:06:00,18184.25,SELL,1,0.02h,Stop Loss,$4.00,$-25.75,$65600.25,52,$-25.75
2024-03-13,13:10:00,18434.0,BUY,1,0.02h,Stop Loss,$-6.00,$-31.75,$65594.25,52,$-31.75
2024-03-13,13:16:00,18189.5,SELL,1,0.02h,Stop Loss,$12.75,$-19.00,$65607.00,52,$-19.00
2024-03-13,13:23:00,18434.5,BUY,1,0.02h,Stop Loss,$-6.00,$-25.00,$65601.00,52,$-25.00
2024-03-13,13:24:00,18184.75,SELL,1,0.02h,Stop Loss,$-6.00,$-31.00,$65595.00,52,$-31.00
2024-03-13,13:25:00,18432.0,BUY,1,0.02h,Stop Loss,$12.75,$-18.25,$65607.75,52,$-18.25
2024-03-13,13:28:00,18184.25,SELL,1,0.02h,Stop Loss,$-6.00,$-24.25,$65601.75,52,$-24.25
2024-03-13,13:29:00,18429.0,BUY,1,0.02h,Stop Loss,$14.00,$-10.25,$65615.75,52,$-10.25
2024-03-13,13:36:00,18155.0,SELL,1,0.02h,Stop Loss,$37.75,$27.50,$65653.50,52,$27.50
2024-03-13,13:43:00,18389.75,BUY,1,0.02h,Stop Loss,$-6.00,$21.50,$65647.50,52,$21.50
2024-03-13,13:47:00,18107.75,SELL,1,0.02h,Break Even,$0.25,$21.75,$65647.75,52,$21.75
2024-03-13,14:07:00,18335.5,BUY,1,0.02h,Stop Loss,$-6.00,$15.75,$65641.75,52,$15.75
2024-03-13,14:11:00,18075.0,SELL,1,0.02h,Stop Loss,$-6.00,$9.75,$65635.75,52,$9.75
2024-03-13,14:16:00,18335.0,BUY,1,0.02h,Stop Loss,$-6.00,$3.75,$65629.75,52,$3.75
2024-03-13,14:17:00,18081.0,SELL,1,0.02h,Break Even,$0.25,$4.00,$65630.00,52,$4.00
2024-03-13,14:24:00,18343.25,BUY,1,0.02h,Stop Loss,$-6.00,$-2.00,$65624.00,52,$-2.00
2024-03-13,14:25:00,18098.25,SELL,1,0.02h,Stop Loss,$21.50,$19.50,$65645.50,52,$19.50
2024-03-13,14:29:00,18341.25,BUY,1,0.02h,Stop Loss,$-6.00,$13.50,$65639.50,52,$13.50
2024-03-13,14:30:00,18095.75,SELL,1,0.02h,Stop Loss,$5.25,$18.75,$65644.75,52,$18.75
2024-03-13,14:32:00,18344.0,BUY,1,0.02h,Stop Loss,$-6.00,$12.75,$65638.75,52,$12.75
2024-03-13,14:33:00,18099.25,SELL,1,0.02h,Stop Loss,$-6.00,$6.75,$65632.75,52,$6.75
2024-03-13,14:34:00,18361.5,BUY,1,0.02h,Break Even,$0.25,$7.00,$65633.00,52,$7.00
2024-03-13,14:38:00,18096.5,SELL,1,0.02h,Stop Loss,$-6.00,$1.00,$65627.00,52,$1.00
2024-03-13,14:39:00,18354.5,BUY,1,0.02h,Stop Loss,$-6.00,$-5.00,$65621.00,52,$-5.00
2024-03-13,14:50:00,18112.75,SELL,1,0.02h,Stop Loss,$16.50,$11.50,$65637.50,52,$11.50
2024-03-13,15:06:00,18356.5,BUY,1,0.02h,Stop Loss,$-6.00,$5.50,$65631.50,52,$5.50
2024-03-13,15:08:00,18094.25,SELL,1,0.02h,Break Even,$0.25,$5.75,$65631.75,52,$5.75
2024-03-13,15:13:00,18362.75,BUY,1,0.02h,Stop Loss,$-6.00,$-0.25,$65625.75,52,$-0.25
2024-03-13,15:14:00,18105.5,SELL,1,0.02h,Stop Loss,$36.50,$36.25,$65662.25,52,$36.25
2024-03-13,15:17:00,18347.5,BUY,1,0.02h,Stop Loss,$15.25,$51.50,$65677.50,52,$51.50
2024-03-13,15:30:00,18073.5,SELL,1,0.02h,Stop Loss,$21.50,$73.00,$65699.00,52,$73.00
2024-03-13,15:42:00,18304.25,BUY,1,0.02h,Stop Loss,$-6.00,$67.00,$65693.00,52,$67.00
2024-03-13,15:43:00,18044.75,SELL,1,0.02h,Stop Loss,$39.00,$106.00,$65732.00,52,$106.00
2024-03-13,15:48:00,18296.0,BUY,1,0.02h,Stop Loss,$12.75,$118.75,$65744.75,52,$118.75
2024-03-13,15:55:00,18075.75,SELL,1,0.02h,Stop Loss,$-6.00,$112.75,$65738.75,52,$112.75
2024-03-13,15:57:00,18332.5,BUY,1,0.02h,Stop Loss,$-6.00,$106.75,$65732.75,52,$106.75
2024-03-13,15:58:00,18083.75,SELL,1,0.02h,Stop Loss,$-6.00,$100.75,$65726.75,52,$100.75
2024-03-13,15:59:00,18330.25,BUY,1,0.02h,Stop Loss,$20.25,$121.00,$65747.00,52,$121.00
2024-03-13,16:02:00,18078.5,SELL,1,0.02h,Stop Loss,$9.00,$130.00,$65756.00,52,$130.00
2024-03-13,16:06:00,18336.0,BUY,1,0.02h,Stop Loss,$-6.00,$124.00,$65750.00,52,$124.00
2024-03-13,16:10:00,18078.0,SELL,1,0.02h,Stop Loss,$7.75,$131.75,$65757.75,52,$131.75
2024-03-13,16:18:00,18335.5,BUY,1,0.02h,Stop Loss,$9.00,$140.75,$65766.75,52,$140.75
2024-03-13,16:22:00,18089.75,SELL,1,0.02h,Stop Loss,$-6.00,$134.75,$65760.75,52,$134.75
2024-03-13,16:24:00,18338.75,BUY,1,0.02h,Stop Loss,$-6.00,$128.75,$65754.75,52,$128.75
2024-03-13,16:25:00,18092.5,SELL,1,0.02h,Stop Loss,$-6.00,$122.75,$65748.75,52,$122.75
2024-03-13,16:26:00,18344.0,BUY,1,0.02h,Stop Loss,$-6.00,$116.75,$65742.75,52,$116.75
2024-03-13,16:27:00,18091.5,SELL,1,0.02h,Stop Loss,$-6.00,$110.75,$65736.75,52,$110.75
2024-03-13,16:28:00,18342.5,BUY,1,0.02h,Stop Loss,$-6.00,$104.75,$65730.75,52,$104.75
2024-03-13,16:29:00,18083.25,SELL,1,0.02h,Stop Loss,$-6.00,$98.75,$65724.75,52,$98.75
2024-03-13,16:31:00,18339.0,BUY,1,0.02h,Stop Loss,$-6.00,$92.75,$65718.75,52,$92.75
2024-03-13,16:32:00,18075.75,SELL,1,0.02h,Stop Loss,$11.50,$104.25,$65730.25,52,$104.25
2024-03-13,16:35:00,18328.5,BUY,1,0.02h,Stop Loss,$-6.00,$98.25,$65724.25,52,$98.25
2024-03-13,16:36:00,18080.75,SELL,1,0.02h,Stop Loss,$-6.00,$92.25,$65718.25,52,$92.25
2024-03-13,16:37:00,18327.0,BUY,1,0.02h,Stop Loss,$-6.00,$86.25,$65712.25,52,$86.25
2024-03-13,16:38:00,18078.0,SELL,1,0.02h,Stop Loss,$-6.00,$80.25,$65706.25,52,$80.25
2024-03-13,16:44:00,18351.5,BUY,1,0.02h,Stop Loss,$-6.00,$74.25,$65700.25,52,$74.25
2024-03-13,16:45:00,18100.25,SELL,1,0.02h,Break Even,$0.25,$74.50,$65700.50,52,$74.50
2024-03-13,16:47:00,18350.75,BUY,1,0.02h,Break Even,$0.25,$74.75,$65700.75,52,$74.75
2024-03-13,16:57:00,18102.75,SELL,1,0.02h,Stop Loss,$14.00,$88.75,$65714.75,52,$88.75
2024-03-13,17:05:00,18362.75,BUY,1,0.02h,Stop Loss,$22.75,$111.50,$65737.50,52,$111.50
2024-03-13,17:17:00,18104.25,SELL,1,0.02h,Stop Loss,$-6.00,$105.50,$65731.50,52,$105.50
2024-03-13,17:20:00,18359.0,BUY,1,0.02h,Stop Loss,$-6.00,$99.50,$65725.50,52,$99.50
2024-03-13,17:21:00,18111.25,SELL,1,0.02h,Stop Loss,$-6.00,$93.50,$65719.50,52,$93.50
2024-03-13,17:22:00,18363.75,BUY,1,0.02h,Stop Loss,$-6.00,$87.50,$65713.50,52,$87.50
2024-03-13,17:23:00,18116.0,SELL,1,0.02h,Stop Loss,$-6.00,$81.50,$65707.50,52,$81.50
2024-03-13,17:24:00,18365.0,BUY,1,0.02h,Stop Loss,$-6.00,$75.50,$65701.50,52,$75.50
2024-03-13,17:25:00,18117.75,SELL,1,0.02h,Stop Loss,$-6.00,$69.50,$65695.50,52,$69.50
2024-03-13,17:28:00,18378.5,BUY,1,0.02h,Break Even,$0.25,$69.75,$65695.75,52,$69.75
2024-03-13,17:31:00,18142.5,SELL,1,0.02h,Stop Loss,$47.75,$117.50,$65743.50,52,$117.50
2024-03-13,17:35:00,18369.75,BUY,1,0.02h,Stop Loss,$-6.00,$111.50,$65737.50,52,$111.50
2024-03-13,17:36:00,18121.75,SELL,1,0.02h,Stop Loss,$-6.00,$105.50,$65731.50,52,$105.50
2024-03-13,17:37:00,18383.25,BUY,1,0.02h,Stop Loss,$-6.00,$99.50,$65725.50,52,$99.50
2024-03-13,17:38:00,18135.5,SELL,1,0.02h,Stop Loss,$24.00,$123.50,$65749.50,52,$123.50
2024-03-13,17:43:00,18372.25,BUY,1,0.02h,Stop Loss,$-6.00,$117.50,$65743.50,52,$117.50
2024-03-13,17:44:00,18120.25,SELL,1,0.02h,Stop Loss,$-6.00,$111.50,$65737.50,52,$111.50
2024-03-13,17:45:00,18367.25,BUY,1,0.02h,Stop Loss,$40.25,$151.75,$65777.75,52,$151.75
2024-03-13,17:57:00,18135.25,SELL,1,0.02h,Stop Loss,$-6.00,$145.75,$65771.75,52,$145.75
2024-03-13,17:58:00,18390.5,BUY,1,0.02h,Stop Loss,$-6.00,$139.75,$65765.75,52,$139.75
2024-03-13,17:59:00,18141.0,SELL,1,0.02h,Stop Loss,$-6.00,$133.75,$65759.75,52,$133.75
2024-03-13,18:00:00,18388.25,BUY,1,0.02h,Stop Loss,$-6.00,$127.75,$65753.75,52,$127.75
2024-03-13,18:01:00,18136.75,SELL,1,0.02h,Stop Loss,$-6.00,$121.75,$65747.75,52,$121.75
2024-03-13,18:04:00,18384.25,BUY,1,0.02h,Break Even,$0.25,$122.00,$65748.00,52,$122.00
2024-03-13,18:20:00,18123.25,SELL,1,0.02h,Stop Loss,$-6.00,$116.00,$65742.00,52,$116.00
2024-03-13,18:21:00,18380.0,BUY,1,0.02h,Stop Loss,$14.00,$130.00,$65756.00,52,$130.00
2024-03-13,18:24:00,18131.75,SELL,1,0.02h,Break Even,$0.25,$130.25,$65756.25,52,$130.25
2024-03-13,18:36:00,18387.75,BUY,1,0.02h,Break Even,$0.25,$130.50,$65756.50,52,$130.50
2024-03-13,18:49:00,18135.5,SELL,1,0.02h,Stop Loss,$-6.00,$124.50,$65750.50,52,$124.50
2024-03-13,18:54:00,18397.25,BUY,1,0.02h,Stop Loss,$-6.00,$118.50,$65744.50,52,$118.50
2024-03-13,18:57:00,18141.5,SELL,1,0.02h,Stop Loss,$-6.00,$112.50,$65738.50,52,$112.50
2024-03-13,18:58:00,18387.0,BUY,1,0.02h,Stop Loss,$-6.00,$106.50,$65732.50,52,$106.50
2024-03-13,18:59:00,18131.75,SELL,1,0.02h,Stop Loss,$-6.00,$100.50,$65726.50,52,$100.50
2024-03-13,19:01:00,18385.75,BUY,1,0.02h,Stop Loss,$-6.00,$94.50,$65720.50,52,$94.50
2024-03-13,19:02:00,18132.75,SELL,1,0.02h,Stop Loss,$11.50,$106.00,$65732.00,52,$106.00
2024-03-13,19:05:00,18384.0,BUY,1,0.02h,Stop Loss,$-6.00,$100.00,$65726.00,52,$100.00
2024-03-13,19:07:00,18123.5,SELL,1,0.02h,Break Even,$0.25,$100.25,$65726.25,52,$100.25
2024-03-13,19:16:00,18373.5,BUY,1,0.02h,Stop Loss,$-6.00,$94.25,$65720.25,52,$94.25
2024-03-13,19:17:00,18123.25,SELL,1,0.02h,Stop Loss,$-6.00,$88.25,$65714.25,52,$88.25
2024-03-13,19:21:00,18382.5,BUY,1,0.02h,Stop Loss,$-6.00,$82.25,$65708.25,52,$82.25
2024-03-13,19:22:00,18127.75,SELL,1,0.02h,Stop Loss,$-6.00,$76.25,$65702.25,52,$76.25
2024-03-13,19:23:00,18372.5,BUY,1,0.02h,Stop Loss,$-6.00,$70.25,$65696.25,52,$70.25
2024-03-13,19:31:00,18086.25,SELL,1,0.02h,Stop Loss,$49.00,$119.25,$65745.25,52,$119.25
2024-03-13,19:36:00,18321.75,BUY,1,0.02h,Stop Loss,$-6.00,$113.25,$65739.25,52,$113.25
2024-03-13,19:37:00,18072.5,SELL,1,0.02h,Stop Loss,$-6.00,$107.25,$65733.25,52,$107.25
2024-03-13,19:48:00,18344.0,BUY,1,0.02h,Stop Loss,$7.75,$115.00,$65741.00,52,$115.00
2024-03-13,19:51:00,18087.75,SELL,1,0.02h,Stop Loss,$81.50,$196.50,$65822.50,52,$196.50
2024-03-13,20:03:00,18331.5,BUY,1,0.02h,Stop Loss,$-6.00,$190.50,$65816.50,52,$190.50
2024-03-13,20:04:00,18080.25,SELL,1,0.02h,Stop Loss,$-6.00,$184.50,$65810.50,52,$184.50
2024-03-13,20:05:00,18333.25,BUY,1,0.02h,Stop Loss,$7.75,$192.25,$65818.25,52,$192.25
2024-03-13,20:11:00,18091.0,SELL,1,0.02h,Stop Loss,$-6.00,$186.25,$65812.25,52,$186.25
2024-03-13,20:12:00,18341.0,BUY,1,0.02h,Stop Loss,$-6.00,$180.25,$65806.25,52,$180.25
2024-03-13,20:13:00,18092.75,SELL,1,0.02h,Stop Loss,$-6.00,$174.25,$65800.25,52,$174.25
2024-03-13,20:14:00,18346.0,BUY,1,0.02h,Stop Loss,$-6.00,$168.25,$65794.25,52,$168.25
2024-03-13,20:15:00,18094.5,SELL,1,0.02h,Stop Loss,$6.50,$174.75,$65800.75,52,$174.75
2024-03-13,20:22:00,18344.0,BUY,1,0.02h,Stop Loss,$-6.00,$168.75,$65794.75,52,$168.75
2024-03-13,20:23:00,18093.75,SELL,1,0.02h,Stop Loss,$-6.00,$162.75,$65788.75,52,$162.75
2024-03-13,20:24:00,18343.5,BUY,1,0.02h,Break Even,$0.25,$163.00,$65789.00,52,$163.00
2024-03-13,20:34:00,18097.75,SELL,1,0.02h,Break Even,$0.25,$163.25,$65789.25,52,$163.25
2024-03-13,20:36:00,18348.75,BUY,1,0.03h,Stop Loss,$-6.00,$157.25,$65783.25,52,$157.25
2024-03-13,20:39:00,18096.75,SELL,1,0.02h,Break Even,$0.25,$157.50,$65783.50,52,$157.50
2024-03-13,20:41:00,18347.5,BUY,1,0.03h,Stop Loss,$-6.00,$151.50,$65777.50,52,$151.50
2024-03-13,20:43:00,18096.75,SELL,1,0.02h,Stop Loss,$-6.00,$145.50,$65771.50,52,$145.50
2024-03-13,20:53:00,18352.75,BUY,1,0.02h,Break Even,$0.25,$145.75,$65771.75,52,$145.75
2024-03-13,20:58:00,18106.5,SELL,1,0.03h,Break Even,$0.25,$146.00,$65772.00,52,$146.00
2024-03-13,21:00:00,18355.5,BUY,1,1.02h,Stop Loss,$-6.00,$140.00,$65766.00,52,$140.00
2024-03-13,22:01:00,18097.5,SELL,1,0.02h,Stop Loss,$-6.00,$134.00,$65760.00,52,$134.00
2024-03-13,22:11:00,18355.75,BUY,1,0.02h,Stop Loss,$-6.00,$128.00,$65754.00,52,$128.00
2024-03-13,22:13:00,18101.0,SELL,1,0.02h,Stop Loss,$-6.00,$122.00,$65748.00,52,$122.00
2024-03-13,22:16:00,18353.0,BUY,1,0.02h,Stop Loss,$-6.00,$116.00,$65742.00,52,$116.00
2024-03-13,22:20:00,18104.5,SELL,1,0.03h,Break Even,$0.25,$116.25,$65742.25,52,$116.25
2024-03-13,22:22:00,18351.75,BUY,1,0.02h,Stop Loss,$-6.00,$110.25,$65736.25,52,$110.25
2024-03-13,22:31:00,18103.25,SELL,1,0.02h,Break Even,$0.25,$110.50,$65736.50,52,$110.50
2024-03-13,22:40:00,18350.0,BUY,1,0.07h,Break Even,$0.25,$110.75,$65736.75,52,$110.75
2024-03-13,22:46:00,18103.75,SELL,1,0.02h,Stop Loss,$-6.00,$104.75,$65730.75,52,$104.75
2024-03-13,22:50:00,18360.25,BUY,1,0.02h,Stop Loss,$-6.00,$98.75,$65724.75,52,$98.75
2024-03-13,23:00:00,18108.0,SELL,1,13.00h,Stop Loss,$-6.00,$92.75,$65718.75,52,$92.75
Final P&L Day: 92.75,,,,,,,,,,,
2024-03-14,12:00:00,18395.25,BUY,1,0.02h,Stop Loss,$-6.00,$-6.00,$65712.75,53,$-6.00
2024-03-14,12:02:00,18150.75,SELL,1,0.02h,Stop Loss,$-6.00,$-12.00,$65706.75,53,$-12.00
2024-03-14,12:03:00,18405.75,BUY,1,0.02h,Break Even,$0.25,$-11.75,$65707.00,53,$-11.75
2024-03-14,12:17:00,18156.5,SELL,1,0.02h,Stop Loss,$-6.00,$-17.75,$65701.00,53,$-17.75
2024-03-14,12:18:00,18410.25,BUY,1,0.02h,Break Even,$0.25,$-17.50,$65701.25,53,$-17.50
2024-03-14,12:22:00,18155.25,SELL,1,0.02h,Stop Loss,$-6.00,$-23.50,$65695.25,53,$-23.50
2024-03-14,12:24:00,18403.75,BUY,1,0.02h,Stop Loss,$-6.00,$-29.50,$65689.25,53,$-29.50
2024-03-14,12:27:00,18155.25,SELL,1,0.02h,Stop Loss,$-6.00,$-35.50,$65683.25,53,$-35.50
2024-03-14,12:28:00,18404.25,BUY,1,0.02h,Stop Loss,$-6.00,$-41.50,$65677.25,53,$-41.50
2024-03-14,12:29:00,18163.0,SELL,1,0.02h,Stop Loss,$-6.00,$-47.50,$65671.25,53,$-47.50
2024-03-14,12:30:00,18407.25,BUY,1,0.02h,Stop Loss,$-6.00,$-53.50,$65665.25,53,$-53.50
2024-03-14,12:31:00,18128.75,SELL,1,0.02h,Stop Loss,$-6.00,$-59.50,$65659.25,53,$-59.50
2024-03-14,12:33:00,18367.0,BUY,1,0.02h,Stop Loss,$37.75,$-21.75,$65697.00,53,$-21.75
2024-03-14,12:38:00,18115.0,SELL,1,0.02h,Stop Loss,$-6.00,$-27.75,$65691.00,53,$-27.75
2024-03-14,12:49:00,18384.0,BUY,1,0.02h,Break Even,$0.25,$-27.50,$65691.25,53,$-27.50
2024-03-14,12:51:00,18117.5,SELL,1,0.02h,Stop Loss,$27.75,$0.25,$65719.00,53,$0.25
2024-03-14,12:56:00,18369.25,BUY,1,0.02h,Stop Loss,$-6.00,$-5.75,$65713.00,53,$-5.75
2024-03-14,12:57:00,18125.5,SELL,1,0.02h,Stop Loss,$-6.00,$-11.75,$65707.00,53,$-11.75
2024-03-14,12:58:00,18374.0,BUY,1,0.02h,Stop Loss,$-6.00,$-17.75,$65701.00,53,$-17.75
2024-03-14,12:59:00,18119.5,SELL,1,0.02h,Stop Loss,$-6.00,$-23.75,$65695.00,53,$-23.75
2024-03-14,13:00:00,18370.5,BUY,1,0.02h,Stop Loss,$21.50,$-2.25,$65716.50,53,$-2.25
2024-03-14,13:09:00,18107.25,SELL,1,0.02h,Stop Loss,$-6.00,$-8.25,$65710.50,53,$-8.25
2024-03-14,13:10:00,18357.75,BUY,1,0.02h,Break Even,$0.25,$-8.00,$65710.75,53,$-8.00
2024-03-14,13:12:00,18112.25,SELL,1,0.02h,Stop Loss,$20.25,$12.25,$65731.00,53,$12.25
2024-03-14,13:16:00,18361.0,BUY,1,0.02h,Stop Loss,$-6.00,$6.25,$65725.00,53,$6.25
2024-03-14,13:17:00,18113.5,SELL,1,0.02h,Stop Loss,$-6.00,$0.25,$65719.00,53,$0.25
2024-03-14,13:35:00,18374.5,BUY,1,0.02h,Break Even,$0.25,$0.50,$65719.25,53,$0.50
2024-03-14,13:39:00,18142.0,SELL,1,0.02h,Stop Loss,$-6.00,$-5.50,$65713.25,53,$-5.50
2024-03-14,13:40:00,18384.75,BUY,1,0.02h,Stop Loss,$19.00,$13.50,$65732.25,53,$13.50
2024-03-14,13:51:00,18247.75,SELL,1,0.02h,Stop Loss,$19.00,$32.50,$65751.25,53,$32.50
2024-03-14,14:07:00,18257.5,BUY,1,0.02h,Stop Loss,$15.25,$47.75,$65766.50,53,$47.75
2024-03-14,14:13:00,18051.75,SELL,1,0.02h,Stop Loss,$-6.00,$41.75,$65760.50,53,$41.75
2024-03-14,14:14:00,18306.0,BUY,1,0.02h,Stop Loss,$7.75,$49.50,$65768.25,53,$49.50
2024-03-14,14:17:00,18050.25,SELL,1,0.02h,Stop Loss,$-6.00,$43.50,$65762.25,53,$43.50
2024-03-14,14:18:00,18294.75,BUY,1,0.02h,Break Even,$0.25,$43.75,$65762.50,53,$43.75
2024-03-14,14:20:00,18037.25,SELL,1,0.02h,Stop Loss,$17.75,$61.50,$65780.25,53,$61.50
2024-03-14,14:29:00,18293.25,BUY,1,0.02h,Stop Loss,$97.75,$159.25,$65878.00,53,$159.25
2024-03-14,14:31:00,18089.25,SELL,1,0.02h,Stop Loss,$-6.00,$153.25,$65872.00,53,$153.25
2024-03-14,14:32:00,18333.75,BUY,1,0.02h,Stop Loss,$10.25,$163.50,$65882.25,53,$163.50
2024-03-14,14:35:00,18088.75,SELL,1,0.02h,Stop Loss,$-6.00,$157.50,$65876.25,53,$157.50
2024-03-14,14:36:00,18337.75,BUY,1,0.02h,Break Even,$0.25,$157.75,$65876.50,53,$157.75
2024-03-14,14:44:00,18049.75,SELL,1,0.02h,Stop Loss,$24.00,$181.75,$65900.50,53,$181.75
2024-03-14,14:51:00,18295.75,BUY,1,0.02h,Stop Loss,$67.75,$249.50,$65968.25,53,$249.50
2024-03-14,14:53:00,18045.0,SELL,1,0.02h,Stop Loss,$-6.00,$243.50,$65962.25,53,$243.50
2024-03-14,14:54:00,18295.0,BUY,1,0.02h,Stop Loss,$39.00,$282.50,$66001.25,53,$282.50
2024-03-14,14:56:00,18044.5,SELL,1,0.02h,Break Even,$0.25,$282.75,$66001.50,53,$282.75
2024-03-14,15:04:00,18324.0,BUY,1,0.02h,Break Even,$0.25,$283.00,$66001.75,53,$283.00
2024-03-14,15:09:00,18060.25,SELL,1,0.02h,Stop Loss,$-6.00,$277.00,$65995.75,53,$277.00
2024-03-14,15:10:00,18307.25,BUY,1,0.02h,Stop Loss,$95.25,$372.25,$66091.00,53,$372.25
2024-03-14,15:13:00,18082.25,SELL,1,0.02h,Break Even,$0.25,$372.50,$66091.25,53,$372.50
2024-03-14,15:26:00,18277.75,BUY,1,0.02h,Stop Loss,$17.75,$390.25,$66109.00,53,$390.25
2024-03-14,15:30:00,18031.75,SELL,1,0.02h,Stop Loss,$-6.00,$384.25,$66103.00,53,$384.25
2024-03-14,15:31:00,18275.5,BUY,1,0.02h,Break Even,$0.25,$384.50,$66103.25,53,$384.50
2024-03-14,15:33:00,18025.75,SELL,1,0.02h,Break Even,$0.25,$384.75,$66103.50,53,$384.75
2024-03-14,15:41:00,18287.5,BUY,1,0.02h,Stop Loss,$-6.00,$378.75,$66097.50,53,$378.75
2024-03-14,15:42:00,18043.0,SELL,1,0.02h,Stop Loss,$9.00,$387.75,$66106.50,53,$387.75
2024-03-14,15:49:00,18280.25,BUY,1,0.02h,Stop Loss,$6.50,$394.25,$66113.00,53,$394.25
2024-03-14,16:06:00,18022.0,SELL,1,0.02h,Stop Loss,$-6.00,$388.25,$66107.00,53,$388.25
2024-03-14,16:08:00,18251.5,BUY,1,0.02h,Stop Loss,$-6.00,$382.25,$66101.00,53,$382.25
2024-03-14,16:09:00,18003.0,SELL,1,0.02h,Stop Loss,$-6.00,$376.25,$66095.00,53,$376.25
2024-03-14,16:16:00,18252.25,BUY,1,0.02h,Stop Loss,$-6.00,$370.25,$66089.00,53,$370.25
2024-03-14,16:17:00,18006.5,SELL,1,0.02h,Stop Loss,$-6.00,$364.25,$66083.00,53,$364.25
2024-03-14,16:21:00,18254.5,BUY,1,0.02h,Stop Loss,$55.25,$419.50,$66138.25,53,$419.50
2024-03-14,16:32:00,18042.75,SELL,1,0.02h,Stop Loss,$42.75,$462.25,$66181.00,53,$462.25
2024-03-14,16:35:00,18283.5,BUY,1,0.02h,Stop Loss,$-6.00,$456.25,$66175.00,53,$456.25
2024-03-14,16:36:00,18050.75,SELL,1,0.02h,Stop Loss,$-6.00,$450.25,$66169.00,53,$450.25
2024-03-14,16:38:00,18291.25,BUY,1,0.02h,Stop Loss,$-6.00,$444.25,$66163.00,53,$444.25
2024-03-14,16:39:00,18036.75,SELL,1,0.02h,Stop Loss,$-6.00,$438.25,$66157.00,53,$438.25
2024-03-14,16:49:00,18268.75,BUY,1,0.02h,Stop Loss,$-6.00,$432.25,$66151.00,53,$432.25
2024-03-14,16:51:00,18022.0,SELL,1,0.02h,Stop Loss,$-6.00,$426.25,$66145.00,53,$426.25
2024-03-14,16:52:00,18275.25,BUY,1,0.02h,Stop Loss,$-6.00,$420.25,$66139.00,53,$420.25
2024-03-14,16:53:00,18027.5,SELL,1,0.02h,Stop Loss,$-6.00,$414.25,$66133.00,53,$414.25
2024-03-14,16:54:00,18271.5,BUY,1,0.02h,Stop Loss,$-6.00,$408.25,$66127.00,53,$408.25
2024-03-14,16:55:00,18020.75,SELL,1,0.02h,Stop Loss,$25.25,$433.50,$66152.25,53,$433.50
2024-03-14,17:04:00,18250.25,BUY,1,0.02h,Break Even,$0.25,$433.75,$66152.50,53,$433.75
2024-03-14,17:08:00,17998.25,SELL,1,0.02h,Stop Loss,$-6.00,$427.75,$66146.50,53,$427.75
2024-03-14,17:09:00,18241.75,BUY,1,0.02h,Stop Loss,$22.75,$450.50,$66169.25,53,$450.50
2024-03-14,17:12:00,17988.25,SELL,1,0.02h,Stop Loss,$-6.00,$444.50,$66163.25,53,$444.50
2024-03-14,17:13:00,18233.5,BUY,1,0.02h,Stop Loss,$-6.00,$438.50,$66157.25,53,$438.50
2024-03-14,17:14:00,17992.5,SELL,1,0.02h,Stop Loss,$7.75,$446.25,$66165.00,53,$446.25
2024-03-14,17:23:00,18229.5,BUY,1,0.02h,Stop Loss,$-6.00,$440.25,$66159.00,53,$440.25
2024-03-14,17:24:00,17993.25,SELL,1,0.02h,Break Even,$0.25,$440.50,$66159.25,53,$440.50
2024-03-14,17:33:00,18229.25,BUY,1,0.02h,Stop Loss,$-6.00,$434.50,$66153.25,53,$434.50
2024-03-14,17:34:00,17982.5,SELL,1,0.02h,Stop Loss,$-6.00,$428.50,$66147.25,53,$428.50
2024-03-14,17:37:00,18238.75,BUY,1,0.02h,Stop Loss,$-6.00,$422.50,$66141.25,53,$422.50
2024-03-14,17:38:00,18004.25,SELL,1,0.02h,Stop Loss,$-6.00,$416.50,$66135.25,53,$416.50
2024-03-14,17:39:00,18253.5,BUY,1,0.02h,Stop Loss,$-6.00,$410.50,$66129.25,53,$410.50
2024-03-14,17:50:00,18012.25,SELL,1,0.02h,Stop Loss,$4.00,$414.50,$66133.25,53,$414.50
2024-03-14,17:52:00,18267.0,BUY,1,0.02h,Break Even,$0.25,$414.75,$66133.50,53,$414.75
2024-03-14,18:02:00,18064.75,SELL,1,0.02h,Stop Loss,$-6.00,$408.75,$66127.50,53,$408.75
2024-03-14,18:07:00,18314.5,BUY,1,0.02h,Stop Loss,$-6.00,$402.75,$66121.50,53,$402.75
2024-03-14,18:08:00,18063.5,SELL,1,0.02h,Stop Loss,$-6.00,$396.75,$66115.50,53,$396.75
2024-03-14,18:10:00,18322.25,BUY,1,0.02h,Stop Loss,$-6.00,$390.75,$66109.50,53,$390.75
2024-03-14,18:12:00,18074.75,SELL,1,0.02h,Stop Loss,$-6.00,$384.75,$66103.50,53,$384.75
2024-03-14,18:14:00,18321.0,BUY,1,0.02h,Stop Loss,$7.75,$392.50,$66111.25,53,$392.50
2024-03-14,18:29:00,18055.0,SELL,1,0.02h,Stop Loss,$-6.00,$386.50,$66105.25,53,$386.50
2024-03-14,18:30:00,18299.75,BUY,1,0.02h,Stop Loss,$25.25,$411.75,$66130.50,53,$411.75
2024-03-14,18:32:00,18040.5,SELL,1,0.02h,Stop Loss,$-6.00,$405.75,$66124.50,53,$405.75
2024-03-14,18:33:00,18289.0,BUY,1,0.02h,Stop Loss,$-6.00,$399.75,$66118.50,53,$399.75
2024-03-14,18:34:00,18042.0,SELL,1,0.02h,Stop Loss,$-6.00,$393.75,$66112.50,53,$393.75
2024-03-14,18:37:00,18286.5,BUY,1,0.02h,Stop Loss,$-6.00,$387.75,$66106.50,53,$387.75
2024-03-14,18:39:00,18036.75,SELL,1,0.02h,Stop Loss,$19.00,$406.75,$66125.50,53,$406.75
2024-03-14,18:49:00,18306.5,BUY,1,0.02h,Break Even,$0.25,$407.00,$66125.75,53,$407.00
2024-03-14,18:54:00,18022.0,SELL,1,0.02h,Stop Loss,$37.75,$444.75,$66163.50,53,$444.75
2024-03-14,19:08:00,18224.5,BUY,1,0.02h,Stop Loss,$-6.00,$438.75,$66157.50,53,$438.75
2024-03-14,19:09:00,17961.75,SELL,1,0.02h,Stop Loss,$-6.00,$432.75,$66151.50,53,$432.75
2024-03-14,19:10:00,18198.5,BUY,1,0.02h,Stop Loss,$29.00,$461.75,$66180.50,53,$461.75
2024-03-14,19:14:00,17939.0,SELL,1,0.02h,Stop Loss,$-6.00,$455.75,$66174.50,53,$455.75
2024-03-14,19:18:00,18199.0,BUY,1,0.02h,Stop Loss,$-6.00,$449.75,$66168.50,53,$449.75
2024-03-14,19:20:00,17943.5,SELL,1,0.02h,Stop Loss,$-6.00,$443.75,$66162.50,53,$443.75
2024-03-14,19:23:00,18195.5,BUY,1,0.02h,Stop Loss,$-6.00,$437.75,$66156.50,53,$437.75
2024-03-14,19:24:00,17941.25,SELL,1,0.02h,Stop Loss,$9.00,$446.75,$66165.50,53,$446.75
2024-03-14,19:30:00,18192.0,BUY,1,0.02h,Break Even,$0.25,$447.00,$66165.75,53,$447.00
2024-03-14,19:32:00,17935.5,SELL,1,0.02h,Stop Loss,$47.75,$494.75,$66213.50,53,$494.75
2024-03-14,19:41:00,18201.0,BUY,1,0.02h,Stop Loss,$45.25,$540.00,$66258.75,53,$540.00
2024-03-14,19:48:00,17964.0,SELL,1,0.02h,Stop Loss,$-6.00,$534.00,$66252.75,53,$534.00
2024-03-14,19:50:00,18221.0,BUY,1,0.02h,Stop Loss,$57.75,$591.75,$66310.50,53,$591.75
2024-03-14,19:53:00,17998.5,SELL,1,0.02h,Stop Loss,$-6.00,$585.75,$66304.50,53,$585.75
2024-03-14,19:54:00,18246.75,BUY,1,0.02h,Stop Loss,$-6.00,$579.75,$66298.50,53,$579.75
2024-03-14,19:56:00,18009.5,SELL,1,0.02h,Stop Loss,$51.50,$631.25,$66350.00,53,$631.25
2024-03-14,19:58:00,18253.75,BUY,1,0.02h,Stop Loss,$-6.00,$625.25,$66344.00,53,$625.25
2024-03-14,20:00:00,18030.75,SELL,1,0.02h,Stop Loss,$-6.00,$619.25,$66338.00,53,$619.25
2024-03-14,20:01:00,18279.25,BUY,1,0.02h,Stop Loss,$46.50,$665.75,$66384.50,53,$665.75
2024-03-14,20:14:00,18016.75,SELL,1,0.02h,Stop Loss,$17.75,$683.50,$66402.25,53,$683.50
2024-03-14,20:18:00,18260.5,BUY,1,0.02h,Stop Loss,$7.75,$691.25,$66410.00,53,$691.25
2024-03-14,20:26:00,18017.0,SELL,1,0.02h,Stop Loss,$4.00,$695.25,$66414.00,53,$695.25
2024-03-14,20:33:00,18261.5,BUY,1,0.02h,Stop Loss,$-6.00,$689.25,$66408.00,53,$689.25
2024-03-14,20:34:00,18011.75,SELL,1,0.02h,Stop Loss,$-6.00,$683.25,$66402.00,53,$683.25
2024-03-14,20:41:00,18265.0,BUY,1,0.02h,Stop Loss,$-6.00,$677.25,$66396.00,53,$677.25
2024-03-14,20:42:00,18020.25,SELL,1,0.02h,Stop Loss,$-6.00,$671.25,$66390.00,53,$671.25
2024-03-14,20:46:00,18273.25,BUY,1,0.02h,Stop Loss,$-6.00,$665.25,$66384.00,53,$665.25
2024-03-14,20:53:00,18014.25,SELL,1,0.02h,Stop Loss,$-6.00,$659.25,$66378.00,53,$659.25
2024-03-14,21:00:00,18267.0,BUY,1,1.02h,Stop Loss,$-6.00,$653.25,$66372.00,53,$653.25
2024-03-14,22:01:00,18002.25,SELL,1,0.02h,Stop Loss,$-6.00,$647.25,$66366.00,53,$647.25
2024-03-14,22:05:00,18253.0,BUY,1,0.02h,Stop Loss,$-6.00,$641.25,$66360.00,53,$641.25
2024-03-14,22:09:00,18009.25,SELL,1,0.02h,Stop Loss,$-6.00,$635.25,$66354.00,53,$635.25
2024-03-14,22:17:00,18254.0,BUY,1,0.02h,Stop Loss,$-6.00,$629.25,$66348.00,53,$629.25
2024-03-14,22:18:00,18006.25,SELL,1,0.02h,Stop Loss,$4.00,$633.25,$66352.00,53,$633.25
2024-03-14,22:22:00,18251.75,BUY,1,0.02h,Stop Loss,$-6.00,$627.25,$66346.00,53,$627.25
2024-03-14,22:28:00,18006.75,SELL,1,0.02h,Stop Loss,$-6.00,$621.25,$66340.00,53,$621.25
2024-03-14,22:29:00,18259.0,BUY,1,0.02h,Break Even,$0.25,$621.50,$66340.25,53,$621.50
2024-03-14,22:32:00,18007.25,SELL,1,0.02h,Stop Loss,$-6.00,$615.50,$66334.25,53,$615.50
2024-03-14,22:38:00,18257.25,BUY,1,0.02h,Break Even,$0.25,$615.75,$66334.50,53,$615.75
2024-03-14,22:41:00,18005.25,SELL,1,0.02h,Stop Loss,$-6.00,$609.75,$66328.50,53,$609.75
2024-03-14,22:42:00,18254.75,BUY,1,0.02h,Stop Loss,$-6.00,$603.75,$66322.50,53,$603.75
2024-03-14,22:43:00,18004.25,SELL,1,0.02h,Break Even,$0.25,$604.00,$66322.75,53,$604.00
2024-03-14,22:52:00,18250.0,BUY,1,0.02h,Break Even,$0.25,$604.25,$66323.00,53,$604.25
2024-03-14,23:00:00,18001.75,SELL,1,13.00h,Stop Loss,$-6.00,$598.25,$66317.00,53,$598.25
Final P&L Day: 598.25,,,,,,,,,,,
2024-03-15,12:02:00,18272.5,BUY,1,0.02h,Stop Loss,$-6.00,$-6.00,$66311.00,54,$-6.00
2024-03-15,12:03:00,18029.75,SELL,1,0.02h,Stop Loss,$-6.00,$-12.00,$66305.00,54,$-12.00
2024-03-15,12:04:00,18276.75,BUY,1,0.02h,Stop Loss,$-6.00,$-18.00,$66299.00,54,$-18.00
2024-03-15,12:17:00,18006.5,SELL,1,0.02h,Stop Loss,$-6.00,$-24.00,$66293.00,54,$-24.00
2024-03-15,12:22:00,18256.25,BUY,1,0.02h,Stop Loss,$-6.00,$-30.00,$66287.00,54,$-30.00
2024-03-15,12:23:00,18008.0,SELL,1,0.02h,Stop Loss,$-6.00,$-36.00,$66281.00,54,$-36.00
2024-03-15,12:24:00,18250.75,BUY,1,0.02h,Stop Loss,$5.25,$-30.75,$66286.25,54,$-30.75
2024-03-15,12:26:00,18009.0,SELL,1,0.02h,Stop Loss,$-6.00,$-36.75,$66280.25,54,$-36.75
2024-03-15,12:39:00,18259.0,BUY,1,0.02h,Break Even,$0.25,$-36.50,$66280.50,54,$-36.50
2024-03-15,12:45:00,18000.25,SELL,1,0.02h,Stop Loss,$51.50,$15.00,$66332.00,54,$15.00
2024-03-15,12:51:00,18251.25,BUY,1,0.02h,Stop Loss,$-6.00,$9.00,$66326.00,54,$9.00
2024-03-15,12:53:00,18004.75,SELL,1,0.02h,Stop Loss,$-6.00,$3.00,$66320.00,54,$3.00
2024-03-15,12:56:00,18258.25,BUY,1,0.02h,Stop Loss,$5.25,$8.25,$66325.25,54,$8.25
2024-03-15,13:02:00,17998.0,SELL,1,0.02h,Stop Loss,$11.50,$19.75,$66336.75,54,$19.75
2024-03-15,13:04:00,18240.75,BUY,1,0.02h,Stop Loss,$-6.00,$13.75,$66330.75,54,$13.75
2024-03-15,13:05:00,18000.0,SELL,1,0.02h,Stop Loss,$14.00,$27.75,$66344.75,54,$27.75
2024-03-15,13:07:00,18236.25,BUY,1,0.02h,Stop Loss,$-6.00,$21.75,$66338.75,54,$21.75
2024-03-15,13:08:00,17988.75,SELL,1,0.02h,Stop Loss,$-6.00,$15.75,$66332.75,54,$15.75
2024-03-15,13:09:00,18228.5,BUY,1,0.02h,Stop Loss,$21.50,$37.25,$66354.25,54,$37.25
2024-03-15,13:24:00,17952.0,SELL,1,0.02h,Stop Loss,$16.50,$53.75,$66370.75,54,$53.75
2024-03-15,13:34:00,18141.25,BUY,1,0.02h,Stop Loss,$97.75,$151.50,$66468.50,54,$151.50
2024-03-15,13:43:00,18099.25,SELL,1,0.02h,Stop Loss,$30.25,$181.75,$66498.75,54,$181.75
2024-03-15,13:56:00,18127.25,BUY,1,0.02h,Stop Loss,$-6.00,$175.75,$66492.75,54,$175.75
2024-03-15,13:57:00,18098.75,SELL,1,0.02h,Stop Loss,$26.50,$202.25,$66519.25,54,$202.25
2024-03-15,14:16:00,18110.75,BUY,1,0.02h,Break Even,$0.25,$202.50,$66519.50,54,$202.50
2024-03-15,14:59:00,18128.5,SELL,1,0.02h,Stop Loss,$26.50,$229.00,$66546.00,54,$229.00
2024-03-15,16:33:00,18067.75,BUY,1,0.02h,Stop Loss,$-6.00,$223.00,$66540.00,54,$223.00
2024-03-15,16:49:00,18045.0,SELL,1,0.02h,Stop Loss,$24.00,$247.00,$66564.00,54,$247.00
2024-03-15,17:11:00,18035.5,BUY,1,0.02h,Stop Loss,$55.25,$302.25,$66619.25,54,$302.25
2024-03-15,17:49:00,18044.0,SELL,1,0.02h,Stop Loss,$20.25,$322.50,$66639.50,54,$322.50
2024-03-15,17:55:00,18068.5,BUY,1,0.02h,Stop Loss,$44.00,$366.50,$66683.50,54,$366.50
2024-03-15,18:14:00,18059.75,SELL,1,0.02h,Stop Loss,$15.25,$381.75,$66698.75,54,$381.75
2024-03-15,18:34:00,18071.25,BUY,1,0.02h,Break Even,$0.25,$382.00,$66699.00,54,$382.00
2024-03-15,19:10:00,18071.75,SELL,1,0.02h,Stop Loss,$9.00,$391.00,$66708.00,54,$391.00
2024-03-15,19:27:00,18087.5,BUY,1,0.02h,Stop Loss,$36.50,$427.50,$66744.50,54,$427.50
2024-03-15,19:39:00,18068.75,SELL,1,0.02h,Break Even,$0.25,$427.75,$66744.75,54,$427.75
2024-03-15,20:05:00,18069.5,BUY,1,0.02h,Break Even,$0.25,$428.00,$66745.00,54,$428.00
2024-03-15,20:22:00,18066.25,SELL,1,0.02h,Stop Loss,$-6.00,$422.00,$66739.00,54,$422.00
2024-03-15,20:25:00,18073.75,BUY,1,0.03h,Stop Loss,$20.25,$442.25,$66759.25,54,$442.25
2024-03-15,20:38:00,18068.75,SELL,1,0.02h,Break Even,$0.25,$442.50,$66759.50,54,$442.50
Final P&L Day: 442.50,,,,,,,,,,,
2024-03-18,12:00:00,18262.75,BUY,1,0.02h,Stop Loss,$4.00,$4.00,$66763.50,55,$4.00
2024-03-18,12:54:00,18264.0,SELL,1,0.02h,Stop Loss,$-6.00,$-2.00,$66757.50,55,$-2.00
2024-03-18,12:58:00,18275.0,BUY,1,0.02h,Stop Loss,$-6.00,$-8.00,$66751.50,55,$-8.00
2024-03-18,13:24:00,18277.0,SELL,1,0.02h,Stop Loss,$-6.00,$-14.00,$66745.50,55,$-14.00
2024-03-18,13:31:00,18294.75,BUY,1,0.02h,Stop Loss,$87.75,$73.75,$66833.25,55,$73.75
2024-03-18,13:57:00,18314.25,SELL,1,0.02h,Stop Loss,$106.50,$180.25,$66939.75,55,$180.25
2024-03-18,14:09:00,18333.25,BUY,1,0.02h,Break Even,$0.25,$180.50,$66940.00,55,$180.50
2024-03-18,14:52:00,18353.75,SELL,1,0.02h,Break Even,$0.25,$180.75,$66940.25,55,$180.75
2024-03-18,16:11:00,18301.75,BUY,1,0.02h,Break Even,$0.25,$181.00,$66940.50,55,$181.00
2024-03-18,16:27:00,18291.5,SELL,1,0.02h,Break Even,$0.25,$181.25,$66940.75,55,$181.25
2024-03-18,16:45:00,18298.5,BUY,1,0.02h,Stop Loss,$-6.00,$175.25,$66934.75,55,$175.25
2024-03-18,16:50:00,18282.5,SELL,1,0.02h,Stop Loss,$104.00,$279.25,$67038.75,55,$279.25
2024-03-18,17:22:00,18274.0,BUY,1,0.02h,Break Even,$0.25,$279.50,$67039.00,55,$279.50
2024-03-18,17:39:00,18254.25,SELL,1,0.02h,Stop Loss,$11.50,$291.00,$67050.50,55,$291.00
2024-03-18,17:59:00,18274.0,BUY,1,0.02h,Break Even,$0.25,$291.25,$67050.75,55,$291.25
2024-03-18,18:42:00,18278.5,SELL,1,0.02h,Stop Loss,$104.00,$395.25,$67154.75,55,$395.25
2024-03-18,19:08:00,18289.5,BUY,1,0.02h,Stop Loss,$21.50,$416.75,$67176.25,55,$416.75
2024-03-18,19:26:00,18280.0,SELL,1,0.02h,Break Even,$0.25,$417.00,$67176.50,55,$417.00
2024-03-18,19:35:00,18286.75,BUY,1,0.02h,Stop Loss,$-6.00,$411.00,$67170.50,55,$411.00
2024-03-18,19:37:00,18277.75,SELL,1,0.02h,Stop Loss,$7.75,$418.75,$67178.25,55,$418.75
2024-03-18,20:29:00,18232.5,BUY,1,0.02h,Stop Loss,$37.75,$456.50,$67216.00,55,$456.50
2024-03-18,20:40:00,18226.0,SELL,1,0.02h,Break Even,$0.25,$456.75,$67216.25,55,$456.75
Final P&L Day: 456.75,,,,,,,,,,,
2024-03-19,12:38:00,18114.0,BUY,1,0.02h,Stop Loss,$-6.00,$-6.00,$67210.25,56,$-6.00
2024-03-19,13:32:00,18116.5,SELL,1,0.02h,Break Even,$0.25,$-5.75,$67210.50,56,$-5.75
2024-03-19,14:01:00,18099.0,BUY,1,0.02h,Stop Loss,$34.00,$28.25,$67244.50,56,$28.25
2024-03-19,14:18:00,18093.0,SELL,1,0.02h,Stop Loss,$32.75,$61.00,$67277.25,56,$61.00
2024-03-19,14:36:00,18105.75,BUY,1,0.02h,Break Even,$0.25,$61.25,$67277.50,56,$61.25
2024-03-19,15:04:00,18117.0,SELL,1,0.02h,Stop Loss,$-6.00,$55.25,$67271.50,56,$55.25
2024-03-19,15:05:00,18129.0,BUY,1,0.02h,Stop Loss,$47.75,$103.00,$67319.25,56,$103.00
2024-03-19,15:21:00,18118.0,SELL,1,0.02h,Break Even,$0.25,$103.25,$67319.50,56,$103.25
2024-03-19,15:30:00,18131.25,BUY,1,0.02h,Stop Loss,$35.25,$138.50,$67354.75,56,$138.50
2024-03-19,15:55:00,18135.75,SELL,1,0.02h,Break Even,$0.25,$138.75,$67355.00,56,$138.75
2024-03-19,16:00:00,18158.75,BUY,1,0.02h,Break Even,$0.25,$139.00,$67355.25,56,$139.00
2024-03-19,17:16:00,18235.5,SELL,1,0.02h,Break Even,$0.25,$139.25,$67355.50,56,$139.25
2024-03-19,17:28:00,18254.75,BUY,1,0.02h,Break Even,$0.25,$139.50,$67355.75,56,$139.50
2024-03-19,17:55:00,18253.25,SELL,1,0.02h,Stop Loss,$6.50,$146.00,$67362.25,56,$146.00
2024-03-19,18:16:00,18271.0,BUY,1,0.02h,Stop Loss,$17.75,$163.75,$67380.00,56,$163.75
2024-03-19,18:56:00,18255.5,SELL,1,0.02h,Stop Loss,$-6.00,$157.75,$67374.00,56,$157.75
2024-03-19,19:38:00,18241.0,BUY,1,0.02h,Stop Loss,$14.00,$171.75,$67388.00,56,$171.75
2024-03-19,20:21:00,18269.25,SELL,1,0.02h,Break Even,$0.25,$172.00,$67388.25,56,$172.00
2024-03-19,20:35:00,18272.25,BUY,1,0.02h,Break Even,$0.25,$172.25,$67388.50,56,$172.25
2024-03-19,20:56:00,18274.0,SELL,1,0.02h,Break Even,$0.25,$172.50,$67388.75,56,$172.50
2024-03-19,22:22:00,18275.25,BUY,1,0.02h,Stop Loss,$-6.00,$166.50,$67382.75,56,$166.50
2024-03-19,22:32:00,18269.25,SELL,1,0.02h,Stop Loss,$-6.00,$160.50,$67376.75,56,$160.50
2024-03-19,22:47:00,18275.5,BUY,1,0.02h,Stop Loss,$-6.00,$154.50,$67370.75,56,$154.50
Final P&L Day: 154.50,,,,,,,,,,,
2024-03-20,12:19:00,18297.5,SELL,1,0.02h,Break Even,$0.25,$0.25,$67371.00,57,$0.25
2024-03-20,12:29:00,18310.75,BUY,1,0.02h,Stop Loss,$-6.00,$-5.75,$67365.00,57,$-5.75
2024-03-20,12:41:00,18295.5,SELL,1,0.02h,Stop Loss,$46.50,$40.75,$67411.50,57,$40.75
2024-03-20,13:10:00,18302.5,BUY,1,0.02h,Stop Loss,$-6.00,$34.75,$67405.50,57,$34.75
2024-03-20,13:12:00,18293.75,SELL,1,0.02h,Break Even,$0.25,$35.00,$67405.75,57,$35.00
2024-03-20,13:19:00,18302.25,BUY,1,0.02h,Stop Loss,$6.50,$41.50,$67412.25,57,$41.50
2024-03-20,13:38:00,18280.5,SELL,1,0.02h,Break Even,$0.25,$41.75,$67412.50,57,$41.75
2024-03-20,14:24:00,18278.5,BUY,1,0.02h,Stop Loss,$25.25,$67.00,$67437.75,57,$67.00
2024-03-20,14:38:00,18265.0,SELL,1,0.02h,Break Even,$0.25,$67.25,$67438.00,57,$67.25
2024-03-20,15:03:00,18270.75,BUY,1,0.02h,Stop Loss,$6.50,$73.75,$67444.50,57,$73.75
2024-03-20,15:35:00,18278.5,SELL,1,0.02h,Stop Loss,$-6.00,$67.75,$67438.50,57,$67.75
2024-03-20,15:56:00,18279.75,BUY,1,0.02h,Stop Loss,$9.00,$76.75,$67447.50,57,$76.75
2024-03-20,16:09:00,18268.0,SELL,1,0.02h,Break Even,$0.25,$77.00,$67447.75,57,$77.00
2024-03-20,16:26:00,18275.25,BUY,1,0.02h,Stop Loss,$19.00,$96.00,$67466.75,57,$96.00
2024-03-20,16:34:00,18262.75,SELL,1,0.02h,Stop Loss,$-6.00,$90.00,$67460.75,57,$90.00
2024-03-20,16:38:00,18273.75,BUY,1,0.02h,Stop Loss,$16.50,$106.50,$67477.25,57,$106.50
2024-03-20,17:10:00,18277.25,SELL,1,0.02h,Break Even,$0.25,$106.75,$67477.50,57,$106.75
2024-03-20,17:52:00,18269.25,BUY,1,0.02h,Stop Loss,$-6.00,$100.75,$67471.50,57,$100.75
2024-03-20,18:35:00,18297.75,SELL,1,0.02h,Stop Loss,$40.25,$141.00,$67511.75,57,$141.00
2024-03-20,18:40:00,18366.5,BUY,1,0.02h,Stop Loss,$40.25,$181.25,$67552.00,57,$181.25
2024-03-20,19:44:00,18458.75,SELL,1,0.02h,Stop Loss,$34.00,$215.25,$67586.00,57,$215.25
2024-03-20,19:58:00,18474.25,BUY,1,0.02h,Stop Loss,$15.25,$230.50,$67601.25,57,$230.50
2024-03-20,22:01:00,18532.0,SELL,1,0.02h,Stop Loss,$10.25,$240.75,$67611.50,57,$240.75
2024-03-20,22:08:00,18543.25,BUY,1,0.02h,Break Even,$0.25,$241.00,$67611.75,57,$241.00
2024-03-20,22:25:00,18536.75,SELL,1,0.02h,Stop Loss,$-6.00,$235.00,$67605.75,57,$235.00
2024-03-20,22:38:00,18545.75,BUY,1,0.02h,Stop Loss,$-6.00,$229.00,$67599.75,57,$229.00
Final P&L Day: 229.00,,,,,,,,,,,
2024-03-21,12:39:00,18647.25,SELL,1,0.02h,Stop Loss,$-6.00,$-6.00,$67593.75,58,$-6.00
2024-03-21,12:41:00,18657.0,BUY,1,0.02h,Break Even,$0.25,$-5.75,$67594.00,58,$-5.75
2024-03-21,12:45:00,18651.25,SELL,1,0.02h,Stop Loss,$-6.00,$-11.75,$67588.00,58,$-11.75
2024-03-21,12:49:00,18654.75,BUY,1,0.02h,Stop Loss,$9.00,$-2.75,$67597.00,58,$-2.75
2024-03-21,13:05:00,18653.25,SELL,1,0.02h,Stop Loss,$-6.00,$-8.75,$67591.00,58,$-8.75
2024-03-21,13:20:00,18657.0,BUY,1,0.02h,Break Even,$0.25,$-8.50,$67591.25,58,$-8.50
2024-03-21,13:49:00,18644.75,SELL,1,0.02h,Stop Loss,$19.00,$10.50,$67610.25,58,$10.50
2024-03-21,14:11:00,18653.75,BUY,1,0.02h,Stop Loss,$4.00,$14.50,$67614.25,58,$14.50
2024-03-21,14:18:00,18643.75,SELL,1,0.02h,Break Even,$0.25,$14.75,$67614.50,58,$14.75
2024-03-21,14:20:00,18661.75,BUY,1,0.02h,Stop Loss,$12.75,$27.50,$67627.25,58,$27.50
2024-03-21,14:32:00,18637.5,SELL,1,0.02h,Stop Loss,$26.50,$54.00,$67653.75,58,$54.00
2024-03-21,14:49:00,18664.5,BUY,1,0.02h,Stop Loss,$7.75,$61.75,$67661.50,58,$61.75
2024-03-21,15:00:00,18643.5,SELL,1,0.02h,Stop Loss,$-6.00,$55.75,$67655.50,58,$55.75
2024-03-21,15:02:00,18661.75,BUY,1,0.02h,Break Even,$0.25,$56.00,$67655.75,58,$56.00
2024-03-21,15:04:00,18641.0,SELL,1,0.02h,Stop Loss,$7.75,$63.75,$67663.50,58,$63.75
2024-03-21,15:22:00,18648.75,BUY,1,0.02h,Stop Loss,$27.75,$91.50,$67691.25,58,$91.50
2024-03-21,16:38:00,18688.5,SELL,1,0.02h,Break Even,$0.25,$91.75,$67691.50,58,$91.75
2024-03-21,16:57:00,18695.0,BUY,1,0.02h,Stop Loss,$-6.00,$85.75,$67685.50,58,$85.75
2024-03-21,17:00:00,18689.0,SELL,1,0.02h,Stop Loss,$4.00,$89.75,$67689.50,58,$89.75
2024-03-21,18:27:00,18616.0,BUY,1,0.02h,Break Even,$0.25,$90.00,$67689.75,58,$90.00
2024-03-21,18:35:00,18594.5,SELL,1,0.02h,Stop Loss,$95.25,$185.25,$67785.00,58,$185.25
2024-03-21,19:11:00,18585.0,BUY,1,0.02h,Stop Loss,$10.25,$195.50,$67795.25,58,$195.50
2024-03-21,19:27:00,18579.25,SELL,1,0.02h,Stop Loss,$6.50,$202.00,$67801.75,58,$202.00
2024-03-21,19:30:00,18586.5,BUY,1,0.02h,Stop Loss,$27.75,$229.75,$67829.50,58,$229.75
2024-03-21,19:35:00,18578.5,SELL,1,0.02h,Stop Loss,$20.25,$250.00,$67849.75,58,$250.00
2024-03-21,19:45:00,18590.5,BUY,1,0.02h,Break Even,$0.25,$250.25,$67850.00,58,$250.25
2024-03-21,19:48:00,18578.75,SELL,1,0.02h,Stop Loss,$37.75,$288.00,$67887.75,58,$288.00
2024-03-21,20:14:00,18576.5,BUY,1,0.02h,Stop Loss,$-6.00,$282.00,$67881.75,58,$282.00
2024-03-21,20:37:00,18575.25,SELL,1,0.02h,Break Even,$0.25,$282.25,$67882.00,58,$282.25
2024-03-21,20:58:00,18580.25,BUY,1,0.02h,Stop Loss,$-6.00,$276.25,$67876.00,58,$276.25
2024-03-21,22:10:00,18570.0,SELL,1,0.02h,Stop Loss,$-6.00,$270.25,$67870.00,58,$270.25
2024-03-21,22:34:00,18579.25,BUY,1,0.03h,Break Even,$0.25,$270.50,$67870.25,58,$270.50
Final P&L Day: 270.50,,,,,,,,,,,
2024-03-22,12:00:00,18510.5,SELL,1,0.02h,Break Even,$0.25,$0.25,$67870.50,59,$0.25
2024-03-22,12:44:00,18519.5,BUY,1,0.02h,Stop Loss,$7.75,$8.00,$67878.25,59,$8.00
2024-03-22,13:23:00,18525.0,SELL,1,0.02h,Stop Loss,$-6.00,$2.00,$67872.25,59,$2.00
2024-03-22,13:32:00,18544.0,BUY,1,0.02h,Stop Loss,$-6.00,$-4.00,$67866.25,59,$-4.00
2024-03-22,13:33:00,18528.0,SELL,1,0.02h,Stop Loss,$39.00,$35.00,$67905.25,59,$35.00
2024-03-22,13:55:00,18538.0,BUY,1,0.02h,Stop Loss,$10.25,$45.25,$67915.50,59,$45.25
2024-03-22,14:16:00,18529.25,SELL,1,0.02h,Stop Loss,$-6.00,$39.25,$67909.50,59,$39.25
2024-03-22,14:21:00,18544.5,BUY,1,0.02h,Stop Loss,$-6.00,$33.25,$67903.50,59,$33.25
2024-03-22,14:23:00,18525.75,SELL,1,0.02h,Stop Loss,$10.25,$43.50,$67913.75,59,$43.50
2024-03-22,15:03:00,18532.0,BUY,1,0.02h,Stop Loss,$19.00,$62.50,$67932.75,59,$62.50
2024-03-22,15:43:00,18543.25,SELL,1,0.02h,Stop Loss,$-6.00,$56.50,$67926.75,59,$56.50
2024-03-22,15:51:00,18553.5,BUY,1,0.02h,Break Even,$0.25,$56.75,$67927.00,59,$56.75
2024-03-22,16:09:00,18546.0,SELL,1,0.02h,Stop Loss,$-6.00,$50.75,$67921.00,59,$50.75
2024-03-22,16:12:00,18555.5,BUY,1,0.02h,Stop Loss,$-6.00,$44.75,$67915.00,59,$44.75
2024-03-22,16:13:00,18549.75,SELL,1,0.02h,Stop Loss,$10.25,$55.00,$67925.25,59,$55.00
2024-03-22,16:27:00,18553.0,BUY,1,0.02h,Stop Loss,$-6.00,$49.00,$67919.25,59,$49.00
2024-03-22,16:35:00,18536.0,SELL,1,0.02h,Break Even,$0.25,$49.25,$67919.50,59,$49.25
2024-03-22,16:44:00,18553.0,BUY,1,0.02h,Break Even,$0.25,$49.50,$67919.75,59,$49.50
2024-03-22,17:42:00,18591.5,SELL,1,0.02h,Stop Loss,$-6.00,$43.50,$67913.75,59,$43.50
2024-03-22,17:45:00,18602.75,BUY,1,0.02h,Break Even,$0.25,$43.75,$67914.00,59,$43.75
2024-03-22,18:12:00,18612.0,SELL,1,0.02h,Stop Loss,$-6.00,$37.75,$67908.00,59,$37.75
2024-03-22,18:30:00,18609.5,BUY,1,0.02h,Break Even,$0.25,$38.00,$67908.25,59,$38.00
2024-03-22,18:34:00,18599.0,SELL,1,0.02h,Stop Loss,$-6.00,$32.00,$67902.25,59,$32.00
2024-03-22,18:35:00,18606.75,BUY,1,0.02h,Break Even,$0.25,$32.25,$67902.50,59,$32.25
2024-03-22,18:42:00,18597.75,SELL,1,0.02h,Stop Loss,$-6.00,$26.25,$67896.50,59,$26.25
2024-03-22,19:37:00,18580.5,BUY,1,0.02h,Break Even,$0.25,$26.50,$67896.75,59,$26.50
2024-03-22,20:01:00,18569.25,SELL,1,0.02h,Stop Loss,$9.00,$35.50,$67905.75,59,$35.50
2024-03-22,20:48:00,18562.75,BUY,1,0.03h,Break Even,$0.25,$35.75,$67906.00,59,$35.75
Final P&L Day: 35.75,,,,,,,,,,,
2024-03-25,12:00:00,18470.25,SELL,1,0.02h,Stop Loss,$22.75,$22.75,$67928.75,60,$22.75
2024-03-25,12:48:00,18482.5,BUY,1,0.02h,Break Even,$0.25,$23.00,$67929.00,60,$23.00
2024-03-25,12:55:00,18479.0,SELL,1,0.02h,Break Even,$0.25,$23.25,$67929.25,60,$23.25
2024-03-25,13:18:00,18477.75,BUY,1,0.02h,Break Even,$0.25,$23.50,$67929.50,60,$23.50
2024-03-25,13:22:00,18474.0,SELL,1,0.02h,Stop Loss,$17.75,$41.25,$67947.25,60,$41.25
2024-03-25,13:52:00,18480.25,BUY,1,0.02h,Stop Loss,$6.50,$47.75,$67953.75,60,$47.75
2024-03-25,14:47:00,18511.25,SELL,1,0.02h,Stop Loss,$21.50,$69.25,$67975.25,60,$69.25
2024-03-25,14:59:00,18519.75,BUY,1,0.02h,Break Even,$0.25,$69.50,$67975.50,60,$69.50
2024-03-25,15:26:00,18520.0,SELL,1,0.02h,Stop Loss,$11.50,$81.00,$67987.00,60,$81.00
2024-03-25,15:38:00,18531.0,BUY,1,0.02h,Stop Loss,$10.25,$91.25,$67997.25,60,$91.25
2024-03-25,16:03:00,18530.75,SELL,1,0.02h,Stop Loss,$24.00,$115.25,$68021.25,60,$115.25
2024-03-25,16:22:00,18533.5,BUY,1,0.02h,Stop Loss,$-6.00,$109.25,$68015.25,60,$109.25
2024-03-25,16:23:00,18527.25,SELL,1,0.02h,Break Even,$0.25,$109.50,$68015.50,60,$109.50
2024-03-25,16:47:00,18528.25,BUY,1,0.02h,Break Even,$0.25,$109.75,$68015.75,60,$109.75
2024-03-25,16:51:00,18519.5,SELL,1,0.02h,Break Even,$0.25,$110.00,$68016.00,60,$110.00
2024-03-25,16:52:00,18526.0,BUY,1,0.02h,Stop Loss,$11.50,$121.50,$68027.50,60,$121.50
2024-03-25,17:09:00,18524.75,SELL,1,0.02h,Stop Loss,$-6.00,$115.50,$68021.50,60,$115.50
2024-03-25,17:15:00,18534.0,BUY,1,0.02h,Break Even,$0.25,$115.75,$68021.75,60,$115.75
2024-03-25,18:30:00,18558.75,SELL,1,0.02h,Break Even,$0.25,$116.00,$68022.00,60,$116.00
2024-03-25,18:41:00,18560.25,BUY,1,0.02h,Break Even,$0.25,$116.25,$68022.25,60,$116.25
2024-03-25,19:04:00,18558.0,SELL,1,0.02h,Stop Loss,$4.00,$120.25,$68026.25,60,$120.25
2024-03-25,19:41:00,18544.25,BUY,1,0.02h,Stop Loss,$14.00,$134.25,$68040.25,60,$134.25
2024-03-25,19:52:00,18531.25,SELL,1,0.02h,Stop Loss,$16.50,$150.75,$68056.75,60,$150.75
2024-03-25,20:25:00,18520.25,BUY,1,0.05h,Stop Loss,$-6.00,$144.75,$68050.75,60,$144.75
2024-03-25,22:33:00,18535.0,SELL,1,0.02h,Break Even,$0.25,$145.00,$68051.00,60,$145.00
Final P&L Day: 145.00,,,,,,,,,,,
2024-03-26,12:00:00,18614.0,BUY,1,0.02h,Break Even,$0.25,$0.25,$68051.25,61,$0.25
2024-03-26,12:35:00,18588.25,SELL,1,0.02h,Stop Loss,$34.00,$34.25,$68085.25,61,$34.25
2024-03-26,13:29:00,18569.25,BUY,1,0.02h,Break Even,$0.25,$34.50,$68085.50,61,$34.50
2024-03-26,14:25:00,18587.75,SELL,1,0.02h,Stop Loss,$31.50,$66.00,$68117.00,61,$66.00
2024-03-26,14:59:00,18558.5,BUY,1,0.02h,Stop Loss,$16.50,$82.50,$68133.50,61,$82.50
2024-03-26,15:41:00,18560.5,SELL,1,0.02h,Stop Loss,$-6.00,$76.50,$68127.50,61,$76.50
2024-03-26,15:53:00,18576.5,BUY,1,0.02h,Stop Loss,$-6.00,$70.50,$68121.50,61,$70.50
2024-03-26,16:14:00,18572.5,SELL,1,0.02h,Break Even,$0.25,$70.75,$68121.75,61,$70.75
2024-03-26,17:09:00,18549.75,BUY,1,0.02h,Break Even,$0.25,$71.00,$68122.00,61,$71.00
2024-03-26,17:21:00,18545.25,SELL,1,0.02h,Break Even,$0.25,$71.25,$68122.25,61,$71.25
2024-03-26,17:31:00,18552.25,BUY,1,0.02h,Break Even,$0.25,$71.50,$68122.50,61,$71.50
2024-03-26,17:45:00,18541.25,SELL,1,0.02h,Stop Loss,$35.25,$106.75,$68157.75,61,$106.75
2024-03-26,18:03:00,18548.0,BUY,1,0.02h,Stop Loss,$-6.00,$100.75,$68151.75,61,$100.75
2024-03-26,18:42:00,18548.25,SELL,1,0.02h,Stop Loss,$12.75,$113.50,$68164.50,61,$113.50
2024-03-26,18:57:00,18556.25,BUY,1,0.02h,Break Even,$0.25,$113.75,$68164.75,61,$113.75
2024-03-26,19:04:00,18546.25,SELL,1,0.02h,Break Even,$0.25,$114.00,$68165.00,61,$114.00
2024-03-26,20:14:00,18470.5,BUY,1,0.02h,Break Even,$0.25,$114.25,$68165.25,61,$114.25
2024-03-26,20:53:00,18477.25,SELL,1,0.02h,Break Even,$0.25,$114.50,$68165.50,61,$114.50
2024-03-26,20:57:00,18481.75,BUY,1,0.02h,Stop Loss,$-6.00,$108.50,$68159.50,61,$108.50
2024-03-26,22:01:00,18474.75,SELL,1,0.02h,Break Even,$0.25,$108.75,$68159.75,61,$108.75
2024-03-26,22:19:00,18477.5,BUY,1,0.02h,Stop Loss,$-6.00,$102.75,$68153.75,61,$102.75
2024-03-26,22:21:00,18476.5,SELL,1,0.02h,Break Even,$0.25,$103.00,$68154.00,61,$103.00
2024-03-26,22:53:00,18476.5,BUY,1,0.02h,Break Even,$0.25,$103.25,$68154.25,61,$103.25
Final P&L Day: 103.25,,,,,,,,,,,
2024-03-27,13:33:00,18536.25,SELL,1,0.02h,Stop Loss,$64.00,$64.00,$68218.25,62,$64.00
2024-03-27,14:35:00,18432.25,BUY,1,0.02h,Stop Loss,$-6.00,$58.00,$68212.25,62,$58.00
2024-03-27,14:49:00,18422.0,SELL,1,0.02h,Stop Loss,$75.25,$133.25,$68287.50,62,$133.25
2024-03-27,15:18:00,18428.0,BUY,1,0.02h,Break Even,$0.25,$133.50,$68287.75,62,$133.50
2024-03-27,15:25:00,18411.5,SELL,1,0.02h,Stop Loss,$4.00,$137.50,$68291.75,62,$137.50
2024-03-27,15:42:00,18421.0,BUY,1,0.02h,Stop Loss,$5.25,$142.75,$68297.00,62,$142.75
2024-03-27,15:54:00,18410.0,SELL,1,0.02h,Stop Loss,$4.00,$146.75,$68301.00,62,$146.75
2024-03-27,16:07:00,18418.75,BUY,1,0.02h,Break Even,$0.25,$147.00,$68301.25,62,$147.00
2024-03-27,16:13:00,18404.75,SELL,1,0.02h,Stop Loss,$-6.00,$141.00,$68295.25,62,$141.00
2024-03-27,16:18:00,18417.0,BUY,1,0.02h,Stop Loss,$16.50,$157.50,$68311.75,62,$157.50
2024-03-27,17:05:00,18433.25,SELL,1,0.02h,Stop Loss,$15.25,$172.75,$68327.00,62,$172.75
2024-03-27,17:22:00,18432.0,BUY,1,0.02h,Stop Loss,$20.25,$193.00,$68347.25,62,$193.00
2024-03-27,17:29:00,18422.5,SELL,1,0.02h,Stop Loss,$-6.00,$187.00,$68341.25,62,$187.00
2024-03-27,17:32:00,18433.25,BUY,1,0.02h,Break Even,$0.25,$187.25,$68341.50,62,$187.25
2024-03-27,17:36:00,18423.75,SELL,1,0.02h,Stop Loss,$-6.00,$181.25,$68335.50,62,$181.25
2024-03-27,17:38:00,18430.75,BUY,1,0.02h,Break Even,$0.25,$181.50,$68335.75,62,$181.50
2024-03-27,17:40:00,18424.75,SELL,1,0.02h,Break Even,$0.25,$181.75,$68336.00,62,$181.75
2024-03-27,17:46:00,18431.25,BUY,1,0.02h,Break Even,$0.25,$182.00,$68336.25,62,$182.00
2024-03-27,18:01:00,18428.0,SELL,1,0.02h,Stop Loss,$-6.00,$176.00,$68330.25,62,$176.00
2024-03-27,18:02:00,18434.25,BUY,1,0.02h,Stop Loss,$-6.00,$170.00,$68324.25,62,$170.00
2024-03-27,18:03:00,18427.25,SELL,1,0.02h,Break Even,$0.25,$170.25,$68324.50,62,$170.25
2024-03-27,18:17:00,18435.5,BUY,1,0.02h,Stop Loss,$31.50,$201.75,$68356.00,62,$201.75
2024-03-27,18:38:00,18434.75,SELL,1,0.02h,Break Even,$0.25,$202.00,$68356.25,62,$202.00
2024-03-27,19:08:00,18431.5,BUY,1,0.02h,Break Even,$0.25,$202.25,$68356.50,62,$202.25
2024-03-27,19:10:00,18420.75,SELL,1,0.02h,Stop Loss,$61.50,$263.75,$68418.00,62,$263.75
2024-03-27,19:28:00,18424.75,BUY,1,0.02h,Stop Loss,$81.50,$345.25,$68499.50,62,$345.25
2024-03-27,20:37:00,18513.0,SELL,1,0.07h,Break Even,$0.25,$345.50,$68499.75,62,$345.50
2024-03-27,22:34:00,18491.0,BUY,1,0.02h,Stop Loss,$-6.00,$339.50,$68493.75,62,$339.50
2024-03-27,22:39:00,18485.75,SELL,1,0.02h,Break Even,$0.25,$339.75,$68494.00,62,$339.75
Final P&L Day: 339.75,,,,,,,,,,,
2024-03-28,12:01:00,18493.75,BUY,1,0.02h,Stop Loss,$9.00,$9.00,$68503.00,63,$9.00
2024-03-28,12:37:00,18485.0,SELL,1,0.02h,Stop Loss,$-6.00,$3.00,$68497.00,63,$3.00
2024-03-28,12:58:00,18499.25,BUY,1,0.02h,Break Even,$0.25,$3.25,$68497.25,63,$3.25
2024-03-28,13:30:00,18500.0,SELL,1,0.02h,Stop Loss,$81.50,$84.75,$68578.75,63,$84.75
2024-03-28,13:42:00,18501.75,BUY,1,0.02h,Stop Loss,$20.25,$105.00,$68599.00,63,$105.00
2024-03-28,14:09:00,18505.0,SELL,1,0.02h,Stop Loss,$16.50,$121.50,$68615.50,63,$121.50
2024-03-28,14:36:00,18506.25,BUY,1,0.02h,Stop Loss,$27.75,$149.25,$68643.25,63,$149.25
2024-03-28,15:04:00,18498.75,SELL,1,0.02h,Stop Loss,$-6.00,$143.25,$68637.25,63,$143.25
2024-03-28,15:06:00,18514.0,BUY,1,0.02h,Break Even,$0.25,$143.50,$68637.50,63,$143.50
2024-03-28,15:08:00,18494.25,SELL,1,0.02h,Stop Loss,$4.00,$147.50,$68641.50,63,$147.50
2024-03-28,15:19:00,18503.25,BUY,1,0.02h,Stop Loss,$15.25,$162.75,$68656.75,63,$162.75
2024-03-28,15:37:00,18500.25,SELL,1,0.02h,Stop Loss,$-6.00,$156.75,$68650.75,63,$156.75
2024-03-28,15:51:00,18508.0,BUY,1,0.02h,Stop Loss,$4.00,$160.75,$68654.75,63,$160.75
2024-03-28,16:06:00,18496.75,SELL,1,0.02h,Stop Loss,$67.75,$228.50,$68722.50,63,$228.50
2024-03-28,17:39:00,18470.75,BUY,1,0.02h,Stop Loss,$4.00,$232.50,$68726.50,63,$232.50
2024-03-28,18:01:00,18467.0,SELL,1,0.02h,Stop Loss,$80.25,$312.75,$68806.75,63,$312.75
2024-03-28,18:09:00,18474.0,BUY,1,0.02h,Stop Loss,$-6.00,$306.75,$68800.75,63,$306.75
2024-03-28,18:24:00,18467.5,SELL,1,0.02h,Break Even,$0.25,$307.00,$68801.00,63,$307.00
2024-03-28,18:29:00,18472.75,BUY,1,0.02h,Break Even,$0.25,$307.25,$68801.25,63,$307.25
2024-03-28,18:38:00,18468.0,SELL,1,0.02h,Break Even,$0.25,$307.50,$68801.50,63,$307.50
2024-03-28,18:51:00,18471.25,BUY,1,0.02h,Break Even,$0.25,$307.75,$68801.75,63,$307.75
2024-03-28,19:37:00,18494.5,SELL,1,0.02h,Stop Loss,$14.00,$321.75,$68815.75,63,$321.75
2024-03-28,20:58:00,18461.25,BUY,1,0.02h,Break Even,$0.25,$322.00,$68816.00,63,$322.00
Final P&L Day: 322.00,,,,,,,,,,,
2024-04-01,12:34:00,18503.25,SELL,1,0.02h,Stop Loss,$36.50,$36.50,$68852.50,64,$36.50
2024-04-01,12:38:00,18509.0,BUY,1,0.02h,Stop Loss,$-6.00,$30.50,$68846.50,64,$30.50
2024-04-01,13:02:00,18506.25,SELL,1,0.02h,Stop Loss,$-6.00,$24.50,$68840.50,64,$24.50
2024-04-01,13:33:00,18515.5,BUY,1,0.02h,Stop Loss,$104.00,$128.50,$68944.50,64,$128.50
2024-04-01,14:05:00,18550.75,SELL,1,0.02h,Stop Loss,$5.25,$133.75,$68949.75,64,$133.75
2024-04-01,14:14:00,18584.75,BUY,1,0.02h,Break Even,$0.25,$134.00,$68950.00,64,$134.00
2024-04-01,14:17:00,18574.5,SELL,1,0.02h,Stop Loss,$34.00,$168.00,$68984.00,64,$168.00
2024-04-01,15:30:00,18470.75,BUY,1,0.02h,Stop Loss,$-6.00,$162.00,$68978.00,64,$162.00
2024-04-01,15:40:00,18453.5,SELL,1,0.02h,Break Even,$0.25,$162.25,$68978.25,64,$162.25
2024-04-01,15:50:00,18468.5,BUY,1,0.02h,Stop Loss,$-6.00,$156.25,$68972.25,64,$156.25
2024-04-01,15:52:00,18448.5,SELL,1,0.02h,Stop Loss,$25.25,$181.50,$68997.50,64,$181.50
2024-04-01,16:07:00,18455.25,BUY,1,0.02h,Stop Loss,$19.00,$200.50,$69016.50,64,$200.50
2024-04-01,16:58:00,18478.0,SELL,1,0.02h,Stop Loss,$14.00,$214.50,$69030.50,64,$214.50
2024-04-01,17:39:00,18452.5,BUY,1,0.02h,Stop Loss,$-6.00,$208.50,$69024.50,64,$208.50
2024-04-01,18:13:00,18454.0,SELL,1,0.02h,Break Even,$0.25,$208.75,$69024.75,64,$208.75
2024-04-01,18:19:00,18463.0,BUY,1,0.02h,Break Even,$0.25,$209.00,$69025.00,64,$209.00
2024-04-01,18:58:00,18468.5,SELL,1,0.02h,Stop Loss,$12.75,$221.75,$69037.75,64,$221.75
2024-04-01,19:07:00,18482.5,BUY,1,0.02h,Break Even,$0.25,$222.00,$69038.00,64,$222.00
2024-04-01,19:27:00,18468.25,SELL,1,0.02h,Break Even,$0.25,$222.25,$69038.25,64,$222.25
2024-04-01,19:34:00,18479.0,BUY,1,0.02h,Break Even,$0.25,$222.50,$69038.50,64,$222.50
2024-04-01,19:36:00,18464.75,SELL,1,0.02h,Stop Loss,$19.00,$241.50,$69057.50,64,$241.50
2024-04-01,19:44:00,18478.5,BUY,1,0.02h,Break Even,$0.25,$241.75,$69057.75,64,$241.75
2024-04-01,20:28:00,18494.75,SELL,1,0.02h,Stop Loss,$-6.00,$235.75,$69051.75,64,$235.75
2024-04-01,20:39:00,18496.75,BUY,1,0.02h,Stop Loss,$-6.00,$229.75,$69045.75,64,$229.75
2024-04-01,22:01:00,18491.5,SELL,1,0.02h,Stop Loss,$21.50,$251.25,$69067.25,64,$251.25
2024-04-01,22:44:00,18483.0,BUY,1,0.02h,Stop Loss,$-6.00,$245.25,$69061.25,64,$245.25
2024-04-01,22:53:00,18478.5,SELL,1,0.02h,Stop Loss,$-6.00,$239.25,$69055.25,64,$239.25
Final P&L Day: 239.25,,,,,,,,,,,
2024-04-02,12:33:00,18410.0,BUY,1,0.02h,Stop Loss,$-6.00,$-6.00,$69049.25,65,$-6.00
2024-04-02,12:34:00,18400.75,SELL,1,0.02h,Stop Loss,$9.00,$3.00,$69058.25,65,$3.00
2024-04-02,14:04:00,18266.0,BUY,1,0.02h,Stop Loss,$32.75,$35.75,$69091.00,65,$35.75
2024-04-02,14:09:00,18243.75,SELL,1,0.02h,Stop Loss,$6.50,$42.25,$69097.50,65,$42.25
2024-04-02,14:26:00,18245.5,BUY,1,0.02h,Break Even,$0.25,$42.50,$69097.75,65,$42.50
2024-04-02,14:49:00,18225.5,SELL,1,0.02h,Stop Loss,$20.25,$62.75,$69118.00,65,$62.75
2024-04-02,15:09:00,18233.75,BUY,1,0.02h,Stop Loss,$4.00,$66.75,$69122.00,65,$66.75
2024-04-02,15:46:00,18258.75,SELL,1,0.02h,Stop Loss,$11.50,$78.25,$69133.50,65,$78.25
2024-04-02,16:25:00,18241.75,BUY,1,0.02h,Break Even,$0.25,$78.50,$69133.75,65,$78.50
2024-04-02,17:18:00,18277.25,SELL,1,0.02h,Stop Loss,$-6.00,$72.50,$69127.75,65,$72.50
2024-04-02,17:47:00,18283.5,BUY,1,0.02h,Break Even,$0.25,$72.75,$69128.00,65,$72.75
2024-04-02,18:00:00,18277.5,SELL,1,0.02h,Stop Loss,$-6.00,$66.75,$69122.00,65,$66.75
2024-04-02,18:09:00,18288.75,BUY,1,0.02h,Break Even,$0.25,$67.00,$69122.25,65,$67.00
2024-04-02,18:32:00,18285.5,SELL,1,0.02h,Break Even,$0.25,$67.25,$69122.50,65,$67.25
2024-04-02,18:34:00,18287.5,BUY,1,0.02h,Break Even,$0.25,$67.50,$69122.75,65,$67.50
2024-04-02,18:36:00,18283.0,SELL,1,0.02h,Stop Loss,$21.50,$89.00,$69144.25,65,$89.00
2024-04-02,18:44:00,18289.25,BUY,1,0.02h,Stop Loss,$-6.00,$83.00,$69138.25,65,$83.00
2024-04-02,18:46:00,18275.5,SELL,1,0.02h,Stop Loss,$22.75,$105.75,$69161.00,65,$105.75
2024-04-02,18:56:00,18285.75,BUY,1,0.02h,Stop Loss,$-6.00,$99.75,$69155.00,65,$99.75
2024-04-02,18:57:00,18280.0,SELL,1,0.02h,Stop Loss,$-6.00,$93.75,$69149.00,65,$93.75
2024-04-02,19:03:00,18286.25,BUY,1,0.02h,Stop Loss,$21.50,$115.25,$69170.50,65,$115.25
2024-04-02,19:18:00,18281.0,SELL,1,0.02h,Break Even,$0.25,$115.50,$69170.75,65,$115.50
2024-04-02,19:25:00,18301.75,BUY,1,0.02h,Stop Loss,$10.25,$125.75,$69181.00,65,$125.75
2024-04-02,20:56:00,18341.75,SELL,1,0.02h,Stop Loss,$-6.00,$119.75,$69175.00,65,$119.75
2024-04-02,22:37:00,18333.5,BUY,1,0.03h,Stop Loss,$-6.00,$113.75,$69169.00,65,$113.75
2024-04-02,22:45:00,18330.0,SELL,1,0.02h,Stop Loss,$-6.00,$107.75,$69163.00,65,$107.75
Final P&L Day: 107.75,,,,,,,,,,,
2024-04-03,13:04:00,18273.75,BUY,1,0.02h,Stop Loss,$5.25,$5.25,$69168.25,66,$5.25
2024-04-03,13:12:00,18260.25,SELL,1,0.02h,Stop Loss,$12.75,$18.00,$69181.00,66,$18.00
2024-04-03,13:34:00,18264.75,BUY,1,0.02h,Stop Loss,$26.50,$44.50,$69207.50,66,$44.50
2024-04-03,15:41:00,18437.0,SELL,1,0.02h,Stop Loss,$-6.00,$38.50,$69201.50,66,$38.50
2024-04-03,15:43:00,18446.0,BUY,1,0.02h,Break Even,$0.25,$38.75,$69201.75,66,$38.75
2024-04-03,15:46:00,18433.25,SELL,1,0.02h,Stop Loss,$-6.00,$32.75,$69195.75,66,$32.75
2024-04-03,16:20:00,18415.25,BUY,1,0.02h,Stop Loss,$12.75,$45.50,$69208.50,66,$45.50
2024-04-03,16:39:00,18374.75,SELL,1,0.02h,Break Even,$0.25,$45.75,$69208.75,66,$45.75
2024-04-03,16:46:00,18419.25,BUY,1,0.02h,Break Even,$0.25,$46.00,$69209.00,66,$46.00
2024-04-03,17:03:00,18410.0,SELL,1,0.02h,Break Even,$0.25,$46.25,$69209.25,66,$46.25
2024-04-03,17:23:00,18419.25,BUY,1,0.02h,Stop Loss,$10.25,$56.50,$69219.50,66,$56.50
2024-04-03,17:39:00,18414.5,SELL,1,0.02h,Stop Loss,$17.75,$74.25,$69237.25,66,$74.25
2024-04-03,17:48:00,18421.0,BUY,1,0.02h,Stop Loss,$4.00,$78.25,$69241.25,66,$78.25
2024-04-03,17:59:00,18415.25,SELL,1,0.02h,Stop Loss,$-6.00,$72.25,$69235.25,66,$72.25
2024-04-03,18:08:00,18427.5,BUY,1,0.02h,Break Even,$0.25,$72.50,$69235.50,66,$72.50
2024-04-03,18:17:00,18415.75,SELL,1,0.02h,Stop Loss,$12.75,$85.25,$69248.25,66,$85.25
2024-04-03,18:39:00,18422.0,BUY,1,0.02h,Stop Loss,$-6.00,$79.25,$69242.25,66,$79.25
2024-04-03,18:47:00,18408.5,SELL,1,0.02h,Stop Loss,$-6.00,$73.25,$69236.25,66,$73.25
2024-04-03,19:39:00,18362.25,BUY,1,0.02h,Break Even,$0.25,$73.50,$69236.50,66,$73.50
2024-04-03,20:59:00,18390.25,SELL,1,0.02h,Break Even,$0.25,$73.75,$69236.75,66,$73.75
2024-04-03,22:28:00,18384.75,BUY,1,0.03h,Break Even,$0.25,$74.00,$69237.00,66,$74.00
2024-04-03,22:32:00,18382.5,SELL,1,0.02h,Stop Loss,$-6.00,$68.00,$69231.00,66,$68.00
2024-04-03,22:33:00,18384.0,BUY,1,0.02h,Stop Loss,$-6.00,$62.00,$69225.00,66,$62.00
2024-04-03,22:34:00,18382.5,SELL,1,0.02h,Stop Loss,$-6.00,$56.00,$69219.00,66,$56.00
2024-04-03,22:35:00,18385.5,BUY,1,0.02h,Stop Loss,$-6.00,$50.00,$69213.00,66,$50.00
Final P&L Day: 50.00,,,,,,,,,,,
2024-04-04,13:44:00,18541.25,SELL,1,0.02h,Stop Loss,$30.25,$30.25,$69243.25,67,$30.25
2024-04-04,15:02:00,18503.75,BUY,1,0.02h,Break Even,$0.25,$30.50,$69243.50,67,$30.50
2024-04-04,15:13:00,18486.0,SELL,1,0.02h,Break Even,$0.25,$30.75,$69243.75,67,$30.75
2024-04-04,15:30:00,18501.75,BUY,1,0.02h,Stop Loss,$17.75,$48.50,$69261.50,67,$48.50
2024-04-04,17:02:00,18550.5,SELL,1,0.02h,Stop Loss,$12.75,$61.25,$69274.25,67,$61.25
2024-04-04,20:42:00,18072.0,BUY,1,0.02h,Break Even,$0.25,$61.50,$69274.50,67,$61.50
2024-04-04,22:24:00,18079.25,SELL,1,0.02h,Stop Loss,$6.50,$68.00,$69281.00,67,$68.00
2024-04-04,22:33:00,18110.25,BUY,1,0.02h,Break Even,$0.25,$68.25,$69281.25,67,$68.25
2024-04-04,22:51:00,18099.75,SELL,1,0.02h,Break Even,$0.25,$68.50,$69281.50,67,$68.50
Final P&L Day: 68.50,,,,,,,,,,,
2024-04-05,12:00:00,18144.25,BUY,1,0.02h,Stop Loss,$19.00,$19.00,$69300.50,68,$19.00
2024-04-05,12:31:00,18109.75,SELL,1,0.02h,Stop Loss,$107.75,$126.75,$69408.25,68,$126.75
2024-04-05,12:39:00,18152.5,BUY,1,0.02h,Stop Loss,$26.50,$153.25,$69434.75,68,$153.25
2024-04-05,12:59:00,18144.75,SELL,1,0.02h,Stop Loss,$27.75,$181.00,$69462.50,68,$181.00
2024-04-05,13:01:00,18161.75,BUY,1,0.02h,Stop Loss,$25.25,$206.25,$69487.75,68,$206.25
2024-04-05,13:05:00,18143.25,SELL,1,0.02h,Stop Loss,$26.50,$232.75,$69514.25,68,$232.75
2024-04-05,13:28:00,18143.0,BUY,1,0.02h,Stop Loss,$21.50,$254.25,$69535.75,68,$254.25
2024-04-05,13:37:00,18127.75,SELL,1,0.02h,Stop Loss,$82.75,$337.00,$69618.50,68,$337.00
2024-04-05,13:43:00,18170.5,BUY,1,0.02h,Stop Loss,$42.75,$379.75,$69661.25,68,$379.75
2024-04-05,14:28:00,18187.75,SELL,1,0.02h,Stop Loss,$-6.00,$373.75,$69655.25,68,$373.75
2024-04-05,14:35:00,18218.75,BUY,1,0.02h,Break Even,$0.25,$374.00,$69655.50,68,$374.00
2024-04-05,14:36:00,18211.75,SELL,1,0.02h,Break Even,$0.25,$374.25,$69655.75,68,$374.25
2024-04-05,14:37:00,18218.25,BUY,1,0.02h,Stop Loss,$30.25,$404.50,$69686.00,68,$404.50
2024-04-05,15:15:00,18272.0,SELL,1,0.02h,Stop Loss,$89.00,$493.50,$69775.00,68,$493.50
2024-04-05,15:30:00,18282.75,BUY,1,0.02h,Break Even,$0.25,$493.75,$69775.25,68,$493.75
2024-04-05,16:30:00,18355.75,SELL,1,0.02h,Stop Loss,$4.00,$497.75,$69779.25,68,$497.75
2024-04-05,16:40:00,18371.75,BUY,1,0.02h,Stop Loss,$-6.00,$491.75,$69773.25,68,$491.75
2024-04-05,16:50:00,18356.25,SELL,1,0.02h,Stop Loss,$-6.00,$485.75,$69767.25,68,$485.75
2024-04-05,16:51:00,18364.5,BUY,1,0.02h,Stop Loss,$10.25,$496.00,$69777.50,68,$496.00
2024-04-05,17:09:00,18357.5,SELL,1,0.02h,Break Even,$0.25,$496.25,$69777.75,68,$496.25
2024-04-05,17:25:00,18369.25,BUY,1,0.02h,Break Even,$0.25,$496.50,$69778.00,68,$496.50
2024-04-05,17:26:00,18363.0,SELL,1,0.02h,Break Even,$0.25,$496.75,$69778.25,68,$496.75
2024-04-05,17:30:00,18369.0,BUY,1,0.02h,Stop Loss,$19.00,$515.75,$69797.25,68,$515.75
2024-04-05,17:41:00,18362.0,SELL,1,0.02h,Stop Loss,$51.50,$567.25,$69848.75,68,$567.25
2024-04-05,18:14:00,18318.75,BUY,1,0.02h,Break Even,$0.25,$567.50,$69849.00,68,$567.50
2024-04-05,18:26:00,18303.25,SELL,1,0.02h,Stop Loss,$-6.00,$561.50,$69843.00,68,$561.50
2024-04-05,18:41:00,18310.5,BUY,1,0.02h,Stop Loss,$-6.00,$555.50,$69837.00,68,$555.50
2024-04-05,18:42:00,18296.25,SELL,1,0.02h,Stop Loss,$12.75,$568.25,$69849.75,68,$568.25
2024-04-05,19:06:00,18293.5,BUY,1,0.02h,Stop Loss,$6.50,$574.75,$69856.25,68,$574.75
2024-04-05,19:28:00,18281.25,SELL,1,0.02h,Stop Loss,$-6.00,$568.75,$69850.25,68,$568.75
2024-04-05,19:29:00,18291.75,BUY,1,0.02h,Stop Loss,$-6.00,$562.75,$69844.25,68,$562.75
2024-04-05,20:01:00,18286.25,SELL,1,0.02h,Break Even,$0.25,$563.00,$69844.50,68,$563.00
2024-04-05,20:27:00,18296.5,BUY,1,0.02h,Break Even,$0.25,$563.25,$69844.75,68,$563.25
Final P&L Day: 563.25,,,,,,,,,,,
2024-04-08,12:03:00,18294.5,SELL,1,0.02h,Stop Loss,$-6.00,$-6.00,$69838.75,69,$-6.00
2024-04-08,12:14:00,18306.75,BUY,1,0.02h,Stop Loss,$6.50,$0.50,$69845.25,69,$0.50
2024-04-08,13:27:00,18346.0,SELL,1,0.02h,Stop Loss,$7.75,$8.25,$69853.00,69,$8.25
2024-04-08,13:59:00,18300.5,BUY,1,0.02h,Stop Loss,$15.25,$23.50,$69868.25,69,$23.50
2024-04-08,14:08:00,18283.25,SELL,1,0.02h,Stop Loss,$-6.00,$17.50,$69862.25,69,$17.50
2024-04-08,14:09:00,18307.25,BUY,1,0.02h,Stop Loss,$11.50,$29.00,$69873.75,69,$29.00
2024-04-08,15:03:00,18331.5,SELL,1,0.02h,Break Even,$0.25,$29.25,$69874.00,69,$29.25
2024-04-08,16:32:00,18291.25,BUY,1,0.02h,Stop Loss,$6.50,$35.75,$69880.50,69,$35.75
2024-04-08,17:15:00,18302.0,SELL,1,0.02h,Break Even,$0.25,$36.00,$69880.75,69,$36.00
2024-04-08,17:30:00,18311.5,BUY,1,0.02h,Stop Loss,$-6.00,$30.00,$69874.75,69,$30.00
2024-04-08,17:37:00,18291.0,SELL,1,0.02h,Stop Loss,$-6.00,$24.00,$69868.75,69,$24.00
2024-04-08,17:58:00,18303.5,BUY,1,0.02h,Stop Loss,$12.75,$36.75,$69881.50,69,$36.75
2024-04-08,18:32:00,18308.0,SELL,1,0.02h,Stop Loss,$-6.00,$30.75,$69875.50,69,$30.75
2024-04-08,18:56:00,18306.5,BUY,1,0.02h,Stop Loss,$11.50,$42.25,$69887.00,69,$42.25
2024-04-08,19:08:00,18292.5,SELL,1,0.02h,Break Even,$0.25,$42.50,$69887.25,69,$42.50
2024-04-08,19:13:00,18308.25,BUY,1,0.02h,Stop Loss,$5.25,$47.75,$69892.50,69,$47.75
2024-04-08,19:23:00,18301.75,SELL,1,0.02h,Break Even,$0.25,$48.00,$69892.75,69,$48.00
2024-04-08,19:30:00,18315.5,BUY,1,0.02h,Stop Loss,$4.00,$52.00,$69896.75,69,$52.00
2024-04-08,19:43:00,18302.75,SELL,1,0.02h,Stop Loss,$40.25,$92.25,$69937.00,69,$92.25
2024-04-08,20:04:00,18311.25,BUY,1,0.02h,Stop Loss,$-6.00,$86.25,$69931.00,69,$86.25
2024-04-08,20:30:00,18308.25,SELL,1,0.03h,Stop Loss,$5.25,$91.50,$69936.25,69,$91.50
2024-04-08,20:42:00,18310.25,BUY,1,0.05h,Stop Loss,$-6.00,$85.50,$69930.25,69,$85.50
2024-04-08,22:39:00,18314.5,SELL,1,0.02h,Stop Loss,$-6.00,$79.50,$69924.25,69,$79.50
Final P&L Day: 79.50,,,,,,,,,,,
2024-04-09,12:00:00,18340.75,BUY,1,0.02h,Stop Loss,$19.00,$19.00,$69943.25,70,$19.00
2024-04-09,13:07:00,18356.25,SELL,1,0.02h,Break Even,$0.25,$19.25,$69943.50,70,$19.25
2024-04-09,13:15:00,18369.75,BUY,1,0.02h,Stop Loss,$5.25,$24.50,$69948.75,70,$24.50
2024-04-09,13:36:00,18368.5,SELL,1,0.02h,Stop Loss,$24.00,$48.50,$69972.75,70,$48.50
2024-04-09,13:40:00,18390.25,BUY,1,0.02h,Stop Loss,$40.25,$88.75,$70013.00,70,$88.75
2024-04-09,13:49:00,18365.5,SELL,1,0.02h,Stop Loss,$80.25,$169.00,$70093.25,70,$169.00
2024-04-09,14:17:00,18362.5,BUY,1,0.02h,Stop Loss,$21.50,$190.50,$70114.75,70,$190.50
2024-04-09,14:21:00,18349.25,SELL,1,0.02h,Stop Loss,$-6.00,$184.50,$70108.75,70,$184.50
2024-04-09,14:23:00,18358.0,BUY,1,0.02h,Stop Loss,$7.75,$192.25,$70116.50,70,$192.25
2024-04-09,14:26:00,18346.5,SELL,1,0.02h,Stop Loss,$56.50,$248.75,$70173.00,70,$248.75
2024-04-09,15:05:00,18215.75,BUY,1,0.02h,Stop Loss,$30.25,$279.00,$70203.25,70,$279.00
2024-04-09,15:33:00,18221.75,SELL,1,0.02h,Stop Loss,$9.00,$288.00,$70212.25,70,$288.00
2024-04-09,15:43:00,18235.25,BUY,1,0.02h,Stop Loss,$80.25,$368.25,$70292.50,70,$368.25
2024-04-09,16:51:00,18288.5,SELL,1,0.02h,Stop Loss,$17.75,$386.00,$70310.25,70,$386.00
2024-04-09,17:08:00,18285.25,BUY,1,0.02h,Break Even,$0.25,$386.25,$70310.50,70,$386.25
2024-04-09,17:17:00,18270.25,SELL,1,0.02h,Stop Loss,$-6.00,$380.25,$70304.50,70,$380.25
2024-04-09,17:22:00,18289.25,BUY,1,0.02h,Stop Loss,$19.00,$399.25,$70323.50,70,$399.25
2024-04-09,17:29:00,18272.25,SELL,1,0.02h,Stop Loss,$-6.00,$393.25,$70317.50,70,$393.25
2024-04-09,17:40:00,18288.25,BUY,1,0.02h,Stop Loss,$16.50,$409.75,$70334.00,70,$409.75
2024-04-09,17:43:00,18264.5,SELL,1,0.02h,Stop Loss,$-6.00,$403.75,$70328.00,70,$403.75
2024-04-09,18:13:00,18271.75,BUY,1,0.02h,Stop Loss,$-6.00,$397.75,$70322.00,70,$397.75
2024-04-09,18:30:00,18260.5,SELL,1,0.02h,Stop Loss,$50.25,$448.00,$70372.25,70,$448.00
2024-04-09,18:57:00,18259.75,BUY,1,0.02h,Stop Loss,$-6.00,$442.00,$70366.25,70,$442.00
2024-04-09,19:00:00,18252.25,SELL,1,0.02h,Stop Loss,$51.50,$493.50,$70417.75,70,$493.50
2024-04-09,19:20:00,18255.25,BUY,1,0.02h,Stop Loss,$11.50,$505.00,$70429.25,70,$505.00
2024-04-09,20:46:00,18383.25,SELL,1,0.02h,Break Even,$0.25,$505.25,$70429.50,70,$505.25
2024-04-09,22:40:00,18378.0,BUY,1,0.02h,Stop Loss,$-6.00,$499.25,$70423.50,70,$499.25
2024-04-09,22:41:00,18376.5,SELL,1,0.02h,Break Even,$0.25,$499.50,$70423.75,70,$499.50
Final P&L Day: 499.50,,,,,,,,,,,
2024-04-10,12:00:00,18381.75,BUY,1,0.02h,Break Even,$0.25,$0.25,$70424.00,71,$0.25
2024-04-10,12:21:00,18381.0,SELL,1,0.02h,Stop Loss,$-6.00,$-5.75,$70418.00,71,$-5.75
2024-04-10,12:30:00,18424.0,BUY,1,0.02h,Stop Loss,$57.75,$52.00,$70475.75,71,$52.00
2024-04-10,12:31:00,18167.25,SELL,1,0.02h,Stop Loss,$239.00,$291.00,$70714.75,71,$291.00
2024-04-10,13:19:00,18129.25,BUY,1,0.02h,Stop Loss,$-6.00,$285.00,$70708.75,71,$285.00
2024-04-10,13:49:00,18139.5,SELL,1,0.02h,Stop Loss,$92.75,$377.75,$70801.50,71,$377.75
2024-04-10,13:52:00,18176.0,BUY,1,0.02h,Break Even,$0.25,$378.00,$70801.75,71,$378.00
2024-04-10,14:07:00,18152.25,SELL,1,0.02h,Stop Loss,$-6.00,$372.00,$70795.75,71,$372.00
2024-04-10,14:08:00,18167.25,BUY,1,0.02h,Stop Loss,$72.75,$444.75,$70868.50,71,$444.75
2024-04-10,14:16:00,18151.75,SELL,1,0.02h,Break Even,$0.25,$445.00,$70868.75,71,$445.00
2024-04-10,14:19:00,18184.0,BUY,1,0.02h,Stop Loss,$101.50,$546.50,$70970.25,71,$546.50
2024-04-10,14:50:00,18186.25,SELL,1,0.02h,Break Even,$0.25,$546.75,$70970.50,71,$546.75
2024-04-10,15:27:00,18158.75,BUY,1,0.02h,Stop Loss,$62.75,$609.50,$71033.25,71,$609.50
2024-04-10,15:38:00,18144.0,SELL,1,0.02h,Stop Loss,$9.00,$618.50,$71042.25,71,$618.50
2024-04-10,16:04:00,18157.5,BUY,1,0.02h,Stop Loss,$16.50,$635.00,$71058.75,71,$635.00
2024-04-10,16:13:00,18136.0,SELL,1,0.02h,Stop Loss,$14.00,$649.00,$71072.75,71,$649.00
2024-04-10,16:27:00,18149.5,BUY,1,0.02h,Stop Loss,$19.00,$668.00,$71091.75,71,$668.00
2024-04-10,17:05:00,18143.75,SELL,1,0.02h,Stop Loss,$45.25,$713.25,$71137.00,71,$713.25
2024-04-10,17:21:00,18179.25,BUY,1,0.02h,Stop Loss,$85.25,$798.50,$71222.25,71,$798.50
2024-04-10,17:34:00,18139.75,SELL,1,0.02h,Stop Loss,$35.25,$833.75,$71257.50,71,$833.75
2024-04-10,17:57:00,18186.75,BUY,1,0.02h,Stop Loss,$84.00,$917.75,$71341.50,71,$917.75
2024-04-10,18:20:00,18159.75,SELL,1,0.02h,Stop Loss,$-6.00,$911.75,$71335.50,71,$911.75
2024-04-10,18:21:00,18173.75,BUY,1,0.02h,Stop Loss,$14.00,$925.75,$71349.50,71,$925.75
2024-04-10,18:23:00,18153.25,SELL,1,0.02h,Stop Loss,$59.00,$984.75,$71408.50,71,$984.75
2024-04-10,18:40:00,18171.0,BUY,1,0.02h,Break Even,$0.25,$985.00,$71408.75,71,$985.00
2024-04-10,18:56:00,18142.25,SELL,1,0.02h,Stop Loss,$32.75,$1017.75,$71441.50,71,$1017.75
2024-04-10,19:13:00,18152.0,BUY,1,0.02h,Stop Loss,$80.25,$1098.00,$71521.75,71,$1098.00
2024-04-10,19:34:00,18153.0,SELL,1,0.02h,Stop Loss,$-6.00,$1092.00,$71515.75,71,$1092.00
2024-04-10,19:43:00,18195.0,BUY,1,0.02h,Stop Loss,$26.50,$1118.50,$71542.25,71,$1118.50
2024-04-10,20:02:00,18171.5,SELL,1,0.02h,Stop Loss,$11.50,$1130.00,$71553.75,71,$1130.00
2024-04-10,20:39:00,18173.5,BUY,1,0.03h,Break Even,$0.25,$1130.25,$71554.00,71,$1130.25
2024-04-10,22:04:00,18169.75,SELL,1,0.02h,Break Even,$0.25,$1130.50,$71554.25,71,$1130.50
2024-04-10,22:24:00,18173.25,BUY,1,0.02h,Break Even,$0.25,$1130.75,$71554.50,71,$1130.75
2024-04-10,22:36:00,18170.75,SELL,1,0.02h,Stop Loss,$-6.00,$1124.75,$71548.50,71,$1124.75
2024-04-10,22:44:00,18174.5,BUY,1,0.03h,Break Even,$0.25,$1125.00,$71548.75,71,$1125.00
2024-04-10,22:55:00,18170.5,SELL,1,0.02h,Break Even,$0.25,$1125.25,$71549.00,71,$1125.25
Final P&L Day: 1125.25,,,,,,,,,,,
2024-04-11,12:31:00,18205.75,BUY,1,0.02h,Stop Loss,$30.25,$30.25,$71579.25,72,$30.25
2024-04-11,13:32:00,18231.75,SELL,1,0.02h,Stop Loss,$17.75,$48.00,$71597.00,72,$48.00
2024-04-11,13:53:00,18270.75,BUY,1,0.02h,Break Even,$0.25,$48.25,$71597.25,72,$48.25
2024-04-11,14:02:00,18230.0,SELL,1,0.02h,Stop Loss,$7.75,$56.00,$71605.00,72,$56.00
2024-04-11,14:32:00,18238.75,BUY,1,0.02h,Break Even,$0.25,$56.25,$71605.25,72,$56.25
2024-04-11,15:29:00,18246.75,SELL,1,0.02h,Break Even,$0.25,$56.50,$71605.50,72,$56.50
2024-04-11,15:36:00,18259.5,BUY,1,0.02h,Break Even,$0.25,$56.75,$71605.75,72,$56.75
2024-04-11,16:31:00,18295.75,SELL,1,0.02h,Stop Loss,$-6.00,$50.75,$71599.75,72,$50.75
2024-04-11,16:36:00,18307.75,BUY,1,0.02h,Break Even,$0.25,$51.00,$71600.00,72,$51.00
2024-04-11,16:38:00,18302.5,SELL,1,0.02h,Stop Loss,$-6.00,$45.00,$71594.00,72,$45.00
2024-04-11,16:43:00,18310.0,BUY,1,0.02h,Stop Loss,$7.75,$52.75,$71601.75,72,$52.75
2024-04-11,18:52:00,18493.75,SELL,1,0.02h,Stop Loss,$25.25,$78.00,$71627.00,72,$78.00
2024-04-11,19:06:00,18501.5,BUY,1,0.02h,Break Even,$0.25,$78.25,$71627.25,72,$78.25
2024-04-11,19:20:00,18488.0,SELL,1,0.02h,Break Even,$0.25,$78.50,$71627.50,72,$78.50
2024-04-11,19:23:00,18502.25,BUY,1,0.02h,Stop Loss,$-6.00,$72.50,$71621.50,72,$72.50
2024-04-11,19:52:00,18499.0,SELL,1,0.02h,Stop Loss,$9.00,$81.50,$71630.50,72,$81.50
2024-04-11,20:27:00,18493.25,BUY,1,0.02h,Stop Loss,$-6.00,$75.50,$71624.50,72,$75.50
2024-04-11,20:41:00,18489.0,SELL,1,0.02h,Stop Loss,$-6.00,$69.50,$71618.50,72,$69.50
2024-04-11,22:11:00,18492.5,BUY,1,0.02h,Break Even,$0.25,$69.75,$71618.75,72,$69.75
2024-04-11,22:34:00,18490.0,SELL,1,0.05h,Break Even,$0.25,$70.00,$71619.00,72,$70.00
2024-04-11,22:45:00,18494.25,BUY,1,0.02h,Stop Loss,$-6.00,$64.00,$71613.00,72,$64.00
Final P&L Day: 64.00,,,,,,,,,,,
2024-04-12,12:00:00,18412.5,SELL,1,0.02h,Stop Loss,$9.00,$9.00,$71622.00,73,$9.00
2024-04-12,13:33:00,18320.5,BUY,1,0.02h,Stop Loss,$16.50,$25.50,$71638.50,73,$25.50
2024-04-12,13:39:00,18296.25,SELL,1,0.02h,Stop Loss,$-6.00,$19.50,$71632.50,73,$19.50
2024-04-12,13:40:00,18306.0,BUY,1,0.02h,Stop Loss,$5.25,$24.75,$71637.75,73,$24.75
2024-04-12,14:04:00,18292.0,SELL,1,0.02h,Break Even,$0.25,$25.00,$71638.00,73,$25.00
2024-04-12,14:24:00,18303.25,BUY,1,0.02h,Break Even,$0.25,$25.25,$71638.25,73,$25.25
2024-04-12,14:26:00,18291.0,SELL,1,0.02h,Stop Loss,$26.50,$51.75,$71664.75,73,$51.75
2024-04-12,15:18:00,18230.5,BUY,1,0.02h,Stop Loss,$61.50,$113.25,$71726.25,73,$113.25
2024-04-12,15:57:00,18254.25,SELL,1,0.02h,Stop Loss,$-6.00,$107.25,$71720.25,73,$107.25
2024-04-12,17:14:00,18169.25,BUY,1,0.02h,Stop Loss,$6.50,$113.75,$71726.75,73,$113.75
2024-04-12,17:22:00,18145.5,SELL,1,0.02h,Stop Loss,$26.50,$140.25,$71753.25,73,$140.25
2024-04-12,17:43:00,18160.5,BUY,1,0.02h,Stop Loss,$24.00,$164.25,$71777.25,73,$164.25
2024-04-12,18:02:00,18148.0,SELL,1,0.02h,Stop Loss,$9.00,$173.25,$71786.25,73,$173.25
2024-04-12,18:07:00,18168.5,BUY,1,0.02h,Stop Loss,$39.00,$212.25,$71825.25,73,$212.25
2024-04-12,18:26:00,18162.5,SELL,1,0.02h,Break Even,$0.25,$212.50,$71825.50,73,$212.50
2024-04-12,19:25:00,18147.75,BUY,1,0.02h,Stop Loss,$25.25,$237.75,$71850.75,73,$237.75
2024-04-12,20:48:00,18185.25,SELL,1,0.02h,Break Even,$0.25,$238.00,$71851.00,73,$238.00
Final P&L Day: 238.00,,,,,,,,,,,
2024-04-15,12:00:00,18292.25,BUY,1,0.02h,Stop Loss,$-6.00,$-6.00,$71845.00,74,$-6.00
2024-04-15,13:30:00,18335.5,SELL,1,0.02h,Stop Loss,$166.50,$160.50,$72011.50,74,$160.50
2024-04-15,13:54:00,18322.0,BUY,1,0.02h,Break Even,$0.25,$160.75,$72011.75,74,$160.75
2024-04-15,14:06:00,18297.25,SELL,1,0.02h,Stop Loss,$34.00,$194.75,$72045.75,74,$194.75
2024-04-15,15:29:00,18193.0,BUY,1,0.02h,Break Even,$0.25,$195.00,$72046.00,74,$195.00
2024-04-15,15:48:00,18185.25,SELL,1,0.02h,Break Even,$0.25,$195.25,$72046.25,74,$195.25
2024-04-15,15:52:00,18206.0,BUY,1,0.02h,Stop Loss,$30.25,$225.50,$72076.50,74,$225.50
2024-04-15,16:17:00,18204.0,SELL,1,0.02h,Stop Loss,$32.75,$258.25,$72109.25,74,$258.25
2024-04-15,17:05:00,18110.75,BUY,1,0.02h,Stop Loss,$45.25,$303.50,$72154.50,74,$303.50
2024-04-15,17:15:00,18099.25,SELL,1,0.02h,Stop Loss,$14.00,$317.50,$72168.50,74,$317.50
2024-04-15,18:28:00,17905.0,BUY,1,0.02h,Break Even,$0.25,$317.75,$72168.75,74,$317.75
2024-04-15,18:30:00,17891.75,SELL,1,0.02h,Stop Loss,$16.50,$334.25,$72185.25,74,$334.25
2024-04-15,18:31:00,17902.5,BUY,1,0.02h,Stop Loss,$19.00,$353.25,$72204.25,74,$353.25
2024-04-15,18:46:00,17893.75,SELL,1,0.02h,Stop Loss,$-6.00,$347.25,$72198.25,74,$347.25
2024-04-15,19:25:00,17878.75,BUY,1,0.02h,Stop Loss,$14.00,$361.25,$72212.25,74,$361.25
2024-04-15,19:29:00,17864.25,SELL,1,0.02h,Stop Loss,$20.25,$381.50,$72232.50,74,$381.50
2024-04-15,19:32:00,17883.75,BUY,1,0.02h,Stop Loss,$22.75,$404.25,$72255.25,74,$404.25
2024-04-15,20:01:00,17864.25,SELL,1,0.02h,Stop Loss,$7.75,$412.00,$72263.00,74,$412.00
2024-04-15,20:54:00,17862.5,BUY,1,0.02h,Break Even,$0.25,$412.25,$72263.25,74,$412.25
2024-04-15,22:41:00,17880.0,SELL,1,0.02h,Break Even,$0.25,$412.50,$72263.50,74,$412.50
2024-04-15,22:48:00,17884.0,BUY,1,0.02h,Stop Loss,$-6.00,$406.50,$72257.50,74,$406.50
2024-04-15,22:49:00,17881.5,SELL,1,0.02h,Break Even,$0.25,$406.75,$72257.75,74,$406.75
Final P&L Day: 406.75,,,,,,,,,,,
2024-04-16,12:00:00,17907.75,BUY,1,0.02h,Stop Loss,$-6.00,$-6.00,$72251.75,75,$-6.00
2024-04-16,12:10:00,17885.75,SELL,1,0.02h,Stop Loss,$-6.00,$-12.00,$72245.75,75,$-12.00
2024-04-16,12:11:00,17890.25,BUY,1,0.02h,Stop Loss,$42.75,$30.75,$72288.50,75,$30.75
2024-04-16,12:18:00,17884.0,SELL,1,0.02h,Stop Loss,$4.00,$34.75,$72292.50,75,$34.75
2024-04-16,12:33:00,17896.0,BUY,1,0.02h,Stop Loss,$-6.00,$28.75,$72286.50,75,$28.75
2024-04-16,12:58:00,17894.75,SELL,1,0.02h,Break Even,$0.25,$29.00,$72286.75,75,$29.00
2024-04-16,13:55:00,17867.25,BUY,1,0.02h,Stop Loss,$34.00,$63.00,$72320.75,75,$63.00
2024-04-16,14:25:00,17887.0,SELL,1,0.02h,Stop Loss,$21.50,$84.50,$72342.25,75,$84.50
2024-04-16,14:51:00,17868.75,BUY,1,0.02h,Break Even,$0.25,$84.75,$72342.50,75,$84.75
2024-04-16,14:52:00,17864.0,SELL,1,0.02h,Stop Loss,$-6.00,$78.75,$72336.50,75,$78.75
2024-04-16,14:53:00,17872.25,BUY,1,0.02h,Stop Loss,$37.75,$116.50,$72374.25,75,$116.50
2024-04-16,15:01:00,17861.25,SELL,1,0.02h,Stop Loss,$34.00,$150.50,$72408.25,75,$150.50
2024-04-16,15:04:00,17878.25,BUY,1,0.02h,Stop Loss,$7.75,$158.25,$72416.00,75,$158.25
2024-04-16,15:40:00,17884.75,SELL,1,0.02h,Stop Loss,$-6.00,$152.25,$72410.00,75,$152.25
2024-04-16,15:43:00,17904.25,BUY,1,0.02h,Break Even,$0.25,$152.50,$72410.25,75,$152.50
2024-04-16,16:01:00,17877.0,SELL,1,0.02h,Stop Loss,$51.50,$204.00,$72461.75,75,$204.00
2024-04-16,16:12:00,17906.5,BUY,1,0.02h,Break Even,$0.25,$204.25,$72462.00,75,$204.25
2024-04-16,16:34:00,17904.75,SELL,1,0.02h,Stop Loss,$17.75,$222.00,$72479.75,75,$222.00
2024-04-16,16:42:00,17917.25,BUY,1,0.02h,Break Even,$0.25,$222.25,$72480.00,75,$222.25
2024-04-16,16:45:00,17897.5,SELL,1,0.02h,Stop Loss,$-6.00,$216.25,$72474.00,75,$216.25
2024-04-16,16:48:00,17913.75,BUY,1,0.02h,Stop Loss,$29.00,$245.25,$72503.00,75,$245.25
2024-04-16,17:02:00,17902.25,SELL,1,0.02h,Stop Loss,$20.25,$265.50,$72523.25,75,$265.50
2024-04-16,17:10:00,17916.5,BUY,1,0.02h,Stop Loss,$4.00,$269.50,$72527.25,75,$269.50
2024-04-16,17:31:00,17847.25,SELL,1,0.02h,Stop Loss,$62.75,$332.25,$72590.00,75,$332.25
2024-04-16,17:44:00,17905.75,BUY,1,0.02h,Break Even,$0.25,$332.50,$72590.25,75,$332.50
2024-04-16,17:48:00,17881.25,SELL,1,0.02h,Stop Loss,$36.50,$369.00,$72626.75,75,$369.00
2024-04-16,18:05:00,17904.75,BUY,1,0.02h,Stop Loss,$20.25,$389.25,$72647.00,75,$389.25
2024-04-16,18:19:00,17884.75,SELL,1,0.02h,Break Even,$0.25,$389.50,$72647.25,75,$389.50
2024-04-16,18:39:00,17891.75,BUY,1,0.02h,Stop Loss,$22.75,$412.25,$72670.00,75,$412.25
2024-04-16,19:17:00,17912.75,SELL,1,0.02h,Break Even,$0.25,$412.50,$72670.25,75,$412.50
2024-04-16,19:23:00,17933.5,BUY,1,0.02h,Stop Loss,$34.00,$446.50,$72704.25,75,$446.50
2024-04-16,19:34:00,17915.25,SELL,1,0.02h,Stop Loss,$111.50,$558.00,$72815.75,75,$558.00
2024-04-16,20:33:00,17887.25,BUY,1,0.02h,Stop Loss,$-6.00,$552.00,$72809.75,75,$552.00
2024-04-16,22:21:00,17899.5,SELL,1,0.02h,Break Even,$0.25,$552.25,$72810.00,75,$552.25
2024-04-16,22:31:00,17901.75,BUY,1,0.02h,Stop Loss,$7.75,$560.00,$72817.75,75,$560.00
Final P&L Day: 560.00,,,,,,,,,,,
2024-04-17,12:02:00,17903.5,SELL,1,0.02h,Stop Loss,$15.25,$15.25,$72833.00,76,$15.25
2024-04-17,12:07:00,17912.5,BUY,1,0.02h,Break Even,$0.25,$15.50,$72833.25,76,$15.50
2024-04-17,12:10:00,17904.5,SELL,1,0.02h,Stop Loss,$24.00,$39.50,$72857.25,76,$39.50
2024-04-17,12:15:00,17913.0,BUY,1,0.02h,Break Even,$0.25,$39.75,$72857.50,76,$39.75
2024-04-17,12:26:00,17899.25,SELL,1,0.02h,Stop Loss,$-6.00,$33.75,$72851.50,76,$33.75
2024-04-17,12:34:00,17916.5,BUY,1,0.02h,Stop Loss,$-6.00,$27.75,$72845.50,76,$27.75
2024-04-17,13:33:00,17945.75,SELL,1,0.02h,Stop Loss,$34.00,$61.75,$72879.50,76,$61.75
2024-04-17,14:49:00,17858.25,BUY,1,0.02h,Stop Loss,$-6.00,$55.75,$72873.50,76,$55.75
2024-04-17,14:52:00,17811.0,SELL,1,0.02h,Stop Loss,$112.75,$168.50,$72986.25,76,$168.50
2024-04-17,15:04:00,17839.25,BUY,1,0.02h,Stop Loss,$41.50,$210.00,$73027.75,76,$210.00
2024-04-17,15:11:00,17815.75,SELL,1,0.02h,Break Even,$0.25,$210.25,$73028.00,76,$210.25
2024-04-17,17:04:00,17668.75,BUY,1,0.02h,Break Even,$0.25,$210.50,$73028.25,76,$210.50
2024-04-17,17:48:00,17704.5,SELL,1,0.02h,Stop Loss,$9.00,$219.50,$73037.25,76,$219.50
2024-04-17,17:49:00,17712.25,BUY,1,0.02h,Stop Loss,$45.25,$264.75,$73082.50,76,$264.75
2024-04-17,18:12:00,17712.75,SELL,1,0.02h,Stop Loss,$-6.00,$258.75,$73076.50,76,$258.75
2024-04-17,18:42:00,17741.25,BUY,1,0.02h,Stop Loss,$150.25,$409.00,$73226.75,76,$409.00
2024-04-17,18:55:00,17706.5,SELL,1,0.02h,Stop Loss,$64.00,$473.00,$73290.75,76,$473.00
2024-04-17,19:45:00,17686.25,BUY,1,0.02h,Stop Loss,$-6.00,$467.00,$73284.75,76,$467.00
2024-04-17,19:59:00,17678.0,SELL,1,0.02h,Stop Loss,$124.00,$591.00,$73408.75,76,$591.00
2024-04-17,20:30:00,17664.25,BUY,1,0.02h,Stop Loss,$-6.00,$585.00,$73402.75,76,$585.00
2024-04-17,20:44:00,17661.0,SELL,1,0.02h,Stop Loss,$-6.00,$579.00,$73396.75,76,$579.00
2024-04-17,20:59:00,17665.0,BUY,1,0.02h,Stop Loss,$-6.00,$573.00,$73390.75,76,$573.00
2024-04-17,22:39:00,17678.5,SELL,1,0.02h,Stop Loss,$-6.00,$567.00,$73384.75,76,$567.00
2024-04-17,22:42:00,17682.75,BUY,1,0.02h,Stop Loss,$-6.00,$561.00,$73378.75,76,$561.00
2024-04-17,22:51:00,17678.25,SELL,1,0.02h,Break Even,$0.25,$561.25,$73379.00,76,$561.25
Final P&L Day: 561.25,,,,,,,,,,,
2024-04-18,12:00:00,17709.5,BUY,1,0.02h,Break Even,$0.25,$0.25,$73379.25,77,$0.25
2024-04-18,12:18:00,17692.0,SELL,1,0.02h,Break Even,$0.25,$0.50,$73379.50,77,$0.50
2024-04-18,12:38:00,17703.75,BUY,1,0.02h,Break Even,$0.25,$0.75,$73379.75,77,$0.75
2024-04-18,12:44:00,17687.0,SELL,1,0.02h,Stop Loss,$9.00,$9.75,$73388.75,77,$9.75
2024-04-18,13:06:00,17694.5,BUY,1,0.02h,Stop Loss,$-6.00,$3.75,$73382.75,77,$3.75
2024-04-18,13:09:00,17685.5,SELL,1,0.02h,Stop Loss,$9.00,$12.75,$73391.75,77,$12.75
2024-04-18,13:12:00,17689.5,BUY,1,0.02h,Break Even,$0.25,$13.00,$73392.00,77,$13.00
2024-04-18,13:17:00,17679.25,SELL,1,0.02h,Stop Loss,$19.00,$32.00,$73411.00,77,$32.00
2024-04-18,14:10:00,17642.0,BUY,1,0.02h,Stop Loss,$32.75,$64.75,$73443.75,77,$64.75
2024-04-18,15:31:00,17697.5,SELL,1,0.02h,Stop Loss,$-6.00,$58.75,$73437.75,77,$58.75
2024-04-18,16:03:00,17700.0,BUY,1,0.02h,Break Even,$0.25,$59.00,$73438.00,77,$59.00
2024-04-18,16:04:00,17695.5,SELL,1,0.02h,Stop Loss,$21.50,$80.50,$73459.50,77,$80.50
2024-04-18,17:50:00,17571.25,BUY,1,0.02h,Stop Loss,$-6.00,$74.50,$73453.50,77,$74.50
2024-04-18,17:51:00,17563.75,SELL,1,0.02h,Stop Loss,$20.25,$94.75,$73473.75,77,$94.75
2024-04-18,18:17:00,17565.0,BUY,1,0.02h,Stop Loss,$37.75,$132.50,$73511.50,77,$132.50
2024-04-18,18:32:00,17550.0,SELL,1,0.02h,Stop Loss,$40.25,$172.75,$73551.75,77,$172.75
2024-04-18,18:50:00,17558.25,BUY,1,0.02h,Stop Loss,$-6.00,$166.75,$73545.75,77,$166.75
2024-04-18,18:51:00,17547.0,SELL,1,0.02h,Stop Loss,$60.25,$227.00,$73606.00,77,$227.00
2024-04-18,19:03:00,17571.25,BUY,1,0.02h,Stop Loss,$-6.00,$221.00,$73600.00,77,$221.00
2024-04-18,19:21:00,17556.5,SELL,1,0.02h,Stop Loss,$22.75,$243.75,$73622.75,77,$243.75
2024-04-18,19:30:00,17562.25,BUY,1,0.02h,Stop Loss,$12.75,$256.50,$73635.50,77,$256.50
2024-04-18,19:55:00,17537.5,SELL,1,0.02h,Stop Loss,$25.25,$281.75,$73660.75,77,$281.75
2024-04-18,20:59:00,17531.25,BUY,1,0.02h,Stop Loss,$-6.00,$275.75,$73654.75,77,$275.75
2024-04-18,22:23:00,17534.25,SELL,1,0.02h,Break Even,$0.25,$276.00,$73655.00,77,$276.00
Final P&L Day: 276.00,,,,,,,,,,,
2024-04-19,12:17:00,17513.5,BUY,1,0.02h,Break Even,$0.25,$0.25,$73655.25,78,$0.25
2024-04-19,12:45:00,17527.0,SELL,1,0.02h,Stop Loss,$44.00,$44.25,$73699.25,78,$44.25
2024-04-19,13:46:00,17492.25,BUY,1,0.02h,Stop Loss,$104.00,$148.25,$73803.25,78,$148.25
2024-04-19,13:51:00,17449.0,SELL,1,0.02h,Stop Loss,$34.00,$182.25,$73837.25,78,$182.25
2024-04-19,14:47:00,17396.25,BUY,1,0.02h,Stop Loss,$34.00,$216.25,$73871.25,78,$216.25
2024-04-19,15:01:00,17378.0,SELL,1,0.02h,Stop Loss,$11.50,$227.75,$73882.75,78,$227.75
2024-04-19,15:48:00,17346.25,BUY,1,0.02h,Stop Loss,$10.25,$238.00,$73893.00,78,$238.00
2024-04-19,15:52:00,17325.25,SELL,1,0.02h,Break Even,$0.25,$238.25,$73893.25,78,$238.25
2024-04-19,16:46:00,17246.75,BUY,1,0.02h,Stop Loss,$40.25,$278.50,$73933.50,78,$278.50
2024-04-19,17:29:00,17274.25,SELL,1,0.02h,Stop Loss,$72.75,$351.25,$74006.25,78,$351.25
2024-04-19,17:48:00,17284.75,BUY,1,0.02h,Stop Loss,$12.75,$364.00,$74019.00,78,$364.00
2024-04-19,18:01:00,17268.5,SELL,1,0.02h,Stop Loss,$91.50,$455.50,$74110.50,78,$455.50
2024-04-19,19:12:00,17174.5,BUY,1,0.02h,Stop Loss,$41.50,$497.00,$74152.00,78,$497.00
2024-04-19,19:36:00,17154.75,SELL,1,0.02h,Stop Loss,$90.25,$587.25,$74242.25,78,$587.25
2024-04-19,19:55:00,17183.25,BUY,1,0.02h,Break Even,$0.25,$587.50,$74242.50,78,$587.50
2024-04-19,20:40:00,17174.5,SELL,1,0.02h,Stop Loss,$-6.00,$581.50,$74236.50,78,$581.50
2024-04-19,20:58:00,17180.75,BUY,1,0.02h,Stop Loss,$-6.00,$575.50,$74230.50,78,$575.50
Final P&L Day: 575.50,,,,,,,,,,,
2024-04-22,13:25:00,17295.0,SELL,1,0.02h,Stop Loss,$27.75,$27.75,$74258.25,79,$27.75
2024-04-22,13:47:00,17298.5,BUY,1,0.02h,Stop Loss,$6.50,$34.25,$74264.75,79,$34.25
2024-04-22,14:01:00,17296.75,SELL,1,0.02h,Stop Loss,$-6.00,$28.25,$74258.75,79,$28.25
2024-04-22,14:02:00,17307.75,BUY,1,0.02h,Stop Loss,$15.25,$43.50,$74274.00,79,$43.50
2024-04-22,14:03:00,17295.25,SELL,1,0.02h,Stop Loss,$29.00,$72.50,$74303.00,79,$72.50
2024-04-22,15:27:00,17193.25,BUY,1,0.02h,Break Even,$0.25,$72.75,$74303.25,79,$72.75
2024-04-22,16:31:00,17247.25,SELL,1,0.02h,Stop Loss,$30.25,$103.00,$74333.50,79,$103.00
2024-04-22,16:48:00,17268.0,BUY,1,0.02h,Break Even,$0.25,$103.25,$74333.75,79,$103.25
2024-04-22,18:42:00,17413.25,SELL,1,0.02h,Stop Loss,$35.25,$138.50,$74369.00,79,$138.50
2024-04-22,19:10:00,17407.5,BUY,1,0.02h,Break Even,$0.25,$138.75,$74369.25,79,$138.75
2024-04-22,19:12:00,17399.25,SELL,1,0.02h,Stop Loss,$-6.00,$132.75,$74363.25,79,$132.75
2024-04-22,19:13:00,17409.25,BUY,1,0.02h,Break Even,$0.25,$133.00,$74363.50,79,$133.00
2024-04-22,19:21:00,17384.25,SELL,1,0.02h,Stop Loss,$19.00,$152.00,$74382.50,79,$152.00
2024-04-22,20:31:00,17338.5,BUY,1,0.02h,Stop Loss,$4.00,$156.00,$74386.50,79,$156.00
2024-04-22,20:49:00,17335.0,SELL,1,0.02h,Stop Loss,$-6.00,$150.00,$74380.50,79,$150.00
2024-04-22,20:53:00,17341.75,BUY,1,0.02h,Stop Loss,$-6.00,$144.00,$74374.50,79,$144.00
2024-04-22,22:15:00,17345.0,SELL,1,0.02h,Stop Loss,$4.00,$148.00,$74378.50,79,$148.00
2024-04-22,22:37:00,17342.5,BUY,1,0.03h,Stop Loss,$-6.00,$142.00,$74372.50,79,$142.00
2024-04-22,22:43:00,17339.0,SELL,1,0.02h,Stop Loss,$-6.00,$136.00,$74366.50,79,$136.00
2024-04-22,22:44:00,17341.0,BUY,1,0.02h,Stop Loss,$-6.00,$130.00,$74360.50,79,$130.00
2024-04-22,22:45:00,17339.75,SELL,1,0.02h,Stop Loss,$-6.00,$124.00,$74354.50,79,$124.00
2024-04-22,22:46:00,17342.5,BUY,1,0.03h,Break Even,$0.25,$124.25,$74354.75,79,$124.25
2024-04-22,22:57:00,17340.0,SELL,1,0.02h,Break Even,$0.25,$124.50,$74355.00,79,$124.50
Final P&L Day: 124.50,,,,,,,,,,,
2024-04-23,12:00:00,17391.0,BUY,1,0.02h,Break Even,$0.25,$0.25,$74355.25,80,$0.25
2024-04-23,12:19:00,17363.25,SELL,1,0.02h,Break Even,$0.25,$0.50,$74355.50,80,$0.50
2024-04-23,12:21:00,17374.5,BUY,1,0.02h,Stop Loss,$9.00,$9.50,$74364.50,80,$9.50
2024-04-23,14:52:00,17562.0,SELL,1,0.02h,Stop Loss,$-6.00,$3.50,$74358.50,80,$3.50
2024-04-23,14:55:00,17576.75,BUY,1,0.02h,Stop Loss,$31.50,$35.00,$74390.00,80,$35.00
2024-04-23,15:03:00,17544.0,SELL,1,0.02h,Break Even,$0.25,$35.25,$74390.25,80,$35.25
2024-04-23,15:14:00,17579.0,BUY,1,0.02h,Stop Loss,$10.25,$45.50,$74400.50,80,$45.50
2024-04-23,15:45:00,17583.5,SELL,1,0.02h,Stop Loss,$35.25,$80.75,$74435.75,80,$80.75
2024-04-23,16:06:00,17584.25,BUY,1,0.02h,Break Even,$0.25,$81.00,$74436.00,80,$81.00
2024-04-23,16:54:00,17598.5,SELL,1,0.02h,Stop Loss,$5.25,$86.25,$74441.25,80,$86.25
2024-04-23,17:08:00,17611.75,BUY,1,0.02h,Stop Loss,$-6.00,$80.25,$74435.25,80,$80.25
2024-04-23,17:12:00,17595.0,SELL,1,0.02h,Stop Loss,$52.75,$133.00,$74488.00,80,$133.00
2024-04-23,17:24:00,17596.25,BUY,1,0.02h,Break Even,$0.25,$133.25,$74488.25,80,$133.25
2024-04-23,17:26:00,17587.75,SELL,1,0.02h,Stop Loss,$-6.00,$127.25,$74482.25,80,$127.25
2024-04-23,17:29:00,17596.75,BUY,1,0.02h,Stop Loss,$4.00,$131.25,$74486.25,80,$131.25
2024-04-23,18:52:00,17634.5,SELL,1,0.02h,Break Even,$0.25,$131.50,$74486.50,80,$131.50
2024-04-23,19:38:00,17630.25,BUY,1,0.02h,Break Even,$0.25,$131.75,$74486.75,80,$131.75
2024-04-23,19:42:00,17626.75,SELL,1,0.02h,Stop Loss,$32.75,$164.50,$74519.50,80,$164.50
2024-04-23,20:05:00,17641.0,BUY,1,0.02h,Stop Loss,$10.25,$174.75,$74529.75,80,$174.75
2024-04-23,22:30:00,17669.5,SELL,1,0.02h,Break Even,$0.25,$175.00,$74530.00,80,$175.00
2024-04-23,22:46:00,17670.75,BUY,1,0.02h,Stop Loss,$-6.00,$169.00,$74524.00,80,$169.00
Final P&L Day: 169.00,,,,,,,,,,,
2024-04-24,12:43:00,17722.25,SELL,1,0.02h,Break Even,$0.25,$0.25,$74524.25,81,$0.25
2024-04-24,13:25:00,17705.25,BUY,1,0.02h,Stop Loss,$41.50,$41.75,$74565.75,81,$41.75
2024-04-24,13:57:00,17716.75,SELL,1,0.02h,Break Even,$0.25,$42.00,$74566.00,81,$42.00
2024-04-24,14:08:00,17768.75,BUY,1,0.02h,Stop Loss,$20.25,$62.25,$74586.25,81,$62.25
2024-04-24,14:14:00,17740.75,SELL,1,0.02h,Stop Loss,$99.00,$161.25,$74685.25,81,$161.25
2024-04-24,15:33:00,17669.5,BUY,1,0.02h,Stop Loss,$7.75,$169.00,$74693.00,81,$169.00
2024-04-24,15:44:00,17639.25,SELL,1,0.02h,Stop Loss,$64.00,$233.00,$74757.00,81,$233.00
2024-04-24,16:53:00,17603.5,BUY,1,0.02h,Stop Loss,$9.00,$242.00,$74766.00,81,$242.00
2024-04-24,18:06:00,17668.25,SELL,1,0.02h,Break Even,$0.25,$242.25,$74766.25,81,$242.25
2024-04-24,19:11:00,17637.5,BUY,1,0.02h,Stop Loss,$30.25,$272.50,$74796.50,81,$272.50
2024-04-24,20:01:00,17665.25,SELL,1,0.02h,Stop Loss,$15.25,$287.75,$74811.75,81,$287.75
2024-04-24,20:02:00,17672.5,BUY,1,0.02h,Break Even,$0.25,$288.00,$74812.00,81,$288.00
2024-04-24,20:03:00,17666.75,SELL,1,0.02h,Stop Loss,$26.50,$314.50,$74838.50,81,$314.50
2024-04-24,20:55:00,17517.0,BUY,1,0.02h,Break Even,$0.25,$314.75,$74838.75,81,$314.75
2024-04-24,20:59:00,17502.5,SELL,1,0.02h,Break Even,$0.25,$315.00,$74839.00,81,$315.00
2024-04-24,22:30:00,17483.75,BUY,1,0.02h,Break Even,$0.25,$315.25,$74839.25,81,$315.25
2024-04-24,22:37:00,17466.25,SELL,1,0.02h,Stop Loss,$29.00,$344.25,$74868.25,81,$344.25
Final P&L Day: 344.25,,,,,,,,,,,
2024-04-25,12:00:00,17501.0,BUY,1,0.02h,Stop Loss,$-6.00,$-6.00,$74862.25,82,$-6.00
2024-04-25,12:13:00,17465.75,SELL,1,0.02h,Stop Loss,$-6.00,$-12.00,$74856.25,82,$-12.00
2024-04-25,13:44:00,17368.5,BUY,1,0.02h,Stop Loss,$20.25,$8.25,$74876.50,82,$8.25
2024-04-25,14:01:00,17342.0,SELL,1,0.02h,Stop Loss,$40.25,$48.50,$74916.75,82,$48.50
2024-04-25,14:06:00,17370.0,BUY,1,0.02h,Stop Loss,$62.75,$111.25,$74979.50,82,$111.25
2024-04-25,14:35:00,17382.5,SELL,1,0.02h,Break Even,$0.25,$111.50,$74979.75,82,$111.50
2024-04-25,15:06:00,17378.0,BUY,1,0.02h,Stop Loss,$15.25,$126.75,$74995.00,82,$126.75
2024-04-25,15:18:00,17362.0,SELL,1,0.02h,Stop Loss,$16.50,$143.25,$75011.50,82,$143.25
2024-04-25,15:27:00,17380.75,BUY,1,0.02h,Stop Loss,$12.75,$156.00,$75024.25,82,$156.00
2024-04-25,15:49:00,17371.75,SELL,1,0.02h,Stop Loss,$11.50,$167.50,$75035.75,82,$167.50
2024-04-25,15:55:00,17394.0,BUY,1,0.02h,Stop Loss,$24.00,$191.50,$75059.75,82,$191.50
2024-04-25,17:21:00,17484.25,SELL,1,0.02h,Stop Loss,$32.75,$224.25,$75092.50,82,$224.25
2024-04-25,17:31:00,17502.0,BUY,1,0.02h,Break Even,$0.25,$224.50,$75092.75,82,$224.50
2024-04-25,18:26:00,17557.75,SELL,1,0.02h,Break Even,$0.25,$224.75,$75093.00,82,$224.75
2024-04-25,19:01:00,17534.0,BUY,1,0.02h,Stop Loss,$16.50,$241.25,$75109.50,82,$241.25
2024-04-25,19:38:00,17570.0,SELL,1,0.02h,Stop Loss,$35.25,$276.50,$75144.75,82,$276.50
2024-04-25,20:00:00,17569.25,BUY,1,0.02h,Stop Loss,$262.75,$539.25,$75407.50,82,$539.25
2024-04-25,22:02:00,17787.25,SELL,1,0.02h,Stop Loss,$5.25,$544.50,$75412.75,82,$544.50
2024-04-25,22:35:00,17774.25,BUY,1,0.02h,Stop Loss,$-6.00,$538.50,$75406.75,82,$538.50
2024-04-25,22:53:00,17773.5,SELL,1,0.02h,Stop Loss,$-6.00,$532.50,$75400.75,82,$532.50
Final P&L Day: 532.50,,,,,,,,,,,
2024-04-26,12:31:00,17795.5,BUY,1,0.02h,Stop Loss,$67.75,$67.75,$75468.50,83,$67.75
2024-04-26,12:42:00,17736.0,SELL,1,0.02h,Stop Loss,$26.50,$94.25,$75495.00,83,$94.25
2024-04-26,12:45:00,17754.0,BUY,1,0.02h,Break Even,$0.25,$94.50,$75495.25,83,$94.50
2024-04-26,12:47:00,17735.75,SELL,1,0.02h,Break Even,$0.25,$94.75,$75495.50,83,$94.75
2024-04-26,13:02:00,17742.5,BUY,1,0.02h,Stop Loss,$16.50,$111.25,$75512.00,83,$111.25
2024-04-26,13:07:00,17717.0,SELL,1,0.02h,Stop Loss,$-6.00,$105.25,$75506.00,83,$105.25
2024-04-26,13:36:00,17734.5,BUY,1,0.02h,Stop Loss,$7.75,$113.00,$75513.75,83,$113.00
2024-04-26,14:31:00,17788.25,SELL,1,0.02h,Break Even,$0.25,$113.25,$75514.00,83,$113.25
2024-04-26,14:36:00,17828.75,BUY,1,0.02h,Break Even,$0.25,$113.50,$75514.25,83,$113.50
2024-04-26,15:13:00,17825.25,SELL,1,0.02h,Stop Loss,$9.00,$122.50,$75523.25,83,$122.50
2024-04-26,15:44:00,17849.75,BUY,1,0.02h,Stop Loss,$47.75,$170.25,$75571.00,83,$170.25
2024-04-26,16:01:00,17831.75,SELL,1,0.02h,Break Even,$0.25,$170.50,$75571.25,83,$170.50
2024-04-26,16:26:00,17851.0,BUY,1,0.02h,Stop Loss,$-6.00,$164.50,$75565.25,83,$164.50
2024-04-26,16:32:00,17835.75,SELL,1,0.02h,Stop Loss,$-6.00,$158.50,$75559.25,83,$158.50
2024-04-26,16:35:00,17854.5,BUY,1,0.02h,Break Even,$0.25,$158.75,$75559.50,83,$158.75
2024-04-26,17:41:00,17876.75,SELL,1,0.02h,Stop Loss,$59.00,$217.75,$75618.50,83,$217.75
2024-04-26,17:49:00,17892.0,BUY,1,0.02h,Stop Loss,$14.00,$231.75,$75632.50,83,$231.75
2024-04-26,17:57:00,17884.25,SELL,1,0.02h,Stop Loss,$12.75,$244.50,$75645.25,83,$244.50
2024-04-26,18:59:00,17861.25,BUY,1,0.02h,Stop Loss,$19.00,$263.50,$75664.25,83,$263.50
2024-04-26,19:42:00,17872.75,SELL,1,0.02h,Stop Loss,$-6.00,$257.50,$75658.25,83,$257.50
2024-04-26,20:42:00,17838.25,BUY,1,0.02h,Stop Loss,$-6.00,$251.50,$75652.25,83,$251.50
2024-04-26,20:44:00,17836.5,SELL,1,0.03h,Break Even,$0.25,$251.75,$75652.50,83,$251.75
2024-04-26,20:49:00,17839.0,BUY,1,0.02h,Break Even,$0.25,$252.00,$75652.75,83,$252.00
Final P&L Day: 252.00,,,,,,,,,,,
2024-04-29,12:37:00,17906.75,SELL,1,0.02h,Break Even,$0.25,$0.25,$75653.00,84,$0.25
2024-04-29,12:41:00,17912.0,BUY,1,0.02h,Stop Loss,$7.75,$8.00,$75660.75,84,$8.00
2024-04-29,13:09:00,17915.0,SELL,1,0.02h,Break Even,$0.25,$8.25,$75661.00,84,$8.25
2024-04-29,13:31:00,17915.0,BUY,1,0.02h,Stop Loss,$112.75,$121.00,$75773.75,84,$121.00
2024-04-29,13:40:00,17896.5,SELL,1,0.02h,Stop Loss,$106.50,$227.50,$75880.25,84,$227.50
2024-04-29,14:05:00,17872.25,BUY,1,0.02h,Break Even,$0.25,$227.75,$75880.50,84,$227.75
2024-04-29,14:40:00,17877.0,SELL,1,0.02h,Stop Loss,$-6.00,$221.75,$75874.50,84,$221.75
2024-04-29,15:20:00,17888.0,BUY,1,0.02h,Stop Loss,$-6.00,$215.75,$75868.50,84,$215.75
2024-04-29,15:23:00,17876.75,SELL,1,0.02h,Stop Loss,$20.25,$236.00,$75888.75,84,$236.00
2024-04-29,15:45:00,17883.25,BUY,1,0.02h,Stop Loss,$-6.00,$230.00,$75882.75,84,$230.00
2024-04-29,16:42:00,17888.25,SELL,1,0.02h,Stop Loss,$-6.00,$224.00,$75876.75,84,$224.00
2024-04-29,16:44:00,17904.5,BUY,1,0.02h,Stop Loss,$11.50,$235.50,$75888.25,84,$235.50
2024-04-29,16:49:00,17898.75,SELL,1,0.02h,Break Even,$0.25,$235.75,$75888.50,84,$235.75
2024-04-29,17:18:00,17895.75,BUY,1,0.02h,Break Even,$0.25,$236.00,$75888.75,84,$236.00
2024-04-29,17:54:00,17916.0,SELL,1,0.02h,Break Even,$0.25,$236.25,$75889.00,84,$236.25
2024-04-29,18:47:00,17881.5,BUY,1,0.02h,Stop Loss,$5.25,$241.50,$75894.25,84,$241.50
2024-04-29,19:01:00,17852.5,SELL,1,0.02h,Stop Loss,$51.50,$293.00,$75945.75,84,$293.00
2024-04-29,19:23:00,17850.75,BUY,1,0.02h,Stop Loss,$-6.00,$287.00,$75939.75,84,$287.00
2024-04-29,20:46:00,17913.75,SELL,1,0.02h,Break Even,$0.25,$287.25,$75940.00,84,$287.25
2024-04-29,22:29:00,17912.75,BUY,1,0.02h,Stop Loss,$-6.00,$281.25,$75934.00,84,$281.25
2024-04-29,22:39:00,17909.0,SELL,1,0.02h,Stop Loss,$-6.00,$275.25,$75928.00,84,$275.25
Final P&L Day: 275.25,,,,,,,,,,,
2024-04-30,12:56:00,17834.5,BUY,1,0.02h,Stop Loss,$-6.00,$-6.00,$75922.00,85,$-6.00
2024-04-30,12:58:00,17822.0,SELL,1,0.02h,Stop Loss,$4.00,$-2.00,$75926.00,85,$-2.00
2024-04-30,13:09:00,17829.25,BUY,1,0.02h,Break Even,$0.25,$-1.75,$75926.25,85,$-1.75
2024-04-30,13:10:00,17820.75,SELL,1,0.02h,Stop Loss,$-6.00,$-7.75,$75920.25,85,$-7.75
2024-04-30,13:11:00,17832.5,BUY,1,0.02h,Break Even,$0.25,$-7.50,$75920.50,85,$-7.50
2024-04-30,14:13:00,17846.5,SELL,1,0.02h,Stop Loss,$-6.00,$-13.50,$75914.50,85,$-13.50
2024-04-30,14:16:00,17872.5,BUY,1,0.02h,Break Even,$0.25,$-13.25,$75914.75,85,$-13.25
2024-04-30,14:22:00,17858.5,SELL,1,0.02h,Stop Loss,$-6.00,$-19.25,$75908.75,85,$-19.25
2024-04-30,14:43:00,17862.75,BUY,1,0.02h,Stop Loss,$-6.00,$-25.25,$75902.75,85,$-25.25
2024-04-30,14:55:00,17841.0,SELL,1,0.02h,Stop Loss,$10.25,$-15.00,$75913.00,85,$-15.00
2024-04-30,15:58:00,17765.5,BUY,1,0.02h,Stop Loss,$-6.00,$-21.00,$75907.00,85,$-21.00
2024-04-30,16:06:00,17746.75,SELL,1,0.02h,Break Even,$0.25,$-20.75,$75907.25,85,$-20.75
2024-04-30,16:12:00,17760.5,BUY,1,0.02h,Stop Loss,$-6.00,$-26.75,$75901.25,85,$-26.75
2024-04-30,16:32:00,17743.75,SELL,1,0.02h,Stop Loss,$51.50,$24.75,$75952.75,85,$24.75
2024-04-30,17:04:00,17717.25,BUY,1,0.02h,Stop Loss,$-6.00,$18.75,$75946.75,85,$18.75
2024-04-30,17:12:00,17695.0,SELL,1,0.02h,Stop Loss,$82.75,$101.50,$76029.50,85,$101.50
2024-04-30,17:25:00,17702.5,BUY,1,0.02h,Stop Loss,$25.25,$126.75,$76054.75,85,$126.75
2024-04-30,18:14:00,17717.5,SELL,1,0.02h,Stop Loss,$-6.00,$120.75,$76048.75,85,$120.75
2024-04-30,18:39:00,17719.25,BUY,1,0.02h,Stop Loss,$-6.00,$114.75,$76042.75,85,$114.75
2024-04-30,18:46:00,17704.0,SELL,1,0.02h,Stop Loss,$15.25,$130.00,$76058.00,85,$130.00
2024-04-30,19:07:00,17695.5,BUY,1,0.02h,Stop Loss,$24.00,$154.00,$76082.00,85,$154.00
2024-04-30,19:17:00,17686.75,SELL,1,0.02h,Stop Loss,$34.00,$188.00,$76116.00,85,$188.00
2024-04-30,19:32:00,17692.75,BUY,1,0.02h,Stop Loss,$26.50,$214.50,$76142.50,85,$214.50
2024-04-30,19:45:00,17683.75,SELL,1,0.02h,Stop Loss,$-6.00,$208.50,$76136.50,85,$208.50
2024-04-30,19:49:00,17695.0,BUY,1,0.02h,Stop Loss,$51.50,$260.00,$76188.00,85,$260.00
2024-04-30,19:52:00,17664.0,SELL,1,0.02h,Stop Loss,$52.75,$312.75,$76240.75,85,$312.75
2024-04-30,22:34:00,17494.25,BUY,1,0.02h,Stop Loss,$-6.00,$306.75,$76234.75,85,$306.75
2024-04-30,22:51:00,17493.25,SELL,1,0.02h,Stop Loss,$-6.00,$300.75,$76228.75,85,$300.75
2024-04-30,22:54:00,17498.5,BUY,1,0.02h,Break Even,$0.25,$301.00,$76229.00,85,$301.00
Final P&L Day: 301.00,,,,,,,,,,,
2024-05-01,12:00:00,17446.75,SELL,1,0.02h,Stop Loss,$15.25,$15.25,$76244.25,86,$15.25
2024-05-01,12:20:00,17477.0,BUY,1,0.02h,Break Even,$0.25,$15.50,$76244.50,86,$15.50
2024-05-01,13:05:00,17496.75,SELL,1,0.02h,Break Even,$0.25,$15.75,$76244.75,86,$15.75
2024-05-01,13:07:00,17499.5,BUY,1,0.02h,Break Even,$0.25,$16.00,$76245.00,86,$16.00
2024-05-01,13:30:00,17500.25,SELL,1,0.02h,Stop Loss,$57.75,$73.75,$76302.75,86,$73.75
2024-05-01,13:31:00,17512.5,BUY,1,0.02h,Stop Loss,$-6.00,$67.75,$76296.75,86,$67.75
2024-05-01,13:32:00,17487.5,SELL,1,0.02h,Stop Loss,$34.00,$101.75,$76330.75,86,$101.75
2024-05-01,14:28:00,17477.0,BUY,1,0.02h,Stop Loss,$15.25,$117.00,$76346.00,86,$117.00
2024-05-01,15:04:00,17476.25,SELL,1,0.02h,Stop Loss,$12.75,$129.75,$76358.75,86,$129.75
2024-05-01,15:34:00,17455.0,BUY,1,0.02h,Stop Loss,$30.25,$160.00,$76389.00,86,$160.00
2024-05-01,15:52:00,17438.5,SELL,1,0.02h,Stop Loss,$10.25,$170.25,$76399.25,86,$170.25
2024-05-01,16:13:00,17455.25,BUY,1,0.02h,Stop Loss,$9.00,$179.25,$76408.25,86,$179.25
2024-05-01,16:40:00,17445.5,SELL,1,0.02h,Stop Loss,$30.25,$209.50,$76438.50,86,$209.50
2024-05-01,17:24:00,17449.0,BUY,1,0.02h,Stop Loss,$-6.00,$203.50,$76432.50,86,$203.50
2024-05-01,19:22:00,17702.0,SELL,1,0.02h,Stop Loss,$120.25,$323.75,$76552.75,86,$323.75
2024-05-01,19:27:00,17748.5,BUY,1,0.02h,Stop Loss,$61.50,$385.25,$76614.25,86,$385.25
2024-05-01,19:30:00,17717.75,SELL,1,0.02h,Stop Loss,$166.50,$551.75,$76780.75,86,$551.75
2024-05-01,20:47:00,17470.5,BUY,1,0.02h,Stop Loss,$-6.00,$545.75,$76774.75,86,$545.75
2024-05-01,22:52:00,17498.5,SELL,1,0.02h,Stop Loss,$-6.00,$539.75,$76768.75,86,$539.75
2024-05-01,22:55:00,17502.0,BUY,1,0.02h,Break Even,$0.25,$540.00,$76769.00,86,$540.00
Final P&L Day: 540.00,,,,,,,,,,,
2024-05-02,12:56:00,17585.0,SELL,1,0.02h,Break Even,$0.25,$0.25,$76769.25,87,$0.25
2024-05-02,13:26:00,17582.5,BUY,1,0.02h,Stop Loss,$9.00,$9.25,$76778.25,87,$9.25
2024-05-02,13:32:00,17557.75,SELL,1,0.02h,Break Even,$0.25,$9.50,$76778.50,87,$9.50
2024-05-02,14:25:00,17497.25,BUY,1,0.02h,Stop Loss,$52.75,$62.25,$76831.25,87,$62.25
2024-05-02,14:43:00,17460.75,SELL,1,0.02h,Stop Loss,$47.75,$110.00,$76879.00,87,$110.00
2024-05-02,14:51:00,17491.0,BUY,1,0.02h,Stop Loss,$22.75,$132.75,$76901.75,87,$132.75
2024-05-02,15:28:00,17519.0,SELL,1,0.02h,Stop Loss,$11.50,$144.25,$76913.25,87,$144.25
2024-05-02,15:48:00,17527.75,BUY,1,0.02h,Stop Loss,$-6.00,$138.25,$76907.25,87,$138.25
2024-05-02,16:12:00,17531.5,SELL,1,0.02h,Stop Loss,$14.00,$152.25,$76921.25,87,$152.25
2024-05-02,16:29:00,17538.75,BUY,1,0.02h,Break Even,$0.25,$152.50,$76921.50,87,$152.50
2024-05-02,16:31:00,17515.5,SELL,1,0.02h,Stop Loss,$34.00,$186.50,$76955.50,87,$186.50
2024-05-02,16:45:00,17529.25,BUY,1,0.02h,Break Even,$0.25,$186.75,$76955.75,87,$186.75
2024-05-02,16:58:00,17517.25,SELL,1,0.02h,Stop Loss,$-6.00,$180.75,$76949.75,87,$180.75
2024-05-02,17:01:00,17536.25,BUY,1,0.02h,Stop Loss,$7.75,$188.50,$76957.50,87,$188.50
2024-05-02,19:34:00,17651.5,SELL,1,0.02h,Stop Loss,$14.00,$202.50,$76971.50,87,$202.50
2024-05-02,20:01:00,17675.25,BUY,1,0.02h,Stop Loss,$15.25,$217.75,$76986.75,87,$217.75
2024-05-02,20:18:00,17650.25,SELL,1,0.02h,Break Even,$0.25,$218.00,$76987.00,87,$218.00
2024-05-02,20:29:00,17662.25,BUY,1,0.02h,Break Even,$0.25,$218.25,$76987.25,87,$218.25
2024-05-02,22:07:00,17729.0,SELL,1,0.02h,Stop Loss,$19.00,$237.25,$77006.25,87,$237.25
2024-05-02,22:14:00,17743.25,BUY,1,0.02h,Break Even,$0.25,$237.50,$77006.50,87,$237.50
2024-05-02,22:34:00,17742.5,SELL,1,0.02h,Stop Loss,$-6.00,$231.50,$77000.50,87,$231.50
Final P&L Day: 231.50,,,,,,,,,,,
2024-05-03,12:01:00,17751.0,BUY,1,0.02h,Break Even,$0.25,$0.25,$77000.75,88,$0.25
2024-05-03,12:30:00,17745.0,SELL,1,0.02h,Break Even,$0.25,$0.50,$77001.00,88,$0.50
2024-05-03,12:31:00,17898.75,BUY,1,0.02h,Stop Loss,$76.50,$77.00,$77077.50,88,$77.00
2024-05-03,14:04:00,17949.0,SELL,1,0.02h,Stop Loss,$72.75,$149.75,$77150.25,88,$149.75
2024-05-03,14:32:00,17941.5,BUY,1,0.02h,Stop Loss,$36.50,$186.25,$77186.75,88,$186.25
2024-05-03,14:33:00,17931.0,SELL,1,0.02h,Stop Loss,$15.25,$201.50,$77202.00,88,$201.50
2024-05-03,14:37:00,17950.0,BUY,1,0.02h,Stop Loss,$6.50,$208.00,$77208.50,88,$208.00
2024-05-03,14:55:00,17938.75,SELL,1,0.02h,Stop Loss,$-6.00,$202.00,$77202.50,88,$202.00
2024-05-03,15:23:00,17943.25,BUY,1,0.02h,Stop Loss,$-6.00,$196.00,$77196.50,88,$196.00
2024-05-03,16:19:00,17987.25,SELL,1,0.02h,Stop Loss,$9.00,$205.00,$77205.50,88,$205.00
2024-05-03,16:25:00,17990.75,BUY,1,0.02h,Stop Loss,$10.25,$215.25,$77215.75,88,$215.25
2024-05-03,16:33:00,17985.5,SELL,1,0.02h,Stop Loss,$-6.00,$209.25,$77209.75,88,$209.25
2024-05-03,16:37:00,17993.0,BUY,1,0.02h,Break Even,$0.25,$209.50,$77210.00,88,$209.50
2024-05-03,16:51:00,17987.0,SELL,1,0.02h,Stop Loss,$9.00,$218.50,$77219.00,88,$218.50
2024-05-03,17:09:00,17989.25,BUY,1,0.02h,Stop Loss,$-6.00,$212.50,$77213.00,88,$212.50
2024-05-03,17:32:00,17983.25,SELL,1,0.02h,Stop Loss,$65.25,$277.75,$77278.25,88,$277.75
2024-05-03,17:42:00,17997.75,BUY,1,0.02h,Stop Loss,$-6.00,$271.75,$77272.25,88,$271.75
2024-05-03,17:44:00,17980.0,SELL,1,0.02h,Break Even,$0.25,$272.00,$77272.50,88,$272.00
2024-05-03,17:50:00,17989.0,BUY,1,0.02h,Break Even,$0.25,$272.25,$77272.75,88,$272.25
2024-05-03,18:42:00,18017.0,SELL,1,0.02h,Stop Loss,$-6.00,$266.25,$77266.75,88,$266.25
2024-05-03,18:43:00,18020.75,BUY,1,0.02h,Stop Loss,$-6.00,$260.25,$77260.75,88,$260.25
2024-05-03,18:45:00,18012.5,SELL,1,0.02h,Stop Loss,$-6.00,$254.25,$77254.75,88,$254.25
2024-05-03,18:54:00,18020.25,BUY,1,0.02h,Stop Loss,$-6.00,$248.25,$77248.75,88,$248.25
2024-05-03,18:55:00,18014.0,SELL,1,0.02h,Stop Loss,$74.00,$322.25,$77322.75,88,$322.25
2024-05-03,19:07:00,18022.5,BUY,1,0.02h,Stop Loss,$-6.00,$316.25,$77316.75,88,$316.25
2024-05-03,19:19:00,18010.25,SELL,1,0.02h,Break Even,$0.25,$316.50,$77317.00,88,$316.50
2024-05-03,19:30:00,18016.25,BUY,1,0.02h,Stop Loss,$-6.00,$310.50,$77311.00,88,$310.50
2024-05-03,19:31:00,18008.75,SELL,1,0.02h,Break Even,$0.25,$310.75,$77311.25,88,$310.75
2024-05-03,20:02:00,18017.75,BUY,1,0.02h,Stop Loss,$-6.00,$304.75,$77305.25,88,$304.75
2024-05-03,20:49:00,18021.0,SELL,1,0.02h,Break Even,$0.25,$305.00,$77305.50,88,$305.00
2024-05-03,20:58:00,18023.25,BUY,1,0.02h,Stop Loss,$-6.00,$299.00,$77299.50,88,$299.00
Final P&L Day: 299.00,,,,,,,,,,,
2024-05-06,12:48:00,18059.5,SELL,1,0.02h,Stop Loss,$-6.00,$-6.00,$77293.50,89,$-6.00
2024-05-06,12:50:00,18061.75,BUY,1,0.02h,Stop Loss,$-6.00,$-12.00,$77287.50,89,$-12.00
2024-05-06,12:55:00,18059.75,SELL,1,0.02h,Break Even,$0.25,$-11.75,$77287.75,89,$-11.75
2024-05-06,13:04:00,18063.75,BUY,1,0.02h,Stop Loss,$-6.00,$-17.75,$77281.75,89,$-17.75
2024-05-06,13:07:00,18057.25,SELL,1,0.02h,Stop Loss,$-6.00,$-23.75,$77275.75,89,$-23.75
2024-05-06,13:12:00,18062.75,BUY,1,0.02h,Stop Loss,$-6.00,$-29.75,$77269.75,89,$-29.75
2024-05-06,13:14:00,18055.0,SELL,1,0.02h,Stop Loss,$-6.00,$-35.75,$77263.75,89,$-35.75
2024-05-06,13:19:00,18064.75,BUY,1,0.02h,Stop Loss,$-6.00,$-41.75,$77257.75,89,$-41.75
2024-05-06,13:32:00,18056.0,SELL,1,0.02h,Stop Loss,$51.50,$9.75,$77309.25,89,$9.75
2024-05-06,13:36:00,18076.75,BUY,1,0.02h,Stop Loss,$16.50,$26.25,$77325.75,89,$26.25
2024-05-06,14:14:00,18091.75,SELL,1,0.02h,Break Even,$0.25,$26.50,$77326.00,89,$26.50
2024-05-06,14:16:00,18099.5,BUY,1,0.02h,Break Even,$0.25,$26.75,$77326.25,89,$26.75
2024-05-06,14:17:00,18097.25,SELL,1,0.02h,Stop Loss,$45.25,$72.00,$77371.50,89,$72.00
2024-05-06,14:25:00,18100.5,BUY,1,0.02h,Stop Loss,$16.50,$88.50,$77388.00,89,$88.50
2024-05-06,14:30:00,18094.25,SELL,1,0.02h,Stop Loss,$-6.00,$82.50,$77382.00,89,$82.50
2024-05-06,14:39:00,18102.25,BUY,1,0.02h,Stop Loss,$-6.00,$76.50,$77376.00,89,$76.50
2024-05-06,14:48:00,18091.0,SELL,1,0.02h,Stop Loss,$-6.00,$70.50,$77370.00,89,$70.50
2024-05-06,14:52:00,18100.5,BUY,1,0.02h,Stop Loss,$20.25,$90.75,$77390.25,89,$90.75
2024-05-06,14:59:00,18095.0,SELL,1,0.02h,Break Even,$0.25,$91.00,$77390.50,89,$91.00
2024-05-06,15:12:00,18096.5,BUY,1,0.02h,Break Even,$0.25,$91.25,$77390.75,89,$91.25
2024-05-06,15:14:00,18087.0,SELL,1,0.02h,Stop Loss,$5.25,$96.50,$77396.00,89,$96.50
2024-05-06,15:24:00,18101.25,BUY,1,0.02h,Stop Loss,$-6.00,$90.50,$77390.00,89,$90.50
2024-05-06,16:02:00,18103.25,SELL,1,0.02h,Stop Loss,$4.00,$94.50,$77394.00,89,$94.50
2024-05-06,16:34:00,18096.5,BUY,1,0.02h,Break Even,$0.25,$94.75,$77394.25,89,$94.75
2024-05-06,16:55:00,18099.0,SELL,1,0.02h,Break Even,$0.25,$95.00,$77394.50,89,$95.00
2024-05-06,16:57:00,18104.5,BUY,1,0.02h,Stop Loss,$16.50,$111.50,$77411.00,89,$111.50
2024-05-06,17:12:00,18096.0,SELL,1,0.02h,Stop Loss,$-6.00,$105.50,$77405.00,89,$105.50
2024-05-06,17:25:00,18111.75,BUY,1,0.02h,Stop Loss,$-6.00,$99.50,$77399.00,89,$99.50
2024-05-06,18:23:00,18131.0,SELL,1,0.02h,Stop Loss,$-6.00,$93.50,$77393.00,89,$93.50
2024-05-06,18:24:00,18135.25,BUY,1,0.02h,Stop Loss,$17.75,$111.25,$77410.75,89,$111.25
2024-05-06,18:42:00,18133.75,SELL,1,0.02h,Break Even,$0.25,$111.50,$77411.00,89,$111.50
2024-05-06,18:48:00,18142.75,BUY,1,0.02h,Stop Loss,$4.00,$115.50,$77415.00,89,$115.50
2024-05-06,19:14:00,18137.5,SELL,1,0.02h,Stop Loss,$-6.00,$109.50,$77409.00,89,$109.50
2024-05-06,19:23:00,18145.25,BUY,1,0.02h,Stop Loss,$-6.00,$103.50,$77403.00,89,$103.50
2024-05-06,19:31:00,18136.5,SELL,1,0.02h,Stop Loss,$10.25,$113.75,$77413.25,89,$113.75
2024-05-06,19:38:00,18149.75,BUY,1,0.02h,Stop Loss,$-6.00,$107.75,$77407.25,89,$107.75
2024-05-06,20:56:00,18183.5,SELL,1,0.02h,Stop Loss,$-6.00,$101.75,$77401.25,89,$101.75
2024-05-06,22:17:00,18184.75,BUY,1,0.02h,Stop Loss,$-6.00,$95.75,$77395.25,89,$95.75
Final P&L Day: 95.75,,,,,,,,,,,
2024-05-07,12:00:00,18164.75,SELL,1,0.02h,Stop Loss,$-6.00,$-6.00,$77389.25,90,$-6.00
2024-05-07,12:42:00,18171.5,BUY,1,0.02h,Stop Loss,$7.75,$1.75,$77397.00,90,$1.75
2024-05-07,13:52:00,18200.75,SELL,1,0.02h,Stop Loss,$7.75,$9.50,$77404.75,90,$9.50
2024-05-07,14:14:00,18208.75,BUY,1,0.02h,Stop Loss,$35.25,$44.75,$77440.00,90,$44.75
2024-05-07,14:24:00,18191.5,SELL,1,0.02h,Stop Loss,$11.50,$56.25,$77451.50,90,$56.25
2024-05-07,14:39:00,18205.0,BUY,1,0.02h,Break Even,$0.25,$56.50,$77451.75,90,$56.50
2024-05-07,15:34:00,18236.75,SELL,1,0.02h,Break Even,$0.25,$56.75,$77452.00,90,$56.75
2024-05-07,15:45:00,18252.5,BUY,1,0.02h,Stop Loss,$-6.00,$50.75,$77446.00,90,$50.75
2024-05-07,16:23:00,18251.0,SELL,1,0.02h,Break Even,$0.25,$51.00,$77446.25,90,$51.00
2024-05-07,16:25:00,18257.5,BUY,1,0.02h,Break Even,$0.25,$51.25,$77446.50,90,$51.25
2024-05-07,16:32:00,18250.5,SELL,1,0.02h,Break Even,$0.25,$51.50,$77446.75,90,$51.50
2024-05-07,16:44:00,18258.25,BUY,1,0.02h,Stop Loss,$-6.00,$45.50,$77440.75,90,$45.50
2024-05-07,16:46:00,18245.75,SELL,1,0.02h,Break Even,$0.25,$45.75,$77441.00,90,$45.75
2024-05-07,17:09:00,18244.75,BUY,1,0.02h,Break Even,$0.25,$46.00,$77441.25,90,$46.00
2024-05-07,17:18:00,18240.0,SELL,1,0.02h,Stop Loss,$9.00,$55.00,$77450.25,90,$55.00
2024-05-07,17:21:00,18247.75,BUY,1,0.02h,Stop Loss,$4.00,$59.00,$77454.25,90,$59.00
2024-05-07,17:41:00,18240.75,SELL,1,0.02h,Stop Loss,$-6.00,$53.00,$77448.25,90,$53.00
2024-05-07,18:45:00,18191.5,BUY,1,0.02h,Stop Loss,$-6.00,$47.00,$77442.25,90,$47.00
2024-05-07,19:19:00,18186.5,SELL,1,0.02h,Stop Loss,$-6.00,$41.00,$77436.25,90,$41.00
2024-05-07,19:22:00,18201.25,BUY,1,0.02h,Stop Loss,$-6.00,$35.00,$77430.25,90,$35.00
2024-05-07,19:33:00,18192.0,SELL,1,0.02h,Break Even,$0.25,$35.25,$77430.50,90,$35.25
2024-05-07,19:37:00,18201.5,BUY,1,0.02h,Break Even,$0.25,$35.50,$77430.75,90,$35.50
2024-05-07,19:39:00,18195.0,SELL,1,0.02h,Break Even,$0.25,$35.75,$77431.00,90,$35.75
2024-05-07,19:40:00,18202.25,BUY,1,0.02h,Break Even,$0.25,$36.00,$77431.25,90,$36.00
2024-05-07,19:43:00,18193.25,SELL,1,0.02h,Break Even,$0.25,$36.25,$77431.50,90,$36.25
2024-05-07,19:49:00,18201.5,BUY,1,0.02h,Stop Loss,$7.75,$44.00,$77439.25,90,$44.00
2024-05-07,20:03:00,18199.5,SELL,1,0.02h,Stop Loss,$-6.00,$38.00,$77433.25,90,$38.00
2024-05-07,20:06:00,18208.5,BUY,1,0.02h,Break Even,$0.25,$38.25,$77433.50,90,$38.25
2024-05-07,20:31:00,18207.0,SELL,1,0.02h,Break Even,$0.25,$38.50,$77433.75,90,$38.50
2024-05-07,22:23:00,18193.75,BUY,1,0.02h,Break Even,$0.25,$38.75,$77434.00,90,$38.75
Final P&L Day: 38.75,,,,,,,,,,,
2024-05-08,12:00:00,18152.5,SELL,1,0.02h,Stop Loss,$26.50,$26.50,$77460.50,91,$26.50
2024-05-08,13:18:00,18091.0,BUY,1,0.02h,Stop Loss,$-6.00,$20.50,$77454.50,91,$20.50
2024-05-08,13:19:00,18088.25,SELL,1,0.02h,Break Even,$0.25,$20.75,$77454.75,91,$20.75
2024-05-08,13:28:00,18092.25,BUY,1,0.02h,Break Even,$0.25,$21.00,$77455.00,91,$21.00
2024-05-08,13:30:00,18083.25,SELL,1,0.02h,Stop Loss,$5.25,$26.25,$77460.25,91,$26.25
2024-05-08,13:31:00,18097.25,BUY,1,0.02h,Stop Loss,$41.50,$67.75,$77501.75,91,$67.75
2024-05-08,15:06:00,18208.0,SELL,1,0.02h,Break Even,$0.25,$68.00,$77502.00,91,$68.00
2024-05-08,16:19:00,18182.75,BUY,1,0.02h,Stop Loss,$19.00,$87.00,$77521.00,91,$87.00
2024-05-08,16:36:00,18160.25,SELL,1,0.02h,Stop Loss,$10.25,$97.25,$77531.25,91,$97.25
2024-05-08,16:50:00,18176.0,BUY,1,0.02h,Stop Loss,$-6.00,$91.25,$77525.25,91,$91.25
2024-05-08,16:51:00,18169.75,SELL,1,0.02h,Break Even,$0.25,$91.50,$77525.50,91,$91.50
2024-05-08,17:44:00,18159.75,BUY,1,0.02h,Stop Loss,$22.75,$114.25,$77548.25,91,$114.25
2024-05-08,18:27:00,18176.5,SELL,1,0.02h,Stop Loss,$-6.00,$108.25,$77542.25,91,$108.25
2024-05-08,18:29:00,18186.0,BUY,1,0.02h,Stop Loss,$-6.00,$102.25,$77536.25,91,$102.25
2024-05-08,18:42:00,18176.5,SELL,1,0.02h,Break Even,$0.25,$102.50,$77536.50,91,$102.50
2024-05-08,19:18:00,18180.25,BUY,1,0.02h,Break Even,$0.25,$102.75,$77536.75,91,$102.75
2024-05-08,20:01:00,18178.0,SELL,1,0.02h,Stop Loss,$-6.00,$96.75,$77530.75,91,$96.75
2024-05-08,20:55:00,18161.0,BUY,1,0.02h,Break Even,$0.25,$97.00,$77531.00,91,$97.00
2024-05-08,22:03:00,18158.75,SELL,1,0.02h,Break Even,$0.25,$97.25,$77531.25,91,$97.25
2024-05-08,22:06:00,18163.5,BUY,1,0.02h,Break Even,$0.25,$97.50,$77531.50,91,$97.50
2024-05-08,22:43:00,18168.25,SELL,1,0.03h,Break Even,$0.25,$97.75,$77531.75,91,$97.75
Final P&L Day: 97.75,,,,,,,,,,,
2024-05-09,12:25:00,18159.25,BUY,1,0.02h,Break Even,$0.25,$0.25,$77532.00,92,$0.25
2024-05-09,13:23:00,18196.75,SELL,1,0.02h,Break Even,$0.25,$0.50,$77532.25,92,$0.50
2024-05-09,14:01:00,18160.5,BUY,1,0.02h,Stop Loss,$14.00,$14.50,$77546.25,92,$14.50
2024-05-09,14:17:00,18148.5,SELL,1,0.02h,Stop Loss,$7.75,$22.25,$77554.00,92,$22.25
2024-05-09,14:26:00,18160.5,BUY,1,0.02h,Stop Loss,$21.50,$43.75,$77575.50,92,$43.75
2024-05-09,14:30:00,18151.25,SELL,1,0.02h,Stop Loss,$-6.00,$37.75,$77569.50,92,$37.75
2024-05-09,14:31:00,18166.25,BUY,1,0.02h,Stop Loss,$21.50,$59.25,$77591.00,92,$59.25
2024-05-09,15:42:00,18212.0,SELL,1,0.02h,Stop Loss,$-6.00,$53.25,$77585.00,92,$53.25
2024-05-09,16:15:00,18199.25,BUY,1,0.02h,Break Even,$0.25,$53.50,$77585.25,92,$53.50
2024-05-09,16:34:00,18185.5,SELL,1,0.02h,Stop Loss,$10.25,$63.75,$77595.50,92,$63.75
2024-05-09,16:38:00,18205.5,BUY,1,0.02h,Break Even,$0.25,$64.00,$77595.75,92,$64.00
2024-05-09,17:20:00,18215.25,SELL,1,0.02h,Stop Loss,$119.00,$183.00,$77714.75,92,$183.00
2024-05-09,17:31:00,18215.75,BUY,1,0.02h,Break Even,$0.25,$183.25,$77715.00,92,$183.25
2024-05-09,17:38:00,18212.5,SELL,1,0.02h,Stop Loss,$-6.00,$177.25,$77709.00,92,$177.25
2024-05-09,17:39:00,18215.0,BUY,1,0.02h,Stop Loss,$-6.00,$171.25,$77703.00,92,$171.25
2024-05-09,17:42:00,18213.0,SELL,1,0.02h,Break Even,$0.25,$171.50,$77703.25,92,$171.50
2024-05-09,17:45:00,18218.25,BUY,1,0.02h,Stop Loss,$11.50,$183.00,$77714.75,92,$183.00
2024-05-09,17:49:00,18209.25,SELL,1,0.02h,Stop Loss,$-6.00,$177.00,$77708.75,92,$177.00
2024-05-09,18:28:00,18213.75,BUY,1,0.02h,Stop Loss,$4.00,$181.00,$77712.75,92,$181.00
2024-05-09,19:11:00,18222.5,SELL,1,0.02h,Stop Loss,$12.75,$193.75,$77725.50,92,$193.75
2024-05-09,19:54:00,18211.5,BUY,1,0.02h,Break Even,$0.25,$194.00,$77725.75,92,$194.00
2024-05-09,19:56:00,18201.5,SELL,1,0.02h,Stop Loss,$7.75,$201.75,$77733.50,92,$201.75
2024-05-09,20:00:00,18215.75,BUY,1,0.02h,Stop Loss,$-6.00,$195.75,$77727.50,92,$195.75
2024-05-09,20:37:00,18228.0,SELL,1,0.03h,Break Even,$0.25,$196.00,$77727.75,92,$196.00
2024-05-09,20:40:00,18230.0,BUY,1,0.05h,Break Even,$0.25,$196.25,$77728.00,92,$196.25
2024-05-09,20:52:00,18228.25,SELL,1,0.02h,Break Even,$0.25,$196.50,$77728.25,92,$196.50
2024-05-09,22:13:00,18227.5,BUY,1,0.02h,Break Even,$0.25,$196.75,$77728.50,92,$196.75
Final P&L Day: 196.75,,,,,,,,,,,
2024-05-10,12:38:00,18277.75,SELL,1,0.02h,Stop Loss,$7.75,$7.75,$77736.25,93,$7.75
2024-05-10,13:11:00,18269.75,BUY,1,0.02h,Stop Loss,$-6.00,$1.75,$77730.25,93,$1.75
2024-05-10,14:02:00,18293.75,SELL,1,0.02h,Break Even,$0.25,$2.00,$77730.50,93,$2.00
2024-05-10,15:16:00,18232.0,BUY,1,0.02h,Break Even,$0.25,$2.25,$77730.75,93,$2.25
2024-05-10,15:38:00,18215.0,SELL,1,0.02h,Stop Loss,$-6.00,$-3.75,$77724.75,93,$-3.75
2024-05-10,15:53:00,18227.5,BUY,1,0.02h,Stop Loss,$24.00,$20.25,$77748.75,93,$20.25
2024-05-10,16:05:00,18214.0,SELL,1,0.02h,Stop Loss,$-6.00,$14.25,$77742.75,93,$14.25
2024-05-10,16:11:00,18227.75,BUY,1,0.02h,Break Even,$0.25,$14.50,$77743.00,93,$14.50
2024-05-10,16:37:00,18226.25,SELL,1,0.02h,Stop Loss,$5.25,$19.75,$77748.25,93,$19.75
2024-05-10,16:49:00,18246.5,BUY,1,0.02h,Stop Loss,$10.25,$30.00,$77758.50,93,$30.00
2024-05-10,17:06:00,18235.75,SELL,1,0.02h,Break Even,$0.25,$30.25,$77758.75,93,$30.25
2024-05-10,17:38:00,18231.75,BUY,1,0.02h,Break Even,$0.25,$30.50,$77759.00,93,$30.50
2024-05-10,17:39:00,18225.0,SELL,1,0.02h,Stop Loss,$-6.00,$24.50,$77753.00,93,$24.50
2024-05-10,17:53:00,18235.25,BUY,1,0.02h,Break Even,$0.25,$24.75,$77753.25,93,$24.75
2024-05-10,18:28:00,18247.25,SELL,1,0.02h,Stop Loss,$-6.00,$18.75,$77747.25,93,$18.75
2024-05-10,18:49:00,18248.25,BUY,1,0.02h,Stop Loss,$-6.00,$12.75,$77741.25,93,$12.75
2024-05-10,19:45:00,18250.75,SELL,1,0.02h,Break Even,$0.25,$13.00,$77741.50,93,$13.00
2024-05-10,19:55:00,18265.0,BUY,1,0.02h,Break Even,$0.25,$13.25,$77741.75,93,$13.25
2024-05-10,20:02:00,18248.5,SELL,1,0.02h,Break Even,$0.25,$13.50,$77742.00,93,$13.50
Final P&L Day: 13.50,,,,,,,,,,,
2024-05-13,12:00:00,18318.0,BUY,1,0.02h,Break Even,$0.25,$0.25,$77742.25,94,$0.25
2024-05-13,13:03:00,18312.25,SELL,1,0.02h,Stop Loss,$20.25,$20.50,$77762.50,94,$20.50
2024-05-13,13:14:00,18321.5,BUY,1,0.02h,Break Even,$0.25,$20.75,$77762.75,94,$20.75
2024-05-13,13:34:00,18310.5,SELL,1,0.02h,Stop Loss,$77.75,$98.50,$77840.50,94,$98.50
2024-05-13,14:04:00,18293.25,BUY,1,0.02h,Stop Loss,$16.50,$115.00,$77857.00,94,$115.00
2024-05-13,14:33:00,18288.25,SELL,1,0.02h,Stop Loss,$-6.00,$109.00,$77851.00,94,$109.00
2024-05-13,14:50:00,18300.25,BUY,1,0.02h,Break Even,$0.25,$109.25,$77851.25,94,$109.25
2024-05-13,15:01:00,18289.5,SELL,1,0.02h,Stop Loss,$-6.00,$103.25,$77845.25,94,$103.25
2024-05-13,15:10:00,18296.5,BUY,1,0.02h,Stop Loss,$32.75,$136.00,$77878.00,94,$136.00
2024-05-13,15:22:00,18287.0,SELL,1,0.02h,Stop Loss,$9.00,$145.00,$77887.00,94,$145.00
2024-05-13,15:53:00,18289.0,BUY,1,0.02h,Break Even,$0.25,$145.25,$77887.25,94,$145.25
2024-05-13,16:43:00,18297.25,SELL,1,0.02h,Stop Loss,$-6.00,$139.25,$77881.25,94,$139.25
2024-05-13,17:21:00,18285.75,BUY,1,0.02h,Stop Loss,$26.50,$165.75,$77907.75,94,$165.75
2024-05-13,17:39:00,18279.25,SELL,1,0.02h,Break Even,$0.25,$166.00,$77908.00,94,$166.00
2024-05-13,17:59:00,18285.0,BUY,1,0.02h,Stop Loss,$-6.00,$160.00,$77902.00,94,$160.00
2024-05-13,18:02:00,18272.5,SELL,1,0.02h,Stop Loss,$4.00,$164.00,$77906.00,94,$164.00
2024-05-13,18:14:00,18279.0,BUY,1,0.02h,Stop Loss,$-6.00,$158.00,$77900.00,94,$158.00
2024-05-13,18:17:00,18274.0,SELL,1,0.02h,Break Even,$0.25,$158.25,$77900.25,94,$158.25
2024-05-13,18:18:00,18279.0,BUY,1,0.02h,Break Even,$0.25,$158.50,$77900.50,94,$158.50
2024-05-13,18:34:00,18278.0,SELL,1,0.02h,Stop Loss,$-6.00,$152.50,$77894.50,94,$152.50
2024-05-13,18:35:00,18284.5,BUY,1,0.02h,Break Even,$0.25,$152.75,$77894.75,94,$152.75
2024-05-13,18:50:00,18278.0,SELL,1,0.02h,Break Even,$0.25,$153.00,$77895.00,94,$153.00
2024-05-13,19:00:00,18288.0,BUY,1,0.02h,Stop Loss,$-6.00,$147.00,$77889.00,94,$147.00
2024-05-13,19:25:00,18282.0,SELL,1,0.02h,Break Even,$0.25,$147.25,$77889.25,94,$147.25
2024-05-13,19:34:00,18290.75,BUY,1,0.02h,Break Even,$0.25,$147.50,$77889.50,94,$147.50
2024-05-13,19:50:00,18287.5,SELL,1,0.02h,Stop Loss,$-6.00,$141.50,$77883.50,94,$141.50
2024-05-13,19:53:00,18298.5,BUY,1,0.02h,Break Even,$0.25,$141.75,$77883.75,94,$141.75
2024-05-13,19:57:00,18285.5,SELL,1,0.02h,Stop Loss,$-6.00,$135.75,$77877.75,94,$135.75
2024-05-13,20:01:00,18295.75,BUY,1,0.02h,Stop Loss,$6.50,$142.25,$77884.25,94,$142.25
2024-05-13,20:09:00,18288.0,SELL,1,0.02h,Break Even,$0.25,$142.50,$77884.50,94,$142.50
2024-05-13,20:27:00,18290.25,BUY,1,0.07h,Break Even,$0.25,$142.75,$77884.75,94,$142.75
2024-05-13,20:41:00,18289.5,SELL,1,0.02h,Break Even,$0.25,$143.00,$77885.00,94,$143.00
2024-05-13,22:15:00,18285.5,BUY,1,0.10h,Break Even,$0.25,$143.25,$77885.25,94,$143.25
2024-05-13,22:23:00,18281.25,SELL,1,0.02h,Break Even,$0.25,$143.50,$77885.50,94,$143.50
2024-05-13,22:48:00,18281.5,BUY,1,0.07h,Break Even,$0.25,$143.75,$77885.75,94,$143.75
Final P&L Day: 143.75,,,,,,,,,,,
2024-05-14,12:31:00,18221.0,SELL,1,0.02h,Stop Loss,$82.75,$82.75,$77968.50,95,$82.75
2024-05-14,12:54:00,18269.25,BUY,1,0.02h,Break Even,$0.25,$83.00,$77968.75,95,$83.00
2024-05-14,13:01:00,18252.5,SELL,1,0.02h,Break Even,$0.25,$83.25,$77969.00,95,$83.25
2024-05-14,13:10:00,18265.0,BUY,1,0.02h,Stop Loss,$15.25,$98.50,$77984.25,95,$98.50
2024-05-14,14:00:00,18290.0,SELL,1,0.02h,Stop Loss,$7.75,$106.25,$77992.00,95,$106.25
2024-05-14,14:12:00,18307.25,BUY,1,0.02h,Stop Loss,$22.75,$129.00,$78014.75,95,$129.00
2024-05-14,14:18:00,18286.0,SELL,1,0.02h,Stop Loss,$24.00,$153.00,$78038.75,95,$153.00
2024-05-14,14:23:00,18313.5,BUY,1,0.02h,Stop Loss,$91.50,$244.50,$78130.25,95,$244.50
2024-05-14,14:39:00,18302.5,SELL,1,0.02h,Stop Loss,$11.50,$256.00,$78141.75,95,$256.00
2024-05-14,14:58:00,18324.75,BUY,1,0.02h,Stop Loss,$51.50,$307.50,$78193.25,95,$307.50
2024-05-14,15:34:00,18337.5,SELL,1,0.02h,Stop Loss,$9.00,$316.50,$78202.25,95,$316.50
2024-05-14,16:10:00,18328.25,BUY,1,0.02h,Stop Loss,$-6.00,$310.50,$78196.25,95,$310.50
2024-05-14,16:18:00,18318.75,SELL,1,0.02h,Break Even,$0.25,$310.75,$78196.50,95,$310.75
2024-05-14,16:55:00,18311.75,BUY,1,0.02h,Break Even,$0.25,$311.00,$78196.75,95,$311.00
2024-05-14,17:07:00,18302.75,SELL,1,0.02h,Break Even,$0.25,$311.25,$78197.00,95,$311.25
2024-05-14,17:23:00,18313.5,BUY,1,0.02h,Stop Loss,$4.00,$315.25,$78201.00,95,$315.25
2024-05-14,19:50:00,18413.0,SELL,1,0.02h,Stop Loss,$-6.00,$309.25,$78195.00,95,$309.25
2024-05-14,19:52:00,18424.5,BUY,1,0.02h,Stop Loss,$9.00,$318.25,$78204.00,95,$318.25
2024-05-14,20:01:00,18412.25,SELL,1,0.02h,Break Even,$0.25,$318.50,$78204.25,95,$318.50
2024-05-14,20:51:00,18410.0,BUY,1,0.02h,Stop Loss,$-6.00,$312.50,$78198.25,95,$312.50
2024-05-14,22:04:00,18405.75,SELL,1,0.02h,Stop Loss,$-6.00,$306.50,$78192.25,95,$306.50
2024-05-14,22:06:00,18411.0,BUY,1,0.02h,Break Even,$0.25,$306.75,$78192.50,95,$306.75
Final P&L Day: 306.75,,,,,,,,,,,
2024-05-15,12:00:00,18410.75,SELL,1,0.02h,Break Even,$0.25,$0.25,$78192.75,96,$0.25
2024-05-15,12:31:00,18523.25,BUY,1,0.02h,Stop Loss,$102.75,$103.00,$78295.50,96,$103.00
2024-05-15,13:22:00,18501.25,SELL,1,0.02h,Stop Loss,$-6.00,$97.00,$78289.50,96,$97.00
2024-05-15,13:25:00,18510.25,BUY,1,0.02h,Stop Loss,$-6.00,$91.00,$78283.50,96,$91.00
2024-05-15,13:26:00,18500.0,SELL,1,0.02h,Break Even,$0.25,$91.25,$78283.75,96,$91.25
2024-05-15,13:29:00,18509.0,BUY,1,0.02h,Stop Loss,$-6.00,$85.25,$78277.75,96,$85.25
2024-05-15,13:46:00,18504.5,SELL,1,0.02h,Stop Loss,$74.00,$159.25,$78351.75,96,$159.25
2024-05-15,14:04:00,18505.75,BUY,1,0.02h,Stop Loss,$20.25,$179.50,$78372.00,96,$179.50
2024-05-15,16:01:00,18582.75,SELL,1,0.02h,Stop Loss,$-6.00,$173.50,$78366.00,96,$173.50
2024-05-15,16:12:00,18601.0,BUY,1,0.02h,Stop Loss,$-6.00,$167.50,$78360.00,96,$167.50
2024-05-15,18:29:00,18683.0,SELL,1,0.02h,Stop Loss,$-6.00,$161.50,$78354.00,96,$161.50
2024-05-15,18:41:00,18689.75,BUY,1,0.02h,Stop Loss,$-6.00,$155.50,$78348.00,96,$155.50
2024-05-15,18:45:00,18680.5,SELL,1,0.02h,Stop Loss,$4.00,$159.50,$78352.00,96,$159.50
2024-05-15,18:55:00,18687.75,BUY,1,0.02h,Stop Loss,$-6.00,$153.50,$78346.00,96,$153.50
2024-05-15,19:03:00,18681.5,SELL,1,0.02h,Break Even,$0.25,$153.75,$78346.25,96,$153.75
2024-05-15,19:06:00,18687.5,BUY,1,0.02h,Stop Loss,$-6.00,$147.75,$78340.25,96,$147.75
2024-05-15,19:34:00,18688.5,SELL,1,0.02h,Break Even,$0.25,$148.00,$78340.50,96,$148.00
2024-05-15,19:57:00,18695.5,BUY,1,0.02h,Stop Loss,$11.50,$159.50,$78352.00,96,$159.50
2024-05-15,20:01:00,18681.5,SELL,1,0.02h,Stop Loss,$15.25,$174.75,$78367.25,96,$174.75
2024-05-15,20:31:00,18686.0,BUY,1,0.02h,Break Even,$0.25,$175.00,$78367.50,96,$175.00
2024-05-15,20:51:00,18684.75,SELL,1,0.02h,Break Even,$0.25,$175.25,$78367.75,96,$175.25
2024-05-15,20:57:00,18692.25,BUY,1,1.07h,Stop Loss,$19.00,$194.25,$78386.75,96,$194.25
2024-05-15,22:58:00,18698.75,SELL,1,0.02h,Stop Loss,$-6.00,$188.25,$78380.75,96,$188.25
Final P&L Day: 188.25,,,,,,,,,,,
2024-05-16,12:00:00,18715.0,BUY,1,0.02h,Stop Loss,$-6.00,$-6.00,$78374.75,97,$-6.00
2024-05-16,12:33:00,18709.25,SELL,1,0.02h,Stop Loss,$19.00,$13.00,$78393.75,97,$13.00
2024-05-16,13:39:00,18692.75,BUY,1,0.02h,Break Even,$0.25,$13.25,$78394.00,97,$13.25
2024-05-16,14:07:00,18691.0,SELL,1,0.02h,Stop Loss,$71.50,$84.75,$78465.50,97,$84.75
2024-05-16,14:19:00,18702.75,BUY,1,0.02h,Stop Loss,$14.00,$98.75,$78479.50,97,$98.75
2024-05-16,15:17:00,18732.0,SELL,1,0.02h,Stop Loss,$6.50,$105.25,$78486.00,97,$105.25
2024-05-16,15:31:00,18744.25,BUY,1,0.02h,Break Even,$0.25,$105.50,$78486.25,97,$105.50
2024-05-16,15:41:00,18734.25,SELL,1,0.02h,Break Even,$0.25,$105.75,$78486.50,97,$105.75
2024-05-16,15:53:00,18742.0,BUY,1,0.02h,Stop Loss,$4.00,$109.75,$78490.50,97,$109.75
2024-05-16,16:01:00,18731.75,SELL,1,0.02h,Stop Loss,$91.50,$201.25,$78582.00,97,$201.25
2024-05-16,16:46:00,18727.0,BUY,1,0.02h,Break Even,$0.25,$201.50,$78582.25,97,$201.50
2024-05-16,17:05:00,18724.0,SELL,1,0.02h,Break Even,$0.25,$201.75,$78582.50,97,$201.75
2024-05-16,17:09:00,18732.0,BUY,1,0.02h,Break Even,$0.25,$202.00,$78582.75,97,$202.00
2024-05-16,17:21:00,18719.5,SELL,1,0.02h,Stop Loss,$111.50,$313.50,$78694.25,97,$313.50
2024-05-16,17:55:00,18706.25,BUY,1,0.02h,Break Even,$0.25,$313.75,$78694.50,97,$313.75
2024-05-16,18:07:00,18688.5,SELL,1,0.02h,Stop Loss,$16.50,$330.25,$78711.00,97,$330.25
2024-05-16,18:35:00,18685.0,BUY,1,0.02h,Stop Loss,$7.75,$338.00,$78718.75,97,$338.00
2024-05-16,18:58:00,18687.0,SELL,1,0.02h,Stop Loss,$-6.00,$332.00,$78712.75,97,$332.00
2024-05-16,19:00:00,18695.25,BUY,1,0.02h,Break Even,$0.25,$332.25,$78713.00,97,$332.25
2024-05-16,19:19:00,18690.0,SELL,1,0.02h,Stop Loss,$-6.00,$326.25,$78707.00,97,$326.25
2024-05-16,19:55:00,18687.5,BUY,1,0.02h,Stop Loss,$-6.00,$320.25,$78701.00,97,$320.25
2024-05-16,19:57:00,18665.0,SELL,1,0.02h,Break Even,$0.25,$320.50,$78701.25,97,$320.50
2024-05-16,20:45:00,18642.0,BUY,1,0.02h,Stop Loss,$-6.00,$314.50,$78695.25,97,$314.50
2024-05-16,20:53:00,18639.0,SELL,1,0.03h,Break Even,$0.25,$314.75,$78695.50,97,$314.75
2024-05-16,22:01:00,18646.0,BUY,1,0.02h,Stop Loss,$-6.00,$308.75,$78689.50,97,$308.75
2024-05-16,22:35:00,18643.75,SELL,1,0.02h,Stop Loss,$-6.00,$302.75,$78683.50,97,$302.75
2024-05-16,22:42:00,18648.75,BUY,1,0.02h,Break Even,$0.25,$303.00,$78683.75,97,$303.00
Final P&L Day: 303.00,,,,,,,,,,,
2024-05-17,13:05:00,18677.75,SELL,1,0.02h,Break Even,$0.25,$0.25,$78684.00,98,$0.25
2024-05-17,14:06:00,18645.5,BUY,1,0.02h,Stop Loss,$-6.00,$-5.75,$78678.00,98,$-5.75
2024-05-17,14:07:00,18635.0,SELL,1,0.02h,Stop Loss,$12.75,$7.00,$78690.75,98,$7.00
2024-05-17,14:22:00,18646.75,BUY,1,0.02h,Stop Loss,$5.25,$12.25,$78696.00,98,$12.25
2024-05-17,15:01:00,18658.5,SELL,1,0.02h,Stop Loss,$10.25,$22.50,$78706.25,98,$22.50
2024-05-17,15:30:00,18654.75,BUY,1,0.02h,Stop Loss,$-6.00,$16.50,$78700.25,98,$16.50
2024-05-17,15:32:00,18647.0,SELL,1,0.02h,Stop Loss,$7.75,$24.25,$78708.00,98,$24.25
2024-05-17,15:56:00,18646.0,BUY,1,0.02h,Break Even,$0.25,$24.50,$78708.25,98,$24.50
2024-05-17,16:13:00,18643.25,SELL,1,0.02h,Break Even,$0.25,$24.75,$78708.50,98,$24.75
2024-05-17,16:55:00,18637.75,BUY,1,0.02h,Break Even,$0.25,$25.00,$78708.75,98,$25.00
2024-05-17,17:07:00,18630.0,SELL,1,0.02h,Stop Loss,$-6.00,$19.00,$78702.75,98,$19.00
2024-05-17,17:43:00,18626.0,BUY,1,0.02h,Break Even,$0.25,$19.25,$78703.00,98,$19.25
2024-05-17,17:48:00,18620.0,SELL,1,0.02h,Stop Loss,$-6.00,$13.25,$78697.00,98,$13.25
2024-05-17,18:39:00,18581.25,BUY,1,0.02h,Stop Loss,$6.50,$19.75,$78703.50,98,$19.75
2024-05-17,18:45:00,18577.0,SELL,1,0.02h,Stop Loss,$-6.00,$13.75,$78697.50,98,$13.75
2024-05-17,18:49:00,18585.75,BUY,1,0.02h,Stop Loss,$19.00,$32.75,$78716.50,98,$32.75
2024-05-17,19:47:00,18626.5,SELL,1,0.02h,Break Even,$0.25,$33.00,$78716.75,98,$33.00
2024-05-17,19:53:00,18631.0,BUY,1,0.02h,Break Even,$0.25,$33.25,$78717.00,98,$33.25
2024-05-17,19:57:00,18625.0,SELL,1,0.02h,Stop Loss,$15.25,$48.50,$78732.25,98,$48.50
2024-05-17,20:00:00,18638.5,BUY,1,0.02h,Break Even,$0.25,$48.75,$78732.50,98,$48.75
2024-05-17,20:01:00,18623.25,SELL,1,0.02h,Break Even,$0.25,$49.00,$78732.75,98,$49.00
2024-05-17,20:19:00,18628.75,BUY,1,0.02h,Break Even,$0.25,$49.25,$78733.00,98,$49.25
Final P&L Day: 49.25,,,,,,,,,,,
2024-05-20,12:29:00,18673.25,SELL,1,0.02h,Break Even,$0.25,$0.25,$78733.25,99,$0.25
2024-05-20,13:16:00,18652.5,BUY,1,0.02h,Break Even,$0.25,$0.50,$78733.50,99,$0.50
2024-05-20,13:26:00,18645.25,SELL,1,0.02h,Stop Loss,$12.75,$13.25,$78746.25,99,$13.25
2024-05-20,13:33:00,18665.5,BUY,1,0.02h,Stop Loss,$62.75,$76.00,$78809.00,99,$76.00
2024-05-20,14:58:00,18742.5,SELL,1,0.02h,Stop Loss,$10.25,$86.25,$78819.25,99,$86.25
2024-05-20,15:26:00,18752.5,BUY,1,0.02h,Stop Loss,$-6.00,$80.25,$78813.25,99,$80.25
2024-05-20,15:44:00,18740.5,SELL,1,0.02h,Break Even,$0.25,$80.50,$78813.50,99,$80.50
2024-05-20,16:03:00,18748.5,BUY,1,0.02h,Stop Loss,$-6.00,$74.50,$78807.50,99,$74.50
2024-05-20,16:16:00,18745.5,SELL,1,0.02h,Stop Loss,$5.25,$79.75,$78812.75,99,$79.75
2024-05-20,16:19:00,18752.0,BUY,1,0.02h,Stop Loss,$-6.00,$73.75,$78806.75,99,$73.75
2024-05-20,16:25:00,18746.25,SELL,1,0.02h,Break Even,$0.25,$74.00,$78807.00,99,$74.00
2024-05-20,16:33:00,18752.5,BUY,1,0.02h,Stop Loss,$-6.00,$68.00,$78801.00,99,$68.00
2024-05-20,17:21:00,18776.25,SELL,1,0.02h,Stop Loss,$14.00,$82.00,$78815.00,99,$82.00
2024-05-20,18:28:00,18745.25,BUY,1,0.02h,Break Even,$0.25,$82.25,$78815.25,99,$82.25
2024-05-20,18:59:00,18752.75,SELL,1,0.02h,Stop Loss,$10.25,$92.50,$78825.50,99,$92.50
2024-05-20,19:06:00,18760.0,BUY,1,0.02h,Stop Loss,$-6.00,$86.50,$78819.50,99,$86.50
2024-05-20,19:37:00,18765.25,SELL,1,0.02h,Break Even,$0.25,$86.75,$78819.75,99,$86.75
2024-05-20,20:02:00,18773.0,BUY,1,0.02h,Stop Loss,$-6.00,$80.75,$78813.75,99,$80.75
2024-05-20,20:07:00,18748.5,SELL,1,0.02h,Break Even,$0.25,$81.00,$78814.00,99,$81.00
2024-05-20,20:35:00,18748.75,BUY,1,0.02h,Break Even,$0.25,$81.25,$78814.25,99,$81.25
2024-05-20,20:46:00,18744.25,SELL,1,0.02h,Break Even,$0.25,$81.50,$78814.50,99,$81.50
2024-05-20,20:55:00,18748.0,BUY,1,0.02h,Stop Loss,$-6.00,$75.50,$78808.50,99,$75.50
2024-05-20,21:00:00,18745.5,SELL,1,1.02h,Break Even,$0.25,$75.75,$78808.75,99,$75.75
2024-05-20,22:01:00,18752.25,BUY,1,0.02h,Break Even,$0.25,$76.00,$78809.00,99,$76.00
2024-05-20,22:21:00,18748.75,SELL,1,0.02h,Stop Loss,$-6.00,$70.00,$78803.00,99,$70.00
Final P&L Day: 70.00,,,,,,,,,,,
2024-05-21,12:00:00,18750.5,BUY,1,0.02h,Stop Loss,$-6.00,$-6.00,$78797.00,100,$-6.00
2024-05-21,12:16:00,18742.5,SELL,1,0.02h,Break Even,$0.25,$-5.75,$78797.25,100,$-5.75
2024-05-21,13:37:00,18712.5,BUY,1,0.02h,Stop Loss,$-6.00,$-11.75,$78791.25,100,$-11.75
2024-05-21,13:47:00,18685.0,SELL,1,0.02h,Stop Loss,$-6.00,$-17.75,$78785.25,100,$-17.75
2024-05-21,13:53:00,18712.5,BUY,1,0.02h,Stop Loss,$9.00,$-8.75,$78794.25,100,$-8.75
2024-05-21,15:33:00,18748.0,SELL,1,0.02h,Stop Loss,$-6.00,$-14.75,$78788.25,100,$-14.75
2024-05-21,16:07:00,18748.25,BUY,1,0.02h,Break Even,$0.25,$-14.50,$78788.50,100,$-14.50
2024-05-21,16:36:00,18757.75,SELL,1,0.02h,Break Even,$0.25,$-14.25,$78788.75,100,$-14.25
2024-05-21,17:28:00,18751.5,BUY,1,0.02h,Stop Loss,$10.25,$-4.00,$78799.00,100,$-4.00
2024-05-21,18:18:00,18767.5,SELL,1,0.02h,Stop Loss,$-6.00,$-10.00,$78793.00,100,$-10.00
2024-05-21,18:53:00,18768.25,BUY,1,0.02h,Stop Loss,$-6.00,$-16.00,$78787.00,100,$-16.00
2024-05-21,19:28:00,18769.75,SELL,1,0.02h,Stop Loss,$-6.00,$-22.00,$78781.00,100,$-22.00
2024-05-21,19:32:00,18781.25,BUY,1,0.02h,Break Even,$0.25,$-21.75,$78781.25,100,$-21.75
2024-05-21,19:51:00,18781.0,SELL,1,0.02h,Break Even,$0.25,$-21.50,$78781.50,100,$-21.50
2024-05-21,19:53:00,18791.25,BUY,1,0.02h,Break Even,$0.25,$-21.25,$78781.75,100,$-21.25
2024-05-21,20:57:00,18803.5,SELL,1,0.02h,Break Even,$0.25,$-21.00,$78782.00,100,$-21.00
2024-05-21,22:21:00,18803.25,BUY,1,0.02h,Break Even,$0.25,$-20.75,$78782.25,100,$-20.75
Final P&L Day: -20.75,,,,,,,,,,,
2024-05-22,12:00:00,18792.5,SELL,1,0.02h,Stop Loss,$-6.00,$-6.00,$78776.25,101,$-6.00
2024-05-22,12:41:00,18796.75,BUY,1,0.02h,Stop Loss,$-6.00,$-12.00,$78770.25,101,$-12.00
2024-05-22,13:10:00,18795.5,SELL,1,0.02h,Break Even,$0.25,$-11.75,$78770.50,101,$-11.75
2024-05-22,13:19:00,18807.0,BUY,1,0.02h,Break Even,$0.25,$-11.50,$78770.75,101,$-11.50
2024-05-22,13:42:00,18799.0,SELL,1,0.02h,Stop Loss,$7.75,$-3.75,$78778.50,101,$-3.75
2024-05-22,13:47:00,18816.5,BUY,1,0.02h,Break Even,$0.25,$-3.50,$78778.75,101,$-3.50
2024-05-22,14:09:00,18811.25,SELL,1,0.02h,Stop Loss,$-6.00,$-9.50,$78772.75,101,$-9.50
2024-05-22,14:15:00,18825.0,BUY,1,0.02h,Stop Loss,$4.00,$-5.50,$78776.75,101,$-5.50
2024-05-22,14:23:00,18806.25,SELL,1,0.02h,Stop Loss,$-6.00,$-11.50,$78770.75,101,$-11.50
2024-05-22,14:42:00,18816.5,BUY,1,0.02h,Stop Loss,$10.25,$-1.25,$78781.00,101,$-1.25
2024-05-22,14:44:00,18808.75,SELL,1,0.02h,Stop Loss,$20.25,$19.00,$78801.25,101,$19.00
2024-05-22,14:58:00,18818.75,BUY,1,0.02h,Stop Loss,$6.50,$25.50,$78807.75,101,$25.50
2024-05-22,15:42:00,18831.5,SELL,1,0.03h,Break Even,$0.25,$25.75,$78808.00,101,$25.75
2024-05-22,16:09:00,18828.0,BUY,1,0.02h,Stop Loss,$-6.00,$19.75,$78802.00,101,$19.75
2024-05-22,16:27:00,18823.0,SELL,1,0.02h,Break Even,$0.25,$20.00,$78802.25,101,$20.00
2024-05-22,17:07:00,18809.25,BUY,1,0.02h,Break Even,$0.25,$20.25,$78802.50,101,$20.25
2024-05-22,17:33:00,18810.75,SELL,1,0.02h,Stop Loss,$10.25,$30.50,$78812.75,101,$30.50
2024-05-22,18:49:00,18721.75,BUY,1,0.02h,Stop Loss,$44.00,$74.50,$78856.75,101,$74.50
2024-05-22,19:20:00,18702.25,SELL,1,0.02h,Stop Loss,$-6.00,$68.50,$78850.75,101,$68.50
2024-05-22,19:25:00,18737.5,BUY,1,0.02h,Break Even,$0.25,$68.75,$78851.00,101,$68.75
2024-05-22,19:47:00,18745.0,SELL,1,0.02h,Break Even,$0.25,$69.00,$78851.25,101,$69.00
2024-05-22,19:57:00,18762.25,BUY,1,0.02h,Stop Loss,$31.50,$100.50,$78882.75,101,$100.50
2024-05-22,20:34:00,18800.25,SELL,1,0.02h,Stop Loss,$156.50,$257.00,$79039.25,101,$257.00
2024-05-22,20:45:00,18821.0,BUY,1,0.02h,Stop Loss,$14.00,$271.00,$79053.25,101,$271.00
Final P&L Day: 271.00,,,,,,,,,,,
2024-05-23,12:59:00,19005.5,SELL,1,0.02h,Break Even,$0.25,$0.25,$79053.50,102,$0.25
2024-05-23,14:13:00,18898.0,BUY,1,0.02h,Stop Loss,$12.75,$13.00,$79066.25,102,$13.00
2024-05-23,14:23:00,18864.0,SELL,1,0.02h,Stop Loss,$-6.00,$7.00,$79060.25,102,$7.00
2024-05-23,14:32:00,18888.0,BUY,1,0.02h,Stop Loss,$87.75,$94.75,$79148.00,102,$94.75
2024-05-23,14:47:00,18885.75,SELL,1,0.02h,Stop Loss,$56.50,$151.25,$79204.50,102,$151.25
2024-05-23,15:09:00,18870.5,BUY,1,0.02h,Stop Loss,$85.25,$236.50,$79289.75,102,$236.50
2024-05-23,16:09:00,18910.0,SELL,1,0.02h,Stop Loss,$19.00,$255.50,$79308.75,102,$255.50
2024-05-23,16:24:00,18913.5,BUY,1,0.02h,Stop Loss,$10.25,$265.75,$79319.00,102,$265.75
2024-05-23,16:43:00,18909.0,SELL,1,0.02h,Stop Loss,$31.50,$297.25,$79350.50,102,$297.25
2024-05-23,19:18:00,18654.5,BUY,1,0.02h,Stop Loss,$10.25,$307.50,$79360.75,102,$307.50
2024-05-23,20:26:00,18689.25,SELL,1,0.07h,Stop Loss,$-6.00,$301.50,$79354.75,102,$301.50
2024-05-23,22:01:00,18687.75,BUY,1,0.02h,Stop Loss,$-6.00,$295.50,$79348.75,102,$295.50
2024-05-23,22:15:00,18683.75,SELL,1,0.02h,Break Even,$0.25,$295.75,$79349.00,102,$295.75
2024-05-23,22:21:00,18689.75,BUY,1,0.02h,Stop Loss,$-6.00,$289.75,$79343.00,102,$289.75
Final P&L Day: 289.75,,,,,,,,,,,
2024-05-24,12:26:00,18728.75,SELL,1,0.02h,Break Even,$0.25,$0.25,$79343.25,103,$0.25
2024-05-24,12:32:00,18745.25,BUY,1,0.02h,Stop Loss,$30.25,$30.50,$79373.50,103,$30.50
2024-05-24,12:55:00,18745.75,SELL,1,0.02h,Break Even,$0.25,$30.75,$79373.75,103,$30.75
2024-05-24,13:02:00,18766.0,BUY,1,0.02h,Break Even,$0.25,$31.00,$79374.00,103,$31.00
2024-05-24,13:07:00,18751.0,SELL,1,0.02h,Break Even,$0.25,$31.25,$79374.25,103,$31.25
2024-05-24,13:29:00,18761.0,BUY,1,0.02h,Stop Loss,$29.00,$60.25,$79403.25,103,$60.25
2024-05-24,13:41:00,18745.0,SELL,1,0.02h,Stop Loss,$6.50,$66.75,$79409.75,103,$66.75
2024-05-24,13:43:00,18759.5,BUY,1,0.02h,Stop Loss,$44.00,$110.75,$79453.75,103,$110.75
2024-05-24,13:53:00,18748.5,SELL,1,0.02h,Stop Loss,$40.25,$151.00,$79494.00,103,$151.00
2024-05-24,14:01:00,18792.25,BUY,1,0.02h,Stop Loss,$12.75,$163.75,$79506.75,103,$163.75
2024-05-24,15:39:00,18893.0,SELL,1,0.02h,Stop Loss,$27.75,$191.50,$79534.50,103,$191.50
2024-05-24,15:45:00,18906.5,BUY,1,0.02h,Stop Loss,$-6.00,$185.50,$79528.50,103,$185.50
2024-05-24,15:46:00,18900.0,SELL,1,0.02h,Stop Loss,$9.00,$194.50,$79537.50,103,$194.50
2024-05-24,16:08:00,18900.75,BUY,1,0.02h,Break Even,$0.25,$194.75,$79537.75,103,$194.75
2024-05-24,16:09:00,18893.5,SELL,1,0.02h,Stop Loss,$-6.00,$188.75,$79531.75,103,$188.75
2024-05-24,16:11:00,18900.5,BUY,1,0.02h,Stop Loss,$6.50,$195.25,$79538.25,103,$195.25
2024-05-24,16:37:00,18894.75,SELL,1,0.02h,Stop Loss,$-6.00,$189.25,$79532.25,103,$189.25
2024-05-24,16:55:00,18909.0,BUY,1,0.02h,Stop Loss,$-6.00,$183.25,$79526.25,103,$183.25
2024-05-24,16:57:00,18889.75,SELL,1,0.02h,Stop Loss,$4.00,$187.25,$79530.25,103,$187.25
2024-05-24,17:21:00,18889.25,BUY,1,0.02h,Stop Loss,$-6.00,$181.25,$79524.25,103,$181.25
2024-05-24,17:22:00,18885.75,SELL,1,0.02h,Stop Loss,$-6.00,$175.25,$79518.25,103,$175.25
2024-05-24,17:23:00,18891.25,BUY,1,0.02h,Stop Loss,$-6.00,$169.25,$79512.25,103,$169.25
2024-05-24,17:34:00,18882.5,SELL,1,0.02h,Break Even,$0.25,$169.50,$79512.50,103,$169.50
2024-05-24,17:52:00,18895.75,BUY,1,0.02h,Stop Loss,$-6.00,$163.50,$79506.50,103,$163.50
2024-05-24,18:24:00,18903.25,SELL,1,0.02h,Stop Loss,$29.00,$192.50,$79535.50,103,$192.50
2024-05-24,19:28:00,18869.5,BUY,1,0.02h,Stop Loss,$-6.00,$186.50,$79529.50,103,$186.50
2024-05-24,19:30:00,18862.25,SELL,1,0.02h,Stop Loss,$12.75,$199.25,$79542.25,103,$199.25
2024-05-24,19:32:00,18872.5,BUY,1,0.02h,Stop Loss,$-6.00,$193.25,$79536.25,103,$193.25
2024-05-24,19:46:00,18866.5,SELL,1,0.02h,Break Even,$0.25,$193.50,$79536.50,103,$193.50
2024-05-24,20:00:00,18874.0,BUY,1,0.02h,Stop Loss,$16.50,$210.00,$79553.00,103,$210.00
2024-05-24,20:21:00,18867.25,SELL,1,0.02h,Stop Loss,$-6.00,$204.00,$79547.00,103,$204.00
2024-05-24,20:26:00,18870.25,BUY,1,0.02h,Stop Loss,$-6.00,$198.00,$79541.00,103,$198.00
2024-05-24,20:29:00,18868.0,SELL,1,0.03h,Break Even,$0.25,$198.25,$79541.25,103,$198.25
2024-05-24,20:35:00,18871.0,BUY,1,0.02h,Stop Loss,$-6.00,$192.25,$79535.25,103,$192.25
Final P&L Day: 192.25,,,,,,,,,,,
2024-05-27,12:38:00,18874.25,SELL,1,0.02h,Stop Loss,$-6.00,$-6.00,$79529.25,104,$-6.00
2024-05-27,13:10:00,18875.25,BUY,1,0.02h,Break Even,$0.25,$-5.75,$79529.50,104,$-5.75
2024-05-27,13:53:00,18890.0,SELL,1,0.02h,Stop Loss,$12.75,$7.00,$79542.25,104,$7.00
2024-05-27,14:35:00,18884.0,BUY,1,0.02h,Stop Loss,$5.25,$12.25,$79547.50,104,$12.25
2024-05-27,16:12:00,18934.75,SELL,1,0.02h,Stop Loss,$-6.00,$6.25,$79541.50,104,$6.25
2024-05-27,16:14:00,18939.75,BUY,1,0.02h,Stop Loss,$-6.00,$0.25,$79535.50,104,$0.25
2024-05-27,16:41:00,18943.25,SELL,1,0.02h,Stop Loss,$-6.00,$-5.75,$79529.50,104,$-5.75
2024-05-27,16:42:00,18945.5,BUY,1,0.02h,Stop Loss,$-6.00,$-11.75,$79523.50,104,$-11.75
2024-05-27,16:43:00,18942.0,SELL,1,0.02h,Stop Loss,$-6.00,$-17.75,$79517.50,104,$-17.75
2024-05-27,16:47:00,18951.0,BUY,1,0.02h,Stop Loss,$-6.00,$-23.75,$79511.50,104,$-23.75
2024-05-27,22:01:00,18938.0,SELL,1,0.02h,Stop Loss,$9.00,$-14.75,$79520.50,104,$-14.75
2024-05-27,22:52:00,18917.5,BUY,1,0.02h,Break Even,$0.25,$-14.50,$79520.75,104,$-14.50
Final P&L Day: -14.50,,,,,,,,,,,
2024-05-28,12:20:00,18919.25,SELL,1,0.02h,Stop Loss,$-6.00,$-6.00,$79514.75,105,$-6.00
2024-05-28,12:26:00,18927.75,BUY,1,0.02h,Break Even,$0.25,$-5.75,$79515.00,105,$-5.75
2024-05-28,12:32:00,18916.75,SELL,1,0.02h,Stop Loss,$-6.00,$-11.75,$79509.00,105,$-11.75
2024-05-28,12:40:00,18925.75,BUY,1,0.02h,Break Even,$0.25,$-11.50,$79509.25,105,$-11.50
2024-05-28,12:43:00,18918.5,SELL,1,0.02h,Break Even,$0.25,$-11.25,$79509.50,105,$-11.25
2024-05-28,13:01:00,18919.25,BUY,1,0.02h,Stop Loss,$-6.00,$-17.25,$79503.50,105,$-17.25
2024-05-28,13:02:00,18913.75,SELL,1,0.02h,Stop Loss,$7.75,$-9.50,$79511.25,105,$-9.50
2024-05-28,13:13:00,18916.0,BUY,1,0.02h,Stop Loss,$11.50,$2.00,$79522.75,105,$2.00
2024-05-28,13:35:00,18911.0,SELL,1,0.02h,Stop Loss,$5.25,$7.25,$79528.00,105,$7.25
2024-05-28,14:06:00,18880.5,BUY,1,0.02h,Stop Loss,$49.00,$56.25,$79577.00,105,$56.25
2024-05-28,14:39:00,18885.75,SELL,1,0.02h,Stop Loss,$15.25,$71.50,$79592.25,105,$71.50
2024-05-28,14:43:00,18901.0,BUY,1,0.02h,Stop Loss,$9.00,$80.50,$79601.25,105,$80.50
2024-05-28,15:07:00,18904.5,SELL,1,0.02h,Stop Loss,$-6.00,$74.50,$79595.25,105,$74.50
2024-05-28,15:13:00,18917.25,BUY,1,0.02h,Break Even,$0.25,$74.75,$79595.50,105,$74.75
2024-05-28,15:17:00,18904.75,SELL,1,0.02h,Stop Loss,$-6.00,$68.75,$79589.50,105,$68.75
2024-05-28,15:20:00,18917.0,BUY,1,0.02h,Break Even,$0.25,$69.00,$79589.75,105,$69.00
2024-05-28,15:57:00,18921.25,SELL,1,0.02h,Stop Loss,$-6.00,$63.00,$79583.75,105,$63.00
2024-05-28,16:02:00,18929.5,BUY,1,0.02h,Stop Loss,$-6.00,$57.00,$79577.75,105,$57.00
2024-05-28,16:06:00,18920.25,SELL,1,0.02h,Stop Loss,$4.00,$61.00,$79581.75,105,$61.00
2024-05-28,16:14:00,18931.0,BUY,1,0.02h,Stop Loss,$9.00,$70.00,$79590.75,105,$70.00
2024-05-28,16:18:00,18915.75,SELL,1,0.02h,Break Even,$0.25,$70.25,$79591.00,105,$70.25
2024-05-28,16:37:00,18926.75,BUY,1,0.02h,Stop Loss,$-6.00,$64.25,$79585.00,105,$64.25
2024-05-28,16:59:00,18922.5,SELL,1,0.02h,Break Even,$0.25,$64.50,$79585.25,105,$64.50
2024-05-28,17:15:00,18926.5,BUY,1,0.02h,Stop Loss,$-6.00,$58.50,$79579.25,105,$58.50
2024-05-28,17:16:00,18921.5,SELL,1,0.02h,Stop Loss,$4.00,$62.50,$79583.25,105,$62.50
2024-05-28,17:19:00,18927.25,BUY,1,0.02h,Stop Loss,$7.75,$70.25,$79591.00,105,$70.25
2024-05-28,17:23:00,18919.25,SELL,1,0.02h,Break Even,$0.25,$70.50,$79591.25,105,$70.50
2024-05-28,17:26:00,18925.0,BUY,1,0.02h,Stop Loss,$-6.00,$64.50,$79585.25,105,$64.50
2024-05-28,17:27:00,18921.5,SELL,1,0.02h,Stop Loss,$-6.00,$58.50,$79579.25,105,$58.50
2024-05-28,17:28:00,18927.25,BUY,1,0.02h,Stop Loss,$-6.00,$52.50,$79573.25,105,$52.50
2024-05-28,17:48:00,18926.5,SELL,1,0.02h,Stop Loss,$14.00,$66.50,$79587.25,105,$66.50
2024-05-28,18:09:00,18916.5,BUY,1,0.02h,Break Even,$0.25,$66.75,$79587.50,105,$66.75
2024-05-28,18:18:00,18903.0,SELL,1,0.02h,Stop Loss,$26.50,$93.25,$79614.00,105,$93.25
2024-05-28,18:58:00,18861.0,BUY,1,0.02h,Stop Loss,$30.25,$123.50,$79644.25,105,$123.50
2024-05-28,19:48:00,18883.75,SELL,1,0.02h,Stop Loss,$35.25,$158.75,$79679.50,105,$158.75
2024-05-28,19:54:00,18900.5,BUY,1,0.02h,Stop Loss,$4.00,$162.75,$79683.50,105,$162.75
2024-05-28,22:02:00,18939.25,SELL,1,0.02h,Break Even,$0.25,$163.00,$79683.75,105,$163.00
2024-05-28,22:48:00,18940.75,BUY,1,0.15h,Break Even,$0.25,$163.25,$79684.00,105,$163.25
Final P&L Day: 163.25,,,,,,,,,,,
2024-05-29,12:00:00,18817.75,SELL,1,0.02h,Stop Loss,$-6.00,$-6.00,$79678.00,106,$-6.00
2024-05-29,13:31:00,18797.75,BUY,1,0.02h,Stop Loss,$21.50,$15.50,$79699.50,106,$15.50
2024-05-29,15:04:00,18858.75,SELL,1,0.02h,Break Even,$0.25,$15.75,$79699.75,106,$15.75
2024-05-29,15:27:00,18854.25,BUY,1,0.02h,Stop Loss,$9.00,$24.75,$79708.75,106,$24.75
2024-05-29,15:33:00,18840.0,SELL,1,0.02h,Stop Loss,$26.50,$51.25,$79735.25,106,$51.25
2024-05-29,15:55:00,18849.0,BUY,1,0.02h,Stop Loss,$12.75,$64.00,$79748.00,106,$64.00
2024-05-29,16:10:00,18841.25,SELL,1,0.02h,Stop Loss,$67.75,$131.75,$79815.75,106,$131.75
2024-05-29,16:22:00,18845.0,BUY,1,0.02h,Stop Loss,$14.00,$145.75,$79829.75,106,$145.75
2024-05-29,17:03:00,18852.25,SELL,1,0.02h,Stop Loss,$11.50,$157.25,$79841.25,106,$157.25
2024-05-29,17:31:00,18851.0,BUY,1,0.02h,Break Even,$0.25,$157.50,$79841.50,106,$157.50
2024-05-29,17:34:00,18842.25,SELL,1,0.02h,Stop Loss,$24.00,$181.50,$79865.50,106,$181.50
2024-05-29,17:52:00,18849.5,BUY,1,0.02h,Stop Loss,$49.00,$230.50,$79914.50,106,$230.50
2024-05-29,18:21:00,18850.75,SELL,1,0.02h,Stop Loss,$-6.00,$224.50,$79908.50,106,$224.50
2024-05-29,19:16:00,18836.0,BUY,1,0.02h,Break Even,$0.25,$224.75,$79908.75,106,$224.75
2024-05-29,19:45:00,18836.75,SELL,1,0.02h,Stop Loss,$10.25,$235.00,$79919.00,106,$235.00
Final P&L Day: 235.00,,,,,,,,,,,
2024-05-30,12:00:00,18745.5,BUY,1,0.02h,Stop Loss,$-6.00,$-6.00,$79913.00,107,$-6.00
2024-05-30,12:56:00,18768.75,SELL,1,0.02h,Stop Loss,$24.00,$18.00,$79937.00,107,$18.00
2024-05-30,13:25:00,18766.0,BUY,1,0.02h,Break Even,$0.25,$18.25,$79937.25,107,$18.25
2024-05-30,13:33:00,18758.0,SELL,1,0.02h,Stop Loss,$65.25,$83.50,$80002.50,107,$83.50
2024-05-30,14:07:00,18746.5,BUY,1,0.02h,Break Even,$0.25,$83.75,$80002.75,107,$83.75
2024-05-30,14:11:00,18725.5,SELL,1,0.02h,Stop Loss,$111.50,$195.25,$80114.25,107,$195.25
2024-05-30,15:23:00,18657.0,BUY,1,0.02h,Stop Loss,$5.25,$200.50,$80119.50,107,$200.50
2024-05-30,15:59:00,18675.0,SELL,1,0.02h,Stop Loss,$24.00,$224.50,$80143.50,107,$224.50
2024-05-30,16:05:00,18692.75,BUY,1,0.02h,Stop Loss,$19.00,$243.50,$80162.50,107,$243.50
2024-05-30,16:30:00,18686.0,SELL,1,0.02h,Stop Loss,$5.25,$248.75,$80167.75,107,$248.75
2024-05-30,16:34:00,18696.0,BUY,1,0.02h,Stop Loss,$11.50,$260.25,$80179.25,107,$260.25
2024-05-30,16:44:00,18689.0,SELL,1,0.02h,Stop Loss,$-6.00,$254.25,$80173.25,107,$254.25
2024-05-30,16:54:00,18698.5,BUY,1,0.02h,Stop Loss,$9.00,$263.25,$80182.25,107,$263.25
2024-05-30,16:58:00,18688.5,SELL,1,0.02h,Stop Loss,$-6.00,$257.25,$80176.25,107,$257.25
2024-05-30,17:00:00,18696.5,BUY,1,0.02h,Stop Loss,$-6.00,$251.25,$80170.25,107,$251.25
2024-05-30,17:49:00,18706.75,SELL,1,0.02h,Stop Loss,$4.00,$255.25,$80174.25,107,$255.25
2024-05-30,19:16:00,18670.0,BUY,1,0.02h,Break Even,$0.25,$255.50,$80174.50,107,$255.50
2024-05-30,19:19:00,18664.5,SELL,1,0.02h,Stop Loss,$32.75,$288.25,$80207.25,107,$288.25
2024-05-30,20:28:00,18581.0,BUY,1,0.02h,Stop Loss,$41.50,$329.75,$80248.75,107,$329.75
2024-05-30,20:54:00,18584.25,SELL,1,0.02h,Stop Loss,$-6.00,$323.75,$80242.75,107,$323.75
2024-05-30,20:59:00,18591.5,BUY,1,0.02h,Stop Loss,$15.25,$339.00,$80258.00,107,$339.00
2024-05-30,22:01:00,18570.0,SELL,1,0.02h,Break Even,$0.25,$339.25,$80258.25,107,$339.25
2024-05-30,22:34:00,18570.25,BUY,1,0.02h,Stop Loss,$-6.00,$333.25,$80252.25,107,$333.25
2024-05-30,22:54:00,18570.75,SELL,1,0.03h,Break Even,$0.25,$333.50,$80252.50,107,$333.50
Final P&L Day: 333.50,,,,,,,,,,,
2024-05-31,12:24:00,18569.0,BUY,1,0.02h,Break Even,$0.25,$0.25,$80252.75,108,$0.25
2024-05-31,13:07:00,18638.25,SELL,1,0.02h,Stop Loss,$10.25,$10.50,$80263.00,108,$10.50
2024-05-31,13:44:00,18627.25,BUY,1,0.02h,Break Even,$0.25,$10.75,$80263.25,108,$10.75
2024-05-31,13:46:00,18589.25,SELL,1,0.02h,Stop Loss,$62.75,$73.50,$80326.00,108,$73.50
2024-05-31,16:41:00,18279.5,BUY,1,0.02h,Stop Loss,$21.50,$95.00,$80347.50,108,$95.00
2024-05-31,17:43:00,18334.5,SELL,1,0.02h,Break Even,$0.25,$95.25,$80347.75,108,$95.25
2024-05-31,17:46:00,18354.25,BUY,1,0.02h,Break Even,$0.25,$95.50,$80348.00,108,$95.50
2024-05-31,17:55:00,18340.0,SELL,1,0.02h,Stop Loss,$-6.00,$89.50,$80342.00,108,$89.50
2024-05-31,18:19:00,18339.75,BUY,1,0.02h,Break Even,$0.25,$89.75,$80342.25,108,$89.75
2024-05-31,18:24:00,18335.75,SELL,1,0.02h,Stop Loss,$7.75,$97.50,$80350.00,108,$97.50
2024-05-31,18:42:00,18335.5,BUY,1,0.02h,Stop Loss,$6.50,$104.00,$80356.50,108,$104.00
2024-05-31,20:50:00,18576.5,SELL,1,0.02h,Break Even,$0.25,$104.25,$80356.75,108,$104.25
Final P&L Day: 104.25,,,,,,,,,,,
2024-06-03,12:00:00,18688.5,BUY,1,0.02h,Break Even,$0.25,$0.25,$80357.00,109,$0.25
2024-06-03,12:37:00,18679.5,SELL,1,0.02h,Stop Loss,$-6.00,$-5.75,$80351.00,109,$-5.75
2024-06-03,12:44:00,18689.5,BUY,1,0.02h,Break Even,$0.25,$-5.50,$80351.25,109,$-5.50
2024-06-03,12:47:00,18684.75,SELL,1,0.02h,Break Even,$0.25,$-5.25,$80351.50,109,$-5.25
2024-06-03,13:02:00,18691.5,BUY,1,0.02h,Break Even,$0.25,$-5.00,$80351.75,109,$-5.00
2024-06-03,13:53:00,18679.5,SELL,1,0.02h,Break Even,$0.25,$-4.75,$80352.00,109,$-4.75
2024-06-03,14:19:00,18690.0,BUY,1,0.02h,Stop Loss,$54.00,$49.25,$80406.00,109,$49.25
2024-06-03,14:23:00,18682.5,SELL,1,0.02h,Break Even,$0.25,$49.50,$80406.25,109,$49.50
2024-06-03,14:24:00,18702.25,BUY,1,0.02h,Stop Loss,$20.25,$69.75,$80426.50,109,$69.75
2024-06-03,14:33:00,18678.0,SELL,1,0.02h,Break Even,$0.25,$70.00,$80426.75,109,$70.00
2024-06-03,15:20:00,18604.75,BUY,1,0.02h,Stop Loss,$36.50,$106.50,$80463.25,109,$106.50
2024-06-03,15:47:00,18594.5,SELL,1,0.02h,Break Even,$0.25,$106.75,$80463.50,109,$106.75
2024-06-03,15:55:00,18615.75,BUY,1,0.02h,Stop Loss,$-6.00,$100.75,$80457.50,109,$100.75
2024-06-03,15:56:00,18608.25,SELL,1,0.02h,Stop Loss,$42.75,$143.50,$80500.25,109,$143.50
2024-06-03,17:21:00,18498.5,BUY,1,0.02h,Stop Loss,$16.50,$160.00,$80516.75,109,$160.00
2024-06-03,18:14:00,18541.25,SELL,1,0.02h,Stop Loss,$57.75,$217.75,$80574.50,109,$217.75
2024-06-03,18:24:00,18568.0,BUY,1,0.02h,Stop Loss,$-6.00,$211.75,$80568.50,109,$211.75
2024-06-03,18:30:00,18538.0,SELL,1,0.02h,Break Even,$0.25,$212.00,$80568.75,109,$212.00
2024-06-03,18:37:00,18562.75,BUY,1,0.02h,Stop Loss,$-6.00,$206.00,$80562.75,109,$206.00
2024-06-03,18:54:00,18550.25,SELL,1,0.02h,Stop Loss,$12.75,$218.75,$80575.50,109,$218.75
2024-06-03,19:03:00,18568.75,BUY,1,0.02h,Break Even,$0.25,$219.00,$80575.75,109,$219.00
2024-06-03,19:40:00,18571.5,SELL,1,0.02h,Stop Loss,$16.50,$235.50,$80592.25,109,$235.50
2024-06-03,19:47:00,18598.5,BUY,1,0.02h,Stop Loss,$-6.00,$229.50,$80586.25,109,$229.50
2024-06-03,20:46:00,18662.0,SELL,1,0.02h,Stop Loss,$-6.00,$223.50,$80580.25,109,$223.50
2024-06-03,22:25:00,18660.5,BUY,1,0.03h,Stop Loss,$-6.00,$217.50,$80574.25,109,$217.50
2024-06-03,22:45:00,18660.0,SELL,1,0.02h,Stop Loss,$-6.00,$211.50,$80568.25,109,$211.50
Final P&L Day: 211.50,,,,,,,,,,,
2024-06-04,12:32:00,18589.5,BUY,1,0.02h,Stop Loss,$9.00,$9.00,$80577.25,110,$9.00
2024-06-04,13:35:00,18594.25,SELL,1,0.02h,Stop Loss,$47.75,$56.75,$80625.00,110,$56.75
2024-06-04,14:02:00,18659.5,BUY,1,0.02h,Stop Loss,$-6.00,$50.75,$80619.00,110,$50.75
2024-06-04,14:07:00,18596.5,SELL,1,0.02h,Break Even,$0.25,$51.00,$80619.25,110,$51.00
2024-06-04,14:29:00,18619.25,BUY,1,0.02h,Stop Loss,$5.25,$56.25,$80624.50,110,$56.25
2024-06-04,14:56:00,18621.0,SELL,1,0.02h,Stop Loss,$49.00,$105.25,$80673.50,110,$105.25
2024-06-04,15:21:00,18626.5,BUY,1,0.02h,Stop Loss,$30.25,$135.50,$80703.75,110,$135.50
2024-06-04,15:30:00,18601.5,SELL,1,0.02h,Stop Loss,$31.50,$167.00,$80735.25,110,$167.00
2024-06-04,15:55:00,18600.5,BUY,1,0.02h,Stop Loss,$6.50,$173.50,$80741.75,110,$173.50
2024-06-04,15:59:00,18592.0,SELL,1,0.02h,Stop Loss,$25.25,$198.75,$80767.00,110,$198.75
2024-06-04,16:26:00,18590.25,BUY,1,0.02h,Stop Loss,$11.50,$210.25,$80778.50,110,$210.25
2024-06-04,17:04:00,18616.5,SELL,1,0.02h,Break Even,$0.25,$210.50,$80778.75,110,$210.50
2024-06-04,17:17:00,18628.75,BUY,1,0.02h,Stop Loss,$16.50,$227.00,$80795.25,110,$227.00
2024-06-04,17:27:00,18614.75,SELL,1,0.02h,Break Even,$0.25,$227.25,$80795.50,110,$227.25
2024-06-04,17:29:00,18634.25,BUY,1,0.02h,Stop Loss,$25.25,$252.50,$80820.75,110,$252.50
2024-06-04,17:38:00,18622.25,SELL,1,0.02h,Break Even,$0.25,$252.75,$80821.00,110,$252.75
2024-06-04,17:42:00,18631.5,BUY,1,0.02h,Stop Loss,$11.50,$264.25,$80832.50,110,$264.25
2024-06-04,17:44:00,18621.5,SELL,1,0.02h,Stop Loss,$7.75,$272.00,$80840.25,110,$272.00
2024-06-04,17:49:00,18628.5,BUY,1,0.02h,Break Even,$0.25,$272.25,$80840.50,110,$272.25
2024-06-04,17:50:00,18625.25,SELL,1,0.02h,Stop Loss,$-6.00,$266.25,$80834.50,110,$266.25
2024-06-04,17:51:00,18630.25,BUY,1,0.02h,Stop Loss,$-6.00,$260.25,$80828.50,110,$260.25
2024-06-04,18:59:00,18712.25,SELL,1,0.02h,Break Even,$0.25,$260.50,$80828.75,110,$260.50
2024-06-04,19:44:00,18682.75,BUY,1,0.02h,Stop Loss,$42.75,$303.25,$80871.50,110,$303.25
2024-06-04,22:06:00,18707.5,SELL,1,0.02h,Break Even,$0.25,$303.50,$80871.75,110,$303.50
2024-06-04,22:27:00,18703.75,BUY,1,0.03h,Stop Loss,$-6.00,$297.50,$80865.75,110,$297.50
Final P&L Day: 297.50,,,,,,,,,,,
2024-06-05,12:32:00,18782.75,SELL,1,0.02h,Stop Loss,$6.50,$6.50,$80872.25,111,$6.50
2024-06-05,12:37:00,18800.75,BUY,1,0.02h,Break Even,$0.25,$6.75,$80872.50,111,$6.75
2024-06-05,13:35:00,18833.75,SELL,1,0.02h,Stop Loss,$85.25,$92.00,$80957.75,111,$92.00
2024-06-05,13:46:00,18841.75,BUY,1,0.02h,Stop Loss,$5.25,$97.25,$80963.00,111,$97.25
2024-06-05,14:08:00,18831.75,SELL,1,0.02h,Stop Loss,$7.75,$105.00,$80970.75,111,$105.00
2024-06-05,14:22:00,18849.75,BUY,1,0.02h,Stop Loss,$12.75,$117.75,$80983.50,111,$117.75
2024-06-05,15:55:00,18969.0,SELL,1,0.02h,Stop Loss,$17.75,$135.50,$81001.25,111,$135.50
2024-06-05,16:12:00,18973.75,BUY,1,0.02h,Break Even,$0.25,$135.75,$81001.50,111,$135.75
2024-06-05,16:16:00,18961.75,SELL,1,0.02h,Stop Loss,$-6.00,$129.75,$80995.50,111,$129.75
2024-06-05,16:21:00,18974.25,BUY,1,0.02h,Stop Loss,$-6.00,$123.75,$80989.50,111,$123.75
2024-06-05,17:21:00,18982.0,SELL,1,0.02h,Stop Loss,$6.50,$130.25,$80996.00,111,$130.25
2024-06-05,17:34:00,19009.25,BUY,1,0.02h,Stop Loss,$-6.00,$124.25,$80990.00,111,$124.25
2024-06-05,18:09:00,19013.25,SELL,1,0.02h,Stop Loss,$-6.00,$118.25,$80984.00,111,$118.25
2024-06-05,18:11:00,19019.5,BUY,1,0.02h,Break Even,$0.25,$118.50,$80984.25,111,$118.50
2024-06-05,18:14:00,19009.75,SELL,1,0.02h,Break Even,$0.25,$118.75,$80984.50,111,$118.75
2024-06-05,18:23:00,19019.25,BUY,1,0.02h,Break Even,$0.25,$119.00,$80984.75,111,$119.00
2024-06-05,19:27:00,19035.75,SELL,1,0.02h,Stop Loss,$19.00,$138.00,$81003.75,111,$138.00
2024-06-05,19:38:00,19046.75,BUY,1,0.02h,Stop Loss,$9.00,$147.00,$81012.75,111,$147.00
2024-06-05,19:47:00,19036.25,SELL,1,0.02h,Stop Loss,$10.25,$157.25,$81023.00,111,$157.25
2024-06-05,19:53:00,19053.5,BUY,1,0.02h,Stop Loss,$27.75,$185.00,$81050.75,111,$185.00
2024-06-05,22:02:00,19076.5,SELL,1,0.02h,Stop Loss,$-6.00,$179.00,$81044.75,111,$179.00
2024-06-05,22:37:00,19083.0,BUY,1,0.02h,Break Even,$0.25,$179.25,$81045.00,111,$179.25
Final P&L Day: 179.25,,,,,,,,,,,
2024-06-06,12:25:00,19097.5,SELL,1,0.02h,Stop Loss,$9.00,$9.00,$81054.00,112,$9.00
2024-06-06,12:53:00,19095.5,BUY,1,0.02h,Stop Loss,$-6.00,$3.00,$81048.00,112,$3.00
2024-06-06,13:46:00,19086.25,SELL,1,0.02h,Stop Loss,$79.00,$82.00,$81127.00,112,$82.00
2024-06-06,14:24:00,19082.25,BUY,1,0.02h,Stop Loss,$9.00,$91.00,$81136.00,112,$91.00
2024-06-06,14:53:00,19079.75,SELL,1,0.02h,Stop Loss,$-6.00,$85.00,$81130.00,112,$85.00
2024-06-06,14:56:00,19097.25,BUY,1,0.02h,Stop Loss,$-6.00,$79.00,$81124.00,112,$79.00
2024-06-06,15:00:00,19083.0,SELL,1,0.02h,Stop Loss,$26.50,$105.50,$81150.50,112,$105.50
2024-06-06,15:10:00,19090.75,BUY,1,0.02h,Break Even,$0.25,$105.75,$81150.75,112,$105.75
2024-06-06,15:11:00,19087.75,SELL,1,0.02h,Stop Loss,$7.75,$113.50,$81158.50,112,$113.50
2024-06-06,15:54:00,19067.75,BUY,1,0.02h,Stop Loss,$7.75,$121.25,$81166.25,112,$121.25
2024-06-06,16:01:00,19062.0,SELL,1,0.02h,Stop Loss,$6.50,$127.75,$81172.75,112,$127.75
2024-06-06,16:05:00,19070.75,BUY,1,0.02h,Stop Loss,$12.75,$140.50,$81185.50,112,$140.50
2024-06-06,16:16:00,19056.25,SELL,1,0.02h,Stop Loss,$67.75,$208.25,$81253.25,112,$208.25
2024-06-06,16:55:00,19052.75,BUY,1,0.02h,Break Even,$0.25,$208.50,$81253.50,112,$208.50
2024-06-06,17:49:00,19070.5,SELL,1,0.02h,Break Even,$0.25,$208.75,$81253.75,112,$208.75
2024-06-06,17:56:00,19082.25,BUY,1,0.02h,Stop Loss,$-6.00,$202.75,$81247.75,112,$202.75
2024-06-06,17:57:00,19072.25,SELL,1,0.02h,Break Even,$0.25,$203.00,$81248.00,112,$203.00
2024-06-06,18:35:00,19052.0,BUY,1,0.02h,Stop Loss,$10.25,$213.25,$81258.25,112,$213.25
2024-06-06,18:37:00,19045.75,SELL,1,0.02h,Stop Loss,$6.50,$219.75,$81264.75,112,$219.75
2024-06-06,18:41:00,19052.5,BUY,1,0.02h,Break Even,$0.25,$220.00,$81265.00,112,$220.00
2024-06-06,19:14:00,19056.0,SELL,1,0.02h,Stop Loss,$24.00,$244.00,$81289.00,112,$244.00
2024-06-06,19:32:00,19061.25,BUY,1,0.02h,Stop Loss,$-6.00,$238.00,$81283.00,112,$238.00
2024-06-06,19:36:00,19051.5,SELL,1,0.02h,Break Even,$0.25,$238.25,$81283.25,112,$238.25
2024-06-06,19:39:00,19060.0,BUY,1,0.02h,Stop Loss,$-6.00,$232.25,$81277.25,112,$232.25
2024-06-06,19:40:00,19055.0,SELL,1,0.02h,Stop Loss,$26.50,$258.75,$81303.75,112,$258.75
2024-06-06,19:49:00,19065.5,BUY,1,0.02h,Stop Loss,$25.25,$284.00,$81329.00,112,$284.00
2024-06-06,20:03:00,19047.75,SELL,1,0.02h,Break Even,$0.25,$284.25,$81329.25,112,$284.25
2024-06-06,20:08:00,19064.25,BUY,1,0.02h,Break Even,$0.25,$284.50,$81329.50,112,$284.50
2024-06-06,20:42:00,19063.5,SELL,1,0.02h,Stop Loss,$-6.00,$278.50,$81323.50,112,$278.50
2024-06-06,20:57:00,19066.75,BUY,1,0.02h,Stop Loss,$-6.00,$272.50,$81317.50,112,$272.50
2024-06-06,22:02:00,19062.25,SELL,1,0.02h,Stop Loss,$-6.00,$266.50,$81311.50,112,$266.50
2024-06-06,22:08:00,19066.75,BUY,1,0.02h,Stop Loss,$-6.00,$260.50,$81305.50,112,$260.50
2024-06-06,22:09:00,19063.0,SELL,1,0.02h,Stop Loss,$-6.00,$254.50,$81299.50,112,$254.50
2024-06-06,22:13:00,19068.75,BUY,1,0.02h,Stop Loss,$-6.00,$248.50,$81293.50,112,$248.50
Final P&L Day: 248.50,,,,,,,,,,,
2024-06-07,12:31:00,19009.0,SELL,1,0.02h,Stop Loss,$102.75,$102.75,$81396.25,113,$102.75
2024-06-07,13:06:00,19025.25,BUY,1,0.02h,Stop Loss,$27.75,$130.50,$81424.00,113,$130.50
2024-06-07,13:35:00,18996.25,SELL,1,0.02h,Break Even,$0.25,$130.75,$81424.25,113,$130.75
2024-06-07,13:46:00,19025.5,BUY,1,0.02h,Stop Loss,$21.50,$152.25,$81445.75,113,$152.25
2024-06-07,14:12:00,19028.5,SELL,1,0.02h,Break Even,$0.25,$152.50,$81446.00,113,$152.50
2024-06-07,14:14:00,19041.5,BUY,1,0.02h,Stop Loss,$-6.00,$146.50,$81440.00,113,$146.50
2024-06-07,14:30:00,19038.5,SELL,1,0.02h,Stop Loss,$14.00,$160.50,$81454.00,113,$160.50
2024-06-07,14:33:00,19042.25,BUY,1,0.02h,Stop Loss,$5.25,$165.75,$81459.25,113,$165.75
2024-06-07,14:34:00,19036.0,SELL,1,0.02h,Stop Loss,$-6.00,$159.75,$81453.25,113,$159.75
2024-06-07,14:35:00,19046.75,BUY,1,0.02h,Stop Loss,$27.75,$187.50,$81481.00,113,$187.50
2024-06-07,15:01:00,19055.25,SELL,1,0.02h,Stop Loss,$19.00,$206.50,$81500.00,113,$206.50
2024-06-07,15:25:00,19061.75,BUY,1,0.02h,Stop Loss,$4.00,$210.50,$81504.00,113,$210.50
2024-06-07,16:43:00,19094.25,SELL,1,0.02h,Stop Loss,$-6.00,$204.50,$81498.00,113,$204.50
2024-06-07,16:53:00,19111.25,BUY,1,0.02h,Stop Loss,$16.50,$221.00,$81514.50,113,$221.00
2024-06-07,17:38:00,19122.25,SELL,1,0.02h,Stop Loss,$22.75,$243.75,$81537.25,113,$243.75
2024-06-07,17:52:00,19132.25,BUY,1,0.02h,Stop Loss,$6.50,$250.25,$81543.75,113,$250.25
2024-06-07,18:00:00,19115.0,SELL,1,0.02h,Stop Loss,$144.00,$394.25,$81687.75,113,$394.25
2024-06-07,18:32:00,19052.25,BUY,1,0.02h,Break Even,$0.25,$394.50,$81688.00,113,$394.50
2024-06-07,19:01:00,19039.0,SELL,1,0.02h,Stop Loss,$4.00,$398.50,$81692.00,113,$398.50
2024-06-07,19:30:00,19047.5,BUY,1,0.02h,Stop Loss,$-6.00,$392.50,$81686.00,113,$392.50
2024-06-07,19:52:00,19037.5,SELL,1,0.02h,Stop Loss,$62.75,$455.25,$81748.75,113,$455.25
2024-06-07,19:59:00,19044.25,BUY,1,0.02h,Stop Loss,$17.75,$473.00,$81766.50,113,$473.00
2024-06-07,20:01:00,19039.5,SELL,1,0.02h,Stop Loss,$7.75,$480.75,$81774.25,113,$480.75
2024-06-07,20:50:00,19024.5,BUY,1,0.02h,Stop Loss,$9.00,$489.75,$81783.25,113,$489.75
Final P&L Day: 489.75,,,,,,,,,,,
2024-06-10,12:24:00,19023.5,SELL,1,0.02h,Stop Loss,$-6.00,$-6.00,$81777.25,114,$-6.00
2024-06-10,13:33:00,19005.75,BUY,1,0.02h,Stop Loss,$-6.00,$-12.00,$81771.25,114,$-12.00
2024-06-10,13:48:00,18992.5,SELL,1,0.02h,Break Even,$0.25,$-11.75,$81771.50,114,$-11.75
2024-06-10,14:09:00,19010.0,BUY,1,0.02h,Stop Loss,$16.50,$4.75,$81788.00,114,$4.75
2024-06-10,14:18:00,19001.25,SELL,1,0.02h,Break Even,$0.25,$5.00,$81788.25,114,$5.00
2024-06-10,14:20:00,19009.0,BUY,1,0.02h,Stop Loss,$29.00,$34.00,$81817.25,114,$34.00
2024-06-10,16:02:00,19091.75,SELL,1,0.02h,Stop Loss,$-6.00,$28.00,$81811.25,114,$28.00
2024-06-10,16:12:00,19105.0,BUY,1,0.02h,Break Even,$0.25,$28.25,$81811.50,114,$28.25
2024-06-10,16:32:00,19104.25,SELL,1,0.02h,Stop Loss,$26.50,$54.75,$81838.00,114,$54.75
2024-06-10,16:35:00,19109.5,BUY,1,0.02h,Stop Loss,$-6.00,$48.75,$81832.00,114,$48.75
2024-06-10,16:41:00,19104.5,SELL,1,0.02h,Stop Loss,$-6.00,$42.75,$81826.00,114,$42.75
2024-06-10,16:42:00,19109.5,BUY,1,0.02h,Break Even,$0.25,$43.00,$81826.25,114,$43.00
2024-06-10,16:48:00,19100.25,SELL,1,0.02h,Stop Loss,$-6.00,$37.00,$81820.25,114,$37.00
2024-06-10,16:53:00,19109.5,BUY,1,0.02h,Stop Loss,$4.00,$41.00,$81824.25,114,$41.00
2024-06-10,17:01:00,19092.25,SELL,1,0.02h,Break Even,$0.25,$41.25,$81824.50,114,$41.25
2024-06-10,17:47:00,19090.75,BUY,1,0.02h,Stop Loss,$-6.00,$35.25,$81818.50,114,$35.25
2024-06-10,18:11:00,19083.0,SELL,1,0.02h,Stop Loss,$5.25,$40.50,$81823.75,114,$40.50
2024-06-10,18:41:00,19071.5,BUY,1,0.02h,Stop Loss,$49.00,$89.50,$81872.75,114,$89.50
2024-06-10,19:34:00,19097.75,SELL,1,0.02h,Break Even,$0.25,$89.75,$81873.00,114,$89.75
2024-06-10,19:42:00,19115.0,BUY,1,0.02h,Stop Loss,$-6.00,$83.75,$81867.00,114,$83.75
2024-06-10,19:46:00,19096.0,SELL,1,0.02h,Break Even,$0.25,$84.00,$81867.25,114,$84.00
2024-06-10,20:00:00,19112.75,BUY,1,0.02h,Break Even,$0.25,$84.25,$81867.50,114,$84.25
2024-06-10,20:02:00,19094.0,SELL,1,0.02h,Stop Loss,$-6.00,$78.25,$81861.50,114,$78.25
2024-06-10,20:27:00,19094.25,BUY,1,0.07h,Stop Loss,$-6.00,$72.25,$81855.50,114,$72.25
2024-06-10,22:06:00,19099.0,SELL,1,0.02h,Stop Loss,$-6.00,$66.25,$81849.50,114,$66.25
2024-06-10,22:37:00,19099.5,BUY,1,0.02h,Break Even,$0.25,$66.50,$81849.75,114,$66.50
2024-06-10,22:46:00,19096.5,SELL,1,0.02h,Stop Loss,$-6.00,$60.50,$81843.75,114,$60.50
Final P&L Day: 60.50,,,,,,,,,,,
2024-06-11,12:45:00,19066.0,BUY,1,0.02h,Stop Loss,$-6.00,$-6.00,$81837.75,115,$-6.00
2024-06-11,12:53:00,19057.5,SELL,1,0.02h,Break Even,$0.25,$-5.75,$81838.00,115,$-5.75
2024-06-11,13:14:00,19058.5,BUY,1,0.02h,Break Even,$0.25,$-5.50,$81838.25,115,$-5.50
2024-06-11,13:26:00,19050.0,SELL,1,0.02h,Stop Loss,$-6.00,$-11.50,$81832.25,115,$-11.50
2024-06-11,13:30:00,19057.5,BUY,1,0.02h,Stop Loss,$27.75,$16.25,$81860.00,115,$16.25
2024-06-11,13:32:00,19048.5,SELL,1,0.02h,Stop Loss,$-6.00,$10.25,$81854.00,115,$10.25
2024-06-11,13:33:00,19060.5,BUY,1,0.02h,Stop Loss,$64.00,$74.25,$81918.00,115,$74.25
2024-06-11,13:47:00,19048.25,SELL,1,0.02h,Stop Loss,$185.25,$259.50,$82103.25,115,$259.50
2024-06-11,14:05:00,19053.5,BUY,1,0.02h,Stop Loss,$50.25,$309.75,$82153.50,115,$309.75
2024-06-11,15:10:00,19107.0,SELL,1,0.02h,Stop Loss,$-6.00,$303.75,$82147.50,115,$303.75
2024-06-11,15:24:00,19115.25,BUY,1,0.02h,Break Even,$0.25,$304.00,$82147.75,115,$304.00
2024-06-11,15:40:00,19111.25,SELL,1,0.02h,Stop Loss,$17.75,$321.75,$82165.50,115,$321.75
2024-06-11,16:13:00,19092.0,BUY,1,0.02h,Break Even,$0.25,$322.00,$82165.75,115,$322.00
2024-06-11,16:24:00,19083.5,SELL,1,0.02h,Break Even,$0.25,$322.25,$82166.00,115,$322.25
2024-06-11,16:26:00,19093.5,BUY,1,0.02h,Break Even,$0.25,$322.50,$82166.25,115,$322.50
2024-06-11,16:59:00,19097.0,SELL,1,0.02h,Stop Loss,$15.25,$337.75,$82181.50,115,$337.75
2024-06-11,17:03:00,19113.25,BUY,1,0.02h,Stop Loss,$51.50,$389.25,$82233.00,115,$389.25
2024-06-11,17:25:00,19110.5,SELL,1,0.02h,Stop Loss,$-6.00,$383.25,$82227.00,115,$383.25
2024-06-11,17:33:00,19124.75,BUY,1,0.02h,Break Even,$0.25,$383.50,$82227.25,115,$383.50
2024-06-11,18:54:00,19199.25,SELL,1,0.02h,Stop Loss,$-6.00,$377.50,$82221.25,115,$377.50
2024-06-11,19:03:00,19216.5,BUY,1,0.02h,Stop Loss,$14.00,$391.50,$82235.25,115,$391.50
2024-06-11,19:12:00,19201.75,SELL,1,0.02h,Stop Loss,$14.00,$405.50,$82249.25,115,$405.50
2024-06-11,19:42:00,19203.75,BUY,1,0.02h,Stop Loss,$-6.00,$399.50,$82243.25,115,$399.50
2024-06-11,20:39:00,19243.75,SELL,1,0.02h,Break Even,$0.25,$399.75,$82243.50,115,$399.75
2024-06-11,20:58:00,19247.25,BUY,1,0.02h,Stop Loss,$-6.00,$393.75,$82237.50,115,$393.75
2024-06-11,22:02:00,19240.25,SELL,1,0.02h,Stop Loss,$14.00,$407.75,$82251.50,115,$407.75
2024-06-11,22:22:00,19240.25,BUY,1,0.02h,Break Even,$0.25,$408.00,$82251.75,115,$408.00
Final P&L Day: 408.00,,,,,,,,,,,
2024-06-12,12:28:00,19266.25,SELL,1,0.02h,Stop Loss,$-6.00,$-6.00,$82245.75,116,$-6.00
2024-06-12,12:30:00,19286.5,BUY,1,0.02h,Stop Loss,$844.00,$838.00,$83089.75,116,$838.00
2024-06-12,13:24:00,19414.0,SELL,1,0.02h,Stop Loss,$-6.00,$832.00,$83083.75,116,$832.00
2024-06-12,13:35:00,19435.5,BUY,1,0.02h,Break Even,$0.25,$832.25,$83084.00,116,$832.25
2024-06-12,14:44:00,19510.25,SELL,1,0.02h,Stop Loss,$52.75,$885.00,$83136.75,116,$885.00
2024-06-12,15:07:00,19522.5,BUY,1,0.02h,Break Even,$0.25,$885.25,$83137.00,116,$885.25
2024-06-12,15:16:00,19503.5,SELL,1,0.02h,Stop Loss,$-6.00,$879.25,$83131.00,116,$879.25
2024-06-12,15:20:00,19523.5,BUY,1,0.02h,Stop Loss,$10.25,$889.50,$83141.25,116,$889.50
2024-06-12,15:45:00,19518.25,SELL,1,0.02h,Stop Loss,$14.00,$903.50,$83155.25,116,$903.50
2024-06-12,16:10:00,19519.75,BUY,1,0.02h,Break Even,$0.25,$903.75,$83155.50,116,$903.75
2024-06-12,16:13:00,19509.75,SELL,1,0.02h,Stop Loss,$-6.00,$897.75,$83149.50,116,$897.75
2024-06-12,16:45:00,19511.0,BUY,1,0.02h,Stop Loss,$10.25,$908.00,$83159.75,116,$908.00
2024-06-12,16:57:00,19504.5,SELL,1,0.02h,Stop Loss,$-6.00,$902.00,$83153.75,116,$902.00
2024-06-12,17:00:00,19509.5,BUY,1,0.02h,Stop Loss,$12.75,$914.75,$83166.50,116,$914.75
2024-06-12,17:32:00,19505.25,SELL,1,0.02h,Stop Loss,$47.75,$962.50,$83214.25,116,$962.50
2024-06-12,17:56:00,19516.25,BUY,1,0.02h,Break Even,$0.25,$962.75,$83214.50,116,$962.75
2024-06-12,18:01:00,19488.5,SELL,1,0.02h,Stop Loss,$71.50,$1034.25,$83286.00,116,$1034.25
2024-06-12,18:19:00,19516.0,BUY,1,0.02h,Stop Loss,$12.75,$1047.00,$83298.75,116,$1047.00
2024-06-12,18:36:00,19488.5,SELL,1,0.02h,Stop Loss,$35.25,$1082.25,$83334.00,116,$1082.25
2024-06-12,18:40:00,19540.0,BUY,1,0.02h,Break Even,$0.25,$1082.50,$83334.25,116,$1082.50
2024-06-12,18:46:00,19495.0,SELL,1,0.02h,Stop Loss,$17.75,$1100.25,$83352.00,116,$1100.25
2024-06-12,18:59:00,19518.5,BUY,1,0.02h,Stop Loss,$27.75,$1128.00,$83379.75,116,$1128.00
2024-06-12,19:26:00,19494.25,SELL,1,0.02h,Stop Loss,$45.25,$1173.25,$83425.00,116,$1173.25
2024-06-12,19:52:00,19498.25,BUY,1,0.02h,Stop Loss,$55.25,$1228.50,$83480.25,116,$1228.50
2024-06-12,20:04:00,19468.25,SELL,1,0.02h,Stop Loss,$7.75,$1236.25,$83488.00,116,$1236.25
2024-06-12,20:16:00,19540.75,BUY,1,0.02h,Stop Loss,$61.50,$1297.75,$83549.50,116,$1297.75
2024-06-12,22:17:00,19589.75,SELL,1,0.02h,Break Even,$0.25,$1298.00,$83549.75,116,$1298.00
2024-06-12,22:21:00,19597.5,BUY,1,0.02h,Break Even,$0.25,$1298.25,$83550.00,116,$1298.25
2024-06-12,22:41:00,19593.75,SELL,1,0.02h,Stop Loss,$-6.00,$1292.25,$83544.00,116,$1292.25
Final P&L Day: 1292.25,,,,,,,,,,,
2024-06-13,12:00:00,19873.25,BUY,1,0.02h,Stop Loss,$-6.00,$-6.00,$83538.00,117,$-6.00
2024-06-13,12:23:00,19637.0,SELL,1,0.02h,Stop Loss,$-6.00,$-12.00,$83532.00,117,$-12.00
2024-06-13,12:24:00,19895.75,BUY,1,0.02h,Stop Loss,$-6.00,$-18.00,$83526.00,117,$-18.00
2024-06-13,12:25:00,19634.75,SELL,1,0.02h,Break Even,$0.25,$-17.75,$83526.25,117,$-17.75
2024-06-13,12:27:00,19900.25,BUY,1,0.02h,Stop Loss,$-6.00,$-23.75,$83520.25,117,$-23.75
2024-06-13,12:28:00,19637.75,SELL,1,0.02h,Break Even,$0.25,$-23.50,$83520.50,117,$-23.50
2024-06-13,12:31:00,19931.75,BUY,1,0.02h,Stop Loss,$-6.00,$-29.50,$83514.50,117,$-29.50
2024-06-13,12:32:00,19669.5,SELL,1,0.02h,Stop Loss,$10.25,$-19.25,$83524.75,117,$-19.25
2024-06-13,12:38:00,19913.75,BUY,1,0.02h,Stop Loss,$-6.00,$-25.25,$83518.75,117,$-25.25
2024-06-13,12:39:00,19652.75,SELL,1,0.02h,Stop Loss,$75.25,$50.00,$83594.00,117,$50.00
2024-06-13,12:43:00,19904.75,BUY,1,0.02h,Stop Loss,$-6.00,$44.00,$83588.00,117,$44.00
2024-06-13,12:44:00,19633.0,SELL,1,0.02h,Stop Loss,$-6.00,$38.00,$83582.00,117,$38.00
2024-06-13,12:45:00,19899.5,BUY,1,0.02h,Break Even,$0.25,$38.25,$83582.25,117,$38.25
2024-06-13,12:53:00,19631.5,SELL,1,0.02h,Break Even,$0.25,$38.50,$83582.50,117,$38.50
2024-06-13,12:55:00,19901.0,BUY,1,0.02h,Stop Loss,$-6.00,$32.50,$83576.50,117,$32.50
2024-06-13,12:56:00,19633.0,SELL,1,0.02h,Stop Loss,$7.75,$40.25,$83584.25,117,$40.25
2024-06-13,12:58:00,19898.0,BUY,1,0.02h,Stop Loss,$-6.00,$34.25,$83578.25,117,$34.25
2024-06-13,13:00:00,19629.25,SELL,1,0.02h,Stop Loss,$7.75,$42.00,$83586.00,117,$42.00
2024-06-13,13:07:00,19882.0,BUY,1,0.02h,Stop Loss,$-6.00,$36.00,$83580.00,117,$36.00
2024-06-13,13:08:00,19623.75,SELL,1,0.02h,Stop Loss,$-6.00,$30.00,$83574.00,117,$30.00
2024-06-13,13:09:00,19884.25,BUY,1,0.02h,Stop Loss,$-6.00,$24.00,$83568.00,117,$24.00
2024-06-13,13:10:00,19619.5,SELL,1,0.02h,Break Even,$0.25,$24.25,$83568.25,117,$24.25
2024-06-13,13:16:00,19893.75,BUY,1,0.02h,Break Even,$0.25,$24.50,$83568.50,117,$24.50
2024-06-13,13:26:00,19640.25,SELL,1,0.02h,Stop Loss,$-6.00,$18.50,$83562.50,117,$18.50
2024-06-13,13:27:00,19900.5,BUY,1,0.02h,Stop Loss,$10.25,$28.75,$83572.75,117,$28.75
2024-06-13,13:31:00,19635.0,SELL,1,0.02h,Stop Loss,$19.00,$47.75,$83591.75,117,$47.75
2024-06-13,13:41:00,19917.0,BUY,1,0.02h,Stop Loss,$5.25,$53.00,$83597.00,117,$53.00
2024-06-13,13:50:00,19653.25,SELL,1,0.02h,Stop Loss,$-6.00,$47.00,$83591.00,117,$47.00
2024-06-13,13:51:00,19912.5,BUY,1,0.02h,Stop Loss,$-6.00,$41.00,$83585.00,117,$41.00
2024-06-13,13:52:00,19637.5,SELL,1,0.02h,Stop Loss,$12.75,$53.75,$83597.75,117,$53.75
2024-06-13,13:54:00,19894.5,BUY,1,0.02h,Stop Loss,$39.00,$92.75,$83636.75,117,$92.75
2024-06-13,13:56:00,19637.5,SELL,1,0.02h,Stop Loss,$16.50,$109.25,$83653.25,117,$109.25
2024-06-13,14:03:00,19905.5,BUY,1,0.02h,Stop Loss,$-6.00,$103.25,$83647.25,117,$103.25
2024-06-13,14:04:00,19641.75,SELL,1,0.02h,Stop Loss,$51.50,$154.75,$83698.75,117,$154.75
2024-06-13,14:08:00,19898.0,BUY,1,0.02h,Break Even,$0.25,$155.00,$83699.00,117,$155.00
2024-06-13,14:12:00,19606.25,SELL,1,0.02h,Stop Loss,$46.50,$201.50,$83745.50,117,$201.50
2024-06-13,14:22:00,19827.25,BUY,1,0.02h,Stop Loss,$-6.00,$195.50,$83739.50,117,$195.50
2024-06-13,14:23:00,19559.75,SELL,1,0.02h,Stop Loss,$100.25,$295.75,$83839.75,117,$295.75
2024-06-13,14:26:00,19815.0,BUY,1,0.02h,Stop Loss,$-6.00,$289.75,$83833.75,117,$289.75
2024-06-13,14:36:00,19559.0,SELL,1,0.02h,Break Even,$0.25,$290.00,$83834.00,117,$290.00
2024-06-13,14:43:00,19843.0,BUY,1,0.02h,Stop Loss,$-6.00,$284.00,$83828.00,117,$284.00
2024-06-13,14:49:00,19567.0,SELL,1,0.02h,Stop Loss,$-6.00,$278.00,$83822.00,117,$278.00
2024-06-13,14:50:00,19844.75,BUY,1,0.02h,Break Even,$0.25,$278.25,$83822.25,117,$278.25
2024-06-13,14:54:00,19572.75,SELL,1,0.02h,Break Even,$0.25,$278.50,$83822.50,117,$278.50
2024-06-13,14:57:00,19826.25,BUY,1,0.02h,Stop Loss,$-6.00,$272.50,$83816.50,117,$272.50
2024-06-13,14:58:00,19560.75,SELL,1,0.02h,Stop Loss,$10.25,$282.75,$83826.75,117,$282.75
2024-06-13,15:07:00,19839.0,BUY,1,0.02h,Stop Loss,$-6.00,$276.75,$83820.75,117,$276.75
2024-06-13,15:08:00,19582.25,SELL,1,0.02h,Break Even,$0.25,$277.00,$83821.00,117,$277.00
2024-06-13,15:11:00,19850.0,BUY,1,0.02h,Break Even,$0.25,$277.25,$83821.25,117,$277.25
2024-06-13,15:16:00,19559.0,SELL,1,0.02h,Break Even,$0.25,$277.50,$83821.50,117,$277.50
2024-06-13,15:30:00,19840.0,BUY,1,0.02h,Stop Loss,$-6.00,$271.50,$83815.50,117,$271.50
2024-06-13,15:31:00,19585.75,SELL,1,0.02h,Stop Loss,$-6.00,$265.50,$83809.50,117,$265.50
2024-06-13,15:33:00,19855.25,BUY,1,0.02h,Break Even,$0.25,$265.75,$83809.75,117,$265.75
2024-06-13,15:51:00,19601.25,SELL,1,0.02h,Stop Loss,$26.50,$292.25,$83836.25,117,$292.25
2024-06-13,15:53:00,19861.25,BUY,1,0.02h,Stop Loss,$-6.00,$286.25,$83830.25,117,$286.25
2024-06-13,15:54:00,19594.75,SELL,1,0.02h,Stop Loss,$-6.00,$280.25,$83824.25,117,$280.25
2024-06-13,15:55:00,19856.0,BUY,1,0.02h,Stop Loss,$11.50,$291.75,$83835.75,117,$291.75
2024-06-13,15:57:00,19594.75,SELL,1,0.02h,Stop Loss,$5.25,$297.00,$83841.00,117,$297.00
2024-06-13,16:04:00,19816.75,BUY,1,0.02h,Stop Loss,$-6.00,$291.00,$83835.00,117,$291.00
2024-06-13,16:05:00,19561.5,SELL,1,0.02h,Stop Loss,$-6.00,$285.00,$83829.00,117,$285.00
2024-06-13,16:06:00,19831.0,BUY,1,0.02h,Stop Loss,$-6.00,$279.00,$83823.00,117,$279.00
2024-06-13,16:07:00,19572.5,SELL,1,0.02h,Stop Loss,$-6.00,$273.00,$83817.00,117,$273.00
2024-06-13,16:08:00,19829.25,BUY,1,0.02h,Stop Loss,$-6.00,$267.00,$83811.00,117,$267.00
2024-06-13,16:09:00,19563.75,SELL,1,0.02h,Stop Loss,$22.75,$289.75,$83833.75,117,$289.75
2024-06-13,16:16:00,19814.0,BUY,1,0.02h,Break Even,$0.25,$290.00,$83834.00,117,$290.00
2024-06-13,16:26:00,19519.5,SELL,1,0.02h,Stop Loss,$52.75,$342.75,$83886.75,117,$342.75
2024-06-13,16:36:00,19798.25,BUY,1,0.02h,Break Even,$0.25,$343.00,$83887.00,117,$343.00
2024-06-13,16:43:00,19536.5,SELL,1,0.02h,Break Even,$0.25,$343.25,$83887.25,117,$343.25
2024-06-13,16:49:00,19774.0,BUY,1,0.02h,Stop Loss,$-6.00,$337.25,$83881.25,117,$337.25
2024-06-13,16:50:00,19521.5,SELL,1,0.02h,Stop Loss,$-6.00,$331.25,$83875.25,117,$331.25
2024-06-13,16:51:00,19789.75,BUY,1,0.02h,Stop Loss,$-6.00,$325.25,$83869.25,117,$325.25
2024-06-13,16:52:00,19538.0,SELL,1,0.02h,Stop Loss,$-6.00,$319.25,$83863.25,117,$319.25
2024-06-13,16:53:00,19804.25,BUY,1,0.02h,Stop Loss,$-6.00,$313.25,$83857.25,117,$313.25
2024-06-13,16:54:00,19545.0,SELL,1,0.02h,Break Even,$0.25,$313.50,$83857.50,117,$313.50
2024-06-13,17:00:00,19804.5,BUY,1,0.02h,Stop Loss,$35.25,$348.75,$83892.75,117,$348.75
2024-06-13,17:08:00,19558.75,SELL,1,0.02h,Break Even,$0.25,$349.00,$83893.00,117,$349.00
2024-06-13,17:10:00,19817.25,BUY,1,0.02h,Stop Loss,$21.50,$370.50,$83914.50,117,$370.50
2024-06-13,17:15:00,19572.25,SELL,1,0.02h,Stop Loss,$49.00,$419.50,$83963.50,117,$419.50
2024-06-13,17:21:00,19823.0,BUY,1,0.02h,Break Even,$0.25,$419.75,$83963.75,117,$419.75
2024-06-13,17:24:00,19565.25,SELL,1,0.02h,Break Even,$0.25,$420.00,$83964.00,117,$420.00
2024-06-13,17:45:00,19839.5,BUY,1,0.02h,Stop Loss,$-6.00,$414.00,$83958.00,117,$414.00
2024-06-13,17:55:00,19579.75,SELL,1,0.02h,Stop Loss,$-6.00,$408.00,$83952.00,117,$408.00
2024-06-13,17:56:00,19839.0,BUY,1,0.02h,Stop Loss,$-6.00,$402.00,$83946.00,117,$402.00
2024-06-13,18:14:00,19583.5,SELL,1,0.02h,Stop Loss,$-6.00,$396.00,$83940.00,117,$396.00
2024-06-13,18:15:00,19845.5,BUY,1,0.02h,Stop Loss,$-6.00,$390.00,$83934.00,117,$390.00
2024-06-13,18:21:00,19586.25,SELL,1,0.02h,Stop Loss,$-6.00,$384.00,$83928.00,117,$384.00
2024-06-13,18:22:00,19848.0,BUY,1,0.02h,Stop Loss,$-6.00,$378.00,$83922.00,117,$378.00
2024-06-13,18:23:00,19588.0,SELL,1,0.02h,Stop Loss,$-6.00,$372.00,$83916.00,117,$372.00
2024-06-13,18:34:00,19853.5,BUY,1,0.02h,Stop Loss,$-6.00,$366.00,$83910.00,117,$366.00
2024-06-13,18:38:00,19589.0,SELL,1,0.02h,Stop Loss,$15.25,$381.25,$83925.25,117,$381.25
2024-06-13,18:40:00,19846.25,BUY,1,0.02h,Stop Loss,$-6.00,$375.25,$83919.25,117,$375.25
2024-06-13,18:41:00,19589.25,SELL,1,0.02h,Stop Loss,$-6.00,$369.25,$83913.25,117,$369.25
2024-06-13,18:49:00,19851.5,BUY,1,0.02h,Stop Loss,$6.50,$375.75,$83919.75,117,$375.75
2024-06-13,19:00:00,19599.0,SELL,1,0.02h,Stop Loss,$20.25,$396.00,$83940.00,117,$396.00
2024-06-13,19:04:00,19865.25,BUY,1,0.02h,Stop Loss,$-6.00,$390.00,$83934.00,117,$390.00
2024-06-13,19:05:00,19610.5,SELL,1,0.02h,Stop Loss,$-6.00,$384.00,$83928.00,117,$384.00
2024-06-13,19:06:00,19871.5,BUY,1,0.02h,Stop Loss,$-6.00,$378.00,$83922.00,117,$378.00
2024-06-13,19:07:00,19606.5,SELL,1,0.02h,Stop Loss,$-6.00,$372.00,$83916.00,117,$372.00
2024-06-13,19:14:00,19864.25,BUY,1,0.02h,Stop Loss,$-6.00,$366.00,$83910.00,117,$366.00
2024-06-13,19:17:00,19590.5,SELL,1,0.02h,Stop Loss,$-6.00,$360.00,$83904.00,117,$360.00
2024-06-13,19:18:00,19860.75,BUY,1,0.02h,Stop Loss,$-6.00,$354.00,$83898.00,117,$354.00
2024-06-13,19:19:00,19601.0,SELL,1,0.02h,Stop Loss,$-6.00,$348.00,$83892.00,117,$348.00
2024-06-13,19:28:00,19865.75,BUY,1,0.02h,Stop Loss,$-6.00,$342.00,$83886.00,117,$342.00
2024-06-13,19:29:00,19608.5,SELL,1,0.02h,Stop Loss,$19.00,$361.00,$83905.00,117,$361.00
2024-06-13,19:34:00,19858.5,BUY,1,0.02h,Stop Loss,$-6.00,$355.00,$83899.00,117,$355.00
2024-06-13,19:35:00,19600.0,SELL,1,0.02h,Stop Loss,$14.00,$369.00,$83913.00,117,$369.00
2024-06-13,19:44:00,19863.75,BUY,1,0.02h,Break Even,$0.25,$369.25,$83913.25,117,$369.25
2024-06-13,19:56:00,19617.25,SELL,1,0.02h,Stop Loss,$-6.00,$363.25,$83907.25,117,$363.25
2024-06-13,19:57:00,19882.5,BUY,1,0.02h,Stop Loss,$7.75,$371.00,$83915.00,117,$371.00
2024-06-13,20:07:00,19622.75,SELL,1,0.02h,Stop Loss,$37.75,$408.75,$83952.75,117,$408.75
2024-06-13,20:10:00,19872.0,BUY,1,0.02h,Stop Loss,$-6.00,$402.75,$83946.75,117,$402.75
2024-06-13,20:11:00,19613.25,SELL,1,0.02h,Stop Loss,$6.50,$409.25,$83953.25,117,$409.25
2024-06-13,20:15:00,19877.75,BUY,1,0.02h,Stop Loss,$-6.00,$403.25,$83947.25,117,$403.25
2024-06-13,20:19:00,19611.75,SELL,1,0.02h,Stop Loss,$-6.00,$397.25,$83941.25,117,$397.25
2024-06-13,20:23:00,19873.75,BUY,1,0.02h,Stop Loss,$-6.00,$391.25,$83935.25,117,$391.25
2024-06-13,20:24:00,19613.0,SELL,1,0.02h,Break Even,$0.25,$391.50,$83935.50,117,$391.50
2024-06-13,20:29:00,19875.25,BUY,1,0.02h,Stop Loss,$-6.00,$385.50,$83929.50,117,$385.50
2024-06-13,20:30:00,19613.5,SELL,1,0.02h,Stop Loss,$6.50,$392.00,$83936.00,117,$392.00
2024-06-13,20:33:00,19874.5,BUY,1,0.02h,Stop Loss,$-6.00,$386.00,$83930.00,117,$386.00
2024-06-13,20:39:00,19605.25,SELL,1,0.02h,Break Even,$0.25,$386.25,$83930.25,117,$386.25
2024-06-13,20:49:00,19857.25,BUY,1,0.02h,Stop Loss,$-6.00,$380.25,$83924.25,117,$380.25
2024-06-13,20:53:00,19600.25,SELL,1,0.02h,Stop Loss,$-6.00,$374.25,$83918.25,117,$374.25
2024-06-13,20:54:00,19859.25,BUY,1,0.02h,Break Even,$0.25,$374.50,$83918.50,117,$374.50
2024-06-13,20:58:00,19606.5,SELL,1,0.02h,Stop Loss,$-6.00,$368.50,$83912.50,117,$368.50
2024-06-13,20:59:00,19868.0,BUY,1,0.02h,Stop Loss,$-6.00,$362.50,$83906.50,117,$362.50
2024-06-13,21:00:00,19608.25,SELL,1,1.02h,Stop Loss,$62.75,$425.25,$83969.25,117,$425.25
2024-06-13,22:03:00,19857.0,BUY,1,0.02h,Stop Loss,$-6.00,$419.25,$83963.25,117,$419.25
2024-06-13,22:07:00,19595.75,SELL,1,0.02h,Stop Loss,$-6.00,$413.25,$83957.25,117,$413.25
2024-06-13,22:10:00,19860.5,BUY,1,0.02h,Stop Loss,$-6.00,$407.25,$83951.25,117,$407.25
2024-06-13,22:19:00,19607.5,SELL,1,0.02h,Break Even,$0.25,$407.50,$83951.50,117,$407.50
2024-06-13,22:30:00,19871.0,BUY,1,0.02h,Stop Loss,$-6.00,$401.50,$83945.50,117,$401.50
2024-06-13,22:31:00,19607.25,SELL,1,0.02h,Stop Loss,$-6.00,$395.50,$83939.50,117,$395.50
2024-06-13,22:32:00,19870.75,BUY,1,0.02h,Stop Loss,$-6.00,$389.50,$83933.50,117,$389.50
2024-06-13,22:33:00,19609.25,SELL,1,0.02h,Stop Loss,$-6.00,$383.50,$83927.50,117,$383.50
2024-06-13,22:34:00,19874.0,BUY,1,0.02h,Stop Loss,$-6.00,$377.50,$83921.50,117,$377.50
2024-06-13,22:40:00,19612.5,SELL,1,0.07h,Stop Loss,$-6.00,$371.50,$83915.50,117,$371.50
2024-06-13,22:45:00,19875.0,BUY,1,0.02h,Stop Loss,$-6.00,$365.50,$83909.50,117,$365.50
2024-06-13,22:46:00,19612.25,SELL,1,0.02h,Stop Loss,$-6.00,$359.50,$83903.50,117,$359.50
2024-06-13,22:47:00,19876.0,BUY,1,0.03h,Stop Loss,$-6.00,$353.50,$83897.50,117,$353.50
2024-06-13,22:50:00,19612.25,SELL,1,0.02h,Stop Loss,$-6.00,$347.50,$83891.50,117,$347.50
2024-06-13,22:51:00,19872.5,BUY,1,0.02h,Stop Loss,$-6.00,$341.50,$83885.50,117,$341.50
2024-06-13,22:58:00,19610.25,SELL,1,0.03h,Break Even,$0.25,$341.75,$83885.75,117,$341.75
Final P&L Day: 341.75,,,,,,,,,,,
2024-06-14,12:05:00,19805.25,BUY,1,0.02h,Stop Loss,$-6.00,$-6.00,$83879.75,118,$-6.00
2024-06-14,12:07:00,19552.0,SELL,1,0.02h,Stop Loss,$-6.00,$-12.00,$83873.75,118,$-12.00
2024-06-14,12:08:00,19809.0,BUY,1,0.02h,Break Even,$0.25,$-11.75,$83874.00,118,$-11.75
2024-06-14,12:10:00,19544.0,SELL,1,0.02h,Stop Loss,$-6.00,$-17.75,$83868.00,118,$-17.75
2024-06-14,12:12:00,19809.5,BUY,1,0.02h,Stop Loss,$-6.00,$-23.75,$83862.00,118,$-23.75
2024-06-14,12:14:00,19534.75,SELL,1,0.02h,Stop Loss,$-6.00,$-29.75,$83856.00,118,$-29.75
2024-06-14,12:16:00,19800.75,BUY,1,0.02h,Stop Loss,$-6.00,$-35.75,$83850.00,118,$-35.75
2024-06-14,12:17:00,19543.25,SELL,1,0.02h,Stop Loss,$-6.00,$-41.75,$83844.00,118,$-41.75
2024-06-14,12:21:00,19816.5,BUY,1,0.02h,Stop Loss,$-6.00,$-47.75,$83838.00,118,$-47.75
2024-06-14,12:22:00,19556.5,SELL,1,0.02h,Stop Loss,$-6.00,$-53.75,$83832.00,118,$-53.75
2024-06-14,12:23:00,19825.0,BUY,1,0.02h,Stop Loss,$-6.00,$-59.75,$83826.00,118,$-59.75
2024-06-14,12:26:00,19564.5,SELL,1,0.02h,Stop Loss,$-6.00,$-65.75,$83820.00,118,$-65.75
2024-06-14,12:27:00,19823.5,BUY,1,0.02h,Break Even,$0.25,$-65.50,$83820.25,118,$-65.50
2024-06-14,12:42:00,19559.25,SELL,1,0.02h,Stop Loss,$-6.00,$-71.50,$83814.25,118,$-71.50
2024-06-14,12:56:00,19822.25,BUY,1,0.02h,Stop Loss,$-6.00,$-77.50,$83808.25,118,$-77.50
2024-06-14,12:57:00,19558.75,SELL,1,0.02h,Stop Loss,$-6.00,$-83.50,$83802.25,118,$-83.50
2024-06-14,12:58:00,19819.75,BUY,1,0.02h,Break Even,$0.25,$-83.25,$83802.50,118,$-83.25
2024-06-14,13:03:00,19558.5,SELL,1,0.02h,Stop Loss,$10.25,$-73.00,$83812.75,118,$-73.00
2024-06-14,13:06:00,19818.25,BUY,1,0.02h,Stop Loss,$-6.00,$-79.00,$83806.75,118,$-79.00
2024-06-14,13:08:00,19559.25,SELL,1,0.02h,Stop Loss,$-6.00,$-85.00,$83800.75,118,$-85.00
2024-06-14,13:09:00,19818.75,BUY,1,0.02h,Break Even,$0.25,$-84.75,$83801.00,118,$-84.75
2024-06-14,13:11:00,19557.5,SELL,1,0.02h,Stop Loss,$-6.00,$-90.75,$83795.00,118,$-90.75
2024-06-14,13:12:00,19822.0,BUY,1,0.02h,Break Even,$0.25,$-90.50,$83795.25,118,$-90.50
2024-06-14,13:18:00,19559.0,SELL,1,0.02h,Break Even,$0.25,$-90.25,$83795.50,118,$-90.25
2024-06-14,13:24:00,19827.25,BUY,1,0.02h,Break Even,$0.25,$-90.00,$83795.75,118,$-90.00
2024-06-14,13:28:00,19565.0,SELL,1,0.02h,Stop Loss,$-6.00,$-96.00,$83789.75,118,$-96.00
2024-06-14,13:29:00,19830.5,BUY,1,0.02h,Stop Loss,$31.50,$-64.50,$83821.25,118,$-64.50
2024-06-14,13:31:00,19577.75,SELL,1,0.02h,Stop Loss,$-6.00,$-70.50,$83815.25,118,$-70.50
2024-06-14,13:32:00,19842.75,BUY,1,0.02h,Stop Loss,$-6.00,$-76.50,$83809.25,118,$-76.50
2024-06-14,13:33:00,19561.0,SELL,1,0.02h,Stop Loss,$4.00,$-72.50,$83813.25,118,$-72.50
2024-06-14,13:37:00,19847.25,BUY,1,0.02h,Stop Loss,$-6.00,$-78.50,$83807.25,118,$-78.50
2024-06-14,13:38:00,19590.5,SELL,1,0.02h,Stop Loss,$-6.00,$-84.50,$83801.25,118,$-84.50
2024-06-14,13:39:00,19856.25,BUY,1,0.02h,Stop Loss,$-6.00,$-90.50,$83795.25,118,$-90.50
2024-06-14,13:40:00,19599.25,SELL,1,0.02h,Stop Loss,$19.00,$-71.50,$83814.25,118,$-71.50
2024-06-14,13:44:00,19852.0,BUY,1,0.02h,Stop Loss,$19.00,$-52.50,$83833.25,118,$-52.50
2024-06-14,13:52:00,19626.25,SELL,1,0.02h,Stop Loss,$-6.00,$-58.50,$83827.25,118,$-58.50
2024-06-14,13:53:00,19893.5,BUY,1,0.02h,Stop Loss,$-6.00,$-64.50,$83821.25,118,$-64.50
2024-06-14,13:54:00,19632.0,SELL,1,0.02h,Stop Loss,$15.25,$-49.25,$83836.50,118,$-49.25
2024-06-14,14:01:00,19875.0,BUY,1,0.02h,Stop Loss,$-6.00,$-55.25,$83830.50,118,$-55.25
2024-06-14,14:02:00,19620.25,SELL,1,0.02h,Stop Loss,$7.75,$-47.50,$83838.25,118,$-47.50
2024-06-14,14:06:00,19869.5,BUY,1,0.02h,Stop Loss,$-6.00,$-53.50,$83832.25,118,$-53.50
2024-06-14,14:07:00,19610.75,SELL,1,0.02h,Stop Loss,$-6.00,$-59.50,$83826.25,118,$-59.50
2024-06-14,14:08:00,19890.5,BUY,1,0.02h,Stop Loss,$-6.00,$-65.50,$83820.25,118,$-65.50
2024-06-14,14:10:00,19605.25,SELL,1,0.02h,Stop Loss,$-6.00,$-71.50,$83814.25,118,$-71.50
2024-06-14,14:11:00,19868.5,BUY,1,0.02h,Stop Loss,$-6.00,$-77.50,$83808.25,118,$-77.50
2024-06-14,14:12:00,19605.5,SELL,1,0.02h,Stop Loss,$-6.00,$-83.50,$83802.25,118,$-83.50
2024-06-14,14:13:00,19857.25,BUY,1,0.02h,Stop Loss,$-6.00,$-89.50,$83796.25,118,$-89.50
2024-06-14,14:14:00,19598.75,SELL,1,0.02h,Stop Loss,$-6.00,$-95.50,$83790.25,118,$-95.50
2024-06-14,14:15:00,19856.25,BUY,1,0.02h,Stop Loss,$47.75,$-47.75,$83838.00,118,$-47.75
2024-06-14,14:22:00,19641.5,SELL,1,0.02h,Stop Loss,$44.00,$-3.75,$83882.00,118,$-3.75
2024-06-14,14:24:00,19900.25,BUY,1,0.02h,Stop Loss,$34.00,$30.25,$83916.00,118,$30.25
2024-06-14,14:30:00,19624.25,SELL,1,0.02h,Stop Loss,$11.50,$41.75,$83927.50,118,$41.75
2024-06-14,14:34:00,19866.5,BUY,1,0.02h,Stop Loss,$-6.00,$35.75,$83921.50,118,$35.75
2024-06-14,14:35:00,19610.0,SELL,1,0.02h,Stop Loss,$-6.00,$29.75,$83915.50,118,$29.75
2024-06-14,14:36:00,19862.0,BUY,1,0.02h,Stop Loss,$-6.00,$23.75,$83909.50,118,$23.75
2024-06-14,14:37:00,19592.5,SELL,1,0.02h,Stop Loss,$54.00,$77.75,$83963.50,118,$77.75
2024-06-14,14:40:00,19836.75,BUY,1,0.02h,Stop Loss,$-6.00,$71.75,$83957.50,118,$71.75
2024-06-14,14:41:00,19585.25,SELL,1,0.02h,Stop Loss,$16.50,$88.25,$83974.00,118,$88.25
2024-06-14,14:45:00,19864.75,BUY,1,0.02h,Break Even,$0.25,$88.50,$83974.25,118,$88.50
2024-06-14,14:53:00,19625.25,SELL,1,0.02h,Stop Loss,$5.25,$93.75,$83979.50,118,$93.75
2024-06-14,14:55:00,19891.75,BUY,1,0.02h,Stop Loss,$-6.00,$87.75,$83973.50,118,$87.75
2024-06-14,14:56:00,19629.25,SELL,1,0.02h,Stop Loss,$15.25,$103.00,$83988.75,118,$103.00
2024-06-14,15:00:00,19890.0,BUY,1,0.02h,Break Even,$0.25,$103.25,$83989.00,118,$103.25
2024-06-14,15:10:00,19600.75,SELL,1,0.02h,Stop Loss,$-6.00,$97.25,$83983.00,118,$97.25
2024-06-14,15:11:00,19866.25,BUY,1,0.02h,Stop Loss,$-6.00,$91.25,$83977.00,118,$91.25
2024-06-14,15:12:00,19612.25,SELL,1,0.02h,Stop Loss,$-6.00,$85.25,$83971.00,118,$85.25
2024-06-14,15:13:00,19882.5,BUY,1,0.02h,Break Even,$0.25,$85.50,$83971.25,118,$85.50
2024-06-14,15:15:00,19624.5,SELL,1,0.02h,Stop Loss,$-6.00,$79.50,$83965.25,118,$79.50
2024-06-14,15:16:00,19881.0,BUY,1,0.02h,Break Even,$0.25,$79.75,$83965.50,118,$79.75
2024-06-14,15:18:00,19609.75,SELL,1,0.02h,Stop Loss,$-6.00,$73.75,$83959.50,118,$73.75
2024-06-14,15:19:00,19878.75,BUY,1,0.02h,Stop Loss,$-6.00,$67.75,$83953.50,118,$67.75
2024-06-14,15:21:00,19625.25,SELL,1,0.02h,Stop Loss,$60.25,$128.00,$84013.75,118,$128.00
2024-06-14,15:36:00,19881.25,BUY,1,0.02h,Stop Loss,$-6.00,$122.00,$84007.75,118,$122.00
2024-06-14,15:37:00,19620.0,SELL,1,0.02h,Stop Loss,$31.50,$153.50,$84039.25,118,$153.50
2024-06-14,15:40:00,19871.0,BUY,1,0.02h,Stop Loss,$-6.00,$147.50,$84033.25,118,$147.50
2024-06-14,15:41:00,19602.25,SELL,1,0.02h,Stop Loss,$-6.00,$141.50,$84027.25,118,$141.50
2024-06-14,15:42:00,19860.0,BUY,1,0.02h,Stop Loss,$-6.00,$135.50,$84021.25,118,$135.50
2024-06-14,15:43:00,19601.0,SELL,1,0.02h,Stop Loss,$45.25,$180.75,$84066.50,118,$180.75
2024-06-14,15:48:00,19836.75,BUY,1,0.02h,Break Even,$0.25,$181.00,$84066.75,118,$181.00
2024-06-14,15:56:00,19603.25,SELL,1,0.02h,Stop Loss,$-6.00,$175.00,$84060.75,118,$175.00
2024-06-14,15:57:00,19868.0,BUY,1,0.02h,Stop Loss,$-6.00,$169.00,$84054.75,118,$169.00
2024-06-14,15:58:00,19602.25,SELL,1,0.02h,Stop Loss,$-6.00,$163.00,$84048.75,118,$163.00
2024-06-14,16:00:00,19877.25,BUY,1,0.02h,Stop Loss,$-6.00,$157.00,$84042.75,118,$157.00
2024-06-14,16:03:00,19617.25,SELL,1,0.02h,Break Even,$0.25,$157.25,$84043.00,118,$157.25
2024-06-14,16:06:00,19877.5,BUY,1,0.02h,Break Even,$0.25,$157.50,$84043.25,118,$157.50
2024-06-14,16:28:00,19620.25,SELL,1,0.02h,Stop Loss,$22.75,$180.25,$84066.00,118,$180.25
2024-06-14,16:36:00,19875.75,BUY,1,0.02h,Break Even,$0.25,$180.50,$84066.25,118,$180.50
2024-06-14,16:39:00,19627.0,SELL,1,0.02h,Stop Loss,$-6.00,$174.50,$84060.25,118,$174.50
2024-06-14,16:40:00,19893.0,BUY,1,0.02h,Stop Loss,$-6.00,$168.50,$84054.25,118,$168.50
2024-06-14,16:42:00,19623.75,SELL,1,0.02h,Stop Loss,$10.25,$178.75,$84064.50,118,$178.75
2024-06-14,16:46:00,19889.0,BUY,1,0.02h,Stop Loss,$-6.00,$172.75,$84058.50,118,$172.75
2024-06-14,16:47:00,19626.0,SELL,1,0.02h,Stop Loss,$-6.00,$166.75,$84052.50,118,$166.75
2024-06-14,16:48:00,19887.25,BUY,1,0.02h,Stop Loss,$-6.00,$160.75,$84046.50,118,$160.75
2024-06-14,16:50:00,19626.25,SELL,1,0.02h,Stop Loss,$-6.00,$154.75,$84040.50,118,$154.75
2024-06-14,16:51:00,19890.75,BUY,1,0.02h,Stop Loss,$-6.00,$148.75,$84034.50,118,$148.75
2024-06-14,16:52:00,19635.0,SELL,1,0.02h,Break Even,$0.25,$149.00,$84034.75,118,$149.00
2024-06-14,16:55:00,19883.0,BUY,1,0.02h,Stop Loss,$-6.00,$143.00,$84028.75,118,$143.00
2024-06-14,16:56:00,19623.75,SELL,1,0.02h,Stop Loss,$-6.00,$137.00,$84022.75,118,$137.00
2024-06-14,16:59:00,19888.25,BUY,1,0.02h,Stop Loss,$5.25,$142.25,$84028.00,118,$142.25
2024-06-14,17:14:00,19652.5,SELL,1,0.02h,Stop Loss,$-6.00,$136.25,$84022.00,118,$136.25
2024-06-14,17:15:00,19911.5,BUY,1,0.02h,Stop Loss,$46.50,$182.75,$84068.50,118,$182.75
2024-06-14,17:19:00,19647.5,SELL,1,0.02h,Stop Loss,$-6.00,$176.75,$84062.50,118,$176.75
2024-06-14,17:27:00,19916.5,BUY,1,0.02h,Stop Loss,$-6.00,$170.75,$84056.50,118,$170.75
2024-06-14,17:28:00,19662.0,SELL,1,0.02h,Stop Loss,$-6.00,$164.75,$84050.50,118,$164.75
2024-06-14,17:32:00,19923.25,BUY,1,0.02h,Stop Loss,$21.50,$186.25,$84072.00,118,$186.25
2024-06-14,17:34:00,19666.75,SELL,1,0.02h,Stop Loss,$-6.00,$180.25,$84066.00,118,$180.25
2024-06-14,17:35:00,19929.75,BUY,1,0.02h,Stop Loss,$-6.00,$174.25,$84060.00,118,$174.25
2024-06-14,17:38:00,19669.75,SELL,1,0.02h,Stop Loss,$-6.00,$168.25,$84054.00,118,$168.25
2024-06-14,17:46:00,19928.5,BUY,1,0.02h,Stop Loss,$-6.00,$162.25,$84048.00,118,$162.25
2024-06-14,17:47:00,19666.75,SELL,1,0.02h,Stop Loss,$7.75,$170.00,$84055.75,118,$170.00
2024-06-14,17:56:00,19924.25,BUY,1,0.02h,Stop Loss,$-6.00,$164.00,$84049.75,118,$164.00
2024-06-14,18:06:00,19662.5,SELL,1,0.02h,Break Even,$0.25,$164.25,$84050.00,118,$164.25
2024-06-14,18:12:00,19906.0,BUY,1,0.02h,Stop Loss,$15.25,$179.50,$84065.25,118,$179.50
2024-06-14,18:15:00,19644.25,SELL,1,0.02h,Stop Loss,$-6.00,$173.50,$84059.25,118,$173.50
2024-06-14,18:16:00,19901.25,BUY,1,0.02h,Stop Loss,$-6.00,$167.50,$84053.25,118,$167.50
2024-06-14,18:29:00,19660.0,SELL,1,0.02h,Stop Loss,$-6.00,$161.50,$84047.25,118,$161.50
2024-06-14,18:30:00,19917.0,BUY,1,0.02h,Stop Loss,$-6.00,$155.50,$84041.25,118,$155.50
2024-06-14,18:31:00,19652.5,SELL,1,0.02h,Break Even,$0.25,$155.75,$84041.50,118,$155.75
2024-06-14,18:43:00,19900.0,BUY,1,0.02h,Stop Loss,$-6.00,$149.75,$84035.50,118,$149.75
2024-06-14,18:44:00,19642.75,SELL,1,0.02h,Break Even,$0.25,$150.00,$84035.75,118,$150.00
2024-06-14,18:47:00,19909.25,BUY,1,0.02h,Stop Loss,$-6.00,$144.00,$84029.75,118,$144.00
2024-06-14,18:48:00,19650.75,SELL,1,0.02h,Stop Loss,$9.00,$153.00,$84038.75,118,$153.00
2024-06-14,18:51:00,19917.5,BUY,1,0.02h,Stop Loss,$14.00,$167.00,$84052.75,118,$167.00
2024-06-14,18:54:00,19667.0,SELL,1,0.02h,Stop Loss,$-6.00,$161.00,$84046.75,118,$161.00
2024-06-14,18:58:00,19923.25,BUY,1,0.02h,Stop Loss,$-6.00,$155.00,$84040.75,118,$155.00
2024-06-14,18:59:00,19668.5,SELL,1,0.02h,Break Even,$0.25,$155.25,$84041.00,118,$155.25
2024-06-14,19:05:00,19933.0,BUY,1,0.02h,Stop Loss,$-6.00,$149.25,$84035.00,118,$149.25
2024-06-14,19:20:00,19669.5,SELL,1,0.02h,Stop Loss,$-6.00,$143.25,$84029.00,118,$143.25
2024-06-14,19:21:00,19926.75,BUY,1,0.02h,Break Even,$0.25,$143.50,$84029.25,118,$143.50
2024-06-14,19:27:00,19668.5,SELL,1,0.02h,Stop Loss,$-6.00,$137.50,$84023.25,118,$137.50
2024-06-14,19:28:00,19930.0,BUY,1,0.02h,Stop Loss,$-6.00,$131.50,$84017.25,118,$131.50
2024-06-14,19:29:00,19668.25,SELL,1,0.02h,Stop Loss,$-6.00,$125.50,$84011.25,118,$125.50
2024-06-14,19:35:00,19927.0,BUY,1,0.02h,Stop Loss,$14.00,$139.50,$84025.25,118,$139.50
2024-06-14,19:37:00,19671.5,SELL,1,0.02h,Stop Loss,$-6.00,$133.50,$84019.25,118,$133.50
2024-06-14,19:38:00,19931.0,BUY,1,0.02h,Stop Loss,$-6.00,$127.50,$84013.25,118,$127.50
2024-06-14,19:40:00,19664.25,SELL,1,0.02h,Stop Loss,$-6.00,$121.50,$84007.25,118,$121.50
2024-06-14,19:41:00,19925.0,BUY,1,0.02h,Stop Loss,$-6.00,$115.50,$84001.25,118,$115.50
2024-06-14,19:46:00,19649.0,SELL,1,0.02h,Break Even,$0.25,$115.75,$84001.50,118,$115.75
2024-06-14,19:49:00,19916.5,BUY,1,0.02h,Stop Loss,$-6.00,$109.75,$83995.50,118,$109.75
2024-06-14,19:52:00,19654.5,SELL,1,0.02h,Break Even,$0.25,$110.00,$83995.75,118,$110.00
2024-06-14,19:55:00,19914.5,BUY,1,0.02h,Stop Loss,$19.00,$129.00,$84014.75,118,$129.00
2024-06-14,19:58:00,19668.25,SELL,1,0.02h,Stop Loss,$-6.00,$123.00,$84008.75,118,$123.00
2024-06-14,20:03:00,19945.75,BUY,1,0.02h,Stop Loss,$-6.00,$117.00,$84002.75,118,$117.00
2024-06-14,20:04:00,19686.0,SELL,1,0.02h,Stop Loss,$-6.00,$111.00,$83996.75,118,$111.00
2024-06-14,20:05:00,19946.0,BUY,1,0.02h,Stop Loss,$-6.00,$105.00,$83990.75,118,$105.00
2024-06-14,20:06:00,19688.5,SELL,1,0.02h,Break Even,$0.25,$105.25,$83991.00,118,$105.25
2024-06-14,20:12:00,19944.5,BUY,1,0.02h,Stop Loss,$-6.00,$99.25,$83985.00,118,$99.25
2024-06-14,20:13:00,19686.75,SELL,1,0.02h,Stop Loss,$-6.00,$93.25,$83979.00,118,$93.25
2024-06-14,20:14:00,19948.75,BUY,1,0.02h,Stop Loss,$-6.00,$87.25,$83973.00,118,$87.25
2024-06-14,20:24:00,19689.75,SELL,1,0.02h,Stop Loss,$-6.00,$81.25,$83967.00,118,$81.25
2024-06-14,20:25:00,19953.0,BUY,1,0.02h,Stop Loss,$-6.00,$75.25,$83961.00,118,$75.25
2024-06-14,20:26:00,19696.25,SELL,1,0.02h,Stop Loss,$-6.00,$69.25,$83955.00,118,$69.25
2024-06-14,20:27:00,19958.25,BUY,1,0.02h,Stop Loss,$-6.00,$63.25,$83949.00,118,$63.25
2024-06-14,20:34:00,19694.25,SELL,1,0.02h,Stop Loss,$-6.00,$57.25,$83943.00,118,$57.25
2024-06-14,20:35:00,19953.25,BUY,1,0.02h,Stop Loss,$-6.00,$51.25,$83937.00,118,$51.25
2024-06-14,20:36:00,19694.5,SELL,1,0.02h,Stop Loss,$-6.00,$45.25,$83931.00,118,$45.25
2024-06-14,20:38:00,19954.0,BUY,1,0.02h,Stop Loss,$-6.00,$39.25,$83925.00,118,$39.25
2024-06-14,20:40:00,19693.0,SELL,1,0.02h,Stop Loss,$-6.00,$33.25,$83919.00,118,$33.25
2024-06-14,20:45:00,19953.5,BUY,1,0.02h,Stop Loss,$-6.00,$27.25,$83913.00,118,$27.25
2024-06-14,20:53:00,19686.5,SELL,1,0.02h,Stop Loss,$-6.00,$21.25,$83907.00,118,$21.25
Final P&L Day: 21.25,,,,,,,,,,,
2024-06-17,12:01:00,19981.5,BUY,1,0.02h,Stop Loss,$-6.00,$-6.00,$83901.00,119,$-6.00
2024-06-17,12:36:00,19959.5,SELL,1,0.02h,Stop Loss,$5.25,$-0.75,$83906.25,119,$-0.75
2024-06-17,13:29:00,19954.0,BUY,1,0.02h,Stop Loss,$11.50,$10.75,$83917.75,119,$10.75
2024-06-17,13:35:00,19940.25,SELL,1,0.02h,Stop Loss,$44.00,$54.75,$83961.75,119,$54.75
2024-06-17,13:42:00,19953.0,BUY,1,0.02h,Break Even,$0.25,$55.00,$83962.00,119,$55.00
2024-06-17,13:43:00,19947.75,SELL,1,0.02h,Stop Loss,$35.25,$90.25,$83997.25,119,$90.25
2024-06-17,14:00:00,19954.5,BUY,1,0.02h,Break Even,$0.25,$90.50,$83997.50,119,$90.50
2024-06-17,14:27:00,19946.5,SELL,1,0.02h,Stop Loss,$26.50,$117.00,$84024.00,119,$117.00
2024-06-17,14:36:00,19968.5,BUY,1,0.02h,Break Even,$0.25,$117.25,$84024.25,119,$117.25
2024-06-17,14:51:00,19960.5,SELL,1,0.02h,Stop Loss,$17.75,$135.00,$84042.00,119,$135.00
2024-06-17,14:58:00,19973.0,BUY,1,0.02h,Break Even,$0.25,$135.25,$84042.25,119,$135.25
2024-06-17,15:56:00,20002.25,SELL,1,0.02h,Stop Loss,$-6.00,$129.25,$84036.25,119,$129.25
2024-06-17,15:57:00,20014.0,BUY,1,0.02h,Break Even,$0.25,$129.50,$84036.50,119,$129.50
2024-06-17,15:58:00,20009.5,SELL,1,0.02h,Stop Loss,$-6.00,$123.50,$84030.50,119,$123.50
2024-06-17,16:00:00,20015.0,BUY,1,0.02h,Stop Loss,$15.25,$138.75,$84045.75,119,$138.75
2024-06-17,18:19:00,20225.75,SELL,1,0.02h,Break Even,$0.25,$139.00,$84046.00,119,$139.00
2024-06-17,18:30:00,20240.25,BUY,1,0.02h,Stop Loss,$9.00,$148.00,$84055.00,119,$148.00
2024-06-17,18:41:00,20234.25,SELL,1,0.02h,Break Even,$0.25,$148.25,$84055.25,119,$148.25
2024-06-17,19:12:00,20236.75,BUY,1,0.02h,Break Even,$0.25,$148.50,$84055.50,119,$148.50
2024-06-17,19:37:00,20239.75,SELL,1,0.02h,Break Even,$0.25,$148.75,$84055.75,119,$148.75
2024-06-17,20:30:00,20181.75,BUY,1,0.02h,Stop Loss,$-6.00,$142.75,$84049.75,119,$142.75
2024-06-17,20:36:00,20179.75,SELL,1,0.02h,Stop Loss,$-6.00,$136.75,$84043.75,119,$136.75
2024-06-17,20:43:00,20183.25,BUY,1,0.03h,Break Even,$0.25,$137.00,$84044.00,119,$137.00
2024-06-17,20:50:00,20178.75,SELL,1,0.02h,Stop Loss,$-6.00,$131.00,$84038.00,119,$131.00
2024-06-17,20:56:00,20182.75,BUY,1,0.05h,Break Even,$0.25,$131.25,$84038.25,119,$131.25
2024-06-17,22:38:00,20206.5,SELL,1,0.02h,Break Even,$0.25,$131.50,$84038.50,119,$131.50
2024-06-17,22:44:00,20210.25,BUY,1,0.02h,Stop Loss,$-6.00,$125.50,$84032.50,119,$125.50
2024-06-17,22:50:00,20207.25,SELL,1,0.02h,Stop Loss,$-6.00,$119.50,$84026.50,119,$119.50
Final P&L Day: 119.50,,,,,,,,,,,
2024-06-18,12:20:00,20230.0,BUY,1,0.02h,Break Even,$0.25,$0.25,$84026.75,120,$0.25
2024-06-18,12:23:00,19958.25,SELL,1,0.02h,Stop Loss,$-6.00,$-5.75,$84020.75,120,$-5.75
2024-06-18,12:24:00,20233.5,BUY,1,0.02h,Stop Loss,$10.25,$4.50,$84031.00,120,$4.50
2024-06-18,12:34:00,19931.0,SELL,1,0.02h,Stop Loss,$-6.00,$-1.50,$84025.00,120,$-1.50
2024-06-18,12:35:00,20215.75,BUY,1,0.02h,Stop Loss,$14.00,$12.50,$84039.00,120,$12.50
2024-06-18,12:37:00,19936.5,SELL,1,0.02h,Stop Loss,$-6.00,$6.50,$84033.00,120,$6.50
2024-06-18,12:38:00,20207.25,BUY,1,0.02h,Stop Loss,$-6.00,$0.50,$84027.00,120,$0.50
2024-06-18,12:39:00,19932.0,SELL,1,0.02h,Stop Loss,$-6.00,$-5.50,$84021.00,120,$-5.50
2024-06-18,12:45:00,20198.75,BUY,1,0.02h,Stop Loss,$-6.00,$-11.50,$84015.00,120,$-11.50
2024-06-18,12:46:00,19933.25,SELL,1,0.02h,Stop Loss,$-6.00,$-17.50,$84009.00,120,$-17.50
2024-06-18,12:47:00,20210.25,BUY,1,0.02h,Stop Loss,$-6.00,$-23.50,$84003.00,120,$-23.50
2024-06-18,12:49:00,19934.25,SELL,1,0.02h,Break Even,$0.25,$-23.25,$84003.25,120,$-23.25
2024-06-18,12:56:00,20210.25,BUY,1,0.02h,Stop Loss,$-6.00,$-29.25,$83997.25,120,$-29.25
2024-06-18,13:00:00,19936.0,SELL,1,0.02h,Stop Loss,$-6.00,$-35.25,$83991.25,120,$-35.25
2024-06-18,13:01:00,20199.25,BUY,1,0.02h,Stop Loss,$-6.00,$-41.25,$83985.25,120,$-41.25
2024-06-18,13:02:00,19922.0,SELL,1,0.02h,Stop Loss,$-6.00,$-47.25,$83979.25,120,$-47.25
2024-06-18,13:03:00,20201.75,BUY,1,0.02h,Stop Loss,$-6.00,$-53.25,$83973.25,120,$-53.25
2024-06-18,13:09:00,19921.0,SELL,1,0.02h,Stop Loss,$-6.00,$-59.25,$83967.25,120,$-59.25
2024-06-18,13:10:00,20195.25,BUY,1,0.02h,Break Even,$0.25,$-59.00,$83967.50,120,$-59.00
2024-06-18,13:19:00,19933.25,SELL,1,0.02h,Stop Loss,$-6.00,$-65.00,$83961.50,120,$-65.00
2024-06-18,13:20:00,20204.5,BUY,1,0.02h,Break Even,$0.25,$-64.75,$83961.75,120,$-64.75
2024-06-18,13:23:00,19929.75,SELL,1,0.02h,Stop Loss,$9.00,$-55.75,$83970.75,120,$-55.75
2024-06-18,13:38:00,20211.5,BUY,1,0.02h,Break Even,$0.25,$-55.50,$83971.00,120,$-55.50
2024-06-18,13:44:00,19909.75,SELL,1,0.02h,Stop Loss,$-6.00,$-61.50,$83965.00,120,$-61.50
2024-06-18,13:45:00,20190.75,BUY,1,0.02h,Stop Loss,$-6.00,$-67.50,$83959.00,120,$-67.50
2024-06-18,13:46:00,19914.0,SELL,1,0.02h,Stop Loss,$41.50,$-26.00,$84000.50,120,$-26.00
2024-06-18,13:56:00,20182.0,BUY,1,0.02h,Stop Loss,$39.00,$13.00,$84039.50,120,$13.00
2024-06-18,14:03:00,19903.25,SELL,1,0.02h,Break Even,$0.25,$13.25,$84039.75,120,$13.25
2024-06-18,14:05:00,20189.75,BUY,1,0.02h,Stop Loss,$24.00,$37.25,$84063.75,120,$37.25
2024-06-18,14:24:00,19902.5,SELL,1,0.02h,Stop Loss,$-6.00,$31.25,$84057.75,120,$31.25
2024-06-18,14:31:00,20181.0,BUY,1,0.02h,Stop Loss,$-6.00,$25.25,$84051.75,120,$25.25
2024-06-18,14:32:00,19908.0,SELL,1,0.02h,Stop Loss,$-6.00,$19.25,$84045.75,120,$19.25
2024-06-18,14:39:00,20192.0,BUY,1,0.02h,Stop Loss,$-6.00,$13.25,$84039.75,120,$13.25
2024-06-18,14:40:00,19917.75,SELL,1,0.02h,Stop Loss,$14.00,$27.25,$84053.75,120,$27.25
2024-06-18,14:44:00,20170.75,BUY,1,0.02h,Stop Loss,$-6.00,$21.25,$84047.75,120,$21.25
2024-06-18,14:45:00,19892.25,SELL,1,0.02h,Stop Loss,$-6.00,$15.25,$84041.75,120,$15.25
2024-06-18,14:46:00,20159.0,BUY,1,0.02h,Stop Loss,$60.25,$75.50,$84102.00,120,$75.50
2024-06-18,14:57:00,19886.5,SELL,1,0.02h,Stop Loss,$-6.00,$69.50,$84096.00,120,$69.50
2024-06-18,14:58:00,20156.75,BUY,1,0.02h,Stop Loss,$15.25,$84.75,$84111.25,120,$84.75
2024-06-18,15:00:00,19886.5,SELL,1,0.02h,Stop Loss,$-6.00,$78.75,$84105.25,120,$78.75
2024-06-18,15:02:00,20176.0,BUY,1,0.02h,Break Even,$0.25,$79.00,$84105.50,120,$79.00
2024-06-18,15:05:00,19874.0,SELL,1,0.02h,Stop Loss,$25.25,$104.25,$84130.75,120,$104.25
2024-06-18,15:15:00,20135.5,BUY,1,0.02h,Stop Loss,$31.50,$135.75,$84162.25,120,$135.75
2024-06-18,15:17:00,19865.75,SELL,1,0.02h,Stop Loss,$-6.00,$129.75,$84156.25,120,$129.75
2024-06-18,15:22:00,20155.75,BUY,1,0.02h,Stop Loss,$-6.00,$123.75,$84150.25,120,$123.75
2024-06-18,15:23:00,19881.25,SELL,1,0.02h,Stop Loss,$-6.00,$117.75,$84144.25,120,$117.75
2024-06-18,15:29:00,20154.75,BUY,1,0.02h,Break Even,$0.25,$118.00,$84144.50,120,$118.00
2024-06-18,15:34:00,19877.5,SELL,1,0.02h,Break Even,$0.25,$118.25,$84144.75,120,$118.25
2024-06-18,15:37:00,20161.25,BUY,1,0.02h,Stop Loss,$11.50,$129.75,$84156.25,120,$129.75
2024-06-18,15:44:00,19895.75,SELL,1,0.02h,Break Even,$0.25,$130.00,$84156.50,120,$130.00
2024-06-18,15:49:00,20175.75,BUY,1,0.02h,Stop Loss,$-6.00,$124.00,$84150.50,120,$124.00
2024-06-18,15:50:00,19903.0,SELL,1,0.02h,Stop Loss,$9.00,$133.00,$84159.50,120,$133.00
2024-06-18,15:55:00,20173.25,BUY,1,0.02h,Stop Loss,$-6.00,$127.00,$84153.50,120,$127.00
2024-06-18,16:00:00,19911.25,SELL,1,0.02h,Stop Loss,$-6.00,$121.00,$84147.50,120,$121.00
2024-06-18,16:01:00,20189.25,BUY,1,0.02h,Stop Loss,$-6.00,$115.00,$84141.50,120,$115.00
2024-06-18,16:02:00,19912.5,SELL,1,0.02h,Stop Loss,$-6.00,$109.00,$84135.50,120,$109.00
2024-06-18,16:19:00,20174.0,BUY,1,0.02h,Break Even,$0.25,$109.25,$84135.75,120,$109.25
2024-06-18,16:34:00,19899.5,SELL,1,0.02h,Stop Loss,$-6.00,$103.25,$84129.75,120,$103.25
2024-06-18,16:35:00,20177.25,BUY,1,0.02h,Stop Loss,$-6.00,$97.25,$84123.75,120,$97.25
2024-06-18,16:36:00,19905.25,SELL,1,0.02h,Stop Loss,$7.75,$105.00,$84131.50,120,$105.00
2024-06-18,16:40:00,20178.5,BUY,1,0.02h,Break Even,$0.25,$105.25,$84131.75,120,$105.25
2024-06-18,16:42:00,19903.5,SELL,1,0.02h,Break Even,$0.25,$105.50,$84132.00,120,$105.50
2024-06-18,16:51:00,20180.5,BUY,1,0.02h,Stop Loss,$12.75,$118.25,$84144.75,120,$118.25
2024-06-18,17:09:00,19925.5,SELL,1,0.02h,Stop Loss,$-6.00,$112.25,$84138.75,120,$112.25
2024-06-18,17:10:00,20205.25,BUY,1,0.02h,Stop Loss,$-6.00,$106.25,$84132.75,120,$106.25
2024-06-18,17:11:00,19925.25,SELL,1,0.02h,Break Even,$0.25,$106.50,$84133.00,120,$106.50
2024-06-18,17:18:00,20200.0,BUY,1,0.02h,Stop Loss,$-6.00,$100.50,$84127.00,120,$100.50
2024-06-18,17:19:00,19927.0,SELL,1,0.02h,Stop Loss,$-6.00,$94.50,$84121.00,120,$94.50
2024-06-18,17:20:00,20203.25,BUY,1,0.02h,Break Even,$0.25,$94.75,$84121.25,120,$94.75
2024-06-18,17:22:00,19933.0,SELL,1,0.02h,Break Even,$0.25,$95.00,$84121.50,120,$95.00
2024-06-18,17:31:00,20206.0,BUY,1,0.02h,Break Even,$0.25,$95.25,$84121.75,120,$95.25
2024-06-18,17:40:00,19933.0,SELL,1,0.02h,Stop Loss,$-6.00,$89.25,$84115.75,120,$89.25
2024-06-18,17:41:00,20213.75,BUY,1,0.02h,Break Even,$0.25,$89.50,$84116.00,120,$89.50
2024-06-18,17:49:00,19948.25,SELL,1,0.02h,Stop Loss,$-6.00,$83.50,$84110.00,120,$83.50
2024-06-18,17:58:00,20209.75,BUY,1,0.02h,Break Even,$0.25,$83.75,$84110.25,120,$83.75
2024-06-18,18:04:00,19894.5,SELL,1,0.02h,Stop Loss,$7.75,$91.50,$84118.00,120,$91.50
2024-06-18,18:25:00,20180.25,BUY,1,0.02h,Break Even,$0.25,$91.75,$84118.25,120,$91.75
2024-06-18,18:32:00,19910.5,SELL,1,0.02h,Stop Loss,$-6.00,$85.75,$84112.25,120,$85.75
2024-06-18,18:43:00,20187.25,BUY,1,0.02h,Stop Loss,$-6.00,$79.75,$84106.25,120,$79.75
2024-06-18,18:50:00,19905.0,SELL,1,0.02h,Stop Loss,$-6.00,$73.75,$84100.25,120,$73.75
2024-06-18,18:51:00,20189.25,BUY,1,0.02h,Break Even,$0.25,$74.00,$84100.50,120,$74.00
2024-06-18,18:57:00,19913.25,SELL,1,0.02h,Stop Loss,$-6.00,$68.00,$84094.50,120,$68.00
2024-06-18,18:58:00,20193.5,BUY,1,0.02h,Stop Loss,$16.50,$84.50,$84111.00,120,$84.50
2024-06-18,19:02:00,19917.75,SELL,1,0.02h,Stop Loss,$26.50,$111.00,$84137.50,120,$111.00
2024-06-18,19:05:00,20184.25,BUY,1,0.02h,Stop Loss,$-6.00,$105.00,$84131.50,120,$105.00
2024-06-18,19:06:00,19916.25,SELL,1,0.02h,Stop Loss,$20.25,$125.25,$84151.75,120,$125.25
2024-06-18,19:09:00,20186.25,BUY,1,0.02h,Stop Loss,$-6.00,$119.25,$84145.75,120,$119.25
2024-06-18,19:10:00,19909.25,SELL,1,0.02h,Stop Loss,$-6.00,$113.25,$84139.75,120,$113.25
2024-06-18,19:11:00,20183.5,BUY,1,0.02h,Break Even,$0.25,$113.50,$84140.00,120,$113.50
2024-06-18,19:17:00,19921.25,SELL,1,0.02h,Stop Loss,$6.50,$120.00,$84146.50,120,$120.00
2024-06-18,19:21:00,20194.5,BUY,1,0.02h,Break Even,$0.25,$120.25,$84146.75,120,$120.25
2024-06-18,19:23:00,19921.5,SELL,1,0.02h,Stop Loss,$-6.00,$114.25,$84140.75,120,$114.25
2024-06-18,19:24:00,20196.5,BUY,1,0.02h,Break Even,$0.25,$114.50,$84141.00,120,$114.50
2024-06-18,19:26:00,19923.5,SELL,1,0.02h,Break Even,$0.25,$114.75,$84141.25,120,$114.75
2024-06-18,19:28:00,20199.25,BUY,1,0.02h,Stop Loss,$-6.00,$108.75,$84135.25,120,$108.75
2024-06-18,19:29:00,19920.75,SELL,1,0.02h,Stop Loss,$22.75,$131.50,$84158.00,120,$131.50
2024-06-18,19:48:00,20182.5,BUY,1,0.02h,Stop Loss,$4.00,$135.50,$84162.00,120,$135.50
2024-06-18,19:56:00,19925.25,SELL,1,0.02h,Break Even,$0.25,$135.75,$84162.25,120,$135.75
2024-06-18,19:59:00,20204.0,BUY,1,0.02h,Stop Loss,$-6.00,$129.75,$84156.25,120,$129.75
2024-06-18,20:00:00,19923.25,SELL,1,0.02h,Stop Loss,$22.75,$152.50,$84179.00,120,$152.50
2024-06-18,20:08:00,20201.0,BUY,1,0.02h,Stop Loss,$-6.00,$146.50,$84173.00,120,$146.50
2024-06-18,20:09:00,19923.25,SELL,1,0.02h,Stop Loss,$-6.00,$140.50,$84167.00,120,$140.50
2024-06-18,20:12:00,20205.0,BUY,1,0.02h,Break Even,$0.25,$140.75,$84167.25,120,$140.75
2024-06-18,20:19:00,19928.75,SELL,1,0.02h,Stop Loss,$-6.00,$134.75,$84161.25,120,$134.75
2024-06-18,20:20:00,20205.5,BUY,1,0.02h,Stop Loss,$-6.00,$128.75,$84155.25,120,$128.75
2024-06-18,20:22:00,19930.25,SELL,1,0.02h,Stop Loss,$-6.00,$122.75,$84149.25,120,$122.75
2024-06-18,20:23:00,20204.5,BUY,1,0.03h,Stop Loss,$-6.00,$116.75,$84143.25,120,$116.75
2024-06-18,20:26:00,19929.25,SELL,1,0.02h,Stop Loss,$-6.00,$110.75,$84137.25,120,$110.75
2024-06-18,20:27:00,20206.75,BUY,1,0.02h,Stop Loss,$-6.00,$104.75,$84131.25,120,$104.75
2024-06-18,20:32:00,19931.0,SELL,1,0.02h,Break Even,$0.25,$105.00,$84131.50,120,$105.00
2024-06-18,20:34:00,20206.0,BUY,1,0.02h,Stop Loss,$-6.00,$99.00,$84125.50,120,$99.00
2024-06-18,20:35:00,19929.5,SELL,1,0.02h,Stop Loss,$-6.00,$93.00,$84119.50,120,$93.00
2024-06-18,20:37:00,20205.0,BUY,1,0.02h,Stop Loss,$-6.00,$87.00,$84113.50,120,$87.00
2024-06-18,20:38:00,19928.5,SELL,1,0.02h,Stop Loss,$-6.00,$81.00,$84107.50,120,$81.00
2024-06-18,20:39:00,20205.5,BUY,1,0.03h,Stop Loss,$-6.00,$75.00,$84101.50,120,$75.00
2024-06-18,21:00:00,19933.5,SELL,1,1.02h,Stop Loss,$-6.00,$69.00,$84095.50,120,$69.00
2024-06-18,22:01:00,20208.0,BUY,1,0.02h,Break Even,$0.25,$69.25,$84095.75,120,$69.25
2024-06-18,22:03:00,19931.75,SELL,1,0.02h,Stop Loss,$-6.00,$63.25,$84089.75,120,$63.25
2024-06-18,22:13:00,20217.75,BUY,1,0.02h,Stop Loss,$-6.00,$57.25,$84083.75,120,$57.25
2024-06-18,22:20:00,19941.0,SELL,1,0.02h,Stop Loss,$-6.00,$51.25,$84077.75,120,$51.25
2024-06-18,22:21:00,20219.25,BUY,1,0.02h,Break Even,$0.25,$51.50,$84078.00,120,$51.50
2024-06-18,22:25:00,19942.75,SELL,1,0.02h,Stop Loss,$-6.00,$45.50,$84072.00,120,$45.50
2024-06-18,22:26:00,20219.25,BUY,1,0.02h,Stop Loss,$-6.00,$39.50,$84066.00,120,$39.50
2024-06-18,22:27:00,19942.75,SELL,1,0.07h,Break Even,$0.25,$39.75,$84066.25,120,$39.75
2024-06-18,22:47:00,20229.0,BUY,1,0.02h,Stop Loss,$-6.00,$33.75,$84060.25,120,$33.75
2024-06-18,22:48:00,19953.5,SELL,1,0.02h,Break Even,$0.25,$34.00,$84060.50,120,$34.00
2024-06-18,22:51:00,20229.25,BUY,1,0.02h,Stop Loss,$-6.00,$28.00,$84054.50,120,$28.00
2024-06-18,22:52:00,19951.75,SELL,1,0.02h,Stop Loss,$-6.00,$22.00,$84048.50,120,$22.00
2024-06-18,22:53:00,20229.75,BUY,1,0.02h,Stop Loss,$-6.00,$16.00,$84042.50,120,$16.00
2024-06-18,22:55:00,19952.0,SELL,1,0.03h,Stop Loss,$-6.00,$10.00,$84036.50,120,$10.00
2024-06-18,22:57:00,20230.25,BUY,1,0.02h,Stop Loss,$-6.00,$4.00,$84030.50,120,$4.00
Final P&L Day: 4.00,,,,,,,,,,,
2024-06-19,12:13:00,19958.5,SELL,1,0.02h,Stop Loss,$-6.00,$-6.00,$84024.50,121,$-6.00
2024-06-19,12:25:00,20232.25,BUY,1,0.02h,Stop Loss,$-6.00,$-12.00,$84018.50,121,$-12.00
2024-06-19,12:26:00,19956.75,SELL,1,0.02h,Stop Loss,$-6.00,$-18.00,$84012.50,121,$-18.00
2024-06-19,12:27:00,20233.0,BUY,1,0.02h,Stop Loss,$-6.00,$-24.00,$84006.50,121,$-24.00
2024-06-19,12:28:00,19958.75,SELL,1,0.02h,Stop Loss,$-6.00,$-30.00,$84000.50,121,$-30.00
2024-06-19,12:29:00,20235.25,BUY,1,0.03h,Stop Loss,$-6.00,$-36.00,$83994.50,121,$-36.00
2024-06-19,12:41:00,19960.75,SELL,1,0.02h,Stop Loss,$-6.00,$-42.00,$83988.50,121,$-42.00
2024-06-19,12:42:00,20238.5,BUY,1,0.02h,Break Even,$0.25,$-41.75,$83988.75,121,$-41.75
2024-06-19,12:48:00,19965.25,SELL,1,0.02h,Stop Loss,$-6.00,$-47.75,$83982.75,121,$-47.75
2024-06-19,12:50:00,20242.0,BUY,1,0.02h,Stop Loss,$-6.00,$-53.75,$83976.75,121,$-53.75
2024-06-19,12:51:00,19968.75,SELL,1,0.02h,Stop Loss,$-6.00,$-59.75,$83970.75,121,$-59.75
2024-06-19,12:52:00,20244.5,BUY,1,0.02h,Stop Loss,$-6.00,$-65.75,$83964.75,121,$-65.75
2024-06-19,12:54:00,19968.25,SELL,1,0.03h,Stop Loss,$-6.00,$-71.75,$83958.75,121,$-71.75
2024-06-19,13:00:00,20242.0,BUY,1,0.02h,Stop Loss,$-6.00,$-77.75,$83952.75,121,$-77.75
2024-06-19,13:05:00,19971.25,SELL,1,0.02h,Stop Loss,$-6.00,$-83.75,$83946.75,121,$-83.75
2024-06-19,13:06:00,20247.5,BUY,1,0.02h,Break Even,$0.25,$-83.50,$83947.00,121,$-83.50
2024-06-19,13:09:00,19972.0,SELL,1,0.02h,Stop Loss,$-6.00,$-89.50,$83941.00,121,$-89.50
2024-06-19,13:18:00,20244.75,BUY,1,0.02h,Break Even,$0.25,$-89.25,$83941.25,121,$-89.25
2024-06-19,13:20:00,19972.25,SELL,1,0.02h,Stop Loss,$-6.00,$-95.25,$83935.25,121,$-95.25
2024-06-19,13:21:00,20245.75,BUY,1,0.02h,Stop Loss,$-6.00,$-101.25,$83929.25,121,$-101.25
2024-06-19,13:22:00,19970.25,SELL,1,0.02h,Break Even,$0.25,$-101.00,$83929.50,121,$-101.00
2024-06-19,13:24:00,20244.5,BUY,1,0.03h,Stop Loss,$-6.00,$-107.00,$83923.50,121,$-107.00
2024-06-19,13:26:00,19970.0,SELL,1,0.02h,Stop Loss,$-6.00,$-113.00,$83917.50,121,$-113.00
2024-06-19,13:27:00,20243.75,BUY,1,0.02h,Stop Loss,$-6.00,$-119.00,$83911.50,121,$-119.00
2024-06-19,13:28:00,19967.75,SELL,1,0.02h,Break Even,$0.25,$-118.75,$83911.75,121,$-118.75
2024-06-19,13:30:00,20242.75,BUY,1,0.02h,Stop Loss,$26.50,$-92.25,$83938.25,121,$-92.25
2024-06-19,13:35:00,19971.0,SELL,1,0.02h,Stop Loss,$14.00,$-78.25,$83952.25,121,$-78.25
2024-06-19,13:48:00,20242.25,BUY,1,0.03h,Stop Loss,$-6.00,$-84.25,$83946.25,121,$-84.25
2024-06-19,13:53:00,19965.0,SELL,1,0.02h,Stop Loss,$-6.00,$-90.25,$83940.25,121,$-90.25
2024-06-19,13:54:00,20239.5,BUY,1,0.02h,Stop Loss,$-6.00,$-96.25,$83934.25,121,$-96.25
2024-06-19,13:55:00,19965.0,SELL,1,0.02h,Stop Loss,$-6.00,$-102.25,$83928.25,121,$-102.25
2024-06-19,13:56:00,20239.25,BUY,1,0.03h,Stop Loss,$-6.00,$-108.25,$83922.25,121,$-108.25
2024-06-19,14:08:00,19963.5,SELL,1,0.02h,Stop Loss,$-6.00,$-114.25,$83916.25,121,$-114.25
2024-06-19,14:15:00,20242.0,BUY,1,0.02h,Stop Loss,$-6.00,$-120.25,$83910.25,121,$-120.25
2024-06-19,14:16:00,19964.5,SELL,1,0.05h,Stop Loss,$-6.00,$-126.25,$83904.25,121,$-126.25
2024-06-19,14:23:00,20238.75,BUY,1,0.03h,Stop Loss,$-6.00,$-132.25,$83898.25,121,$-132.25
2024-06-19,14:36:00,19950.0,SELL,1,0.02h,Stop Loss,$-6.00,$-138.25,$83892.25,121,$-138.25
2024-06-19,14:41:00,20232.5,BUY,1,0.02h,Break Even,$0.25,$-138.00,$83892.50,121,$-138.00
2024-06-19,14:47:00,19962.75,SELL,1,0.02h,Stop Loss,$-6.00,$-144.00,$83886.50,121,$-144.00
2024-06-19,14:48:00,20240.75,BUY,1,0.02h,Stop Loss,$-6.00,$-150.00,$83880.50,121,$-150.00
2024-06-19,14:51:00,19960.75,SELL,1,0.02h,Break Even,$0.25,$-149.75,$83880.75,121,$-149.75
2024-06-19,14:58:00,20237.25,BUY,1,0.02h,Stop Loss,$-6.00,$-155.75,$83874.75,121,$-155.75
2024-06-19,15:02:00,19963.0,SELL,1,0.02h,Stop Loss,$-6.00,$-161.75,$83868.75,121,$-161.75
2024-06-19,15:03:00,20241.75,BUY,1,0.02h,Stop Loss,$-6.00,$-167.75,$83862.75,121,$-167.75
2024-06-19,15:08:00,19963.0,SELL,1,0.02h,Stop Loss,$-6.00,$-173.75,$83856.75,121,$-173.75
2024-06-19,15:13:00,20241.25,BUY,1,0.02h,Stop Loss,$-6.00,$-179.75,$83850.75,121,$-179.75
2024-06-19,15:23:00,19962.5,SELL,1,0.02h,Stop Loss,$-6.00,$-185.75,$83844.75,121,$-185.75
2024-06-19,15:37:00,20246.5,BUY,1,0.02h,Stop Loss,$-6.00,$-191.75,$83838.75,121,$-191.75
2024-06-19,15:39:00,19969.75,SELL,1,0.02h,Break Even,$0.25,$-191.50,$83839.00,121,$-191.50
2024-06-19,15:42:00,20245.0,BUY,1,0.02h,Stop Loss,$-6.00,$-197.50,$83833.00,121,$-197.50
2024-06-19,15:53:00,19967.0,SELL,1,0.03h,Stop Loss,$-6.00,$-203.50,$83827.00,121,$-203.50
2024-06-19,15:55:00,20241.75,BUY,1,0.02h,Break Even,$0.25,$-203.25,$83827.25,121,$-203.25
2024-06-19,16:11:00,19956.75,SELL,1,0.02h,Stop Loss,$-6.00,$-209.25,$83821.25,121,$-209.25
2024-06-19,16:19:00,20236.0,BUY,1,0.02h,Stop Loss,$-6.00,$-215.25,$83815.25,121,$-215.25
2024-06-19,16:27:00,19960.0,SELL,1,0.07h,Break Even,$0.25,$-215.00,$83815.50,121,$-215.00
2024-06-19,16:36:00,20237.25,BUY,1,0.02h,Stop Loss,$-6.00,$-221.00,$83809.50,121,$-221.00
2024-06-19,16:37:00,19962.5,SELL,1,0.10h,Stop Loss,$-6.00,$-227.00,$83803.50,121,$-227.00
2024-06-19,16:44:00,20238.25,BUY,1,0.02h,Stop Loss,$-6.00,$-233.00,$83797.50,121,$-233.00
2024-06-19,16:45:00,19962.0,SELL,1,0.02h,Stop Loss,$-6.00,$-239.00,$83791.50,121,$-239.00
2024-06-19,16:46:00,20237.0,BUY,1,0.02h,Stop Loss,$-6.00,$-245.00,$83785.50,121,$-245.00
2024-06-19,16:55:00,19957.25,SELL,1,0.02h,Stop Loss,$-6.00,$-251.00,$83779.50,121,$-251.00
2024-06-19,16:56:00,20231.5,BUY,1,0.02h,Stop Loss,$-6.00,$-257.00,$83773.50,121,$-257.00
2024-06-19,16:57:00,19955.5,SELL,1,0.02h,Stop Loss,$-6.00,$-263.00,$83767.50,121,$-263.00
2024-06-19,16:58:00,20231.25,BUY,1,0.02h,Stop Loss,$-6.00,$-269.00,$83761.50,121,$-269.00
2024-06-19,16:59:00,19954.75,SELL,1,0.02h,Stop Loss,$-6.00,$-275.00,$83755.50,121,$-275.00
2024-06-19,17:00:00,20230.75,BUY,1,5.02h,Stop Loss,$-6.00,$-281.00,$83749.50,121,$-281.00
2024-06-19,22:01:00,19961.75,SELL,1,0.03h,Break Even,$0.25,$-280.75,$83749.75,121,$-280.75
2024-06-19,22:04:00,20237.5,BUY,1,0.02h,Stop Loss,$-6.00,$-286.75,$83743.75,121,$-286.75
2024-06-19,22:12:00,19957.5,SELL,1,0.05h,Stop Loss,$-6.00,$-292.75,$83737.75,121,$-292.75
2024-06-19,22:16:00,20234.0,BUY,1,0.02h,Stop Loss,$-6.00,$-298.75,$83731.75,121,$-298.75
2024-06-19,22:19:00,19958.25,SELL,1,0.02h,Stop Loss,$-6.00,$-304.75,$83725.75,121,$-304.75
2024-06-19,22:20:00,20236.25,BUY,1,0.02h,Stop Loss,$-6.00,$-310.75,$83719.75,121,$-310.75
2024-06-19,22:27:00,19955.5,SELL,1,0.02h,Break Even,$0.25,$-310.50,$83720.00,121,$-310.50
2024-06-19,22:36:00,20230.5,BUY,1,0.02h,Stop Loss,$-6.00,$-316.50,$83714.00,121,$-316.50
2024-06-19,22:37:00,19955.5,SELL,1,0.02h,Stop Loss,$-6.00,$-322.50,$83708.00,121,$-322.50
2024-06-19,22:38:00,20229.5,BUY,1,0.02h,Stop Loss,$-6.00,$-328.50,$83702.00,121,$-328.50
2024-06-19,22:49:00,19956.0,SELL,1,0.03h,Stop Loss,$-6.00,$-334.50,$83696.00,121,$-334.50
Final P&L Day: -334.50,,,,,,,,,,,
2024-06-20,12:02:00,20297.5,BUY,1,0.02h,Stop Loss,$-6.00,$-6.00,$83690.00,122,$-6.00
2024-06-20,12:03:00,20025.0,SELL,1,0.02h,Stop Loss,$-6.00,$-12.00,$83684.00,122,$-12.00
2024-06-20,12:04:00,20301.75,BUY,1,0.02h,Stop Loss,$-6.00,$-18.00,$83678.00,122,$-18.00
2024-06-20,12:07:00,20025.0,SELL,1,0.02h,Stop Loss,$5.25,$-12.75,$83683.25,122,$-12.75
2024-06-20,12:09:00,20295.25,BUY,1,0.02h,Stop Loss,$-6.00,$-18.75,$83677.25,122,$-18.75
2024-06-20,12:11:00,20007.5,SELL,1,0.02h,Stop Loss,$-6.00,$-24.75,$83671.25,122,$-24.75
2024-06-20,12:14:00,20292.0,BUY,1,0.02h,Stop Loss,$-6.00,$-30.75,$83665.25,122,$-30.75
2024-06-20,12:25:00,20012.0,SELL,1,0.02h,Stop Loss,$-6.00,$-36.75,$83659.25,122,$-36.75
2024-06-20,12:28:00,20296.5,BUY,1,0.02h,Stop Loss,$-6.00,$-42.75,$83653.25,122,$-42.75
2024-06-20,12:29:00,20022.5,SELL,1,0.02h,Break Even,$0.25,$-42.50,$83653.50,122,$-42.50
2024-06-20,12:34:00,20283.75,BUY,1,0.02h,Stop Loss,$-6.00,$-48.50,$83647.50,122,$-48.50
2024-06-20,12:37:00,20005.25,SELL,1,0.02h,Break Even,$0.25,$-48.25,$83647.75,122,$-48.25
2024-06-20,12:40:00,20274.0,BUY,1,0.02h,Break Even,$0.25,$-48.00,$83648.00,122,$-48.00
2024-06-20,12:49:00,19999.0,SELL,1,0.02h,Break Even,$0.25,$-47.75,$83648.25,122,$-47.75
2024-06-20,12:57:00,20271.25,BUY,1,0.02h,Stop Loss,$-6.00,$-53.75,$83642.25,122,$-53.75
2024-06-20,12:58:00,19991.0,SELL,1,0.02h,Stop Loss,$5.25,$-48.50,$83647.50,122,$-48.50
2024-06-20,13:06:00,20265.5,BUY,1,0.02h,Stop Loss,$-6.00,$-54.50,$83641.50,122,$-54.50
2024-06-20,13:18:00,19974.0,SELL,1,0.02h,Stop Loss,$-6.00,$-60.50,$83635.50,122,$-60.50
2024-06-20,13:31:00,20252.5,BUY,1,0.02h,Stop Loss,$-6.00,$-66.50,$83629.50,122,$-66.50
2024-06-20,13:35:00,19928.75,SELL,1,0.02h,Break Even,$0.25,$-66.25,$83629.75,122,$-66.25
2024-06-20,13:39:00,20226.75,BUY,1,0.02h,Stop Loss,$20.25,$-46.00,$83650.00,122,$-46.00
2024-06-20,13:51:00,19974.25,SELL,1,0.02h,Stop Loss,$54.00,$8.00,$83704.00,122,$8.00
2024-06-20,13:55:00,20237.0,BUY,1,0.02h,Stop Loss,$-6.00,$2.00,$83698.00,122,$2.00
2024-06-20,13:56:00,19966.0,SELL,1,0.02h,Stop Loss,$-6.00,$-4.00,$83692.00,122,$-4.00
2024-06-20,14:00:00,20234.25,BUY,1,0.02h,Stop Loss,$16.50,$12.50,$83708.50,122,$12.50
2024-06-20,14:02:00,19946.5,SELL,1,0.02h,Stop Loss,$-6.00,$6.50,$83702.50,122,$6.50
2024-06-20,14:11:00,20178.75,BUY,1,0.02h,Break Even,$0.25,$6.75,$83702.75,122,$6.75
2024-06-20,14:13:00,19884.75,SELL,1,0.02h,Stop Loss,$7.75,$14.50,$83710.50,122,$14.50
2024-06-20,14:24:00,20157.25,BUY,1,0.02h,Break Even,$0.25,$14.75,$83710.75,122,$14.75
2024-06-20,14:29:00,19895.75,SELL,1,0.02h,Break Even,$0.25,$15.00,$83711.00,122,$15.00
2024-06-20,14:36:00,20170.0,BUY,1,0.02h,Stop Loss,$-6.00,$9.00,$83705.00,122,$9.00
2024-06-20,14:37:00,19908.0,SELL,1,0.02h,Stop Loss,$-6.00,$3.00,$83699.00,122,$3.00
2024-06-20,14:38:00,20189.25,BUY,1,0.02h,Stop Loss,$9.00,$12.00,$83708.00,122,$12.00
2024-06-20,14:47:00,19901.0,SELL,1,0.02h,Stop Loss,$-6.00,$6.00,$83702.00,122,$6.00
2024-06-20,14:48:00,20172.5,BUY,1,0.02h,Break Even,$0.25,$6.25,$83702.25,122,$6.25
2024-06-20,14:50:00,19903.75,SELL,1,0.02h,Break Even,$0.25,$6.50,$83702.50,122,$6.50
2024-06-20,14:52:00,20190.0,BUY,1,0.02h,Break Even,$0.25,$6.75,$83702.75,122,$6.75
2024-06-20,14:54:00,19916.5,SELL,1,0.02h,Break Even,$0.25,$7.00,$83703.00,122,$7.00
2024-06-20,14:56:00,20191.75,BUY,1,0.02h,Stop Loss,$-6.00,$1.00,$83697.00,122,$1.00
2024-06-20,14:57:00,19929.0,SELL,1,0.02h,Stop Loss,$-6.00,$-5.00,$83691.00,122,$-5.00
2024-06-20,14:58:00,20203.5,BUY,1,0.02h,Stop Loss,$21.50,$16.50,$83712.50,122,$16.50
2024-06-20,15:03:00,19937.75,SELL,1,0.02h,Break Even,$0.25,$16.75,$83712.75,122,$16.75
2024-06-20,15:11:00,20213.75,BUY,1,0.02h,Stop Loss,$-6.00,$10.75,$83706.75,122,$10.75
2024-06-20,15:12:00,19943.25,SELL,1,0.02h,Stop Loss,$-6.00,$4.75,$83700.75,122,$4.75
2024-06-20,15:15:00,20214.0,BUY,1,0.02h,Stop Loss,$-6.00,$-1.25,$83694.75,122,$-1.25
2024-06-20,15:16:00,19939.5,SELL,1,0.02h,Break Even,$0.25,$-1.00,$83695.00,122,$-1.00
2024-06-20,15:18:00,20206.75,BUY,1,0.02h,Stop Loss,$10.25,$9.25,$83705.25,122,$9.25
2024-06-20,15:27:00,19917.0,SELL,1,0.02h,Break Even,$0.25,$9.50,$83705.50,122,$9.50
2024-06-20,15:32:00,20198.0,BUY,1,0.02h,Stop Loss,$-6.00,$3.50,$83699.50,122,$3.50
2024-06-20,15:33:00,19924.5,SELL,1,0.02h,Stop Loss,$-6.00,$-2.50,$83693.50,122,$-2.50
2024-06-20,15:34:00,20195.5,BUY,1,0.02h,Stop Loss,$-6.00,$-8.50,$83687.50,122,$-8.50
2024-06-20,15:35:00,19929.25,SELL,1,0.02h,Stop Loss,$-6.00,$-14.50,$83681.50,122,$-14.50
2024-06-20,15:36:00,20200.5,BUY,1,0.02h,Stop Loss,$-6.00,$-20.50,$83675.50,122,$-20.50
2024-06-20,15:43:00,19935.75,SELL,1,0.02h,Stop Loss,$-6.00,$-26.50,$83669.50,122,$-26.50
2024-06-20,15:44:00,20204.25,BUY,1,0.02h,Stop Loss,$-6.00,$-32.50,$83663.50,122,$-32.50
2024-06-20,15:45:00,19931.75,SELL,1,0.02h,Stop Loss,$-6.00,$-38.50,$83657.50,122,$-38.50
2024-06-20,15:46:00,20197.75,BUY,1,0.02h,Stop Loss,$-6.00,$-44.50,$83651.50,122,$-44.50
2024-06-20,15:47:00,19917.75,SELL,1,0.02h,Stop Loss,$-6.00,$-50.50,$83645.50,122,$-50.50
2024-06-20,15:48:00,20182.0,BUY,1,0.02h,Stop Loss,$11.50,$-39.00,$83657.00,122,$-39.00
2024-06-20,15:50:00,19887.0,SELL,1,0.02h,Break Even,$0.25,$-38.75,$83657.25,122,$-38.75
2024-06-20,15:56:00,20179.25,BUY,1,0.02h,Stop Loss,$-6.00,$-44.75,$83651.25,122,$-44.75
2024-06-20,15:59:00,19904.0,SELL,1,0.02h,Stop Loss,$-6.00,$-50.75,$83645.25,122,$-50.75
2024-06-20,16:00:00,20163.25,BUY,1,0.02h,Stop Loss,$-6.00,$-56.75,$83639.25,122,$-56.75
2024-06-20,16:01:00,19889.75,SELL,1,0.02h,Stop Loss,$-6.00,$-62.75,$83633.25,122,$-62.75
2024-06-20,16:02:00,20157.75,BUY,1,0.02h,Stop Loss,$-6.00,$-68.75,$83627.25,122,$-68.75
2024-06-20,16:03:00,19888.25,SELL,1,0.02h,Stop Loss,$-6.00,$-74.75,$83621.25,122,$-74.75
2024-06-20,16:05:00,20159.5,BUY,1,0.02h,Stop Loss,$-6.00,$-80.75,$83615.25,122,$-80.75
2024-06-20,16:06:00,19903.75,SELL,1,0.02h,Break Even,$0.25,$-80.50,$83615.50,122,$-80.50
2024-06-20,16:09:00,20161.5,BUY,1,0.02h,Stop Loss,$-6.00,$-86.50,$83609.50,122,$-86.50
2024-06-20,16:10:00,19891.25,SELL,1,0.02h,Break Even,$0.25,$-86.25,$83609.75,122,$-86.25
2024-06-20,16:13:00,20158.5,BUY,1,0.02h,Stop Loss,$-6.00,$-92.25,$83603.75,122,$-92.25
2024-06-20,16:14:00,19892.0,SELL,1,0.02h,Break Even,$0.25,$-92.00,$83604.00,122,$-92.00
2024-06-20,16:27:00,20098.0,BUY,1,0.02h,Stop Loss,$-6.00,$-98.00,$83598.00,122,$-98.00
2024-06-20,16:29:00,19813.25,SELL,1,0.02h,Stop Loss,$81.50,$-16.50,$83679.50,122,$-16.50
2024-06-20,16:41:00,20048.75,BUY,1,0.02h,Stop Loss,$-6.00,$-22.50,$83673.50,122,$-22.50
2024-06-20,16:42:00,19793.0,SELL,1,0.02h,Stop Loss,$-6.00,$-28.50,$83667.50,122,$-28.50
2024-06-20,16:43:00,20056.75,BUY,1,0.02h,Stop Loss,$7.75,$-20.75,$83675.25,122,$-20.75
2024-06-20,16:47:00,19801.75,SELL,1,0.02h,Stop Loss,$-6.00,$-26.75,$83669.25,122,$-26.75
2024-06-20,16:48:00,20079.0,BUY,1,0.02h,Stop Loss,$-6.00,$-32.75,$83663.25,122,$-32.75
2024-06-20,16:49:00,19803.0,SELL,1,0.02h,Stop Loss,$16.50,$-16.25,$83679.75,122,$-16.25
2024-06-20,16:51:00,20094.0,BUY,1,0.02h,Break Even,$0.25,$-16.00,$83680.00,122,$-16.00
2024-06-20,17:08:00,19732.0,SELL,1,0.02h,Break Even,$0.25,$-15.75,$83680.25,122,$-15.75
2024-06-20,17:27:00,20012.5,BUY,1,0.02h,Stop Loss,$22.75,$7.00,$83703.00,122,$7.00
2024-06-20,17:29:00,19737.0,SELL,1,0.02h,Stop Loss,$-6.00,$1.00,$83697.00,122,$1.00
2024-06-20,17:30:00,20006.5,BUY,1,0.02h,Stop Loss,$97.75,$98.75,$83794.75,122,$98.75
2024-06-20,17:34:00,19725.5,SELL,1,0.02h,Stop Loss,$-6.00,$92.75,$83788.75,122,$92.75
2024-06-20,17:35:00,19980.0,BUY,1,0.02h,Stop Loss,$25.25,$118.00,$83814.00,122,$118.00
2024-06-20,17:37:00,19708.5,SELL,1,0.02h,Stop Loss,$-6.00,$112.00,$83808.00,122,$112.00
2024-06-20,17:38:00,19974.0,BUY,1,0.02h,Break Even,$0.25,$112.25,$83808.25,122,$112.25
2024-06-20,17:40:00,19708.5,SELL,1,0.02h,Break Even,$0.25,$112.50,$83808.50,122,$112.50
2024-06-20,17:45:00,20017.0,BUY,1,0.02h,Break Even,$0.25,$112.75,$83808.75,122,$112.75
2024-06-20,18:01:00,19781.5,SELL,1,0.02h,Stop Loss,$-6.00,$106.75,$83802.75,122,$106.75
2024-06-20,18:02:00,20051.75,BUY,1,0.02h,Break Even,$0.25,$107.00,$83803.00,122,$107.00
2024-06-20,18:08:00,19811.0,SELL,1,0.02h,Stop Loss,$10.25,$117.25,$83813.25,122,$117.25
2024-06-20,18:21:00,20050.5,BUY,1,0.02h,Stop Loss,$46.50,$163.75,$83859.75,122,$163.75
2024-06-20,18:41:00,19782.25,SELL,1,0.02h,Stop Loss,$-6.00,$157.75,$83853.75,122,$157.75
2024-06-20,18:42:00,20043.0,BUY,1,0.02h,Stop Loss,$-6.00,$151.75,$83847.75,122,$151.75
2024-06-20,18:43:00,19773.0,SELL,1,0.02h,Stop Loss,$-6.00,$145.75,$83841.75,122,$145.75
2024-06-20,18:48:00,20037.25,BUY,1,0.02h,Stop Loss,$-6.00,$139.75,$83835.75,122,$139.75
2024-06-20,18:49:00,19770.0,SELL,1,0.02h,Break Even,$0.25,$140.00,$83836.00,122,$140.00
2024-06-20,18:53:00,20025.0,BUY,1,0.02h,Stop Loss,$25.25,$165.25,$83861.25,122,$165.25
2024-06-20,18:56:00,19762.5,SELL,1,0.02h,Stop Loss,$-6.00,$159.25,$83855.25,122,$159.25
2024-06-20,19:02:00,20016.0,BUY,1,0.02h,Stop Loss,$-6.00,$153.25,$83849.25,122,$153.25
2024-06-20,19:03:00,19729.0,SELL,1,0.02h,Stop Loss,$62.75,$216.00,$83912.00,122,$216.00
2024-06-20,19:08:00,20004.5,BUY,1,0.02h,Stop Loss,$-6.00,$210.00,$83906.00,122,$210.00
2024-06-20,19:09:00,19740.5,SELL,1,0.02h,Stop Loss,$6.50,$216.50,$83912.50,122,$216.50
2024-06-20,19:21:00,20002.5,BUY,1,0.02h,Break Even,$0.25,$216.75,$83912.75,122,$216.75
2024-06-20,19:30:00,19760.75,SELL,1,0.02h,Stop Loss,$6.50,$223.25,$83919.25,122,$223.25
2024-06-20,19:32:00,20028.5,BUY,1,0.02h,Stop Loss,$-6.00,$217.25,$83913.25,122,$217.25
2024-06-20,19:33:00,19760.25,SELL,1,0.02h,Stop Loss,$-6.00,$211.25,$83907.25,122,$211.25
2024-06-20,19:34:00,20036.75,BUY,1,0.02h,Stop Loss,$-6.00,$205.25,$83901.25,122,$205.25
2024-06-20,19:35:00,19786.0,SELL,1,0.02h,Stop Loss,$44.00,$249.25,$83945.25,122,$249.25
2024-06-20,19:37:00,20027.5,BUY,1,0.02h,Stop Loss,$-6.00,$243.25,$83939.25,122,$243.25
2024-06-20,19:38:00,19753.5,SELL,1,0.02h,Stop Loss,$-6.00,$237.25,$83933.25,122,$237.25
2024-06-20,19:39:00,20027.25,BUY,1,0.02h,Stop Loss,$-6.00,$231.25,$83927.25,122,$231.25
2024-06-20,19:52:00,19793.25,SELL,1,0.02h,Stop Loss,$25.25,$256.50,$83952.50,122,$256.50
2024-06-20,19:57:00,20038.75,BUY,1,0.02h,Break Even,$0.25,$256.75,$83952.75,122,$256.75
2024-06-20,19:59:00,19763.25,SELL,1,0.02h,Stop Loss,$-6.00,$250.75,$83946.75,122,$250.75
2024-06-20,20:00:00,20035.75,BUY,1,0.02h,Stop Loss,$-6.00,$244.75,$83940.75,122,$244.75
2024-06-20,20:01:00,19766.25,SELL,1,0.02h,Stop Loss,$21.50,$266.25,$83962.25,122,$266.25
2024-06-20,20:15:00,20035.5,BUY,1,0.02h,Stop Loss,$-6.00,$260.25,$83956.25,122,$260.25
2024-06-20,20:17:00,19775.25,SELL,1,0.02h,Stop Loss,$6.50,$266.75,$83962.75,122,$266.75
2024-06-20,20:24:00,20046.0,BUY,1,0.02h,Stop Loss,$-6.00,$260.75,$83956.75,122,$260.75
2024-06-20,20:27:00,19772.25,SELL,1,0.02h,Stop Loss,$-6.00,$254.75,$83950.75,122,$254.75
2024-06-20,20:28:00,20042.5,BUY,1,0.02h,Break Even,$0.25,$255.00,$83951.00,122,$255.00
2024-06-20,20:32:00,19778.25,SELL,1,0.02h,Stop Loss,$-6.00,$249.00,$83945.00,122,$249.00
2024-06-20,20:35:00,20049.75,BUY,1,0.02h,Break Even,$0.25,$249.25,$83945.25,122,$249.25
2024-06-20,20:47:00,19782.0,SELL,1,0.02h,Break Even,$0.25,$249.50,$83945.50,122,$249.50
2024-06-20,20:49:00,20050.0,BUY,1,0.02h,Stop Loss,$-6.00,$243.50,$83939.50,122,$243.50
2024-06-20,20:59:00,19783.5,SELL,1,0.02h,Stop Loss,$-6.00,$237.50,$83933.50,122,$237.50
2024-06-20,21:00:00,20053.25,BUY,1,1.02h,Stop Loss,$-6.00,$231.50,$83927.50,122,$231.50
2024-06-20,22:08:00,19787.75,SELL,1,0.05h,Stop Loss,$-6.00,$225.50,$83921.50,122,$225.50
2024-06-20,22:17:00,20060.0,BUY,1,0.02h,Stop Loss,$-6.00,$219.50,$83915.50,122,$219.50
2024-06-20,22:18:00,19791.25,SELL,1,0.02h,Stop Loss,$-6.00,$213.50,$83909.50,122,$213.50
2024-06-20,22:19:00,20058.25,BUY,1,0.02h,Break Even,$0.25,$213.75,$83909.75,122,$213.75
2024-06-20,22:24:00,19791.5,SELL,1,0.05h,Break Even,$0.25,$214.00,$83910.00,122,$214.00
2024-06-20,22:32:00,20057.75,BUY,1,0.02h,Stop Loss,$-6.00,$208.00,$83904.00,122,$208.00
2024-06-20,22:35:00,19788.25,SELL,1,0.02h,Stop Loss,$-6.00,$202.00,$83898.00,122,$202.00
2024-06-20,22:36:00,20058.0,BUY,1,0.03h,Stop Loss,$-6.00,$196.00,$83892.00,122,$196.00
2024-06-20,22:41:00,19788.25,SELL,1,0.03h,Stop Loss,$-6.00,$190.00,$83886.00,122,$190.00
2024-06-20,22:43:00,20056.0,BUY,1,0.02h,Stop Loss,$-6.00,$184.00,$83880.00,122,$184.00
2024-06-20,22:44:00,19789.25,SELL,1,0.02h,Break Even,$0.25,$184.25,$83880.25,122,$184.25
2024-06-20,22:47:00,20056.0,BUY,1,0.02h,Stop Loss,$-6.00,$178.25,$83874.25,122,$178.25
2024-06-20,22:48:00,19788.0,SELL,1,0.07h,Stop Loss,$-6.00,$172.25,$83868.25,122,$172.25
2024-06-20,22:53:00,20058.25,BUY,1,0.02h,Break Even,$0.25,$172.50,$83868.50,122,$172.50
Final P&L Day: 172.50,,,,,,,,,,,
2024-06-21,12:04:00,19735.0,SELL,1,0.02h,Stop Loss,$-6.00,$-6.00,$83862.50,123,$-6.00
2024-06-21,12:20:00,19995.75,BUY,1,0.02h,Stop Loss,$-6.00,$-12.00,$83856.50,123,$-12.00
2024-06-21,12:21:00,19727.75,SELL,1,0.02h,Stop Loss,$16.50,$4.50,$83873.00,123,$4.50
2024-06-21,12:24:00,19991.0,BUY,1,0.02h,Stop Loss,$-6.00,$-1.50,$83867.00,123,$-1.50
2024-06-21,12:30:00,19727.75,SELL,1,0.02h,Stop Loss,$10.25,$8.75,$83877.25,123,$8.75
2024-06-21,12:40:00,20021.75,BUY,1,0.02h,Stop Loss,$-6.00,$2.75,$83871.25,123,$2.75
2024-06-21,12:41:00,19753.75,SELL,1,0.02h,Stop Loss,$-6.00,$-3.25,$83865.25,123,$-3.25
2024-06-21,12:42:00,20014.25,BUY,1,0.02h,Stop Loss,$50.25,$47.00,$83915.50,123,$47.00
2024-06-21,12:52:00,19764.75,SELL,1,0.02h,Stop Loss,$-6.00,$41.00,$83909.50,123,$41.00
2024-06-21,12:53:00,20029.0,BUY,1,0.02h,Stop Loss,$-6.00,$35.00,$83903.50,123,$35.00
2024-06-21,12:55:00,19760.75,SELL,1,0.02h,Stop Loss,$-6.00,$29.00,$83897.50,123,$29.00
2024-06-21,12:56:00,20032.5,BUY,1,0.02h,Stop Loss,$-6.00,$23.00,$83891.50,123,$23.00
2024-06-21,12:57:00,19766.5,SELL,1,0.02h,Stop Loss,$-6.00,$17.00,$83885.50,123,$17.00
2024-06-21,12:58:00,20032.25,BUY,1,0.02h,Break Even,$0.25,$17.25,$83885.75,123,$17.25
2024-06-21,13:03:00,19763.25,SELL,1,0.02h,Stop Loss,$49.00,$66.25,$83934.75,123,$66.25
2024-06-21,13:11:00,20023.75,BUY,1,0.02h,Stop Loss,$-6.00,$60.25,$83928.75,123,$60.25
2024-06-21,13:15:00,19768.25,SELL,1,0.02h,Stop Loss,$17.75,$78.00,$83946.50,123,$78.00
2024-06-21,13:20:00,20038.75,BUY,1,0.02h,Stop Loss,$-6.00,$72.00,$83940.50,123,$72.00
2024-06-21,13:50:00,19957.5,SELL,1,0.02h,Stop Loss,$87.75,$159.75,$84028.25,123,$159.75
2024-06-21,14:05:00,19961.5,BUY,1,0.02h,Stop Loss,$15.25,$175.00,$84043.50,123,$175.00
2024-06-21,14:27:00,19965.75,SELL,1,0.02h,Stop Loss,$15.25,$190.25,$84058.75,123,$190.25
2024-06-21,14:47:00,19977.75,BUY,1,0.02h,Stop Loss,$40.25,$230.50,$84099.00,123,$230.50
2024-06-21,15:29:00,19994.5,SELL,1,0.02h,Stop Loss,$5.25,$235.75,$84104.25,123,$235.75
2024-06-21,15:43:00,20013.0,BUY,1,0.02h,Stop Loss,$6.50,$242.25,$84110.75,123,$242.25
2024-06-21,16:16:00,20043.75,SELL,1,0.02h,Break Even,$0.25,$242.50,$84111.00,123,$242.50
2024-06-21,16:17:00,20053.75,BUY,1,0.02h,Stop Loss,$14.00,$256.50,$84125.00,123,$256.50
2024-06-21,16:25:00,20042.75,SELL,1,0.02h,Stop Loss,$11.50,$268.00,$84136.50,123,$268.00
2024-06-21,17:52:00,19977.75,BUY,1,0.02h,Stop Loss,$40.25,$308.25,$84176.75,123,$308.25
2024-06-21,18:00:00,19961.25,SELL,1,0.02h,Break Even,$0.25,$308.50,$84177.00,123,$308.50
2024-06-21,18:12:00,19974.5,BUY,1,0.02h,Stop Loss,$16.50,$325.00,$84193.50,123,$325.00
2024-06-21,18:40:00,19982.25,SELL,1,0.02h,Break Even,$0.25,$325.25,$84193.75,123,$325.25
2024-06-21,19:03:00,19989.75,BUY,1,0.02h,Stop Loss,$19.00,$344.25,$84212.75,123,$344.25
2024-06-21,19:31:00,19993.5,SELL,1,0.02h,Break Even,$0.25,$344.50,$84213.00,123,$344.50
2024-06-21,19:35:00,20002.75,BUY,1,0.02h,Stop Loss,$6.50,$351.00,$84219.50,123,$351.00
2024-06-21,19:47:00,19992.0,SELL,1,0.02h,Stop Loss,$7.75,$358.75,$84227.25,123,$358.75
2024-06-21,19:55:00,20001.5,BUY,1,0.02h,Break Even,$0.25,$359.00,$84227.50,123,$359.00
2024-06-21,19:56:00,19997.0,SELL,1,0.02h,Stop Loss,$29.00,$388.00,$84256.50,123,$388.00
2024-06-21,20:09:00,19998.5,BUY,1,0.02h,Stop Loss,$-6.00,$382.00,$84250.50,123,$382.00
2024-06-21,20:55:00,20006.5,SELL,1,0.05h,Stop Loss,$-6.00,$376.00,$84244.50,123,$376.00
2024-06-21,21:00:00,20009.0,BUY,1,63.00h,Stop Loss,$-6.00,$370.00,$84238.50,123,$370.00
Final P&L Day: 370.00,,,,,,,,,,,
2024-06-24,12:00:00,19954.0,SELL,1,0.02h,Stop Loss,$20.25,$20.25,$84258.75,124,$20.25
2024-06-24,12:25:00,19967.5,BUY,1,0.02h,Break Even,$0.25,$20.50,$84259.00,124,$20.50
2024-06-24,12:35:00,19953.75,SELL,1,0.02h,Stop Loss,$40.25,$60.75,$84299.25,124,$60.75
2024-06-24,13:25:00,19926.25,BUY,1,0.02h,Stop Loss,$-6.00,$54.75,$84293.25,124,$54.75
2024-06-24,13:42:00,19907.25,SELL,1,0.02h,Stop Loss,$36.50,$91.25,$84329.75,124,$91.25
2024-06-24,13:56:00,19931.75,BUY,1,0.02h,Break Even,$0.25,$91.50,$84330.00,124,$91.50
2024-06-24,14:22:00,19949.5,SELL,1,0.02h,Stop Loss,$4.00,$95.50,$84334.00,124,$95.50
2024-06-24,15:01:00,19897.75,BUY,1,0.02h,Break Even,$0.25,$95.75,$84334.25,124,$95.75
2024-06-24,15:27:00,19882.5,SELL,1,0.02h,Stop Loss,$31.50,$127.25,$84365.75,124,$127.25
2024-06-24,15:36:00,19911.25,BUY,1,0.02h,Stop Loss,$-6.00,$121.25,$84359.75,124,$121.25
2024-06-24,15:37:00,19902.0,SELL,1,0.02h,Stop Loss,$-6.00,$115.25,$84353.75,124,$115.25
2024-06-24,15:38:00,19908.0,BUY,1,0.02h,Stop Loss,$44.00,$159.25,$84397.75,124,$159.25
2024-06-24,15:51:00,19900.25,SELL,1,0.02h,Stop Loss,$29.00,$188.25,$84426.75,124,$188.25
2024-06-24,16:00:00,19918.0,BUY,1,0.02h,Break Even,$0.25,$188.50,$84427.00,124,$188.50
2024-06-24,16:08:00,19899.0,SELL,1,0.02h,Stop Loss,$21.50,$210.00,$84448.50,124,$210.00
2024-06-24,16:21:00,19902.75,BUY,1,0.02h,Stop Loss,$-6.00,$204.00,$84442.50,124,$204.00
2024-06-24,16:23:00,19896.75,SELL,1,0.02h,Break Even,$0.25,$204.25,$84442.75,124,$204.25
2024-06-24,16:24:00,19903.0,BUY,1,0.02h,Break Even,$0.25,$204.50,$84443.00,124,$204.50
2024-06-24,16:25:00,19898.0,SELL,1,0.02h,Break Even,$0.25,$204.75,$84443.25,124,$204.75
2024-06-24,16:31:00,19907.25,BUY,1,0.02h,Break Even,$0.25,$205.00,$84443.50,124,$205.00
2024-06-24,16:40:00,19896.75,SELL,1,0.02h,Stop Loss,$-6.00,$199.00,$84437.50,124,$199.00
2024-06-24,17:47:00,19821.75,BUY,1,0.02h,Stop Loss,$-6.00,$193.00,$84431.50,124,$193.00
2024-06-24,17:49:00,19815.0,SELL,1,0.02h,Stop Loss,$11.50,$204.50,$84443.00,124,$204.50
2024-06-24,17:57:00,19828.5,BUY,1,0.02h,Stop Loss,$-6.00,$198.50,$84437.00,124,$198.50
2024-06-24,17:59:00,19810.5,SELL,1,0.02h,Break Even,$0.25,$198.75,$84437.25,124,$198.75
2024-06-24,18:40:00,19800.25,BUY,1,0.02h,Break Even,$0.25,$199.00,$84437.50,124,$199.00
2024-06-24,19:22:00,19826.25,SELL,1,0.02h,Break Even,$0.25,$199.25,$84437.75,124,$199.25
2024-06-24,20:44:00,19751.25,BUY,1,0.02h,Stop Loss,$-6.00,$193.25,$84431.75,124,$193.25
2024-06-24,20:53:00,19746.75,SELL,1,0.02h,Stop Loss,$-6.00,$187.25,$84425.75,124,$187.25
2024-06-24,21:00:00,19753.25,BUY,1,1.02h,Stop Loss,$67.75,$255.00,$84493.50,124,$255.00
2024-06-24,22:47:00,19761.75,SELL,1,0.02h,Stop Loss,$-6.00,$249.00,$84487.50,124,$249.00
2024-06-24,22:48:00,19762.25,BUY,1,0.07h,Stop Loss,$-6.00,$243.00,$84481.50,124,$243.00
2024-06-24,22:52:00,19761.25,SELL,1,0.03h,Stop Loss,$-6.00,$237.00,$84475.50,124,$237.00
2024-06-24,22:54:00,19763.25,BUY,1,0.02h,Break Even,$0.25,$237.25,$84475.75,124,$237.25
2024-06-24,23:00:00,19759.75,SELL,1,13.00h,Stop Loss,$-6.00,$231.25,$84469.75,124,$231.25
Final P&L Day: 231.25,,,,,,,,,,,
2024-06-25,12:00:00,19819.75,BUY,1,0.02h,Stop Loss,$4.00,$4.00,$84473.75,125,$4.00
2024-06-25,12:33:00,19817.25,SELL,1,0.02h,Stop Loss,$-6.00,$-2.00,$84467.75,125,$-2.00
2024-06-25,12:38:00,19829.75,BUY,1,0.02h,Break Even,$0.25,$-1.75,$84468.00,125,$-1.75
2024-06-25,12:42:00,19820.0,SELL,1,0.02h,Stop Loss,$-6.00,$-7.75,$84462.00,125,$-7.75
2024-06-25,12:57:00,19827.75,BUY,1,0.02h,Stop Loss,$5.25,$-2.50,$84467.25,125,$-2.50
2024-06-25,13:28:00,19832.0,SELL,1,0.02h,Stop Loss,$24.00,$21.50,$84491.25,125,$21.50
2024-06-25,13:46:00,19836.75,BUY,1,0.02h,Stop Loss,$-6.00,$15.50,$84485.25,125,$15.50
2024-06-25,14:46:00,19871.75,SELL,1,0.02h,Stop Loss,$-6.00,$9.50,$84479.25,125,$9.50
2024-06-25,15:03:00,19889.75,BUY,1,0.02h,Stop Loss,$10.25,$19.75,$84489.50,125,$19.75
2024-06-25,16:12:00,19943.5,SELL,1,0.02h,Stop Loss,$22.75,$42.50,$84512.25,125,$42.50
2024-06-25,17:15:00,19887.25,BUY,1,0.02h,Stop Loss,$-6.00,$36.50,$84506.25,125,$36.50
2024-06-25,18:49:00,19920.5,SELL,1,0.02h,Break Even,$0.25,$36.75,$84506.50,125,$36.75
2024-06-25,19:00:00,19950.0,BUY,1,0.02h,Stop Loss,$-6.00,$30.75,$84500.50,125,$30.75
2024-06-25,19:01:00,19939.75,SELL,1,0.02h,Stop Loss,$-6.00,$24.75,$84494.50,125,$24.75
2024-06-25,19:03:00,19945.75,BUY,1,0.02h,Break Even,$0.25,$25.00,$84494.75,125,$25.00
2024-06-25,19:04:00,19941.25,SELL,1,0.02h,Stop Loss,$-6.00,$19.00,$84488.75,125,$19.00
2024-06-25,19:06:00,19947.25,BUY,1,0.02h,Break Even,$0.25,$19.25,$84489.00,125,$19.25
2024-06-25,19:11:00,19938.0,SELL,1,0.02h,Break Even,$0.25,$19.50,$84489.25,125,$19.50
2024-06-25,19:17:00,19950.75,BUY,1,0.02h,Stop Loss,$15.25,$34.75,$84504.50,125,$34.75
2024-06-25,19:46:00,19957.0,SELL,1,0.02h,Stop Loss,$9.00,$43.75,$84513.50,125,$43.75
2024-06-25,19:59:00,19973.0,BUY,1,0.02h,Stop Loss,$15.25,$59.00,$84528.75,125,$59.00
2024-06-25,22:33:00,19976.25,SELL,1,0.02h,Break Even,$0.25,$59.25,$84529.00,125,$59.25
2024-06-25,22:58:00,19976.5,BUY,1,0.02h,Break Even,$0.25,$59.50,$84529.25,125,$59.50
Final P&L Day: 59.50,,,,,,,,,,,
2024-06-26,12:15:00,19979.25,SELL,1,0.02h,Stop Loss,$4.00,$4.00,$84533.25,126,$4.00
2024-06-26,13:28:00,19929.25,BUY,1,0.02h,Break Even,$0.25,$4.25,$84533.50,126,$4.25
2024-06-26,14:29:00,19956.25,SELL,1,0.02h,Stop Loss,$45.25,$49.50,$84578.75,126,$49.50
2024-06-26,14:46:00,19997.0,BUY,1,0.02h,Stop Loss,$35.25,$84.75,$84614.00,126,$84.75
2024-06-26,15:00:00,19974.75,SELL,1,0.02h,Stop Loss,$17.75,$102.50,$84631.75,126,$102.50
2024-06-26,15:23:00,19966.25,BUY,1,0.02h,Stop Loss,$26.50,$129.00,$84658.25,126,$129.00
2024-06-26,15:32:00,19951.0,SELL,1,0.02h,Break Even,$0.25,$129.25,$84658.50,126,$129.25
2024-06-26,15:39:00,19966.75,BUY,1,0.02h,Break Even,$0.25,$129.50,$84658.75,126,$129.50
2024-06-26,16:18:00,19998.75,SELL,1,0.02h,Break Even,$0.25,$129.75,$84659.00,126,$129.75
2024-06-26,16:28:00,20013.25,BUY,1,0.02h,Stop Loss,$21.50,$151.25,$84680.50,126,$151.25
2024-06-26,16:38:00,19997.0,SELL,1,0.02h,Stop Loss,$36.50,$187.75,$84717.00,126,$187.75
2024-06-26,17:13:00,19978.75,BUY,1,0.02h,Stop Loss,$5.25,$193.00,$84722.25,126,$193.00
2024-06-26,17:20:00,19946.5,SELL,1,0.02h,Stop Loss,$40.25,$233.25,$84762.50,126,$233.25
2024-06-26,17:35:00,19969.25,BUY,1,0.02h,Stop Loss,$-6.00,$227.25,$84756.50,126,$227.25
2024-06-26,17:38:00,19958.0,SELL,1,0.02h,Stop Loss,$-6.00,$221.25,$84750.50,126,$221.25
2024-06-26,17:39:00,19966.5,BUY,1,0.02h,Stop Loss,$16.50,$237.75,$84767.00,126,$237.75
2024-06-26,18:05:00,19964.5,SELL,1,0.02h,Stop Loss,$20.25,$258.00,$84787.25,126,$258.00
2024-06-26,18:14:00,19972.0,BUY,1,0.02h,Break Even,$0.25,$258.25,$84787.50,126,$258.25
2024-06-26,18:23:00,19964.25,SELL,1,0.02h,Stop Loss,$-6.00,$252.25,$84781.50,126,$252.25
2024-06-26,18:25:00,19976.5,BUY,1,0.02h,Break Even,$0.25,$252.50,$84781.75,126,$252.50
2024-06-26,18:37:00,19963.75,SELL,1,0.02h,Break Even,$0.25,$252.75,$84782.00,126,$252.75
2024-06-26,18:48:00,19972.75,BUY,1,0.02h,Stop Loss,$12.75,$265.50,$84794.75,126,$265.50
2024-06-26,18:56:00,19960.0,SELL,1,0.02h,Stop Loss,$34.00,$299.50,$84828.75,126,$299.50
2024-06-26,19:24:00,19948.25,BUY,1,0.02h,Break Even,$0.25,$299.75,$84829.00,126,$299.75
2024-06-26,20:03:00,19926.75,SELL,1,0.02h,Stop Loss,$10.25,$310.00,$84839.25,126,$310.00
2024-06-26,20:44:00,19947.25,BUY,1,0.02h,Stop Loss,$-6.00,$304.00,$84833.25,126,$304.00
2024-06-26,20:51:00,19943.75,SELL,1,0.02h,Stop Loss,$-6.00,$298.00,$84827.25,126,$298.00
2024-06-26,20:55:00,19948.5,BUY,1,0.02h,Break Even,$0.25,$298.25,$84827.50,126,$298.25
2024-06-26,22:16:00,19948.75,SELL,1,0.02h,Stop Loss,$-6.00,$292.25,$84821.50,126,$292.25
Final P&L Day: 292.25,,,,,,,,,,,
2024-06-27,12:00:00,19974.5,BUY,1,0.02h,Stop Loss,$34.00,$34.00,$84855.50,127,$34.00
2024-06-27,12:30:00,19968.0,SELL,1,0.02h,Stop Loss,$57.75,$91.75,$84913.25,127,$91.75
2024-06-27,12:32:00,19989.0,BUY,1,0.02h,Stop Loss,$21.50,$113.25,$84934.75,127,$113.25
2024-06-27,13:13:00,19992.0,SELL,1,0.02h,Break Even,$0.25,$113.50,$84935.00,127,$113.50
2024-06-27,13:18:00,20000.0,BUY,1,0.02h,Stop Loss,$-6.00,$107.50,$84929.00,127,$107.50
2024-06-27,13:22:00,19993.5,SELL,1,0.02h,Break Even,$0.25,$107.75,$84929.25,127,$107.75
2024-06-27,13:31:00,20015.75,BUY,1,0.02h,Stop Loss,$39.00,$146.75,$84968.25,127,$146.75
2024-06-27,13:54:00,20044.0,SELL,1,0.02h,Stop Loss,$-6.00,$140.75,$84962.25,127,$140.75
2024-06-27,14:01:00,20069.75,BUY,1,0.02h,Stop Loss,$34.00,$174.75,$84996.25,127,$174.75
2024-06-27,14:33:00,20062.0,SELL,1,0.02h,Stop Loss,$-6.00,$168.75,$84990.25,127,$168.75
2024-06-27,15:19:00,20032.25,BUY,1,0.02h,Break Even,$0.25,$169.00,$84990.50,127,$169.00
2024-06-27,15:20:00,20023.25,SELL,1,0.02h,Stop Loss,$25.25,$194.25,$85015.75,127,$194.25
2024-06-27,15:57:00,19988.75,BUY,1,0.02h,Break Even,$0.25,$194.50,$85016.00,127,$194.50
2024-06-27,17:00:00,20028.75,SELL,1,0.02h,Stop Loss,$-6.00,$188.50,$85010.00,127,$188.50
2024-06-27,17:04:00,20047.0,BUY,1,0.02h,Break Even,$0.25,$188.75,$85010.25,127,$188.75
2024-06-27,17:14:00,20036.75,SELL,1,0.02h,Break Even,$0.25,$189.00,$85010.50,127,$189.00
2024-06-27,17:27:00,20042.5,BUY,1,0.02h,Stop Loss,$11.50,$200.50,$85022.00,127,$200.50
2024-06-27,17:55:00,20050.0,SELL,1,0.02h,Stop Loss,$-6.00,$194.50,$85016.00,127,$194.50
2024-06-27,18:49:00,20020.5,BUY,1,0.02h,Stop Loss,$11.50,$206.00,$85027.50,127,$206.00
2024-06-27,19:35:00,20040.5,SELL,1,0.02h,Break Even,$0.25,$206.25,$85027.75,127,$206.25
2024-06-27,19:42:00,20049.75,BUY,1,0.02h,Stop Loss,$-6.00,$200.25,$85021.75,127,$200.25
2024-06-27,19:43:00,20040.5,SELL,1,0.02h,Break Even,$0.25,$200.50,$85022.00,127,$200.50
2024-06-27,20:01:00,20059.75,BUY,1,0.02h,Stop Loss,$4.00,$204.50,$85026.00,127,$204.50
2024-06-27,20:42:00,20067.0,SELL,1,0.02h,Break Even,$0.25,$204.75,$85026.25,127,$204.75
2024-06-27,20:55:00,20069.0,BUY,1,0.02h,Stop Loss,$-6.00,$198.75,$85020.25,127,$198.75
2024-06-27,21:00:00,20067.25,SELL,1,1.02h,Stop Loss,$5.25,$204.00,$85025.50,127,$204.00
2024-06-27,22:11:00,20069.0,BUY,1,0.02h,Stop Loss,$-6.00,$198.00,$85019.50,127,$198.00
2024-06-27,23:00:00,20083.0,SELL,1,13.00h,Stop Loss,$-6.00,$192.00,$85013.50,127,$192.00
Final P&L Day: 192.00,,,,,,,,,,,
2024-06-28,12:00:00,20126.75,BUY,1,0.02h,Break Even,$0.25,$0.25,$85013.75,128,$0.25
2024-06-28,12:39:00,20130.25,SELL,1,0.02h,Stop Loss,$-6.00,$-5.75,$85007.75,128,$-5.75
2024-06-28,13:39:00,20087.5,BUY,1,0.02h,Stop Loss,$14.00,$8.25,$85021.75,128,$8.25
2024-06-28,14:37:00,20210.0,SELL,1,0.02h,Stop Loss,$31.50,$39.75,$85053.25,128,$39.75
2024-06-28,15:35:00,20120.5,BUY,1,0.02h,Stop Loss,$-6.00,$33.75,$85047.25,128,$33.75
2024-06-28,15:44:00,20101.0,SELL,1,0.02h,Stop Loss,$5.25,$39.00,$85052.50,128,$39.00
2024-06-28,15:51:00,20120.75,BUY,1,0.02h,Break Even,$0.25,$39.25,$85052.75,128,$39.25
2024-06-28,15:59:00,20103.5,SELL,1,0.02h,Stop Loss,$-6.00,$33.25,$85046.75,128,$33.25
2024-06-28,16:02:00,20113.75,BUY,1,0.02h,Break Even,$0.25,$33.50,$85047.00,128,$33.50
2024-06-28,16:03:00,20105.0,SELL,1,0.02h,Stop Loss,$24.00,$57.50,$85071.00,128,$57.50
2024-06-28,16:30:00,20070.75,BUY,1,0.02h,Stop Loss,$21.50,$79.00,$85092.50,128,$79.00
2024-06-28,16:34:00,20046.5,SELL,1,0.02h,Stop Loss,$56.50,$135.50,$85149.00,128,$135.50
2024-06-28,17:00:00,20036.5,BUY,1,0.02h,Stop Loss,$-6.00,$129.50,$85143.00,128,$129.50
2024-06-28,17:32:00,20046.25,SELL,1,0.02h,Break Even,$0.25,$129.75,$85143.25,128,$129.75
2024-06-28,18:05:00,20058.25,BUY,1,0.02h,Stop Loss,$-6.00,$123.75,$85137.25,128,$123.75
2024-06-28,18:23:00,20014.0,SELL,1,0.02h,Stop Loss,$29.00,$152.75,$85166.25,128,$152.75
2024-06-28,19:44:00,20013.0,BUY,1,0.02h,Stop Loss,$9.00,$161.75,$85175.25,128,$161.75
2024-06-28,19:56:00,19966.75,SELL,1,0.02h,Stop Loss,$69.00,$230.75,$85244.25,128,$230.75
2024-06-28,20:20:00,19968.75,BUY,1,0.02h,Stop Loss,$-6.00,$224.75,$85238.25,128,$224.75
2024-06-28,20:35:00,19961.5,SELL,1,0.02h,Stop Loss,$-6.00,$218.75,$85232.25,128,$218.75
2024-06-28,20:44:00,19970.75,BUY,1,0.02h,Break Even,$0.25,$219.00,$85232.50,128,$219.00
Final P&L Day: 219.00,,,,,,,,,,,
2024-07-01,12:34:00,19976.75,SELL,1,0.02h,Stop Loss,$-6.00,$-6.00,$85226.50,129,$-6.00
2024-07-01,12:35:00,19981.75,BUY,1,0.02h,Break Even,$0.25,$-5.75,$85226.75,129,$-5.75
2024-07-01,12:37:00,19978.0,SELL,1,0.02h,Break Even,$0.25,$-5.50,$85227.00,129,$-5.50
2024-07-01,12:53:00,19981.0,BUY,1,0.02h,Stop Loss,$10.25,$4.75,$85237.25,129,$4.75
2024-07-01,13:08:00,19965.75,SELL,1,0.02h,Break Even,$0.25,$5.00,$85237.50,129,$5.00
2024-07-01,13:32:00,19976.5,BUY,1,0.02h,Break Even,$0.25,$5.25,$85237.75,129,$5.25
2024-07-01,13:33:00,19946.25,SELL,1,0.02h,Stop Loss,$17.75,$23.00,$85255.50,129,$23.00
2024-07-01,14:04:00,19904.0,BUY,1,0.02h,Stop Loss,$56.50,$79.50,$85312.00,129,$79.50
2024-07-01,14:12:00,19853.25,SELL,1,0.02h,Stop Loss,$64.00,$143.50,$85376.00,129,$143.50
2024-07-01,14:22:00,19909.25,BUY,1,0.02h,Stop Loss,$135.25,$278.75,$85511.25,129,$278.75
2024-07-01,14:42:00,19877.0,SELL,1,0.02h,Stop Loss,$-6.00,$272.75,$85505.25,129,$272.75
2024-07-01,15:12:00,19926.5,BUY,1,0.02h,Break Even,$0.25,$273.00,$85505.50,129,$273.00
2024-07-01,16:59:00,20006.0,SELL,1,0.02h,Break Even,$0.25,$273.25,$85505.75,129,$273.25
2024-07-01,17:37:00,20008.5,BUY,1,0.02h,Break Even,$0.25,$273.50,$85506.00,129,$273.50
2024-07-01,17:50:00,19995.75,SELL,1,0.02h,Stop Loss,$4.00,$277.50,$85510.00,129,$277.50
2024-07-01,18:08:00,20004.75,BUY,1,0.02h,Stop Loss,$27.75,$305.25,$85537.75,129,$305.25
2024-07-01,18:29:00,20006.5,SELL,1,0.02h,Break Even,$0.25,$305.50,$85538.00,129,$305.50
2024-07-01,18:59:00,20017.0,BUY,1,0.02h,Stop Loss,$-6.00,$299.50,$85532.00,129,$299.50
2024-07-01,19:02:00,20008.25,SELL,1,0.02h,Stop Loss,$9.00,$308.50,$85541.00,129,$308.50
2024-07-01,19:06:00,20025.5,BUY,1,0.02h,Stop Loss,$15.25,$323.75,$85556.25,129,$323.75
2024-07-01,19:23:00,20018.5,SELL,1,0.02h,Break Even,$0.25,$324.00,$85556.50,129,$324.00
2024-07-01,19:36:00,20031.25,BUY,1,0.02h,Break Even,$0.25,$324.25,$85556.75,129,$324.25
2024-07-01,19:47:00,20012.5,SELL,1,0.02h,Stop Loss,$6.50,$330.75,$85563.25,129,$330.75
2024-07-01,19:51:00,20031.5,BUY,1,0.02h,Stop Loss,$32.75,$363.50,$85596.00,129,$363.50
2024-07-01,20:16:00,20041.0,SELL,1,0.02h,Stop Loss,$5.25,$368.75,$85601.25,129,$368.75
2024-07-01,20:26:00,20048.25,BUY,1,0.02h,Stop Loss,$-6.00,$362.75,$85595.25,129,$362.75
2024-07-01,20:27:00,20045.25,SELL,1,0.02h,Stop Loss,$-6.00,$356.75,$85589.25,129,$356.75
2024-07-01,20:28:00,20046.75,BUY,1,0.05h,Stop Loss,$-6.00,$350.75,$85583.25,129,$350.75
2024-07-01,20:44:00,20046.0,BUY,1,0.02h,Stop Loss,$-6.00,$344.75,$85577.25,129,$344.75
2024-07-01,20:46:00,20042.5,SELL,1,0.02h,Stop Loss,$-6.00,$338.75,$85571.25,129,$338.75
2024-07-01,22:02:00,20047.0,BUY,1,0.02h,Stop Loss,$9.00,$347.75,$85580.25,129,$347.75
2024-07-01,22:19:00,20042.75,SELL,1,0.02h,Stop Loss,$-6.00,$341.75,$85574.25,129,$341.75
Final P&L Day: 341.75,,,,,,,,,,,
2024-07-02,12:34:00,19958.75,BUY,1,0.02h,Break Even,$0.25,$0.25,$85574.50,130,$0.25
2024-07-02,12:35:00,19953.5,SELL,1,0.02h,Stop Loss,$-6.00,$-5.75,$85568.50,130,$-5.75
2024-07-02,13:01:00,19954.0,BUY,1,0.02h,Stop Loss,$27.75,$22.00,$85596.25,130,$22.00
2024-07-02,14:11:00,20027.5,SELL,1,0.02h,Stop Loss,$11.50,$33.50,$85607.75,130,$33.50
2024-07-02,14:30:00,20058.5,BUY,1,0.02h,Stop Loss,$85.25,$118.75,$85693.00,130,$118.75
2024-07-02,15:21:00,20102.75,SELL,1,0.02h,Stop Loss,$75.25,$194.00,$85768.25,130,$194.00
2024-07-02,15:26:00,20124.0,BUY,1,0.02h,Break Even,$0.25,$194.25,$85768.50,130,$194.25
2024-07-02,15:55:00,20126.5,SELL,1,0.02h,Stop Loss,$20.25,$214.50,$85788.75,130,$214.50
2024-07-02,16:29:00,20102.75,BUY,1,0.02h,Stop Loss,$17.75,$232.25,$85806.50,130,$232.25
2024-07-02,18:35:00,20211.25,SELL,1,0.02h,Stop Loss,$-6.00,$226.25,$85800.50,130,$226.25
2024-07-02,18:36:00,20217.5,BUY,1,0.02h,Stop Loss,$5.25,$231.50,$85805.75,130,$231.50
2024-07-02,18:37:00,20216.75,SELL,1,0.02h,Break Even,$0.25,$231.75,$85806.00,130,$231.75
2024-07-02,18:38:00,20218.25,BUY,1,0.02h,Stop Loss,$11.50,$243.25,$85817.50,130,$243.25
2024-07-02,19:05:00,20221.25,SELL,1,0.02h,Stop Loss,$-6.00,$237.25,$85811.50,130,$237.25
2024-07-02,19:26:00,20224.75,BUY,1,0.02h,Stop Loss,$-6.00,$231.25,$85805.50,130,$231.25
2024-07-02,19:42:00,20218.25,SELL,1,0.02h,Break Even,$0.25,$231.50,$85805.75,130,$231.50
2024-07-02,19:54:00,20231.5,BUY,1,0.02h,Stop Loss,$19.00,$250.50,$85824.75,130,$250.50
2024-07-02,20:38:00,20242.5,SELL,1,0.02h,Stop Loss,$7.75,$258.25,$85832.50,130,$258.25
2024-07-02,21:00:00,20240.25,BUY,1,1.02h,Break Even,$0.25,$258.50,$85832.75,130,$258.50
2024-07-02,22:02:00,20234.5,SELL,1,0.02h,Break Even,$0.25,$258.75,$85833.00,130,$258.75
2024-07-02,22:11:00,20238.5,BUY,1,0.03h,Stop Loss,$-6.00,$252.75,$85827.00,130,$252.75
2024-07-02,22:14:00,20235.5,SELL,1,0.02h,Stop Loss,$-6.00,$246.75,$85821.00,130,$246.75
2024-07-02,22:22:00,20239.5,BUY,1,0.02h,Break Even,$0.25,$247.00,$85821.25,130,$247.00
Final P&L Day: 247.00,,,,,,,,,,,
2024-07-03,12:10:00,20242.0,SELL,1,0.02h,Break Even,$0.25,$0.25,$85821.50,131,$0.25
2024-07-03,13:01:00,20221.75,BUY,1,0.02h,Break Even,$0.25,$0.50,$85821.75,131,$0.50
2024-07-03,13:06:00,20211.5,SELL,1,0.02h,Stop Loss,$-6.00,$-5.50,$85815.75,131,$-5.50
2024-07-03,13:09:00,20221.5,BUY,1,0.02h,Stop Loss,$-6.00,$-11.50,$85809.75,131,$-11.50
2024-07-03,13:24:00,20212.5,SELL,1,0.02h,Break Even,$0.25,$-11.25,$85810.00,131,$-11.25
2024-07-03,13:31:00,20242.5,BUY,1,0.02h,Stop Loss,$57.75,$46.50,$85867.75,131,$46.50
2024-07-03,14:26:00,20257.5,SELL,1,0.02h,Stop Loss,$51.50,$98.00,$85919.25,131,$98.00
2024-07-03,14:39:00,20281.0,BUY,1,0.02h,Stop Loss,$-6.00,$92.00,$85913.25,131,$92.00
2024-07-03,15:36:00,20334.5,SELL,1,0.02h,Break Even,$0.25,$92.25,$85913.50,131,$92.25
2024-07-03,15:44:00,20343.75,BUY,1,0.02h,Stop Loss,$19.00,$111.25,$85932.50,131,$111.25
2024-07-03,16:41:00,20396.5,SELL,1,0.02h,Stop Loss,$4.00,$115.25,$85936.50,131,$115.25
2024-07-03,16:57:00,20406.75,BUY,1,0.02h,Stop Loss,$25.25,$140.50,$85961.75,131,$140.50
2024-07-03,22:02:00,20405.5,SELL,1,0.02h,Break Even,$0.25,$140.75,$85962.00,131,$140.75
2024-07-03,22:23:00,20406.75,BUY,1,0.02h,Stop Loss,$-6.00,$134.75,$85956.00,131,$134.75
2024-07-03,22:49:00,20406.5,SELL,1,0.07h,Stop Loss,$17.75,$152.50,$85973.75,131,$152.50
Final P&L Day: 152.50,,,,,,,,,,,
2024-07-04,12:09:00,20404.25,BUY,1,0.07h,Stop Loss,$-6.00,$-6.00,$85967.75,132,$-6.00
2024-07-04,13:25:00,20406.5,SELL,1,0.02h,Stop Loss,$-6.00,$-12.00,$85961.75,132,$-12.00
2024-07-04,15:01:00,20378.5,BUY,1,0.02h,Break Even,$0.25,$-11.75,$85962.00,132,$-11.75
2024-07-04,15:50:00,20386.5,SELL,1,0.02h,Break Even,$0.25,$-11.50,$85962.25,132,$-11.50
2024-07-04,16:29:00,20383.0,BUY,1,0.02h,Stop Loss,$-6.00,$-17.50,$85956.25,132,$-17.50
2024-07-04,16:48:00,20380.5,SELL,1,0.02h,Stop Loss,$-6.00,$-23.50,$85950.25,132,$-23.50
2024-07-04,16:51:00,20384.0,BUY,1,0.02h,Stop Loss,$-6.00,$-29.50,$85944.25,132,$-29.50
2024-07-04,16:54:00,20379.75,SELL,1,0.02h,Stop Loss,$-6.00,$-35.50,$85938.25,132,$-35.50
2024-07-04,22:05:00,20384.0,BUY,1,0.02h,Stop Loss,$19.00,$-16.50,$85957.25,132,$-16.50
2024-07-04,22:31:00,20382.25,SELL,1,0.02h,Stop Loss,$-6.00,$-22.50,$85951.25,132,$-22.50
2024-07-04,22:33:00,20386.0,BUY,1,0.02h,Break Even,$0.25,$-22.25,$85951.50,132,$-22.25
2024-07-04,22:48:00,20383.5,SELL,1,0.02h,Stop Loss,$-6.00,$-28.25,$85945.50,132,$-28.25
2024-07-04,22:53:00,20386.25,BUY,1,0.05h,Stop Loss,$-6.00,$-34.25,$85939.50,132,$-34.25
2024-07-04,22:59:00,20382.25,SELL,1,0.02h,Stop Loss,$-6.00,$-40.25,$85933.50,132,$-40.25
Final P&L Day: -40.25,,,,,,,,,,,
2024-07-05,12:00:00,20433.5,BUY,1,0.02h,Break Even,$0.25,$0.25,$85933.75,133,$0.25
2024-07-05,12:48:00,20439.5,SELL,1,0.02h,Stop Loss,$46.50,$46.75,$85980.25,133,$46.75
2024-07-05,13:21:00,20426.5,BUY,1,0.02h,Stop Loss,$21.50,$68.25,$86001.75,133,$68.25
2024-07-05,14:12:00,20467.25,SELL,1,0.02h,Break Even,$0.25,$68.50,$86002.00,133,$68.50
2024-07-05,14:19:00,20507.75,BUY,1,0.02h,Stop Loss,$16.50,$85.00,$86018.50,133,$85.00
2024-07-05,15:02:00,20520.5,SELL,1,0.02h,Break Even,$0.25,$85.25,$86018.75,133,$85.25
2024-07-05,15:08:00,20537.25,BUY,1,0.02h,Stop Loss,$35.25,$120.50,$86054.00,133,$120.50
2024-07-05,16:09:00,20582.75,SELL,1,0.02h,Stop Loss,$-6.00,$114.50,$86048.00,133,$114.50
2024-07-05,16:12:00,20594.25,BUY,1,0.02h,Stop Loss,$17.75,$132.25,$86065.75,133,$132.25
2024-07-05,16:36:00,20595.0,SELL,1,0.02h,Stop Loss,$-6.00,$126.25,$86059.75,133,$126.25
2024-07-05,17:15:00,20595.0,BUY,1,0.02h,Stop Loss,$7.75,$134.00,$86067.50,133,$134.00
2024-07-05,18:01:00,20621.75,SELL,1,0.02h,Stop Loss,$32.75,$166.75,$86100.25,133,$166.75
2024-07-05,18:14:00,20627.25,BUY,1,0.02h,Stop Loss,$-6.00,$160.75,$86094.25,133,$160.75
2024-07-05,18:24:00,20615.5,SELL,1,0.02h,Stop Loss,$26.50,$187.25,$86120.75,133,$187.25
2024-07-05,18:50:00,20612.5,BUY,1,0.02h,Stop Loss,$4.00,$191.25,$86124.75,133,$191.25
2024-07-05,19:33:00,20616.75,SELL,1,0.02h,Stop Loss,$-6.00,$185.25,$86118.75,133,$185.25
2024-07-05,19:35:00,20626.75,BUY,1,0.02h,Stop Loss,$-6.00,$179.25,$86112.75,133,$179.25
2024-07-05,20:01:00,20613.0,SELL,1,0.02h,Break Even,$0.25,$179.50,$86113.00,133,$179.50
Final P&L Day: 179.50,,,,,,,,,,,
2024-07-08,12:00:00,20628.25,BUY,1,0.02h,Stop Loss,$-6.00,$-6.00,$86107.00,134,$-6.00
2024-07-08,12:45:00,20632.75,SELL,1,0.02h,Stop Loss,$-6.00,$-12.00,$86101.00,134,$-12.00
2024-07-08,12:47:00,20633.5,BUY,1,0.02h,Stop Loss,$-6.00,$-18.00,$86095.00,134,$-18.00
2024-07-08,12:48:00,20630.5,SELL,1,0.02h,Break Even,$0.25,$-17.75,$86095.25,134,$-17.75
2024-07-08,13:06:00,20632.5,BUY,1,0.02h,Stop Loss,$-6.00,$-23.75,$86089.25,134,$-23.75
2024-07-08,13:31:00,20628.25,SELL,1,0.02h,Stop Loss,$37.75,$14.00,$86127.00,134,$14.00
2024-07-08,13:51:00,20646.5,BUY,1,0.02h,Stop Loss,$21.50,$35.50,$86148.50,134,$35.50
2024-07-08,14:01:00,20607.75,SELL,1,0.02h,Stop Loss,$40.25,$75.75,$86188.75,134,$75.75
2024-07-08,14:08:00,20633.75,BUY,1,0.02h,Stop Loss,$4.00,$79.75,$86192.75,134,$79.75
2024-07-08,14:21:00,20611.25,SELL,1,0.02h,Stop Loss,$11.50,$91.25,$86204.25,134,$91.25
2024-07-08,14:31:00,20631.75,BUY,1,0.02h,Stop Loss,$-6.00,$85.25,$86198.25,134,$85.25
2024-07-08,14:34:00,20615.0,SELL,1,0.02h,Break Even,$0.25,$85.50,$86198.50,134,$85.50
2024-07-08,15:03:00,20618.5,BUY,1,0.02h,Stop Loss,$37.75,$123.25,$86236.25,134,$123.25
2024-07-08,16:04:00,20647.5,SELL,1,0.02h,Break Even,$0.25,$123.50,$86236.50,134,$123.50
2024-07-08,16:49:00,20626.25,BUY,1,0.02h,Break Even,$0.25,$123.75,$86236.75,134,$123.75
2024-07-08,17:52:00,20647.25,SELL,1,0.02h,Break Even,$0.25,$124.00,$86237.00,134,$124.00
2024-07-08,18:21:00,20646.5,BUY,1,0.02h,Stop Loss,$-6.00,$118.00,$86231.00,134,$118.00
2024-07-08,18:33:00,20635.0,SELL,1,0.02h,Break Even,$0.25,$118.25,$86231.25,134,$118.25
2024-07-08,18:55:00,20638.25,BUY,1,0.02h,Stop Loss,$19.00,$137.25,$86250.25,134,$137.25
2024-07-08,19:12:00,20633.25,SELL,1,0.02h,Break Even,$0.25,$137.50,$86250.50,134,$137.50
2024-07-08,19:44:00,20633.5,BUY,1,0.02h,Stop Loss,$15.25,$152.75,$86265.75,134,$152.75
2024-07-08,20:35:00,20675.5,SELL,1,0.02h,Stop Loss,$-6.00,$146.75,$86259.75,134,$146.75
2024-07-08,20:43:00,20678.0,BUY,1,0.02h,Stop Loss,$-6.00,$140.75,$86253.75,134,$140.75
2024-07-08,20:44:00,20677.0,SELL,1,0.02h,Stop Loss,$-6.00,$134.75,$86247.75,134,$134.75
2024-07-08,20:46:00,20677.25,BUY,1,0.03h,Break Even,$0.25,$135.00,$86248.00,134,$135.00
2024-07-08,22:39:00,20690.75,SELL,1,0.05h,Break Even,$0.25,$135.25,$86248.25,134,$135.25
2024-07-08,22:48:00,20694.75,BUY,1,0.02h,Stop Loss,$-6.00,$129.25,$86242.25,134,$129.25
2024-07-08,22:55:00,20691.0,SELL,1,0.02h,Break Even,$0.25,$129.50,$86242.50,134,$129.50
Final P&L Day: 129.50,,,,,,,,,,,
2024-07-09,12:00:00,20725.5,BUY,1,0.02h,Break Even,$0.25,$0.25,$86242.75,135,$0.25
2024-07-09,12:25:00,20715.25,SELL,1,0.02h,Break Even,$0.25,$0.50,$86243.00,135,$0.50
2024-07-09,12:51:00,20719.0,BUY,1,0.02h,Break Even,$0.25,$0.75,$86243.25,135,$0.75
2024-07-09,13:52:00,20726.5,SELL,1,0.02h,Break Even,$0.25,$1.00,$86243.50,135,$1.00
2024-07-09,13:55:00,20739.25,BUY,1,0.02h,Break Even,$0.25,$1.25,$86243.75,135,$1.25
2024-07-09,14:07:00,20720.0,SELL,1,0.02h,Break Even,$0.25,$1.50,$86244.00,135,$1.50
2024-07-09,14:12:00,20753.25,BUY,1,0.02h,Stop Loss,$76.50,$78.00,$86320.50,135,$78.00
2024-07-09,14:25:00,20718.75,SELL,1,0.02h,Stop Loss,$32.75,$110.75,$86353.25,135,$110.75
2024-07-09,14:45:00,20728.5,BUY,1,0.02h,Stop Loss,$39.00,$149.75,$86392.25,135,$149.75
2024-07-09,14:56:00,20712.25,SELL,1,0.02h,Stop Loss,$41.50,$191.25,$86433.75,135,$191.25
2024-07-09,15:47:00,20698.75,BUY,1,0.02h,Stop Loss,$5.25,$196.50,$86439.00,135,$196.50
2024-07-09,16:27:00,20696.0,SELL,1,0.02h,Stop Loss,$-6.00,$190.50,$86433.00,135,$190.50
2024-07-09,17:03:00,20682.0,BUY,1,0.02h,Stop Loss,$27.75,$218.25,$86460.75,135,$218.25
2024-07-09,17:17:00,20663.25,SELL,1,0.02h,Stop Loss,$75.25,$293.50,$86536.00,135,$293.50
2024-07-09,17:39:00,20652.0,BUY,1,0.02h,Break Even,$0.25,$293.75,$86536.25,135,$293.75
2024-07-09,17:48:00,20643.5,SELL,1,0.02h,Break Even,$0.25,$294.00,$86536.50,135,$294.00
2024-07-09,17:52:00,20652.25,BUY,1,0.02h,Stop Loss,$16.50,$310.50,$86553.00,135,$310.50
2024-07-09,18:07:00,20650.5,SELL,1,0.02h,Stop Loss,$-6.00,$304.50,$86547.00,135,$304.50
2024-07-09,18:09:00,20656.75,BUY,1,0.02h,Stop Loss,$17.75,$322.25,$86564.75,135,$322.25
2024-07-09,18:28:00,20654.75,SELL,1,0.02h,Stop Loss,$12.75,$335.00,$86577.50,135,$335.00
2024-07-09,18:37:00,20664.5,BUY,1,0.02h,Break Even,$0.25,$335.25,$86577.75,135,$335.25
2024-07-09,18:56:00,20660.25,SELL,1,0.02h,Stop Loss,$10.25,$345.50,$86588.00,135,$345.50
2024-07-09,19:00:00,20671.5,BUY,1,0.02h,Break Even,$0.25,$345.75,$86588.25,135,$345.75
2024-07-09,19:22:00,20659.5,SELL,1,0.02h,Stop Loss,$4.00,$349.75,$86592.25,135,$349.75
2024-07-09,19:39:00,20667.0,BUY,1,0.02h,Stop Loss,$-6.00,$343.75,$86586.25,135,$343.75
2024-07-09,20:12:00,20673.25,SELL,1,0.03h,Stop Loss,$-6.00,$337.75,$86580.25,135,$337.75
2024-07-09,20:15:00,20675.0,BUY,1,0.02h,Break Even,$0.25,$338.00,$86580.50,135,$338.00
2024-07-09,22:54:00,20692.25,SELL,1,0.02h,Stop Loss,$-6.00,$332.00,$86574.50,135,$332.00
Final P&L Day: 332.00,,,,,,,,,,,
2024-07-10,12:00:00,20749.75,BUY,1,0.02h,Break Even,$0.25,$0.25,$86574.75,136,$0.25
2024-07-10,12:47:00,20755.0,SELL,1,0.02h,Break Even,$0.25,$0.50,$86575.00,136,$0.50
2024-07-10,13:07:00,20758.5,BUY,1,0.02h,Break Even,$0.25,$0.75,$86575.25,136,$0.75
2024-07-10,13:20:00,20755.5,SELL,1,0.02h,Stop Loss,$-6.00,$-5.25,$86569.25,136,$-5.25
2024-07-10,13:26:00,20765.0,BUY,1,0.02h,Stop Loss,$-6.00,$-11.25,$86563.25,136,$-11.25
2024-07-10,13:32:00,20752.5,SELL,1,0.02h,Stop Loss,$44.00,$32.75,$86607.25,136,$32.75
2024-07-10,13:46:00,20761.25,BUY,1,0.02h,Stop Loss,$-6.00,$26.75,$86601.25,136,$26.75
2024-07-10,14:21:00,20761.0,SELL,1,0.02h,Stop Loss,$12.75,$39.50,$86614.00,136,$39.50
2024-07-10,15:23:00,20735.0,BUY,1,0.02h,Stop Loss,$-6.00,$33.50,$86608.00,136,$33.50
2024-07-10,17:27:00,20848.25,SELL,1,0.02h,Stop Loss,$-6.00,$27.50,$86602.00,136,$27.50
2024-07-10,17:28:00,20857.75,BUY,1,0.02h,Stop Loss,$-6.00,$21.50,$86596.00,136,$21.50
2024-07-10,18:20:00,20867.0,SELL,1,0.02h,Stop Loss,$15.25,$36.75,$86611.25,136,$36.75
2024-07-10,18:36:00,20872.75,BUY,1,0.02h,Stop Loss,$-6.00,$30.75,$86605.25,136,$30.75
2024-07-10,18:42:00,20867.0,SELL,1,0.02h,Break Even,$0.25,$31.00,$86605.50,136,$31.00
2024-07-10,18:44:00,20873.25,BUY,1,0.02h,Stop Loss,$-6.00,$25.00,$86599.50,136,$25.00
2024-07-10,19:02:00,20869.75,SELL,1,0.02h,Stop Loss,$14.00,$39.00,$86613.50,136,$39.00
2024-07-10,19:30:00,20870.0,BUY,1,0.02h,Stop Loss,$-6.00,$33.00,$86607.50,136,$33.00
2024-07-10,20:04:00,20884.0,SELL,1,0.02h,Stop Loss,$9.00,$42.00,$86616.50,136,$42.00
2024-07-10,20:20:00,20893.5,BUY,1,0.02h,Stop Loss,$-6.00,$36.00,$86610.50,136,$36.00
2024-07-10,20:47:00,20886.75,SELL,1,0.02h,Stop Loss,$-6.00,$30.00,$86604.50,136,$30.00
2024-07-10,20:55:00,20892.5,BUY,1,0.02h,Break Even,$0.25,$30.25,$86604.75,136,$30.25
2024-07-10,22:14:00,20893.25,SELL,1,0.03h,Stop Loss,$-6.00,$24.25,$86598.75,136,$24.25
2024-07-10,22:25:00,20896.5,BUY,1,0.02h,Stop Loss,$-6.00,$18.25,$86592.75,136,$18.25
2024-07-10,22:33:00,20892.5,SELL,1,0.07h,Stop Loss,$16.50,$34.75,$86609.25,136,$34.75
2024-07-10,22:58:00,20889.75,BUY,1,0.02h,Break Even,$0.25,$35.00,$86609.50,136,$35.00
Final P&L Day: 35.00,,,,,,,,,,,
2024-07-11,12:00:00,20882.25,SELL,1,0.02h,Break Even,$0.25,$0.25,$86609.75,137,$0.25
2024-07-11,12:30:00,20888.75,BUY,1,0.02h,Stop Loss,$415.25,$415.50,$87025.00,137,$415.50
2024-07-11,12:52:00,20907.5,SELL,1,0.02h,Stop Loss,$89.00,$504.50,$87114.00,137,$504.50
2024-07-11,13:18:00,20914.0,BUY,1,0.02h,Break Even,$0.25,$504.75,$87114.25,137,$504.75
2024-07-11,13:29:00,20895.5,SELL,1,0.02h,Stop Loss,$25.25,$530.00,$87139.50,137,$530.00
2024-07-11,16:11:00,20519.0,BUY,1,0.02h,Stop Loss,$16.50,$546.50,$87156.00,137,$546.50
2024-07-11,16:19:00,20481.5,SELL,1,0.02h,Stop Loss,$-6.00,$540.50,$87150.00,137,$540.50
2024-07-11,16:31:00,20510.0,BUY,1,0.02h,Stop Loss,$20.25,$560.75,$87170.25,137,$560.75
2024-07-11,16:48:00,20470.5,SELL,1,0.02h,Stop Loss,$75.25,$636.00,$87245.50,137,$636.00
2024-07-11,17:17:00,20474.25,BUY,1,0.02h,Break Even,$0.25,$636.25,$87245.75,137,$636.25
2024-07-11,17:35:00,20459.5,SELL,1,0.02h,Stop Loss,$30.25,$666.50,$87276.00,137,$666.50
2024-07-11,18:17:00,20412.5,BUY,1,0.02h,Stop Loss,$-6.00,$660.50,$87270.00,137,$660.50
2024-07-11,19:22:00,20466.5,SELL,1,0.02h,Stop Loss,$11.50,$672.00,$87281.50,137,$672.00
2024-07-11,19:38:00,20481.25,BUY,1,0.02h,Stop Loss,$19.00,$691.00,$87300.50,137,$691.00
2024-07-11,19:45:00,20448.25,SELL,1,0.02h,Break Even,$0.25,$691.25,$87300.75,137,$691.25
2024-07-11,19:50:00,20466.0,BUY,1,0.02h,Stop Loss,$41.50,$732.75,$87342.25,137,$732.75
2024-07-11,19:55:00,20447.0,SELL,1,0.02h,Stop Loss,$32.75,$765.50,$87375.00,137,$765.50
2024-07-11,20:31:00,20452.0,BUY,1,0.02h,Stop Loss,$-6.00,$759.50,$87369.00,137,$759.50
2024-07-11,20:39:00,20442.75,SELL,1,0.02h,Stop Loss,$-6.00,$753.50,$87363.00,137,$753.50
2024-07-11,20:40:00,20445.5,BUY,1,0.02h,Break Even,$0.25,$753.75,$87363.25,137,$753.75
2024-07-11,20:43:00,20442.5,SELL,1,0.02h,Break Even,$0.25,$754.00,$87363.50,137,$754.00
2024-07-11,20:45:00,20445.5,BUY,1,0.02h,Break Even,$0.25,$754.25,$87363.75,137,$754.25
2024-07-11,20:46:00,20442.5,SELL,1,0.02h,Stop Loss,$4.00,$758.25,$87367.75,137,$758.25
2024-07-11,22:04:00,20444.25,BUY,1,0.02h,Stop Loss,$4.00,$762.25,$87371.75,137,$762.25
2024-07-11,22:07:00,20437.5,SELL,1,0.02h,Break Even,$0.25,$762.50,$87372.00,137,$762.50
2024-07-11,22:32:00,20440.0,BUY,1,0.02h,Stop Loss,$22.75,$785.25,$87394.75,137,$785.25
Final P&L Day: 785.25,,,,,,,,,,,
2024-07-12,12:03:00,20429.5,SELL,1,0.02h,Break Even,$0.25,$0.25,$87395.00,138,$0.25
2024-07-12,12:35:00,20429.0,BUY,1,0.02h,Stop Loss,$-6.00,$-5.75,$87389.00,138,$-5.75
2024-07-12,13:19:00,20436.0,SELL,1,0.02h,Break Even,$0.25,$-5.50,$87389.25,138,$-5.50
2024-07-12,13:31:00,20459.25,BUY,1,0.02h,Stop Loss,$42.75,$37.25,$87432.00,138,$37.25
2024-07-12,14:24:00,20536.75,SELL,1,0.02h,Break Even,$0.25,$37.50,$87432.25,138,$37.50
2024-07-12,14:26:00,20558.75,BUY,1,0.02h,Break Even,$0.25,$37.75,$87432.50,138,$37.75
2024-07-12,15:20:00,20634.75,SELL,1,0.02h,Stop Loss,$4.00,$41.75,$87436.50,138,$41.75
2024-07-12,15:30:00,20655.5,BUY,1,0.02h,Break Even,$0.25,$42.00,$87436.75,138,$42.00
2024-07-12,15:35:00,20638.0,SELL,1,0.02h,Break Even,$0.25,$42.25,$87437.00,138,$42.25
2024-07-12,15:40:00,20654.0,BUY,1,0.02h,Stop Loss,$19.00,$61.25,$87456.00,138,$61.25
2024-07-12,15:54:00,20647.75,SELL,1,0.02h,Stop Loss,$-6.00,$55.25,$87450.00,138,$55.25
2024-07-12,16:37:00,20606.5,BUY,1,0.02h,Break Even,$0.25,$55.50,$87450.25,138,$55.50
2024-07-12,16:50:00,20589.75,SELL,1,0.02h,Stop Loss,$-6.00,$49.50,$87444.25,138,$49.50
2024-07-12,16:51:00,20597.0,BUY,1,0.02h,Stop Loss,$17.75,$67.25,$87462.00,138,$67.25
2024-07-12,18:08:00,20703.5,SELL,1,0.02h,Break Even,$0.25,$67.50,$87462.25,138,$67.50
2024-07-12,18:41:00,20709.5,BUY,1,0.02h,Stop Loss,$-6.00,$61.50,$87456.25,138,$61.50
2024-07-12,18:53:00,20701.25,SELL,1,0.02h,Break Even,$0.25,$61.75,$87456.50,138,$61.75
2024-07-12,18:58:00,20708.5,BUY,1,0.02h,Break Even,$0.25,$62.00,$87456.75,138,$62.00
2024-07-12,19:05:00,20698.25,SELL,1,0.02h,Stop Loss,$-6.00,$56.00,$87450.75,138,$56.00
2024-07-12,20:42:00,20537.5,BUY,1,0.02h,Break Even,$0.25,$56.25,$87451.00,138,$56.25
Final P&L Day: 56.25,,,,,,,,,,,
2024-07-15,12:39:00,20612.5,SELL,1,0.02h,Stop Loss,$17.75,$17.75,$87468.75,139,$17.75
2024-07-15,13:06:00,20612.5,BUY,1,0.02h,Break Even,$0.25,$18.00,$87469.00,139,$18.00
2024-07-15,13:13:00,20602.0,SELL,1,0.02h,Break Even,$0.25,$18.25,$87469.25,139,$18.25
2024-07-15,13:21:00,20612.75,BUY,1,0.02h,Break Even,$0.25,$18.50,$87469.50,139,$18.50
2024-07-15,13:46:00,20599.25,SELL,1,0.02h,Stop Loss,$49.00,$67.50,$87518.50,139,$67.50
2024-07-15,13:55:00,20635.25,BUY,1,0.02h,Break Even,$0.25,$67.75,$87518.75,139,$67.75
2024-07-15,15:30:00,20734.5,SELL,1,0.02h,Stop Loss,$49.00,$116.75,$87567.75,139,$116.75
2024-07-15,16:30:00,20663.75,BUY,1,0.02h,Stop Loss,$-6.00,$110.75,$87561.75,139,$110.75
2024-07-15,16:46:00,20645.75,SELL,1,0.02h,Stop Loss,$31.50,$142.25,$87593.25,139,$142.25
2024-07-15,16:59:00,20654.0,BUY,1,0.02h,Break Even,$0.25,$142.50,$87593.50,139,$142.50
2024-07-15,17:01:00,20617.25,SELL,1,0.02h,Stop Loss,$109.00,$251.50,$87702.50,139,$251.50
2024-07-15,17:25:00,20647.5,BUY,1,0.02h,Break Even,$0.25,$251.75,$87702.75,139,$251.75
2024-07-15,17:28:00,20616.5,SELL,1,0.02h,Stop Loss,$61.50,$313.25,$87764.25,139,$313.25
2024-07-15,18:24:00,20589.25,BUY,1,0.02h,Stop Loss,$35.25,$348.50,$87799.50,139,$348.50
2024-07-15,18:46:00,20588.5,SELL,1,0.02h,Stop Loss,$-6.00,$342.50,$87793.50,139,$342.50
2024-07-15,18:48:00,20606.25,BUY,1,0.02h,Stop Loss,$25.25,$367.75,$87818.75,139,$367.75
2024-07-15,19:37:00,20611.5,SELL,1,0.02h,Stop Loss,$11.50,$379.25,$87830.25,139,$379.25
2024-07-15,20:01:00,20599.25,BUY,1,0.02h,Break Even,$0.25,$379.50,$87830.50,139,$379.50
2024-07-15,22:35:00,20639.25,SELL,1,0.02h,Stop Loss,$10.25,$389.75,$87840.75,139,$389.75
Final P&L Day: 389.75,,,,,,,,,,,
2024-07-16,12:27:00,20634.25,BUY,1,0.02h,Stop Loss,$-6.00,$-6.00,$87834.75,140,$-6.00
2024-07-16,12:51:00,20628.25,SELL,1,0.02h,Stop Loss,$24.00,$18.00,$87858.75,140,$18.00
2024-07-16,13:12:00,20636.0,BUY,1,0.02h,Break Even,$0.25,$18.25,$87859.00,140,$18.25
2024-07-16,13:46:00,20630.75,SELL,1,0.02h,Stop Loss,$32.75,$51.00,$87891.75,140,$51.00
2024-07-16,14:33:00,20548.75,BUY,1,0.02h,Stop Loss,$-6.00,$45.00,$87885.75,140,$45.00
2024-07-16,14:59:00,20543.75,SELL,1,0.02h,Stop Loss,$41.50,$86.50,$87927.25,140,$86.50
2024-07-16,15:05:00,20568.5,BUY,1,0.02h,Break Even,$0.25,$86.75,$87927.50,140,$86.75
2024-07-16,15:22:00,20561.5,SELL,1,0.02h,Stop Loss,$-6.00,$80.75,$87921.50,140,$80.75
2024-07-16,15:51:00,20554.0,BUY,1,0.02h,Stop Loss,$46.50,$127.25,$87968.00,140,$127.25
2024-07-16,16:08:00,20547.25,SELL,1,0.02h,Stop Loss,$-6.00,$121.25,$87962.00,140,$121.25
2024-07-16,16:49:00,20518.75,BUY,1,0.02h,Stop Loss,$10.25,$131.50,$87972.25,140,$131.50
2024-07-16,17:16:00,20515.0,SELL,1,0.02h,Stop Loss,$57.75,$189.25,$88030.00,140,$189.25
2024-07-16,17:49:00,20523.5,BUY,1,0.02h,Stop Loss,$-6.00,$183.25,$88024.00,140,$183.25
2024-07-16,18:04:00,20508.5,SELL,1,0.02h,Break Even,$0.25,$183.50,$88024.25,140,$183.50
2024-07-16,18:06:00,20522.75,BUY,1,0.02h,Break Even,$0.25,$183.75,$88024.50,140,$183.75
2024-07-16,18:14:00,20506.5,SELL,1,0.02h,Stop Loss,$-6.00,$177.75,$88018.50,140,$177.75
2024-07-16,18:24:00,20528.5,BUY,1,0.02h,Stop Loss,$72.75,$250.50,$88091.25,140,$250.50
2024-07-16,19:20:00,20566.75,SELL,1,0.02h,Stop Loss,$12.75,$263.25,$88104.00,140,$263.25
2024-07-16,19:34:00,20584.25,BUY,1,0.02h,Stop Loss,$41.50,$304.75,$88145.50,140,$304.75
2024-07-16,19:47:00,20568.5,SELL,1,0.02h,Break Even,$0.25,$305.00,$88145.75,140,$305.00
2024-07-16,19:52:00,20593.25,BUY,1,0.02h,Stop Loss,$4.00,$309.00,$88149.75,140,$309.00
2024-07-16,20:24:00,20594.25,SELL,1,0.03h,Break Even,$0.25,$309.25,$88150.00,140,$309.25
2024-07-16,20:29:00,20599.0,BUY,1,0.02h,Stop Loss,$-6.00,$303.25,$88144.00,140,$303.25
2024-07-16,20:47:00,20597.0,SELL,1,0.03h,Stop Loss,$-6.00,$297.25,$88138.00,140,$297.25
2024-07-16,22:19:00,20591.75,BUY,1,0.02h,Stop Loss,$-6.00,$291.25,$88132.00,140,$291.25
2024-07-16,22:21:00,20588.5,SELL,1,0.02h,Break Even,$0.25,$291.50,$88132.25,140,$291.50
2024-07-16,22:35:00,20592.0,BUY,1,0.02h,Stop Loss,$-6.00,$285.50,$88126.25,140,$285.50
2024-07-16,22:49:00,20587.25,SELL,1,0.02h,Stop Loss,$-6.00,$279.50,$88120.25,140,$279.50
Final P&L Day: 279.50,,,,,,,,,,,
2024-07-17,13:10:00,20293.5,BUY,1,0.02h,Break Even,$0.25,$0.25,$88120.50,141,$0.25
2024-07-17,13:13:00,20284.0,SELL,1,0.02h,Break Even,$0.25,$0.50,$88120.75,141,$0.50
2024-07-17,14:36:00,20169.5,BUY,1,0.02h,Break Even,$0.25,$0.75,$88121.00,141,$0.75
2024-07-17,14:50:00,20125.25,SELL,1,0.02h,Stop Loss,$37.75,$38.50,$88158.75,141,$38.50
2024-07-17,15:20:00,20127.75,BUY,1,0.02h,Stop Loss,$-6.00,$32.50,$88152.75,141,$32.50
2024-07-17,15:21:00,20113.5,SELL,1,0.02h,Break Even,$0.25,$32.75,$88153.00,141,$32.75
2024-07-17,15:22:00,20138.0,BUY,1,0.02h,Stop Loss,$24.00,$56.75,$88177.00,141,$56.75
2024-07-17,15:27:00,20097.5,SELL,1,0.02h,Break Even,$0.25,$57.00,$88177.25,141,$57.00
2024-07-17,15:31:00,20130.0,BUY,1,0.02h,Stop Loss,$5.25,$62.25,$88182.50,141,$62.25
2024-07-17,15:37:00,20108.0,SELL,1,0.02h,Stop Loss,$-6.00,$56.25,$88176.50,141,$56.25
2024-07-17,16:55:00,20047.75,BUY,1,0.02h,Stop Loss,$52.75,$109.00,$88229.25,141,$109.00
2024-07-17,17:10:00,20023.0,SELL,1,0.02h,Stop Loss,$-6.00,$103.00,$88223.25,141,$103.00
2024-07-17,17:22:00,20051.0,BUY,1,0.02h,Break Even,$0.25,$103.25,$88223.50,141,$103.25
2024-07-17,17:29:00,20033.0,SELL,1,0.02h,Stop Loss,$-6.00,$97.25,$88217.50,141,$97.25
2024-07-17,17:30:00,20046.5,BUY,1,0.02h,Stop Loss,$49.00,$146.25,$88266.50,141,$146.25
2024-07-17,17:44:00,20040.5,SELL,1,0.02h,Break Even,$0.25,$146.50,$88266.75,141,$146.50
2024-07-17,18:11:00,20048.0,BUY,1,0.02h,Stop Loss,$16.50,$163.00,$88283.25,141,$163.00
2024-07-17,18:40:00,20041.25,SELL,1,0.02h,Stop Loss,$-6.00,$157.00,$88277.25,141,$157.00
2024-07-17,19:13:00,20039.5,BUY,1,0.02h,Break Even,$0.25,$157.25,$88277.50,141,$157.25
2024-07-17,19:18:00,20013.0,SELL,1,0.02h,Break Even,$0.25,$157.50,$88277.75,141,$157.50
2024-07-17,19:22:00,20032.25,BUY,1,0.02h,Stop Loss,$74.00,$231.50,$88351.75,141,$231.50
2024-07-17,19:40:00,20027.25,SELL,1,0.02h,Stop Loss,$-6.00,$225.50,$88345.75,141,$225.50
2024-07-17,19:50:00,20055.0,BUY,1,0.02h,Stop Loss,$64.00,$289.50,$88409.75,141,$289.50
2024-07-17,19:57:00,20014.25,SELL,1,0.02h,Stop Loss,$34.00,$323.50,$88443.75,141,$323.50
2024-07-17,20:24:00,20009.25,BUY,1,0.02h,Stop Loss,$32.75,$356.25,$88476.50,141,$356.25
2024-07-17,20:47:00,20009.75,SELL,1,0.02h,Stop Loss,$-6.00,$350.25,$88470.50,141,$350.25
2024-07-17,21:26:00,20017.0,BUY,1,0.58h,Stop Loss,$135.25,$485.50,$88605.75,141,$485.50
2024-07-17,22:38:00,20042.5,SELL,1,0.02h,Stop Loss,$20.25,$505.75,$88626.00,141,$505.75
2024-07-17,22:51:00,20052.75,BUY,1,0.02h,Stop Loss,$-6.00,$499.75,$88620.00,141,$499.75
Final P&L Day: 499.75,,,,,,,,,,,
2024-07-18,13:23:00,20136.75,SELL,1,0.02h,Break Even,$0.25,$0.25,$88620.25,142,$0.25
2024-07-18,14:06:00,20092.25,BUY,1,0.02h,Stop Loss,$50.25,$50.50,$88670.50,142,$50.50
2024-07-18,14:21:00,20056.75,SELL,1,0.02h,Stop Loss,$22.75,$73.25,$88693.25,142,$73.25
2024-07-18,14:54:00,20011.5,BUY,1,0.02h,Stop Loss,$26.50,$99.75,$88719.75,142,$99.75
2024-07-18,15:07:00,19948.75,SELL,1,0.02h,Stop Loss,$49.00,$148.75,$88768.75,142,$148.75
2024-07-18,16:10:00,19837.75,BUY,1,0.02h,Stop Loss,$-6.00,$142.75,$88762.75,142,$142.75
2024-07-18,16:20:00,19810.25,SELL,1,0.02h,Break Even,$0.25,$143.00,$88763.00,142,$143.00
2024-07-18,16:21:00,19815.25,BUY,1,0.02h,Stop Loss,$89.00,$232.00,$88852.00,142,$232.00
2024-07-18,17:09:00,19874.25,SELL,1,0.02h,Stop Loss,$42.75,$274.75,$88894.75,142,$274.75
2024-07-18,17:13:00,19914.0,BUY,1,0.02h,Stop Loss,$-6.00,$268.75,$88888.75,142,$268.75
2024-07-18,17:38:00,19906.0,SELL,1,0.02h,Stop Loss,$62.75,$331.50,$88951.50,142,$331.50
2024-07-18,17:48:00,19916.0,BUY,1,0.02h,Stop Loss,$25.25,$356.75,$88976.75,142,$356.75
2024-07-18,17:52:00,19883.75,SELL,1,0.02h,Stop Loss,$30.25,$387.00,$89007.00,142,$387.00
2024-07-18,18:25:00,19886.0,BUY,1,0.02h,Stop Loss,$-6.00,$381.00,$89001.00,142,$381.00
2024-07-18,18:28:00,19856.75,SELL,1,0.02h,Stop Loss,$20.25,$401.25,$89021.25,142,$401.25
2024-07-18,18:57:00,19845.25,BUY,1,0.02h,Stop Loss,$6.50,$407.75,$89027.75,142,$407.75
2024-07-18,19:08:00,19830.0,SELL,1,0.02h,Stop Loss,$56.50,$464.25,$89084.25,142,$464.25
2024-07-18,19:30:00,19823.75,BUY,1,0.02h,Stop Loss,$34.00,$498.25,$89118.25,142,$498.25
2024-07-18,22:23:00,19947.5,SELL,1,0.02h,Break Even,$0.25,$498.50,$89118.50,142,$498.50
2024-07-18,22:48:00,19959.5,BUY,1,0.02h,Break Even,$0.25,$498.75,$89118.75,142,$498.75
Final P&L Day: 498.75,,,,,,,,,,,
2024-07-19,12:00:00,19923.5,SELL,1,0.02h,Stop Loss,$-6.00,$-6.00,$89112.75,143,$-6.00
2024-07-19,12:36:00,19925.5,BUY,1,0.02h,Stop Loss,$29.00,$23.00,$89141.75,143,$23.00
2024-07-19,13:04:00,19919.25,SELL,1,0.02h,Stop Loss,$20.25,$43.25,$89162.00,143,$43.25
2024-07-19,13:40:00,19927.5,BUY,1,0.02h,Stop Loss,$134.00,$177.25,$89296.00,143,$177.25
2024-07-19,13:48:00,19862.75,SELL,1,0.02h,Stop Loss,$4.00,$181.25,$89300.00,143,$181.25
2024-07-19,13:52:00,19922.25,BUY,1,0.02h,Stop Loss,$36.50,$217.75,$89336.50,143,$217.75
2024-07-19,14:13:00,19879.0,SELL,1,0.02h,Stop Loss,$141.50,$359.25,$89478.00,143,$359.25
2024-07-19,14:55:00,19821.5,BUY,1,0.02h,Stop Loss,$42.75,$402.00,$89520.75,143,$402.00
2024-07-19,15:11:00,19800.5,SELL,1,0.02h,Stop Loss,$71.50,$473.50,$89592.25,143,$473.50
2024-07-19,15:52:00,19767.25,BUY,1,0.02h,Stop Loss,$12.75,$486.25,$89605.00,143,$486.25
2024-07-19,16:20:00,19778.0,SELL,1,0.02h,Break Even,$0.25,$486.50,$89605.25,143,$486.50
2024-07-19,17:00:00,19728.75,BUY,1,0.02h,Break Even,$0.25,$486.75,$89605.50,143,$486.75
2024-07-19,17:03:00,19695.75,SELL,1,0.02h,Stop Loss,$10.25,$497.00,$89615.75,143,$497.00
2024-07-19,17:34:00,19690.5,BUY,1,0.02h,Stop Loss,$24.00,$521.00,$89639.75,143,$521.00
2024-07-19,17:44:00,19667.75,SELL,1,0.02h,Break Even,$0.25,$521.25,$89640.00,143,$521.25
2024-07-19,17:47:00,19700.25,BUY,1,0.02h,Stop Loss,$31.50,$552.75,$89671.50,143,$552.75
2024-07-19,18:23:00,19708.75,SELL,1,0.02h,Stop Loss,$20.25,$573.00,$89691.75,143,$573.00
2024-07-19,18:52:00,19711.75,BUY,1,0.02h,Break Even,$0.25,$573.25,$89692.00,143,$573.25
2024-07-19,19:33:00,19743.75,SELL,1,0.02h,Stop Loss,$21.50,$594.75,$89713.50,143,$594.75
2024-07-19,20:44:00,19703.5,BUY,1,0.02h,Stop Loss,$-6.00,$588.75,$89707.50,143,$588.75
2024-07-19,20:56:00,19700.5,SELL,1,0.02h,Break Even,$0.25,$589.00,$89707.75,143,$589.00
Final P&L Day: 589.00,,,,,,,,,,,
2024-07-22,12:00:00,19897.5,BUY,1,0.02h,Break Even,$0.25,$0.25,$89708.00,144,$0.25
2024-07-22,12:53:00,19913.5,SELL,1,0.02h,Break Even,$0.25,$0.50,$89708.25,144,$0.50
2024-07-22,13:04:00,19924.75,BUY,1,0.02h,Stop Loss,$-6.00,$-5.50,$89702.25,144,$-5.50
2024-07-22,13:32:00,19901.0,SELL,1,0.02h,Stop Loss,$14.00,$8.50,$89716.25,144,$8.50
2024-07-22,13:39:00,19974.25,BUY,1,0.02h,Stop Loss,$6.50,$15.00,$89722.75,144,$15.00
2024-07-22,14:02:00,19945.5,SELL,1,0.02h,Stop Loss,$40.25,$55.25,$89763.00,144,$55.25
2024-07-22,14:29:00,19962.25,BUY,1,0.02h,Stop Loss,$12.75,$68.00,$89775.75,144,$68.00
2024-07-22,14:55:00,19964.25,SELL,1,0.02h,Break Even,$0.25,$68.25,$89776.00,144,$68.25
2024-07-22,15:06:00,19987.75,BUY,1,0.02h,Stop Loss,$35.25,$103.50,$89811.25,144,$103.50
2024-07-22,15:10:00,19895.75,SELL,1,0.02h,Stop Loss,$7.75,$111.25,$89819.00,144,$111.25
2024-07-22,15:54:00,19859.5,BUY,1,0.02h,Stop Loss,$42.75,$154.00,$89861.75,144,$154.00
2024-07-22,17:58:00,19989.5,SELL,1,0.02h,Stop Loss,$20.25,$174.25,$89882.00,144,$174.25
2024-07-22,18:01:00,19998.75,BUY,1,0.02h,Stop Loss,$9.00,$183.25,$89891.00,144,$183.25
2024-07-22,18:44:00,20017.5,SELL,1,0.02h,Stop Loss,$-6.00,$177.25,$89885.00,144,$177.25
2024-07-22,18:54:00,20032.0,BUY,1,0.02h,Break Even,$0.25,$177.50,$89885.25,144,$177.50
2024-07-22,18:56:00,20022.0,SELL,1,0.02h,Stop Loss,$42.75,$220.25,$89928.00,144,$220.25
2024-07-22,19:39:00,20014.75,BUY,1,0.02h,Stop Loss,$17.75,$238.00,$89945.75,144,$238.00
2024-07-22,19:55:00,19992.25,SELL,1,0.02h,Break Even,$0.25,$238.25,$89946.00,144,$238.25
2024-07-22,20:58:00,19976.5,BUY,1,0.02h,Break Even,$0.25,$238.50,$89946.25,144,$238.50
2024-07-22,22:48:00,19986.5,SELL,1,0.02h,Break Even,$0.25,$238.75,$89946.50,144,$238.75
Final P&L Day: 238.75,,,,,,,,,,,
2024-07-23,12:01:00,19992.75,BUY,1,0.02h,Stop Loss,$-6.00,$-6.00,$89940.50,145,$-6.00
2024-07-23,12:06:00,19981.25,SELL,1,0.02h,Stop Loss,$-6.00,$-12.00,$89934.50,145,$-12.00
2024-07-23,12:48:00,19955.75,BUY,1,0.02h,Stop Loss,$34.00,$22.00,$89968.50,145,$22.00
2024-07-23,13:14:00,19958.75,SELL,1,0.02h,Stop Loss,$4.00,$26.00,$89972.50,145,$26.00
2024-07-23,13:19:00,19975.0,BUY,1,0.02h,Stop Loss,$-6.00,$20.00,$89966.50,145,$20.00
2024-07-23,13:29:00,19956.25,SELL,1,0.02h,Break Even,$0.25,$20.25,$89966.75,145,$20.25
2024-07-23,13:38:00,19988.5,BUY,1,0.02h,Stop Loss,$11.50,$31.75,$89978.25,145,$31.75
2024-07-23,14:03:00,19972.25,SELL,1,0.02h,Stop Loss,$44.00,$75.75,$90022.25,145,$75.75
2024-07-23,14:08:00,20014.5,BUY,1,0.02h,Stop Loss,$29.00,$104.75,$90051.25,145,$104.75
2024-07-23,14:33:00,20006.75,SELL,1,0.02h,Stop Loss,$44.00,$148.75,$90095.25,145,$148.75
2024-07-23,15:02:00,19988.75,BUY,1,0.02h,Stop Loss,$-6.00,$142.75,$90089.25,145,$142.75
2024-07-23,15:45:00,20049.5,SELL,1,0.02h,Break Even,$0.25,$143.00,$90089.50,145,$143.00
2024-07-23,17:23:00,19963.25,BUY,1,0.02h,Stop Loss,$9.00,$152.00,$90098.50,145,$152.00
2024-07-23,17:42:00,19953.25,SELL,1,0.02h,Stop Loss,$15.25,$167.25,$90113.75,145,$167.25
2024-07-23,17:47:00,19964.5,BUY,1,0.02h,Stop Loss,$19.00,$186.25,$90132.75,145,$186.25
2024-07-23,18:26:00,19968.75,SELL,1,0.02h,Stop Loss,$95.25,$281.50,$90228.00,145,$281.50
2024-07-23,18:39:00,19986.25,BUY,1,0.02h,Stop Loss,$5.25,$286.75,$90233.25,145,$286.75
2024-07-23,18:42:00,19967.75,SELL,1,0.02h,Stop Loss,$6.50,$293.25,$90239.75,145,$293.25
2024-07-23,19:00:00,19976.25,BUY,1,0.02h,Break Even,$0.25,$293.50,$90240.00,145,$293.50
2024-07-23,19:19:00,19973.25,SELL,1,0.02h,Break Even,$0.25,$293.75,$90240.25,145,$293.75
2024-07-23,19:22:00,19984.5,BUY,1,0.02h,Stop Loss,$30.25,$324.00,$90270.50,145,$324.00
2024-07-23,19:35:00,19974.25,SELL,1,0.02h,Break Even,$0.25,$324.25,$90270.75,145,$324.25
2024-07-23,20:05:00,19986.75,BUY,1,0.02h,Stop Loss,$29.00,$353.25,$90299.75,145,$353.25
2024-07-23,20:13:00,19932.75,SELL,1,0.02h,Stop Loss,$11.50,$364.75,$90311.25,145,$364.75
2024-07-23,20:24:00,19960.0,BUY,1,0.02h,Stop Loss,$-6.00,$358.75,$90305.25,145,$358.75
2024-07-23,21:00:00,19944.75,SELL,1,1.02h,Stop Loss,$632.75,$991.50,$90938.00,145,$991.50
2024-07-23,22:40:00,19828.75,BUY,1,0.02h,Stop Loss,$25.25,$1016.75,$90963.25,145,$1016.75
2024-07-23,22:49:00,19823.5,SELL,1,0.02h,Break Even,$0.25,$1017.00,$90963.50,145,$1017.00
2024-07-23,22:50:00,19827.0,BUY,1,0.02h,Break Even,$0.25,$1017.25,$90963.75,145,$1017.25
2024-07-23,22:54:00,19823.25,SELL,1,0.02h,Break Even,$0.25,$1017.50,$90964.00,145,$1017.50
Final P&L Day: 1017.50,,,,,,,,,,,
2024-07-24,13:01:00,19636.25,BUY,1,0.02h,Break Even,$0.25,$0.25,$90964.25,146,$0.25
2024-07-24,13:26:00,19629.25,SELL,1,0.02h,Stop Loss,$-6.00,$-5.75,$90958.25,146,$-5.75
2024-07-24,13:27:00,19641.25,BUY,1,0.02h,Stop Loss,$7.75,$2.00,$90966.00,146,$2.00
2024-07-24,13:31:00,19631.75,SELL,1,0.02h,Break Even,$0.25,$2.25,$90966.25,146,$2.25
2024-07-24,13:32:00,19645.5,BUY,1,0.02h,Stop Loss,$16.50,$18.75,$90982.75,146,$18.75
2024-07-24,13:33:00,19629.25,SELL,1,0.02h,Stop Loss,$109.00,$127.75,$91091.75,146,$127.75
2024-07-24,15:38:00,19404.5,BUY,1,0.02h,Stop Loss,$5.25,$133.00,$91097.00,146,$133.00
2024-07-24,15:41:00,19391.0,SELL,1,0.02h,Stop Loss,$27.75,$160.75,$91124.75,146,$160.75
2024-07-24,16:23:00,19358.25,BUY,1,0.02h,Stop Loss,$-6.00,$154.75,$91118.75,146,$154.75
2024-07-24,16:24:00,19347.75,SELL,1,0.02h,Break Even,$0.25,$155.00,$91119.00,146,$155.00
2024-07-24,17:07:00,19343.0,BUY,1,0.02h,Break Even,$0.25,$155.25,$91119.25,146,$155.25
2024-07-24,17:31:00,19340.25,SELL,1,0.02h,Break Even,$0.25,$155.50,$91119.50,146,$155.50
2024-07-24,17:36:00,19363.0,BUY,1,0.02h,Stop Loss,$-6.00,$149.50,$91113.50,146,$149.50
2024-07-24,17:49:00,19342.5,SELL,1,0.02h,Stop Loss,$10.25,$159.75,$91123.75,146,$159.75
2024-07-24,19:35:00,19267.75,BUY,1,0.02h,Stop Loss,$-6.00,$153.75,$91117.75,146,$153.75
2024-07-24,19:53:00,19243.5,SELL,1,0.02h,Stop Loss,$92.75,$246.50,$91210.50,146,$246.50
2024-07-24,20:10:00,19248.0,BUY,1,0.02h,Stop Loss,$35.25,$281.75,$91245.75,146,$281.75
2024-07-24,20:55:00,19259.25,SELL,1,0.02h,Break Even,$0.25,$282.00,$91246.00,146,$282.00
2024-07-24,22:01:00,19270.75,BUY,1,0.02h,Stop Loss,$7.75,$289.75,$91253.75,146,$289.75
2024-07-24,22:30:00,19278.25,SELL,1,0.02h,Break Even,$0.25,$290.00,$91254.00,146,$290.00
2024-07-24,22:35:00,19288.25,BUY,1,0.02h,Stop Loss,$-6.00,$284.00,$91248.00,146,$284.00
2024-07-24,22:48:00,19280.25,SELL,1,0.02h,Break Even,$0.25,$284.25,$91248.25,146,$284.25
Final P&L Day: 284.25,,,,,,,,,,,
2024-07-25,12:36:00,19161.25,BUY,1,0.02h,Stop Loss,$115.25,$115.25,$91363.50,147,$115.25
2024-07-25,13:06:00,19189.0,SELL,1,0.02h,Stop Loss,$-6.00,$109.25,$91357.50,147,$109.25
2024-07-25,13:07:00,19208.25,BUY,1,0.02h,Stop Loss,$40.25,$149.50,$91397.75,147,$149.50
2024-07-25,13:31:00,19198.75,SELL,1,0.02h,Stop Loss,$32.75,$182.25,$91430.50,147,$182.25
2024-07-25,14:24:00,19029.5,BUY,1,0.02h,Stop Loss,$102.75,$285.00,$91533.25,147,$285.00
2024-07-25,15:28:00,19187.75,SELL,1,0.02h,Stop Loss,$12.75,$297.75,$91546.00,147,$297.75
2024-07-25,15:40:00,19222.5,BUY,1,0.02h,Stop Loss,$-6.00,$291.75,$91540.00,147,$291.75
2024-07-25,15:41:00,19201.5,SELL,1,0.02h,Stop Loss,$150.25,$442.00,$91690.25,147,$442.00
2024-07-25,15:54:00,19203.0,BUY,1,0.02h,Stop Loss,$30.25,$472.25,$91720.50,147,$472.25
2024-07-25,16:52:00,19304.25,SELL,1,0.02h,Break Even,$0.25,$472.50,$91720.75,147,$472.50
2024-07-25,17:00:00,19333.5,BUY,1,0.02h,Stop Loss,$36.50,$509.00,$91757.25,147,$509.00
2024-07-25,17:16:00,19314.0,SELL,1,0.02h,Stop Loss,$20.25,$529.25,$91777.50,147,$529.25
2024-07-25,17:59:00,19300.0,BUY,1,0.02h,Stop Loss,$-6.00,$523.25,$91771.50,147,$523.25
2024-07-25,18:05:00,19256.25,SELL,1,0.02h,Stop Loss,$102.75,$626.00,$91874.25,147,$626.00
2024-07-25,18:35:00,19243.5,BUY,1,0.02h,Break Even,$0.25,$626.25,$91874.50,147,$626.25
2024-07-25,18:37:00,19204.75,SELL,1,0.02h,Stop Loss,$9.00,$635.25,$91883.50,147,$635.25
2024-07-25,19:21:00,19155.0,BUY,1,0.02h,Stop Loss,$124.00,$759.25,$92007.50,147,$759.25
2024-07-25,19:38:00,19158.0,SELL,1,0.02h,Stop Loss,$60.25,$819.50,$92067.75,147,$819.50
2024-07-25,20:48:00,18983.5,BUY,1,0.02h,Stop Loss,$-6.00,$813.50,$92061.75,147,$813.50
2024-07-25,22:28:00,19013.25,SELL,1,0.02h,Stop Loss,$-6.00,$807.50,$92055.75,147,$807.50
2024-07-25,22:34:00,19022.75,BUY,1,0.02h,Break Even,$0.25,$807.75,$92056.00,147,$807.75
2024-07-25,22:50:00,19015.75,SELL,1,0.02h,Break Even,$0.25,$808.00,$92056.25,147,$808.00
Final P&L Day: 808.00,,,,,,,,,,,
2024-07-26,12:00:00,19212.5,BUY,1,0.02h,Break Even,$0.25,$0.25,$92056.50,148,$0.25
2024-07-26,12:36:00,19177.5,SELL,1,0.02h,Break Even,$0.25,$0.50,$92056.75,148,$0.50
2024-07-26,13:26:00,19181.75,BUY,1,0.02h,Break Even,$0.25,$0.75,$92057.00,148,$0.75
2024-07-26,13:29:00,19160.0,SELL,1,0.02h,Stop Loss,$-6.00,$-5.25,$92051.00,148,$-5.25
2024-07-26,14:01:00,19164.5,BUY,1,0.02h,Stop Loss,$29.00,$23.75,$92080.00,148,$23.75
2024-07-26,14:07:00,19081.5,SELL,1,0.02h,Stop Loss,$14.00,$37.75,$92094.00,148,$37.75
2024-07-26,14:24:00,19126.25,BUY,1,0.02h,Stop Loss,$109.00,$146.75,$92203.00,148,$146.75
2024-07-26,14:33:00,19073.5,SELL,1,0.02h,Stop Loss,$46.50,$193.25,$92249.50,148,$193.25
2024-07-26,14:59:00,19119.0,BUY,1,0.02h,Stop Loss,$64.00,$257.25,$92313.50,148,$257.25
2024-07-26,15:19:00,19107.5,SELL,1,0.02h,Stop Loss,$21.50,$278.75,$92335.00,148,$278.75
2024-07-26,15:32:00,19133.25,BUY,1,0.02h,Stop Loss,$15.25,$294.00,$92350.25,148,$294.00
2024-07-26,15:37:00,19113.5,SELL,1,0.02h,Break Even,$0.25,$294.25,$92350.50,148,$294.25
2024-07-26,15:38:00,19134.25,BUY,1,0.02h,Stop Loss,$20.25,$314.50,$92370.75,148,$314.50
2024-07-26,17:11:00,19271.25,SELL,1,0.02h,Stop Loss,$17.75,$332.25,$92388.50,148,$332.25
2024-07-26,17:13:00,19279.0,BUY,1,0.02h,Stop Loss,$9.00,$341.25,$92397.50,148,$341.25
2024-07-26,17:15:00,19264.5,SELL,1,0.02h,Stop Loss,$-6.00,$335.25,$92391.50,148,$335.25
2024-07-26,17:17:00,19278.0,BUY,1,0.02h,Stop Loss,$5.25,$340.50,$92396.75,148,$340.50
2024-07-26,17:35:00,19231.5,SELL,1,0.02h,Stop Loss,$204.00,$544.50,$92600.75,148,$544.50
2024-07-26,18:04:00,19210.0,BUY,1,0.02h,Break Even,$0.25,$544.75,$92601.00,148,$544.75
2024-07-26,18:05:00,19192.0,SELL,1,0.02h,Stop Loss,$31.50,$576.25,$92632.50,148,$576.25
2024-07-26,18:08:00,19208.75,BUY,1,0.02h,Break Even,$0.25,$576.50,$92632.75,148,$576.50
2024-07-26,18:20:00,19170.25,SELL,1,0.02h,Break Even,$0.25,$576.75,$92633.00,148,$576.75
2024-07-26,19:23:00,19140.75,BUY,1,0.02h,Stop Loss,$21.50,$598.25,$92654.50,148,$598.25
2024-07-26,19:35:00,19116.75,SELL,1,0.02h,Stop Loss,$21.50,$619.75,$92676.00,148,$619.75
2024-07-26,19:42:00,19170.25,BUY,1,0.02h,Stop Loss,$-6.00,$613.75,$92670.00,148,$613.75
2024-07-26,19:54:00,19133.25,SELL,1,0.02h,Stop Loss,$60.25,$674.00,$92730.25,148,$674.00
2024-07-26,20:01:00,19174.25,BUY,1,0.02h,Break Even,$0.25,$674.25,$92730.50,148,$674.25
2024-07-26,20:39:00,19177.5,SELL,1,0.02h,Stop Loss,$-6.00,$668.25,$92724.50,148,$668.25
Final P&L Day: 668.25,,,,,,,,,,,
2024-07-29,12:00:00,19297.0,BUY,1,0.02h,Stop Loss,$56.50,$56.50,$92781.00,149,$56.50
2024-07-29,12:52:00,19316.5,SELL,1,0.02h,Break Even,$0.25,$56.75,$92781.25,149,$56.75
2024-07-29,13:40:00,19312.75,BUY,1,0.02h,Stop Loss,$31.50,$88.25,$92812.75,149,$88.25
2024-07-29,14:10:00,19307.75,SELL,1,0.02h,Stop Loss,$65.25,$153.50,$92878.00,149,$153.50
2024-07-29,14:42:00,19304.75,BUY,1,0.02h,Stop Loss,$37.75,$191.25,$92915.75,149,$191.25
2024-07-29,14:51:00,19252.25,SELL,1,0.02h,Stop Loss,$11.50,$202.75,$92927.25,149,$202.75
2024-07-29,15:45:00,19164.75,BUY,1,0.02h,Stop Loss,$60.25,$263.00,$92987.50,149,$263.00
2024-07-29,16:52:00,19297.25,SELL,1,0.02h,Break Even,$0.25,$263.25,$92987.75,149,$263.25
2024-07-29,16:56:00,19328.5,BUY,1,0.02h,Stop Loss,$5.25,$268.50,$92993.00,149,$268.50
2024-07-29,16:59:00,19313.5,SELL,1,0.02h,Stop Loss,$40.25,$308.75,$93033.25,149,$308.75
2024-07-29,17:04:00,19319.25,BUY,1,0.02h,Stop Loss,$-6.00,$302.75,$93027.25,149,$302.75
2024-07-29,17:06:00,19310.0,SELL,1,0.02h,Stop Loss,$-6.00,$296.75,$93021.25,149,$296.75
2024-07-29,17:11:00,19324.75,BUY,1,0.02h,Stop Loss,$12.75,$309.50,$93034.00,149,$309.50
2024-07-29,17:21:00,19308.75,SELL,1,0.02h,Stop Loss,$35.25,$344.75,$93069.25,149,$344.75
2024-07-29,18:58:00,19213.75,BUY,1,0.02h,Stop Loss,$45.25,$390.00,$93114.50,149,$390.00
2024-07-29,19:53:00,19238.75,SELL,1,0.02h,Stop Loss,$37.75,$427.75,$93152.25,149,$427.75
2024-07-29,20:27:00,19210.5,BUY,1,0.02h,Stop Loss,$6.50,$434.25,$93158.75,149,$434.25
2024-07-29,20:53:00,19210.0,SELL,1,0.02h,Break Even,$0.25,$434.50,$93159.00,149,$434.50
2024-07-29,21:00:00,19221.75,BUY,1,1.02h,Stop Loss,$47.75,$482.25,$93206.75,149,$482.25
2024-07-29,22:33:00,19217.5,SELL,1,0.02h,Stop Loss,$-6.00,$476.25,$93200.75,149,$476.25
Final P&L Day: 476.25,,,,,,,,,,,
2024-07-30,12:00:00,19261.75,BUY,1,0.02h,Break Even,$0.25,$0.25,$93201.00,150,$0.25
2024-07-30,12:29:00,19257.25,SELL,1,0.02h,Stop Loss,$9.00,$9.25,$93210.00,150,$9.25
2024-07-30,12:35:00,19261.0,BUY,1,0.02h,Stop Loss,$-6.00,$3.25,$93204.00,150,$3.25
2024-07-30,12:36:00,19257.0,SELL,1,0.02h,Stop Loss,$-6.00,$-2.75,$93198.00,150,$-2.75
2024-07-30,12:37:00,19265.5,BUY,1,0.02h,Break Even,$0.25,$-2.50,$93198.25,150,$-2.50
2024-07-30,13:10:00,19264.5,SELL,1,0.02h,Stop Loss,$-6.00,$-8.50,$93192.25,150,$-8.50
2024-07-30,13:11:00,19268.0,BUY,1,0.02h,Stop Loss,$-6.00,$-14.50,$93186.25,150,$-14.50
2024-07-30,13:46:00,19236.25,SELL,1,0.02h,Stop Loss,$14.00,$-0.50,$93200.25,150,$-0.50
2024-07-30,14:18:00,19229.0,BUY,1,0.02h,Break Even,$0.25,$-0.25,$93200.50,150,$-0.25
2024-07-30,14:19:00,19199.0,SELL,1,0.02h,Stop Loss,$29.00,$28.75,$93229.50,150,$28.75
2024-07-30,16:10:00,18968.5,BUY,1,0.02h,Break Even,$0.25,$29.00,$93229.75,150,$29.00
2024-07-30,16:22:00,18929.0,SELL,1,0.02h,Stop Loss,$57.75,$86.75,$93287.50,150,$86.75
2024-07-30,16:43:00,18945.25,BUY,1,0.02h,Break Even,$0.25,$87.00,$93287.75,150,$87.00
2024-07-30,16:46:00,18915.5,SELL,1,0.02h,Stop Loss,$82.75,$169.75,$93370.50,150,$169.75
2024-07-30,17:15:00,18878.75,BUY,1,0.02h,Stop Loss,$30.25,$200.00,$93400.75,150,$200.00
2024-07-30,18:48:00,18962.75,SELL,1,0.02h,Stop Loss,$16.50,$216.50,$93417.25,150,$216.50
2024-07-30,19:24:00,18947.5,BUY,1,0.02h,Break Even,$0.25,$216.75,$93417.50,150,$216.75
2024-07-30,19:32:00,18926.25,SELL,1,0.02h,Stop Loss,$35.25,$252.00,$93452.75,150,$252.00
2024-07-30,19:47:00,18936.5,BUY,1,0.02h,Stop Loss,$166.50,$418.50,$93619.25,150,$418.50
2024-07-30,20:01:00,18866.75,SELL,1,0.02h,Stop Loss,$477.75,$896.25,$94097.00,150,$896.25
2024-07-30,20:30:00,18839.5,BUY,1,0.02h,Stop Loss,$24.00,$920.25,$94121.00,150,$920.25
2024-07-30,20:56:00,18847.5,SELL,1,0.02h,Break Even,$0.25,$920.50,$94121.25,150,$920.50
2024-07-30,22:01:00,18875.0,BUY,1,0.02h,Stop Loss,$75.25,$995.75,$94196.50,150,$995.75
2024-07-30,22:51:00,18969.0,SELL,1,0.02h,Break Even,$0.25,$996.00,$94196.75,150,$996.00
Final P&L Day: 996.00,,,,,,,,,,,
2024-07-31,12:00:00,19251.75,BUY,1,0.02h,Stop Loss,$14.00,$14.00,$94210.75,151,$14.00
2024-07-31,13:33:00,19335.5,SELL,1,0.02h,Stop Loss,$24.00,$38.00,$94234.75,151,$38.00
2024-07-31,13:41:00,19398.25,BUY,1,0.02h,Stop Loss,$34.00,$72.00,$94268.75,151,$72.00
2024-07-31,13:47:00,19334.5,SELL,1,0.02h,Stop Loss,$-6.00,$66.00,$94262.75,151,$66.00
2024-07-31,13:50:00,19364.0,BUY,1,0.02h,Break Even,$0.25,$66.25,$94263.00,151,$66.25
2024-07-31,14:49:00,19447.25,SELL,1,0.02h,Stop Loss,$36.50,$102.75,$94299.50,151,$102.75
2024-07-31,15:04:00,19456.5,BUY,1,0.02h,Stop Loss,$22.75,$125.50,$94322.25,151,$125.50
2024-07-31,15:48:00,19481.25,SELL,1,0.02h,Break Even,$0.25,$125.75,$94322.50,151,$125.75
2024-07-31,15:49:00,19487.0,BUY,1,0.02h,Break Even,$0.25,$126.00,$94322.75,151,$126.00
2024-07-31,15:51:00,19476.75,SELL,1,0.02h,Stop Loss,$52.75,$178.75,$94375.50,151,$178.75
2024-07-31,16:14:00,19475.25,BUY,1,0.02h,Stop Loss,$29.00,$207.75,$94404.50,151,$207.75
2024-07-31,16:25:00,19461.75,SELL,1,0.02h,Stop Loss,$82.75,$290.50,$94487.25,151,$290.50
2024-07-31,16:52:00,19452.75,BUY,1,0.02h,Break Even,$0.25,$290.75,$94487.50,151,$290.75
2024-07-31,16:54:00,19440.25,SELL,1,0.02h,Stop Loss,$29.00,$319.75,$94516.50,151,$319.75
2024-07-31,17:06:00,19447.75,BUY,1,0.02h,Stop Loss,$9.00,$328.75,$94525.50,151,$328.75
2024-07-31,17:26:00,19436.0,SELL,1,0.02h,Stop Loss,$4.00,$332.75,$94529.50,151,$332.75
2024-07-31,17:51:00,19432.5,BUY,1,0.02h,Stop Loss,$-6.00,$326.75,$94523.50,151,$326.75
2024-07-31,19:14:00,19535.75,SELL,1,0.02h,Stop Loss,$39.00,$365.75,$94562.50,151,$365.75
2024-07-31,19:17:00,19555.25,BUY,1,0.02h,Stop Loss,$46.50,$412.25,$94609.00,151,$412.25
2024-07-31,19:19:00,19502.5,SELL,1,0.02h,Stop Loss,$140.25,$552.50,$94749.25,151,$552.50
2024-07-31,19:41:00,19515.25,BUY,1,0.02h,Stop Loss,$54.00,$606.50,$94803.25,151,$606.50
2024-07-31,19:53:00,19463.75,SELL,1,0.02h,Stop Loss,$47.75,$654.25,$94851.00,151,$654.25
2024-07-31,20:01:00,19550.0,BUY,1,0.02h,Stop Loss,$127.75,$782.00,$94978.75,151,$782.00
2024-07-31,22:32:00,19621.25,SELL,1,0.02h,Stop Loss,$-6.00,$776.00,$94972.75,151,$776.00
2024-07-31,22:37:00,19637.0,BUY,1,0.02h,Break Even,$0.25,$776.25,$94973.00,151,$776.25
2024-07-31,22:40:00,19609.5,SELL,1,0.02h,Break Even,$0.25,$776.50,$94973.25,151,$776.50
2024-07-31,22:53:00,19638.0,BUY,1,0.02h,Break Even,$0.25,$776.75,$94973.50,151,$776.75
Final P&L Day: 776.75,,,,,,,,,,,
2024-08-01,12:00:00,19574.25,SELL,1,0.02h,Break Even,$0.25,$0.25,$94973.75,152,$0.25
2024-08-01,12:19:00,19613.0,BUY,1,0.02h,Stop Loss,$5.25,$5.50,$94979.00,152,$5.50
2024-08-01,12:40:00,19608.5,SELL,1,0.02h,Stop Loss,$46.50,$52.00,$95025.50,152,$52.00
2024-08-01,13:40:00,19563.25,BUY,1,0.02h,Stop Loss,$104.00,$156.00,$95129.50,152,$156.00
2024-08-01,14:06:00,19578.75,SELL,1,0.02h,Stop Loss,$71.50,$227.50,$95201.00,152,$227.50
2024-08-01,16:08:00,19227.75,BUY,1,0.02h,Stop Loss,$-6.00,$221.50,$95195.00,152,$221.50
2024-08-01,16:21:00,19175.5,SELL,1,0.02h,Stop Loss,$35.25,$256.75,$95230.25,152,$256.75
2024-08-01,17:58:00,18981.5,BUY,1,0.02h,Stop Loss,$69.00,$325.75,$95299.25,152,$325.75
2024-08-01,18:13:00,18950.0,SELL,1,0.02h,Break Even,$0.25,$326.00,$95299.50,152,$326.00
2024-08-01,19:02:00,18915.25,BUY,1,0.02h,Stop Loss,$37.75,$363.75,$95337.25,152,$363.75
2024-08-01,20:03:00,18953.0,SELL,1,0.02h,Stop Loss,$151.50,$515.25,$95488.75,152,$515.25
2024-08-01,20:39:00,18929.25,BUY,1,0.02h,Stop Loss,$4.00,$519.25,$95492.75,152,$519.25
2024-08-01,20:41:00,18908.5,SELL,1,0.02h,Stop Loss,$39.00,$558.25,$95531.75,152,$558.25
2024-08-01,20:48:00,18928.75,BUY,1,0.02h,Break Even,$0.25,$558.50,$95532.00,152,$558.50
2024-08-01,22:09:00,18925.25,SELL,1,0.02h,Stop Loss,$37.75,$596.25,$95569.75,152,$596.25
2024-08-01,22:29:00,18938.0,BUY,1,0.02h,Stop Loss,$4.00,$600.25,$95573.75,152,$600.25
2024-08-01,22:39:00,18901.5,SELL,1,0.02h,Stop Loss,$91.50,$691.75,$95665.25,152,$691.75
Final P&L Day: 691.75,,,,,,,,,,,
2024-08-02,12:54:00,18612.0,BUY,1,0.02h,Stop Loss,$110.25,$110.25,$95775.50,153,$110.25
2024-08-02,13:02:00,18573.0,SELL,1,0.02h,Stop Loss,$84.00,$194.25,$95859.50,153,$194.25
2024-08-02,13:09:00,18595.25,BUY,1,0.02h,Stop Loss,$21.50,$215.75,$95881.00,153,$215.75
2024-08-02,13:34:00,18562.75,SELL,1,0.02h,Stop Loss,$89.00,$304.75,$95970.00,153,$304.75
2024-08-02,13:40:00,18719.25,BUY,1,0.02h,Stop Loss,$176.50,$481.25,$96146.50,153,$481.25
2024-08-02,13:52:00,18605.25,SELL,1,0.02h,Stop Loss,$85.25,$566.50,$96231.75,153,$566.50
2024-08-02,14:30:00,18486.75,BUY,1,0.02h,Stop Loss,$169.00,$735.50,$96400.75,153,$735.50
2024-08-02,14:36:00,18457.25,SELL,1,0.02h,Stop Loss,$81.50,$817.00,$96482.25,153,$817.00
2024-08-02,14:47:00,18499.5,BUY,1,0.02h,Stop Loss,$122.75,$939.75,$96605.00,153,$939.75
2024-08-02,14:57:00,18453.0,SELL,1,0.02h,Stop Loss,$89.00,$1028.75,$96694.00,153,$1028.75
2024-08-02,15:13:00,18476.75,BUY,1,0.02h,Stop Loss,$7.75,$1036.50,$96701.75,153,$1036.50
2024-08-02,15:21:00,18432.5,SELL,1,0.02h,Break Even,$0.25,$1036.75,$96702.00,153,$1036.75
2024-08-02,15:24:00,18493.25,BUY,1,0.02h,Stop Loss,$54.00,$1090.75,$96756.00,153,$1090.75
2024-08-02,16:12:00,18535.5,SELL,1,0.02h,Stop Loss,$56.50,$1147.25,$96812.50,153,$1147.25
2024-08-02,16:22:00,18607.5,BUY,1,0.02h,Break Even,$0.25,$1147.50,$96812.75,153,$1147.50
2024-08-02,16:38:00,18563.25,SELL,1,0.02h,Break Even,$0.25,$1147.75,$96813.00,153,$1147.75
2024-08-02,16:41:00,18608.0,BUY,1,0.02h,Stop Loss,$110.25,$1258.00,$96923.25,153,$1258.00
2024-08-02,16:48:00,18558.75,SELL,1,0.02h,Stop Loss,$7.75,$1265.75,$96931.00,153,$1265.75
2024-08-02,17:15:00,18550.25,BUY,1,0.02h,Stop Loss,$25.25,$1291.00,$96956.25,153,$1291.00
2024-08-02,17:23:00,18509.75,SELL,1,0.02h,Stop Loss,$31.50,$1322.50,$96987.75,153,$1322.50
2024-08-02,17:59:00,18484.5,BUY,1,0.02h,Stop Loss,$34.00,$1356.50,$97021.75,153,$1356.50
2024-08-02,18:15:00,18474.25,SELL,1,0.02h,Stop Loss,$30.25,$1386.75,$97052.00,153,$1386.75
2024-08-02,18:23:00,18501.25,BUY,1,0.02h,Stop Loss,$49.00,$1435.75,$97101.00,153,$1435.75
2024-08-02,18:59:00,18514.75,SELL,1,0.02h,Stop Loss,$72.75,$1508.50,$97173.75,153,$1508.50
2024-08-02,19:04:00,18532.0,BUY,1,0.02h,Break Even,$0.25,$1508.75,$97174.00,153,$1508.75
2024-08-02,19:05:00,18520.75,SELL,1,0.02h,Stop Loss,$65.25,$1574.00,$97239.25,153,$1574.00
2024-08-02,19:15:00,18540.25,BUY,1,0.02h,Stop Loss,$4.00,$1578.00,$97243.25,153,$1578.00
2024-08-02,19:39:00,18504.5,SELL,1,0.02h,Stop Loss,$72.75,$1650.75,$97316.00,153,$1650.75
2024-08-02,19:56:00,18555.25,BUY,1,0.02h,Stop Loss,$109.00,$1759.75,$97425.00,153,$1759.75
2024-08-02,20:32:00,18543.25,SELL,1,0.02h,Stop Loss,$9.00,$1768.75,$97434.00,153,$1768.75
Final P&L Day: 1768.75,,,,,,,,,,,
2024-08-05,12:57:00,17526.5,BUY,1,0.02h,Stop Loss,$150.25,$150.25,$97584.25,154,$150.25
2024-08-05,13:30:00,17564.25,SELL,1,0.02h,Stop Loss,$259.00,$409.25,$97843.25,154,$409.25
2024-08-05,13:34:00,17681.0,BUY,1,0.02h,Stop Loss,$125.25,$534.50,$97968.50,154,$534.50
2024-08-05,14:28:00,17906.75,SELL,1,0.02h,Stop Loss,$114.00,$648.50,$98082.50,154,$648.50
2024-08-05,14:37:00,17968.5,BUY,1,0.02h,Stop Loss,$66.50,$715.00,$98149.00,154,$715.00
2024-08-05,15:01:00,17918.0,SELL,1,0.02h,Stop Loss,$127.75,$842.75,$98276.75,154,$842.75
2024-08-05,15:08:00,18018.75,BUY,1,0.02h,Stop Loss,$502.75,$1345.50,$98779.50,154,$1345.50
2024-08-05,15:44:00,18080.75,SELL,1,0.02h,Stop Loss,$45.25,$1390.75,$98824.75,154,$1390.75
2024-08-05,16:04:00,18151.75,BUY,1,0.02h,Break Even,$0.25,$1391.00,$98825.00,154,$1391.00
2024-08-05,16:38:00,18139.5,SELL,1,0.02h,Stop Loss,$41.50,$1432.50,$98866.50,154,$1432.50
2024-08-05,17:16:00,18104.25,BUY,1,0.02h,Stop Loss,$21.50,$1454.00,$98888.00,154,$1454.00
2024-08-05,17:50:00,18101.0,SELL,1,0.02h,Stop Loss,$27.75,$1481.75,$98915.75,154,$1481.75
2024-08-05,18:31:00,18052.5,BUY,1,0.02h,Stop Loss,$17.75,$1499.50,$98933.50,154,$1499.50
2024-08-05,18:39:00,17999.75,SELL,1,0.02h,Stop Loss,$17.75,$1517.25,$98951.25,154,$1517.25
2024-08-05,19:05:00,17996.0,BUY,1,0.02h,Stop Loss,$-6.00,$1511.25,$98945.25,154,$1511.25
2024-08-05,19:10:00,17926.75,SELL,1,0.02h,Break Even,$0.25,$1511.50,$98945.50,154,$1511.50
2024-08-05,19:23:00,17948.0,BUY,1,0.02h,Stop Loss,$35.25,$1546.75,$98980.75,154,$1546.75
2024-08-05,19:45:00,17932.75,SELL,1,0.02h,Stop Loss,$22.75,$1569.50,$99003.50,154,$1569.50
2024-08-05,19:54:00,17968.25,BUY,1,0.02h,Break Even,$0.25,$1569.75,$99003.75,154,$1569.75
2024-08-05,22:46:00,18215.0,SELL,1,0.02h,Stop Loss,$9.00,$1578.75,$99012.75,154,$1578.75
Final P&L Day: 1578.75,,,,,,,,,,,
2024-08-06,13:20:00,18102.25,BUY,1,0.02h,Stop Loss,$7.75,$7.75,$99020.50,155,$7.75
2024-08-06,13:25:00,18082.25,SELL,1,0.02h,Stop Loss,$4.00,$11.75,$99024.50,155,$11.75
2024-08-06,13:26:00,18105.75,BUY,1,0.02h,Stop Loss,$94.00,$105.75,$99118.50,155,$105.75
2024-08-06,13:38:00,18047.25,SELL,1,0.02h,Stop Loss,$19.00,$124.75,$99137.50,155,$124.75
2024-08-06,13:54:00,18117.25,BUY,1,0.02h,Stop Loss,$107.75,$232.50,$99245.25,155,$232.50
2024-08-06,14:31:00,18133.5,SELL,1,0.02h,Stop Loss,$10.25,$242.75,$99255.50,155,$242.75
2024-08-06,14:37:00,18193.5,BUY,1,0.02h,Stop Loss,$134.00,$376.75,$99389.50,155,$376.75
2024-08-06,15:14:00,18280.0,SELL,1,0.02h,Stop Loss,$70.25,$447.00,$99459.75,155,$447.00
2024-08-06,15:44:00,18250.25,BUY,1,0.02h,Stop Loss,$54.00,$501.00,$99513.75,155,$501.00
2024-08-06,16:27:00,18330.25,SELL,1,0.02h,Stop Loss,$9.00,$510.00,$99522.75,155,$510.00
2024-08-06,16:42:00,18358.75,BUY,1,0.02h,Stop Loss,$26.50,$536.50,$99549.25,155,$536.50
2024-08-06,17:19:00,18408.0,SELL,1,0.02h,Stop Loss,$21.50,$558.00,$99570.75,155,$558.00
2024-08-06,17:30:00,18422.75,BUY,1,0.02h,Stop Loss,$52.75,$610.75,$99623.50,155,$610.75
2024-08-06,17:44:00,18402.75,SELL,1,0.02h,Stop Loss,$14.00,$624.75,$99637.50,155,$624.75
2024-08-06,17:54:00,18428.0,BUY,1,0.02h,Stop Loss,$29.00,$653.75,$99666.50,155,$653.75
2024-08-06,18:04:00,18408.0,SELL,1,0.02h,Break Even,$0.25,$654.00,$99666.75,155,$654.00
2024-08-06,18:18:00,18425.5,BUY,1,0.02h,Stop Loss,$59.00,$713.00,$99725.75,155,$713.00
2024-08-06,18:58:00,18442.75,SELL,1,0.02h,Stop Loss,$157.75,$870.75,$99883.50,155,$870.75
2024-08-06,19:26:00,18366.0,BUY,1,0.02h,Break Even,$0.25,$871.00,$99883.75,155,$871.00
2024-08-06,19:37:00,18330.5,SELL,1,0.02h,Stop Loss,$6.50,$877.50,$99890.25,155,$877.50
2024-08-06,20:21:00,18265.5,BUY,1,0.02h,Break Even,$0.25,$877.75,$99890.50,155,$877.75
2024-08-06,20:33:00,18181.25,SELL,1,0.02h,Stop Loss,$-6.00,$871.75,$99884.50,155,$871.75
2024-08-06,22:21:00,18126.0,BUY,1,0.02h,Stop Loss,$51.50,$923.25,$99936.00,155,$923.25
2024-08-06,22:37:00,18085.0,SELL,1,0.02h,Break Even,$0.25,$923.50,$99936.25,155,$923.50
2024-08-06,22:56:00,18100.0,BUY,1,0.02h,Break Even,$0.25,$923.75,$99936.50,155,$923.75
Final P&L Day: 923.75,,,,,,,,,,,
2024-08-07,12:56:00,18416.5,SELL,1,0.02h,Stop Loss,$-6.00,$-6.00,$99930.50,156,$-6.00
2024-08-07,13:01:00,18436.0,BUY,1,0.02h,Stop Loss,$9.00,$3.00,$99939.50,156,$3.00
2024-08-07,13:04:00,18425.5,SELL,1,0.02h,Stop Loss,$5.25,$8.25,$99944.75,156,$8.25
2024-08-07,13:10:00,18438.0,BUY,1,0.02h,Break Even,$0.25,$8.50,$99945.00,156,$8.50
2024-08-07,13:13:00,18418.5,SELL,1,0.02h,Stop Loss,$45.25,$53.75,$99990.25,156,$53.75
2024-08-07,13:26:00,18433.75,BUY,1,0.02h,Stop Loss,$15.25,$69.00,$100005.50,156,$69.00
2024-08-07,14:08:00,18503.25,SELL,1,0.02h,Stop Loss,$11.50,$80.50,$100017.00,156,$80.50
2024-08-07,14:10:00,18533.5,BUY,1,0.02h,Stop Loss,$45.25,$125.75,$100062.25,156,$125.75
2024-08-07,14:18:00,18482.75,SELL,1,0.02h,Stop Loss,$197.75,$323.50,$100260.00,156,$323.50
2024-08-07,14:45:00,18503.25,BUY,1,0.02h,Stop Loss,$101.50,$425.00,$100361.50,156,$425.00
2024-08-07,15:14:00,18491.75,SELL,1,0.02h,Stop Loss,$42.75,$467.75,$100404.25,156,$467.75
2024-08-07,16:22:00,18382.0,BUY,1,0.02h,Stop Loss,$20.25,$488.00,$100424.50,156,$488.00
2024-08-07,16:43:00,18351.5,SELL,1,0.02h,Stop Loss,$97.75,$585.75,$100522.25,156,$585.75
2024-08-07,17:38:00,18232.0,BUY,1,0.02h,Stop Loss,$59.00,$644.75,$100581.25,156,$644.75
2024-08-07,17:42:00,18196.0,SELL,1,0.02h,Stop Loss,$24.00,$668.75,$100605.25,156,$668.75
2024-08-07,18:30:00,18080.0,BUY,1,0.02h,Stop Loss,$-6.00,$662.75,$100599.25,156,$662.75
2024-08-07,18:32:00,18049.5,SELL,1,0.02h,Stop Loss,$94.00,$756.75,$100693.25,156,$756.75
2024-08-07,19:03:00,18085.25,BUY,1,0.02h,Stop Loss,$96.50,$853.25,$100789.75,156,$853.25
2024-08-07,19:27:00,18077.0,SELL,1,0.02h,Stop Loss,$55.25,$908.50,$100845.00,156,$908.50
2024-08-07,19:38:00,18103.25,BUY,1,0.02h,Stop Loss,$46.50,$955.00,$100891.50,156,$955.00
2024-08-07,19:41:00,18076.0,SELL,1,0.02h,Stop Loss,$17.75,$972.75,$100909.25,156,$972.75
2024-08-07,22:19:00,17891.0,BUY,1,0.02h,Stop Loss,$36.50,$1009.25,$100945.75,156,$1009.25
2024-08-07,22:47:00,17897.5,SELL,1,0.02h,Stop Loss,$35.25,$1044.50,$100981.00,156,$1044.50
2024-08-07,22:59:00,17906.75,BUY,1,0.02h,Stop Loss,$-6.00,$1038.50,$100975.00,156,$1038.50
Final P&L Day: 1038.50,,,,,,,,,,,
2024-08-08,12:27:00,17966.5,SELL,1,0.02h,Break Even,$0.25,$0.25,$100975.25,157,$0.25
2024-08-08,12:29:00,17981.0,BUY,1,0.02h,Stop Loss,$54.00,$54.25,$101029.25,157,$54.25
2024-08-08,13:38:00,18163.75,SELL,1,0.02h,Stop Loss,$87.75,$142.00,$101117.00,157,$142.00
2024-08-08,13:59:00,18174.5,BUY,1,0.02h,Stop Loss,$180.25,$322.25,$101297.25,157,$322.25
2024-08-08,15:08:00,18383.5,SELL,1,0.02h,Stop Loss,$34.00,$356.25,$101331.25,157,$356.25
2024-08-08,15:25:00,18395.75,BUY,1,0.02h,Stop Loss,$10.25,$366.50,$101341.50,157,$366.50
2024-08-08,15:42:00,18377.75,SELL,1,0.02h,Stop Loss,$17.75,$384.25,$101359.25,157,$384.25
2024-08-08,15:43:00,18389.25,BUY,1,0.02h,Stop Loss,$-6.00,$378.25,$101353.25,157,$378.25
2024-08-08,15:47:00,18376.0,SELL,1,0.02h,Break Even,$0.25,$378.50,$101353.50,157,$378.50
2024-08-08,15:55:00,18396.75,BUY,1,0.02h,Stop Loss,$27.75,$406.25,$101381.25,157,$406.25
2024-08-08,16:31:00,18408.5,SELL,1,0.02h,Stop Loss,$111.50,$517.75,$101492.75,157,$517.75
2024-08-08,16:53:00,18411.0,BUY,1,0.02h,Stop Loss,$44.00,$561.75,$101536.75,157,$561.75
2024-08-08,17:03:00,18381.25,SELL,1,0.02h,Stop Loss,$52.75,$614.50,$101589.50,157,$614.50
2024-08-08,17:13:00,18412.0,BUY,1,0.02h,Stop Loss,$52.75,$667.25,$101642.25,157,$667.25
2024-08-08,18:28:00,18498.75,SELL,1,0.02h,Break Even,$0.25,$667.50,$101642.50,157,$667.50
2024-08-08,19:13:00,18506.0,BUY,1,0.02h,Stop Loss,$6.50,$674.00,$101649.00,157,$674.00
2024-08-08,19:18:00,18484.75,SELL,1,0.02h,Stop Loss,$60.25,$734.25,$101709.25,157,$734.25
2024-08-08,19:23:00,18501.0,BUY,1,0.02h,Stop Loss,$19.00,$753.25,$101728.25,157,$753.25
2024-08-08,19:29:00,18463.25,SELL,1,0.02h,Stop Loss,$107.75,$861.00,$101836.00,157,$861.00
2024-08-08,19:44:00,18495.0,BUY,1,0.02h,Stop Loss,$64.00,$925.00,$101900.00,157,$925.00
2024-08-08,20:53:00,18563.0,SELL,1,0.02h,Break Even,$0.25,$925.25,$101900.25,157,$925.25
2024-08-08,20:56:00,18566.0,BUY,1,0.02h,Stop Loss,$-6.00,$919.25,$101894.25,157,$919.25
2024-08-08,21:00:00,18557.5,SELL,1,1.02h,Stop Loss,$96.50,$1015.75,$101990.75,157,$1015.75
2024-08-08,22:03:00,18573.75,BUY,1,0.02h,Break Even,$0.25,$1016.00,$101991.00,157,$1016.00
2024-08-08,22:06:00,18555.0,SELL,1,0.02h,Break Even,$0.25,$1016.25,$101991.25,157,$1016.25
2024-08-08,22:25:00,18552.75,BUY,1,0.02h,Stop Loss,$9.00,$1025.25,$102000.25,157,$1025.25
2024-08-08,22:42:00,18545.25,SELL,1,0.02h,Break Even,$0.25,$1025.50,$102000.50,157,$1025.50
2024-08-08,23:00:00,18561.5,BUY,1,13.00h,Stop Loss,$-6.00,$1019.50,$101994.50,157,$1019.50
Final P&L Day: 1019.50,,,,,,,,,,,
2024-08-09,12:00:00,18525.25,SELL,1,0.02h,Stop Loss,$42.75,$42.75,$102037.25,158,$42.75
2024-08-09,12:53:00,18439.25,BUY,1,0.02h,Break Even,$0.25,$43.00,$102037.50,158,$43.00
2024-08-09,12:54:00,18429.5,SELL,1,0.02h,Stop Loss,$91.50,$134.50,$102129.00,158,$134.50
2024-08-09,12:57:00,18440.75,BUY,1,0.02h,Stop Loss,$-6.00,$128.50,$102123.00,158,$128.50
2024-08-09,13:00:00,18424.0,SELL,1,0.02h,Stop Loss,$57.75,$186.25,$102180.75,158,$186.25
2024-08-09,13:07:00,18439.75,BUY,1,0.02h,Break Even,$0.25,$186.50,$102181.00,158,$186.50
2024-08-09,13:25:00,18429.25,SELL,1,0.02h,Stop Loss,$-6.00,$180.50,$102175.00,158,$180.50
2024-08-09,13:29:00,18448.0,BUY,1,0.02h,Stop Loss,$25.25,$205.75,$102200.25,158,$205.75
2024-08-09,13:47:00,18437.0,SELL,1,0.02h,Break Even,$0.25,$206.00,$102200.50,158,$206.00
2024-08-09,13:54:00,18475.25,BUY,1,0.02h,Stop Loss,$39.00,$245.00,$102239.50,158,$245.00
2024-08-09,13:57:00,18437.5,SELL,1,0.02h,Stop Loss,$40.25,$285.25,$102279.75,158,$285.25
2024-08-09,14:05:00,18490.5,BUY,1,0.02h,Break Even,$0.25,$285.50,$102280.00,158,$285.50
2024-08-09,14:30:00,18495.25,SELL,1,0.02h,Stop Loss,$109.00,$394.50,$102389.00,158,$394.50
2024-08-09,14:48:00,18501.0,BUY,1,0.02h,Stop Loss,$40.25,$434.75,$102429.25,158,$434.75
2024-08-09,15:25:00,18535.0,SELL,1,0.02h,Stop Loss,$-6.00,$428.75,$102423.25,158,$428.75
2024-08-09,15:27:00,18546.5,BUY,1,0.02h,Stop Loss,$35.25,$464.00,$102458.50,158,$464.00
2024-08-09,15:29:00,18531.5,SELL,1,0.02h,Stop Loss,$107.75,$571.75,$102566.25,158,$571.75
2024-08-09,15:50:00,18530.0,BUY,1,0.02h,Stop Loss,$7.75,$579.50,$102574.00,158,$579.50
2024-08-09,15:57:00,18481.25,SELL,1,0.02h,Stop Loss,$26.50,$606.00,$102600.50,158,$606.00
2024-08-09,16:30:00,18481.25,BUY,1,0.02h,Stop Loss,$89.00,$695.00,$102689.50,158,$695.00
2024-08-09,17:51:00,18619.25,SELL,1,0.02h,Break Even,$0.25,$695.25,$102689.75,158,$695.25
2024-08-09,18:41:00,18601.0,BUY,1,0.02h,Stop Loss,$4.00,$699.25,$102693.75,158,$699.25
2024-08-09,18:53:00,18584.5,SELL,1,0.02h,Stop Loss,$62.75,$762.00,$102756.50,158,$762.00
2024-08-09,19:08:00,18600.0,BUY,1,0.02h,Stop Loss,$17.75,$779.75,$102774.25,158,$779.75
2024-08-09,19:54:00,18596.5,SELL,1,0.02h,Stop Loss,$85.25,$865.00,$102859.50,158,$865.00
2024-08-09,20:04:00,18617.75,BUY,1,0.02h,Break Even,$0.25,$865.25,$102859.75,158,$865.25
2024-08-09,20:22:00,18608.5,SELL,1,0.02h,Stop Loss,$-6.00,$859.25,$102853.75,158,$859.25
Final P&L Day: 859.25,,,,,,,,,,,
2024-08-12,12:00:00,18664.5,BUY,1,0.02h,Break Even,$0.25,$0.25,$102854.00,159,$0.25
2024-08-12,12:43:00,18666.75,SELL,1,0.02h,Stop Loss,$14.00,$14.25,$102868.00,159,$14.25
2024-08-12,13:03:00,18671.0,BUY,1,0.02h,Stop Loss,$-6.00,$8.25,$102862.00,159,$8.25
2024-08-12,13:10:00,18655.0,SELL,1,0.02h,Stop Loss,$-6.00,$2.25,$102856.00,159,$2.25
2024-08-12,13:27:00,18663.0,BUY,1,0.02h,Break Even,$0.25,$2.50,$102856.25,159,$2.50
2024-08-12,13:29:00,18639.25,SELL,1,0.02h,Break Even,$0.25,$2.75,$102856.50,159,$2.75
2024-08-12,14:07:00,18605.25,BUY,1,0.02h,Stop Loss,$50.25,$53.00,$102906.75,159,$53.00
2024-08-12,15:23:00,18682.0,SELL,1,0.02h,Stop Loss,$207.75,$260.75,$103114.50,159,$260.75
2024-08-12,15:51:00,18670.75,BUY,1,0.02h,Stop Loss,$69.00,$329.75,$103183.50,159,$329.75
2024-08-12,16:19:00,18686.25,SELL,1,0.02h,Break Even,$0.25,$330.00,$103183.75,159,$330.00
2024-08-12,16:26:00,18699.75,BUY,1,0.02h,Stop Loss,$5.25,$335.25,$103189.00,159,$335.25
2024-08-12,16:29:00,18685.25,SELL,1,0.02h,Break Even,$0.25,$335.50,$103189.25,159,$335.50
2024-08-12,16:30:00,18694.75,BUY,1,0.02h,Stop Loss,$20.25,$355.75,$103209.50,159,$355.75
2024-08-12,16:37:00,18688.75,SELL,1,0.02h,Stop Loss,$12.75,$368.50,$103222.25,159,$368.50
2024-08-12,16:40:00,18709.75,BUY,1,0.02h,Stop Loss,$15.25,$383.75,$103237.50,159,$383.75
2024-08-12,16:43:00,18686.5,SELL,1,0.02h,Stop Loss,$-6.00,$377.75,$103231.50,159,$377.75
2024-08-12,16:44:00,18698.75,BUY,1,0.02h,Break Even,$0.25,$378.00,$103231.75,159,$378.00
2024-08-12,16:53:00,18686.25,SELL,1,0.02h,Break Even,$0.25,$378.25,$103232.00,159,$378.25
2024-08-12,17:20:00,18664.0,BUY,1,0.02h,Stop Loss,$36.50,$414.75,$103268.50,159,$414.75
2024-08-12,17:39:00,18642.75,SELL,1,0.02h,Stop Loss,$-6.00,$408.75,$103262.50,159,$408.75
2024-08-12,18:17:00,18627.0,BUY,1,0.02h,Break Even,$0.25,$409.00,$103262.75,159,$409.00
2024-08-12,18:31:00,18608.75,SELL,1,0.02h,Break Even,$0.25,$409.25,$103263.00,159,$409.25
2024-08-12,18:37:00,18629.25,BUY,1,0.02h,Stop Loss,$5.25,$414.50,$103268.25,159,$414.50
2024-08-12,19:09:00,18619.25,SELL,1,0.02h,Stop Loss,$17.75,$432.25,$103286.00,159,$432.25
2024-08-12,19:13:00,18635.0,BUY,1,0.02h,Stop Loss,$-6.00,$426.25,$103280.00,159,$426.25
2024-08-12,19:14:00,18617.0,SELL,1,0.02h,Stop Loss,$5.25,$431.50,$103285.25,159,$431.50
2024-08-12,19:26:00,18631.25,BUY,1,0.02h,Stop Loss,$22.75,$454.25,$103308.00,159,$454.25
2024-08-12,19:30:00,18620.5,SELL,1,0.02h,Stop Loss,$-6.00,$448.25,$103302.00,159,$448.25
2024-08-12,19:31:00,18631.5,BUY,1,0.02h,Break Even,$0.25,$448.50,$103302.25,159,$448.50
2024-08-12,19:33:00,18623.75,SELL,1,0.02h,Stop Loss,$16.50,$465.00,$103318.75,159,$465.00
2024-08-12,19:59:00,18618.25,BUY,1,0.02h,Stop Loss,$131.50,$596.50,$103450.25,159,$596.50
2024-08-12,20:30:00,18631.5,SELL,1,0.02h,Break Even,$0.25,$596.75,$103450.50,159,$596.75
2024-08-12,22:01:00,18645.0,BUY,1,0.02h,Stop Loss,$6.50,$603.25,$103457.00,159,$603.25
2024-08-12,22:32:00,18636.25,SELL,1,0.02h,Stop Loss,$15.25,$618.50,$103472.25,159,$618.50
2024-08-12,22:51:00,18641.5,BUY,1,0.02h,Break Even,$0.25,$618.75,$103472.50,159,$618.75
2024-08-12,22:56:00,18634.5,SELL,1,0.02h,Stop Loss,$-6.00,$612.75,$103466.50,159,$612.75
2024-08-12,22:57:00,18636.5,BUY,1,0.02h,Break Even,$0.25,$613.00,$103466.75,159,$613.00
Final P&L Day: 613.00,,,,,,,,,,,
2024-08-13,13:17:00,18800.0,SELL,1,0.02h,Break Even,$0.25,$0.25,$103467.00,160,$0.25
2024-08-13,13:19:00,18813.5,BUY,1,0.02h,Stop Loss,$-6.00,$-5.75,$103461.00,160,$-5.75
2024-08-13,14:19:00,18878.0,SELL,1,0.02h,Break Even,$0.25,$-5.50,$103461.25,160,$-5.50
2024-08-13,14:27:00,18902.75,BUY,1,0.02h,Stop Loss,$25.25,$19.75,$103486.50,160,$19.75
2024-08-13,14:32:00,18873.5,SELL,1,0.02h,Stop Loss,$11.50,$31.25,$103498.00,160,$31.25
2024-08-13,14:38:00,18903.0,BUY,1,0.02h,Stop Loss,$-6.00,$25.25,$103492.00,160,$25.25
2024-08-13,17:27:00,19067.0,SELL,1,0.02h,Stop Loss,$37.75,$63.00,$103529.75,160,$63.00
2024-08-13,17:32:00,19078.5,BUY,1,0.02h,Stop Loss,$12.75,$75.75,$103542.50,160,$75.75
2024-08-13,17:34:00,19065.5,SELL,1,0.02h,Stop Loss,$42.75,$118.50,$103585.25,160,$118.50
2024-08-13,17:44:00,19079.0,BUY,1,0.02h,Break Even,$0.25,$118.75,$103585.50,160,$118.75
2024-08-13,17:47:00,19015.75,SELL,1,0.02h,Stop Loss,$10.25,$129.00,$103595.75,160,$129.00
2024-08-13,18:06:00,19059.0,BUY,1,0.02h,Stop Loss,$21.50,$150.50,$103617.25,160,$150.50
2024-08-13,18:19:00,19045.0,SELL,1,0.02h,Break Even,$0.25,$150.75,$103617.50,160,$150.75
2024-08-13,18:24:00,19063.0,BUY,1,0.02h,Stop Loss,$20.25,$171.00,$103637.75,160,$171.00
2024-08-13,19:06:00,19052.5,SELL,1,0.02h,Break Even,$0.25,$171.25,$103638.00,160,$171.25
2024-08-13,19:31:00,19063.5,BUY,1,0.02h,Stop Loss,$21.50,$192.75,$103659.50,160,$192.75
2024-08-13,20:30:00,19097.25,SELL,1,0.02h,Stop Loss,$34.00,$226.75,$103693.50,160,$226.75
2024-08-13,20:59:00,19096.5,BUY,1,0.02h,Stop Loss,$7.75,$234.50,$103701.25,160,$234.50
2024-08-13,22:20:00,19099.25,SELL,1,0.02h,Stop Loss,$26.50,$261.00,$103727.75,160,$261.00
2024-08-13,22:54:00,19099.0,BUY,1,0.02h,Stop Loss,$-6.00,$255.00,$103721.75,160,$255.00
2024-08-13,22:55:00,19097.0,SELL,1,0.02h,Stop Loss,$-6.00,$249.00,$103715.75,160,$249.00
2024-08-13,22:57:00,19098.75,BUY,1,0.02h,Stop Loss,$-6.00,$243.00,$103709.75,160,$243.00
2024-08-13,22:58:00,19097.75,SELL,1,0.02h,Stop Loss,$-6.00,$237.00,$103703.75,160,$237.00
2024-08-13,23:00:00,19099.0,BUY,1,13.00h,Stop Loss,$65.25,$302.25,$103769.00,160,$302.25
Final P&L Day: 302.25,,,,,,,,,,,
2024-08-14,12:13:00,19099.75,SELL,1,0.02h,Stop Loss,$4.00,$4.00,$103773.00,161,$4.00
2024-08-14,12:28:00,19104.75,BUY,1,0.02h,Stop Loss,$41.50,$45.50,$103814.50,161,$45.50
2024-08-14,12:33:00,19063.5,SELL,1,0.02h,Stop Loss,$44.00,$89.50,$103858.50,161,$89.50
2024-08-14,12:40:00,19122.5,BUY,1,0.02h,Stop Loss,$-6.00,$83.50,$103852.50,161,$83.50
2024-08-14,13:21:00,19133.75,SELL,1,0.02h,Break Even,$0.25,$83.75,$103852.75,161,$83.75
2024-08-14,13:22:00,19138.75,BUY,1,0.02h,Break Even,$0.25,$84.00,$103853.00,161,$84.00
2024-08-14,13:29:00,19126.25,SELL,1,0.02h,Break Even,$0.25,$84.25,$103853.25,161,$84.25
2024-08-14,13:31:00,19162.5,BUY,1,0.02h,Stop Loss,$46.50,$130.75,$103899.75,161,$130.75
2024-08-14,13:35:00,19108.25,SELL,1,0.02h,Stop Loss,$110.25,$241.00,$104010.00,161,$241.00
2024-08-14,14:44:00,18995.75,BUY,1,0.02h,Stop Loss,$9.00,$250.00,$104019.00,161,$250.00
2024-08-14,16:15:00,19162.0,SELL,1,0.02h,Stop Loss,$72.75,$322.75,$104091.75,161,$322.75
2024-08-14,17:02:00,19068.75,BUY,1,0.02h,Stop Loss,$26.50,$349.25,$104118.25,161,$349.25
2024-08-14,17:28:00,19064.75,SELL,1,0.02h,Stop Loss,$-6.00,$343.25,$104112.25,161,$343.25
2024-08-14,17:30:00,19084.5,BUY,1,0.02h,Stop Loss,$11.50,$354.75,$104123.75,161,$354.75
2024-08-14,17:40:00,19071.0,SELL,1,0.02h,Break Even,$0.25,$355.00,$104124.00,161,$355.00
2024-08-14,17:50:00,19084.25,BUY,1,0.02h,Stop Loss,$7.75,$362.75,$104131.75,161,$362.75
2024-08-14,17:52:00,19073.25,SELL,1,0.02h,Stop Loss,$-6.00,$356.75,$104125.75,161,$356.75
2024-08-14,17:54:00,19086.75,BUY,1,0.02h,Break Even,$0.25,$357.00,$104126.00,161,$357.00
2024-08-14,18:01:00,19051.75,SELL,1,0.02h,Break Even,$0.25,$357.25,$104126.25,161,$357.25
2024-08-14,18:21:00,19082.25,BUY,1,0.02h,Stop Loss,$15.25,$372.50,$104141.50,161,$372.50
2024-08-14,18:47:00,19078.5,SELL,1,0.02h,Stop Loss,$16.50,$389.00,$104158.00,161,$389.00
2024-08-14,18:53:00,19091.5,BUY,1,0.02h,Stop Loss,$6.50,$395.50,$104164.50,161,$395.50
2024-08-14,19:11:00,19076.5,SELL,1,0.02h,Break Even,$0.25,$395.75,$104164.75,161,$395.75
2024-08-14,19:42:00,19071.5,BUY,1,0.02h,Stop Loss,$10.25,$406.00,$104175.00,161,$406.00
2024-08-14,20:36:00,19143.75,SELL,1,0.02h,Stop Loss,$-6.00,$400.00,$104169.00,161,$400.00
2024-08-14,20:48:00,19148.25,BUY,1,0.02h,Stop Loss,$-6.00,$394.00,$104163.00,161,$394.00
2024-08-14,20:53:00,19144.75,SELL,1,0.02h,Break Even,$0.25,$394.25,$104163.25,161,$394.25
2024-08-14,22:54:00,19133.0,BUY,1,0.02h,Stop Loss,$-6.00,$388.25,$104157.25,161,$388.25
2024-08-14,22:56:00,19126.75,SELL,1,0.03h,Stop Loss,$-6.00,$382.25,$104151.25,161,$382.25
Final P&L Day: 382.25,,,,,,,,,,,
2024-08-15,12:00:00,19163.0,BUY,1,0.02h,Stop Loss,$5.25,$5.25,$104156.50,162,$5.25
2024-08-15,13:18:00,19322.25,SELL,1,0.02h,Stop Loss,$10.25,$15.50,$104166.75,162,$15.50
2024-08-15,13:25:00,19335.75,BUY,1,0.02h,Stop Loss,$4.00,$19.50,$104170.75,162,$19.50
2024-08-15,14:57:00,19472.25,SELL,1,0.02h,Stop Loss,$7.75,$27.25,$104178.50,162,$27.25
2024-08-15,15:05:00,19494.25,BUY,1,0.02h,Stop Loss,$11.50,$38.75,$104190.00,162,$38.75
2024-08-15,15:36:00,19505.5,SELL,1,0.02h,Break Even,$0.25,$39.00,$104190.25,162,$39.00
2024-08-15,15:37:00,19515.0,BUY,1,0.02h,Stop Loss,$9.00,$48.00,$104199.25,162,$48.00
2024-08-15,16:41:00,19547.0,SELL,1,0.02h,Stop Loss,$75.25,$123.25,$104274.50,162,$123.25
2024-08-15,17:16:00,19539.25,BUY,1,0.02h,Stop Loss,$14.00,$137.25,$104288.50,162,$137.25
2024-08-15,18:17:00,19569.0,SELL,1,0.02h,Stop Loss,$-6.00,$131.25,$104282.50,162,$131.25
2024-08-15,18:22:00,19586.0,BUY,1,0.02h,Stop Loss,$-6.00,$125.25,$104276.50,162,$125.25
2024-08-15,18:33:00,19578.5,SELL,1,0.02h,Break Even,$0.25,$125.50,$104276.75,162,$125.50
2024-08-15,18:34:00,19583.0,BUY,1,0.02h,Break Even,$0.25,$125.75,$104277.00,162,$125.75
2024-08-15,18:40:00,19580.0,SELL,1,0.02h,Stop Loss,$6.50,$132.25,$104283.50,162,$132.25
2024-08-15,18:49:00,19582.75,BUY,1,0.02h,Break Even,$0.25,$132.50,$104283.75,162,$132.50
2024-08-15,18:51:00,19573.5,SELL,1,0.02h,Stop Loss,$19.00,$151.50,$104302.75,162,$151.50
2024-08-15,18:58:00,19584.5,BUY,1,0.02h,Stop Loss,$-6.00,$145.50,$104296.75,162,$145.50
2024-08-15,19:01:00,19566.75,SELL,1,0.02h,Break Even,$0.25,$145.75,$104297.00,162,$145.75
2024-08-15,19:07:00,19585.5,BUY,1,0.02h,Break Even,$0.25,$146.00,$104297.25,162,$146.00
2024-08-15,19:13:00,19571.5,SELL,1,0.02h,Break Even,$0.25,$146.25,$104297.50,162,$146.25
2024-08-15,19:20:00,19584.0,BUY,1,0.02h,Stop Loss,$-6.00,$140.25,$104291.50,162,$140.25
2024-08-15,19:49:00,19586.0,SELL,1,0.02h,Stop Loss,$50.25,$190.50,$104341.75,162,$190.50
2024-08-15,20:03:00,19579.5,BUY,1,0.02h,Break Even,$0.25,$190.75,$104342.00,162,$190.75
2024-08-15,20:04:00,19573.25,SELL,1,0.02h,Stop Loss,$24.00,$214.75,$104366.00,162,$214.75
2024-08-15,20:10:00,19583.0,BUY,1,0.02h,Break Even,$0.25,$215.00,$104366.25,162,$215.00
2024-08-15,20:15:00,19566.0,SELL,1,0.02h,Stop Loss,$-6.00,$209.00,$104360.25,162,$209.00
2024-08-15,20:29:00,19583.25,BUY,1,0.02h,Stop Loss,$10.25,$219.25,$104370.50,162,$219.25
2024-08-15,20:50:00,19577.5,SELL,1,0.02h,Break Even,$0.25,$219.50,$104370.75,162,$219.50
2024-08-15,22:13:00,19579.75,BUY,1,0.02h,Stop Loss,$-6.00,$213.50,$104364.75,162,$213.50
Final P&L Day: 213.50,,,,,,,,,,,
2024-08-16,12:00:00,19553.25,SELL,1,0.02h,Stop Loss,$-6.00,$-6.00,$104358.75,163,$-6.00
2024-08-16,13:01:00,19479.25,BUY,1,0.02h,Break Even,$0.25,$-5.75,$104359.00,163,$-5.75
2024-08-16,13:31:00,19466.0,SELL,1,0.02h,Break Even,$0.25,$-5.50,$104359.25,163,$-5.50
2024-08-16,13:33:00,19503.25,BUY,1,0.02h,Stop Loss,$41.50,$36.00,$104400.75,163,$36.00
2024-08-16,13:47:00,19486.5,SELL,1,0.02h,Stop Loss,$9.00,$45.00,$104409.75,163,$45.00
2024-08-16,13:51:00,19521.25,BUY,1,0.02h,Stop Loss,$34.00,$79.00,$104443.75,163,$79.00
2024-08-16,14:00:00,19495.75,SELL,1,0.02h,Stop Loss,$12.75,$91.75,$104456.50,163,$91.75
2024-08-16,14:01:00,19525.5,BUY,1,0.02h,Stop Loss,$7.75,$99.50,$104464.25,163,$99.50
2024-08-16,14:41:00,19553.5,SELL,1,0.02h,Stop Loss,$44.00,$143.50,$104508.25,163,$143.50
2024-08-16,15:29:00,19532.0,BUY,1,0.02h,Break Even,$0.25,$143.75,$104508.50,163,$143.75
2024-08-16,17:16:00,19627.0,SELL,1,0.02h,Break Even,$0.25,$144.00,$104508.75,163,$144.00
2024-08-16,17:21:00,19636.5,BUY,1,0.02h,Break Even,$0.25,$144.25,$104509.00,163,$144.25
2024-08-16,17:22:00,19633.5,SELL,1,0.02h,Stop Loss,$-6.00,$138.25,$104503.00,163,$138.25
2024-08-16,17:23:00,19637.25,BUY,1,0.02h,Stop Loss,$12.75,$151.00,$104515.75,163,$151.00
2024-08-16,17:42:00,19629.75,SELL,1,0.02h,Stop Loss,$-6.00,$145.00,$104509.75,163,$145.00
2024-08-16,17:44:00,19640.25,BUY,1,0.02h,Stop Loss,$19.00,$164.00,$104528.75,163,$164.00
2024-08-16,17:48:00,19630.0,SELL,1,0.02h,Stop Loss,$-6.00,$158.00,$104522.75,163,$158.00
2024-08-16,18:30:00,19615.5,BUY,1,0.02h,Stop Loss,$4.00,$162.00,$104526.75,163,$162.00
2024-08-16,18:44:00,19603.0,SELL,1,0.02h,Stop Loss,$11.50,$173.50,$104538.25,163,$173.50
2024-08-16,18:55:00,19616.0,BUY,1,0.02h,Break Even,$0.25,$173.75,$104538.50,163,$173.75
2024-08-16,19:11:00,19606.5,SELL,1,0.02h,Break Even,$0.25,$174.00,$104538.75,163,$174.00
2024-08-16,19:35:00,19611.75,BUY,1,0.02h,Break Even,$0.25,$174.25,$104539.00,163,$174.25
2024-08-16,19:40:00,19603.25,SELL,1,0.02h,Break Even,$0.25,$174.50,$104539.25,163,$174.50
2024-08-16,19:57:00,19608.75,BUY,1,0.02h,Stop Loss,$4.00,$178.50,$104543.25,163,$178.50
2024-08-16,20:32:00,19606.25,SELL,1,0.02h,Stop Loss,$5.25,$183.75,$104548.50,163,$183.75
2024-08-16,20:53:00,19610.5,BUY,1,0.02h,Break Even,$0.25,$184.00,$104548.75,163,$184.00
2024-08-16,21:00:00,19604.5,SELL,1,63.00h,Stop Loss,$-6.00,$178.00,$104542.75,163,$178.00
Final P&L Day: 178.00,,,,,,,,,,,
2024-08-19,12:04:00,19618.0,BUY,1,0.02h,Break Even,$0.25,$0.25,$104543.00,164,$0.25
2024-08-19,12:37:00,19621.25,SELL,1,0.02h,Stop Loss,$-6.00,$-5.75,$104537.00,164,$-5.75
2024-08-19,12:48:00,19628.75,BUY,1,0.02h,Stop Loss,$-6.00,$-11.75,$104531.00,164,$-11.75
2024-08-19,12:53:00,19618.5,SELL,1,0.02h,Stop Loss,$-6.00,$-17.75,$104525.00,164,$-17.75
2024-08-19,13:06:00,19630.5,BUY,1,0.02h,Break Even,$0.25,$-17.50,$104525.25,164,$-17.50
2024-08-19,13:23:00,19623.0,SELL,1,0.02h,Break Even,$0.25,$-17.25,$104525.50,164,$-17.25
2024-08-19,13:48:00,19613.5,BUY,1,0.02h,Stop Loss,$35.25,$18.00,$104560.75,164,$18.00
2024-08-19,13:55:00,19583.25,SELL,1,0.02h,Stop Loss,$24.00,$42.00,$104584.75,164,$42.00
2024-08-19,14:09:00,19619.0,BUY,1,0.02h,Stop Loss,$-6.00,$36.00,$104578.75,164,$36.00
2024-08-19,14:18:00,19549.25,SELL,1,0.02h,Stop Loss,$-6.00,$30.00,$104572.75,164,$30.00
2024-08-19,14:28:00,19610.25,BUY,1,0.02h,Stop Loss,$12.75,$42.75,$104585.50,164,$42.75
2024-08-19,15:19:00,19643.0,SELL,1,0.02h,Break Even,$0.25,$43.00,$104585.75,164,$43.00
2024-08-19,15:25:00,19662.5,BUY,1,0.02h,Stop Loss,$-6.00,$37.00,$104579.75,164,$37.00
2024-08-19,15:42:00,19655.0,SELL,1,0.02h,Break Even,$0.25,$37.25,$104580.00,164,$37.25
2024-08-19,15:45:00,19659.5,BUY,1,0.02h,Stop Loss,$19.00,$56.25,$104599.00,164,$56.25
2024-08-19,15:58:00,19644.75,SELL,1,0.02h,Stop Loss,$111.50,$167.75,$104710.50,164,$167.75
2024-08-19,16:17:00,19655.0,BUY,1,0.02h,Stop Loss,$15.25,$183.00,$104725.75,164,$183.00
2024-08-19,16:36:00,19649.0,SELL,1,0.02h,Stop Loss,$-6.00,$177.00,$104719.75,164,$177.00
2024-08-19,16:39:00,19660.75,BUY,1,0.02h,Break Even,$0.25,$177.25,$104720.00,164,$177.25
2024-08-19,17:15:00,19681.75,SELL,1,0.02h,Stop Loss,$21.50,$198.75,$104741.50,164,$198.75
2024-08-19,17:22:00,19690.5,BUY,1,0.02h,Stop Loss,$-6.00,$192.75,$104735.50,164,$192.75
2024-08-19,19:03:00,19761.75,SELL,1,0.02h,Stop Loss,$-6.00,$186.75,$104729.50,164,$186.75
2024-08-19,19:16:00,19767.75,BUY,1,0.02h,Stop Loss,$6.50,$193.25,$104736.00,164,$193.25
2024-08-19,19:47:00,19768.5,SELL,1,0.02h,Stop Loss,$-6.00,$187.25,$104730.00,164,$187.25
2024-08-19,19:52:00,19792.5,BUY,1,0.02h,Stop Loss,$41.50,$228.75,$104771.50,164,$228.75
2024-08-19,20:48:00,19860.25,SELL,1,0.02h,Stop Loss,$-6.00,$222.75,$104765.50,164,$222.75
2024-08-19,22:02:00,19868.25,BUY,1,0.02h,Stop Loss,$-6.00,$216.75,$104759.50,164,$216.75
2024-08-19,22:48:00,19864.75,SELL,1,0.02h,Stop Loss,$-6.00,$210.75,$104753.50,164,$210.75
Final P&L Day: 210.75,,,,,,,,,,,
2024-08-20,12:01:00,19878.25,BUY,1,0.02h,Stop Loss,$-6.00,$-6.00,$104747.50,165,$-6.00
2024-08-20,12:09:00,19869.0,SELL,1,0.02h,Stop Loss,$-6.00,$-12.00,$104741.50,165,$-12.00
2024-08-20,12:10:00,19877.0,BUY,1,0.02h,Break Even,$0.25,$-11.75,$104741.75,165,$-11.75
2024-08-20,12:23:00,19867.25,SELL,1,0.02h,Stop Loss,$-6.00,$-17.75,$104735.75,165,$-17.75
2024-08-20,13:32:00,19839.75,BUY,1,0.02h,Stop Loss,$26.50,$8.75,$104762.25,165,$8.75
2024-08-20,14:12:00,19862.5,SELL,1,0.02h,Stop Loss,$165.25,$174.00,$104927.50,165,$174.00
2024-08-20,14:54:00,19808.5,BUY,1,0.02h,Break Even,$0.25,$174.25,$104927.75,165,$174.25
2024-08-20,14:58:00,19783.25,SELL,1,0.02h,Break Even,$0.25,$174.50,$104928.00,165,$174.50
2024-08-20,15:14:00,19800.75,BUY,1,0.02h,Break Even,$0.25,$174.75,$104928.25,165,$174.75
2024-08-20,15:31:00,19797.0,SELL,1,0.02h,Break Even,$0.25,$175.00,$104928.50,165,$175.00
2024-08-20,15:32:00,19807.25,BUY,1,0.02h,Stop Loss,$9.00,$184.00,$104937.50,165,$184.00
2024-08-20,15:45:00,19795.0,SELL,1,0.02h,Stop Loss,$56.50,$240.50,$104994.00,165,$240.50
2024-08-20,15:54:00,19820.5,BUY,1,0.02h,Stop Loss,$10.25,$250.75,$105004.25,165,$250.75
2024-08-20,16:17:00,19820.25,SELL,1,0.02h,Stop Loss,$32.75,$283.50,$105037.00,165,$283.50
2024-08-20,16:51:00,19813.5,BUY,1,0.02h,Break Even,$0.25,$283.75,$105037.25,165,$283.75
2024-08-20,16:52:00,19807.0,SELL,1,0.02h,Stop Loss,$11.50,$295.25,$105048.75,165,$295.25
2024-08-20,17:28:00,19792.25,BUY,1,0.02h,Stop Loss,$-6.00,$289.25,$105042.75,165,$289.25
2024-08-20,18:50:00,19849.75,SELL,1,0.02h,Break Even,$0.25,$289.50,$105043.00,165,$289.50
2024-08-20,19:05:00,19853.0,BUY,1,0.02h,Stop Loss,$6.50,$296.00,$105049.50,165,$296.00
2024-08-20,19:09:00,19839.75,SELL,1,0.02h,Break Even,$0.25,$296.25,$105049.75,165,$296.25
2024-08-20,19:49:00,19837.5,BUY,1,0.02h,Stop Loss,$21.50,$317.75,$105071.25,165,$317.75
2024-08-20,19:55:00,19826.75,SELL,1,0.02h,Stop Loss,$41.50,$359.25,$105112.75,165,$359.25
2024-08-20,20:15:00,19831.5,BUY,1,0.02h,Stop Loss,$-6.00,$353.25,$105106.75,165,$353.25
2024-08-20,20:24:00,19818.75,SELL,1,0.02h,Stop Loss,$-6.00,$347.25,$105100.75,165,$347.25
2024-08-20,22:26:00,19803.25,BUY,1,0.02h,Break Even,$0.25,$347.50,$105101.00,165,$347.50
2024-08-20,22:29:00,19799.0,SELL,1,0.02h,Stop Loss,$-6.00,$341.50,$105095.00,165,$341.50
2024-08-20,22:32:00,19803.5,BUY,1,0.02h,Break Even,$0.25,$341.75,$105095.25,165,$341.75
2024-08-20,22:47:00,19800.5,SELL,1,0.02h,Stop Loss,$-6.00,$335.75,$105089.25,165,$335.75
Final P&L Day: 335.75,,,,,,,,,,,
2024-08-21,12:00:00,19832.25,BUY,1,0.02h,Break Even,$0.25,$0.25,$105089.50,166,$0.25
2024-08-21,12:51:00,19845.25,SELL,1,0.02h,Break Even,$0.25,$0.50,$105089.75,166,$0.50
2024-08-21,13:06:00,19853.0,BUY,1,0.02h,Stop Loss,$-6.00,$-5.50,$105083.75,166,$-5.50
2024-08-21,13:21:00,19843.75,SELL,1,0.02h,Break Even,$0.25,$-5.25,$105084.00,166,$-5.25
2024-08-21,13:25:00,19854.5,BUY,1,0.02h,Stop Loss,$-6.00,$-11.25,$105078.00,166,$-11.25
2024-08-21,13:29:00,19844.0,SELL,1,0.02h,Stop Loss,$9.00,$-2.25,$105087.00,166,$-2.25
2024-08-21,13:42:00,19855.5,BUY,1,0.02h,Break Even,$0.25,$-2.00,$105087.25,166,$-2.00
2024-08-21,14:17:00,19869.0,SELL,1,0.02h,Stop Loss,$26.50,$24.50,$105113.75,166,$24.50
2024-08-21,14:20:00,19898.25,BUY,1,0.02h,Stop Loss,$26.50,$51.00,$105140.25,166,$51.00
2024-08-21,14:28:00,19881.75,SELL,1,0.02h,Break Even,$0.25,$51.25,$105140.50,166,$51.25
2024-08-21,14:37:00,19935.5,BUY,1,0.02h,Stop Loss,$26.50,$77.75,$105167.00,166,$77.75
2024-08-21,14:52:00,19859.75,SELL,1,0.02h,Stop Loss,$250.25,$328.00,$105417.25,166,$328.00
2024-08-21,15:13:00,19879.75,BUY,1,0.02h,Stop Loss,$42.75,$370.75,$105460.00,166,$370.75
2024-08-21,15:27:00,19864.0,SELL,1,0.02h,Break Even,$0.25,$371.00,$105460.25,166,$371.00
2024-08-21,16:19:00,19818.25,BUY,1,0.02h,Stop Loss,$57.75,$428.75,$105518.00,166,$428.75
2024-08-21,17:19:00,19858.5,SELL,1,0.02h,Stop Loss,$-6.00,$422.75,$105512.00,166,$422.75
2024-08-21,17:32:00,19868.25,BUY,1,0.02h,Break Even,$0.25,$423.00,$105512.25,166,$423.00
2024-08-21,18:40:00,19904.25,SELL,1,0.02h,Stop Loss,$25.25,$448.25,$105537.50,166,$448.25
2024-08-21,18:55:00,19915.0,BUY,1,0.02h,Break Even,$0.25,$448.50,$105537.75,166,$448.50
2024-08-21,19:01:00,19898.25,SELL,1,0.02h,Stop Loss,$29.00,$477.50,$105566.75,166,$477.50
2024-08-21,19:34:00,19875.0,BUY,1,0.02h,Stop Loss,$-6.00,$471.50,$105560.75,166,$471.50
2024-08-21,19:39:00,19865.0,SELL,1,0.02h,Stop Loss,$-6.00,$465.50,$105554.75,166,$465.50
2024-08-21,19:40:00,19875.25,BUY,1,0.02h,Break Even,$0.25,$465.75,$105555.00,166,$465.75
2024-08-21,19:44:00,19859.75,SELL,1,0.02h,Stop Loss,$-6.00,$459.75,$105549.00,166,$459.75
2024-08-21,19:49:00,19879.0,BUY,1,0.02h,Stop Loss,$20.25,$480.00,$105569.25,166,$480.00
2024-08-21,20:48:00,19912.75,SELL,1,0.02h,Stop Loss,$-6.00,$474.00,$105563.25,166,$474.00
2024-08-21,20:52:00,19918.75,BUY,1,0.02h,Stop Loss,$-6.00,$468.00,$105557.25,166,$468.00
2024-08-21,22:06:00,19913.75,SELL,1,0.02h,Stop Loss,$-6.00,$462.00,$105551.25,166,$462.00
2024-08-21,22:07:00,19922.5,BUY,1,0.02h,Stop Loss,$6.50,$468.50,$105557.75,166,$468.50
2024-08-21,23:00:00,19935.0,SELL,1,13.00h,Stop Loss,$-6.00,$462.50,$105551.75,166,$462.50
Final P&L Day: 462.50,,,,,,,,,,,
2024-08-22,12:00:00,19976.75,BUY,1,0.02h,Stop Loss,$4.00,$4.00,$105555.75,167,$4.00
2024-08-22,12:21:00,19964.25,SELL,1,0.02h,Stop Loss,$20.25,$24.25,$105576.00,167,$24.25
2024-08-22,12:31:00,19981.25,BUY,1,0.02h,Stop Loss,$11.50,$35.75,$105587.50,167,$35.75
2024-08-22,12:37:00,19963.5,SELL,1,0.02h,Stop Loss,$75.25,$111.00,$105662.75,167,$111.00
2024-08-22,12:45:00,19969.75,BUY,1,0.02h,Break Even,$0.25,$111.25,$105663.00,167,$111.25
2024-08-22,12:46:00,19959.75,SELL,1,0.02h,Stop Loss,$22.75,$134.00,$105685.75,167,$134.00
2024-08-22,12:52:00,19971.75,BUY,1,0.02h,Stop Loss,$6.50,$140.50,$105692.25,167,$140.50
2024-08-22,13:39:00,19981.25,SELL,1,0.02h,Stop Loss,$40.25,$180.75,$105732.50,167,$180.75
2024-08-22,13:57:00,20003.75,BUY,1,0.02h,Stop Loss,$10.25,$191.00,$105742.75,167,$191.00
2024-08-22,14:01:00,19973.75,SELL,1,0.02h,Stop Loss,$80.25,$271.25,$105823.00,167,$271.25
2024-08-22,15:03:00,19905.5,BUY,1,0.02h,Stop Loss,$9.00,$280.25,$105832.00,167,$280.25
2024-08-22,15:11:00,19869.0,SELL,1,0.02h,Stop Loss,$39.00,$319.25,$105871.00,167,$319.25
2024-08-22,16:06:00,19736.0,BUY,1,0.02h,Stop Loss,$7.75,$327.00,$105878.75,167,$327.00
2024-08-22,16:51:00,19775.25,SELL,1,0.02h,Stop Loss,$80.25,$407.25,$105959.00,167,$407.25
2024-08-22,17:28:00,19720.75,BUY,1,0.02h,Break Even,$0.25,$407.50,$105959.25,167,$407.50
2024-08-22,17:30:00,19709.25,SELL,1,0.02h,Stop Loss,$7.75,$415.25,$105967.00,167,$415.25
2024-08-22,18:16:00,19639.75,BUY,1,0.02h,Break Even,$0.25,$415.50,$105967.25,167,$415.50
2024-08-22,18:55:00,19629.25,SELL,1,0.02h,Stop Loss,$-6.00,$409.50,$105961.25,167,$409.50
2024-08-22,19:05:00,19660.75,BUY,1,0.02h,Break Even,$0.25,$409.75,$105961.50,167,$409.75
2024-08-22,19:11:00,19630.0,SELL,1,0.02h,Stop Loss,$-6.00,$403.75,$105955.50,167,$403.75
2024-08-22,20:03:00,19597.25,BUY,1,0.02h,Stop Loss,$16.50,$420.25,$105972.00,167,$420.25
2024-08-22,20:44:00,19609.5,SELL,1,0.02h,Break Even,$0.25,$420.50,$105972.25,167,$420.50
2024-08-22,20:45:00,19613.5,BUY,1,0.02h,Stop Loss,$14.00,$434.50,$105986.25,167,$434.50
2024-08-22,22:23:00,19619.0,SELL,1,0.02h,Stop Loss,$-6.00,$428.50,$105980.25,167,$428.50
2024-08-22,22:24:00,19622.25,BUY,1,0.02h,Break Even,$0.25,$428.75,$105980.50,167,$428.75
Final P&L Day: 428.75,,,,,,,,,,,
2024-08-23,13:27:00,19761.5,SELL,1,0.02h,Stop Loss,$10.25,$10.25,$105990.75,168,$10.25
2024-08-23,13:50:00,19749.5,BUY,1,0.02h,Stop Loss,$19.00,$29.25,$106009.75,168,$29.25
2024-08-23,14:38:00,19830.25,SELL,1,0.02h,Stop Loss,$110.25,$139.50,$106120.00,168,$139.50
2024-08-23,15:16:00,19780.25,BUY,1,0.02h,Break Even,$0.25,$139.75,$106120.25,168,$139.75
2024-08-23,15:46:00,19718.0,SELL,1,0.02h,Stop Loss,$30.25,$170.00,$106150.50,168,$170.00
2024-08-23,16:36:00,19690.75,BUY,1,0.02h,Stop Loss,$30.25,$200.25,$106180.75,168,$200.25
2024-08-23,16:43:00,19608.25,SELL,1,0.02h,Stop Loss,$6.50,$206.75,$106187.25,168,$206.75
2024-08-23,16:56:00,19689.75,BUY,1,0.02h,Stop Loss,$34.00,$240.75,$106221.25,168,$240.75
2024-08-23,18:00:00,19732.75,SELL,1,0.02h,Stop Loss,$35.25,$276.00,$106256.50,168,$276.00
2024-08-23,18:05:00,19748.75,BUY,1,0.02h,Break Even,$0.25,$276.25,$106256.75,168,$276.25
2024-08-23,18:33:00,19742.25,SELL,1,0.02h,Break Even,$0.25,$276.50,$106257.00,168,$276.50
2024-08-23,18:41:00,19753.75,BUY,1,0.02h,Stop Loss,$36.50,$313.00,$106293.50,168,$313.00
2024-08-23,18:58:00,19742.5,SELL,1,0.02h,Stop Loss,$84.00,$397.00,$106377.50,168,$397.00
2024-08-23,19:13:00,19755.25,BUY,1,0.02h,Stop Loss,$139.00,$536.00,$106516.50,168,$536.00
2024-08-23,19:39:00,19770.25,SELL,1,0.02h,Stop Loss,$46.50,$582.50,$106563.00,168,$582.50
2024-08-23,19:54:00,19781.75,BUY,1,0.02h,Stop Loss,$107.75,$690.25,$106670.75,168,$690.25
2024-08-23,20:34:00,19786.75,SELL,1,0.02h,Break Even,$0.25,$690.50,$106671.00,168,$690.50
Final P&L Day: 690.50,,,,,,,,,,,
2024-08-26,12:12:00,19784.5,BUY,1,0.02h,Break Even,$0.25,$0.25,$106671.25,169,$0.25
2024-08-26,12:28:00,19776.5,SELL,1,0.02h,Stop Loss,$-6.00,$-5.75,$106665.25,169,$-5.75
2024-08-26,12:55:00,19773.0,BUY,1,0.02h,Break Even,$0.25,$-5.50,$106665.50,169,$-5.50
2024-08-26,13:05:00,19760.25,SELL,1,0.02h,Stop Loss,$-6.00,$-11.50,$106659.50,169,$-11.50
2024-08-26,13:09:00,19774.0,BUY,1,0.02h,Stop Loss,$-6.00,$-17.50,$106653.50,169,$-17.50
2024-08-26,13:31:00,19768.25,SELL,1,0.02h,Stop Loss,$111.50,$94.00,$106765.00,169,$94.00
2024-08-26,13:34:00,19793.75,BUY,1,0.02h,Stop Loss,$22.75,$116.75,$106787.75,169,$116.75
2024-08-26,13:43:00,19760.25,SELL,1,0.02h,Stop Loss,$52.75,$169.50,$106840.50,169,$169.50
2024-08-26,14:57:00,19576.75,BUY,1,0.02h,Stop Loss,$36.50,$206.00,$106877.00,169,$206.00
2024-08-26,15:33:00,19595.25,SELL,1,0.02h,Stop Loss,$-6.00,$200.00,$106871.00,169,$200.00
2024-08-26,15:43:00,19611.0,BUY,1,0.02h,Stop Loss,$35.25,$235.25,$106906.25,169,$235.25
2024-08-26,15:46:00,19588.5,SELL,1,0.02h,Stop Loss,$6.50,$241.75,$106912.75,169,$241.75
2024-08-26,16:18:00,19579.0,BUY,1,0.02h,Break Even,$0.25,$242.00,$106913.00,169,$242.00
2024-08-26,16:57:00,19619.5,SELL,1,0.02h,Break Even,$0.25,$242.25,$106913.25,169,$242.25
2024-08-26,17:26:00,19618.25,BUY,1,0.02h,Stop Loss,$-6.00,$236.25,$106907.25,169,$236.25
2024-08-26,17:30:00,19595.25,SELL,1,0.02h,Break Even,$0.25,$236.50,$106907.50,169,$236.50
2024-08-26,18:17:00,19541.25,BUY,1,0.02h,Break Even,$0.25,$236.75,$106907.75,169,$236.75
2024-08-26,19:09:00,19597.25,SELL,1,0.02h,Break Even,$0.25,$237.00,$106908.00,169,$237.00
2024-08-26,19:55:00,19586.5,BUY,1,0.02h,Break Even,$0.25,$237.25,$106908.25,169,$237.25
2024-08-26,19:57:00,19571.0,SELL,1,0.02h,Stop Loss,$56.50,$293.75,$106964.75,169,$293.75
2024-08-26,20:00:00,19593.5,BUY,1,0.02h,Stop Loss,$4.00,$297.75,$106968.75,169,$297.75
2024-08-26,20:06:00,19575.25,SELL,1,0.02h,Break Even,$0.25,$298.00,$106969.00,169,$298.00
2024-08-26,20:55:00,19566.5,BUY,1,0.02h,Break Even,$0.25,$298.25,$106969.25,169,$298.25
2024-08-26,21:00:00,19549.75,SELL,1,1.02h,Stop Loss,$-6.00,$292.25,$106963.25,169,$292.25
2024-08-26,22:01:00,19565.75,BUY,1,0.02h,Stop Loss,$11.50,$303.75,$106974.75,169,$303.75
2024-08-26,22:10:00,19535.75,SELL,1,0.02h,Break Even,$0.25,$304.00,$106975.00,169,$304.00
2024-08-26,22:58:00,19535.75,BUY,1,0.03h,Break Even,$0.25,$304.25,$106975.25,169,$304.25
Final P&L Day: 304.25,,,,,,,,,,,
2024-08-27,12:21:00,19554.5,SELL,1,0.02h,Stop Loss,$4.00,$4.00,$106979.25,170,$4.00
2024-08-27,13:24:00,19516.0,BUY,1,0.02h,Stop Loss,$4.00,$8.00,$106983.25,170,$8.00
2024-08-27,13:38:00,19488.25,SELL,1,0.02h,Stop Loss,$84.00,$92.00,$107067.25,170,$92.00
2024-08-27,13:52:00,19509.75,BUY,1,0.02h,Stop Loss,$106.50,$198.50,$107173.75,170,$198.50
2024-08-27,15:20:00,19656.0,SELL,1,0.02h,Stop Loss,$20.25,$218.75,$107194.00,170,$218.75
2024-08-27,16:03:00,19614.5,BUY,1,0.02h,Stop Loss,$4.00,$222.75,$107198.00,170,$222.75
2024-08-27,16:32:00,19618.0,SELL,1,0.02h,Stop Loss,$-6.00,$216.75,$107192.00,170,$216.75
2024-08-27,16:33:00,19635.75,BUY,1,0.02h,Stop Loss,$30.25,$247.00,$107222.25,170,$247.00
2024-08-27,16:42:00,19610.5,SELL,1,0.02h,Stop Loss,$121.50,$368.50,$107343.75,170,$368.50
2024-08-27,16:51:00,19638.5,BUY,1,0.02h,Stop Loss,$27.75,$396.25,$107371.50,170,$396.25
2024-08-27,17:05:00,19622.25,SELL,1,0.02h,Stop Loss,$10.25,$406.50,$107381.75,170,$406.50
2024-08-27,17:06:00,19631.5,BUY,1,0.02h,Break Even,$0.25,$406.75,$107382.00,170,$406.75
2024-08-27,18:12:00,19670.75,SELL,1,0.02h,Stop Loss,$37.75,$444.50,$107419.75,170,$444.50
2024-08-27,18:46:00,19667.0,BUY,1,0.02h,Stop Loss,$-6.00,$438.50,$107413.75,170,$438.50
2024-08-27,18:50:00,19658.75,SELL,1,0.02h,Stop Loss,$77.75,$516.25,$107491.50,170,$516.25
2024-08-27,19:28:00,19656.5,BUY,1,0.02h,Stop Loss,$-6.00,$510.25,$107485.50,170,$510.25
2024-08-27,19:32:00,19640.25,SELL,1,0.02h,Stop Loss,$16.50,$526.75,$107502.00,170,$526.75
2024-08-27,19:40:00,19650.5,BUY,1,0.02h,Stop Loss,$17.75,$544.50,$107519.75,170,$544.50
2024-08-27,19:54:00,19636.75,SELL,1,0.02h,Break Even,$0.25,$544.75,$107520.00,170,$544.75
2024-08-27,20:04:00,19654.25,BUY,1,0.02h,Stop Loss,$17.75,$562.50,$107537.75,170,$562.50
2024-08-27,20:13:00,19646.0,SELL,1,0.02h,Stop Loss,$-6.00,$556.50,$107531.75,170,$556.50
2024-08-27,22:02:00,19644.25,BUY,1,0.02h,Break Even,$0.25,$556.75,$107532.00,170,$556.75
2024-08-27,22:11:00,19607.25,SELL,1,0.02h,Stop Loss,$14.00,$570.75,$107546.00,170,$570.75
2024-08-27,23:00:00,19595.75,BUY,1,13.00h,Stop Loss,$109.00,$679.75,$107655.00,170,$679.75
Final P&L Day: 679.75,,,,,,,,,,,
2024-08-28,13:07:00,19630.25,SELL,1,0.02h,Stop Loss,$51.50,$51.50,$107706.50,171,$51.50
2024-08-28,13:31:00,19653.75,BUY,1,0.02h,Break Even,$0.25,$51.75,$107706.75,171,$51.75
2024-08-28,13:38:00,19610.75,SELL,1,0.02h,Stop Loss,$27.75,$79.50,$107734.50,171,$79.50
2024-08-28,14:20:00,19568.5,BUY,1,0.02h,Stop Loss,$24.00,$103.50,$107758.50,171,$103.50
2024-08-28,14:38:00,19559.0,SELL,1,0.02h,Break Even,$0.25,$103.75,$107758.75,171,$103.75
2024-08-28,15:37:00,19400.75,BUY,1,0.02h,Stop Loss,$10.25,$114.00,$107769.00,171,$114.00
2024-08-28,16:16:00,19406.25,SELL,1,0.02h,Stop Loss,$84.00,$198.00,$107853.00,171,$198.00
2024-08-28,16:35:00,19417.0,BUY,1,0.02h,Stop Loss,$12.75,$210.75,$107865.75,171,$210.75
2024-08-28,17:15:00,19417.25,SELL,1,0.02h,Stop Loss,$12.75,$223.50,$107878.50,171,$223.50
2024-08-28,17:36:00,19436.5,BUY,1,0.02h,Stop Loss,$-6.00,$217.50,$107872.50,171,$217.50
2024-08-28,17:39:00,19430.0,SELL,1,0.02h,Stop Loss,$37.75,$255.25,$107910.25,171,$255.25
2024-08-28,18:24:00,19333.5,BUY,1,0.02h,Break Even,$0.25,$255.50,$107910.50,171,$255.50
2024-08-28,18:25:00,19326.0,SELL,1,0.02h,Stop Loss,$9.00,$264.50,$107919.50,171,$264.50
2024-08-28,18:34:00,19334.5,BUY,1,0.02h,Break Even,$0.25,$264.75,$107919.75,171,$264.75
2024-08-28,18:45:00,19324.75,SELL,1,0.02h,Break Even,$0.25,$265.00,$107920.00,171,$265.00
2024-08-28,18:51:00,19342.5,BUY,1,0.02h,Stop Loss,$76.50,$341.50,$107996.50,171,$341.50
2024-08-28,19:58:00,19432.5,SELL,1,0.02h,Stop Loss,$57.75,$399.25,$108054.25,171,$399.25
2024-08-28,20:20:00,19449.0,BUY,1,0.02h,Break Even,$0.25,$399.50,$108054.50,171,$399.50
2024-08-28,20:24:00,19347.25,SELL,1,0.02h,Stop Loss,$421.50,$821.00,$108476.00,171,$821.00
Final P&L Day: 821.00,,,,,,,,,,,
2024-08-29,12:00:00,19466.25,BUY,1,0.02h,Stop Loss,$10.25,$10.25,$108486.25,172,$10.25
2024-08-29,12:44:00,19451.75,SELL,1,0.02h,Stop Loss,$27.75,$38.00,$108514.00,172,$38.00
2024-08-29,12:49:00,19482.25,BUY,1,0.02h,Break Even,$0.25,$38.25,$108514.25,172,$38.25
2024-08-29,13:01:00,19464.75,SELL,1,0.02h,Stop Loss,$-6.00,$32.25,$108508.25,172,$32.25
2024-08-29,13:02:00,19473.75,BUY,1,0.02h,Stop Loss,$10.25,$42.50,$108518.50,172,$42.50
2024-08-29,13:27:00,19474.75,SELL,1,0.02h,Stop Loss,$17.75,$60.25,$108536.25,172,$60.25
2024-08-29,13:29:00,19493.5,BUY,1,0.02h,Stop Loss,$35.25,$95.50,$108571.50,172,$95.50
2024-08-29,14:16:00,19605.0,SELL,1,0.02h,Stop Loss,$89.00,$184.50,$108660.50,172,$184.50
2024-08-29,14:30:00,19599.25,BUY,1,0.02h,Stop Loss,$52.75,$237.25,$108713.25,172,$237.25
2024-08-29,15:06:00,19637.75,SELL,1,0.02h,Stop Loss,$66.50,$303.75,$108779.75,172,$303.75
2024-08-29,15:11:00,19663.75,BUY,1,0.02h,Stop Loss,$-6.00,$297.75,$108773.75,172,$297.75
2024-08-29,15:20:00,19637.25,SELL,1,0.02h,Stop Loss,$91.50,$389.25,$108865.25,172,$389.25
2024-08-29,15:40:00,19649.0,BUY,1,0.02h,Break Even,$0.25,$389.50,$108865.50,172,$389.50
2024-08-29,15:45:00,19622.75,SELL,1,0.02h,Break Even,$0.25,$389.75,$108865.75,172,$389.75
2024-08-29,16:01:00,19645.0,BUY,1,0.02h,Stop Loss,$19.00,$408.75,$108884.75,172,$408.75
2024-08-29,16:51:00,19657.5,SELL,1,0.02h,Break Even,$0.25,$409.00,$108885.00,172,$409.00
2024-08-29,17:37:00,19623.75,BUY,1,0.02h,Stop Loss,$-6.00,$403.00,$108879.00,172,$403.00
2024-08-29,17:38:00,19615.5,SELL,1,0.02h,Break Even,$0.25,$403.25,$108879.25,172,$403.25
2024-08-29,17:57:00,19627.0,BUY,1,0.02h,Break Even,$0.25,$403.50,$108879.50,172,$403.50
2024-08-29,18:02:00,19584.75,SELL,1,0.02h,Break Even,$0.25,$403.75,$108879.75,172,$403.75
2024-08-29,19:26:00,19401.25,BUY,1,0.02h,Stop Loss,$6.50,$410.25,$108886.25,172,$410.25
2024-08-29,19:51:00,19402.75,SELL,1,0.02h,Stop Loss,$66.50,$476.75,$108952.75,172,$476.75
2024-08-29,20:07:00,19420.5,BUY,1,0.02h,Stop Loss,$14.00,$490.75,$108966.75,172,$490.75
2024-08-29,20:50:00,19441.25,SELL,1,0.02h,Stop Loss,$-6.00,$484.75,$108960.75,172,$484.75
2024-08-29,20:55:00,19447.0,BUY,1,0.02h,Break Even,$0.25,$485.00,$108961.00,172,$485.00
2024-08-29,22:06:00,19437.25,SELL,1,0.02h,Stop Loss,$57.75,$542.75,$109018.75,172,$542.75
2024-08-29,22:32:00,19438.25,BUY,1,0.02h,Stop Loss,$-6.00,$536.75,$109012.75,172,$536.75
2024-08-29,22:37:00,19431.0,SELL,1,0.02h,Stop Loss,$-6.00,$530.75,$109006.75,172,$530.75
2024-08-29,22:45:00,19438.0,BUY,1,0.02h,Break Even,$0.25,$531.00,$109007.00,172,$531.00
2024-08-29,22:51:00,19430.75,SELL,1,0.02h,Break Even,$0.25,$531.25,$109007.25,172,$531.25
Final P&L Day: 531.25,,,,,,,,,,,
2024-08-30,12:00:00,19526.75,BUY,1,0.02h,Stop Loss,$37.75,$37.75,$109045.00,173,$37.75
2024-08-30,12:36:00,19517.0,SELL,1,0.02h,Stop Loss,$27.75,$65.50,$109072.75,173,$65.50
2024-08-30,12:44:00,19554.0,BUY,1,0.02h,Stop Loss,$-6.00,$59.50,$109066.75,173,$59.50
2024-08-30,12:47:00,19534.25,SELL,1,0.02h,Stop Loss,$25.25,$84.75,$109092.00,173,$84.75
2024-08-30,13:09:00,19536.75,BUY,1,0.02h,Stop Loss,$17.75,$102.50,$109109.75,173,$102.50
2024-08-30,13:34:00,19525.5,SELL,1,0.02h,Stop Loss,$35.25,$137.75,$109145.00,173,$137.75
2024-08-30,13:42:00,19565.0,BUY,1,0.02h,Stop Loss,$16.50,$154.25,$109161.50,173,$154.25
2024-08-30,14:15:00,19575.25,SELL,1,0.02h,Stop Loss,$64.00,$218.25,$109225.50,173,$218.25
2024-08-30,14:37:00,19583.0,BUY,1,0.02h,Stop Loss,$-6.00,$212.25,$109219.50,173,$212.25
2024-08-30,14:47:00,19555.25,SELL,1,0.02h,Stop Loss,$25.25,$237.50,$109244.75,173,$237.50
2024-08-30,14:50:00,19588.5,BUY,1,0.02h,Break Even,$0.25,$237.75,$109245.00,173,$237.75
2024-08-30,14:53:00,19563.25,SELL,1,0.02h,Stop Loss,$110.25,$348.00,$109355.25,173,$348.00
2024-08-30,15:54:00,19470.75,BUY,1,0.02h,Stop Loss,$6.50,$354.50,$109361.75,173,$354.50
2024-08-30,16:01:00,19424.25,SELL,1,0.02h,Stop Loss,$42.75,$397.25,$109404.50,173,$397.25
2024-08-30,16:08:00,19467.5,BUY,1,0.02h,Stop Loss,$24.00,$421.25,$109428.50,173,$421.25
2024-08-30,16:22:00,19456.0,SELL,1,0.02h,Stop Loss,$17.75,$439.00,$109446.25,173,$439.00
2024-08-30,16:52:00,19431.75,BUY,1,0.02h,Stop Loss,$65.25,$504.25,$109511.50,173,$504.25
2024-08-30,17:24:00,19458.25,SELL,1,0.02h,Stop Loss,$27.75,$532.00,$109539.25,173,$532.00
2024-08-30,17:32:00,19472.75,BUY,1,0.02h,Stop Loss,$36.50,$568.50,$109575.75,173,$568.50
2024-08-30,17:45:00,19467.0,SELL,1,0.02h,Stop Loss,$21.50,$590.00,$109597.25,173,$590.00
2024-08-30,18:12:00,19469.25,BUY,1,0.02h,Stop Loss,$19.00,$609.00,$109616.25,173,$609.00
2024-08-30,19:13:00,19504.5,SELL,1,0.02h,Stop Loss,$41.50,$650.50,$109657.75,173,$650.50
2024-08-30,19:19:00,19520.25,BUY,1,0.02h,Stop Loss,$6.50,$657.00,$109664.25,173,$657.00
2024-08-30,19:44:00,19529.5,SELL,1,0.02h,Break Even,$0.25,$657.25,$109664.50,173,$657.25
2024-08-30,19:51:00,19593.5,BUY,1,0.02h,Stop Loss,$52.75,$710.00,$109717.25,173,$710.00
2024-08-30,20:42:00,19597.75,SELL,1,0.02h,Stop Loss,$-6.00,$704.00,$109711.25,173,$704.00
Final P&L Day: 704.00,,,,,,,,,,,
2024-09-02,12:01:00,19610.5,BUY,1,0.02h,Break Even,$0.25,$0.25,$109711.50,174,$0.25
2024-09-02,12:29:00,19613.0,SELL,1,0.02h,Stop Loss,$-6.00,$-5.75,$109705.50,174,$-5.75
2024-09-02,12:32:00,19616.75,BUY,1,0.02h,Break Even,$0.25,$-5.50,$109705.75,174,$-5.50
2024-09-02,12:35:00,19613.5,SELL,1,0.02h,Stop Loss,$-6.00,$-11.50,$109699.75,174,$-11.50
2024-09-02,12:53:00,19613.25,BUY,1,0.02h,Stop Loss,$-6.00,$-17.50,$109693.75,174,$-17.50
2024-09-02,12:58:00,19609.75,SELL,1,0.02h,Break Even,$0.25,$-17.25,$109694.00,174,$-17.25
2024-09-02,13:02:00,19615.25,BUY,1,0.02h,Stop Loss,$5.25,$-12.00,$109699.25,174,$-12.00
2024-09-02,13:30:00,19618.0,SELL,1,0.02h,Stop Loss,$-6.00,$-18.00,$109693.25,174,$-18.00
2024-09-02,13:31:00,19621.75,BUY,1,0.02h,Stop Loss,$5.25,$-12.75,$109698.50,174,$-12.75
2024-09-02,13:35:00,19617.75,SELL,1,0.02h,Break Even,$0.25,$-12.50,$109698.75,174,$-12.50
2024-09-02,13:39:00,19625.5,BUY,1,0.02h,Break Even,$0.25,$-12.25,$109699.00,174,$-12.25
2024-09-02,14:00:00,19619.5,SELL,1,0.02h,Break Even,$0.25,$-12.00,$109699.25,174,$-12.00
2024-09-02,14:32:00,19617.75,BUY,1,0.02h,Stop Loss,$50.25,$38.25,$109749.50,174,$38.25
2024-09-02,15:26:00,19656.25,SELL,1,0.02h,Break Even,$0.25,$38.50,$109749.75,174,$38.50
2024-09-02,15:51:00,19653.75,BUY,1,0.02h,Break Even,$0.25,$38.75,$109750.00,174,$38.75
2024-09-02,16:08:00,19650.0,SELL,1,0.02h,Stop Loss,$-6.00,$32.75,$109744.00,174,$32.75
2024-09-02,16:10:00,19654.75,BUY,1,0.02h,Break Even,$0.25,$33.00,$109744.25,174,$33.00
2024-09-02,16:21:00,19651.25,SELL,1,0.02h,Break Even,$0.25,$33.25,$109744.50,174,$33.25
2024-09-02,16:42:00,19653.5,BUY,1,0.02h,Stop Loss,$-6.00,$27.25,$109738.50,174,$27.25
2024-09-02,16:49:00,19648.0,SELL,1,0.02h,Stop Loss,$9.00,$36.25,$109747.50,174,$36.25
2024-09-02,22:01:00,19663.0,BUY,1,0.02h,Stop Loss,$-6.00,$30.25,$109741.50,174,$30.25
2024-09-02,22:25:00,19663.75,SELL,1,0.02h,Stop Loss,$17.75,$48.00,$109759.25,174,$48.00
Final P&L Day: 48.00,,,,,,,,,,,
2024-09-03,12:41:00,19514.75,BUY,1,0.02h,Stop Loss,$14.00,$14.00,$109773.25,175,$14.00
2024-09-03,12:54:00,19507.0,SELL,1,0.02h,Stop Loss,$10.25,$24.25,$109783.50,175,$24.25
2024-09-03,13:22:00,19495.0,BUY,1,0.02h,Stop Loss,$-6.00,$18.25,$109777.50,175,$18.25
2024-09-03,13:30:00,19478.25,SELL,1,0.02h,Stop Loss,$127.75,$146.00,$109905.25,175,$146.00
2024-09-03,15:13:00,19216.5,BUY,1,0.02h,Stop Loss,$25.25,$171.25,$109930.50,175,$171.25
2024-09-03,15:25:00,19195.75,SELL,1,0.02h,Stop Loss,$19.00,$190.25,$109949.50,175,$190.25
2024-09-03,15:37:00,19219.75,BUY,1,0.02h,Break Even,$0.25,$190.50,$109949.75,175,$190.50
2024-09-03,15:41:00,19184.75,SELL,1,0.02h,Stop Loss,$31.50,$222.00,$109981.25,175,$222.00
2024-09-03,16:16:00,19176.5,BUY,1,0.02h,Stop Loss,$82.75,$304.75,$110064.00,175,$304.75
2024-09-03,16:27:00,19159.25,SELL,1,0.02h,Stop Loss,$6.50,$311.25,$110070.50,175,$311.25
2024-09-03,17:08:00,19157.75,BUY,1,0.02h,Stop Loss,$24.00,$335.25,$110094.50,175,$335.25
2024-09-03,17:13:00,19139.0,SELL,1,0.02h,Stop Loss,$49.00,$384.25,$110143.50,175,$384.25
2024-09-03,17:22:00,19168.0,BUY,1,0.02h,Stop Loss,$36.50,$420.75,$110180.00,175,$420.75
2024-09-03,17:35:00,19138.25,SELL,1,0.02h,Stop Loss,$-6.00,$414.75,$110174.00,175,$414.75
2024-09-03,18:40:00,19056.25,BUY,1,0.02h,Stop Loss,$10.25,$425.00,$110184.25,175,$425.00
2024-09-03,18:43:00,19049.75,SELL,1,0.02h,Stop Loss,$14.00,$439.00,$110198.25,175,$439.00
2024-09-03,19:02:00,19055.75,BUY,1,0.02h,Break Even,$0.25,$439.25,$110198.50,175,$439.25
2024-09-03,19:12:00,19045.75,SELL,1,0.02h,Stop Loss,$15.25,$454.50,$110213.75,175,$454.50
2024-09-03,19:22:00,19060.25,BUY,1,0.02h,Break Even,$0.25,$454.75,$110214.00,175,$454.75
2024-09-03,19:25:00,19044.25,SELL,1,0.02h,Stop Loss,$10.25,$465.00,$110224.25,175,$465.00
2024-09-03,19:59:00,19001.25,BUY,1,0.02h,Stop Loss,$55.25,$520.25,$110279.50,175,$520.25
2024-09-03,20:19:00,18994.0,SELL,1,0.02h,Stop Loss,$-6.00,$514.25,$110273.50,175,$514.25
2024-09-03,20:55:00,18987.5,BUY,1,0.02h,Stop Loss,$19.00,$533.25,$110292.50,175,$533.25
2024-09-03,22:06:00,18971.0,SELL,1,0.02h,Break Even,$0.25,$533.50,$110292.75,175,$533.50
2024-09-03,22:20:00,18982.0,BUY,1,0.02h,Stop Loss,$16.50,$550.00,$110309.25,175,$550.00
2024-09-03,22:50:00,18981.0,SELL,1,0.02h,Stop Loss,$-6.00,$544.00,$110303.25,175,$544.00
Final P&L Day: 544.00,,,,,,,,,,,
2024-09-04,12:44:00,18888.75,BUY,1,0.02h,Stop Loss,$16.50,$16.50,$110319.75,176,$16.50
2024-09-04,13:11:00,18892.25,SELL,1,0.02h,Stop Loss,$5.25,$21.75,$110325.00,176,$21.75
2024-09-04,13:35:00,18922.25,BUY,1,0.02h,Break Even,$0.25,$22.00,$110325.25,176,$22.00
2024-09-04,14:01:00,18852.0,SELL,1,0.02h,Break Even,$0.25,$22.25,$110325.50,176,$22.25
2024-09-04,14:10:00,18971.75,BUY,1,0.02h,Stop Loss,$132.75,$155.00,$110458.25,176,$155.00
2024-09-04,14:19:00,18931.5,SELL,1,0.02h,Stop Loss,$22.75,$177.75,$110481.00,176,$177.75
2024-09-04,14:24:00,18962.0,BUY,1,0.02h,Stop Loss,$41.50,$219.25,$110522.50,176,$219.25
2024-09-04,15:16:00,19054.75,SELL,1,0.02h,Stop Loss,$27.75,$247.00,$110550.25,176,$247.00
2024-09-04,15:55:00,19029.25,BUY,1,0.02h,Stop Loss,$-6.00,$241.00,$110544.25,176,$241.00
2024-09-04,15:57:00,18991.25,SELL,1,0.02h,Stop Loss,$7.75,$248.75,$110552.00,176,$248.75
2024-09-04,16:17:00,19023.5,BUY,1,0.02h,Stop Loss,$40.25,$289.00,$110592.25,176,$289.00
2024-09-04,16:47:00,19032.5,SELL,1,0.02h,Break Even,$0.25,$289.25,$110592.50,176,$289.25
2024-09-04,16:56:00,19053.25,BUY,1,0.02h,Stop Loss,$12.75,$302.00,$110605.25,176,$302.00
2024-09-04,17:05:00,19041.25,SELL,1,0.02h,Stop Loss,$-6.00,$296.00,$110599.25,176,$296.00
2024-09-04,17:11:00,19060.0,BUY,1,0.02h,Stop Loss,$19.00,$315.00,$110618.25,176,$315.00
2024-09-04,17:15:00,19036.75,SELL,1,0.02h,Break Even,$0.25,$315.25,$110618.50,176,$315.25
2024-09-04,17:23:00,19058.75,BUY,1,0.02h,Stop Loss,$-6.00,$309.25,$110612.50,176,$309.25
2024-09-04,17:25:00,19037.5,SELL,1,0.02h,Stop Loss,$20.25,$329.50,$110632.75,176,$329.50
2024-09-04,18:15:00,19016.75,BUY,1,0.02h,Stop Loss,$30.25,$359.75,$110663.00,176,$359.75
2024-09-04,18:20:00,18991.0,SELL,1,0.02h,Stop Loss,$11.50,$371.25,$110674.50,176,$371.25
2024-09-04,18:27:00,19018.25,BUY,1,0.02h,Break Even,$0.25,$371.50,$110674.75,176,$371.50
2024-09-04,18:35:00,18991.25,SELL,1,0.02h,Stop Loss,$90.25,$461.75,$110765.00,176,$461.75
2024-09-04,19:24:00,18937.75,BUY,1,0.02h,Stop Loss,$59.00,$520.75,$110824.00,176,$520.75
2024-09-04,20:01:00,18960.75,SELL,1,0.02h,Stop Loss,$32.75,$553.50,$110856.75,176,$553.50
2024-09-04,20:30:00,18954.75,BUY,1,0.02h,Break Even,$0.25,$553.75,$110857.00,176,$553.75
2024-09-04,22:20:00,18962.75,SELL,1,0.02h,Stop Loss,$-6.00,$547.75,$110851.00,176,$547.75
2024-09-04,22:33:00,18971.75,BUY,1,0.02h,Stop Loss,$25.25,$573.00,$110876.25,176,$573.00
2024-09-04,22:59:00,18974.25,SELL,1,0.02h,Break Even,$0.25,$573.25,$110876.50,176,$573.25
Final P&L Day: 573.25,,,,,,,,,,,
2024-09-05,12:33:00,18911.5,BUY,1,0.02h,Stop Loss,$5.25,$5.25,$110881.75,177,$5.25
2024-09-05,12:41:00,18861.75,SELL,1,0.02h,Stop Loss,$30.25,$35.50,$110912.00,177,$35.50
2024-09-05,12:48:00,18889.75,BUY,1,0.02h,Stop Loss,$25.25,$60.75,$110937.25,177,$60.75
2024-09-05,13:26:00,18897.5,SELL,1,0.02h,Stop Loss,$14.00,$74.75,$110951.25,177,$74.75
2024-09-05,13:34:00,18932.25,BUY,1,0.02h,Stop Loss,$17.75,$92.50,$110969.00,177,$92.50
2024-09-05,14:17:00,19048.75,SELL,1,0.02h,Stop Loss,$19.00,$111.50,$110988.00,177,$111.50
2024-09-05,14:18:00,19058.25,BUY,1,0.02h,Stop Loss,$32.75,$144.25,$111020.75,177,$144.25
2024-09-05,14:45:00,19071.0,SELL,1,0.02h,Stop Loss,$172.75,$317.00,$111193.50,177,$317.00
2024-09-05,16:04:00,18907.25,BUY,1,0.02h,Stop Loss,$-6.00,$311.00,$111187.50,177,$311.00
2024-09-05,16:17:00,18879.75,SELL,1,0.02h,Stop Loss,$10.25,$321.25,$111197.75,177,$321.25
2024-09-05,16:21:00,18899.75,BUY,1,0.02h,Stop Loss,$14.00,$335.25,$111211.75,177,$335.25
2024-09-05,16:53:00,18932.0,SELL,1,0.02h,Stop Loss,$32.75,$368.00,$111244.50,177,$368.00
2024-09-05,16:58:00,18950.75,BUY,1,0.02h,Break Even,$0.25,$368.25,$111244.75,177,$368.25
2024-09-05,17:06:00,18930.5,SELL,1,0.02h,Stop Loss,$114.00,$482.25,$111358.75,177,$482.25
2024-09-05,17:38:00,18950.25,BUY,1,0.02h,Break Even,$0.25,$482.50,$111359.00,177,$482.50
2024-09-05,18:26:00,18993.25,SELL,1,0.02h,Break Even,$0.25,$482.75,$111359.25,177,$482.75
2024-09-05,18:38:00,19009.5,BUY,1,0.02h,Stop Loss,$-6.00,$476.75,$111353.25,177,$476.75
2024-09-05,18:43:00,18989.25,SELL,1,0.02h,Break Even,$0.25,$477.00,$111353.50,177,$477.00
2024-09-05,18:48:00,19012.0,BUY,1,0.02h,Break Even,$0.25,$477.25,$111353.75,177,$477.25
2024-09-05,18:59:00,18992.5,SELL,1,0.02h,Stop Loss,$6.50,$483.75,$111360.25,177,$483.75
2024-09-05,19:32:00,18971.5,BUY,1,0.02h,Stop Loss,$39.00,$522.75,$111399.25,177,$522.75
2024-09-05,19:42:00,18942.5,SELL,1,0.02h,Stop Loss,$46.50,$569.25,$111445.75,177,$569.25
2024-09-05,20:00:00,18975.75,BUY,1,0.02h,Stop Loss,$42.75,$612.00,$111488.50,177,$612.00
2024-09-05,20:17:00,18933.5,SELL,1,0.02h,Stop Loss,$86.50,$698.50,$111575.00,177,$698.50
2024-09-05,20:47:00,18931.0,BUY,1,0.02h,Stop Loss,$-6.00,$692.50,$111569.00,177,$692.50
2024-09-05,20:49:00,18926.5,SELL,1,0.02h,Stop Loss,$31.50,$724.00,$111600.50,177,$724.00
2024-09-05,22:02:00,18929.75,BUY,1,0.02h,Stop Loss,$-6.00,$718.00,$111594.50,177,$718.00
2024-09-05,22:11:00,18918.5,SELL,1,0.02h,Stop Loss,$15.25,$733.25,$111609.75,177,$733.25
2024-09-05,22:44:00,18915.5,BUY,1,0.02h,Stop Loss,$-6.00,$727.25,$111603.75,177,$727.25
2024-09-05,22:48:00,18910.75,SELL,1,0.02h,Stop Loss,$-6.00,$721.25,$111597.75,177,$721.25
2024-09-05,22:53:00,18921.0,BUY,1,0.02h,Stop Loss,$-6.00,$715.25,$111591.75,177,$715.25
Final P&L Day: 715.25,,,,,,,,,,,
2024-09-06,12:00:00,18782.75,SELL,1,0.02h,Break Even,$0.25,$0.25,$111592.00,178,$0.25
2024-09-06,12:31:00,18853.25,BUY,1,0.02h,Stop Loss,$9.00,$9.25,$111601.00,178,$9.25
2024-09-06,13:33:00,18891.75,SELL,1,0.02h,Stop Loss,$17.75,$27.00,$111618.75,178,$27.00
2024-09-06,15:03:00,18603.5,BUY,1,0.02h,Stop Loss,$52.75,$79.75,$111671.50,178,$79.75
2024-09-06,15:09:00,18536.0,SELL,1,0.02h,Stop Loss,$29.00,$108.75,$111700.50,178,$108.75
2024-09-06,15:34:00,18544.75,BUY,1,0.02h,Stop Loss,$-6.00,$102.75,$111694.50,178,$102.75
2024-09-06,15:36:00,18520.5,SELL,1,0.02h,Stop Loss,$66.50,$169.25,$111761.00,178,$169.25
2024-09-06,16:14:00,18477.5,BUY,1,0.02h,Stop Loss,$45.25,$214.50,$111806.25,178,$214.50
2024-09-06,16:15:00,18470.0,SELL,1,0.02h,Stop Loss,$39.00,$253.50,$111845.25,178,$253.50
2024-09-06,16:26:00,18484.5,BUY,1,0.02h,Break Even,$0.25,$253.75,$111845.50,178,$253.75
2024-09-06,16:29:00,18456.25,SELL,1,0.02h,Stop Loss,$26.50,$280.25,$111872.00,178,$280.25
2024-09-06,16:36:00,18484.25,BUY,1,0.02h,Stop Loss,$22.75,$303.00,$111894.75,178,$303.00
2024-09-06,16:41:00,18449.0,SELL,1,0.02h,Stop Loss,$7.75,$310.75,$111902.50,178,$310.75
2024-09-06,16:46:00,18472.5,BUY,1,0.02h,Break Even,$0.25,$311.00,$111902.75,178,$311.00
2024-09-06,16:47:00,18463.25,SELL,1,0.02h,Stop Loss,$15.25,$326.25,$111918.00,178,$326.25
2024-09-06,17:05:00,18470.25,BUY,1,0.02h,Break Even,$0.25,$326.50,$111918.25,178,$326.50
2024-09-06,17:33:00,18494.25,SELL,1,0.02h,Stop Loss,$49.00,$375.50,$111967.25,178,$375.50
2024-09-06,17:57:00,18490.75,BUY,1,0.02h,Stop Loss,$-6.00,$369.50,$111961.25,178,$369.50
2024-09-06,18:03:00,18457.25,SELL,1,0.02h,Stop Loss,$12.75,$382.25,$111974.00,178,$382.25
2024-09-06,18:42:00,18458.25,BUY,1,0.02h,Stop Loss,$26.50,$408.75,$112000.50,178,$408.75
2024-09-06,19:37:00,18495.5,SELL,1,0.02h,Stop Loss,$94.00,$502.75,$112094.50,178,$502.75
2024-09-06,19:50:00,18516.75,BUY,1,0.02h,Stop Loss,$60.25,$563.00,$112154.75,178,$563.00
2024-09-06,19:52:00,18477.5,SELL,1,0.02h,Stop Loss,$45.25,$608.25,$112200.00,178,$608.25
Final P&L Day: 608.25,,,,,,,,,,,
2024-09-09,12:00:00,18596.5,BUY,1,0.02h,Stop Loss,$21.50,$21.50,$112221.50,179,$21.50
2024-09-09,14:20:00,18651.75,SELL,1,0.02h,Stop Loss,$44.00,$65.50,$112265.50,179,$65.50
2024-09-09,15:27:00,18541.5,BUY,1,0.02h,Stop Loss,$9.00,$74.50,$112274.50,179,$74.50
2024-09-09,17:25:00,18709.0,SELL,1,0.02h,Break Even,$0.25,$74.75,$112274.75,179,$74.75
2024-09-09,18:47:00,18613.25,BUY,1,0.02h,Stop Loss,$4.00,$78.75,$112278.75,179,$78.75
2024-09-09,19:00:00,18603.75,SELL,1,0.02h,Stop Loss,$21.50,$100.25,$112300.25,179,$100.25
2024-09-09,19:11:00,18608.0,BUY,1,0.02h,Stop Loss,$7.75,$108.00,$112308.00,179,$108.00
2024-09-09,19:12:00,18600.0,SELL,1,0.02h,Break Even,$0.25,$108.25,$112308.25,179,$108.25
2024-09-09,19:13:00,18604.25,BUY,1,0.02h,Break Even,$0.25,$108.50,$112308.50,179,$108.50
2024-09-09,19:15:00,18596.5,SELL,1,0.02h,Stop Loss,$-6.00,$102.50,$112302.50,179,$102.50
2024-09-09,19:16:00,18606.25,BUY,1,0.02h,Stop Loss,$19.00,$121.50,$112321.50,179,$121.50
2024-09-09,19:21:00,18596.5,SELL,1,0.02h,Stop Loss,$46.50,$168.00,$112368.00,179,$168.00
2024-09-09,19:26:00,18608.25,BUY,1,0.02h,Stop Loss,$52.75,$220.75,$112420.75,179,$220.75
2024-09-09,20:49:00,18716.5,SELL,1,0.02h,Stop Loss,$-6.00,$214.75,$112414.75,179,$214.75
2024-09-09,22:01:00,18735.0,BUY,1,0.02h,Stop Loss,$-6.00,$208.75,$112408.75,179,$208.75
2024-09-09,22:12:00,18716.25,SELL,1,0.02h,Stop Loss,$20.25,$229.00,$112429.00,179,$229.00
2024-09-09,22:32:00,18724.5,BUY,1,0.02h,Stop Loss,$-6.00,$223.00,$112423.00,179,$223.00
2024-09-09,22:44:00,18712.0,SELL,1,0.02h,Stop Loss,$9.00,$232.00,$112432.00,179,$232.00
Final P&L Day: 232.00,,,,,,,,,,,
2024-09-10,12:10:00,18715.0,BUY,1,0.02h,Stop Loss,$7.75,$7.75,$112439.75,180,$7.75
2024-09-10,13:17:00,18756.0,SELL,1,0.02h,Break Even,$0.25,$8.00,$112440.00,180,$8.00
2024-09-10,13:19:00,18760.0,BUY,1,0.02h,Stop Loss,$15.25,$23.25,$112455.25,180,$23.25
2024-09-10,13:38:00,18747.0,SELL,1,0.02h,Stop Loss,$57.75,$81.00,$112513.00,180,$81.00
2024-09-10,13:54:00,18772.75,BUY,1,0.02h,Stop Loss,$40.25,$121.25,$112553.25,180,$121.25
2024-09-10,14:13:00,18739.5,SELL,1,0.02h,Stop Loss,$156.50,$277.75,$112709.75,180,$277.75
2024-09-10,14:30:00,18780.75,BUY,1,0.02h,Stop Loss,$10.25,$288.00,$112720.00,180,$288.00
2024-09-10,14:44:00,18734.0,SELL,1,0.02h,Stop Loss,$76.50,$364.50,$112796.50,180,$364.50
2024-09-10,15:10:00,18732.25,BUY,1,0.02h,Stop Loss,$77.75,$442.25,$112874.25,180,$442.25
2024-09-10,15:40:00,18742.0,SELL,1,0.02h,Stop Loss,$9.00,$451.25,$112883.25,180,$451.25
2024-09-10,16:25:00,18647.0,BUY,1,0.02h,Stop Loss,$24.00,$475.25,$112907.25,180,$475.25
2024-09-10,18:53:00,18820.75,SELL,1,0.02h,Stop Loss,$-6.00,$469.25,$112901.25,180,$469.25
2024-09-10,19:10:00,18833.0,BUY,1,0.02h,Stop Loss,$41.50,$510.75,$112942.75,180,$510.75
2024-09-10,19:45:00,18848.0,SELL,1,0.02h,Break Even,$0.25,$511.00,$112943.00,180,$511.00
2024-09-10,19:48:00,18858.25,BUY,1,0.02h,Stop Loss,$-6.00,$505.00,$112937.00,180,$505.00
2024-09-10,19:51:00,18840.25,SELL,1,0.02h,Stop Loss,$-6.00,$499.00,$112931.00,180,$499.00
2024-09-10,19:56:00,18855.75,BUY,1,0.02h,Stop Loss,$14.00,$513.00,$112945.00,180,$513.00
2024-09-10,20:03:00,18846.25,SELL,1,0.02h,Break Even,$0.25,$513.25,$112945.25,180,$513.25
2024-09-10,20:55:00,18831.25,BUY,1,0.02h,Stop Loss,$-6.00,$507.25,$112939.25,180,$507.25
2024-09-10,22:13:00,18828.0,SELL,1,0.02h,Break Even,$0.25,$507.50,$112939.50,180,$507.50
2024-09-10,22:16:00,18834.25,BUY,1,0.02h,Stop Loss,$-6.00,$501.50,$112933.50,180,$501.50
2024-09-10,22:31:00,18828.75,SELL,1,0.02h,Stop Loss,$-6.00,$495.50,$112927.50,180,$495.50
2024-09-10,22:41:00,18834.0,BUY,1,0.02h,Stop Loss,$22.75,$518.25,$112950.25,180,$518.25
Final P&L Day: 518.25,,,,,,,,,,,
2024-09-11,12:01:00,18828.5,SELL,1,0.02h,Stop Loss,$10.25,$10.25,$112960.50,181,$10.25
2024-09-11,12:14:00,18839.0,BUY,1,0.02h,Stop Loss,$-6.00,$4.25,$112954.50,181,$4.25
2024-09-11,12:31:00,18754.25,SELL,1,0.02h,Stop Loss,$101.50,$105.75,$113056.00,181,$105.75
2024-09-11,12:50:00,18822.5,BUY,1,0.02h,Stop Loss,$26.50,$132.25,$113082.50,181,$132.25
2024-09-11,13:32:00,18891.0,SELL,1,0.02h,Stop Loss,$82.75,$215.00,$113165.25,181,$215.00
2024-09-11,15:05:00,18607.25,BUY,1,0.02h,Stop Loss,$189.00,$404.00,$113354.25,181,$404.00
2024-09-11,16:48:00,18885.25,SELL,1,0.02h,Stop Loss,$24.00,$428.00,$113378.25,181,$428.00
2024-09-11,16:55:00,18916.0,BUY,1,0.02h,Stop Loss,$-6.00,$422.00,$113372.25,181,$422.00
2024-09-11,18:55:00,19107.25,SELL,1,0.02h,Break Even,$0.25,$422.25,$113372.50,181,$422.25
2024-09-11,18:56:00,19134.75,BUY,1,0.02h,Stop Loss,$15.25,$437.50,$113387.75,181,$437.50
2024-09-11,19:00:00,19127.75,SELL,1,0.02h,Stop Loss,$69.00,$506.50,$113456.75,181,$506.50
2024-09-11,19:08:00,19138.5,BUY,1,0.02h,Stop Loss,$35.25,$541.75,$113492.00,181,$541.75
2024-09-11,20:47:00,19246.25,SELL,1,0.02h,Break Even,$0.25,$542.00,$113492.25,181,$542.00
2024-09-11,20:48:00,19249.0,BUY,1,0.02h,Stop Loss,$-6.00,$536.00,$113486.25,181,$536.00
2024-09-11,20:50:00,19246.25,SELL,1,0.02h,Break Even,$0.25,$536.25,$113486.50,181,$536.25
2024-09-11,20:52:00,19249.5,BUY,1,0.02h,Stop Loss,$-6.00,$530.25,$113480.50,181,$530.25
2024-09-11,20:57:00,19242.75,SELL,1,0.02h,Stop Loss,$-6.00,$524.25,$113474.50,181,$524.25
2024-09-11,22:21:00,19245.25,BUY,1,0.02h,Break Even,$0.25,$524.50,$113474.75,181,$524.50
Final P&L Day: 524.50,,,,,,,,,,,
2024-09-12,12:35:00,19269.25,SELL,1,0.02h,Stop Loss,$4.00,$4.00,$113478.75,182,$4.00
2024-09-12,12:55:00,19501.5,BUY,1,0.02h,Break Even,$0.25,$4.25,$113479.00,182,$4.25
2024-09-12,12:58:00,19267.5,SELL,1,0.02h,Stop Loss,$-6.00,$-1.75,$113473.00,182,$-1.75
2024-09-12,12:59:00,19495.75,BUY,1,0.02h,Stop Loss,$-6.00,$-7.75,$113467.00,182,$-7.75
2024-09-12,13:01:00,19256.25,SELL,1,0.02h,Stop Loss,$-6.00,$-13.75,$113461.00,182,$-13.75
2024-09-12,13:02:00,19498.0,BUY,1,0.02h,Stop Loss,$-6.00,$-19.75,$113455.00,182,$-19.75
2024-09-12,13:03:00,19267.75,SELL,1,0.02h,Stop Loss,$-6.00,$-25.75,$113449.00,182,$-25.75
2024-09-12,13:04:00,19498.25,BUY,1,0.02h,Stop Loss,$29.00,$3.25,$113478.00,182,$3.25
2024-09-12,13:09:00,19273.0,SELL,1,0.02h,Stop Loss,$-6.00,$-2.75,$113472.00,182,$-2.75
2024-09-12,13:10:00,19512.0,BUY,1,0.02h,Stop Loss,$7.75,$5.00,$113479.75,182,$5.00
2024-09-12,13:21:00,19261.5,SELL,1,0.02h,Stop Loss,$-6.00,$-1.00,$113473.75,182,$-1.00
2024-09-12,13:22:00,19495.75,BUY,1,0.02h,Stop Loss,$-6.00,$-7.00,$113467.75,182,$-7.00
2024-09-12,13:23:00,19261.5,SELL,1,0.02h,Stop Loss,$-6.00,$-13.00,$113461.75,182,$-13.00
2024-09-12,13:26:00,19499.5,BUY,1,0.02h,Stop Loss,$20.25,$7.25,$113482.00,182,$7.25
2024-09-12,13:30:00,19259.0,SELL,1,0.02h,Stop Loss,$122.75,$130.00,$113604.75,182,$130.00
2024-09-12,13:42:00,19495.0,BUY,1,0.02h,Stop Loss,$101.50,$231.50,$113706.25,182,$231.50
2024-09-12,13:47:00,19247.0,SELL,1,0.02h,Stop Loss,$130.25,$361.75,$113836.50,182,$361.75
2024-09-12,13:52:00,19441.25,BUY,1,0.02h,Stop Loss,$-6.00,$355.75,$113830.50,182,$355.75
2024-09-12,13:53:00,19232.0,SELL,1,0.02h,Stop Loss,$-6.00,$349.75,$113824.50,182,$349.75
2024-09-12,13:55:00,19494.25,BUY,1,0.02h,Stop Loss,$-6.00,$343.75,$113818.50,182,$343.75
2024-09-12,13:56:00,19240.75,SELL,1,0.02h,Stop Loss,$16.50,$360.25,$113835.00,182,$360.25
2024-09-12,14:01:00,19490.0,BUY,1,0.02h,Stop Loss,$49.00,$409.25,$113884.00,182,$409.25
2024-09-12,14:05:00,19241.0,SELL,1,0.02h,Stop Loss,$39.00,$448.25,$113923.00,182,$448.25
2024-09-12,14:14:00,19548.0,BUY,1,0.02h,Stop Loss,$19.00,$467.25,$113942.00,182,$467.25
2024-09-12,14:25:00,19323.75,SELL,1,0.02h,Stop Loss,$-6.00,$461.25,$113936.00,182,$461.25
2024-09-12,14:26:00,19561.25,BUY,1,0.02h,Stop Loss,$-6.00,$455.25,$113930.00,182,$455.25
2024-09-12,14:28:00,19331.25,SELL,1,0.02h,Stop Loss,$-6.00,$449.25,$113924.00,182,$449.25
2024-09-12,14:29:00,19574.5,BUY,1,0.02h,Break Even,$0.25,$449.50,$113924.25,182,$449.50
2024-09-12,14:38:00,19301.5,SELL,1,0.02h,Stop Loss,$36.50,$486.00,$113960.75,182,$486.00
2024-09-12,14:51:00,19543.0,BUY,1,0.02h,Stop Loss,$20.25,$506.25,$113981.00,182,$506.25
2024-09-12,14:54:00,19312.5,SELL,1,0.02h,Stop Loss,$-6.00,$500.25,$113975.00,182,$500.25
2024-09-12,14:56:00,19582.25,BUY,1,0.02h,Stop Loss,$-6.00,$494.25,$113969.00,182,$494.25
2024-09-12,14:57:00,19334.5,SELL,1,0.02h,Stop Loss,$-6.00,$488.25,$113963.00,182,$488.25
2024-09-12,14:58:00,19546.25,BUY,1,0.02h,Stop Loss,$5.25,$493.50,$113968.25,182,$493.50
2024-09-12,15:01:00,19266.25,SELL,1,0.02h,Break Even,$0.25,$493.75,$113968.50,182,$493.75
2024-09-12,15:06:00,19563.5,BUY,1,0.02h,Break Even,$0.25,$494.00,$113968.75,182,$494.00
2024-09-12,15:15:00,19375.25,SELL,1,0.02h,Stop Loss,$251.50,$745.50,$114220.25,182,$745.50
2024-09-12,15:20:00,19570.25,BUY,1,0.02h,Break Even,$0.25,$745.75,$114220.50,182,$745.75
2024-09-12,15:23:00,19317.5,SELL,1,0.02h,Stop Loss,$61.50,$807.25,$114282.00,182,$807.25
2024-09-12,15:27:00,19529.5,BUY,1,0.02h,Stop Loss,$-6.00,$801.25,$114276.00,182,$801.25
2024-09-12,15:28:00,19309.25,SELL,1,0.02h,Stop Loss,$-6.00,$795.25,$114270.00,182,$795.25
2024-09-12,15:29:00,19536.25,BUY,1,0.02h,Stop Loss,$-6.00,$789.25,$114264.00,182,$789.25
2024-09-12,15:30:00,19288.25,SELL,1,0.02h,Stop Loss,$-6.00,$783.25,$114258.00,182,$783.25
2024-09-12,15:31:00,19523.25,BUY,1,0.02h,Stop Loss,$66.50,$849.75,$114324.50,182,$849.75
2024-09-12,15:33:00,19299.75,SELL,1,0.02h,Stop Loss,$-6.00,$843.75,$114318.50,182,$843.75
2024-09-12,15:34:00,19528.0,BUY,1,0.02h,Stop Loss,$-6.00,$837.75,$114312.50,182,$837.75
2024-09-12,15:35:00,19282.5,SELL,1,0.02h,Break Even,$0.25,$838.00,$114312.75,182,$838.00
2024-09-12,15:38:00,19535.75,BUY,1,0.02h,Stop Loss,$-6.00,$832.00,$114306.75,182,$832.00
2024-09-12,15:46:00,19268.0,SELL,1,0.02h,Stop Loss,$-6.00,$826.00,$114300.75,182,$826.00
2024-09-12,15:48:00,19499.25,BUY,1,0.02h,Break Even,$0.25,$826.25,$114301.00,182,$826.25
2024-09-12,15:57:00,19272.25,SELL,1,0.02h,Stop Loss,$-6.00,$820.25,$114295.00,182,$820.25
2024-09-12,15:59:00,19494.5,BUY,1,0.02h,Stop Loss,$-6.00,$814.25,$114289.00,182,$814.25
2024-09-12,16:00:00,19265.5,SELL,1,0.02h,Stop Loss,$22.75,$837.00,$114311.75,182,$837.00
2024-09-12,16:06:00,19521.25,BUY,1,0.02h,Stop Loss,$-6.00,$831.00,$114305.75,182,$831.00
2024-09-12,16:07:00,19298.25,SELL,1,0.02h,Stop Loss,$-6.00,$825.00,$114299.75,182,$825.00
2024-09-12,16:15:00,19539.0,BUY,1,0.02h,Stop Loss,$5.25,$830.25,$114305.00,182,$830.25
2024-09-12,16:18:00,19301.25,SELL,1,0.02h,Break Even,$0.25,$830.50,$114305.25,182,$830.50
2024-09-12,16:24:00,19530.5,BUY,1,0.02h,Stop Loss,$-6.00,$824.50,$114299.25,182,$824.50
2024-09-12,16:25:00,19303.0,SELL,1,0.02h,Stop Loss,$-6.00,$818.50,$114293.25,182,$818.50
2024-09-12,16:27:00,19553.75,BUY,1,0.02h,Stop Loss,$-6.00,$812.50,$114287.25,182,$812.50
2024-09-12,16:28:00,19307.0,SELL,1,0.02h,Break Even,$0.25,$812.75,$114287.50,182,$812.75
2024-09-12,16:34:00,19550.25,BUY,1,0.02h,Stop Loss,$-6.00,$806.75,$114281.50,182,$806.75
2024-09-12,16:55:00,19357.5,SELL,1,0.02h,Stop Loss,$29.00,$835.75,$114310.50,182,$835.75
2024-09-12,16:58:00,19613.25,BUY,1,0.02h,Stop Loss,$-6.00,$829.75,$114304.50,182,$829.75
2024-09-12,16:59:00,19381.25,SELL,1,0.02h,Stop Loss,$-6.00,$823.75,$114298.50,182,$823.75
2024-09-12,17:00:00,19615.5,BUY,1,0.02h,Stop Loss,$45.25,$869.00,$114343.75,182,$869.00
2024-09-12,17:11:00,19389.5,SELL,1,0.02h,Stop Loss,$-6.00,$863.00,$114337.75,182,$863.00
2024-09-12,17:12:00,19617.0,BUY,1,0.02h,Stop Loss,$-6.00,$857.00,$114331.75,182,$857.00
2024-09-12,17:13:00,19388.75,SELL,1,0.02h,Stop Loss,$-6.00,$851.00,$114325.75,182,$851.00
2024-09-12,17:18:00,19635.25,BUY,1,0.02h,Break Even,$0.25,$851.25,$114326.00,182,$851.25
2024-09-12,17:29:00,19413.25,SELL,1,0.02h,Stop Loss,$-6.00,$845.25,$114320.00,182,$845.25
2024-09-12,17:30:00,19639.25,BUY,1,0.02h,Stop Loss,$6.50,$851.75,$114326.50,182,$851.75
2024-09-12,17:34:00,19404.75,SELL,1,0.02h,Stop Loss,$-6.00,$845.75,$114320.50,182,$845.75
2024-09-12,17:35:00,19644.75,BUY,1,0.02h,Stop Loss,$-6.00,$839.75,$114314.50,182,$839.75
2024-09-12,17:36:00,19410.5,SELL,1,0.02h,Stop Loss,$-6.00,$833.75,$114308.50,182,$833.75
2024-09-12,17:39:00,19662.75,BUY,1,0.02h,Stop Loss,$14.00,$847.75,$114322.50,182,$847.75
2024-09-12,17:43:00,19424.5,SELL,1,0.02h,Stop Loss,$27.75,$875.50,$114350.25,182,$875.50
2024-09-12,17:55:00,19691.75,BUY,1,0.02h,Stop Loss,$37.75,$913.25,$114388.00,182,$913.25
2024-09-12,18:06:00,19463.75,SELL,1,0.02h,Stop Loss,$12.75,$926.00,$114400.75,182,$926.00
2024-09-12,18:08:00,19696.0,BUY,1,0.02h,Stop Loss,$-6.00,$920.00,$114394.75,182,$920.00
2024-09-12,18:10:00,19454.25,SELL,1,0.02h,Stop Loss,$61.50,$981.50,$114456.25,182,$981.50
2024-09-12,18:14:00,19682.25,BUY,1,0.02h,Stop Loss,$-6.00,$975.50,$114450.25,182,$975.50
2024-09-12,18:16:00,19445.0,SELL,1,0.02h,Stop Loss,$-6.00,$969.50,$114444.25,182,$969.50
2024-09-12,18:17:00,19679.5,BUY,1,0.02h,Stop Loss,$-6.00,$963.50,$114438.25,182,$963.50
2024-09-12,18:18:00,19447.25,SELL,1,0.02h,Break Even,$0.25,$963.75,$114438.50,182,$963.75
2024-09-12,18:24:00,19689.5,BUY,1,0.02h,Stop Loss,$-6.00,$957.75,$114432.50,182,$957.75
2024-09-12,18:25:00,19470.25,SELL,1,0.02h,Break Even,$0.25,$958.00,$114432.75,182,$958.00
2024-09-12,18:28:00,19706.5,BUY,1,0.02h,Stop Loss,$-6.00,$952.00,$114426.75,182,$952.00
2024-09-12,18:29:00,19474.75,SELL,1,0.02h,Stop Loss,$-6.00,$946.00,$114420.75,182,$946.00
2024-09-12,18:30:00,19705.75,BUY,1,0.02h,Stop Loss,$36.50,$982.50,$114457.25,182,$982.50
2024-09-12,18:33:00,19453.0,SELL,1,0.02h,Stop Loss,$-6.00,$976.50,$114451.25,182,$976.50
2024-09-12,18:35:00,19700.75,BUY,1,0.02h,Stop Loss,$21.50,$998.00,$114472.75,182,$998.00
2024-09-12,18:46:00,19464.5,SELL,1,0.02h,Stop Loss,$-6.00,$992.00,$114466.75,182,$992.00
2024-09-12,18:47:00,19701.5,BUY,1,0.02h,Stop Loss,$-6.00,$986.00,$114460.75,182,$986.00
2024-09-12,18:48:00,19474.25,SELL,1,0.02h,Stop Loss,$64.00,$1050.00,$114524.75,182,$1050.00
2024-09-12,19:04:00,19677.0,BUY,1,0.02h,Stop Loss,$-6.00,$1044.00,$114518.75,182,$1044.00
2024-09-12,19:05:00,19439.75,SELL,1,0.02h,Stop Loss,$-6.00,$1038.00,$114512.75,182,$1038.00
2024-09-12,19:10:00,19692.25,BUY,1,0.02h,Stop Loss,$-6.00,$1032.00,$114506.75,182,$1032.00
2024-09-12,19:11:00,19460.25,SELL,1,0.02h,Stop Loss,$-6.00,$1026.00,$114500.75,182,$1026.00
2024-09-12,19:12:00,19684.75,BUY,1,0.02h,Stop Loss,$15.25,$1041.25,$114516.00,182,$1041.25
2024-09-12,19:21:00,19452.75,SELL,1,0.02h,Stop Loss,$54.00,$1095.25,$114570.00,182,$1095.25
2024-09-12,19:25:00,19684.75,BUY,1,0.02h,Stop Loss,$12.75,$1108.00,$114582.75,182,$1108.00
2024-09-12,19:35:00,19445.0,SELL,1,0.02h,Break Even,$0.25,$1108.25,$114583.00,182,$1108.25
2024-09-12,19:45:00,19690.0,BUY,1,0.02h,Break Even,$0.25,$1108.50,$114583.25,182,$1108.50
2024-09-12,19:47:00,19443.5,SELL,1,0.02h,Stop Loss,$-6.00,$1102.50,$114577.25,182,$1102.50
2024-09-12,19:48:00,19670.5,BUY,1,0.02h,Stop Loss,$4.00,$1106.50,$114581.25,182,$1106.50
2024-09-12,19:52:00,19437.25,SELL,1,0.02h,Stop Loss,$-6.00,$1100.50,$114575.25,182,$1100.50
2024-09-12,19:53:00,19665.0,BUY,1,0.02h,Stop Loss,$10.25,$1110.75,$114585.50,182,$1110.75
2024-09-12,19:56:00,19431.25,SELL,1,0.02h,Stop Loss,$-6.00,$1104.75,$114579.50,182,$1104.75
2024-09-12,19:57:00,19669.75,BUY,1,0.02h,Stop Loss,$-6.00,$1098.75,$114573.50,182,$1098.75
2024-09-12,19:58:00,19431.0,SELL,1,0.02h,Break Even,$0.25,$1099.00,$114573.75,182,$1099.00
2024-09-12,20:01:00,19683.0,BUY,1,0.02h,Stop Loss,$25.25,$1124.25,$114599.00,182,$1124.25
2024-09-12,20:04:00,19447.75,SELL,1,0.02h,Stop Loss,$-6.00,$1118.25,$114593.00,182,$1118.25
2024-09-12,20:05:00,19683.0,BUY,1,0.02h,Stop Loss,$-6.00,$1112.25,$114587.00,182,$1112.25
2024-09-12,20:07:00,19419.5,SELL,1,0.02h,Stop Loss,$74.00,$1186.25,$114661.00,182,$1186.25
2024-09-12,20:14:00,19653.25,BUY,1,0.03h,Break Even,$0.25,$1186.50,$114661.25,182,$1186.50
2024-09-12,20:23:00,19429.5,SELL,1,0.02h,Stop Loss,$-6.00,$1180.50,$114655.25,182,$1180.50
2024-09-12,20:25:00,19662.25,BUY,1,0.02h,Stop Loss,$-6.00,$1174.50,$114649.25,182,$1174.50
2024-09-12,20:26:00,19429.0,SELL,1,0.02h,Break Even,$0.25,$1174.75,$114649.50,182,$1174.75
2024-09-12,20:32:00,19663.5,BUY,1,0.02h,Stop Loss,$14.00,$1188.75,$114663.50,182,$1188.75
2024-09-12,20:37:00,19423.0,SELL,1,0.02h,Stop Loss,$-6.00,$1182.75,$114657.50,182,$1182.75
2024-09-12,20:38:00,19660.5,BUY,1,0.02h,Stop Loss,$-6.00,$1176.75,$114651.50,182,$1176.75
2024-09-12,20:39:00,19422.25,SELL,1,0.02h,Stop Loss,$-6.00,$1170.75,$114645.50,182,$1170.75
2024-09-12,20:41:00,19659.0,BUY,1,0.02h,Stop Loss,$-6.00,$1164.75,$114639.50,182,$1164.75
2024-09-12,20:42:00,19428.0,SELL,1,0.02h,Break Even,$0.25,$1165.00,$114639.75,182,$1165.00
2024-09-12,20:53:00,19652.5,BUY,1,0.02h,Stop Loss,$-6.00,$1159.00,$114633.75,182,$1159.00
2024-09-12,20:54:00,19417.5,SELL,1,0.02h,Stop Loss,$-6.00,$1153.00,$114627.75,182,$1153.00
2024-09-12,20:55:00,19651.0,BUY,1,0.02h,Stop Loss,$-6.00,$1147.00,$114621.75,182,$1147.00
2024-09-12,20:56:00,19417.75,SELL,1,0.02h,Stop Loss,$-6.00,$1141.00,$114615.75,182,$1141.00
2024-09-12,20:58:00,19653.5,BUY,1,0.02h,Stop Loss,$-6.00,$1135.00,$114609.75,182,$1135.00
2024-09-12,20:59:00,19412.5,SELL,1,0.02h,Stop Loss,$-6.00,$1129.00,$114603.75,182,$1129.00
2024-09-12,21:00:00,19647.25,BUY,1,1.02h,Stop Loss,$22.75,$1151.75,$114626.50,182,$1151.75
2024-09-12,22:07:00,19423.0,SELL,1,0.02h,Break Even,$0.25,$1152.00,$114626.75,182,$1152.00
2024-09-12,22:11:00,19660.0,BUY,1,0.03h,Stop Loss,$19.00,$1171.00,$114645.75,182,$1171.00
2024-09-12,22:22:00,19431.75,SELL,1,0.02h,Stop Loss,$-6.00,$1165.00,$114639.75,182,$1165.00
2024-09-12,22:25:00,19665.0,BUY,1,0.02h,Break Even,$0.25,$1165.25,$114640.00,182,$1165.25
2024-09-12,22:29:00,19437.5,SELL,1,0.02h,Break Even,$0.25,$1165.50,$114640.25,182,$1165.50
2024-09-12,22:40:00,19671.5,BUY,1,0.02h,Stop Loss,$-6.00,$1159.50,$114634.25,182,$1159.50
2024-09-12,22:41:00,19437.75,SELL,1,0.02h,Stop Loss,$-6.00,$1153.50,$114628.25,182,$1153.50
2024-09-12,22:42:00,19673.25,BUY,1,0.02h,Stop Loss,$-6.00,$1147.50,$114622.25,182,$1147.50
2024-09-12,22:43:00,19437.0,SELL,1,0.02h,Stop Loss,$-6.00,$1141.50,$114616.25,182,$1141.50
2024-09-12,22:44:00,19673.0,BUY,1,0.02h,Break Even,$0.25,$1141.75,$114616.50,182,$1141.75
2024-09-12,22:47:00,19444.5,SELL,1,0.02h,Break Even,$0.25,$1142.00,$114616.75,182,$1142.00
2024-09-12,23:00:00,19677.0,BUY,1,13.00h,Stop Loss,$-6.00,$1136.00,$114610.75,182,$1136.00
Final P&L Day: 1136.00,,,,,,,,,,,
2024-09-13,12:00:00,19453.75,SELL,1,0.02h,Stop Loss,$4.00,$4.00,$114614.75,183,$4.00
2024-09-13,12:02:00,19696.0,BUY,1,0.02h,Stop Loss,$-6.00,$-2.00,$114608.75,183,$-2.00
2024-09-13,12:04:00,19462.0,SELL,1,0.02h,Stop Loss,$-6.00,$-8.00,$114602.75,183,$-8.00
2024-09-13,12:05:00,19701.0,BUY,1,0.02h,Stop Loss,$-6.00,$-14.00,$114596.75,183,$-14.00
2024-09-13,12:22:00,19462.75,SELL,1,0.02h,Stop Loss,$-6.00,$-20.00,$114590.75,183,$-20.00
2024-09-13,12:23:00,19696.25,BUY,1,0.02h,Stop Loss,$-6.00,$-26.00,$114584.75,183,$-26.00
2024-09-13,12:24:00,19458.25,SELL,1,0.02h,Stop Loss,$-6.00,$-32.00,$114578.75,183,$-32.00
2024-09-13,12:30:00,19688.75,BUY,1,0.02h,Stop Loss,$-6.00,$-38.00,$114572.75,183,$-38.00
2024-09-13,12:31:00,19448.25,SELL,1,0.02h,Break Even,$0.25,$-37.75,$114573.00,183,$-37.75
2024-09-13,12:33:00,19688.0,BUY,1,0.02h,Stop Loss,$11.50,$-26.25,$114584.50,183,$-26.25
2024-09-13,12:35:00,19448.75,SELL,1,0.02h,Stop Loss,$-6.00,$-32.25,$114578.50,183,$-32.25
2024-09-13,12:36:00,19686.0,BUY,1,0.02h,Break Even,$0.25,$-32.00,$114578.75,183,$-32.00
2024-09-13,12:42:00,19421.5,SELL,1,0.02h,Stop Loss,$29.00,$-3.00,$114607.75,183,$-3.00
2024-09-13,12:45:00,19669.0,BUY,1,0.02h,Stop Loss,$17.75,$14.75,$114625.50,183,$14.75
2024-09-13,12:50:00,19442.75,SELL,1,0.02h,Stop Loss,$-6.00,$8.75,$114619.50,183,$8.75
2024-09-13,13:01:00,19685.75,BUY,1,0.02h,Stop Loss,$-6.00,$2.75,$114613.50,183,$2.75
2024-09-13,13:02:00,19446.75,SELL,1,0.02h,Stop Loss,$-6.00,$-3.25,$114607.50,183,$-3.25
2024-09-13,13:03:00,19680.5,BUY,1,0.02h,Break Even,$0.25,$-3.00,$114607.75,183,$-3.00
2024-09-13,13:17:00,19430.0,SELL,1,0.02h,Stop Loss,$-6.00,$-9.00,$114601.75,183,$-9.00
2024-09-13,13:28:00,19671.5,BUY,1,0.02h,Stop Loss,$-6.00,$-15.00,$114595.75,183,$-15.00
2024-09-13,13:33:00,19420.75,SELL,1,0.02h,Stop Loss,$-6.00,$-21.00,$114589.75,183,$-21.00
2024-09-13,13:34:00,19673.25,BUY,1,0.02h,Stop Loss,$-6.00,$-27.00,$114583.75,183,$-27.00
2024-09-13,13:35:00,19446.5,SELL,1,0.02h,Stop Loss,$-6.00,$-33.00,$114577.75,183,$-33.00
2024-09-13,13:36:00,19683.5,BUY,1,0.02h,Stop Loss,$70.25,$37.25,$114648.00,183,$37.25
2024-09-13,13:40:00,19470.75,SELL,1,0.02h,Stop Loss,$11.50,$48.75,$114659.50,183,$48.75
2024-09-13,13:42:00,19711.75,BUY,1,0.02h,Stop Loss,$42.75,$91.50,$114702.25,183,$91.50
2024-09-13,13:46:00,19477.5,SELL,1,0.02h,Stop Loss,$71.50,$163.00,$114773.75,183,$163.00
2024-09-13,13:49:00,19725.0,BUY,1,0.02h,Stop Loss,$-6.00,$157.00,$114767.75,183,$157.00
2024-09-13,13:50:00,19474.5,SELL,1,0.02h,Stop Loss,$35.25,$192.25,$114803.00,183,$192.25
2024-09-13,13:52:00,19720.75,BUY,1,0.02h,Stop Loss,$11.50,$203.75,$114814.50,183,$203.75
2024-09-13,13:55:00,19479.0,SELL,1,0.02h,Stop Loss,$-6.00,$197.75,$114808.50,183,$197.75
2024-09-13,13:56:00,19708.5,BUY,1,0.02h,Stop Loss,$-6.00,$191.75,$114802.50,183,$191.75
2024-09-13,13:57:00,19477.25,SELL,1,0.02h,Stop Loss,$-6.00,$185.75,$114796.50,183,$185.75
2024-09-13,13:58:00,19704.75,BUY,1,0.02h,Stop Loss,$27.75,$213.50,$114824.25,183,$213.50
2024-09-13,14:01:00,19459.5,SELL,1,0.02h,Stop Loss,$11.50,$225.00,$114835.75,183,$225.00
2024-09-13,14:04:00,19703.0,BUY,1,0.02h,Stop Loss,$-6.00,$219.00,$114829.75,183,$219.00
2024-09-13,14:05:00,19482.25,SELL,1,0.02h,Stop Loss,$-6.00,$213.00,$114823.75,183,$213.00
2024-09-13,14:06:00,19711.0,BUY,1,0.02h,Stop Loss,$116.50,$329.50,$114940.25,183,$329.50
2024-09-13,14:09:00,19502.5,SELL,1,0.02h,Break Even,$0.25,$329.75,$114940.50,183,$329.75
2024-09-13,14:13:00,19742.5,BUY,1,0.02h,Stop Loss,$-6.00,$323.75,$114934.50,183,$323.75
2024-09-13,14:14:00,19484.75,SELL,1,0.02h,Stop Loss,$35.25,$359.00,$114969.75,183,$359.00
2024-09-13,14:16:00,19738.0,BUY,1,0.02h,Stop Loss,$-6.00,$353.00,$114963.75,183,$353.00
2024-09-13,14:17:00,19506.0,SELL,1,0.02h,Break Even,$0.25,$353.25,$114964.00,183,$353.25
2024-09-13,14:21:00,19740.25,BUY,1,0.02h,Break Even,$0.25,$353.50,$114964.25,183,$353.50
2024-09-13,14:27:00,19494.25,SELL,1,0.02h,Stop Loss,$82.75,$436.25,$115047.00,183,$436.25
2024-09-13,14:38:00,19698.25,BUY,1,0.02h,Stop Loss,$19.00,$455.25,$115066.00,183,$455.25
2024-09-13,14:52:00,19502.25,SELL,1,0.02h,Stop Loss,$62.75,$518.00,$115128.75,183,$518.00
2024-09-13,14:55:00,19744.75,BUY,1,0.02h,Stop Loss,$-6.00,$512.00,$115122.75,183,$512.00
2024-09-13,14:56:00,19514.75,SELL,1,0.02h,Stop Loss,$-6.00,$506.00,$115116.75,183,$506.00
2024-09-13,15:00:00,19749.25,BUY,1,0.02h,Stop Loss,$10.25,$516.25,$115127.00,183,$516.25
2024-09-13,15:11:00,19518.25,SELL,1,0.02h,Stop Loss,$7.75,$524.00,$115134.75,183,$524.00
2024-09-13,15:13:00,19764.75,BUY,1,0.02h,Stop Loss,$21.50,$545.50,$115156.25,183,$545.50
2024-09-13,15:23:00,19536.25,SELL,1,0.02h,Stop Loss,$-6.00,$539.50,$115150.25,183,$539.50
2024-09-13,15:33:00,19761.5,BUY,1,0.02h,Stop Loss,$-6.00,$533.50,$115144.25,183,$533.50
2024-09-13,15:34:00,19522.0,SELL,1,0.02h,Stop Loss,$11.50,$545.00,$115155.75,183,$545.00
2024-09-13,15:40:00,19745.5,BUY,1,0.02h,Stop Loss,$-6.00,$539.00,$115149.75,183,$539.00
2024-09-13,15:41:00,19526.0,SELL,1,0.02h,Stop Loss,$22.75,$561.75,$115172.50,183,$561.75
2024-09-13,15:43:00,19762.25,BUY,1,0.02h,Break Even,$0.25,$562.00,$115172.75,183,$562.00
2024-09-13,15:50:00,19531.25,SELL,1,0.02h,Stop Loss,$27.75,$589.75,$115200.50,183,$589.75
2024-09-13,15:52:00,19765.5,BUY,1,0.02h,Stop Loss,$11.50,$601.25,$115212.00,183,$601.25
2024-09-13,15:58:00,19538.5,SELL,1,0.02h,Stop Loss,$22.75,$624.00,$115234.75,183,$624.00
2024-09-13,16:04:00,19782.75,BUY,1,0.02h,Stop Loss,$-6.00,$618.00,$115228.75,183,$618.00
2024-09-13,16:05:00,19547.25,SELL,1,0.02h,Stop Loss,$42.75,$660.75,$115271.50,183,$660.75
2024-09-13,16:12:00,19757.0,BUY,1,0.02h,Stop Loss,$-6.00,$654.75,$115265.50,183,$654.75
2024-09-13,16:13:00,19527.25,SELL,1,0.02h,Stop Loss,$114.00,$768.75,$115379.50,183,$768.75
2024-09-13,16:15:00,19741.25,BUY,1,0.02h,Stop Loss,$-6.00,$762.75,$115373.50,183,$762.75
2024-09-13,16:16:00,19492.75,SELL,1,0.02h,Stop Loss,$19.00,$781.75,$115392.50,183,$781.75
2024-09-13,16:19:00,19731.25,BUY,1,0.02h,Stop Loss,$15.25,$797.00,$115407.75,183,$797.00
2024-09-13,16:42:00,19494.25,SELL,1,0.02h,Stop Loss,$-6.00,$791.00,$115401.75,183,$791.00
2024-09-13,16:46:00,19724.5,BUY,1,0.02h,Stop Loss,$5.25,$796.25,$115407.00,183,$796.25
2024-09-13,16:50:00,19489.75,SELL,1,0.02h,Stop Loss,$-6.00,$790.25,$115401.00,183,$790.25
2024-09-13,17:01:00,19778.25,BUY,1,0.02h,Stop Loss,$-6.00,$784.25,$115395.00,183,$784.25
2024-09-13,17:02:00,19544.75,SELL,1,0.02h,Stop Loss,$25.25,$809.50,$115420.25,183,$809.50
2024-09-13,17:06:00,19787.25,BUY,1,0.02h,Stop Loss,$10.25,$819.75,$115430.50,183,$819.75
2024-09-13,17:11:00,19551.5,SELL,1,0.02h,Stop Loss,$11.50,$831.25,$115442.00,183,$831.25
2024-09-13,17:17:00,19792.5,BUY,1,0.02h,Stop Loss,$-6.00,$825.25,$115436.00,183,$825.25
2024-09-13,17:18:00,19559.75,SELL,1,0.02h,Stop Loss,$-6.00,$819.25,$115430.00,183,$819.25
2024-09-13,17:19:00,19798.5,BUY,1,0.02h,Stop Loss,$-6.00,$813.25,$115424.00,183,$813.25
2024-09-13,17:28:00,19549.75,SELL,1,0.02h,Break Even,$0.25,$813.50,$115424.25,183,$813.50
2024-09-13,17:33:00,19803.0,BUY,1,0.02h,Break Even,$0.25,$813.75,$115424.50,183,$813.75
2024-09-13,17:42:00,19556.5,SELL,1,0.02h,Stop Loss,$10.25,$824.00,$115434.75,183,$824.00
2024-09-13,17:45:00,19800.75,BUY,1,0.02h,Stop Loss,$-6.00,$818.00,$115428.75,183,$818.00
2024-09-13,17:46:00,19563.25,SELL,1,0.02h,Stop Loss,$-6.00,$812.00,$115422.75,183,$812.00
2024-09-13,17:47:00,19802.0,BUY,1,0.02h,Break Even,$0.25,$812.25,$115423.00,183,$812.25
2024-09-13,17:54:00,19571.75,SELL,1,0.02h,Stop Loss,$-6.00,$806.25,$115417.00,183,$806.25
2024-09-13,17:55:00,19804.5,BUY,1,0.02h,Stop Loss,$-6.00,$800.25,$115411.00,183,$800.25
2024-09-13,17:56:00,19569.0,SELL,1,0.02h,Stop Loss,$-6.00,$794.25,$115405.00,183,$794.25
2024-09-13,17:57:00,19806.5,BUY,1,0.02h,Stop Loss,$-6.00,$788.25,$115399.00,183,$788.25
2024-09-13,17:58:00,19568.25,SELL,1,0.02h,Stop Loss,$-6.00,$782.25,$115393.00,183,$782.25
2024-09-13,18:02:00,19780.5,BUY,1,0.02h,Stop Loss,$-6.00,$776.25,$115387.00,183,$776.25
2024-09-13,18:03:00,19545.0,SELL,1,0.02h,Stop Loss,$-6.00,$770.25,$115381.00,183,$770.25
2024-09-13,18:05:00,19782.5,BUY,1,0.02h,Stop Loss,$34.00,$804.25,$115415.00,183,$804.25
2024-09-13,18:08:00,19566.25,SELL,1,0.02h,Break Even,$0.25,$804.50,$115415.25,183,$804.50
2024-09-13,18:17:00,19776.75,BUY,1,0.02h,Stop Loss,$-6.00,$798.50,$115409.25,183,$798.50
2024-09-13,18:18:00,19537.0,SELL,1,0.02h,Stop Loss,$15.25,$813.75,$115424.50,183,$813.75
2024-09-13,18:24:00,19764.25,BUY,1,0.02h,Stop Loss,$-6.00,$807.75,$115418.50,183,$807.75
2024-09-13,18:25:00,19512.5,SELL,1,0.02h,Stop Loss,$-6.00,$801.75,$115412.50,183,$801.75
2024-09-13,18:27:00,19751.25,BUY,1,0.02h,Stop Loss,$-6.00,$795.75,$115406.50,183,$795.75
2024-09-13,18:28:00,19510.0,SELL,1,0.02h,Stop Loss,$-6.00,$789.75,$115400.50,183,$789.75
2024-09-13,18:36:00,19738.75,BUY,1,0.02h,Stop Loss,$20.25,$810.00,$115420.75,183,$810.00
2024-09-13,18:38:00,19503.0,SELL,1,0.02h,Stop Loss,$-6.00,$804.00,$115414.75,183,$804.00
2024-09-13,18:46:00,19761.75,BUY,1,0.02h,Stop Loss,$-6.00,$798.00,$115408.75,183,$798.00
2024-09-13,18:47:00,19523.0,SELL,1,0.02h,Stop Loss,$21.50,$819.50,$115430.25,183,$819.50
2024-09-13,18:49:00,19749.0,BUY,1,0.02h,Stop Loss,$-6.00,$813.50,$115424.25,183,$813.50
2024-09-13,18:50:00,19510.5,SELL,1,0.02h,Stop Loss,$-6.00,$807.50,$115418.25,183,$807.50
2024-09-13,18:51:00,19736.75,BUY,1,0.02h,Stop Loss,$-6.00,$801.50,$115412.25,183,$801.50
2024-09-13,18:52:00,19506.25,SELL,1,0.02h,Stop Loss,$21.50,$823.00,$115433.75,183,$823.00
2024-09-13,18:57:00,19746.0,BUY,1,0.02h,Stop Loss,$-6.00,$817.00,$115427.75,183,$817.00
2024-09-13,18:58:00,19509.5,SELL,1,0.02h,Stop Loss,$5.25,$822.25,$115433.00,183,$822.25
2024-09-13,19:09:00,19740.5,BUY,1,0.02h,Stop Loss,$-6.00,$816.25,$115427.00,183,$816.25
2024-09-13,19:10:00,19504.75,SELL,1,0.02h,Stop Loss,$-6.00,$810.25,$115421.00,183,$810.25
2024-09-13,19:11:00,19738.75,BUY,1,0.02h,Break Even,$0.25,$810.50,$115421.25,183,$810.50
2024-09-13,19:15:00,19511.75,SELL,1,0.02h,Stop Loss,$-6.00,$804.50,$115415.25,183,$804.50
2024-09-13,19:16:00,19750.25,BUY,1,0.02h,Stop Loss,$22.75,$827.25,$115438.00,183,$827.25
2024-09-13,19:24:00,19525.0,SELL,1,0.02h,Stop Loss,$-6.00,$821.25,$115432.00,183,$821.25
2024-09-13,19:25:00,19765.0,BUY,1,0.02h,Stop Loss,$-6.00,$815.25,$115426.00,183,$815.25
2024-09-13,19:42:00,19528.5,SELL,1,0.02h,Break Even,$0.25,$815.50,$115426.25,183,$815.50
2024-09-13,19:45:00,19771.0,BUY,1,0.02h,Stop Loss,$-6.00,$809.50,$115420.25,183,$809.50
2024-09-13,19:46:00,19536.75,SELL,1,0.02h,Break Even,$0.25,$809.75,$115420.50,183,$809.75
2024-09-13,19:53:00,19780.5,BUY,1,0.02h,Break Even,$0.25,$810.00,$115420.75,183,$810.00
2024-09-13,19:58:00,19537.25,SELL,1,0.02h,Break Even,$0.25,$810.25,$115421.00,183,$810.25
2024-09-13,20:02:00,19752.5,BUY,1,0.02h,Stop Loss,$-6.00,$804.25,$115415.00,183,$804.25
2024-09-13,20:03:00,19507.0,SELL,1,0.02h,Stop Loss,$-6.00,$798.25,$115409.00,183,$798.25
2024-09-13,20:14:00,19743.0,BUY,1,0.02h,Stop Loss,$17.75,$816.00,$115426.75,183,$816.00
2024-09-13,20:18:00,19517.5,SELL,1,0.02h,Stop Loss,$-6.00,$810.00,$115420.75,183,$810.00
2024-09-13,20:19:00,19755.5,BUY,1,0.02h,Stop Loss,$-6.00,$804.00,$115414.75,183,$804.00
2024-09-13,20:20:00,19519.5,SELL,1,0.02h,Break Even,$0.25,$804.25,$115415.00,183,$804.25
2024-09-13,20:29:00,19758.75,BUY,1,0.02h,Break Even,$0.25,$804.50,$115415.25,183,$804.50
2024-09-13,20:32:00,19518.5,SELL,1,0.02h,Stop Loss,$-6.00,$798.50,$115409.25,183,$798.50
2024-09-13,20:41:00,19756.5,BUY,1,0.02h,Stop Loss,$-6.00,$792.50,$115403.25,183,$792.50
2024-09-13,20:42:00,19520.75,SELL,1,0.02h,Stop Loss,$-6.00,$786.50,$115397.25,183,$786.50
2024-09-13,20:43:00,19757.75,BUY,1,0.03h,Stop Loss,$-6.00,$780.50,$115391.25,183,$780.50
2024-09-13,20:54:00,19506.0,SELL,1,0.02h,Stop Loss,$-6.00,$774.50,$115385.25,183,$774.50
2024-09-13,20:55:00,19742.75,BUY,1,0.02h,Stop Loss,$-6.00,$768.50,$115379.25,183,$768.50
2024-09-13,20:56:00,19503.5,SELL,1,0.02h,Stop Loss,$-6.00,$762.50,$115373.25,183,$762.50
2024-09-13,20:57:00,19741.0,BUY,1,0.05h,Break Even,$0.25,$762.75,$115373.50,183,$762.75
Final P&L Day: 762.75,,,,,,,,,,,
2024-09-16,12:21:00,19676.75,SELL,1,0.02h,Break Even,$0.25,$0.25,$115373.75,184,$0.25
2024-09-16,12:41:00,19678.25,BUY,1,0.02h,Stop Loss,$-6.00,$-5.75,$115367.75,184,$-5.75
2024-09-16,12:42:00,19669.25,SELL,1,0.02h,Stop Loss,$-6.00,$-11.75,$115361.75,184,$-11.75
2024-09-16,13:01:00,19673.5,BUY,1,0.02h,Stop Loss,$10.25,$-1.50,$115372.00,184,$-1.50
2024-09-16,13:08:00,19667.0,SELL,1,0.02h,Stop Loss,$-6.00,$-7.50,$115366.00,184,$-7.50
2024-09-16,13:50:00,19641.75,BUY,1,0.02h,Stop Loss,$46.50,$39.00,$115412.50,184,$39.00
2024-09-16,14:21:00,19640.75,SELL,1,0.02h,Stop Loss,$-6.00,$33.00,$115406.50,184,$33.00
2024-09-16,15:12:00,19597.75,BUY,1,0.02h,Stop Loss,$37.75,$70.75,$115444.25,184,$70.75
2024-09-16,15:39:00,19595.0,SELL,1,0.02h,Stop Loss,$-6.00,$64.75,$115438.25,184,$64.75
2024-09-16,15:59:00,19597.5,BUY,1,0.02h,Break Even,$0.25,$65.00,$115438.50,184,$65.00
2024-09-16,16:14:00,19583.5,SELL,1,0.02h,Break Even,$0.25,$65.25,$115438.75,184,$65.25
2024-09-16,16:29:00,19598.25,BUY,1,0.02h,Break Even,$0.25,$65.50,$115439.00,184,$65.50
2024-09-16,16:45:00,19577.75,SELL,1,0.02h,Stop Loss,$4.00,$69.50,$115443.00,184,$69.50
2024-09-16,16:51:00,19599.5,BUY,1,0.02h,Stop Loss,$22.75,$92.25,$115465.75,184,$92.25
2024-09-16,17:20:00,19606.75,SELL,1,0.02h,Stop Loss,$15.25,$107.50,$115481.00,184,$107.50
2024-09-16,17:26:00,19623.0,BUY,1,0.02h,Stop Loss,$25.25,$132.75,$115506.25,184,$132.75
2024-09-16,18:08:00,19641.25,SELL,1,0.02h,Break Even,$0.25,$133.00,$115506.50,184,$133.00
2024-09-16,18:12:00,19665.75,BUY,1,0.02h,Stop Loss,$5.25,$138.25,$115511.75,184,$138.25
2024-09-16,18:41:00,19645.25,SELL,1,0.02h,Stop Loss,$-6.00,$132.25,$115505.75,184,$132.25
2024-09-16,19:00:00,19665.5,BUY,1,0.02h,Break Even,$0.25,$132.50,$115506.00,184,$132.50
2024-09-16,19:15:00,19648.0,SELL,1,0.02h,Stop Loss,$20.25,$152.75,$115526.25,184,$152.75
2024-09-16,19:32:00,19654.0,BUY,1,0.02h,Stop Loss,$7.75,$160.50,$115534.00,184,$160.50
2024-09-16,20:03:00,19664.25,SELL,1,0.02h,Stop Loss,$9.00,$169.50,$115543.00,184,$169.50
2024-09-16,20:23:00,19667.5,BUY,1,0.02h,Break Even,$0.25,$169.75,$115543.25,184,$169.75
2024-09-16,20:34:00,19662.0,SELL,1,0.02h,Break Even,$0.25,$170.00,$115543.50,184,$170.00
2024-09-16,22:04:00,19661.75,BUY,1,0.02h,Stop Loss,$25.25,$195.25,$115568.75,184,$195.25
2024-09-16,22:51:00,19686.0,SELL,1,0.02h,Stop Loss,$-6.00,$189.25,$115562.75,184,$189.25
2024-09-16,22:53:00,19690.75,BUY,1,0.02h,Stop Loss,$6.50,$195.75,$115569.25,184,$195.75
2024-09-16,22:57:00,19683.0,SELL,1,0.02h,Break Even,$0.25,$196.00,$115569.50,184,$196.00
Final P&L Day: 196.00,,,,,,,,,,,
2024-09-17,12:01:00,19793.25,BUY,1,0.02h,Stop Loss,$-6.00,$-6.00,$115563.50,185,$-6.00
2024-09-17,12:03:00,19557.5,SELL,1,0.02h,Break Even,$0.25,$-5.75,$115563.75,185,$-5.75
2024-09-17,12:12:00,19782.75,BUY,1,0.02h,Stop Loss,$-6.00,$-11.75,$115557.75,185,$-11.75
2024-09-17,12:18:00,19534.0,SELL,1,0.02h,Break Even,$0.25,$-11.50,$115558.00,185,$-11.50
2024-09-17,12:25:00,19773.5,BUY,1,0.02h,Stop Loss,$10.25,$-1.25,$115568.25,185,$-1.25
2024-09-17,12:27:00,19542.5,SELL,1,0.02h,Stop Loss,$-6.00,$-7.25,$115562.25,185,$-7.25
2024-09-17,12:28:00,19780.5,BUY,1,0.02h,Stop Loss,$-6.00,$-13.25,$115556.25,185,$-13.25
2024-09-17,12:29:00,19548.5,SELL,1,0.02h,Stop Loss,$32.75,$19.50,$115589.00,185,$19.50
2024-09-17,12:31:00,19788.0,BUY,1,0.02h,Break Even,$0.25,$19.75,$115589.25,185,$19.75
2024-09-17,12:40:00,19550.75,SELL,1,0.02h,Break Even,$0.25,$20.00,$115589.50,185,$20.00
2024-09-17,12:48:00,19782.0,BUY,1,0.02h,Stop Loss,$5.25,$25.25,$115594.75,185,$25.25
2024-09-17,13:01:00,19567.75,SELL,1,0.02h,Stop Loss,$-6.00,$19.25,$115588.75,185,$19.25
2024-09-17,13:02:00,19801.75,BUY,1,0.02h,Break Even,$0.25,$19.50,$115589.00,185,$19.50
2024-09-17,13:08:00,19573.0,SELL,1,0.02h,Stop Loss,$-6.00,$13.50,$115583.00,185,$13.50
2024-09-17,13:10:00,19810.0,BUY,1,0.02h,Break Even,$0.25,$13.75,$115583.25,185,$13.75
2024-09-17,13:15:00,19568.5,SELL,1,0.02h,Break Even,$0.25,$14.00,$115583.50,185,$14.00
2024-09-17,13:20:00,19797.5,BUY,1,0.02h,Stop Loss,$-6.00,$8.00,$115577.50,185,$8.00
2024-09-17,13:24:00,19558.0,SELL,1,0.02h,Break Even,$0.25,$8.25,$115577.75,185,$8.25
2024-09-17,13:36:00,19768.25,BUY,1,0.02h,Stop Loss,$111.50,$119.75,$115689.25,185,$119.75
2024-09-17,13:38:00,19539.75,SELL,1,0.02h,Stop Loss,$72.75,$192.50,$115762.00,185,$192.50
2024-09-17,13:48:00,19797.0,BUY,1,0.02h,Stop Loss,$44.00,$236.50,$115806.00,185,$236.50
2024-09-17,14:01:00,19514.5,SELL,1,0.02h,Stop Loss,$26.50,$263.00,$115832.50,185,$263.00
2024-09-17,14:04:00,19778.0,BUY,1,0.02h,Stop Loss,$69.00,$332.00,$115901.50,185,$332.00
2024-09-17,14:25:00,19559.75,SELL,1,0.02h,Stop Loss,$-6.00,$326.00,$115895.50,185,$326.00
2024-09-17,14:27:00,19802.5,BUY,1,0.02h,Stop Loss,$21.50,$347.50,$115917.00,185,$347.50
2024-09-17,14:33:00,19557.0,SELL,1,0.02h,Stop Loss,$87.75,$435.25,$116004.75,185,$435.25
2024-09-17,14:45:00,19817.75,BUY,1,0.02h,Stop Loss,$119.00,$554.25,$116123.75,185,$554.25
2024-09-17,14:55:00,19581.75,SELL,1,0.02h,Stop Loss,$-6.00,$548.25,$116117.75,185,$548.25
2024-09-17,14:56:00,19816.25,BUY,1,0.02h,Break Even,$0.25,$548.50,$116118.00,185,$548.50
2024-09-17,14:59:00,19546.25,SELL,1,0.02h,Stop Loss,$159.00,$707.50,$116277.00,185,$707.50
2024-09-17,15:06:00,19773.0,BUY,1,0.02h,Stop Loss,$30.25,$737.75,$116307.25,185,$737.75
2024-09-17,15:14:00,19561.0,SELL,1,0.02h,Stop Loss,$-6.00,$731.75,$116301.25,185,$731.75
2024-09-17,15:15:00,19800.25,BUY,1,0.02h,Stop Loss,$21.50,$753.25,$116322.75,185,$753.25
2024-09-17,15:17:00,19576.0,SELL,1,0.02h,Stop Loss,$49.00,$802.25,$116371.75,185,$802.25
2024-09-17,15:23:00,19771.75,BUY,1,0.02h,Stop Loss,$44.00,$846.25,$116415.75,185,$846.25
2024-09-17,15:25:00,19553.25,SELL,1,0.02h,Break Even,$0.25,$846.50,$116416.00,185,$846.50
2024-09-17,15:44:00,19759.75,BUY,1,0.02h,Stop Loss,$-6.00,$840.50,$116410.00,185,$840.50
2024-09-17,15:45:00,19524.25,SELL,1,0.02h,Break Even,$0.25,$840.75,$116410.25,185,$840.75
2024-09-17,15:47:00,19776.25,BUY,1,0.02h,Stop Loss,$-6.00,$834.75,$116404.25,185,$834.75
2024-09-17,15:56:00,19521.5,SELL,1,0.02h,Stop Loss,$-6.00,$828.75,$116398.25,185,$828.75
2024-09-17,15:57:00,19767.5,BUY,1,0.02h,Stop Loss,$-6.00,$822.75,$116392.25,185,$822.75
2024-09-17,15:58:00,19531.5,SELL,1,0.02h,Stop Loss,$-6.00,$816.75,$116386.25,185,$816.75
2024-09-17,15:59:00,19772.5,BUY,1,0.02h,Stop Loss,$7.75,$824.50,$116394.00,185,$824.50
2024-09-17,16:02:00,19542.5,SELL,1,0.02h,Stop Loss,$-6.00,$818.50,$116388.00,185,$818.50
2024-09-17,16:03:00,19780.5,BUY,1,0.02h,Stop Loss,$7.75,$826.25,$116395.75,185,$826.25
2024-09-17,16:05:00,19530.0,SELL,1,0.02h,Stop Loss,$-6.00,$820.25,$116389.75,185,$820.25
2024-09-17,16:07:00,19767.0,BUY,1,0.02h,Stop Loss,$14.00,$834.25,$116403.75,185,$834.25
2024-09-17,16:09:00,19526.25,SELL,1,0.02h,Stop Loss,$21.50,$855.75,$116425.25,185,$855.75
2024-09-17,16:12:00,19754.25,BUY,1,0.02h,Break Even,$0.25,$856.00,$116425.50,185,$856.00
2024-09-17,16:15:00,19514.0,SELL,1,0.02h,Stop Loss,$-6.00,$850.00,$116419.50,185,$850.00
2024-09-17,16:16:00,19738.25,BUY,1,0.02h,Stop Loss,$-6.00,$844.00,$116413.50,185,$844.00
2024-09-17,16:18:00,19496.75,SELL,1,0.02h,Stop Loss,$115.25,$959.25,$116528.75,185,$959.25
2024-09-17,16:33:00,19689.5,BUY,1,0.02h,Stop Loss,$6.50,$965.75,$116535.25,185,$965.75
2024-09-17,16:39:00,19448.75,SELL,1,0.02h,Stop Loss,$-6.00,$959.75,$116529.25,185,$959.75
2024-09-17,16:55:00,19641.75,BUY,1,0.02h,Stop Loss,$60.25,$1020.00,$116589.50,185,$1020.00
2024-09-17,16:57:00,19424.25,SELL,1,0.02h,Stop Loss,$-6.00,$1014.00,$116583.50,185,$1014.00
2024-09-17,16:58:00,19658.5,BUY,1,0.02h,Break Even,$0.25,$1014.25,$116583.75,185,$1014.25
2024-09-17,17:03:00,19407.75,SELL,1,0.02h,Stop Loss,$21.50,$1035.75,$116605.25,185,$1035.75
2024-09-17,17:08:00,19635.75,BUY,1,0.02h,Stop Loss,$27.75,$1063.50,$116633.00,185,$1063.50
2024-09-17,17:10:00,19408.25,SELL,1,0.02h,Stop Loss,$32.75,$1096.25,$116665.75,185,$1096.25
2024-09-17,17:13:00,19634.75,BUY,1,0.02h,Stop Loss,$52.75,$1149.00,$116718.50,185,$1149.00
2024-09-17,17:15:00,19412.75,SELL,1,0.02h,Stop Loss,$25.25,$1174.25,$116743.75,185,$1174.25
2024-09-17,17:20:00,19654.0,BUY,1,0.02h,Stop Loss,$35.25,$1209.50,$116779.00,185,$1209.50
2024-09-17,17:31:00,19458.25,SELL,1,0.02h,Stop Loss,$21.50,$1231.00,$116800.50,185,$1231.00
2024-09-17,17:38:00,19667.5,BUY,1,0.02h,Stop Loss,$-6.00,$1225.00,$116794.50,185,$1225.00
2024-09-17,17:43:00,19389.75,SELL,1,0.02h,Stop Loss,$79.00,$1304.00,$116873.50,185,$1304.00
2024-09-17,17:53:00,19654.0,BUY,1,0.02h,Stop Loss,$71.50,$1375.50,$116945.00,185,$1375.50
2024-09-17,17:59:00,19426.25,SELL,1,0.02h,Break Even,$0.25,$1375.75,$116945.25,185,$1375.75
2024-09-17,18:03:00,19666.25,BUY,1,0.02h,Stop Loss,$22.75,$1398.50,$116968.00,185,$1398.50
2024-09-17,18:05:00,19435.75,SELL,1,0.02h,Stop Loss,$-6.00,$1392.50,$116962.00,185,$1392.50
2024-09-17,18:06:00,19671.0,BUY,1,0.02h,Break Even,$0.25,$1392.75,$116962.25,185,$1392.75
2024-09-17,18:09:00,19433.0,SELL,1,0.02h,Stop Loss,$-6.00,$1386.75,$116956.25,185,$1386.75
2024-09-17,18:19:00,19655.75,BUY,1,0.02h,Stop Loss,$-6.00,$1380.75,$116950.25,185,$1380.75
2024-09-17,18:20:00,19417.25,SELL,1,0.02h,Stop Loss,$-6.00,$1374.75,$116944.25,185,$1374.75
2024-09-17,18:21:00,19646.25,BUY,1,0.02h,Stop Loss,$105.25,$1480.00,$117049.50,185,$1480.00
2024-09-17,18:24:00,19443.25,SELL,1,0.02h,Stop Loss,$-6.00,$1474.00,$117043.50,185,$1474.00
2024-09-17,18:25:00,19678.0,BUY,1,0.02h,Stop Loss,$-6.00,$1468.00,$117037.50,185,$1468.00
2024-09-17,18:29:00,19427.75,SELL,1,0.02h,Stop Loss,$-6.00,$1462.00,$117031.50,185,$1462.00
2024-09-17,18:30:00,19662.0,BUY,1,0.02h,Stop Loss,$-6.00,$1456.00,$117025.50,185,$1456.00
2024-09-17,18:31:00,19417.5,SELL,1,0.02h,Stop Loss,$41.50,$1497.50,$117067.00,185,$1497.50
2024-09-17,18:37:00,19662.0,BUY,1,0.02h,Stop Loss,$-6.00,$1491.50,$117061.00,185,$1491.50
2024-09-17,18:38:00,19425.0,SELL,1,0.02h,Stop Loss,$-6.00,$1485.50,$117055.00,185,$1485.50
2024-09-17,18:39:00,19661.75,BUY,1,0.02h,Stop Loss,$-6.00,$1479.50,$117049.00,185,$1479.50
2024-09-17,18:40:00,19427.25,SELL,1,0.02h,Stop Loss,$-6.00,$1473.50,$117043.00,185,$1473.50
2024-09-17,18:41:00,19664.5,BUY,1,0.02h,Stop Loss,$-6.00,$1467.50,$117037.00,185,$1467.50
2024-09-17,18:45:00,19433.5,SELL,1,0.02h,Stop Loss,$-6.00,$1461.50,$117031.00,185,$1461.50
2024-09-17,18:46:00,19662.25,BUY,1,0.02h,Stop Loss,$-6.00,$1455.50,$117025.00,185,$1455.50
2024-09-17,18:47:00,19420.75,SELL,1,0.02h,Stop Loss,$-6.00,$1449.50,$117019.00,185,$1449.50
2024-09-17,18:48:00,19657.75,BUY,1,0.02h,Stop Loss,$-6.00,$1443.50,$117013.00,185,$1443.50
2024-09-17,18:49:00,19388.25,SELL,1,0.02h,Break Even,$0.25,$1443.75,$117013.25,185,$1443.75
2024-09-17,18:53:00,19624.0,BUY,1,0.02h,Stop Loss,$-6.00,$1437.75,$117007.25,185,$1437.75
2024-09-17,18:54:00,19378.0,SELL,1,0.02h,Stop Loss,$-6.00,$1431.75,$117001.25,185,$1431.75
2024-09-17,18:55:00,19631.25,BUY,1,0.02h,Stop Loss,$41.50,$1473.25,$117042.75,185,$1473.25
2024-09-17,18:59:00,19398.25,SELL,1,0.02h,Stop Loss,$-6.00,$1467.25,$117036.75,185,$1467.25
2024-09-17,19:00:00,19640.5,BUY,1,0.02h,Stop Loss,$-6.00,$1461.25,$117030.75,185,$1461.25
2024-09-17,19:01:00,19404.25,SELL,1,0.02h,Stop Loss,$-6.00,$1455.25,$117024.75,185,$1455.25
2024-09-17,19:02:00,19651.75,BUY,1,0.02h,Stop Loss,$-6.00,$1449.25,$117018.75,185,$1449.25
2024-09-17,19:03:00,19414.0,SELL,1,0.02h,Stop Loss,$-6.00,$1443.25,$117012.75,185,$1443.25
2024-09-17,19:04:00,19642.25,BUY,1,0.02h,Break Even,$0.25,$1443.50,$117013.00,185,$1443.50
2024-09-17,19:09:00,19413.75,SELL,1,0.02h,Break Even,$0.25,$1443.75,$117013.25,185,$1443.75
2024-09-17,19:13:00,19661.75,BUY,1,0.02h,Stop Loss,$-6.00,$1437.75,$117007.25,185,$1437.75
2024-09-17,19:14:00,19421.0,SELL,1,0.02h,Break Even,$0.25,$1438.00,$117007.50,185,$1438.00
2024-09-17,19:16:00,19664.25,BUY,1,0.02h,Break Even,$0.25,$1438.25,$117007.75,185,$1438.25
2024-09-17,19:31:00,19413.5,SELL,1,0.02h,Stop Loss,$-6.00,$1432.25,$117001.75,185,$1432.25
2024-09-17,19:43:00,19645.25,BUY,1,0.02h,Break Even,$0.25,$1432.50,$117002.00,185,$1432.50
2024-09-17,19:45:00,19403.75,SELL,1,0.02h,Break Even,$0.25,$1432.75,$117002.25,185,$1432.75
2024-09-17,19:49:00,19653.25,BUY,1,0.02h,Stop Loss,$21.50,$1454.25,$117023.75,185,$1454.25
2024-09-17,19:54:00,19436.5,SELL,1,0.02h,Break Even,$0.25,$1454.50,$117024.00,185,$1454.50
2024-09-17,20:00:00,19682.0,BUY,1,0.02h,Stop Loss,$-6.00,$1448.50,$117018.00,185,$1448.50
2024-09-17,20:25:00,19455.25,SELL,1,0.02h,Stop Loss,$-6.00,$1442.50,$117012.00,185,$1442.50
2024-09-17,20:33:00,19700.75,BUY,1,0.02h,Stop Loss,$-6.00,$1436.50,$117006.00,185,$1436.50
2024-09-17,20:34:00,19459.75,SELL,1,0.03h,Stop Loss,$-6.00,$1430.50,$117000.00,185,$1430.50
2024-09-17,20:44:00,19693.0,BUY,1,0.02h,Break Even,$0.25,$1430.75,$117000.25,185,$1430.75
2024-09-17,22:03:00,19445.75,SELL,1,0.03h,Stop Loss,$-6.00,$1424.75,$116994.25,185,$1424.75
2024-09-17,22:19:00,19691.5,BUY,1,0.02h,Stop Loss,$-6.00,$1418.75,$116988.25,185,$1418.75
2024-09-17,22:24:00,19458.5,SELL,1,0.02h,Stop Loss,$-6.00,$1412.75,$116982.25,185,$1412.75
2024-09-17,22:25:00,19693.5,BUY,1,0.02h,Stop Loss,$-6.00,$1406.75,$116976.25,185,$1406.75
2024-09-17,22:35:00,19457.25,SELL,1,0.02h,Stop Loss,$-6.00,$1400.75,$116970.25,185,$1400.75
2024-09-17,22:43:00,19689.75,BUY,1,0.02h,Stop Loss,$-6.00,$1394.75,$116964.25,185,$1394.75
2024-09-17,22:44:00,19453.5,SELL,1,0.03h,Break Even,$0.25,$1395.00,$116964.50,185,$1395.00
2024-09-17,22:46:00,19687.0,BUY,1,0.02h,Stop Loss,$-6.00,$1389.00,$116958.50,185,$1389.00
2024-09-17,22:47:00,19453.75,SELL,1,0.02h,Stop Loss,$-6.00,$1383.00,$116952.50,185,$1383.00
2024-09-17,22:52:00,19697.25,BUY,1,0.02h,Stop Loss,$-6.00,$1377.00,$116946.50,185,$1377.00
2024-09-17,22:53:00,19458.25,SELL,1,0.02h,Stop Loss,$-6.00,$1371.00,$116940.50,185,$1371.00
2024-09-17,22:54:00,19691.25,BUY,1,0.02h,Stop Loss,$-6.00,$1365.00,$116934.50,185,$1365.00
2024-09-17,22:55:00,19455.75,SELL,1,0.02h,Break Even,$0.25,$1365.25,$116934.75,185,$1365.25
2024-09-17,22:57:00,19684.5,BUY,1,0.02h,Stop Loss,$5.25,$1370.50,$116940.00,185,$1370.50
Final P&L Day: 1370.50,,,,,,,,,,,
2024-09-18,12:00:00,19467.5,SELL,1,0.02h,Stop Loss,$14.00,$14.00,$116954.00,186,$14.00
2024-09-18,12:07:00,19685.0,BUY,1,0.02h,Stop Loss,$9.00,$23.00,$116963.00,186,$23.00
2024-09-18,12:11:00,19452.25,SELL,1,0.02h,Stop Loss,$-6.00,$17.00,$116957.00,186,$17.00
2024-09-18,12:12:00,19684.75,BUY,1,0.02h,Stop Loss,$-6.00,$11.00,$116951.00,186,$11.00
2024-09-18,12:13:00,19447.25,SELL,1,0.02h,Stop Loss,$-6.00,$5.00,$116945.00,186,$5.00
2024-09-18,12:14:00,19679.5,BUY,1,0.02h,Stop Loss,$-6.00,$-1.00,$116939.00,186,$-1.00
2024-09-18,12:21:00,19451.5,SELL,1,0.02h,Stop Loss,$-6.00,$-7.00,$116933.00,186,$-7.00
2024-09-18,12:24:00,19695.0,BUY,1,0.02h,Stop Loss,$-6.00,$-13.00,$116927.00,186,$-13.00
2024-09-18,12:25:00,19461.5,SELL,1,0.02h,Stop Loss,$-6.00,$-19.00,$116921.00,186,$-19.00
2024-09-18,12:26:00,19696.75,BUY,1,0.02h,Stop Loss,$-6.00,$-25.00,$116915.00,186,$-25.00
2024-09-18,12:27:00,19459.5,SELL,1,0.02h,Stop Loss,$-6.00,$-31.00,$116909.00,186,$-31.00
2024-09-18,12:28:00,19698.25,BUY,1,0.02h,Break Even,$0.25,$-30.75,$116909.25,186,$-30.75
2024-09-18,12:30:00,19464.5,SELL,1,0.02h,Stop Loss,$-6.00,$-36.75,$116903.25,186,$-36.75
2024-09-18,12:41:00,19728.0,BUY,1,0.02h,Stop Loss,$-6.00,$-42.75,$116897.25,186,$-42.75
2024-09-18,12:42:00,19487.0,SELL,1,0.02h,Stop Loss,$-6.00,$-48.75,$116891.25,186,$-48.75
2024-09-18,12:43:00,19722.5,BUY,1,0.02h,Stop Loss,$4.00,$-44.75,$116895.25,186,$-44.75
2024-09-18,12:53:00,19486.0,SELL,1,0.02h,Stop Loss,$-6.00,$-50.75,$116889.25,186,$-50.75
2024-09-18,12:54:00,19721.75,BUY,1,0.02h,Break Even,$0.25,$-50.50,$116889.50,186,$-50.50
2024-09-18,13:00:00,19490.75,SELL,1,0.02h,Stop Loss,$-6.00,$-56.50,$116883.50,186,$-56.50
2024-09-18,13:06:00,19727.0,BUY,1,0.02h,Break Even,$0.25,$-56.25,$116883.75,186,$-56.25
2024-09-18,13:11:00,19488.0,SELL,1,0.02h,Stop Loss,$-6.00,$-62.25,$116877.75,186,$-62.25
2024-09-18,13:12:00,19725.75,BUY,1,0.02h,Stop Loss,$-6.00,$-68.25,$116871.75,186,$-68.25
2024-09-18,13:13:00,19492.75,SELL,1,0.02h,Stop Loss,$-6.00,$-74.25,$116865.75,186,$-74.25
2024-09-18,13:14:00,19728.25,BUY,1,0.02h,Stop Loss,$-6.00,$-80.25,$116859.75,186,$-80.25
2024-09-18,13:15:00,19494.0,SELL,1,0.02h,Stop Loss,$-6.00,$-86.25,$116853.75,186,$-86.25
2024-09-18,13:18:00,19726.75,BUY,1,0.02h,Stop Loss,$-6.00,$-92.25,$116847.75,186,$-92.25
2024-09-18,13:19:00,19489.75,SELL,1,0.02h,Stop Loss,$-6.00,$-98.25,$116841.75,186,$-98.25
2024-09-18,13:20:00,19727.75,BUY,1,0.02h,Break Even,$0.25,$-98.00,$116842.00,186,$-98.00
2024-09-18,13:29:00,19497.25,SELL,1,0.02h,Stop Loss,$24.00,$-74.00,$116866.00,186,$-74.00
2024-09-18,13:32:00,19712.25,BUY,1,0.02h,Stop Loss,$-6.00,$-80.00,$116860.00,186,$-80.00
2024-09-18,13:33:00,19480.75,SELL,1,0.02h,Stop Loss,$20.25,$-59.75,$116880.25,186,$-59.75
2024-09-18,13:52:00,19699.0,BUY,1,0.02h,Stop Loss,$-6.00,$-65.75,$116874.25,186,$-65.75
2024-09-18,13:53:00,19467.25,SELL,1,0.02h,Stop Loss,$16.50,$-49.25,$116890.75,186,$-49.25
2024-09-18,13:55:00,19694.25,BUY,1,0.02h,Stop Loss,$59.00,$9.75,$116949.75,186,$9.75
2024-09-18,14:03:00,19456.5,SELL,1,0.02h,Break Even,$0.25,$10.00,$116950.00,186,$10.00
2024-09-18,14:06:00,19698.5,BUY,1,0.02h,Stop Loss,$7.75,$17.75,$116957.75,186,$17.75
2024-09-18,14:10:00,19447.0,SELL,1,0.02h,Stop Loss,$21.50,$39.25,$116979.25,186,$39.25
2024-09-18,14:14:00,19668.0,BUY,1,0.02h,Stop Loss,$-6.00,$33.25,$116973.25,186,$33.25
2024-09-18,14:15:00,19452.0,SELL,1,0.02h,Stop Loss,$-6.00,$27.25,$116967.25,186,$27.25
2024-09-18,14:16:00,19687.5,BUY,1,0.02h,Stop Loss,$-6.00,$21.25,$116961.25,186,$21.25
2024-09-18,14:17:00,19443.25,SELL,1,0.02h,Stop Loss,$11.50,$32.75,$116972.75,186,$32.75
2024-09-18,14:19:00,19671.5,BUY,1,0.02h,Break Even,$0.25,$33.00,$116973.00,186,$33.00
2024-09-18,14:21:00,19426.5,SELL,1,0.02h,Stop Loss,$16.50,$49.50,$116989.50,186,$49.50
2024-09-18,14:36:00,19681.5,BUY,1,0.02h,Stop Loss,$4.00,$53.50,$116993.50,186,$53.50
2024-09-18,15:00:00,19455.5,SELL,1,0.02h,Stop Loss,$9.00,$62.50,$117002.50,186,$62.50
2024-09-18,15:15:00,19674.0,BUY,1,0.02h,Stop Loss,$-6.00,$56.50,$116996.50,186,$56.50
2024-09-18,15:16:00,19434.25,SELL,1,0.02h,Stop Loss,$-6.00,$50.50,$116990.50,186,$50.50
2024-09-18,15:17:00,19665.0,BUY,1,0.02h,Stop Loss,$-6.00,$44.50,$116984.50,186,$44.50
2024-09-18,15:18:00,19431.25,SELL,1,0.02h,Stop Loss,$-6.00,$38.50,$116978.50,186,$38.50
2024-09-18,15:19:00,19664.75,BUY,1,0.02h,Stop Loss,$-6.00,$32.50,$116972.50,186,$32.50
2024-09-18,15:20:00,19429.75,SELL,1,0.02h,Stop Loss,$51.50,$84.00,$117024.00,186,$84.00
2024-09-18,15:25:00,19642.0,BUY,1,0.02h,Break Even,$0.25,$84.25,$117024.25,186,$84.25
2024-09-18,15:29:00,19428.5,SELL,1,0.02h,Stop Loss,$12.75,$97.00,$117037.00,186,$97.00
2024-09-18,15:33:00,19640.25,BUY,1,0.02h,Stop Loss,$-6.00,$91.00,$117031.00,186,$91.00
2024-09-18,15:34:00,19402.25,SELL,1,0.02h,Stop Loss,$-6.00,$85.00,$117025.00,186,$85.00
2024-09-18,15:35:00,19634.5,BUY,1,0.02h,Stop Loss,$-6.00,$79.00,$117019.00,186,$79.00
2024-09-18,15:36:00,19404.0,SELL,1,0.02h,Stop Loss,$-6.00,$73.00,$117013.00,186,$73.00
2024-09-18,15:37:00,19636.25,BUY,1,0.02h,Stop Loss,$-6.00,$67.00,$117007.00,186,$67.00
2024-09-18,15:38:00,19406.0,SELL,1,0.02h,Stop Loss,$-6.00,$61.00,$117001.00,186,$61.00
2024-09-18,15:39:00,19638.0,BUY,1,0.02h,Stop Loss,$-6.00,$55.00,$116995.00,186,$55.00
2024-09-18,15:46:00,19380.5,SELL,1,0.02h,Stop Loss,$-6.00,$49.00,$116989.00,186,$49.00
2024-09-18,16:05:00,19588.75,BUY,1,0.02h,Stop Loss,$12.75,$61.75,$117001.75,186,$61.75
2024-09-18,16:10:00,19373.5,SELL,1,0.02h,Stop Loss,$-6.00,$55.75,$116995.75,186,$55.75
2024-09-18,16:11:00,19622.25,BUY,1,0.02h,Stop Loss,$-6.00,$49.75,$116989.75,186,$49.75
2024-09-18,16:12:00,19390.25,SELL,1,0.02h,Break Even,$0.25,$50.00,$116990.00,186,$50.00
2024-09-18,16:16:00,19637.0,BUY,1,0.02h,Stop Loss,$32.75,$82.75,$117022.75,186,$82.75
2024-09-18,16:27:00,19432.0,SELL,1,0.02h,Stop Loss,$-6.00,$76.75,$117016.75,186,$76.75
2024-09-18,16:28:00,19670.0,BUY,1,0.02h,Stop Loss,$-6.00,$70.75,$117010.75,186,$70.75
2024-09-18,16:29:00,19437.0,SELL,1,0.02h,Break Even,$0.25,$71.00,$117011.00,186,$71.00
2024-09-18,16:31:00,19667.75,BUY,1,0.02h,Break Even,$0.25,$71.25,$117011.25,186,$71.25
2024-09-18,16:37:00,19431.5,SELL,1,0.02h,Break Even,$0.25,$71.50,$117011.50,186,$71.50
2024-09-18,16:39:00,19668.25,BUY,1,0.02h,Stop Loss,$-6.00,$65.50,$117005.50,186,$65.50
2024-09-18,16:40:00,19430.25,SELL,1,0.02h,Stop Loss,$-6.00,$59.50,$116999.50,186,$59.50
2024-09-18,16:41:00,19655.25,BUY,1,0.02h,Stop Loss,$-6.00,$53.50,$116993.50,186,$53.50
2024-09-18,16:42:00,19426.0,SELL,1,0.02h,Stop Loss,$-6.00,$47.50,$116987.50,186,$47.50
2024-09-18,16:47:00,19668.5,BUY,1,0.02h,Stop Loss,$21.50,$69.00,$117009.00,186,$69.00
2024-09-18,16:52:00,19447.75,SELL,1,0.02h,Stop Loss,$-6.00,$63.00,$117003.00,186,$63.00
2024-09-18,16:53:00,19686.25,BUY,1,0.02h,Break Even,$0.25,$63.25,$117003.25,186,$63.25
2024-09-18,17:07:00,19464.75,SELL,1,0.02h,Stop Loss,$-6.00,$57.25,$116997.25,186,$57.25
2024-09-18,17:09:00,19702.0,BUY,1,0.02h,Stop Loss,$-6.00,$51.25,$116991.25,186,$51.25
2024-09-18,17:10:00,19463.75,SELL,1,0.02h,Break Even,$0.25,$51.50,$116991.50,186,$51.50
2024-09-18,17:16:00,19689.5,BUY,1,0.02h,Stop Loss,$-6.00,$45.50,$116985.50,186,$45.50
2024-09-18,17:17:00,19452.0,SELL,1,0.02h,Stop Loss,$-6.00,$39.50,$116979.50,186,$39.50
2024-09-18,17:18:00,19686.5,BUY,1,0.02h,Stop Loss,$-6.00,$33.50,$116973.50,186,$33.50
2024-09-18,17:19:00,19451.25,SELL,1,0.02h,Break Even,$0.25,$33.75,$116973.75,186,$33.75
2024-09-18,17:25:00,19677.0,BUY,1,0.02h,Stop Loss,$-6.00,$27.75,$116967.75,186,$27.75
2024-09-18,17:26:00,19453.25,SELL,1,0.02h,Stop Loss,$-6.00,$21.75,$116961.75,186,$21.75
2024-09-18,17:27:00,19688.5,BUY,1,0.02h,Stop Loss,$6.50,$28.25,$116968.25,186,$28.25
2024-09-18,17:31:00,19472.5,SELL,1,0.02h,Stop Loss,$-6.00,$22.25,$116962.25,186,$22.25
2024-09-18,17:39:00,19690.25,BUY,1,0.02h,Stop Loss,$-6.00,$16.25,$116956.25,186,$16.25
2024-09-18,17:40:00,19453.75,SELL,1,0.02h,Stop Loss,$-6.00,$10.25,$116950.25,186,$10.25
2024-09-18,17:41:00,19689.0,BUY,1,0.02h,Break Even,$0.25,$10.50,$116950.50,186,$10.50
2024-09-18,17:46:00,19466.5,SELL,1,0.02h,Stop Loss,$59.00,$69.50,$117009.50,186,$69.50
2024-09-18,17:55:00,19689.25,BUY,1,0.02h,Stop Loss,$-6.00,$63.50,$117003.50,186,$63.50
2024-09-18,18:13:00,19453.75,SELL,1,0.02h,Stop Loss,$-6.00,$57.50,$116997.50,186,$57.50
2024-09-18,18:14:00,19701.5,BUY,1,0.02h,Stop Loss,$194.00,$251.50,$117191.50,186,$251.50
2024-09-18,18:16:00,19516.5,SELL,1,0.02h,Stop Loss,$-6.00,$245.50,$117185.50,186,$245.50
2024-09-18,18:17:00,19766.0,BUY,1,0.02h,Stop Loss,$165.25,$410.75,$117350.75,186,$410.75
2024-09-18,18:25:00,19565.75,SELL,1,0.02h,Stop Loss,$14.00,$424.75,$117364.75,186,$424.75
2024-09-18,18:27:00,19792.25,BUY,1,0.02h,Stop Loss,$-6.00,$418.75,$117358.75,186,$418.75
2024-09-18,18:28:00,19548.5,SELL,1,0.02h,Break Even,$0.25,$419.00,$117359.00,186,$419.00
2024-09-18,18:32:00,19817.75,BUY,1,0.02h,Stop Loss,$-6.00,$413.00,$117353.00,186,$413.00
2024-09-18,18:33:00,19605.0,SELL,1,0.02h,Stop Loss,$5.25,$418.25,$117358.25,186,$418.25
2024-09-18,18:35:00,19864.0,BUY,1,0.02h,Break Even,$0.25,$418.50,$117358.50,186,$418.50
2024-09-18,18:46:00,19515.25,SELL,1,0.02h,Stop Loss,$-6.00,$412.50,$117352.50,186,$412.50
2024-09-18,18:47:00,19793.5,BUY,1,0.02h,Stop Loss,$64.00,$476.50,$117416.50,186,$476.50
2024-09-18,18:50:00,19543.0,SELL,1,0.02h,Stop Loss,$-6.00,$470.50,$117410.50,186,$470.50
2024-09-18,18:51:00,19776.5,BUY,1,0.02h,Stop Loss,$104.00,$574.50,$117514.50,186,$574.50
2024-09-18,18:53:00,19581.5,SELL,1,0.02h,Stop Loss,$35.25,$609.75,$117549.75,186,$609.75
2024-09-18,19:19:00,19680.0,BUY,1,0.02h,Stop Loss,$-6.00,$603.75,$117543.75,186,$603.75
2024-09-18,19:20:00,19468.5,SELL,1,0.02h,Stop Loss,$329.00,$932.75,$117872.75,186,$932.75
2024-09-18,19:24:00,19676.0,BUY,1,0.02h,Stop Loss,$61.50,$994.25,$117934.25,186,$994.25
2024-09-18,19:37:00,19431.0,SELL,1,0.02h,Stop Loss,$-6.00,$988.25,$117928.25,186,$988.25
2024-09-18,19:56:00,19595.75,BUY,1,0.02h,Stop Loss,$24.00,$1012.25,$117952.25,186,$1012.25
2024-09-18,20:01:00,19351.25,SELL,1,0.02h,Stop Loss,$65.25,$1077.50,$118017.50,186,$1077.50
2024-09-18,20:08:00,19632.0,BUY,1,0.02h,Stop Loss,$70.25,$1147.75,$118087.75,186,$1147.75
2024-09-18,20:12:00,19403.0,SELL,1,0.02h,Break Even,$0.25,$1148.00,$118088.00,186,$1148.00
2024-09-18,20:18:00,19654.0,BUY,1,0.02h,Stop Loss,$-6.00,$1142.00,$118082.00,186,$1142.00
2024-09-18,20:19:00,19428.5,SELL,1,0.02h,Stop Loss,$-6.00,$1136.00,$118076.00,186,$1136.00
2024-09-18,20:20:00,19661.0,BUY,1,0.02h,Break Even,$0.25,$1136.25,$118076.25,186,$1136.25
2024-09-18,20:29:00,19411.75,SELL,1,0.02h,Stop Loss,$-6.00,$1130.25,$118070.25,186,$1130.25
2024-09-18,20:30:00,19643.75,BUY,1,0.02h,Stop Loss,$-6.00,$1124.25,$118064.25,186,$1124.25
2024-09-18,20:31:00,19419.5,SELL,1,0.02h,Break Even,$0.25,$1124.50,$118064.50,186,$1124.50
2024-09-18,20:44:00,19623.75,BUY,1,0.02h,Stop Loss,$-6.00,$1118.50,$118058.50,186,$1118.50
2024-09-18,20:45:00,19399.75,SELL,1,0.02h,Stop Loss,$-6.00,$1112.50,$118052.50,186,$1112.50
2024-09-18,20:46:00,19626.75,BUY,1,0.02h,Break Even,$0.25,$1112.75,$118052.75,186,$1112.75
2024-09-18,20:51:00,19406.25,SELL,1,0.02h,Stop Loss,$-6.00,$1106.75,$118046.75,186,$1106.75
2024-09-18,20:52:00,19629.75,BUY,1,0.02h,Stop Loss,$-6.00,$1100.75,$118040.75,186,$1100.75
2024-09-18,20:53:00,19397.25,SELL,1,0.03h,Break Even,$0.25,$1101.00,$118041.00,186,$1101.00
2024-09-18,20:55:00,19632.0,BUY,1,0.02h,Break Even,$0.25,$1101.25,$118041.25,186,$1101.25
2024-09-18,21:00:00,19403.75,SELL,1,1.02h,Stop Loss,$-6.00,$1095.25,$118035.25,186,$1095.25
2024-09-18,22:01:00,19645.0,BUY,1,0.02h,Break Even,$0.25,$1095.50,$118035.50,186,$1095.50
2024-09-18,22:04:00,19433.25,SELL,1,0.02h,Stop Loss,$-6.00,$1089.50,$118029.50,186,$1089.50
2024-09-18,22:05:00,19660.5,BUY,1,0.02h,Stop Loss,$-6.00,$1083.50,$118023.50,186,$1083.50
2024-09-18,22:06:00,19425.5,SELL,1,0.02h,Stop Loss,$-6.00,$1077.50,$118017.50,186,$1077.50
2024-09-18,22:07:00,19653.75,BUY,1,0.02h,Stop Loss,$-6.00,$1071.50,$118011.50,186,$1071.50
2024-09-18,22:08:00,19422.25,SELL,1,0.02h,Stop Loss,$-6.00,$1065.50,$118005.50,186,$1065.50
2024-09-18,22:09:00,19650.25,BUY,1,0.02h,Break Even,$0.25,$1065.75,$118005.75,186,$1065.75
2024-09-18,22:15:00,19428.75,SELL,1,0.02h,Stop Loss,$-6.00,$1059.75,$117999.75,186,$1059.75
2024-09-18,22:16:00,19664.0,BUY,1,0.02h,Stop Loss,$-6.00,$1053.75,$117993.75,186,$1053.75
2024-09-18,22:17:00,19436.0,SELL,1,0.02h,Stop Loss,$-6.00,$1047.75,$117987.75,186,$1047.75
2024-09-18,22:19:00,19675.5,BUY,1,0.02h,Break Even,$0.25,$1048.00,$117988.00,186,$1048.00
2024-09-18,22:22:00,19445.25,SELL,1,0.02h,Break Even,$0.25,$1048.25,$117988.25,186,$1048.25
2024-09-18,22:24:00,19673.5,BUY,1,0.02h,Stop Loss,$-6.00,$1042.25,$117982.25,186,$1042.25
2024-09-18,22:36:00,19452.75,SELL,1,0.02h,Stop Loss,$-6.00,$1036.25,$117976.25,186,$1036.25
2024-09-18,22:37:00,19685.0,BUY,1,0.02h,Break Even,$0.25,$1036.50,$117976.50,186,$1036.50
2024-09-18,22:39:00,19451.75,SELL,1,0.02h,Stop Loss,$-6.00,$1030.50,$117970.50,186,$1030.50
2024-09-18,22:44:00,19683.5,BUY,1,0.02h,Break Even,$0.25,$1030.75,$117970.75,186,$1030.75
2024-09-18,22:46:00,19448.0,SELL,1,0.02h,Break Even,$0.25,$1031.00,$117971.00,186,$1031.00
2024-09-18,22:56:00,19664.0,BUY,1,0.02h,Break Even,$0.25,$1031.25,$117971.25,186,$1031.25
Final P&L Day: 1031.25,,,,,,,,,,,
2024-09-19,12:37:00,19766.75,SELL,1,0.02h,Stop Loss,$11.50,$11.50,$117982.75,187,$11.50
2024-09-19,12:40:00,20003.0,BUY,1,0.02h,Stop Loss,$49.00,$60.50,$118031.75,187,$60.50
2024-09-19,12:53:00,19763.25,SELL,1,0.02h,Stop Loss,$-6.00,$54.50,$118025.75,187,$54.50
2024-09-19,12:54:00,19995.5,BUY,1,0.02h,Stop Loss,$-6.00,$48.50,$118019.75,187,$48.50
2024-09-19,12:55:00,19762.25,SELL,1,0.02h,Stop Loss,$-6.00,$42.50,$118013.75,187,$42.50
2024-09-19,13:04:00,19994.75,BUY,1,0.02h,Stop Loss,$-6.00,$36.50,$118007.75,187,$36.50
2024-09-19,13:24:00,19796.5,SELL,1,0.02h,Break Even,$0.25,$36.75,$118008.00,187,$36.75
2024-09-19,13:32:00,20039.5,BUY,1,0.02h,Stop Loss,$34.00,$70.75,$118042.00,187,$70.75
2024-09-19,13:34:00,19798.75,SELL,1,0.02h,Stop Loss,$55.25,$126.00,$118097.25,187,$126.00
2024-09-19,13:36:00,20020.0,BUY,1,0.02h,Break Even,$0.25,$126.25,$118097.50,187,$126.25
2024-09-19,13:40:00,19812.75,SELL,1,0.02h,Stop Loss,$-6.00,$120.25,$118091.50,187,$120.25
2024-09-19,13:41:00,20060.5,BUY,1,0.02h,Stop Loss,$46.50,$166.75,$118138.00,187,$166.75
2024-09-19,13:47:00,19784.25,SELL,1,0.02h,Stop Loss,$27.75,$194.50,$118165.75,187,$194.50
2024-09-19,13:50:00,20015.25,BUY,1,0.02h,Stop Loss,$-6.00,$188.50,$118159.75,187,$188.50
2024-09-19,13:58:00,19767.0,SELL,1,0.02h,Stop Loss,$-6.00,$182.50,$118153.75,187,$182.50
2024-09-19,13:59:00,20008.25,BUY,1,0.02h,Stop Loss,$7.75,$190.25,$118161.50,187,$190.25
2024-09-19,14:07:00,19794.0,SELL,1,0.02h,Stop Loss,$-6.00,$184.25,$118155.50,187,$184.25
2024-09-19,14:09:00,20040.0,BUY,1,0.02h,Break Even,$0.25,$184.50,$118155.75,187,$184.50
2024-09-19,14:12:00,19809.0,SELL,1,0.02h,Break Even,$0.25,$184.75,$118156.00,187,$184.75
2024-09-19,14:16:00,20059.0,BUY,1,0.02h,Stop Loss,$-6.00,$178.75,$118150.00,187,$178.75
2024-09-19,14:17:00,19821.0,SELL,1,0.02h,Stop Loss,$-6.00,$172.75,$118144.00,187,$172.75
2024-09-19,14:18:00,20071.25,BUY,1,0.02h,Stop Loss,$47.75,$220.50,$118191.75,187,$220.50
2024-09-19,14:23:00,19843.5,SELL,1,0.02h,Stop Loss,$-6.00,$214.50,$118185.75,187,$214.50
2024-09-19,14:24:00,20075.75,BUY,1,0.02h,Stop Loss,$72.75,$287.25,$118258.50,187,$287.25
2024-09-19,14:27:00,19862.0,SELL,1,0.02h,Stop Loss,$-6.00,$281.25,$118252.50,187,$281.25
2024-09-19,14:29:00,20129.25,BUY,1,0.02h,Stop Loss,$-6.00,$275.25,$118246.50,187,$275.25
2024-09-19,14:30:00,19893.0,SELL,1,0.02h,Break Even,$0.25,$275.50,$118246.75,187,$275.50
2024-09-19,14:32:00,20153.75,BUY,1,0.02h,Stop Loss,$7.75,$283.25,$118254.50,187,$283.25
2024-09-19,14:39:00,19895.5,SELL,1,0.02h,Stop Loss,$-6.00,$277.25,$118248.50,187,$277.25
2024-09-19,14:40:00,20142.5,BUY,1,0.02h,Stop Loss,$-6.00,$271.25,$118242.50,187,$271.25
2024-09-19,14:43:00,19879.5,SELL,1,0.02h,Stop Loss,$47.75,$319.00,$118290.25,187,$319.00
2024-09-19,14:49:00,20095.75,BUY,1,0.02h,Stop Loss,$62.75,$381.75,$118353.00,187,$381.75
2024-09-19,14:51:00,19862.5,SELL,1,0.02h,Stop Loss,$-6.00,$375.75,$118347.00,187,$375.75
2024-09-19,14:52:00,20092.25,BUY,1,0.02h,Stop Loss,$-6.00,$369.75,$118341.00,187,$369.75
2024-09-19,14:53:00,19846.25,SELL,1,0.02h,Stop Loss,$-6.00,$363.75,$118335.00,187,$363.75
2024-09-19,14:54:00,20086.25,BUY,1,0.02h,Stop Loss,$-6.00,$357.75,$118329.00,187,$357.75
2024-09-19,14:55:00,19844.0,SELL,1,0.02h,Stop Loss,$42.75,$400.50,$118371.75,187,$400.50
2024-09-19,15:05:00,20104.25,BUY,1,0.02h,Break Even,$0.25,$400.75,$118372.00,187,$400.75
2024-09-19,15:09:00,19835.5,SELL,1,0.02h,Stop Loss,$-6.00,$394.75,$118366.00,187,$394.75
2024-09-19,15:16:00,20101.75,BUY,1,0.02h,Stop Loss,$109.00,$503.75,$118475.00,187,$503.75
2024-09-19,15:26:00,19903.25,SELL,1,0.02h,Stop Loss,$21.50,$525.25,$118496.50,187,$525.25
2024-09-19,15:28:00,20134.75,BUY,1,0.02h,Break Even,$0.25,$525.50,$118496.75,187,$525.50
2024-09-19,15:33:00,19891.75,SELL,1,0.02h,Stop Loss,$36.50,$562.00,$118533.25,187,$562.00
2024-09-19,15:36:00,20137.25,BUY,1,0.02h,Stop Loss,$-6.00,$556.00,$118527.25,187,$556.00
2024-09-19,15:37:00,19900.25,SELL,1,0.02h,Stop Loss,$-6.00,$550.00,$118521.25,187,$550.00
2024-09-19,15:38:00,20137.5,BUY,1,0.02h,Stop Loss,$-6.00,$544.00,$118515.25,187,$544.00
2024-09-19,15:39:00,19898.25,SELL,1,0.02h,Stop Loss,$-6.00,$538.00,$118509.25,187,$538.00
2024-09-19,15:40:00,20135.25,BUY,1,0.02h,Stop Loss,$-6.00,$532.00,$118503.25,187,$532.00
2024-09-19,15:51:00,19901.5,SELL,1,0.02h,Stop Loss,$-6.00,$526.00,$118497.25,187,$526.00
2024-09-19,15:52:00,20113.5,BUY,1,0.02h,Stop Loss,$-6.00,$520.00,$118491.25,187,$520.00
2024-09-19,15:54:00,19868.5,SELL,1,0.02h,Stop Loss,$-6.00,$514.00,$118485.25,187,$514.00
2024-09-19,16:00:00,20098.25,BUY,1,0.02h,Stop Loss,$30.25,$544.25,$118515.50,187,$544.25
2024-09-19,16:02:00,19880.0,SELL,1,0.02h,Stop Loss,$-6.00,$538.25,$118509.50,187,$538.25
2024-09-19,16:03:00,20123.75,BUY,1,0.02h,Stop Loss,$27.75,$566.00,$118537.25,187,$566.00
2024-09-19,16:05:00,19898.5,SELL,1,0.02h,Stop Loss,$-6.00,$560.00,$118531.25,187,$560.00
2024-09-19,16:06:00,20130.5,BUY,1,0.02h,Stop Loss,$4.00,$564.00,$118535.25,187,$564.00
2024-09-19,16:11:00,19906.25,SELL,1,0.02h,Stop Loss,$51.50,$615.50,$118586.75,187,$615.50
2024-09-19,16:14:00,20124.75,BUY,1,0.02h,Stop Loss,$-6.00,$609.50,$118580.75,187,$609.50
2024-09-19,16:18:00,19905.0,SELL,1,0.02h,Stop Loss,$-6.00,$603.50,$118574.75,187,$603.50
2024-09-19,16:19:00,20137.0,BUY,1,0.02h,Stop Loss,$31.50,$635.00,$118606.25,187,$635.00
2024-09-19,16:26:00,19918.75,SELL,1,0.02h,Break Even,$0.25,$635.25,$118606.50,187,$635.25
2024-09-19,16:31:00,20163.5,BUY,1,0.02h,Stop Loss,$-6.00,$629.25,$118600.50,187,$629.25
2024-09-19,16:32:00,19918.5,SELL,1,0.02h,Break Even,$0.25,$629.50,$118600.75,187,$629.50
2024-09-19,16:35:00,20161.75,BUY,1,0.02h,Break Even,$0.25,$629.75,$118601.00,187,$629.75
2024-09-19,16:39:00,19930.5,SELL,1,0.02h,Break Even,$0.25,$630.00,$118601.25,187,$630.00
2024-09-19,16:41:00,20168.0,BUY,1,0.02h,Stop Loss,$-6.00,$624.00,$118595.25,187,$624.00
2024-09-19,16:42:00,19924.25,SELL,1,0.02h,Stop Loss,$-6.00,$618.00,$118589.25,187,$618.00
2024-09-19,16:43:00,20159.75,BUY,1,0.02h,Break Even,$0.25,$618.25,$118589.50,187,$618.25
2024-09-19,16:50:00,19929.5,SELL,1,0.02h,Stop Loss,$-6.00,$612.25,$118583.50,187,$612.25
2024-09-19,16:51:00,20167.25,BUY,1,0.02h,Stop Loss,$-6.00,$606.25,$118577.50,187,$606.25
2024-09-19,16:52:00,19930.0,SELL,1,0.02h,Stop Loss,$-6.00,$600.25,$118571.50,187,$600.25
2024-09-19,16:53:00,20168.0,BUY,1,0.02h,Break Even,$0.25,$600.50,$118571.75,187,$600.50
2024-09-19,16:57:00,19926.0,SELL,1,0.02h,Stop Loss,$-6.00,$594.50,$118565.75,187,$594.50
2024-09-19,17:05:00,20160.25,BUY,1,0.02h,Stop Loss,$-6.00,$588.50,$118559.75,187,$588.50
2024-09-19,17:06:00,19921.25,SELL,1,0.02h,Stop Loss,$-6.00,$582.50,$118553.75,187,$582.50
2024-09-19,17:07:00,20148.25,BUY,1,0.02h,Stop Loss,$-6.00,$576.50,$118547.75,187,$576.50
2024-09-19,17:08:00,19915.75,SELL,1,0.02h,Stop Loss,$-6.00,$570.50,$118541.75,187,$570.50
2024-09-19,17:09:00,20149.0,BUY,1,0.02h,Stop Loss,$-6.00,$564.50,$118535.75,187,$564.50
2024-09-19,17:10:00,19918.5,SELL,1,0.02h,Stop Loss,$-6.00,$558.50,$118529.75,187,$558.50
2024-09-19,17:11:00,20151.75,BUY,1,0.02h,Stop Loss,$-6.00,$552.50,$118523.75,187,$552.50
2024-09-19,17:12:00,19916.25,SELL,1,0.02h,Stop Loss,$24.00,$576.50,$118547.75,187,$576.50
2024-09-19,17:17:00,20165.75,BUY,1,0.02h,Stop Loss,$-6.00,$570.50,$118541.75,187,$570.50
2024-09-19,17:18:00,19932.75,SELL,1,0.02h,Stop Loss,$-6.00,$564.50,$118535.75,187,$564.50
2024-09-19,17:19:00,20164.75,BUY,1,0.02h,Stop Loss,$4.00,$568.50,$118539.75,187,$568.50
2024-09-19,17:31:00,19931.75,SELL,1,0.02h,Stop Loss,$16.50,$585.00,$118556.25,187,$585.00
2024-09-19,17:37:00,20167.25,BUY,1,0.02h,Stop Loss,$-6.00,$579.00,$118550.25,187,$579.00
2024-09-19,17:38:00,19938.5,SELL,1,0.02h,Stop Loss,$-6.00,$573.00,$118544.25,187,$573.00
2024-09-19,17:39:00,20172.25,BUY,1,0.02h,Stop Loss,$4.00,$577.00,$118548.25,187,$577.00
2024-09-19,17:42:00,19943.0,SELL,1,0.02h,Stop Loss,$-6.00,$571.00,$118542.25,187,$571.00
2024-09-19,17:43:00,20183.0,BUY,1,0.02h,Stop Loss,$-6.00,$565.00,$118536.25,187,$565.00
2024-09-19,17:44:00,19936.5,SELL,1,0.02h,Stop Loss,$-6.00,$559.00,$118530.25,187,$559.00
2024-09-19,17:45:00,20183.0,BUY,1,0.02h,Break Even,$0.25,$559.25,$118530.50,187,$559.25
2024-09-19,17:50:00,19955.75,SELL,1,0.02h,Stop Loss,$27.75,$587.00,$118558.25,187,$587.00
2024-09-19,18:01:00,20198.5,BUY,1,0.02h,Stop Loss,$-6.00,$581.00,$118552.25,187,$581.00
2024-09-19,18:02:00,19958.75,SELL,1,0.02h,Stop Loss,$-6.00,$575.00,$118546.25,187,$575.00
2024-09-19,18:03:00,20191.25,BUY,1,0.02h,Stop Loss,$5.25,$580.25,$118551.50,187,$580.25
2024-09-19,18:07:00,19956.0,SELL,1,0.02h,Stop Loss,$49.00,$629.25,$118600.50,187,$629.25
2024-09-19,18:13:00,20170.75,BUY,1,0.02h,Stop Loss,$-6.00,$623.25,$118594.50,187,$623.25
2024-09-19,18:20:00,19902.25,SELL,1,0.02h,Stop Loss,$9.00,$632.25,$118603.50,187,$632.25
2024-09-19,18:32:00,20148.25,BUY,1,0.02h,Break Even,$0.25,$632.50,$118603.75,187,$632.50
2024-09-19,18:39:00,19906.0,SELL,1,0.02h,Stop Loss,$-6.00,$626.50,$118597.75,187,$626.50
2024-09-19,18:40:00,20151.5,BUY,1,0.02h,Stop Loss,$-6.00,$620.50,$118591.75,187,$620.50
2024-09-19,18:41:00,19908.25,SELL,1,0.02h,Stop Loss,$6.50,$627.00,$118598.25,187,$627.00
2024-09-19,18:46:00,20142.25,BUY,1,0.02h,Stop Loss,$35.25,$662.25,$118633.50,187,$662.25
2024-09-19,18:53:00,19893.25,SELL,1,0.02h,Stop Loss,$15.25,$677.50,$118648.75,187,$677.50
2024-09-19,18:59:00,20142.25,BUY,1,0.02h,Stop Loss,$22.75,$700.25,$118671.50,187,$700.25
2024-09-19,19:05:00,19904.5,SELL,1,0.02h,Stop Loss,$56.50,$756.75,$118728.00,187,$756.75
2024-09-19,19:08:00,20130.25,BUY,1,0.02h,Stop Loss,$-6.00,$750.75,$118722.00,187,$750.75
2024-09-19,19:09:00,19890.5,SELL,1,0.02h,Stop Loss,$27.75,$778.50,$118749.75,187,$778.50
2024-09-19,19:19:00,20097.0,BUY,1,0.02h,Stop Loss,$7.75,$786.25,$118757.50,187,$786.25
2024-09-19,19:21:00,19842.0,SELL,1,0.02h,Stop Loss,$-6.00,$780.25,$118751.50,187,$780.25
2024-09-19,19:22:00,20089.25,BUY,1,0.02h,Stop Loss,$-6.00,$774.25,$118745.50,187,$774.25
2024-09-19,19:23:00,19863.5,SELL,1,0.02h,Stop Loss,$-6.00,$768.25,$118739.50,187,$768.25
2024-09-19,19:26:00,20111.25,BUY,1,0.02h,Stop Loss,$-6.00,$762.25,$118733.50,187,$762.25
2024-09-19,19:30:00,19871.75,SELL,1,0.02h,Stop Loss,$61.50,$823.75,$118795.00,187,$823.75
2024-09-19,19:44:00,20117.75,BUY,1,0.02h,Break Even,$0.25,$824.00,$118795.25,187,$824.00
2024-09-19,19:52:00,19840.75,SELL,1,0.02h,Stop Loss,$-6.00,$818.00,$118789.25,187,$818.00
2024-09-19,19:53:00,20070.25,BUY,1,0.02h,Stop Loss,$-6.00,$812.00,$118783.25,187,$812.00
2024-09-19,19:54:00,19834.25,SELL,1,0.02h,Stop Loss,$-6.00,$806.00,$118777.25,187,$806.00
2024-09-19,19:55:00,20091.5,BUY,1,0.02h,Stop Loss,$25.25,$831.25,$118802.50,187,$831.25
2024-09-19,19:58:00,19844.0,SELL,1,0.02h,Stop Loss,$45.25,$876.50,$118847.75,187,$876.50
2024-09-19,20:02:00,20076.75,BUY,1,0.02h,Stop Loss,$4.00,$880.50,$118851.75,187,$880.50
2024-09-19,20:04:00,19839.25,SELL,1,0.02h,Stop Loss,$6.50,$887.00,$118858.25,187,$887.00
2024-09-19,20:18:00,20060.25,BUY,1,0.02h,Stop Loss,$-6.00,$881.00,$118852.25,187,$881.00
2024-09-19,20:19:00,19826.0,SELL,1,0.02h,Stop Loss,$-6.00,$875.00,$118846.25,187,$875.00
2024-09-19,20:24:00,20060.75,BUY,1,0.02h,Stop Loss,$5.25,$880.25,$118851.50,187,$880.25
2024-09-19,20:27:00,19830.75,SELL,1,0.02h,Break Even,$0.25,$880.50,$118851.75,187,$880.50
2024-09-19,20:33:00,20063.25,BUY,1,0.02h,Stop Loss,$-6.00,$874.50,$118845.75,187,$874.50
2024-09-19,20:45:00,19834.5,SELL,1,0.02h,Stop Loss,$37.75,$912.25,$118883.50,187,$912.25
2024-09-19,20:52:00,20065.0,BUY,1,0.02h,Stop Loss,$-6.00,$906.25,$118877.50,187,$906.25
2024-09-19,20:54:00,19824.5,SELL,1,0.03h,Break Even,$0.25,$906.50,$118877.75,187,$906.50
2024-09-19,21:00:00,20063.25,BUY,1,1.02h,Stop Loss,$26.50,$933.00,$118904.25,187,$933.00
2024-09-19,22:08:00,19835.25,SELL,1,0.03h,Break Even,$0.25,$933.25,$118904.50,187,$933.25
2024-09-19,22:16:00,20069.5,BUY,1,0.02h,Break Even,$0.25,$933.50,$118904.75,187,$933.50
2024-09-19,22:18:00,19822.0,SELL,1,0.02h,Stop Loss,$-6.00,$927.50,$118898.75,187,$927.50
2024-09-19,22:23:00,20060.25,BUY,1,0.02h,Stop Loss,$-6.00,$921.50,$118892.75,187,$921.50
2024-09-19,22:24:00,19826.75,SELL,1,0.03h,Break Even,$0.25,$921.75,$118893.00,187,$921.75
2024-09-19,22:26:00,20063.75,BUY,1,0.02h,Stop Loss,$5.25,$927.00,$118898.25,187,$927.00
2024-09-19,22:31:00,19828.5,SELL,1,0.02h,Stop Loss,$-6.00,$921.00,$118892.25,187,$921.00
2024-09-19,22:32:00,20060.25,BUY,1,0.02h,Break Even,$0.25,$921.25,$118892.50,187,$921.25
2024-09-19,22:37:00,19816.5,SELL,1,0.02h,Stop Loss,$-6.00,$915.25,$118886.50,187,$915.25
2024-09-19,22:38:00,20054.75,BUY,1,0.02h,Stop Loss,$-6.00,$909.25,$118880.50,187,$909.25
2024-09-19,22:40:00,19801.25,SELL,1,0.02h,Break Even,$0.25,$909.50,$118880.75,187,$909.50
2024-09-19,22:45:00,20040.75,BUY,1,0.02h,Stop Loss,$-6.00,$903.50,$118874.75,187,$903.50
2024-09-19,22:46:00,19805.0,SELL,1,0.02h,Stop Loss,$20.25,$923.75,$118895.00,187,$923.75
2024-09-19,22:52:00,20038.5,BUY,1,0.02h,Stop Loss,$12.75,$936.50,$118907.75,187,$936.50
2024-09-19,22:54:00,19805.0,SELL,1,0.02h,Stop Loss,$-6.00,$930.50,$118901.75,187,$930.50
2024-09-19,22:55:00,20044.0,BUY,1,0.02h,Stop Loss,$-6.00,$924.50,$118895.75,187,$924.50
Final P&L Day: 924.50,,,,,,,,,,,
2024-09-20,12:02:00,19791.0,SELL,1,0.02h,Stop Loss,$-6.00,$-6.00,$118889.75,188,$-6.00
2024-09-20,12:05:00,20033.5,BUY,1,0.02h,Stop Loss,$-6.00,$-12.00,$118883.75,188,$-12.00
2024-09-20,12:06:00,19802.0,SELL,1,0.02h,Stop Loss,$20.25,$8.25,$118904.00,188,$8.25
2024-09-20,12:16:00,20050.25,BUY,1,0.02h,Break Even,$0.25,$8.50,$118904.25,188,$8.50
2024-09-20,12:23:00,19810.5,SELL,1,0.02h,Stop Loss,$-6.00,$2.50,$118898.25,188,$2.50
2024-09-20,12:25:00,20046.75,BUY,1,0.02h,Stop Loss,$9.00,$11.50,$118907.25,188,$11.50
2024-09-20,12:34:00,19821.75,SELL,1,0.02h,Stop Loss,$-6.00,$5.50,$118901.25,188,$5.50
2024-09-20,12:37:00,20057.25,BUY,1,0.02h,Stop Loss,$-6.00,$-0.50,$118895.25,188,$-0.50
2024-09-20,12:38:00,19823.25,SELL,1,0.02h,Stop Loss,$-6.00,$-6.50,$118889.25,188,$-6.50
2024-09-20,12:45:00,20071.0,BUY,1,0.02h,Stop Loss,$-6.00,$-12.50,$118883.25,188,$-12.50
2024-09-20,12:46:00,19830.75,SELL,1,0.02h,Stop Loss,$-6.00,$-18.50,$118877.25,188,$-18.50
2024-09-20,12:48:00,20070.0,BUY,1,0.02h,Stop Loss,$9.00,$-9.50,$118886.25,188,$-9.50
2024-09-20,12:58:00,19824.5,SELL,1,0.02h,Break Even,$0.25,$-9.25,$118886.50,188,$-9.25
2024-09-20,13:01:00,20064.0,BUY,1,0.02h,Stop Loss,$-6.00,$-15.25,$118880.50,188,$-15.25
2024-09-20,13:21:00,19795.25,SELL,1,0.02h,Stop Loss,$-6.00,$-21.25,$118874.50,188,$-21.25
2024-09-20,13:33:00,20040.75,BUY,1,0.02h,Stop Loss,$29.00,$7.75,$118903.50,188,$7.75
2024-09-20,13:59:00,20007.75,SELL,1,0.02h,Stop Loss,$66.50,$74.25,$118970.00,188,$74.25
2024-09-20,14:29:00,20007.75,BUY,1,0.02h,Break Even,$0.25,$74.50,$118970.25,188,$74.50
2024-09-20,14:31:00,19989.75,SELL,1,0.02h,Stop Loss,$52.75,$127.25,$119023.00,188,$127.25
2024-09-20,14:40:00,20009.25,BUY,1,0.02h,Stop Loss,$-6.00,$121.25,$119017.00,188,$121.25
2024-09-20,14:44:00,19991.5,SELL,1,0.02h,Stop Loss,$17.75,$139.00,$119034.75,188,$139.00
2024-09-20,15:34:00,19930.75,BUY,1,0.02h,Stop Loss,$87.75,$226.75,$119122.50,188,$226.75
2024-09-20,17:05:00,20004.25,SELL,1,0.02h,Break Even,$0.25,$227.00,$119122.75,188,$227.00
2024-09-20,17:18:00,20018.5,BUY,1,0.02h,Break Even,$0.25,$227.25,$119123.00,188,$227.25
2024-09-20,17:23:00,20008.0,SELL,1,0.02h,Break Even,$0.25,$227.50,$119123.25,188,$227.50
2024-09-20,17:34:00,20021.5,BUY,1,0.02h,Stop Loss,$7.75,$235.25,$119131.00,188,$235.25
2024-09-20,17:46:00,20011.0,SELL,1,0.02h,Stop Loss,$20.25,$255.50,$119151.25,188,$255.50
2024-09-20,18:50:00,19957.5,BUY,1,0.02h,Stop Loss,$11.50,$267.00,$119162.75,188,$267.00
2024-09-20,19:53:00,20036.75,SELL,1,0.02h,Break Even,$0.25,$267.25,$119163.00,188,$267.25
2024-09-20,20:41:00,20022.25,BUY,1,0.02h,Stop Loss,$-6.00,$261.25,$119157.00,188,$261.25
Final P&L Day: 261.25,,,,,,,,,,,
2024-09-23,12:51:00,20073.5,SELL,1,0.02h,Break Even,$0.25,$0.25,$119157.25,189,$0.25
2024-09-23,12:58:00,20089.75,BUY,1,0.02h,Stop Loss,$7.75,$8.00,$119165.00,189,$8.00
2024-09-23,13:12:00,20080.5,SELL,1,0.02h,Stop Loss,$27.75,$35.75,$119192.75,189,$35.75
2024-09-23,13:49:00,20082.25,BUY,1,0.02h,Stop Loss,$77.75,$113.50,$119270.50,189,$113.50
2024-09-23,14:15:00,20057.25,SELL,1,0.02h,Stop Loss,$35.25,$148.75,$119305.75,189,$148.75
2024-09-23,14:22:00,20086.75,BUY,1,0.02h,Stop Loss,$57.75,$206.50,$119363.50,189,$206.50
2024-09-23,14:39:00,20074.5,SELL,1,0.02h,Stop Loss,$71.50,$278.00,$119435.00,189,$278.00
2024-09-23,14:45:00,20104.75,BUY,1,0.02h,Break Even,$0.25,$278.25,$119435.25,189,$278.25
2024-09-23,15:02:00,20083.25,SELL,1,0.02h,Stop Loss,$30.25,$308.50,$119465.50,189,$308.50
2024-09-23,15:27:00,20083.75,BUY,1,0.02h,Stop Loss,$-6.00,$302.50,$119459.50,189,$302.50
2024-09-23,16:03:00,20102.25,SELL,1,0.02h,Stop Loss,$20.25,$322.75,$119479.75,189,$322.75
2024-09-23,17:20:00,20051.75,BUY,1,0.02h,Stop Loss,$17.75,$340.50,$119497.50,189,$340.50
2024-09-23,17:29:00,20037.25,SELL,1,0.02h,Break Even,$0.25,$340.75,$119497.75,189,$340.75
2024-09-23,17:33:00,20049.5,BUY,1,0.02h,Stop Loss,$22.75,$363.50,$119520.50,189,$363.50
2024-09-23,18:30:00,20067.0,SELL,1,0.02h,Break Even,$0.25,$363.75,$119520.75,189,$363.75
2024-09-23,18:43:00,20075.75,BUY,1,0.02h,Stop Loss,$-6.00,$357.75,$119514.75,189,$357.75
2024-09-23,18:46:00,20068.5,SELL,1,0.02h,Stop Loss,$-6.00,$351.75,$119508.75,189,$351.75
2024-09-23,18:51:00,20076.5,BUY,1,0.02h,Stop Loss,$-6.00,$345.75,$119502.75,189,$345.75
2024-09-23,19:10:00,20068.25,SELL,1,0.02h,Stop Loss,$11.50,$357.25,$119514.25,189,$357.25
2024-09-23,19:23:00,20077.25,BUY,1,0.02h,Stop Loss,$-6.00,$351.25,$119508.25,189,$351.25
2024-09-23,19:44:00,20069.75,SELL,1,0.02h,Stop Loss,$62.75,$414.00,$119571.00,189,$414.00
2024-09-23,19:50:00,20085.0,BUY,1,0.02h,Break Even,$0.25,$414.25,$119571.25,189,$414.25
2024-09-23,19:54:00,20067.25,SELL,1,0.02h,Break Even,$0.25,$414.50,$119571.50,189,$414.50
2024-09-23,19:57:00,20076.75,BUY,1,0.02h,Stop Loss,$10.25,$424.75,$119581.75,189,$424.75
2024-09-23,20:08:00,20067.0,SELL,1,0.02h,Break Even,$0.25,$425.00,$119582.00,189,$425.00
2024-09-23,20:53:00,20062.0,BUY,1,0.02h,Stop Loss,$-6.00,$419.00,$119576.00,189,$419.00
2024-09-23,20:59:00,20058.25,SELL,1,0.02h,Stop Loss,$-6.00,$413.00,$119570.00,189,$413.00
2024-09-23,21:00:00,20063.25,BUY,1,1.02h,Stop Loss,$6.50,$419.50,$119576.50,189,$419.50
2024-09-23,22:07:00,20054.75,SELL,1,0.02h,Stop Loss,$19.00,$438.50,$119595.50,189,$438.50
2024-09-23,22:33:00,20055.25,BUY,1,0.02h,Stop Loss,$-6.00,$432.50,$119589.50,189,$432.50
2024-09-23,22:39:00,20052.0,SELL,1,0.02h,Stop Loss,$7.75,$440.25,$119597.25,189,$440.25
2024-09-23,23:00:00,20051.25,BUY,1,13.00h,Stop Loss,$256.50,$696.75,$119853.75,189,$696.75
Final P&L Day: 696.75,,,,,,,,,,,
2024-09-24,12:33:00,20098.5,SELL,1,0.02h,Stop Loss,$10.25,$10.25,$119864.00,190,$10.25
2024-09-24,12:49:00,20109.0,BUY,1,0.02h,Stop Loss,$4.00,$14.25,$119868.00,190,$14.25
2024-09-24,13:33:00,20117.75,SELL,1,0.02h,Stop Loss,$26.50,$40.75,$119894.50,190,$40.75
2024-09-24,14:48:00,20014.25,BUY,1,0.02h,Stop Loss,$9.00,$49.75,$119903.50,190,$49.75
2024-09-24,16:26:00,20183.5,SELL,1,0.02h,Stop Loss,$45.25,$95.00,$119948.75,190,$95.00
2024-09-24,16:34:00,20197.0,BUY,1,0.02h,Break Even,$0.25,$95.25,$119949.00,190,$95.25
2024-09-24,16:54:00,20191.75,SELL,1,0.02h,Stop Loss,$50.25,$145.50,$119999.25,190,$145.50
2024-09-24,17:17:00,20185.5,BUY,1,0.02h,Stop Loss,$20.25,$165.75,$120019.50,190,$165.75
2024-09-24,17:24:00,20173.25,SELL,1,0.02h,Break Even,$0.25,$166.00,$120019.75,190,$166.00
2024-09-24,17:34:00,20183.0,BUY,1,0.02h,Stop Loss,$10.25,$176.25,$120030.00,190,$176.25
2024-09-24,17:49:00,20177.5,SELL,1,0.02h,Stop Loss,$31.50,$207.75,$120061.50,190,$207.75
2024-09-24,18:54:00,20153.0,BUY,1,0.02h,Break Even,$0.25,$208.00,$120061.75,190,$208.00
2024-09-24,19:19:00,20146.0,SELL,1,0.02h,Break Even,$0.25,$208.25,$120062.00,190,$208.25
2024-09-24,19:21:00,20153.5,BUY,1,0.02h,Stop Loss,$4.00,$212.25,$120066.00,190,$212.25
2024-09-24,19:31:00,20146.5,SELL,1,0.02h,Break Even,$0.25,$212.50,$120066.25,190,$212.50
2024-09-24,19:39:00,20154.25,BUY,1,0.02h,Stop Loss,$25.25,$237.75,$120091.50,190,$237.75
2024-09-24,19:57:00,20151.75,SELL,1,0.02h,Break Even,$0.25,$238.00,$120091.75,190,$238.00
2024-09-24,20:01:00,20165.75,BUY,1,0.02h,Break Even,$0.25,$238.25,$120092.00,190,$238.25
2024-09-24,22:01:00,20183.25,SELL,1,0.02h,Break Even,$0.25,$238.50,$120092.25,190,$238.50
2024-09-24,22:14:00,20185.5,BUY,1,0.02h,Break Even,$0.25,$238.75,$120092.50,190,$238.75
2024-09-24,22:19:00,20184.25,SELL,1,0.02h,Stop Loss,$4.00,$242.75,$120096.50,190,$242.75
2024-09-24,22:46:00,20185.5,BUY,1,0.02h,Stop Loss,$-6.00,$236.75,$120090.50,190,$236.75
Final P&L Day: 236.75,,,,,,,,,,,
2024-09-25,12:00:00,20140.75,SELL,1,0.02h,Stop Loss,$-6.00,$-6.00,$120084.50,191,$-6.00
2024-09-25,12:28:00,20144.0,BUY,1,0.02h,Break Even,$0.25,$-5.75,$120084.75,191,$-5.75
2024-09-25,12:29:00,20142.25,SELL,1,0.02h,Break Even,$0.25,$-5.50,$120085.00,191,$-5.50
2024-09-25,12:31:00,20145.5,BUY,1,0.02h,Stop Loss,$9.00,$3.50,$120094.00,191,$3.50
2024-09-25,12:48:00,20141.25,SELL,1,0.02h,Break Even,$0.25,$3.75,$120094.25,191,$3.75
2024-09-25,12:55:00,20149.0,BUY,1,0.02h,Stop Loss,$-6.00,$-2.25,$120088.25,191,$-2.25
2024-09-25,12:57:00,20142.75,SELL,1,0.02h,Break Even,$0.25,$-2.00,$120088.50,191,$-2.00
2024-09-25,12:59:00,20150.0,BUY,1,0.02h,Stop Loss,$-6.00,$-8.00,$120082.50,191,$-8.00
2024-09-25,13:04:00,20142.0,SELL,1,0.02h,Stop Loss,$-6.00,$-14.00,$120076.50,191,$-14.00
2024-09-25,13:10:00,20151.0,BUY,1,0.02h,Stop Loss,$-6.00,$-20.00,$120070.50,191,$-20.00
2024-09-25,13:20:00,20146.0,SELL,1,0.02h,Stop Loss,$-6.00,$-26.00,$120064.50,191,$-26.00
2024-09-25,13:31:00,20160.75,BUY,1,0.02h,Stop Loss,$62.75,$36.75,$120127.25,191,$36.75
2024-09-25,14:30:00,20227.5,SELL,1,0.02h,Stop Loss,$61.50,$98.25,$120188.75,191,$98.25
2024-09-25,15:09:00,20243.75,BUY,1,0.02h,Break Even,$0.25,$98.50,$120189.00,191,$98.50
2024-09-25,15:13:00,20222.25,SELL,1,0.02h,Stop Loss,$17.75,$116.25,$120206.75,191,$116.25
2024-09-25,15:39:00,20238.5,BUY,1,0.02h,Stop Loss,$-6.00,$110.25,$120200.75,191,$110.25
2024-09-25,15:47:00,20208.5,SELL,1,0.02h,Break Even,$0.25,$110.50,$120201.00,191,$110.50
2024-09-25,16:21:00,20207.0,BUY,1,0.02h,Stop Loss,$9.00,$119.50,$120210.00,191,$119.50
2024-09-25,16:44:00,20195.75,SELL,1,0.02h,Break Even,$0.25,$119.75,$120210.25,191,$119.75
2024-09-25,17:27:00,20181.0,BUY,1,0.02h,Stop Loss,$9.00,$128.75,$120219.25,191,$128.75
2024-09-25,17:36:00,20162.0,SELL,1,0.02h,Break Even,$0.25,$129.00,$120219.50,191,$129.00
2024-09-25,17:55:00,20186.0,BUY,1,0.02h,Stop Loss,$12.75,$141.75,$120232.25,191,$141.75
2024-09-25,18:13:00,20176.0,SELL,1,0.02h,Break Even,$0.25,$142.00,$120232.50,191,$142.00
2024-09-25,18:27:00,20185.5,BUY,1,0.02h,Stop Loss,$5.25,$147.25,$120237.75,191,$147.25
2024-09-25,18:58:00,20182.75,SELL,1,0.02h,Stop Loss,$30.25,$177.50,$120268.00,191,$177.50
2024-09-25,19:04:00,20198.5,BUY,1,0.02h,Stop Loss,$-6.00,$171.50,$120262.00,191,$171.50
2024-09-25,19:09:00,20186.75,SELL,1,0.02h,Break Even,$0.25,$171.75,$120262.25,191,$171.75
2024-09-25,19:38:00,20185.0,BUY,1,0.02h,Break Even,$0.25,$172.00,$120262.50,191,$172.00
2024-09-25,19:40:00,20179.0,SELL,1,0.02h,Stop Loss,$4.00,$176.00,$120266.50,191,$176.00
2024-09-25,19:49:00,20189.0,BUY,1,0.02h,Break Even,$0.25,$176.25,$120266.75,191,$176.25
2024-09-25,22:03:00,20232.5,SELL,1,0.02h,Stop Loss,$-6.00,$170.25,$120260.75,191,$170.25
2024-09-25,22:29:00,20237.5,BUY,1,0.02h,Stop Loss,$-6.00,$164.25,$120254.75,191,$164.25
Final P&L Day: 164.25,,,,,,,,,,,
2024-09-26,13:26:00,20508.0,SELL,1,0.02h,Break Even,$0.25,$0.25,$120255.00,192,$0.25
2024-09-26,15:18:00,20274.5,BUY,1,0.02h,Stop Loss,$-6.00,$-5.75,$120249.00,192,$-5.75
2024-09-26,15:19:00,20257.0,SELL,1,0.02h,Stop Loss,$99.00,$93.25,$120348.00,192,$93.25
2024-09-26,15:42:00,20250.0,BUY,1,0.02h,Stop Loss,$35.25,$128.50,$120383.25,192,$128.50
2024-09-26,16:12:00,20277.0,SELL,1,0.02h,Stop Loss,$16.50,$145.00,$120399.75,192,$145.00
2024-09-26,16:54:00,20259.0,BUY,1,0.02h,Stop Loss,$-6.00,$139.00,$120393.75,192,$139.00
2024-09-26,16:55:00,20252.25,SELL,1,0.02h,Stop Loss,$6.50,$145.50,$120400.25,192,$145.50
2024-09-26,17:31:00,20256.5,BUY,1,0.02h,Stop Loss,$45.25,$190.75,$120445.50,192,$190.75
2024-09-26,18:48:00,20326.0,SELL,1,0.02h,Stop Loss,$-6.00,$184.75,$120439.50,192,$184.75
2024-09-26,18:52:00,20334.0,BUY,1,0.02h,Break Even,$0.25,$185.00,$120439.75,192,$185.00
2024-09-26,19:03:00,20323.25,SELL,1,0.02h,Stop Loss,$-6.00,$179.00,$120433.75,192,$179.00
2024-09-26,19:06:00,20337.75,BUY,1,0.02h,Stop Loss,$-6.00,$173.00,$120427.75,192,$173.00
2024-09-26,19:40:00,20345.75,SELL,1,0.02h,Break Even,$0.25,$173.25,$120428.00,192,$173.25
2024-09-26,19:50:00,20353.5,BUY,1,0.02h,Break Even,$0.25,$173.50,$120428.25,192,$173.50
2024-09-26,19:51:00,20346.25,SELL,1,0.02h,Stop Loss,$51.50,$225.00,$120479.75,192,$225.00
2024-09-26,20:08:00,20352.0,BUY,1,0.02h,Break Even,$0.25,$225.25,$120480.00,192,$225.25
2024-09-26,20:21:00,20344.0,SELL,1,0.02h,Break Even,$0.25,$225.50,$120480.25,192,$225.50
2024-09-26,20:27:00,20347.0,BUY,1,0.02h,Stop Loss,$-6.00,$219.50,$120474.25,192,$219.50
2024-09-26,20:30:00,20346.25,SELL,1,0.02h,Stop Loss,$-6.00,$213.50,$120468.25,192,$213.50
2024-09-26,20:31:00,20348.0,BUY,1,0.02h,Stop Loss,$-6.00,$207.50,$120462.25,192,$207.50
2024-09-26,20:43:00,20343.25,SELL,1,0.02h,Stop Loss,$-6.00,$201.50,$120456.25,192,$201.50
2024-09-26,22:01:00,20350.0,BUY,1,0.02h,Stop Loss,$5.25,$206.75,$120461.50,192,$206.75
2024-09-26,22:39:00,20368.75,SELL,1,0.02h,Stop Loss,$9.00,$215.75,$120470.50,192,$215.75
2024-09-26,22:46:00,20371.5,BUY,1,0.02h,Break Even,$0.25,$216.00,$120470.75,192,$216.00
2024-09-26,22:53:00,20367.0,SELL,1,0.02h,Break Even,$0.25,$216.25,$120471.00,192,$216.25
Final P&L Day: 216.25,,,,,,,,,,,
2024-09-27,12:23:00,20359.25,BUY,1,0.02h,Stop Loss,$-6.00,$-6.00,$120465.00,193,$-6.00
2024-09-27,12:24:00,20356.5,SELL,1,0.02h,Break Even,$0.25,$-5.75,$120465.25,193,$-5.75
2024-09-27,12:28:00,20359.75,BUY,1,0.02h,Break Even,$0.25,$-5.50,$120465.50,193,$-5.50
2024-09-27,12:55:00,20361.5,SELL,1,0.02h,Stop Loss,$-6.00,$-11.50,$120459.50,193,$-11.50
2024-09-27,13:05:00,20379.25,BUY,1,0.02h,Stop Loss,$10.25,$-1.25,$120469.75,193,$-1.25
2024-09-27,13:26:00,20373.5,SELL,1,0.02h,Break Even,$0.25,$-1.00,$120470.00,193,$-1.00
2024-09-27,14:04:00,20370.25,BUY,1,0.02h,Stop Loss,$11.50,$10.50,$120481.50,193,$10.50
2024-09-27,14:06:00,20331.0,SELL,1,0.02h,Break Even,$0.25,$10.75,$120481.75,193,$10.75
2024-09-27,14:42:00,20325.5,BUY,1,0.02h,Stop Loss,$5.25,$16.00,$120487.00,193,$16.00
2024-09-27,14:51:00,20298.5,SELL,1,0.02h,Break Even,$0.25,$16.25,$120487.25,193,$16.25
2024-09-27,15:43:00,20282.5,BUY,1,0.02h,Break Even,$0.25,$16.50,$120487.50,193,$16.50
2024-09-27,15:50:00,20253.0,SELL,1,0.02h,Stop Loss,$84.00,$100.50,$120571.50,193,$100.50
2024-09-27,16:28:00,20249.75,BUY,1,0.02h,Stop Loss,$35.25,$135.75,$120606.75,193,$135.75
2024-09-27,17:11:00,20252.75,SELL,1,0.02h,Stop Loss,$10.25,$146.00,$120617.00,193,$146.00
2024-09-27,17:48:00,20243.75,BUY,1,0.02h,Break Even,$0.25,$146.25,$120617.25,193,$146.25
2024-09-27,18:13:00,20255.25,SELL,1,0.02h,Stop Loss,$12.75,$159.00,$120630.00,193,$159.00
2024-09-27,18:48:00,20229.75,BUY,1,0.02h,Stop Loss,$5.25,$164.25,$120635.25,193,$164.25
2024-09-27,19:24:00,20235.75,SELL,1,0.02h,Stop Loss,$22.75,$187.00,$120658.00,193,$187.00
2024-09-27,19:54:00,20232.25,BUY,1,0.02h,Stop Loss,$39.00,$226.00,$120697.00,193,$226.00
2024-09-27,20:00:00,20223.0,SELL,1,0.02h,Stop Loss,$37.75,$263.75,$120734.75,193,$263.75
2024-09-27,20:34:00,20207.25,BUY,1,0.02h,Stop Loss,$-6.00,$257.75,$120728.75,193,$257.75
2024-09-27,20:38:00,20204.0,SELL,1,0.02h,Stop Loss,$5.25,$263.00,$120734.00,193,$263.00
Final P&L Day: 263.00,,,,,,,,,,,
2024-09-30,12:30:00,20162.25,BUY,1,0.02h,Break Even,$0.25,$0.25,$120734.25,194,$0.25
2024-09-30,12:42:00,20154.0,SELL,1,0.02h,Break Even,$0.25,$0.50,$120734.50,194,$0.50
2024-09-30,12:51:00,20169.0,BUY,1,0.02h,Break Even,$0.25,$0.75,$120734.75,194,$0.75
2024-09-30,13:24:00,20173.25,SELL,1,0.02h,Break Even,$0.25,$1.00,$120735.00,194,$1.00
2024-09-30,13:29:00,20178.75,BUY,1,0.02h,Stop Loss,$5.25,$6.25,$120740.25,194,$6.25
2024-09-30,13:59:00,20216.75,SELL,1,0.02h,Stop Loss,$71.50,$77.75,$120811.75,194,$77.75
2024-09-30,14:33:00,20177.75,BUY,1,0.02h,Stop Loss,$75.25,$153.00,$120887.00,194,$153.00
2024-09-30,14:47:00,20177.25,SELL,1,0.02h,Stop Loss,$36.50,$189.50,$120923.50,194,$189.50
2024-09-30,14:51:00,20186.0,BUY,1,0.02h,Stop Loss,$-6.00,$183.50,$120917.50,194,$183.50
2024-09-30,14:52:00,20178.25,SELL,1,0.02h,Break Even,$0.25,$183.75,$120917.75,194,$183.75
2024-09-30,14:54:00,20186.25,BUY,1,0.02h,Break Even,$0.25,$184.00,$120918.00,194,$184.00
2024-09-30,14:55:00,20177.5,SELL,1,0.02h,Break Even,$0.25,$184.25,$120918.25,194,$184.25
2024-09-30,15:02:00,20184.5,BUY,1,0.02h,Stop Loss,$14.00,$198.25,$120932.25,194,$198.25
2024-09-30,15:38:00,20186.0,SELL,1,0.02h,Stop Loss,$12.75,$211.00,$120945.00,194,$211.00
2024-09-30,15:48:00,20217.75,BUY,1,0.02h,Break Even,$0.25,$211.25,$120945.25,194,$211.25
2024-09-30,16:33:00,20225.75,SELL,1,0.02h,Break Even,$0.25,$211.50,$120945.50,194,$211.50
2024-09-30,17:53:00,20188.5,BUY,1,0.02h,Stop Loss,$17.75,$229.25,$120963.25,194,$229.25
2024-09-30,18:11:00,20180.75,SELL,1,0.02h,Stop Loss,$24.00,$253.25,$120987.25,194,$253.25
2024-09-30,18:38:00,20146.75,BUY,1,0.02h,Stop Loss,$4.00,$257.25,$120991.25,194,$257.25
2024-09-30,19:02:00,20137.25,SELL,1,0.02h,Stop Loss,$25.25,$282.50,$121016.50,194,$282.50
2024-09-30,19:20:00,20156.5,BUY,1,0.02h,Break Even,$0.25,$282.75,$121016.75,194,$282.75
2024-09-30,20:42:00,20253.5,SELL,1,0.02h,Stop Loss,$-6.00,$276.75,$121010.75,194,$276.75
2024-09-30,22:29:00,20237.25,BUY,1,0.02h,Stop Loss,$-6.00,$270.75,$121004.75,194,$270.75
2024-09-30,23:00:00,20234.75,SELL,1,13.00h,Stop Loss,$-6.00,$264.75,$120998.75,194,$264.75
Final P&L Day: 264.75,,,,,,,,,,,
2024-10-01,12:00:00,20272.25,BUY,1,0.02h,Break Even,$0.25,$0.25,$120999.00,195,$0.25
2024-10-01,12:32:00,20262.5,SELL,1,0.02h,Stop Loss,$4.00,$4.25,$121003.00,195,$4.25
2024-10-01,12:55:00,20269.75,BUY,1,0.02h,Break Even,$0.25,$4.50,$121003.25,195,$4.50
2024-10-01,13:16:00,20258.75,SELL,1,0.02h,Break Even,$0.25,$4.75,$121003.50,195,$4.75
2024-10-01,14:43:00,19960.5,BUY,1,0.02h,Stop Loss,$4.00,$8.75,$121007.50,195,$8.75
2024-10-01,14:53:00,19921.0,SELL,1,0.02h,Break Even,$0.25,$9.00,$121007.75,195,$9.00
2024-10-01,15:30:00,19893.5,BUY,1,0.02h,Stop Loss,$15.25,$24.25,$121023.00,195,$24.25
2024-10-01,16:02:00,19919.5,SELL,1,0.02h,Stop Loss,$12.75,$37.00,$121035.75,195,$37.00
2024-10-01,16:04:00,19955.5,BUY,1,0.02h,Stop Loss,$52.75,$89.75,$121088.50,195,$89.75
2024-10-01,16:27:00,19948.25,SELL,1,0.02h,Stop Loss,$69.00,$158.75,$121157.50,195,$158.75
2024-10-01,16:56:00,19927.5,BUY,1,0.02h,Stop Loss,$19.00,$177.75,$121176.50,195,$177.75
2024-10-01,17:05:00,19894.5,SELL,1,0.02h,Stop Loss,$81.50,$259.25,$121258.00,195,$259.25
2024-10-01,17:33:00,19888.5,BUY,1,0.02h,Stop Loss,$79.00,$338.25,$121337.00,195,$338.25
2024-10-01,18:53:00,20040.0,SELL,1,0.02h,Stop Loss,$37.75,$376.00,$121374.75,195,$376.00
2024-10-01,18:57:00,20061.0,BUY,1,0.02h,Stop Loss,$7.75,$383.75,$121382.50,195,$383.75
2024-10-01,19:06:00,20044.5,SELL,1,0.02h,Break Even,$0.25,$384.00,$121382.75,195,$384.00
2024-10-01,19:08:00,20053.5,BUY,1,0.02h,Stop Loss,$39.00,$423.00,$121421.75,195,$423.00
2024-10-01,19:13:00,20039.0,SELL,1,0.02h,Stop Loss,$40.25,$463.25,$121462.00,195,$463.25
2024-10-01,20:02:00,20008.75,BUY,1,0.02h,Stop Loss,$26.50,$489.75,$121488.50,195,$489.75
2024-10-01,20:09:00,19983.0,SELL,1,0.02h,Stop Loss,$-6.00,$483.75,$121482.50,195,$483.75
2024-10-01,22:01:00,19980.75,BUY,1,0.02h,Stop Loss,$-6.00,$477.75,$121476.50,195,$477.75
2024-10-01,22:03:00,19952.5,SELL,1,0.02h,Break Even,$0.25,$478.00,$121476.75,195,$478.00
2024-10-01,22:37:00,19941.25,BUY,1,0.02h,Break Even,$0.25,$478.25,$121477.00,195,$478.25
2024-10-01,22:45:00,19912.75,SELL,1,0.02h,Stop Loss,$-6.00,$472.25,$121471.00,195,$472.25
Final P&L Day: 472.25,,,,,,,,,,,
2024-10-02,12:01:00,19933.5,BUY,1,0.02h,Stop Loss,$26.50,$26.50,$121497.50,196,$26.50
2024-10-02,12:30:00,19931.5,SELL,1,0.02h,Stop Loss,$-6.00,$20.50,$121491.50,196,$20.50
2024-10-02,12:36:00,19954.25,BUY,1,0.02h,Stop Loss,$29.00,$49.50,$121520.50,196,$49.50
2024-10-02,13:01:00,19963.75,SELL,1,0.02h,Stop Loss,$31.50,$81.00,$121552.00,196,$81.00
2024-10-02,13:56:00,19922.75,BUY,1,0.02h,Break Even,$0.25,$81.25,$121552.25,196,$81.25
2024-10-02,14:57:00,20002.25,SELL,1,0.02h,Stop Loss,$7.75,$89.00,$121560.00,196,$89.00
2024-10-02,15:04:00,20033.25,BUY,1,0.02h,Stop Loss,$35.25,$124.25,$121595.25,196,$124.25
2024-10-02,15:55:00,20046.0,SELL,1,0.02h,Stop Loss,$24.00,$148.25,$121619.25,196,$148.25
2024-10-02,16:02:00,20062.25,BUY,1,0.02h,Stop Loss,$50.25,$198.50,$121669.50,196,$198.50
2024-10-02,16:20:00,20047.5,SELL,1,0.02h,Stop Loss,$45.25,$243.75,$121714.75,196,$243.75
2024-10-02,16:27:00,20075.25,BUY,1,0.02h,Break Even,$0.25,$244.00,$121715.00,196,$244.00
2024-10-02,16:32:00,20049.25,SELL,1,0.02h,Break Even,$0.25,$244.25,$121715.25,196,$244.25
2024-10-02,17:29:00,20018.5,BUY,1,0.02h,Break Even,$0.25,$244.50,$121715.50,196,$244.50
2024-10-02,17:35:00,19976.25,SELL,1,0.02h,Stop Loss,$25.25,$269.75,$121740.75,196,$269.75
2024-10-02,17:39:00,20005.75,BUY,1,0.02h,Stop Loss,$14.00,$283.75,$121754.75,196,$283.75
2024-10-02,18:25:00,20036.0,SELL,1,0.02h,Break Even,$0.25,$284.00,$121755.00,196,$284.00
2024-10-02,19:05:00,20028.75,BUY,1,0.02h,Break Even,$0.25,$284.25,$121755.25,196,$284.25
2024-10-02,19:41:00,20024.75,SELL,1,0.02h,Stop Loss,$-6.00,$278.25,$121749.25,196,$278.25
2024-10-02,19:45:00,20043.75,BUY,1,0.02h,Stop Loss,$22.75,$301.00,$121772.00,196,$301.00
2024-10-02,19:55:00,20030.75,SELL,1,0.02h,Stop Loss,$26.50,$327.50,$121798.50,196,$327.50
2024-10-02,20:11:00,20035.5,BUY,1,0.02h,Stop Loss,$4.00,$331.50,$121802.50,196,$331.50
2024-10-02,22:02:00,20049.0,SELL,1,0.02h,Stop Loss,$35.25,$366.75,$121837.75,196,$366.75
2024-10-02,22:10:00,20067.75,BUY,1,0.02h,Stop Loss,$-6.00,$360.75,$121831.75,196,$360.75
2024-10-02,22:16:00,20055.5,SELL,1,0.02h,Break Even,$0.25,$361.00,$121832.00,196,$361.00
Final P&L Day: 361.00,,,,,,,,,,,
2024-10-03,12:34:00,19982.75,BUY,1,0.02h,Stop Loss,$-6.00,$-6.00,$121826.00,197,$-6.00
2024-10-03,12:35:00,19964.25,SELL,1,0.02h,Stop Loss,$80.25,$74.25,$121906.25,197,$74.25
2024-10-03,13:33:00,19940.5,BUY,1,0.02h,Stop Loss,$92.75,$167.00,$121999.00,197,$167.00
2024-10-03,14:20:00,20028.25,SELL,1,0.02h,Stop Loss,$59.00,$226.00,$122058.00,197,$226.00
2024-10-03,14:52:00,20019.5,BUY,1,0.02h,Stop Loss,$9.00,$235.00,$122067.00,197,$235.00
2024-10-03,15:00:00,19939.75,SELL,1,0.02h,Stop Loss,$17.75,$252.75,$122084.75,197,$252.75
2024-10-03,15:17:00,19983.0,BUY,1,0.02h,Break Even,$0.25,$253.00,$122085.00,197,$253.00
2024-10-03,16:07:00,20030.0,SELL,1,0.02h,Stop Loss,$41.50,$294.50,$122126.50,197,$294.50
2024-10-03,16:11:00,20042.75,BUY,1,0.02h,Break Even,$0.25,$294.75,$122126.75,197,$294.75
2024-10-03,16:17:00,20032.25,SELL,1,0.02h,Stop Loss,$20.25,$315.00,$122147.00,197,$315.00
2024-10-03,16:23:00,20047.5,BUY,1,0.02h,Stop Loss,$-6.00,$309.00,$122141.00,197,$309.00
2024-10-03,16:31:00,20014.0,SELL,1,0.02h,Stop Loss,$9.00,$318.00,$122150.00,197,$318.00
2024-10-03,17:22:00,19936.75,BUY,1,0.02h,Stop Loss,$36.50,$354.50,$122186.50,197,$354.50
2024-10-03,17:43:00,19937.75,SELL,1,0.02h,Break Even,$0.25,$354.75,$122186.75,197,$354.75
2024-10-03,17:46:00,19960.25,BUY,1,0.02h,Stop Loss,$5.25,$360.00,$122192.00,197,$360.00
2024-10-03,17:51:00,19941.5,SELL,1,0.02h,Break Even,$0.25,$360.25,$122192.25,197,$360.25
2024-10-03,17:55:00,19956.25,BUY,1,0.02h,Stop Loss,$30.25,$390.50,$122222.50,197,$390.50
2024-10-03,18:18:00,19955.75,SELL,1,0.02h,Break Even,$0.25,$390.75,$122222.75,197,$390.75
2024-10-03,18:20:00,19965.75,BUY,1,0.02h,Break Even,$0.25,$391.00,$122223.00,197,$391.00
2024-10-03,18:23:00,19933.75,SELL,1,0.02h,Break Even,$0.25,$391.25,$122223.25,197,$391.25
2024-10-03,18:41:00,19956.5,BUY,1,0.02h,Stop Loss,$25.25,$416.50,$122248.50,197,$416.50
2024-10-03,18:58:00,19948.5,SELL,1,0.02h,Stop Loss,$10.25,$426.75,$122258.75,197,$426.75
2024-10-03,19:25:00,19940.0,BUY,1,0.02h,Break Even,$0.25,$427.00,$122259.00,197,$427.00
2024-10-03,19:29:00,19918.0,SELL,1,0.02h,Stop Loss,$-6.00,$421.00,$122253.00,197,$421.00
2024-10-03,19:35:00,19944.25,BUY,1,0.02h,Stop Loss,$9.00,$430.00,$122262.00,197,$430.00
2024-10-03,20:26:00,19983.5,SELL,1,0.02h,Break Even,$0.25,$430.25,$122262.25,197,$430.25
2024-10-03,22:29:00,19955.75,BUY,1,0.02h,Stop Loss,$-6.00,$424.25,$122256.25,197,$424.25
Final P&L Day: 424.25,,,,,,,,,,,
2024-10-04,13:25:00,20225.0,SELL,1,0.02h,Break Even,$0.25,$0.25,$122256.50,198,$0.25
2024-10-04,14:44:00,20079.25,BUY,1,0.02h,Stop Loss,$67.75,$68.00,$122324.25,198,$68.00
2024-10-04,15:16:00,20099.0,SELL,1,0.02h,Break Even,$0.25,$68.25,$122324.50,198,$68.25
2024-10-04,15:53:00,20088.0,BUY,1,0.02h,Stop Loss,$57.75,$126.00,$122382.25,198,$126.00
2024-10-04,16:14:00,20100.25,SELL,1,0.02h,Stop Loss,$25.25,$151.25,$122407.50,198,$151.25
2024-10-04,16:34:00,20111.75,BUY,1,0.02h,Stop Loss,$-6.00,$145.25,$122401.50,198,$145.25
2024-10-04,17:03:00,20142.75,SELL,1,0.02h,Stop Loss,$-6.00,$139.25,$122395.50,198,$139.25
2024-10-04,17:16:00,20156.5,BUY,1,0.02h,Stop Loss,$34.00,$173.25,$122429.50,198,$173.25
2024-10-04,17:30:00,20145.0,SELL,1,0.02h,Stop Loss,$14.00,$187.25,$122443.50,198,$187.25
2024-10-04,17:45:00,20168.0,BUY,1,0.02h,Stop Loss,$-6.00,$181.25,$122437.50,198,$181.25
2024-10-04,17:54:00,20130.0,SELL,1,0.02h,Stop Loss,$20.25,$201.50,$122457.75,198,$201.50
2024-10-04,18:23:00,20141.75,BUY,1,0.02h,Stop Loss,$-6.00,$195.50,$122451.75,198,$195.50
2024-10-04,20:17:00,20214.0,SELL,1,0.02h,Stop Loss,$-6.00,$189.50,$122445.75,198,$189.50
Final P&L Day: 189.50,,,,,,,,,,,
2024-10-07,12:38:00,20136.0,BUY,1,0.02h,Stop Loss,$-6.00,$-6.00,$122439.75,199,$-6.00
2024-10-07,12:55:00,20132.25,SELL,1,0.02h,Stop Loss,$15.25,$9.25,$122455.00,199,$9.25
2024-10-07,13:09:00,20142.5,BUY,1,0.02h,Stop Loss,$-6.00,$3.25,$122449.00,199,$3.25
2024-10-07,13:44:00,20118.75,SELL,1,0.02h,Stop Loss,$41.50,$44.75,$122490.50,199,$44.75
2024-10-07,14:06:00,20142.5,BUY,1,0.02h,Stop Loss,$-6.00,$38.75,$122484.50,199,$38.75
2024-10-07,14:45:00,20147.75,SELL,1,0.02h,Stop Loss,$12.75,$51.50,$122497.25,199,$51.50
2024-10-07,14:57:00,20165.25,BUY,1,0.02h,Stop Loss,$32.75,$84.25,$122530.00,199,$84.25
2024-10-07,15:02:00,20142.75,SELL,1,0.02h,Stop Loss,$67.75,$152.00,$122597.75,199,$152.00
2024-10-07,15:15:00,20158.75,BUY,1,0.02h,Break Even,$0.25,$152.25,$122598.00,199,$152.25
2024-10-07,15:39:00,20148.5,SELL,1,0.02h,Break Even,$0.25,$152.50,$122598.25,199,$152.50
2024-10-07,15:41:00,20168.0,BUY,1,0.02h,Break Even,$0.25,$152.75,$122598.50,199,$152.75
2024-10-07,15:44:00,20149.25,SELL,1,0.02h,Break Even,$0.25,$153.00,$122598.75,199,$153.00
2024-10-07,16:18:00,20159.5,BUY,1,0.02h,Break Even,$0.25,$153.25,$122599.00,199,$153.25
2024-10-07,16:33:00,20137.0,SELL,1,0.02h,Break Even,$0.25,$153.50,$122599.25,199,$153.50
2024-10-07,17:03:00,20150.25,BUY,1,0.02h,Stop Loss,$6.50,$160.00,$122605.75,199,$160.00
2024-10-07,17:24:00,20132.75,SELL,1,0.02h,Stop Loss,$-6.00,$154.00,$122599.75,199,$154.00
2024-10-07,17:57:00,20134.25,BUY,1,0.02h,Stop Loss,$11.50,$165.50,$122611.25,199,$165.50
2024-10-07,18:03:00,20121.5,SELL,1,0.02h,Stop Loss,$14.00,$179.50,$122625.25,199,$179.50
2024-10-07,19:23:00,20015.75,BUY,1,0.02h,Stop Loss,$7.75,$187.25,$122633.00,199,$187.25
2024-10-07,19:29:00,19994.75,SELL,1,0.02h,Stop Loss,$12.75,$200.00,$122645.75,199,$200.00
2024-10-07,19:52:00,20008.75,BUY,1,0.02h,Stop Loss,$15.25,$215.25,$122661.00,199,$215.25
2024-10-07,20:56:00,20018.5,SELL,1,0.02h,Break Even,$0.25,$215.50,$122661.25,199,$215.50
2024-10-07,22:02:00,20029.0,BUY,1,0.02h,Break Even,$0.25,$215.75,$122661.50,199,$215.75
2024-10-07,22:05:00,20017.5,SELL,1,0.02h,Stop Loss,$26.50,$242.25,$122688.00,199,$242.25
Final P&L Day: 242.25,,,,,,,,,,,
2024-10-08,12:00:00,20094.0,BUY,1,0.02h,Stop Loss,$7.75,$7.75,$122695.75,200,$7.75
2024-10-08,12:42:00,20061.75,SELL,1,0.02h,Stop Loss,$-6.00,$1.75,$122689.75,200,$1.75
2024-10-08,13:05:00,20067.0,BUY,1,0.02h,Break Even,$0.25,$2.00,$122690.00,200,$2.00
2024-10-08,13:06:00,20064.0,SELL,1,0.02h,Stop Loss,$7.75,$9.75,$122697.75,200,$9.75
2024-10-08,13:10:00,20072.0,BUY,1,0.02h,Stop Loss,$10.25,$20.00,$122708.00,200,$20.00
2024-10-08,15:12:00,20228.25,SELL,1,0.02h,Stop Loss,$12.75,$32.75,$122720.75,200,$32.75
2024-10-08,15:42:00,20235.5,BUY,1,0.02h,Stop Loss,$11.50,$44.25,$122732.25,200,$44.25
2024-10-08,16:04:00,20230.25,SELL,1,0.02h,Stop Loss,$29.00,$73.25,$122761.25,200,$73.25
2024-10-08,16:23:00,20233.5,BUY,1,0.02h,Break Even,$0.25,$73.50,$122761.50,200,$73.50
2024-10-08,16:25:00,20224.0,SELL,1,0.02h,Stop Loss,$-6.00,$67.50,$122755.50,200,$67.50
2024-10-08,16:28:00,20238.5,BUY,1,0.02h,Break Even,$0.25,$67.75,$122755.75,200,$67.75
2024-10-08,16:50:00,20222.75,SELL,1,0.02h,Stop Loss,$15.25,$83.00,$122771.00,200,$83.00
2024-10-08,17:01:00,20234.5,BUY,1,0.02h,Stop Loss,$-6.00,$77.00,$122765.00,200,$77.00
2024-10-08,17:02:00,20230.75,SELL,1,0.02h,Stop Loss,$9.00,$86.00,$122774.00,200,$86.00
2024-10-08,17:35:00,20207.75,BUY,1,0.02h,Stop Loss,$32.75,$118.75,$122806.75,200,$118.75
2024-10-08,18:32:00,20228.0,SELL,1,0.02h,Stop Loss,$7.75,$126.50,$122814.50,200,$126.50
2024-10-08,18:36:00,20242.0,BUY,1,0.02h,Break Even,$0.25,$126.75,$122814.75,200,$126.75
2024-10-08,20:01:00,20286.5,SELL,1,0.02h,Stop Loss,$16.50,$143.25,$122831.25,200,$143.25
2024-10-08,20:38:00,20292.5,BUY,1,0.02h,Break Even,$0.25,$143.50,$122831.50,200,$143.50
2024-10-08,20:56:00,20280.5,SELL,1,0.02h,Stop Loss,$-6.00,$137.50,$122825.50,200,$137.50
2024-10-08,22:26:00,20286.25,BUY,1,0.02h,Stop Loss,$-6.00,$131.50,$122819.50,200,$131.50
2024-10-08,22:27:00,20284.25,SELL,1,0.03h,Break Even,$0.25,$131.75,$122819.75,200,$131.75
2024-10-08,22:56:00,20284.5,BUY,1,0.02h,Stop Loss,$31.50,$163.25,$122851.25,200,$163.25
Final P&L Day: 163.25,,,,,,,,,,,
2024-10-09,12:00:00,20257.25,SELL,1,0.02h,Break Even,$0.25,$0.25,$122851.50,201,$0.25
2024-10-09,12:30:00,20271.75,BUY,1,0.02h,Stop Loss,$-6.00,$-5.75,$122845.50,201,$-5.75
2024-10-09,12:45:00,20264.5,SELL,1,0.02h,Stop Loss,$16.50,$10.75,$122862.00,201,$10.75
2024-10-09,12:57:00,20272.75,BUY,1,0.02h,Break Even,$0.25,$11.00,$122862.25,201,$11.00
2024-10-09,13:31:00,20284.25,SELL,1,0.02h,Stop Loss,$81.50,$92.50,$122943.75,201,$92.50
2024-10-09,14:02:00,20271.25,BUY,1,0.02h,Stop Loss,$11.50,$104.00,$122955.25,201,$104.00
2024-10-09,14:48:00,20321.5,SELL,1,0.02h,Break Even,$0.25,$104.25,$122955.50,201,$104.25
2024-10-09,14:58:00,20347.75,BUY,1,0.02h,Stop Loss,$5.25,$109.50,$122960.75,201,$109.50
2024-10-09,16:06:00,20403.5,SELL,1,0.02h,Break Even,$0.25,$109.75,$122961.00,201,$109.75
2024-10-09,16:31:00,20409.0,BUY,1,0.02h,Stop Loss,$21.50,$131.25,$122982.50,201,$131.25
2024-10-09,16:53:00,20403.75,SELL,1,0.02h,Stop Loss,$36.50,$167.75,$123019.00,201,$167.75
2024-10-09,17:14:00,20407.0,BUY,1,0.02h,Break Even,$0.25,$168.00,$123019.25,201,$168.00
2024-10-09,17:52:00,20411.5,SELL,1,0.02h,Stop Loss,$76.50,$244.50,$123095.75,201,$244.50
2024-10-09,18:08:00,20410.5,BUY,1,0.02h,Break Even,$0.25,$244.75,$123096.00,201,$244.75
2024-10-09,18:12:00,20400.0,SELL,1,0.02h,Stop Loss,$9.00,$253.75,$123105.00,201,$253.75
2024-10-09,18:15:00,20410.75,BUY,1,0.02h,Stop Loss,$-6.00,$247.75,$123099.00,201,$247.75
2024-10-09,18:17:00,20401.5,SELL,1,0.02h,Break Even,$0.25,$248.00,$123099.25,201,$248.00
2024-10-09,18:25:00,20413.25,BUY,1,0.02h,Stop Loss,$57.75,$305.75,$123157.00,201,$305.75
2024-10-09,19:01:00,20427.75,SELL,1,0.02h,Stop Loss,$17.75,$323.50,$123174.75,201,$323.50
2024-10-09,19:06:00,20441.25,BUY,1,0.02h,Stop Loss,$-6.00,$317.50,$123168.75,201,$317.50
2024-10-09,19:08:00,20420.5,SELL,1,0.02h,Stop Loss,$26.50,$344.00,$123195.25,201,$344.00
2024-10-09,19:19:00,20435.0,BUY,1,0.02h,Stop Loss,$4.00,$348.00,$123199.25,201,$348.00
2024-10-09,20:03:00,20441.25,SELL,1,0.02h,Stop Loss,$10.25,$358.25,$123209.50,201,$358.25
2024-10-09,20:38:00,20436.75,BUY,1,0.02h,Stop Loss,$-6.00,$352.25,$123203.50,201,$352.25
2024-10-09,22:09:00,20437.0,SELL,1,0.02h,Stop Loss,$-6.00,$346.25,$123197.50,201,$346.25
2024-10-09,22:13:00,20440.0,BUY,1,0.02h,Break Even,$0.25,$346.50,$123197.75,201,$346.50
2024-10-09,22:15:00,20437.0,SELL,1,0.02h,Stop Loss,$-6.00,$340.50,$123191.75,201,$340.50
2024-10-09,22:17:00,20441.0,BUY,1,0.02h,Break Even,$0.25,$340.75,$123192.00,201,$340.75
Final P&L Day: 340.75,,,,,,,,,,,
2024-10-10,12:00:00,20437.25,SELL,1,0.02h,Break Even,$0.25,$0.25,$123192.25,202,$0.25
2024-10-10,12:09:00,20450.75,BUY,1,0.02h,Break Even,$0.25,$0.50,$123192.50,202,$0.50
2024-10-10,12:16:00,20444.75,SELL,1,0.02h,Break Even,$0.25,$0.75,$123192.75,202,$0.75
2024-10-10,13:05:00,20380.25,BUY,1,0.02h,Break Even,$0.25,$1.00,$123193.00,202,$1.00
2024-10-10,13:10:00,20362.5,SELL,1,0.02h,Stop Loss,$21.50,$22.50,$123214.50,202,$22.50
2024-10-10,13:32:00,20380.25,BUY,1,0.02h,Stop Loss,$27.75,$50.25,$123242.25,202,$50.25
2024-10-10,13:48:00,20331.75,SELL,1,0.02h,Stop Loss,$77.75,$128.00,$123320.00,202,$128.00
2024-10-10,13:58:00,20371.25,BUY,1,0.02h,Stop Loss,$32.75,$160.75,$123352.75,202,$160.75
2024-10-10,14:26:00,20381.0,SELL,1,0.02h,Break Even,$0.25,$161.00,$123353.00,202,$161.00
2024-10-10,14:27:00,20391.75,BUY,1,0.02h,Stop Loss,$76.50,$237.50,$123429.50,202,$237.50
2024-10-10,14:35:00,20380.0,SELL,1,0.02h,Stop Loss,$14.00,$251.50,$123443.50,202,$251.50
2024-10-10,14:44:00,20410.0,BUY,1,0.02h,Stop Loss,$26.50,$278.00,$123470.00,202,$278.00
2024-10-10,14:54:00,20377.25,SELL,1,0.02h,Stop Loss,$15.25,$293.25,$123485.25,202,$293.25
2024-10-10,15:08:00,20403.25,BUY,1,0.02h,Stop Loss,$37.75,$331.00,$123523.00,202,$331.00
2024-10-10,16:28:00,20478.75,SELL,1,0.02h,Stop Loss,$45.25,$376.25,$123568.25,202,$376.25
2024-10-10,17:21:00,20455.75,BUY,1,0.02h,Stop Loss,$17.75,$394.00,$123586.00,202,$394.00
2024-10-10,17:47:00,20446.5,SELL,1,0.02h,Stop Loss,$69.00,$463.00,$123655.00,202,$463.00
2024-10-10,18:50:00,20411.0,BUY,1,0.02h,Stop Loss,$-6.00,$457.00,$123649.00,202,$457.00
2024-10-10,18:51:00,20402.5,SELL,1,0.02h,Stop Loss,$-6.00,$451.00,$123643.00,202,$451.00
2024-10-10,18:53:00,20410.25,BUY,1,0.02h,Break Even,$0.25,$451.25,$123643.25,202,$451.25
2024-10-10,19:05:00,20401.5,SELL,1,0.02h,Stop Loss,$29.00,$480.25,$123672.25,202,$480.25
2024-10-10,19:20:00,20413.5,BUY,1,0.02h,Stop Loss,$6.50,$486.75,$123678.75,202,$486.75
2024-10-10,19:37:00,20404.5,SELL,1,0.02h,Stop Loss,$22.75,$509.50,$123701.50,202,$509.50
2024-10-10,19:48:00,20416.5,BUY,1,0.02h,Break Even,$0.25,$509.75,$123701.75,202,$509.75
2024-10-10,20:10:00,20420.0,SELL,1,0.02h,Stop Loss,$-6.00,$503.75,$123695.75,202,$503.75
2024-10-10,20:17:00,20430.0,BUY,1,0.02h,Stop Loss,$-6.00,$497.75,$123689.75,202,$497.75
2024-10-10,22:01:00,20432.0,SELL,1,0.02h,Stop Loss,$5.25,$503.00,$123695.00,202,$503.00
2024-10-10,22:24:00,20433.0,BUY,1,0.02h,Stop Loss,$-6.00,$497.00,$123689.00,202,$497.00
2024-10-10,22:39:00,20430.5,SELL,1,0.02h,Break Even,$0.25,$497.25,$123689.25,202,$497.25
2024-10-10,22:40:00,20433.75,BUY,1,0.02h,Break Even,$0.25,$497.50,$123689.50,202,$497.50
2024-10-10,22:56:00,20433.0,SELL,1,0.02h,Stop Loss,$-6.00,$491.50,$123683.50,202,$491.50
Final P&L Day: 491.50,,,,,,,,,,,
2024-10-11,12:32:00,20408.25,BUY,1,0.02h,Stop Loss,$11.50,$11.50,$123695.00,203,$11.50
2024-10-11,12:39:00,20383.75,SELL,1,0.02h,Stop Loss,$45.25,$56.75,$123740.25,203,$56.75
2024-10-11,13:48:00,20354.5,BUY,1,0.02h,Break Even,$0.25,$57.00,$123740.50,203,$57.00
2024-10-11,14:46:00,20434.25,SELL,1,0.02h,Stop Loss,$-6.00,$51.00,$123734.50,203,$51.00
2024-10-11,15:04:00,20441.5,BUY,1,0.02h,Stop Loss,$39.00,$90.00,$123773.50,203,$90.00
2024-10-11,15:19:00,20423.5,SELL,1,0.02h,Stop Loss,$54.00,$144.00,$123827.50,203,$144.00
2024-10-11,15:34:00,20442.75,BUY,1,0.02h,Stop Loss,$19.00,$163.00,$123846.50,203,$163.00
2024-10-11,16:16:00,20452.75,SELL,1,0.02h,Stop Loss,$11.50,$174.50,$123858.00,203,$174.50
2024-10-11,16:59:00,20439.5,BUY,1,0.02h,Break Even,$0.25,$174.75,$123858.25,203,$174.75
2024-10-11,17:14:00,20424.25,SELL,1,0.02h,Stop Loss,$-6.00,$168.75,$123852.25,203,$168.75
2024-10-11,17:25:00,20437.75,BUY,1,0.02h,Stop Loss,$7.75,$176.50,$123860.00,203,$176.50
2024-10-11,18:01:00,20437.5,SELL,1,0.02h,Break Even,$0.25,$176.75,$123860.25,203,$176.75
2024-10-11,18:06:00,20444.5,BUY,1,0.02h,Break Even,$0.25,$177.00,$123860.50,203,$177.00
2024-10-11,18:37:00,20454.0,SELL,1,0.02h,Stop Loss,$4.00,$181.00,$123864.50,203,$181.00
2024-10-11,18:49:00,20459.0,BUY,1,0.02h,Break Even,$0.25,$181.25,$123864.75,203,$181.25
2024-10-11,19:38:00,20473.5,SELL,1,0.02h,Stop Loss,$10.25,$191.50,$123875.00,203,$191.50
Final P&L Day: 191.50,,,,,,,,,,,
2024-10-14,12:00:00,20506.75,BUY,1,0.02h,Break Even,$0.25,$0.25,$123875.25,204,$0.25
2024-10-14,13:30:00,20550.5,SELL,1,0.02h,Stop Loss,$32.75,$33.00,$123908.00,204,$33.00
2024-10-14,13:32:00,20557.0,BUY,1,0.02h,Stop Loss,$69.00,$102.00,$123977.00,204,$102.00
2024-10-14,14:14:00,20627.75,SELL,1,0.02h,Stop Loss,$9.00,$111.00,$123986.00,204,$111.00
2024-10-14,14:29:00,20638.25,BUY,1,0.02h,Stop Loss,$17.75,$128.75,$124003.75,204,$128.75
2024-10-14,14:46:00,20627.0,SELL,1,0.02h,Stop Loss,$4.00,$132.75,$124007.75,204,$132.75
2024-10-14,15:22:00,20578.5,BUY,1,0.02h,Stop Loss,$26.50,$159.25,$124034.25,204,$159.25
2024-10-14,15:26:00,20561.0,SELL,1,0.02h,Stop Loss,$50.25,$209.50,$124084.50,204,$209.50
2024-10-14,15:48:00,20568.0,BUY,1,0.02h,Stop Loss,$9.00,$218.50,$124093.50,204,$218.50
2024-10-14,16:58:00,20601.25,SELL,1,0.02h,Stop Loss,$-6.00,$212.50,$124087.50,204,$212.50
2024-10-14,17:04:00,20618.5,BUY,1,0.02h,Stop Loss,$6.50,$219.00,$124094.00,204,$219.00
2024-10-14,17:11:00,20606.75,SELL,1,0.02h,Stop Loss,$21.50,$240.50,$124115.50,204,$240.50
2024-10-14,17:27:00,20611.5,BUY,1,0.02h,Stop Loss,$-6.00,$234.50,$124109.50,204,$234.50
2024-10-14,17:34:00,20600.0,SELL,1,0.02h,Stop Loss,$12.75,$247.25,$124122.25,204,$247.25
2024-10-14,17:39:00,20612.5,BUY,1,0.02h,Break Even,$0.25,$247.50,$124122.50,204,$247.50
2024-10-14,18:01:00,20603.0,SELL,1,0.02h,Break Even,$0.25,$247.75,$124122.75,204,$247.75
2024-10-14,18:06:00,20611.0,BUY,1,0.02h,Break Even,$0.25,$248.00,$124123.00,204,$248.00
2024-10-14,19:01:00,20620.0,SELL,1,0.02h,Stop Loss,$5.25,$253.25,$124128.25,204,$253.25
2024-10-14,19:15:00,20627.25,BUY,1,0.02h,Stop Loss,$12.75,$266.00,$124141.00,204,$266.00
2024-10-14,19:55:00,20633.5,SELL,1,0.02h,Stop Loss,$26.50,$292.50,$124167.50,204,$292.50
2024-10-14,20:44:00,20627.5,BUY,1,0.02h,Stop Loss,$-6.00,$286.50,$124161.50,204,$286.50
2024-10-14,22:12:00,20625.0,SELL,1,0.03h,Break Even,$0.25,$286.75,$124161.75,204,$286.75
2024-10-14,22:29:00,20631.0,BUY,1,0.02h,Stop Loss,$-6.00,$280.75,$124155.75,204,$280.75
2024-10-14,22:36:00,20624.75,SELL,1,0.02h,Break Even,$0.25,$281.00,$124156.00,204,$281.00
2024-10-14,22:59:00,20625.5,BUY,1,13.02h,Stop Loss,$-6.00,$275.00,$124150.00,204,$275.00
Final P&L Day: 275.00,,,,,,,,,,,
2024-10-15,12:00:00,20613.0,SELL,1,0.02h,Stop Loss,$6.50,$6.50,$124156.50,205,$6.50
2024-10-15,12:19:00,20628.5,BUY,1,0.02h,Break Even,$0.25,$6.75,$124156.75,205,$6.75
2024-10-15,12:27:00,20614.5,SELL,1,0.02h,Break Even,$0.25,$7.00,$124157.00,205,$7.00
2024-10-15,12:53:00,20616.75,BUY,1,0.02h,Stop Loss,$7.75,$14.75,$124164.75,205,$14.75
2024-10-15,13:30:00,20631.25,SELL,1,0.02h,Stop Loss,$111.50,$126.25,$124276.25,205,$126.25
2024-10-15,13:55:00,20639.75,BUY,1,0.02h,Stop Loss,$70.25,$196.50,$124346.50,205,$196.50
2024-10-15,14:10:00,20621.25,SELL,1,0.02h,Stop Loss,$80.25,$276.75,$124426.75,205,$276.75
2024-10-15,15:16:00,20436.0,BUY,1,0.02h,Stop Loss,$20.25,$297.00,$124447.00,205,$297.00
2024-10-15,15:26:00,20402.75,SELL,1,0.02h,Stop Loss,$9.00,$306.00,$124456.00,205,$306.00
2024-10-15,15:34:00,20422.75,BUY,1,0.02h,Stop Loss,$37.75,$343.75,$124493.75,205,$343.75
2024-10-15,15:40:00,20400.0,SELL,1,0.02h,Stop Loss,$31.50,$375.25,$124525.25,205,$375.25
2024-10-15,16:11:00,20390.5,BUY,1,0.02h,Stop Loss,$5.25,$380.50,$124530.50,205,$380.50
2024-10-15,16:46:00,20391.5,SELL,1,0.02h,Stop Loss,$45.25,$425.75,$124575.75,205,$425.75
2024-10-15,17:41:00,20373.0,BUY,1,0.02h,Break Even,$0.25,$426.00,$124576.00,205,$426.00
2024-10-15,17:58:00,20356.25,SELL,1,0.02h,Stop Loss,$-6.00,$420.00,$124570.00,205,$420.00
2024-10-15,18:04:00,20385.25,BUY,1,0.02h,Break Even,$0.25,$420.25,$124570.25,205,$420.25
2024-10-15,18:10:00,20364.75,SELL,1,0.02h,Stop Loss,$4.00,$424.25,$124574.25,205,$424.25
2024-10-15,18:22:00,20378.75,BUY,1,0.02h,Break Even,$0.25,$424.50,$124574.50,205,$424.50
2024-10-15,18:34:00,20363.0,SELL,1,0.02h,Stop Loss,$11.50,$436.00,$124586.00,205,$436.00
2024-10-15,19:43:00,20306.75,BUY,1,0.02h,Break Even,$0.25,$436.25,$124586.25,205,$436.25
2024-10-15,20:18:00,20321.75,SELL,1,0.02h,Stop Loss,$-6.00,$430.25,$124580.25,205,$430.25
2024-10-15,20:25:00,20336.5,BUY,1,0.02h,Break Even,$0.25,$430.50,$124580.50,205,$430.50
2024-10-15,20:47:00,20332.5,SELL,1,0.02h,Stop Loss,$-6.00,$424.50,$124574.50,205,$424.50
2024-10-15,20:49:00,20336.5,BUY,1,0.02h,Break Even,$0.25,$424.75,$124574.75,205,$424.75
2024-10-15,20:57:00,20333.75,SELL,1,0.02h,Break Even,$0.25,$425.00,$124575.00,205,$425.00
2024-10-15,22:22:00,20329.25,BUY,1,0.02h,Stop Loss,$-6.00,$419.00,$124569.00,205,$419.00
Final P&L Day: 419.00,,,,,,,,,,,
2024-10-16,12:21:00,20354.75,SELL,1,0.02h,Break Even,$0.25,$0.25,$124569.25,206,$0.25
2024-10-16,12:53:00,20359.75,BUY,1,0.02h,Break Even,$0.25,$0.50,$124569.50,206,$0.50
2024-10-16,13:00:00,20351.25,SELL,1,0.02h,Break Even,$0.25,$0.75,$124569.75,206,$0.75
2024-10-16,13:01:00,20355.5,BUY,1,0.02h,Break Even,$0.25,$1.00,$124570.00,206,$1.00
2024-10-16,13:23:00,20355.5,SELL,1,0.02h,Break Even,$0.25,$1.25,$124570.25,206,$1.25
2024-10-16,14:09:00,20265.5,BUY,1,0.02h,Stop Loss,$91.50,$92.75,$124661.75,206,$92.75
2024-10-16,14:40:00,20280.0,SELL,1,0.02h,Stop Loss,$51.50,$144.25,$124713.25,206,$144.25
2024-10-16,15:12:00,20297.0,BUY,1,0.02h,Stop Loss,$30.25,$174.50,$124743.50,206,$174.50
2024-10-16,15:47:00,20294.5,SELL,1,0.02h,Stop Loss,$30.25,$204.75,$124773.75,206,$204.75
2024-10-16,16:11:00,20298.75,BUY,1,0.02h,Break Even,$0.25,$205.00,$124774.00,206,$205.00
2024-10-16,16:14:00,20279.75,SELL,1,0.02h,Break Even,$0.25,$205.25,$124774.25,206,$205.25
2024-10-16,16:24:00,20296.0,BUY,1,0.02h,Stop Loss,$4.00,$209.25,$124778.25,206,$209.25
2024-10-16,17:19:00,20313.0,SELL,1,0.02h,Stop Loss,$16.50,$225.75,$124794.75,206,$225.75
2024-10-16,17:35:00,20326.0,BUY,1,0.02h,Break Even,$0.25,$226.00,$124795.00,206,$226.00
2024-10-16,17:41:00,20311.25,SELL,1,0.02h,Break Even,$0.25,$226.25,$124795.25,206,$226.25
2024-10-16,17:44:00,20326.25,BUY,1,0.02h,Stop Loss,$12.75,$239.00,$124808.00,206,$239.00
2024-10-16,18:08:00,20323.75,SELL,1,0.02h,Stop Loss,$11.50,$250.50,$124819.50,206,$250.50
2024-10-16,18:11:00,20336.25,BUY,1,0.02h,Break Even,$0.25,$250.75,$124819.75,206,$250.75
2024-10-16,19:02:00,20356.75,SELL,1,0.02h,Stop Loss,$10.25,$261.00,$124830.00,206,$261.00
2024-10-16,19:12:00,20364.25,BUY,1,0.02h,Stop Loss,$-6.00,$255.00,$124824.00,206,$255.00
2024-10-16,19:13:00,20358.0,SELL,1,0.02h,Break Even,$0.25,$255.25,$124824.25,206,$255.25
2024-10-16,19:17:00,20361.75,BUY,1,0.02h,Break Even,$0.25,$255.50,$124824.50,206,$255.50
2024-10-16,19:18:00,20358.5,SELL,1,0.02h,Break Even,$0.25,$255.75,$124824.75,206,$255.75
2024-10-16,20:32:00,20339.0,BUY,1,0.02h,Break Even,$0.25,$256.00,$124825.00,206,$256.00
2024-10-16,20:50:00,20333.25,SELL,1,0.02h,Stop Loss,$-6.00,$250.00,$124819.00,206,$250.00
2024-10-16,22:31:00,20328.5,BUY,1,0.02h,Stop Loss,$-6.00,$244.00,$124813.00,206,$244.00
2024-10-16,22:37:00,20323.75,SELL,1,0.02h,Stop Loss,$-6.00,$238.00,$124807.00,206,$238.00
2024-10-16,22:47:00,20328.5,BUY,1,0.02h,Break Even,$0.25,$238.25,$124807.25,206,$238.25
Final P&L Day: 238.25,,,,,,,,,,,
2024-10-17,13:31:00,20548.0,SELL,1,0.02h,Stop Loss,$26.50,$26.50,$124833.75,207,$26.50
2024-10-17,14:21:00,20444.5,BUY,1,0.02h,Stop Loss,$11.50,$38.00,$124845.25,207,$38.00
2024-10-17,14:38:00,20414.25,SELL,1,0.02h,Stop Loss,$51.50,$89.50,$124896.75,207,$89.50
2024-10-17,15:10:00,20424.0,BUY,1,0.02h,Stop Loss,$20.25,$109.75,$124917.00,207,$109.75
2024-10-17,16:23:00,20487.75,SELL,1,0.02h,Break Even,$0.25,$110.00,$124917.25,207,$110.00
2024-10-17,16:45:00,20488.25,BUY,1,0.02h,Stop Loss,$-6.00,$104.00,$124911.25,207,$104.00
2024-10-17,16:54:00,20471.75,SELL,1,0.02h,Stop Loss,$-6.00,$98.00,$124905.25,207,$98.00
2024-10-17,16:56:00,20486.25,BUY,1,0.02h,Stop Loss,$-6.00,$92.00,$124899.25,207,$92.00
2024-10-17,16:58:00,20474.25,SELL,1,0.02h,Stop Loss,$76.50,$168.50,$124975.75,207,$168.50
2024-10-17,17:05:00,20489.5,BUY,1,0.02h,Stop Loss,$-6.00,$162.50,$124969.75,207,$162.50
2024-10-17,17:20:00,20475.5,SELL,1,0.02h,Break Even,$0.25,$162.75,$124970.00,207,$162.75
2024-10-17,17:40:00,20478.0,BUY,1,0.02h,Break Even,$0.25,$163.00,$124970.25,207,$163.00
2024-10-17,17:57:00,20476.75,SELL,1,0.02h,Stop Loss,$17.75,$180.75,$124988.00,207,$180.75
2024-10-17,18:48:00,20413.25,BUY,1,0.02h,Stop Loss,$-6.00,$174.75,$124982.00,207,$174.75
2024-10-17,19:21:00,20409.0,SELL,1,0.02h,Stop Loss,$35.25,$210.00,$125017.25,207,$210.00
2024-10-17,20:02:00,20383.75,BUY,1,0.02h,Stop Loss,$26.50,$236.50,$125043.75,207,$236.50
2024-10-17,20:03:00,20372.75,SELL,1,0.02h,Break Even,$0.25,$236.75,$125044.00,207,$236.75
2024-10-17,20:04:00,20379.25,BUY,1,0.02h,Stop Loss,$6.50,$243.25,$125050.50,207,$243.25
2024-10-17,20:28:00,20388.75,SELL,1,0.02h,Stop Loss,$-6.00,$237.25,$125044.50,207,$237.25
2024-10-17,22:02:00,20388.0,BUY,1,0.02h,Stop Loss,$-6.00,$231.25,$125038.50,207,$231.25
2024-10-17,22:03:00,20385.25,SELL,1,0.02h,Stop Loss,$22.75,$254.00,$125061.25,207,$254.00
2024-10-17,22:14:00,20386.0,BUY,1,0.02h,Break Even,$0.25,$254.25,$125061.50,207,$254.25
Final P&L Day: 254.25,,,,,,,,,,,
2024-10-18,13:27:00,20462.0,SELL,1,0.02h,Break Even,$0.25,$0.25,$125061.75,208,$0.25
2024-10-18,13:44:00,20489.25,BUY,1,0.02h,Stop Loss,$49.00,$49.25,$125110.75,208,$49.25
2024-10-18,13:51:00,20463.0,SELL,1,0.02h,Stop Loss,$36.50,$85.75,$125147.25,208,$85.75
2024-10-18,13:56:00,20485.0,BUY,1,0.02h,Stop Loss,$4.00,$89.75,$125151.25,208,$89.75
2024-10-18,14:20:00,20487.5,SELL,1,0.02h,Stop Loss,$4.00,$93.75,$125155.25,208,$93.75
2024-10-18,14:22:00,20492.75,BUY,1,0.02h,Break Even,$0.25,$94.00,$125155.50,208,$94.00
2024-10-18,14:23:00,20487.5,SELL,1,0.02h,Stop Loss,$35.25,$129.25,$125190.75,208,$129.25
2024-10-18,14:25:00,20492.5,BUY,1,0.02h,Stop Loss,$4.00,$133.25,$125194.75,208,$133.25
2024-10-18,14:26:00,20487.0,SELL,1,0.02h,Break Even,$0.25,$133.50,$125195.00,208,$133.50
2024-10-18,14:27:00,20492.0,BUY,1,0.02h,Stop Loss,$-6.00,$127.50,$125189.00,208,$127.50
2024-10-18,14:28:00,20480.0,SELL,1,0.02h,Stop Loss,$14.00,$141.50,$125203.00,208,$141.50
2024-10-18,14:30:00,20499.5,BUY,1,0.02h,Stop Loss,$20.25,$161.75,$125223.25,208,$161.75
2024-10-18,14:37:00,20475.75,SELL,1,0.02h,Stop Loss,$10.25,$172.00,$125233.50,208,$172.00
2024-10-18,14:43:00,20494.25,BUY,1,0.02h,Break Even,$0.25,$172.25,$125233.75,208,$172.25
2024-10-18,14:53:00,20481.75,SELL,1,0.02h,Stop Loss,$19.00,$191.25,$125252.75,208,$191.25
2024-10-18,15:07:00,20487.5,BUY,1,0.02h,Stop Loss,$10.25,$201.50,$125263.00,208,$201.50
2024-10-18,15:39:00,20491.5,SELL,1,0.02h,Stop Loss,$-6.00,$195.50,$125257.00,208,$195.50
2024-10-18,16:33:00,20468.0,BUY,1,0.02h,Stop Loss,$17.75,$213.25,$125274.75,208,$213.25
2024-10-18,17:27:00,20500.75,SELL,1,0.02h,Stop Loss,$50.25,$263.50,$125325.00,208,$263.50
2024-10-18,17:47:00,20503.0,BUY,1,0.02h,Stop Loss,$-6.00,$257.50,$125319.00,208,$257.50
2024-10-18,17:51:00,20494.5,SELL,1,0.02h,Break Even,$0.25,$257.75,$125319.25,208,$257.75
2024-10-18,18:13:00,20495.75,BUY,1,0.02h,Break Even,$0.25,$258.00,$125319.50,208,$258.00
2024-10-18,18:38:00,20495.0,SELL,1,0.02h,Stop Loss,$14.00,$272.00,$125333.50,208,$272.00
2024-10-18,19:28:00,20490.5,BUY,1,0.02h,Stop Loss,$11.50,$283.50,$125345.00,208,$283.50
2024-10-18,19:35:00,20481.0,SELL,1,0.02h,Stop Loss,$9.00,$292.50,$125354.00,208,$292.50
2024-10-18,19:38:00,20489.25,BUY,1,0.02h,Stop Loss,$-6.00,$286.50,$125348.00,208,$286.50
2024-10-18,19:39:00,20481.0,SELL,1,0.02h,Break Even,$0.25,$286.75,$125348.25,208,$286.75
2024-10-18,19:58:00,20488.5,BUY,1,0.02h,Stop Loss,$-6.00,$280.75,$125342.25,208,$280.75
2024-10-18,20:30:00,20489.75,SELL,1,0.02h,Break Even,$0.25,$281.00,$125342.50,208,$281.00
2024-10-18,20:32:00,20491.0,BUY,1,0.03h,Break Even,$0.25,$281.25,$125342.75,208,$281.25
2024-10-18,20:35:00,20488.0,SELL,1,0.02h,Stop Loss,$-6.00,$275.25,$125336.75,208,$275.25
2024-10-18,20:40:00,20492.25,BUY,1,0.02h,Stop Loss,$-6.00,$269.25,$125330.75,208,$269.25
2024-10-18,20:49:00,20489.5,SELL,1,0.02h,Break Even,$0.25,$269.50,$125331.00,208,$269.50
Final P&L Day: 269.50,,,,,,,,,,,
2024-10-21,12:31:00,20390.75,BUY,1,0.02h,Break Even,$0.25,$0.25,$125331.25,209,$0.25
2024-10-21,12:41:00,20388.0,SELL,1,0.02h,Stop Loss,$-6.00,$-5.75,$125325.25,209,$-5.75
2024-10-21,12:42:00,20392.25,BUY,1,0.02h,Stop Loss,$-6.00,$-11.75,$125319.25,209,$-11.75
2024-10-21,12:43:00,20385.25,SELL,1,0.02h,Stop Loss,$-6.00,$-17.75,$125313.25,209,$-17.75
2024-10-21,12:46:00,20396.25,BUY,1,0.02h,Stop Loss,$-6.00,$-23.75,$125307.25,209,$-23.75
2024-10-21,14:29:00,20507.0,SELL,1,0.02h,Stop Loss,$14.00,$-9.75,$125321.25,209,$-9.75
2024-10-21,15:39:00,20379.75,BUY,1,0.02h,Stop Loss,$99.00,$89.25,$125420.25,209,$89.25
2024-10-21,16:29:00,20441.0,SELL,1,0.02h,Stop Loss,$-6.00,$83.25,$125414.25,209,$83.25
2024-10-21,16:35:00,20453.0,BUY,1,0.02h,Break Even,$0.25,$83.50,$125414.50,209,$83.50
2024-10-21,16:36:00,20444.0,SELL,1,0.02h,Stop Loss,$26.50,$110.00,$125441.00,209,$110.00
2024-10-21,16:50:00,20445.5,BUY,1,0.02h,Stop Loss,$6.50,$116.50,$125447.50,209,$116.50
2024-10-21,17:23:00,20463.75,SELL,1,0.02h,Stop Loss,$-6.00,$110.50,$125441.50,209,$110.50
2024-10-21,17:28:00,20474.0,BUY,1,0.02h,Stop Loss,$-6.00,$104.50,$125435.50,209,$104.50
2024-10-21,18:07:00,20478.25,SELL,1,0.02h,Stop Loss,$10.25,$114.75,$125445.75,209,$114.75
2024-10-21,18:17:00,20491.75,BUY,1,0.02h,Break Even,$0.25,$115.00,$125446.00,209,$115.00
2024-10-21,18:21:00,20480.5,SELL,1,0.02h,Stop Loss,$10.25,$125.25,$125456.25,209,$125.25
2024-10-21,19:11:00,20470.25,BUY,1,0.02h,Stop Loss,$-6.00,$119.25,$125450.25,209,$119.25
2024-10-21,19:32:00,20469.75,SELL,1,0.02h,Stop Loss,$5.25,$124.50,$125455.50,209,$124.50
2024-10-21,19:47:00,20481.75,BUY,1,0.02h,Stop Loss,$-6.00,$118.50,$125449.50,209,$118.50
2024-10-21,20:55:00,20536.75,SELL,1,0.02h,Stop Loss,$-6.00,$112.50,$125443.50,209,$112.50
2024-10-21,20:59:00,20543.75,BUY,1,0.02h,Stop Loss,$-6.00,$106.50,$125437.50,209,$106.50
2024-10-21,22:01:00,20536.75,SELL,1,0.02h,Stop Loss,$12.75,$119.25,$125450.25,209,$119.25
2024-10-21,22:16:00,20539.0,BUY,1,0.02h,Stop Loss,$-6.00,$113.25,$125444.25,209,$113.25
2024-10-21,22:17:00,20531.75,SELL,1,0.02h,Break Even,$0.25,$113.50,$125444.50,209,$113.50
Final P&L Day: 113.50,,,,,,,,,,,
2024-10-22,13:15:00,20391.75,BUY,1,0.02h,Break Even,$0.25,$0.25,$125444.75,210,$0.25
2024-10-22,14:40:00,20482.25,SELL,1,0.02h,Stop Loss,$-6.00,$-5.75,$125438.75,210,$-5.75
2024-10-22,14:56:00,20492.0,BUY,1,0.02h,Break Even,$0.25,$-5.50,$125439.00,210,$-5.50
2024-10-22,15:12:00,20479.0,SELL,1,0.02h,Stop Loss,$7.75,$2.25,$125446.75,210,$2.25
2024-10-22,15:33:00,20486.25,BUY,1,0.02h,Break Even,$0.25,$2.50,$125447.00,210,$2.50
2024-10-22,15:51:00,20474.75,SELL,1,0.02h,Stop Loss,$22.75,$25.25,$125469.75,210,$25.25
2024-10-22,15:56:00,20490.25,BUY,1,0.02h,Stop Loss,$-6.00,$19.25,$125463.75,210,$19.25
2024-10-22,16:00:00,20472.75,SELL,1,0.02h,Stop Loss,$26.50,$45.75,$125490.25,210,$45.75
2024-10-22,16:50:00,20463.25,BUY,1,0.02h,Stop Loss,$52.75,$98.50,$125543.00,210,$98.50
2024-10-22,18:14:00,20549.5,SELL,1,0.02h,Stop Loss,$7.75,$106.25,$125550.75,210,$106.25
2024-10-22,19:12:00,20543.25,BUY,1,0.02h,Break Even,$0.25,$106.50,$125551.00,210,$106.50
2024-10-22,19:43:00,20544.25,SELL,1,0.02h,Break Even,$0.25,$106.75,$125551.25,210,$106.75
2024-10-22,19:44:00,20548.25,BUY,1,0.02h,Break Even,$0.25,$107.00,$125551.50,210,$107.00
2024-10-22,20:01:00,20524.25,SELL,1,0.02h,Stop Loss,$69.00,$176.00,$125620.50,210,$176.00
2024-10-22,20:36:00,20527.25,BUY,1,0.02h,Break Even,$0.25,$176.25,$125620.75,210,$176.25
2024-10-22,20:46:00,20518.25,SELL,1,0.02h,Stop Loss,$-6.00,$170.25,$125614.75,210,$170.25
2024-10-22,20:50:00,20527.25,BUY,1,0.02h,Stop Loss,$-6.00,$164.25,$125608.75,210,$164.25
2024-10-22,20:51:00,20521.25,SELL,1,0.02h,Stop Loss,$-6.00,$158.25,$125602.75,210,$158.25
2024-10-22,20:52:00,20525.25,BUY,1,0.02h,Break Even,$0.25,$158.50,$125603.00,210,$158.50
2024-10-22,21:00:00,20517.5,SELL,1,1.02h,Stop Loss,$59.00,$217.50,$125662.00,210,$217.50
2024-10-22,22:34:00,20508.25,BUY,1,0.02h,Stop Loss,$-6.00,$211.50,$125656.00,210,$211.50
2024-10-22,22:40:00,20502.5,SELL,1,0.02h,Stop Loss,$-6.00,$205.50,$125650.00,210,$205.50
2024-10-22,22:47:00,20505.75,BUY,1,0.05h,Stop Loss,$-6.00,$199.50,$125644.00,210,$199.50
2024-10-22,22:51:00,20503.25,SELL,1,0.02h,Stop Loss,$-6.00,$193.50,$125638.00,210,$193.50
Final P&L Day: 193.50,,,,,,,,,,,
2024-10-23,12:20:00,20493.75,BUY,1,0.02h,Stop Loss,$-6.00,$-6.00,$125632.00,211,$-6.00
2024-10-23,12:34:00,20469.5,SELL,1,0.02h,Stop Loss,$15.25,$9.25,$125647.25,211,$9.25
2024-10-23,13:42:00,20436.75,BUY,1,0.02h,Stop Loss,$22.75,$32.00,$125670.00,211,$32.00
2024-10-23,13:45:00,20427.0,SELL,1,0.02h,Stop Loss,$37.75,$69.75,$125707.75,211,$69.75
2024-10-23,13:49:00,20442.25,BUY,1,0.02h,Stop Loss,$-6.00,$63.75,$125701.75,211,$63.75
2024-10-23,13:51:00,20423.5,SELL,1,0.02h,Stop Loss,$47.75,$111.50,$125749.50,211,$111.50
2024-10-23,13:57:00,20440.5,BUY,1,0.02h,Stop Loss,$19.00,$130.50,$125768.50,211,$130.50
2024-10-23,14:01:00,20418.75,SELL,1,0.02h,Stop Loss,$77.75,$208.25,$125846.25,211,$208.25
2024-10-23,14:30:00,20418.25,BUY,1,0.02h,Stop Loss,$30.25,$238.50,$125876.50,211,$238.50
2024-10-23,14:55:00,20407.75,SELL,1,0.02h,Stop Loss,$35.25,$273.75,$125911.75,211,$273.75
2024-10-23,15:46:00,20348.0,BUY,1,0.02h,Stop Loss,$5.25,$279.00,$125917.00,211,$279.00
2024-10-23,16:04:00,20296.0,SELL,1,0.02h,Stop Loss,$11.50,$290.50,$125928.50,211,$290.50
2024-10-23,16:49:00,20273.75,BUY,1,0.02h,Stop Loss,$17.75,$308.25,$125946.25,211,$308.25
2024-10-23,16:52:00,20256.5,SELL,1,0.02h,Stop Loss,$26.50,$334.75,$125972.75,211,$334.75
2024-10-23,18:26:00,20128.0,BUY,1,0.02h,Stop Loss,$24.00,$358.75,$125996.75,211,$358.75
2024-10-23,19:11:00,20166.25,SELL,1,0.02h,Stop Loss,$46.50,$405.25,$126043.25,211,$405.25
2024-10-23,19:19:00,20174.0,BUY,1,0.02h,Stop Loss,$24.00,$429.25,$126067.25,211,$429.25
2024-10-23,20:48:00,20278.0,SELL,1,0.02h,Stop Loss,$-6.00,$423.25,$126061.25,211,$423.25
2024-10-23,20:50:00,20283.25,BUY,1,0.02h,Stop Loss,$-6.00,$417.25,$126055.25,211,$417.25
2024-10-23,20:51:00,20281.0,SELL,1,0.02h,Stop Loss,$-6.00,$411.25,$126049.25,211,$411.25
2024-10-23,20:53:00,20286.25,BUY,1,0.03h,Break Even,$0.25,$411.50,$126049.50,211,$411.50
2024-10-23,20:56:00,20278.0,SELL,1,0.02h,Stop Loss,$17.75,$429.25,$126067.25,211,$429.25
2024-10-23,22:02:00,20293.5,BUY,1,0.02h,Break Even,$0.25,$429.50,$126067.50,211,$429.50
2024-10-23,22:18:00,20281.5,SELL,1,0.02h,Stop Loss,$-6.00,$423.50,$126061.50,211,$423.50
2024-10-23,22:26:00,20290.25,BUY,1,0.02h,Stop Loss,$-6.00,$417.50,$126055.50,211,$417.50
2024-10-23,22:32:00,20276.25,SELL,1,0.02h,Stop Loss,$-6.00,$411.50,$126049.50,211,$411.50
2024-10-23,22:58:00,20286.75,BUY,1,0.02h,Break Even,$0.25,$411.75,$126049.75,211,$411.75
Final P&L Day: 411.75,,,,,,,,,,,
2024-10-24,12:48:00,20398.0,SELL,1,0.02h,Stop Loss,$-6.00,$-6.00,$126043.75,212,$-6.00
2024-10-24,13:14:00,20402.5,BUY,1,0.02h,Break Even,$0.25,$-5.75,$126044.00,212,$-5.75
2024-10-24,13:22:00,20392.75,SELL,1,0.02h,Stop Loss,$7.75,$2.00,$126051.75,212,$2.00
2024-10-24,14:02:00,20351.0,BUY,1,0.02h,Stop Loss,$126.50,$128.50,$126178.25,212,$128.50
2024-10-24,14:23:00,20335.25,SELL,1,0.02h,Break Even,$0.25,$128.75,$126178.50,212,$128.75
2024-10-24,14:25:00,20357.5,BUY,1,0.02h,Break Even,$0.25,$129.00,$126178.75,212,$129.00
2024-10-24,14:27:00,20330.0,SELL,1,0.02h,Stop Loss,$79.00,$208.00,$126257.75,212,$208.00
2024-10-24,14:34:00,20355.25,BUY,1,0.02h,Stop Loss,$34.00,$242.00,$126291.75,212,$242.00
2024-10-24,14:49:00,20340.5,SELL,1,0.02h,Stop Loss,$30.25,$272.25,$126322.00,212,$272.25
2024-10-24,15:12:00,20340.75,BUY,1,0.02h,Break Even,$0.25,$272.50,$126322.25,212,$272.50
2024-10-24,15:30:00,20340.25,SELL,1,0.02h,Break Even,$0.25,$272.75,$126322.50,212,$272.75
2024-10-24,15:32:00,20347.0,BUY,1,0.02h,Break Even,$0.25,$273.00,$126322.75,212,$273.00
2024-10-24,15:33:00,20341.25,SELL,1,0.02h,Stop Loss,$16.50,$289.50,$126339.25,212,$289.50
2024-10-24,16:00:00,20327.75,BUY,1,0.02h,Stop Loss,$44.00,$333.50,$126383.25,212,$333.50
2024-10-24,16:07:00,20291.5,SELL,1,0.02h,Stop Loss,$41.50,$375.00,$126424.75,212,$375.00
2024-10-24,16:25:00,20307.0,BUY,1,0.02h,Stop Loss,$15.25,$390.25,$126440.00,212,$390.25
2024-10-24,17:23:00,20362.5,SELL,1,0.02h,Stop Loss,$11.50,$401.75,$126451.50,212,$401.75
2024-10-24,17:39:00,20369.75,BUY,1,0.02h,Break Even,$0.25,$402.00,$126451.75,212,$402.00
2024-10-24,17:52:00,20355.75,SELL,1,0.02h,Stop Loss,$4.00,$406.00,$126455.75,212,$406.00
2024-10-24,18:13:00,20364.75,BUY,1,0.02h,Stop Loss,$9.00,$415.00,$126464.75,212,$415.00
2024-10-24,18:31:00,20364.0,SELL,1,0.02h,Break Even,$0.25,$415.25,$126465.00,212,$415.25
2024-10-24,18:51:00,20364.0,BUY,1,0.02h,Stop Loss,$11.50,$426.75,$126476.50,212,$426.75
2024-10-24,19:02:00,20349.0,SELL,1,0.02h,Break Even,$0.25,$427.00,$126476.75,212,$427.00
2024-10-24,19:10:00,20368.0,BUY,1,0.02h,Stop Loss,$11.50,$438.50,$126488.25,212,$438.50
2024-10-24,19:44:00,20379.5,SELL,1,0.02h,Stop Loss,$-6.00,$432.50,$126482.25,212,$432.50
2024-10-24,19:48:00,20396.0,BUY,1,0.02h,Stop Loss,$7.75,$440.25,$126490.00,212,$440.25
2024-10-24,19:54:00,20385.0,SELL,1,0.02h,Break Even,$0.25,$440.50,$126490.25,212,$440.50
2024-10-24,19:55:00,20397.75,BUY,1,0.02h,Break Even,$0.25,$440.75,$126490.50,212,$440.75
2024-10-24,19:59:00,20384.5,SELL,1,0.02h,Stop Loss,$32.75,$473.50,$126523.25,212,$473.50
2024-10-24,20:03:00,20391.5,BUY,1,0.02h,Stop Loss,$6.50,$480.00,$126529.75,212,$480.00
2024-10-24,20:23:00,20394.0,SELL,1,0.02h,Stop Loss,$-6.00,$474.00,$126523.75,212,$474.00
2024-10-24,21:00:00,20391.0,BUY,1,1.02h,Stop Loss,$21.50,$495.50,$126545.25,212,$495.50
2024-10-24,22:05:00,20381.5,SELL,1,0.02h,Break Even,$0.25,$495.75,$126545.50,212,$495.75
2024-10-24,22:17:00,20384.75,BUY,1,0.02h,Stop Loss,$-6.00,$489.75,$126539.50,212,$489.75
2024-10-24,22:34:00,20378.5,SELL,1,0.02h,Break Even,$0.25,$490.00,$126539.75,212,$490.00
2024-10-24,22:59:00,20380.75,BUY,1,0.02h,Stop Loss,$-6.00,$484.00,$126533.75,212,$484.00
Final P&L Day: 484.00,,,,,,,,,,,
2024-10-25,13:30:00,20491.25,SELL,1,0.02h,Stop Loss,$-6.00,$-6.00,$126527.75,213,$-6.00
2024-10-25,13:31:00,20519.25,BUY,1,0.02h,Stop Loss,$69.00,$63.00,$126596.75,213,$63.00
2024-10-25,14:44:00,20665.75,SELL,1,0.02h,Stop Loss,$64.00,$127.00,$126660.75,213,$127.00
2024-10-25,15:06:00,20666.25,BUY,1,0.02h,Stop Loss,$37.75,$164.75,$126698.50,213,$164.75
2024-10-25,15:12:00,20645.75,SELL,1,0.02h,Break Even,$0.25,$165.00,$126698.75,213,$165.00
2024-10-25,15:16:00,20666.0,BUY,1,0.02h,Break Even,$0.25,$165.25,$126699.00,213,$165.25
2024-10-25,15:27:00,20646.0,SELL,1,0.02h,Stop Loss,$4.00,$169.25,$126703.00,213,$169.25
2024-10-25,16:07:00,20634.75,BUY,1,0.02h,Break Even,$0.25,$169.50,$126703.25,213,$169.50
2024-10-25,16:50:00,20641.25,SELL,1,0.02h,Stop Loss,$-6.00,$163.50,$126697.25,213,$163.50
2024-10-25,16:54:00,20653.75,BUY,1,0.02h,Stop Loss,$-6.00,$157.50,$126691.25,213,$157.50
2024-10-25,16:57:00,20643.5,SELL,1,0.02h,Stop Loss,$9.00,$166.50,$126700.25,213,$166.50
2024-10-25,17:54:00,20554.25,BUY,1,0.02h,Break Even,$0.25,$166.75,$126700.50,213,$166.75
2024-10-25,17:56:00,20533.25,SELL,1,0.02h,Break Even,$0.25,$167.00,$126700.75,213,$167.00
2024-10-25,18:26:00,20514.25,BUY,1,0.02h,Stop Loss,$15.25,$182.25,$126716.00,213,$182.25
2024-10-25,19:05:00,20533.0,SELL,1,0.02h,Stop Loss,$20.25,$202.50,$126736.25,213,$202.50
2024-10-25,19:38:00,20524.5,BUY,1,0.02h,Stop Loss,$6.50,$209.00,$126742.75,213,$209.00
2024-10-25,19:44:00,20515.75,SELL,1,0.02h,Break Even,$0.25,$209.25,$126743.00,213,$209.25
2024-10-25,19:47:00,20524.0,BUY,1,0.02h,Stop Loss,$-6.00,$203.25,$126737.00,213,$203.25
2024-10-25,19:51:00,20510.5,SELL,1,0.02h,Break Even,$0.25,$203.50,$126737.25,213,$203.50
Final P&L Day: 203.50,,,,,,,,,,,
2024-10-28,12:00:00,20618.5,BUY,1,0.02h,Stop Loss,$14.00,$14.00,$126751.25,214,$14.00
2024-10-28,13:12:00,20642.25,SELL,1,0.02h,Stop Loss,$4.00,$18.00,$126755.25,214,$18.00
2024-10-28,14:08:00,20567.5,BUY,1,0.02h,Stop Loss,$75.25,$93.25,$126830.50,214,$93.25
2024-10-28,14:37:00,20583.0,SELL,1,0.02h,Stop Loss,$11.50,$104.75,$126842.00,214,$104.75
2024-10-28,14:38:00,20589.25,BUY,1,0.02h,Break Even,$0.25,$105.00,$126842.25,214,$105.00
2024-10-28,14:39:00,20583.75,SELL,1,0.02h,Stop Loss,$-6.00,$99.00,$126836.25,214,$99.00
2024-10-28,14:40:00,20595.25,BUY,1,0.02h,Stop Loss,$20.25,$119.25,$126856.50,214,$119.25
2024-10-28,14:57:00,20589.0,SELL,1,0.02h,Stop Loss,$29.00,$148.25,$126885.50,214,$148.25
2024-10-28,16:11:00,20548.25,BUY,1,0.02h,Break Even,$0.25,$148.50,$126885.75,214,$148.50
2024-10-28,16:35:00,20537.75,SELL,1,0.02h,Stop Loss,$30.25,$178.75,$126916.00,214,$178.75
2024-10-28,16:46:00,20554.25,BUY,1,0.02h,Break Even,$0.25,$179.00,$126916.25,214,$179.00
2024-10-28,16:49:00,20535.75,SELL,1,0.02h,Break Even,$0.25,$179.25,$126916.50,214,$179.25
2024-10-28,17:09:00,20547.25,BUY,1,0.02h,Stop Loss,$-6.00,$173.25,$126910.50,214,$173.25
2024-10-28,17:12:00,20534.5,SELL,1,0.02h,Stop Loss,$64.00,$237.25,$126974.50,214,$237.25
2024-10-28,17:21:00,20549.0,BUY,1,0.02h,Stop Loss,$6.50,$243.75,$126981.00,214,$243.75
2024-10-28,17:51:00,20541.0,SELL,1,0.02h,Stop Loss,$-6.00,$237.75,$126975.00,214,$237.75
2024-10-28,17:52:00,20550.0,BUY,1,0.02h,Stop Loss,$15.25,$253.00,$126990.25,214,$253.00
2024-10-28,18:04:00,20544.25,SELL,1,0.02h,Stop Loss,$-6.00,$247.00,$126984.25,214,$247.00
2024-10-28,18:07:00,20554.25,BUY,1,0.02h,Break Even,$0.25,$247.25,$126984.50,214,$247.25
2024-10-28,18:14:00,20541.0,SELL,1,0.02h,Break Even,$0.25,$247.50,$126984.75,214,$247.50
2024-10-28,18:54:00,20541.5,BUY,1,0.02h,Stop Loss,$15.25,$262.75,$127000.00,214,$262.75
2024-10-28,19:05:00,20526.25,SELL,1,0.02h,Stop Loss,$20.25,$283.00,$127020.25,214,$283.00
2024-10-28,19:28:00,20526.5,BUY,1,0.02h,Break Even,$0.25,$283.25,$127020.50,214,$283.25
2024-10-28,19:44:00,20520.5,SELL,1,0.02h,Break Even,$0.25,$283.50,$127020.75,214,$283.50
2024-10-28,20:23:00,20508.25,BUY,1,0.02h,Break Even,$0.25,$283.75,$127021.00,214,$283.75
2024-10-28,20:52:00,20511.75,SELL,1,0.03h,Break Even,$0.25,$284.00,$127021.25,214,$284.00
2024-10-28,22:40:00,20499.0,BUY,1,0.02h,Stop Loss,$-6.00,$278.00,$127015.25,214,$278.00
2024-10-28,22:47:00,20495.0,SELL,1,0.02h,Stop Loss,$-6.00,$272.00,$127009.25,214,$272.00
Final P&L Day: 272.00,,,,,,,,,,,
2024-10-29,12:20:00,20493.0,BUY,1,0.02h,Stop Loss,$-6.00,$-6.00,$127003.25,215,$-6.00
2024-10-29,12:21:00,20483.5,SELL,1,0.02h,Break Even,$0.25,$-5.75,$127003.50,215,$-5.75
2024-10-29,12:30:00,20493.75,BUY,1,0.02h,Break Even,$0.25,$-5.50,$127003.75,215,$-5.50
2024-10-29,12:51:00,20490.5,SELL,1,0.02h,Break Even,$0.25,$-5.25,$127004.00,215,$-5.25
2024-10-29,12:53:00,20500.0,BUY,1,0.02h,Break Even,$0.25,$-5.00,$127004.25,215,$-5.00
2024-10-29,13:00:00,20489.0,SELL,1,0.02h,Break Even,$0.25,$-4.75,$127004.50,215,$-4.75
2024-10-29,13:06:00,20496.5,BUY,1,0.02h,Stop Loss,$10.25,$5.50,$127014.75,215,$5.50
2024-10-29,13:15:00,20491.75,SELL,1,0.02h,Break Even,$0.25,$5.75,$127015.00,215,$5.75
2024-10-29,13:29:00,20510.25,BUY,1,0.02h,Break Even,$0.25,$6.00,$127015.25,215,$6.00
2024-10-29,13:32:00,20479.5,SELL,1,0.02h,Stop Loss,$157.75,$163.75,$127173.00,215,$163.75
2024-10-29,13:46:00,20509.75,BUY,1,0.02h,Stop Loss,$20.25,$184.00,$127193.25,215,$184.00
2024-10-29,15:11:00,20582.5,SELL,1,0.02h,Stop Loss,$10.25,$194.25,$127203.50,215,$194.25
2024-10-29,15:16:00,20596.75,BUY,1,0.02h,Stop Loss,$67.75,$262.00,$127271.25,215,$262.00
2024-10-29,15:36:00,20585.25,SELL,1,0.02h,Stop Loss,$6.50,$268.50,$127277.75,215,$268.50
2024-10-29,15:39:00,20604.25,BUY,1,0.02h,Stop Loss,$-6.00,$262.50,$127271.75,215,$262.50
2024-10-29,16:30:00,20614.75,SELL,1,0.02h,Stop Loss,$-6.00,$256.50,$127265.75,215,$256.50
2024-10-29,16:43:00,20628.5,BUY,1,0.02h,Stop Loss,$26.50,$283.00,$127292.25,215,$283.00
2024-10-29,17:28:00,20659.0,SELL,1,0.02h,Stop Loss,$-6.00,$277.00,$127286.25,215,$277.00
2024-10-29,17:35:00,20676.75,BUY,1,0.02h,Stop Loss,$9.00,$286.00,$127295.25,215,$286.00
2024-10-29,17:44:00,20661.5,SELL,1,0.02h,Stop Loss,$11.50,$297.50,$127306.75,215,$297.50
2024-10-29,17:51:00,20679.5,BUY,1,0.02h,Stop Loss,$-6.00,$291.50,$127300.75,215,$291.50
2024-10-29,18:06:00,20666.0,SELL,1,0.02h,Break Even,$0.25,$291.75,$127301.00,215,$291.75
2024-10-29,18:20:00,20680.75,BUY,1,0.02h,Break Even,$0.25,$292.00,$127301.25,215,$292.00
2024-10-29,18:57:00,20695.5,SELL,1,0.02h,Break Even,$0.25,$292.25,$127301.50,215,$292.25
2024-10-29,19:07:00,20703.0,BUY,1,0.02h,Stop Loss,$5.25,$297.50,$127306.75,215,$297.50
2024-10-29,19:42:00,20721.5,SELL,1,0.02h,Stop Loss,$-6.00,$291.50,$127300.75,215,$291.50
2024-10-29,19:45:00,20734.5,BUY,1,0.02h,Stop Loss,$21.50,$313.00,$127322.25,215,$313.00
2024-10-29,19:52:00,20720.25,SELL,1,0.02h,Break Even,$0.25,$313.25,$127322.50,215,$313.25
2024-10-29,20:07:00,20731.0,BUY,1,0.02h,Stop Loss,$19.00,$332.25,$127341.50,215,$332.25
2024-10-29,20:19:00,20708.0,SELL,1,0.02h,Stop Loss,$15.25,$347.50,$127356.75,215,$347.50
2024-10-29,20:54:00,20717.25,BUY,1,0.02h,Stop Loss,$-6.00,$341.50,$127350.75,215,$341.50
2024-10-29,20:59:00,20706.0,SELL,1,0.02h,Break Even,$0.25,$341.75,$127351.00,215,$341.75
2024-10-29,22:01:00,20721.0,BUY,1,0.02h,Stop Loss,$5.25,$347.00,$127356.25,215,$347.00
Final P&L Day: 347.00,,,,,,,,,,,
2024-10-30,12:00:00,20714.5,SELL,1,0.02h,Stop Loss,$-6.00,$-6.00,$127350.25,216,$-6.00
2024-10-30,12:39:00,20712.75,BUY,1,0.02h,Stop Loss,$4.00,$-2.00,$127354.25,216,$-2.00
2024-10-30,12:47:00,20706.0,SELL,1,0.02h,Stop Loss,$5.25,$3.25,$127359.50,216,$3.25
2024-10-30,13:57:00,20627.25,BUY,1,0.02h,Stop Loss,$11.50,$14.75,$127371.00,216,$14.75
2024-10-30,14:47:00,20671.75,SELL,1,0.02h,Stop Loss,$21.50,$36.25,$127392.50,216,$36.25
2024-10-30,15:25:00,20650.5,BUY,1,0.02h,Stop Loss,$19.00,$55.25,$127411.50,216,$55.25
2024-10-30,16:10:00,20659.25,SELL,1,0.02h,Stop Loss,$14.00,$69.25,$127425.50,216,$69.25
2024-10-30,16:41:00,20658.25,BUY,1,0.02h,Stop Loss,$-6.00,$63.25,$127419.50,216,$63.25
2024-10-30,16:42:00,20645.5,SELL,1,0.02h,Stop Loss,$-6.00,$57.25,$127413.50,216,$57.25
2024-10-30,16:46:00,20659.0,BUY,1,0.02h,Break Even,$0.25,$57.50,$127413.75,216,$57.50
2024-10-30,16:57:00,20648.25,SELL,1,0.02h,Stop Loss,$16.50,$74.00,$127430.25,216,$74.00
2024-10-30,18:08:00,20612.75,BUY,1,0.02h,Stop Loss,$10.25,$84.25,$127440.50,216,$84.25
2024-10-30,18:30:00,20596.0,SELL,1,0.02h,Break Even,$0.25,$84.50,$127440.75,216,$84.50
2024-10-30,18:34:00,20607.5,BUY,1,0.02h,Stop Loss,$5.25,$89.75,$127446.00,216,$89.75
2024-10-30,18:58:00,20609.0,SELL,1,0.02h,Stop Loss,$11.50,$101.25,$127457.50,216,$101.25
2024-10-30,20:05:00,20571.25,BUY,1,0.02h,Break Even,$0.25,$101.50,$127457.75,216,$101.50
2024-10-30,20:06:00,20533.75,SELL,1,0.02h,Stop Loss,$59.00,$160.50,$127516.75,216,$160.50
2024-10-30,20:30:00,20542.5,BUY,1,0.02h,Stop Loss,$37.75,$198.25,$127554.50,216,$198.25
2024-10-30,20:44:00,20514.0,SELL,1,0.02h,Stop Loss,$-6.00,$192.25,$127548.50,216,$192.25
2024-10-30,20:46:00,20529.0,BUY,1,0.02h,Break Even,$0.25,$192.50,$127548.75,216,$192.50
2024-10-30,20:51:00,20511.25,SELL,1,0.02h,Break Even,$0.25,$192.75,$127549.00,216,$192.75
2024-10-30,22:37:00,20454.0,BUY,1,0.02h,Break Even,$0.25,$193.00,$127549.25,216,$193.00
2024-10-30,22:41:00,20446.5,SELL,1,0.02h,Stop Loss,$-6.00,$187.00,$127543.25,216,$187.00
2024-10-30,22:42:00,20453.0,BUY,1,0.02h,Stop Loss,$11.50,$198.50,$127554.75,216,$198.50
2024-10-30,22:48:00,20437.25,SELL,1,0.02h,Stop Loss,$5.25,$203.75,$127560.00,216,$203.75
Final P&L Day: 203.75,,,,,,,,,,,
2024-10-31,12:26:00,20407.75,BUY,1,0.02h,Break Even,$0.25,$0.25,$127560.25,217,$0.25
2024-10-31,12:36:00,20389.25,SELL,1,0.02h,Stop Loss,$12.75,$13.00,$127573.00,217,$13.00
2024-10-31,12:46:00,20411.25,BUY,1,0.02h,Break Even,$0.25,$13.25,$127573.25,217,$13.25
2024-10-31,12:50:00,20387.0,SELL,1,0.02h,Stop Loss,$-6.00,$7.25,$127567.25,217,$7.25
2024-10-31,12:52:00,20403.75,BUY,1,0.02h,Stop Loss,$-6.00,$1.25,$127561.25,217,$1.25
2024-10-31,12:55:00,20387.0,SELL,1,0.02h,Stop Loss,$11.50,$12.75,$127572.75,217,$12.75
2024-10-31,13:17:00,20393.75,BUY,1,0.02h,Stop Loss,$-6.00,$6.75,$127566.75,217,$6.75
2024-10-31,13:21:00,20382.25,SELL,1,0.02h,Stop Loss,$-6.00,$0.75,$127560.75,217,$0.75
2024-10-31,13:24:00,20389.75,BUY,1,0.02h,Break Even,$0.25,$1.00,$127561.00,217,$1.00
2024-10-31,13:26:00,20376.0,SELL,1,0.02h,Break Even,$0.25,$1.25,$127561.25,217,$1.25
2024-10-31,14:20:00,20187.0,BUY,1,0.02h,Stop Loss,$5.25,$6.50,$127566.50,217,$6.50
2024-10-31,14:28:00,20149.75,SELL,1,0.02h,Stop Loss,$45.25,$51.75,$127611.75,217,$51.75
2024-10-31,15:22:00,20107.0,BUY,1,0.02h,Stop Loss,$7.75,$59.50,$127619.50,217,$59.50
2024-10-31,15:33:00,20076.75,SELL,1,0.02h,Stop Loss,$24.00,$83.50,$127643.50,217,$83.50
2024-10-31,16:02:00,20063.75,BUY,1,0.02h,Stop Loss,$-6.00,$77.50,$127637.50,217,$77.50
2024-10-31,16:03:00,20050.25,SELL,1,0.02h,Stop Loss,$-6.00,$71.50,$127631.50,217,$71.50
2024-10-31,16:05:00,20068.25,BUY,1,0.02h,Stop Loss,$66.50,$138.00,$127698.00,217,$138.00
2024-10-31,16:35:00,20072.75,SELL,1,0.02h,Break Even,$0.25,$138.25,$127698.25,217,$138.25
2024-10-31,16:41:00,20083.25,BUY,1,0.02h,Stop Loss,$-6.00,$132.25,$127692.25,217,$132.25
2024-10-31,16:42:00,20072.5,SELL,1,0.02h,Stop Loss,$-6.00,$126.25,$127686.25,217,$126.25
2024-10-31,16:44:00,20089.75,BUY,1,0.02h,Stop Loss,$29.00,$155.25,$127715.25,217,$155.25
2024-10-31,17:16:00,20087.5,SELL,1,0.02h,Stop Loss,$6.50,$161.75,$127721.75,217,$161.75
2024-10-31,17:22:00,20098.0,BUY,1,0.02h,Stop Loss,$6.50,$168.25,$127728.25,217,$168.25
2024-10-31,17:27:00,20087.0,SELL,1,0.02h,Stop Loss,$59.00,$227.25,$127787.25,217,$227.25
2024-10-31,18:31:00,20044.5,BUY,1,0.02h,Break Even,$0.25,$227.50,$127787.50,217,$227.50
2024-10-31,18:34:00,20017.5,SELL,1,0.02h,Stop Loss,$21.50,$249.00,$127809.00,217,$249.00
2024-10-31,18:46:00,20037.0,BUY,1,0.02h,Break Even,$0.25,$249.25,$127809.25,217,$249.25
2024-10-31,18:49:00,20023.75,SELL,1,0.02h,Stop Loss,$20.25,$269.50,$127829.50,217,$269.50
2024-10-31,18:55:00,20032.75,BUY,1,0.02h,Stop Loss,$17.75,$287.25,$127847.25,217,$287.25
2024-10-31,19:33:00,20064.25,SELL,1,0.02h,Stop Loss,$-6.00,$281.25,$127841.25,217,$281.25
2024-10-31,19:43:00,20085.5,BUY,1,0.02h,Stop Loss,$11.50,$292.75,$127852.75,217,$292.75
2024-10-31,19:55:00,20042.25,SELL,1,0.02h,Stop Loss,$9.00,$301.75,$127861.75,217,$301.75
2024-10-31,20:25:00,20070.75,BUY,1,0.02h,Stop Loss,$15.25,$317.00,$127877.00,217,$317.00
2024-10-31,20:34:00,20028.75,SELL,1,0.02h,Stop Loss,$17.75,$334.75,$127894.75,217,$334.75
2024-10-31,22:01:00,20083.75,BUY,1,0.02h,Stop Loss,$-6.00,$328.75,$127888.75,217,$328.75
2024-10-31,22:52:00,20084.75,SELL,1,0.02h,Stop Loss,$6.50,$335.25,$127895.25,217,$335.25
Final P&L Day: 335.25,,,,,,,,,,,
2024-11-01,12:00:00,20109.0,BUY,1,0.02h,Stop Loss,$19.00,$19.00,$127914.25,218,$19.00
2024-11-01,12:29:00,20101.75,SELL,1,0.02h,Stop Loss,$9.00,$28.00,$127923.25,218,$28.00
2024-11-01,12:33:00,20133.75,BUY,1,0.02h,Stop Loss,$40.25,$68.25,$127963.50,218,$68.25
2024-11-01,12:50:00,20113.75,SELL,1,0.02h,Stop Loss,$19.00,$87.25,$127982.50,218,$87.25
2024-11-01,12:54:00,20123.5,BUY,1,0.02h,Stop Loss,$12.75,$100.00,$127995.25,218,$100.00
2024-11-01,12:59:00,20113.5,SELL,1,0.02h,Break Even,$0.25,$100.25,$127995.50,218,$100.25
2024-11-01,13:35:00,20111.75,BUY,1,0.02h,Break Even,$0.25,$100.50,$127995.75,218,$100.50
2024-11-01,14:42:00,20220.25,SELL,1,0.02h,Stop Loss,$46.50,$147.00,$128042.25,218,$147.00
2024-11-01,15:00:00,20235.25,BUY,1,0.02h,Break Even,$0.25,$147.25,$128042.50,218,$147.25
2024-11-01,15:42:00,20256.0,SELL,1,0.02h,Stop Loss,$10.25,$157.50,$128052.75,218,$157.50
2024-11-01,16:10:00,20248.25,BUY,1,0.02h,Stop Loss,$5.25,$162.75,$128058.00,218,$162.75
2024-11-01,16:19:00,20232.0,SELL,1,0.02h,Break Even,$0.25,$163.00,$128058.25,218,$163.00
2024-11-01,16:20:00,20244.5,BUY,1,0.02h,Stop Loss,$-6.00,$157.00,$128052.25,218,$157.00
2024-11-01,16:21:00,20232.0,SELL,1,0.02h,Stop Loss,$26.50,$183.50,$128078.75,218,$183.50
2024-11-01,16:35:00,20250.75,BUY,1,0.02h,Break Even,$0.25,$183.75,$128079.00,218,$183.75
2024-11-01,16:44:00,20198.25,SELL,1,0.02h,Stop Loss,$4.00,$187.75,$128083.00,218,$187.75
2024-11-01,17:17:00,20219.75,BUY,1,0.02h,Break Even,$0.25,$188.00,$128083.25,218,$188.00
2024-11-01,17:34:00,20195.25,SELL,1,0.02h,Stop Loss,$34.00,$222.00,$128117.25,218,$222.00
2024-11-01,18:26:00,20165.0,BUY,1,0.02h,Stop Loss,$14.00,$236.00,$128131.25,218,$236.00
2024-11-01,18:43:00,20151.5,SELL,1,0.02h,Break Even,$0.25,$236.25,$128131.50,218,$236.25
2024-11-01,18:45:00,20165.0,BUY,1,0.02h,Stop Loss,$55.25,$291.50,$128186.75,218,$291.50
2024-11-01,19:04:00,20158.0,SELL,1,0.02h,Stop Loss,$-6.00,$285.50,$128180.75,218,$285.50
2024-11-01,19:05:00,20166.75,BUY,1,0.02h,Break Even,$0.25,$285.75,$128181.00,218,$285.75
2024-11-01,19:29:00,20170.5,SELL,1,0.02h,Stop Loss,$55.25,$341.00,$128236.25,218,$341.00
2024-11-01,19:44:00,20180.75,BUY,1,0.02h,Stop Loss,$-6.00,$335.00,$128230.25,218,$335.00
2024-11-01,19:45:00,20169.25,SELL,1,0.02h,Stop Loss,$11.50,$346.50,$128241.75,218,$346.50
2024-11-01,19:47:00,20175.75,BUY,1,0.02h,Break Even,$0.25,$346.75,$128242.00,218,$346.75
2024-11-01,19:49:00,20161.0,SELL,1,0.02h,Stop Loss,$14.00,$360.75,$128256.00,218,$360.75
2024-11-01,20:08:00,20161.5,BUY,1,0.02h,Stop Loss,$-6.00,$354.75,$128250.00,218,$354.75
2024-11-01,20:49:00,20163.0,SELL,1,0.02h,Stop Loss,$-6.00,$348.75,$128244.00,218,$348.75
2024-11-01,21:00:00,20169.5,BUY,1,63.00h,Stop Loss,$50.25,$399.00,$128294.25,218,$399.00
Final P&L Day: 399.00,,,,,,,,,,,
2024-11-04,12:16:00,20165.5,SELL,1,0.02h,Break Even,$0.25,$0.25,$128294.50,219,$0.25
2024-11-04,12:52:00,20148.0,BUY,1,0.02h,Stop Loss,$-6.00,$-5.75,$128288.50,219,$-5.75
2024-11-04,13:16:00,20143.5,SELL,1,0.02h,Stop Loss,$-6.00,$-11.75,$128282.50,219,$-11.75
2024-11-04,13:21:00,20165.0,BUY,1,0.02h,Stop Loss,$-6.00,$-17.75,$128276.50,219,$-17.75
2024-11-04,13:25:00,20157.0,SELL,1,0.02h,Stop Loss,$14.00,$-3.75,$128290.50,219,$-3.75
2024-11-04,13:30:00,20161.25,BUY,1,0.02h,Stop Loss,$-6.00,$-9.75,$128284.50,219,$-9.75
2024-11-04,13:46:00,20156.5,SELL,1,0.02h,Stop Loss,$-6.00,$-15.75,$128278.50,219,$-15.75
2024-11-04,14:46:00,20125.5,BUY,1,0.02h,Stop Loss,$16.50,$0.75,$128295.00,219,$0.75
2024-11-04,16:21:00,20193.25,SELL,1,0.02h,Stop Loss,$40.25,$41.00,$128335.25,219,$41.00
2024-11-04,17:22:00,20083.0,BUY,1,0.02h,Stop Loss,$17.75,$58.75,$128353.00,219,$58.75
2024-11-04,18:06:00,20119.25,SELL,1,0.02h,Stop Loss,$46.50,$105.25,$128399.50,219,$105.25
2024-11-04,18:15:00,20137.75,BUY,1,0.02h,Stop Loss,$25.25,$130.50,$128424.75,219,$130.50
2024-11-04,19:00:00,20148.75,SELL,1,0.02h,Stop Loss,$-6.00,$124.50,$128418.75,219,$124.50
2024-11-04,19:08:00,20163.5,BUY,1,0.02h,Stop Loss,$10.25,$134.75,$128429.00,219,$134.75
2024-11-04,19:11:00,20149.75,SELL,1,0.02h,Stop Loss,$-6.00,$128.75,$128423.00,219,$128.75
2024-11-04,19:15:00,20159.5,BUY,1,0.02h,Break Even,$0.25,$129.00,$128423.25,219,$129.00
2024-11-04,19:18:00,20151.5,SELL,1,0.02h,Break Even,$0.25,$129.25,$128423.50,219,$129.25
2024-11-04,19:38:00,20151.75,BUY,1,0.02h,Break Even,$0.25,$129.50,$128423.75,219,$129.50
2024-11-04,19:46:00,20145.5,SELL,1,0.02h,Stop Loss,$11.50,$141.00,$128435.25,219,$141.00
2024-11-04,20:26:00,20134.75,BUY,1,0.02h,Break Even,$0.25,$141.25,$128435.50,219,$141.25
2024-11-04,20:29:00,20118.0,SELL,1,0.02h,Break Even,$0.25,$141.50,$128435.75,219,$141.50
2024-11-04,21:09:00,20107.25,BUY,1,0.02h,Stop Loss,$9.00,$150.50,$128444.75,219,$150.50
2024-11-04,21:38:00,20104.0,SELL,1,0.02h,Break Even,$0.25,$150.75,$128445.00,219,$150.75
2024-11-04,21:50:00,20110.25,BUY,1,0.02h,Stop Loss,$-6.00,$144.75,$128439.00,219,$144.75
2024-11-04,21:57:00,20105.5,SELL,1,0.02h,Break Even,$0.25,$145.00,$128439.25,219,$145.00
2024-11-04,22:00:00,20115.0,BUY,1,14.00h,Stop Loss,$222.75,$367.75,$128662.00,219,$367.75
Final P&L Day: 367.75,,,,,,,,,,,
2024-11-05,12:25:00,20142.25,SELL,1,0.02h,Stop Loss,$5.25,$5.25,$128667.25,220,$5.25
2024-11-05,12:51:00,20148.0,BUY,1,0.02h,Stop Loss,$-6.00,$-0.75,$128661.25,220,$-0.75
2024-11-05,13:13:00,20136.5,SELL,1,0.02h,Break Even,$0.25,$-0.50,$128661.50,220,$-0.50
2024-11-05,13:23:00,20149.25,BUY,1,0.02h,Stop Loss,$-6.00,$-6.50,$128655.50,220,$-6.50
2024-11-05,13:52:00,20152.75,SELL,1,0.02h,Break Even,$0.25,$-6.25,$128655.75,220,$-6.25
2024-11-05,14:17:00,20142.25,BUY,1,0.02h,Break Even,$0.25,$-6.00,$128656.00,220,$-6.00
2024-11-05,15:31:00,20275.0,SELL,1,0.02h,Break Even,$0.25,$-5.75,$128656.25,220,$-5.75
2024-11-05,15:41:00,20286.75,BUY,1,0.02h,Stop Loss,$9.00,$3.25,$128665.25,220,$3.25
2024-11-05,15:53:00,20264.25,SELL,1,0.02h,Stop Loss,$20.25,$23.50,$128685.50,220,$23.50
2024-11-05,16:09:00,20293.25,BUY,1,0.02h,Stop Loss,$11.50,$35.00,$128697.00,220,$35.00
2024-11-05,17:40:00,20349.25,SELL,1,0.02h,Break Even,$0.25,$35.25,$128697.25,220,$35.25
2024-11-05,17:47:00,20363.75,BUY,1,0.02h,Stop Loss,$10.25,$45.50,$128707.50,220,$45.50
2024-11-05,17:59:00,20344.5,SELL,1,0.02h,Stop Loss,$-6.00,$39.50,$128701.50,220,$39.50
2024-11-05,18:07:00,20365.5,BUY,1,0.02h,Break Even,$0.25,$39.75,$128701.75,220,$39.75
2024-11-05,18:12:00,20347.0,SELL,1,0.02h,Stop Loss,$10.25,$50.00,$128712.00,220,$50.00
2024-11-05,19:03:00,20321.0,BUY,1,0.02h,Break Even,$0.25,$50.25,$128712.25,220,$50.25
2024-11-05,19:19:00,20312.75,SELL,1,0.02h,Break Even,$0.25,$50.50,$128712.50,220,$50.50
2024-11-05,19:28:00,20323.25,BUY,1,0.02h,Break Even,$0.25,$50.75,$128712.75,220,$50.75
2024-11-05,19:51:00,20313.0,SELL,1,0.02h,Stop Loss,$35.25,$86.00,$128748.00,220,$86.00
2024-11-05,20:09:00,20316.25,BUY,1,0.02h,Stop Loss,$21.50,$107.50,$128769.50,220,$107.50
2024-11-05,20:44:00,20311.0,SELL,1,0.02h,Stop Loss,$-6.00,$101.50,$128763.50,220,$101.50
2024-11-05,20:59:00,20331.25,BUY,1,0.02h,Stop Loss,$66.50,$168.00,$128830.00,220,$168.00
2024-11-05,21:42:00,20362.25,SELL,1,0.02h,Stop Loss,$-6.00,$162.00,$128824.00,220,$162.00
Final P&L Day: 162.00,,,,,,,,,,,
2024-11-06,12:00:00,20607.0,BUY,1,0.02h,Stop Loss,$26.50,$26.50,$128850.50,221,$26.50
2024-11-06,13:03:00,20665.75,SELL,1,0.02h,Stop Loss,$-6.00,$20.50,$128844.50,221,$20.50
2024-11-06,13:17:00,20683.5,BUY,1,0.02h,Stop Loss,$-6.00,$14.50,$128838.50,221,$14.50
2024-11-06,13:46:00,20687.25,SELL,1,0.02h,Stop Loss,$39.00,$53.50,$128877.50,221,$53.50
2024-11-06,14:28:00,20688.5,BUY,1,0.02h,Stop Loss,$-6.00,$47.50,$128871.50,221,$47.50
2024-11-06,14:49:00,20680.5,SELL,1,0.02h,Stop Loss,$76.50,$124.00,$128948.00,221,$124.00
2024-11-06,15:03:00,20725.5,BUY,1,0.02h,Break Even,$0.25,$124.25,$128948.25,221,$124.25
2024-11-06,15:06:00,20686.5,SELL,1,0.02h,Break Even,$0.25,$124.50,$128948.50,221,$124.50
2024-11-06,15:11:00,20735.25,BUY,1,0.02h,Stop Loss,$32.75,$157.25,$128981.25,221,$157.25
2024-11-06,15:42:00,20772.25,SELL,1,0.02h,Stop Loss,$111.50,$268.75,$129092.75,221,$268.75
2024-11-06,16:13:00,20747.0,BUY,1,0.02h,Stop Loss,$45.25,$314.00,$129138.00,221,$314.00
2024-11-06,17:22:00,20794.0,SELL,1,0.02h,Break Even,$0.25,$314.25,$129138.25,221,$314.25
2024-11-06,17:33:00,20801.75,BUY,1,0.02h,Break Even,$0.25,$314.50,$129138.50,221,$314.50
2024-11-06,17:40:00,20792.0,SELL,1,0.02h,Break Even,$0.25,$314.75,$129138.75,221,$314.75
2024-11-06,17:43:00,20803.0,BUY,1,0.02h,Break Even,$0.25,$315.00,$129139.00,221,$315.00
2024-11-06,18:59:00,20853.25,SELL,1,0.02h,Stop Loss,$-6.00,$309.00,$129133.00,221,$309.00
2024-11-06,19:02:00,20873.25,BUY,1,0.02h,Break Even,$0.25,$309.25,$129133.25,221,$309.25
2024-11-06,19:07:00,20854.0,SELL,1,0.02h,Stop Loss,$11.50,$320.75,$129144.75,221,$320.75
2024-11-06,19:09:00,20869.0,BUY,1,0.02h,Break Even,$0.25,$321.00,$129145.00,221,$321.00
2024-11-06,19:11:00,20858.25,SELL,1,0.02h,Break Even,$0.25,$321.25,$129145.25,221,$321.25
2024-11-06,19:14:00,20872.25,BUY,1,0.02h,Stop Loss,$36.50,$357.75,$129181.75,221,$357.75
2024-11-06,19:43:00,20869.0,SELL,1,0.02h,Break Even,$0.25,$358.00,$129182.00,221,$358.00
2024-11-06,19:48:00,20885.5,BUY,1,0.02h,Stop Loss,$9.00,$367.00,$129191.00,221,$367.00
2024-11-06,19:56:00,20876.5,SELL,1,0.02h,Break Even,$0.25,$367.25,$129191.25,221,$367.25
2024-11-06,19:58:00,20883.25,BUY,1,0.02h,Break Even,$0.25,$367.50,$129191.50,221,$367.50
2024-11-06,20:38:00,20897.75,SELL,1,0.02h,Stop Loss,$6.50,$374.00,$129198.00,221,$374.00
2024-11-06,20:45:00,20912.75,BUY,1,0.02h,Break Even,$0.25,$374.25,$129198.25,221,$374.25
2024-11-06,20:53:00,20881.0,SELL,1,0.02h,Break Even,$0.25,$374.50,$129198.50,221,$374.50
2024-11-06,21:02:00,20917.75,BUY,1,0.02h,Stop Loss,$25.25,$399.75,$129223.75,221,$399.75
2024-11-06,21:08:00,20897.5,SELL,1,0.02h,Break Even,$0.25,$400.00,$129224.00,221,$400.00
2024-11-06,21:23:00,20902.25,BUY,1,0.02h,Stop Loss,$44.00,$444.00,$129268.00,221,$444.00
2024-11-06,21:41:00,20901.25,SELL,1,0.02h,Break Even,$0.25,$444.25,$129268.25,221,$444.25
2024-11-06,21:43:00,20908.0,BUY,1,0.02h,Stop Loss,$20.25,$464.50,$129288.50,221,$464.50
Final P&L Day: 464.50,,,,,,,,,,,
2024-11-07,12:44:00,20960.75,SELL,1,0.02h,Stop Loss,$-6.00,$-6.00,$129282.50,222,$-6.00
2024-11-07,13:00:00,20967.0,BUY,1,0.02h,Stop Loss,$5.25,$-0.75,$129287.75,222,$-0.75
2024-11-07,13:25:00,20978.25,SELL,1,0.02h,Break Even,$0.25,$-0.50,$129288.00,222,$-0.50
2024-11-07,13:46:00,20989.5,BUY,1,0.02h,Break Even,$0.25,$-0.25,$129288.25,222,$-0.25
2024-11-07,15:34:00,21092.25,SELL,1,0.02h,Stop Loss,$12.75,$12.50,$129301.00,222,$12.50
2024-11-07,15:37:00,21123.5,BUY,1,0.02h,Break Even,$0.25,$12.75,$129301.25,222,$12.75
2024-11-07,15:42:00,21106.0,SELL,1,0.02h,Stop Loss,$-6.00,$6.75,$129295.25,222,$6.75
2024-11-07,15:43:00,21111.5,BUY,1,0.02h,Break Even,$0.25,$7.00,$129295.50,222,$7.00
2024-11-07,15:44:00,21106.75,SELL,1,0.02h,Stop Loss,$-6.00,$1.00,$129289.50,222,$1.00
2024-11-07,15:45:00,21118.75,BUY,1,0.02h,Stop Loss,$49.00,$50.00,$129338.50,222,$50.00
2024-11-07,16:11:00,21132.75,SELL,1,0.02h,Stop Loss,$-6.00,$44.00,$129332.50,222,$44.00
2024-11-07,16:12:00,21145.75,BUY,1,0.02h,Break Even,$0.25,$44.25,$129332.75,222,$44.25
2024-11-07,17:05:00,21171.5,SELL,1,0.02h,Stop Loss,$14.00,$58.25,$129346.75,222,$58.25
2024-11-07,17:16:00,21179.25,BUY,1,0.02h,Break Even,$0.25,$58.50,$129347.00,222,$58.50
2024-11-07,17:17:00,21173.75,SELL,1,0.02h,Break Even,$0.25,$58.75,$129347.25,222,$58.75
2024-11-07,17:18:00,21177.75,BUY,1,0.02h,Stop Loss,$6.50,$65.25,$129353.75,222,$65.25
2024-11-07,17:21:00,21172.0,SELL,1,0.02h,Stop Loss,$-6.00,$59.25,$129347.75,222,$59.25
2024-11-07,17:22:00,21183.5,BUY,1,0.02h,Break Even,$0.25,$59.50,$129348.00,222,$59.50
2024-11-07,17:26:00,21172.25,SELL,1,0.02h,Break Even,$0.25,$59.75,$129348.25,222,$59.75
2024-11-07,17:31:00,21184.0,BUY,1,0.02h,Stop Loss,$17.75,$77.50,$129366.00,222,$77.50
2024-11-07,17:34:00,21166.5,SELL,1,0.02h,Break Even,$0.25,$77.75,$129366.25,222,$77.75
2024-11-07,17:38:00,21185.0,BUY,1,0.02h,Stop Loss,$5.25,$83.00,$129371.50,222,$83.00
2024-11-07,18:08:00,21179.25,SELL,1,0.02h,Stop Loss,$30.25,$113.25,$129401.75,222,$113.25
2024-11-07,18:52:00,21179.25,BUY,1,0.02h,Stop Loss,$11.50,$124.75,$129413.25,222,$124.75
2024-11-07,19:24:00,21179.25,SELL,1,0.02h,Break Even,$0.25,$125.00,$129413.50,222,$125.00
2024-11-07,19:28:00,21192.0,BUY,1,0.02h,Stop Loss,$-6.00,$119.00,$129407.50,222,$119.00
2024-11-07,19:43:00,21173.75,SELL,1,0.02h,Stop Loss,$11.50,$130.50,$129419.00,222,$130.50
2024-11-07,19:48:00,21199.0,BUY,1,0.02h,Stop Loss,$57.75,$188.25,$129476.75,222,$188.25
2024-11-07,20:35:00,21229.5,SELL,1,0.02h,Break Even,$0.25,$188.50,$129477.00,222,$188.50
2024-11-07,20:48:00,21243.0,BUY,1,0.02h,Stop Loss,$14.00,$202.50,$129491.00,222,$202.50
2024-11-07,20:52:00,21218.0,SELL,1,0.02h,Stop Loss,$34.00,$236.50,$129525.00,222,$236.50
2024-11-07,21:07:00,21232.5,BUY,1,0.02h,Stop Loss,$14.00,$250.50,$129539.00,222,$250.50
2024-11-07,21:28:00,21232.0,SELL,1,0.02h,Break Even,$0.25,$250.75,$129539.25,222,$250.75
2024-11-07,21:59:00,21226.75,BUY,1,0.02h,Break Even,$0.25,$251.00,$129539.50,222,$251.00
Final P&L Day: 251.00,,,,,,,,,,,
2024-11-08,12:00:00,21161.75,SELL,1,0.02h,Stop Loss,$-6.00,$-6.00,$129533.50,223,$-6.00
2024-11-08,12:32:00,21178.0,BUY,1,0.02h,Stop Loss,$-6.00,$-12.00,$129527.50,223,$-12.00
2024-11-08,13:13:00,21174.5,SELL,1,0.02h,Stop Loss,$-6.00,$-18.00,$129521.50,223,$-18.00
2024-11-08,13:24:00,21185.25,BUY,1,0.02h,Stop Loss,$-6.00,$-24.00,$129515.50,223,$-24.00
2024-11-08,13:31:00,21174.75,SELL,1,0.02h,Stop Loss,$5.25,$-18.75,$129520.75,223,$-18.75
2024-11-08,14:10:00,21172.75,BUY,1,0.02h,Stop Loss,$10.25,$-8.50,$129531.00,223,$-8.50
2024-11-08,14:47:00,21194.5,SELL,1,0.02h,Stop Loss,$-6.00,$-14.50,$129525.00,223,$-14.50
2024-11-08,14:48:00,21211.75,BUY,1,0.02h,Stop Loss,$6.50,$-8.00,$129531.50,223,$-8.00
2024-11-08,15:05:00,21190.5,SELL,1,0.02h,Stop Loss,$34.00,$26.00,$129565.50,223,$26.00
2024-11-08,15:22:00,21199.75,BUY,1,0.02h,Break Even,$0.25,$26.25,$129565.75,223,$26.25
2024-11-08,15:25:00,21181.5,SELL,1,0.02h,Break Even,$0.25,$26.50,$129566.00,223,$26.50
2024-11-08,15:27:00,21193.25,BUY,1,0.02h,Stop Loss,$6.50,$33.00,$129572.50,223,$33.00
2024-11-08,15:39:00,21188.0,SELL,1,0.02h,Stop Loss,$5.25,$38.25,$129577.75,223,$38.25
2024-11-08,15:51:00,21193.5,BUY,1,0.02h,Stop Loss,$32.75,$71.00,$129610.50,223,$71.00
2024-11-08,16:03:00,21173.25,SELL,1,0.02h,Break Even,$0.25,$71.25,$129610.75,223,$71.25
2024-11-08,16:12:00,21197.25,BUY,1,0.02h,Stop Loss,$20.25,$91.50,$129631.00,223,$91.50
2024-11-08,16:44:00,21197.5,SELL,1,0.02h,Break Even,$0.25,$91.75,$129631.25,223,$91.75
2024-11-08,16:51:00,21221.75,BUY,1,0.02h,Break Even,$0.25,$92.00,$129631.50,223,$92.00
2024-11-08,17:06:00,21207.5,SELL,1,0.02h,Stop Loss,$-6.00,$86.00,$129625.50,223,$86.00
2024-11-08,17:33:00,21217.25,BUY,1,0.02h,Break Even,$0.25,$86.25,$129625.75,223,$86.25
2024-11-08,18:54:00,21243.5,SELL,1,0.02h,Stop Loss,$22.75,$109.00,$129648.50,223,$109.00
2024-11-08,19:08:00,21253.75,BUY,1,0.02h,Break Even,$0.25,$109.25,$129648.75,223,$109.25
2024-11-08,19:21:00,21244.5,SELL,1,0.02h,Stop Loss,$-6.00,$103.25,$129642.75,223,$103.25
2024-11-08,19:26:00,21253.0,BUY,1,0.02h,Break Even,$0.25,$103.50,$129643.00,223,$103.50
2024-11-08,19:49:00,21248.75,SELL,1,0.02h,Break Even,$0.25,$103.75,$129643.25,223,$103.75
2024-11-08,20:54:00,21223.75,BUY,1,0.02h,Stop Loss,$26.50,$130.25,$129669.75,223,$130.25
2024-11-08,20:57:00,21220.5,SELL,1,0.02h,Stop Loss,$-6.00,$124.25,$129663.75,223,$124.25
2024-11-08,20:58:00,21230.5,BUY,1,0.02h,Break Even,$0.25,$124.50,$129664.00,223,$124.50
2024-11-08,21:32:00,21228.25,SELL,1,0.02h,Break Even,$0.25,$124.75,$129664.25,223,$124.75
2024-11-08,21:56:00,21235.5,BUY,1,0.02h,Stop Loss,$-6.00,$118.75,$129658.25,223,$118.75
Final P&L Day: 118.75,,,,,,,,,,,
2024-11-11,13:16:00,21317.75,SELL,1,0.02h,Stop Loss,$5.25,$5.25,$129663.50,224,$5.25
2024-11-11,14:06:00,21299.75,BUY,1,0.02h,Break Even,$0.25,$5.50,$129663.75,224,$5.50
2024-11-11,14:12:00,21293.25,SELL,1,0.02h,Stop Loss,$7.75,$13.25,$129671.50,224,$13.25
2024-11-11,15:16:00,21197.5,BUY,1,0.02h,Break Even,$0.25,$13.50,$129671.75,224,$13.50
2024-11-11,15:17:00,21183.5,SELL,1,0.02h,Stop Loss,$7.75,$21.25,$129679.50,224,$21.25
2024-11-11,15:25:00,21197.0,BUY,1,0.02h,Stop Loss,$10.25,$31.50,$129689.75,224,$31.50
2024-11-11,15:49:00,21200.0,SELL,1,0.02h,Stop Loss,$-6.00,$25.50,$129683.75,224,$25.50
2024-11-11,15:54:00,21221.5,BUY,1,0.02h,Break Even,$0.25,$25.75,$129684.00,224,$25.75
2024-11-11,16:13:00,21211.0,SELL,1,0.02h,Break Even,$0.25,$26.00,$129684.25,224,$26.00
2024-11-11,16:15:00,21222.5,BUY,1,0.02h,Stop Loss,$-6.00,$20.00,$129678.25,224,$20.00
2024-11-11,16:16:00,21217.5,SELL,1,0.02h,Stop Loss,$4.00,$24.00,$129682.25,224,$24.00
2024-11-11,16:20:00,21228.75,BUY,1,0.02h,Break Even,$0.25,$24.25,$129682.50,224,$24.25
2024-11-11,16:27:00,21209.75,SELL,1,0.02h,Break Even,$0.25,$24.50,$129682.75,224,$24.50
2024-11-11,17:38:00,21181.0,BUY,1,0.02h,Break Even,$0.25,$24.75,$129683.00,224,$24.75
2024-11-11,17:39:00,21176.75,SELL,1,0.02h,Stop Loss,$22.75,$47.50,$129705.75,224,$47.50
2024-11-11,18:30:00,21141.5,BUY,1,0.02h,Stop Loss,$-6.00,$41.50,$129699.75,224,$41.50
2024-11-11,19:12:00,21164.0,SELL,1,0.02h,Stop Loss,$-6.00,$35.50,$129693.75,224,$35.50
2024-11-11,19:35:00,21177.0,BUY,1,0.02h,Stop Loss,$-6.00,$29.50,$129687.75,224,$29.50
2024-11-11,19:48:00,21165.75,SELL,1,0.02h,Stop Loss,$-6.00,$23.50,$129681.75,224,$23.50
2024-11-11,19:49:00,21173.0,BUY,1,0.02h,Stop Loss,$4.00,$27.50,$129685.75,224,$27.50
2024-11-11,19:53:00,21165.25,SELL,1,0.02h,Break Even,$0.25,$27.75,$129686.00,224,$27.75
2024-11-11,20:00:00,21175.0,BUY,1,0.02h,Stop Loss,$-6.00,$21.75,$129680.00,224,$21.75
2024-11-11,20:50:00,21192.5,SELL,1,0.02h,Break Even,$0.25,$22.00,$129680.25,224,$22.00
2024-11-11,20:51:00,21207.0,BUY,1,0.02h,Stop Loss,$4.00,$26.00,$129684.25,224,$26.00
2024-11-11,21:33:00,21217.5,SELL,1,0.02h,Stop Loss,$-6.00,$20.00,$129678.25,224,$20.00
2024-11-11,21:41:00,21223.25,BUY,1,0.02h,Stop Loss,$-6.00,$14.00,$129672.25,224,$14.00
2024-11-11,21:51:00,21220.0,SELL,1,0.02h,Stop Loss,$-6.00,$8.00,$129666.25,224,$8.00
2024-11-11,21:52:00,21223.5,BUY,1,0.02h,Stop Loss,$-6.00,$2.00,$129660.25,224,$2.00
2024-11-11,21:55:00,21219.25,SELL,1,0.02h,Break Even,$0.25,$2.25,$129660.50,224,$2.25
Final P&L Day: 2.25,,,,,,,,,,,
2024-11-12,12:42:00,21204.5,BUY,1,0.02h,Break Even,$0.25,$0.25,$129660.75,225,$0.25
2024-11-12,12:58:00,21193.0,SELL,1,0.02h,Break Even,$0.25,$0.50,$129661.00,225,$0.50
2024-11-12,13:14:00,21200.75,BUY,1,0.02h,Stop Loss,$-6.00,$-5.50,$129655.00,225,$-5.50
2024-11-12,14:04:00,21213.5,SELL,1,0.02h,Break Even,$0.25,$-5.25,$129655.25,225,$-5.25
2024-11-12,14:30:00,21214.25,BUY,1,0.02h,Stop Loss,$21.50,$16.25,$129676.75,225,$16.25
2024-11-12,14:31:00,21204.5,SELL,1,0.02h,Stop Loss,$41.50,$57.75,$129718.25,225,$57.75
2024-11-12,14:36:00,21229.25,BUY,1,0.02h,Stop Loss,$44.00,$101.75,$129762.25,225,$101.75
2024-11-12,14:48:00,21212.0,SELL,1,0.02h,Break Even,$0.25,$102.00,$129762.50,225,$102.00
2024-11-12,14:50:00,21220.5,BUY,1,0.02h,Break Even,$0.25,$102.25,$129762.75,225,$102.25
2024-11-12,15:05:00,21191.75,SELL,1,0.02h,Break Even,$0.25,$102.50,$129763.00,225,$102.50
2024-11-12,15:16:00,21219.75,BUY,1,0.02h,Stop Loss,$14.00,$116.50,$129777.00,225,$116.50
2024-11-12,15:19:00,21208.0,SELL,1,0.02h,Stop Loss,$4.00,$120.50,$129781.00,225,$120.50
2024-11-12,15:27:00,21224.0,BUY,1,0.02h,Stop Loss,$11.50,$132.00,$129792.50,225,$132.00
2024-11-12,15:45:00,21204.0,SELL,1,0.02h,Stop Loss,$4.00,$136.00,$129796.50,225,$136.00
2024-11-12,16:54:00,21189.75,BUY,1,0.02h,Stop Loss,$7.75,$143.75,$129804.25,225,$143.75
2024-11-12,17:00:00,21154.5,SELL,1,0.02h,Stop Loss,$30.25,$174.00,$129834.50,225,$174.00
2024-11-12,17:30:00,21159.0,BUY,1,0.02h,Break Even,$0.25,$174.25,$129834.75,225,$174.25
2024-11-12,17:44:00,21140.5,SELL,1,0.02h,Break Even,$0.25,$174.50,$129835.00,225,$174.50
2024-11-12,18:16:00,21110.0,BUY,1,0.02h,Stop Loss,$22.75,$197.25,$129857.75,225,$197.25
2024-11-12,19:54:00,21195.75,SELL,1,0.02h,Stop Loss,$11.50,$208.75,$129869.25,225,$208.75
2024-11-12,20:38:00,21190.25,BUY,1,0.02h,Stop Loss,$7.75,$216.50,$129877.00,225,$216.50
2024-11-12,20:53:00,21180.5,SELL,1,0.02h,Stop Loss,$7.75,$224.25,$129884.75,225,$224.25
2024-11-12,21:03:00,21194.25,BUY,1,0.02h,Stop Loss,$-6.00,$218.25,$129878.75,225,$218.25
2024-11-12,21:20:00,21190.5,SELL,1,0.02h,Break Even,$0.25,$218.50,$129879.00,225,$218.50
2024-11-12,21:26:00,21192.5,BUY,1,0.02h,Break Even,$0.25,$218.75,$129879.25,225,$218.75
2024-11-12,21:38:00,21189.75,SELL,1,0.02h,Break Even,$0.25,$219.00,$129879.50,225,$219.00
Final P&L Day: 219.00,,,,,,,,,,,
2024-11-13,12:24:00,21155.5,BUY,1,0.02h,Stop Loss,$-6.00,$-6.00,$129873.50,226,$-6.00
2024-11-13,12:37:00,21143.25,SELL,1,0.02h,Stop Loss,$11.50,$5.50,$129885.00,226,$5.50
2024-11-13,13:11:00,21133.75,BUY,1,0.02h,Break Even,$0.25,$5.75,$129885.25,226,$5.75
2024-11-13,13:56:00,21180.5,SELL,1,0.02h,Stop Loss,$25.25,$31.00,$129910.50,226,$31.00
2024-11-13,14:23:00,21188.5,BUY,1,0.02h,Stop Loss,$-6.00,$25.00,$129904.50,226,$25.00
2024-11-13,14:28:00,21173.5,SELL,1,0.02h,Stop Loss,$57.75,$82.75,$129962.25,226,$82.75
2024-11-13,15:33:00,21123.75,BUY,1,0.02h,Stop Loss,$32.75,$115.50,$129995.00,226,$115.50
2024-11-13,15:52:00,21101.75,SELL,1,0.02h,Stop Loss,$5.25,$120.75,$130000.25,226,$120.75
2024-11-13,15:56:00,21126.0,BUY,1,0.02h,Break Even,$0.25,$121.00,$130000.50,226,$121.00
2024-11-13,16:04:00,21109.75,SELL,1,0.02h,Break Even,$0.25,$121.25,$130000.75,226,$121.25
2024-11-13,16:11:00,21117.25,BUY,1,0.02h,Stop Loss,$32.75,$154.00,$130033.50,226,$154.00
2024-11-13,16:42:00,21125.5,SELL,1,0.02h,Stop Loss,$94.00,$248.00,$130127.50,226,$248.00
2024-11-13,16:49:00,21153.25,BUY,1,0.02h,Stop Loss,$21.50,$269.50,$130149.00,226,$269.50
2024-11-13,17:45:00,21173.0,SELL,1,0.02h,Stop Loss,$-6.00,$263.50,$130143.00,226,$263.50
2024-11-13,17:48:00,21202.5,BUY,1,0.02h,Stop Loss,$14.00,$277.50,$130157.00,226,$277.50
2024-11-13,18:18:00,21213.5,SELL,1,0.02h,Stop Loss,$7.75,$285.25,$130164.75,226,$285.25
2024-11-13,18:24:00,21229.5,BUY,1,0.02h,Break Even,$0.25,$285.50,$130165.00,226,$285.50
2024-11-13,19:06:00,21231.5,SELL,1,0.02h,Break Even,$0.25,$285.75,$130165.25,226,$285.75
2024-11-13,20:15:00,21189.0,BUY,1,0.02h,Stop Loss,$22.75,$308.50,$130188.00,226,$308.50
2024-11-13,20:29:00,21180.25,SELL,1,0.02h,Break Even,$0.25,$308.75,$130188.25,226,$308.75
2024-11-13,20:35:00,21202.5,BUY,1,0.02h,Stop Loss,$71.50,$380.25,$130259.75,226,$380.25
2024-11-13,20:50:00,21192.5,SELL,1,0.02h,Stop Loss,$114.00,$494.25,$130373.75,226,$494.25
2024-11-13,21:13:00,21169.25,BUY,1,0.02h,Stop Loss,$14.00,$508.25,$130387.75,226,$508.25
2024-11-13,21:49:00,21168.75,SELL,1,0.02h,Break Even,$0.25,$508.50,$130388.00,226,$508.50
Final P&L Day: 508.50,,,,,,,,,,,
2024-11-14,12:02:00,21175.25,BUY,1,0.02h,Break Even,$0.25,$0.25,$130388.25,227,$0.25
2024-11-14,12:07:00,21168.5,SELL,1,0.02h,Break Even,$0.25,$0.50,$130388.50,227,$0.50
2024-11-14,12:19:00,21171.5,BUY,1,0.02h,Stop Loss,$-6.00,$-5.50,$130382.50,227,$-5.50
2024-11-14,12:22:00,21167.75,SELL,1,0.02h,Break Even,$0.25,$-5.25,$130382.75,227,$-5.25
2024-11-14,12:33:00,21172.25,BUY,1,0.02h,Break Even,$0.25,$-5.00,$130383.00,227,$-5.00
2024-11-14,12:49:00,21164.75,SELL,1,0.02h,Break Even,$0.25,$-4.75,$130383.25,227,$-4.75
2024-11-14,13:15:00,21169.5,BUY,1,0.02h,Break Even,$0.25,$-4.50,$130383.50,227,$-4.50
2024-11-14,13:32:00,21135.0,SELL,1,0.02h,Stop Loss,$-6.00,$-10.50,$130377.50,227,$-10.50
2024-11-14,14:14:00,21139.75,BUY,1,0.02h,Break Even,$0.25,$-10.25,$130377.75,227,$-10.25
2024-11-14,14:19:00,21133.25,SELL,1,0.02h,Break Even,$0.25,$-10.00,$130378.00,227,$-10.00
2024-11-14,14:31:00,21161.0,BUY,1,0.02h,Stop Loss,$7.75,$-2.25,$130385.75,227,$-2.25
2024-11-14,14:42:00,21098.75,SELL,1,0.02h,Break Even,$0.25,$-2.00,$130386.00,227,$-2.00
2024-11-14,15:15:00,21107.0,BUY,1,0.02h,Break Even,$0.25,$-1.75,$130386.25,227,$-1.75
2024-11-14,15:18:00,21091.5,SELL,1,0.02h,Stop Loss,$110.25,$108.50,$130496.50,227,$108.50
2024-11-14,15:31:00,21097.0,BUY,1,0.02h,Break Even,$0.25,$108.75,$130496.75,227,$108.75
2024-11-14,15:59:00,21094.5,SELL,1,0.02h,Stop Loss,$46.50,$155.25,$130543.25,227,$155.25
2024-11-14,16:25:00,21112.5,BUY,1,0.02h,Stop Loss,$11.50,$166.75,$130554.75,227,$166.75
2024-11-14,16:54:00,21110.5,SELL,1,0.02h,Stop Loss,$25.25,$192.00,$130580.00,227,$192.00
2024-11-14,17:42:00,21074.25,BUY,1,0.02h,Break Even,$0.25,$192.25,$130580.25,227,$192.25
2024-11-14,17:49:00,21054.5,SELL,1,0.02h,Stop Loss,$166.50,$358.75,$130746.75,227,$358.75
2024-11-14,17:56:00,21077.5,BUY,1,0.02h,Stop Loss,$4.00,$362.75,$130750.75,227,$362.75
2024-11-14,18:33:00,21089.5,SELL,1,0.02h,Stop Loss,$19.00,$381.75,$130769.75,227,$381.75
2024-11-14,19:06:00,21078.75,BUY,1,0.02h,Stop Loss,$14.00,$395.75,$130783.75,227,$395.75
2024-11-14,19:14:00,21055.75,SELL,1,0.02h,Stop Loss,$12.75,$408.50,$130796.50,227,$408.50
2024-11-14,19:30:00,21066.0,BUY,1,0.02h,Break Even,$0.25,$408.75,$130796.75,227,$408.75
2024-11-14,19:48:00,21057.25,SELL,1,0.02h,Stop Loss,$15.25,$424.00,$130812.00,227,$424.00
2024-11-14,19:53:00,21077.25,BUY,1,0.02h,Stop Loss,$50.25,$474.25,$130862.25,227,$474.25
2024-11-14,20:01:00,21042.25,SELL,1,0.02h,Stop Loss,$25.25,$499.50,$130887.50,227,$499.50
2024-11-14,20:29:00,21032.25,BUY,1,0.02h,Stop Loss,$21.50,$521.00,$130909.00,227,$521.00
2024-11-14,20:31:00,21016.0,SELL,1,0.02h,Stop Loss,$36.50,$557.50,$130945.50,227,$557.50
2024-11-14,21:00:00,21008.75,BUY,1,0.02h,Stop Loss,$4.00,$561.50,$130949.50,227,$561.50
2024-11-14,21:05:00,20994.75,SELL,1,0.02h,Break Even,$0.25,$561.75,$130949.75,227,$561.75
2024-11-14,21:36:00,20982.0,BUY,1,0.02h,Stop Loss,$-6.00,$555.75,$130943.75,227,$555.75
Final P&L Day: 555.75,,,,,,,,,,,
2024-11-15,12:00:00,20844.0,SELL,1,0.02h,Stop Loss,$9.00,$9.00,$130952.75,228,$9.00
2024-11-15,12:50:00,20854.75,BUY,1,0.02h,Break Even,$0.25,$9.25,$130953.00,228,$9.25
2024-11-15,13:07:00,20851.0,SELL,1,0.02h,Break Even,$0.25,$9.50,$130953.25,228,$9.50
2024-11-15,16:19:00,20566.75,BUY,1,0.02h,Stop Loss,$22.75,$32.25,$130976.00,228,$32.25
2024-11-15,16:38:00,20550.5,SELL,1,0.02h,Stop Loss,$20.25,$52.50,$130996.25,228,$52.50
2024-11-15,17:45:00,20502.75,BUY,1,0.02h,Stop Loss,$30.25,$82.75,$131026.50,228,$82.75
2024-11-15,17:51:00,20467.25,SELL,1,0.02h,Stop Loss,$-6.00,$76.75,$131020.50,228,$76.75
2024-11-15,19:08:00,20440.25,BUY,1,0.02h,Stop Loss,$60.25,$137.00,$131080.75,228,$137.00
2024-11-15,19:21:00,20434.75,SELL,1,0.02h,Stop Loss,$4.00,$141.00,$131084.75,228,$141.00
2024-11-15,19:41:00,20444.5,BUY,1,0.02h,Stop Loss,$26.50,$167.50,$131111.25,228,$167.50
2024-11-15,20:42:00,20468.75,SELL,1,0.02h,Stop Loss,$19.00,$186.50,$131130.25,228,$186.50
2024-11-15,20:55:00,20500.75,BUY,1,0.02h,Stop Loss,$49.00,$235.50,$131179.25,228,$235.50
2024-11-15,21:24:00,20497.25,SELL,1,0.02h,Break Even,$0.25,$235.75,$131179.50,228,$235.75
2024-11-15,21:41:00,20499.0,BUY,1,0.02h,Stop Loss,$-6.00,$229.75,$131173.50,228,$229.75
2024-11-15,21:46:00,20495.5,SELL,1,0.02h,Stop Loss,$-6.00,$223.75,$131167.50,228,$223.75
2024-11-15,21:47:00,20498.0,BUY,1,0.02h,Stop Loss,$4.00,$227.75,$131171.50,228,$227.75
Final P&L Day: 227.75,,,,,,,,,,,
2024-11-18,12:34:00,20551.0,SELL,1,0.02h,Stop Loss,$-6.00,$-6.00,$131165.50,229,$-6.00
2024-11-18,12:37:00,20567.25,BUY,1,0.02h,Break Even,$0.25,$-5.75,$131165.75,229,$-5.75
2024-11-18,12:54:00,20562.25,SELL,1,0.02h,Stop Loss,$-6.00,$-11.75,$131159.75,229,$-11.75
2024-11-18,13:36:00,20531.25,BUY,1,0.02h,Stop Loss,$9.00,$-2.75,$131168.75,229,$-2.75
2024-11-18,14:30:00,20557.25,SELL,1,0.02h,Stop Loss,$104.00,$101.25,$131272.75,229,$101.25
2024-11-18,15:03:00,20565.75,BUY,1,0.02h,Break Even,$0.25,$101.50,$131273.00,229,$101.50
2024-11-18,16:49:00,20684.0,SELL,1,0.02h,Stop Loss,$40.25,$141.75,$131313.25,229,$141.75
2024-11-18,17:28:00,20663.25,BUY,1,0.02h,Stop Loss,$-6.00,$135.75,$131307.25,229,$135.75
2024-11-18,17:31:00,20651.0,SELL,1,0.02h,Break Even,$0.25,$136.00,$131307.50,229,$136.00
2024-11-18,17:59:00,20656.75,BUY,1,0.02h,Stop Loss,$11.50,$147.50,$131319.00,229,$147.50
2024-11-18,18:27:00,20653.25,SELL,1,0.02h,Break Even,$0.25,$147.75,$131319.25,229,$147.75
2024-11-18,18:58:00,20646.25,BUY,1,0.02h,Stop Loss,$27.75,$175.50,$131347.00,229,$175.50
2024-11-18,19:11:00,20628.75,SELL,1,0.02h,Stop Loss,$7.75,$183.25,$131354.75,229,$183.25
2024-11-18,19:42:00,20616.75,BUY,1,0.02h,Stop Loss,$9.00,$192.25,$131363.75,229,$192.25
2024-11-18,20:34:00,20632.5,SELL,1,0.02h,Break Even,$0.25,$192.50,$131364.00,229,$192.50
2024-11-18,20:50:00,20645.25,BUY,1,0.02h,Stop Loss,$-6.00,$186.50,$131358.00,229,$186.50
2024-11-18,20:51:00,20630.5,SELL,1,0.02h,Stop Loss,$5.25,$191.75,$131363.25,229,$191.75
2024-11-18,21:03:00,20645.5,BUY,1,0.02h,Break Even,$0.25,$192.00,$131363.50,229,$192.00
2024-11-18,21:10:00,20626.25,SELL,1,0.02h,Break Even,$0.25,$192.25,$131363.75,229,$192.25
2024-11-18,21:44:00,20632.75,BUY,1,0.02h,Stop Loss,$-6.00,$186.25,$131357.75,229,$186.25
Final P&L Day: 186.25,,,,,,,,,,,
2024-11-19,12:00:00,20580.0,SELL,1,0.02h,Break Even,$0.25,$0.25,$131358.00,230,$0.25
2024-11-19,12:15:00,20616.75,BUY,1,0.02h,Break Even,$0.25,$0.50,$131358.25,230,$0.50
2024-11-19,12:17:00,20608.5,SELL,1,0.02h,Stop Loss,$6.50,$7.00,$131364.75,230,$7.00
2024-11-19,12:55:00,20609.25,BUY,1,0.02h,Break Even,$0.25,$7.25,$131365.00,230,$7.25
2024-11-19,13:10:00,20602.0,SELL,1,0.02h,Break Even,$0.25,$7.50,$131365.25,230,$7.50
2024-11-19,14:12:00,20481.75,BUY,1,0.02h,Stop Loss,$9.00,$16.50,$131374.25,230,$16.50
2024-11-19,15:01:00,20526.5,SELL,1,0.02h,Stop Loss,$-6.00,$10.50,$131368.25,230,$10.50
2024-11-19,15:02:00,20552.5,BUY,1,0.02h,Break Even,$0.25,$10.75,$131368.50,230,$10.75
2024-11-19,15:03:00,20524.75,SELL,1,0.02h,Stop Loss,$-6.00,$4.75,$131362.50,230,$4.75
2024-11-19,15:07:00,20560.75,BUY,1,0.02h,Stop Loss,$5.25,$10.00,$131367.75,230,$10.00
2024-11-19,16:54:00,20671.0,SELL,1,0.02h,Stop Loss,$24.00,$34.00,$131391.75,230,$34.00
2024-11-19,17:14:00,20675.75,BUY,1,0.02h,Break Even,$0.25,$34.25,$131392.00,230,$34.25
2024-11-19,17:22:00,20660.75,SELL,1,0.02h,Stop Loss,$74.00,$108.25,$131466.00,230,$108.25
2024-11-19,17:30:00,20685.0,BUY,1,0.02h,Stop Loss,$-6.00,$102.25,$131460.00,230,$102.25
2024-11-19,17:54:00,20684.5,SELL,1,0.02h,Stop Loss,$-6.00,$96.25,$131454.00,230,$96.25
2024-11-19,17:56:00,20693.75,BUY,1,0.02h,Stop Loss,$-6.00,$90.25,$131448.00,230,$90.25
2024-11-19,18:02:00,20683.75,SELL,1,0.02h,Break Even,$0.25,$90.50,$131448.25,230,$90.50
2024-11-19,18:04:00,20691.75,BUY,1,0.02h,Stop Loss,$9.00,$99.50,$131457.25,230,$99.50
2024-11-19,19:18:00,20765.25,SELL,1,0.02h,Stop Loss,$9.00,$108.50,$131466.25,230,$108.50
2024-11-19,19:54:00,20744.75,BUY,1,0.02h,Stop Loss,$14.00,$122.50,$131480.25,230,$122.50
2024-11-19,20:04:00,20729.0,SELL,1,0.02h,Break Even,$0.25,$122.75,$131480.50,230,$122.75
2024-11-19,20:07:00,20743.5,BUY,1,0.02h,Break Even,$0.25,$123.00,$131480.75,230,$123.00
2024-11-19,21:22:00,20768.0,SELL,1,0.02h,Break Even,$0.25,$123.25,$131481.00,230,$123.25
Final P&L Day: 123.25,,,,,,,,,,,
2024-11-20,12:00:00,20793.25,BUY,1,0.02h,Break Even,$0.25,$0.25,$131481.25,231,$0.25
2024-11-20,12:36:00,20807.5,SELL,1,0.02h,Stop Loss,$-6.00,$-5.75,$131475.25,231,$-5.75
2024-11-20,12:45:00,20814.0,BUY,1,0.02h,Break Even,$0.25,$-5.50,$131475.50,231,$-5.50
2024-11-20,13:14:00,20814.25,SELL,1,0.02h,Break Even,$0.25,$-5.25,$131475.75,231,$-5.25
2024-11-20,13:20:00,20823.25,BUY,1,0.02h,Stop Loss,$5.25,$0.00,$131481.00,231,$0.00
2024-11-20,13:28:00,20817.5,SELL,1,0.02h,Break Even,$0.25,$0.25,$131481.25,231,$0.25
2024-11-20,15:34:00,20561.25,BUY,1,0.02h,Stop Loss,$41.50,$41.75,$131522.75,231,$41.75
2024-11-20,16:12:00,20586.75,SELL,1,0.02h,Stop Loss,$6.50,$48.25,$131529.25,231,$48.25
2024-11-20,16:41:00,20610.0,BUY,1,0.02h,Stop Loss,$25.25,$73.50,$131554.50,231,$73.50
2024-11-20,17:11:00,20660.25,SELL,1,0.02h,Stop Loss,$30.25,$103.75,$131584.75,231,$103.75
2024-11-20,17:35:00,20637.75,BUY,1,0.02h,Stop Loss,$17.75,$121.50,$131602.50,231,$121.50
2024-11-20,17:55:00,20609.0,SELL,1,0.02h,Stop Loss,$-6.00,$115.50,$131596.50,231,$115.50
2024-11-20,18:28:00,20625.0,BUY,1,0.02h,Stop Loss,$19.00,$134.50,$131615.50,231,$134.50
2024-11-20,18:35:00,20605.75,SELL,1,0.02h,Stop Loss,$6.50,$141.00,$131622.00,231,$141.00
2024-11-20,19:03:00,20589.75,BUY,1,0.02h,Stop Loss,$12.75,$153.75,$131634.75,231,$153.75
2024-11-20,19:07:00,20570.75,SELL,1,0.02h,Stop Loss,$15.25,$169.00,$131650.00,231,$169.00
2024-11-20,19:35:00,20583.75,BUY,1,0.02h,Stop Loss,$6.50,$175.50,$131656.50,231,$175.50
2024-11-20,20:08:00,20598.25,SELL,1,0.02h,Break Even,$0.25,$175.75,$131656.75,231,$175.75
2024-11-20,20:10:00,20610.5,BUY,1,0.02h,Stop Loss,$12.75,$188.50,$131669.50,231,$188.50
2024-11-20,21:21:00,20644.25,SELL,1,0.02h,Stop Loss,$166.50,$355.00,$131836.00,231,$355.00
2024-11-20,21:45:00,20711.75,BUY,1,0.02h,Stop Loss,$90.25,$445.25,$131926.25,231,$445.25
Final P&L Day: 445.25,,,,,,,,,,,
2024-11-21,12:37:00,20773.25,SELL,1,0.02h,Break Even,$0.25,$0.25,$131926.50,232,$0.25
2024-11-21,12:43:00,20799.0,BUY,1,0.02h,Stop Loss,$32.75,$33.00,$131959.25,232,$33.00
2024-11-21,12:50:00,20774.25,SELL,1,0.02h,Stop Loss,$4.00,$37.00,$131963.25,232,$37.00
2024-11-21,13:13:00,20777.5,BUY,1,0.02h,Stop Loss,$36.50,$73.50,$131999.75,232,$73.50
2024-11-21,14:34:00,20837.0,SELL,1,0.02h,Stop Loss,$269.00,$342.50,$132268.75,232,$342.50
2024-11-21,15:17:00,20706.25,BUY,1,0.02h,Stop Loss,$-6.00,$336.50,$132262.75,232,$336.50
2024-11-21,15:24:00,20618.0,SELL,1,0.02h,Stop Loss,$126.50,$463.00,$132389.25,232,$463.00
2024-11-21,15:47:00,20615.75,BUY,1,0.02h,Stop Loss,$92.75,$555.75,$132482.00,232,$555.75
2024-11-21,16:47:00,20728.0,SELL,1,0.02h,Stop Loss,$77.75,$633.50,$132559.75,232,$633.50
2024-11-21,17:10:00,20741.5,BUY,1,0.02h,Stop Loss,$27.75,$661.25,$132587.50,232,$661.25
2024-11-21,18:19:00,20822.0,SELL,1,0.02h,Break Even,$0.25,$661.50,$132587.75,232,$661.50
2024-11-21,18:24:00,20834.25,BUY,1,0.02h,Stop Loss,$26.50,$688.00,$132614.25,232,$688.00
2024-11-21,18:42:00,20831.0,SELL,1,0.02h,Stop Loss,$-6.00,$682.00,$132608.25,232,$682.00
2024-11-21,18:45:00,20849.75,BUY,1,0.02h,Stop Loss,$7.75,$689.75,$132616.00,232,$689.75
2024-11-21,18:53:00,20837.75,SELL,1,0.02h,Stop Loss,$11.50,$701.25,$132627.50,232,$701.25
2024-11-21,18:55:00,20852.5,BUY,1,0.02h,Stop Loss,$45.25,$746.50,$132672.75,232,$746.50
2024-11-21,19:07:00,20845.0,SELL,1,0.02h,Stop Loss,$67.75,$814.25,$132740.50,232,$814.25
2024-11-21,19:27:00,20844.5,BUY,1,0.02h,Stop Loss,$-6.00,$808.25,$132734.50,232,$808.25
2024-11-21,19:51:00,20826.5,SELL,1,0.02h,Stop Loss,$14.00,$822.25,$132748.50,232,$822.25
2024-11-21,19:59:00,20844.0,BUY,1,0.02h,Stop Loss,$15.25,$837.50,$132763.75,232,$837.50
2024-11-21,20:35:00,20852.0,SELL,1,0.02h,Stop Loss,$67.75,$905.25,$132831.50,232,$905.25
2024-11-21,21:52:00,20808.5,BUY,1,0.02h,Stop Loss,$-6.00,$899.25,$132825.50,232,$899.25
2024-11-21,21:54:00,20798.5,SELL,1,0.02h,Stop Loss,$-6.00,$893.25,$132819.50,232,$893.25
2024-11-21,21:55:00,20801.0,BUY,1,0.02h,Stop Loss,$-6.00,$887.25,$132813.50,232,$887.25
2024-11-21,21:59:00,20795.5,SELL,1,0.02h,Break Even,$0.25,$887.50,$132813.75,232,$887.50
Final P&L Day: 887.50,,,,,,,,,,,
2024-11-22,12:26:00,20786.75,BUY,1,0.02h,Stop Loss,$-6.00,$-6.00,$132807.75,233,$-6.00
2024-11-22,12:28:00,20782.25,SELL,1,0.02h,Break Even,$0.25,$-5.75,$132808.00,233,$-5.75
2024-11-22,12:30:00,20789.5,BUY,1,0.02h,Break Even,$0.25,$-5.50,$132808.25,233,$-5.50
2024-11-22,12:32:00,20777.5,SELL,1,0.02h,Stop Loss,$-6.00,$-11.50,$132802.25,233,$-11.50
2024-11-22,12:36:00,20795.0,BUY,1,0.02h,Break Even,$0.25,$-11.25,$132802.50,233,$-11.25
2024-11-22,12:43:00,20780.0,SELL,1,0.02h,Break Even,$0.25,$-11.00,$132802.75,233,$-11.00
2024-11-22,12:48:00,20786.25,BUY,1,0.02h,Stop Loss,$-6.00,$-17.00,$132796.75,233,$-17.00
2024-11-22,12:49:00,20782.0,SELL,1,0.02h,Break Even,$0.25,$-16.75,$132797.00,233,$-16.75
2024-11-22,12:51:00,20791.0,BUY,1,0.02h,Stop Loss,$-6.00,$-22.75,$132791.00,233,$-22.75
2024-11-22,13:16:00,20785.25,SELL,1,0.02h,Stop Loss,$-6.00,$-28.75,$132785.00,233,$-28.75
2024-11-22,13:21:00,20800.25,BUY,1,0.02h,Stop Loss,$62.75,$34.00,$132847.75,233,$34.00
2024-11-22,13:33:00,20790.5,SELL,1,0.02h,Break Even,$0.25,$34.25,$132848.00,233,$34.25
2024-11-22,14:08:00,20790.5,BUY,1,0.02h,Stop Loss,$-6.00,$28.25,$132842.00,233,$28.25
2024-11-22,14:23:00,20785.75,SELL,1,0.02h,Stop Loss,$22.75,$51.00,$132864.75,233,$51.00
2024-11-22,14:33:00,20811.25,BUY,1,0.02h,Stop Loss,$37.75,$88.75,$132902.50,233,$88.75
2024-11-22,14:54:00,20798.25,SELL,1,0.02h,Stop Loss,$-6.00,$82.75,$132896.50,233,$82.75
2024-11-22,14:57:00,20835.75,BUY,1,0.02h,Stop Loss,$19.00,$101.75,$132915.50,233,$101.75
2024-11-22,15:06:00,20805.5,SELL,1,0.02h,Stop Loss,$-6.00,$95.75,$132909.50,233,$95.75
2024-11-22,15:40:00,20815.5,BUY,1,0.02h,Stop Loss,$22.75,$118.50,$132932.25,233,$118.50
2024-11-22,16:10:00,20808.5,SELL,1,0.02h,Stop Loss,$34.00,$152.50,$132966.25,233,$152.50
2024-11-22,16:40:00,20804.0,BUY,1,0.02h,Break Even,$0.25,$152.75,$132966.50,233,$152.75
2024-11-22,16:44:00,20763.75,SELL,1,0.02h,Stop Loss,$14.00,$166.75,$132980.50,233,$166.75
2024-11-22,16:50:00,20794.25,BUY,1,0.02h,Stop Loss,$11.50,$178.25,$132992.00,233,$178.25
2024-11-22,17:36:00,20823.0,SELL,1,0.02h,Stop Loss,$22.75,$201.00,$133014.75,233,$201.00
2024-11-22,17:48:00,20827.5,BUY,1,0.02h,Stop Loss,$29.00,$230.00,$133043.75,233,$230.00
2024-11-22,18:30:00,20851.5,SELL,1,0.02h,Break Even,$0.25,$230.25,$133044.00,233,$230.25
2024-11-22,18:32:00,20868.0,BUY,1,0.02h,Stop Loss,$11.50,$241.75,$133055.50,233,$241.75
2024-11-22,18:35:00,20857.5,SELL,1,0.02h,Break Even,$0.25,$242.00,$133055.75,233,$242.00
2024-11-22,19:29:00,20830.5,BUY,1,0.02h,Stop Loss,$-6.00,$236.00,$133049.75,233,$236.00
2024-11-22,20:04:00,20819.25,SELL,1,0.02h,Stop Loss,$72.75,$308.75,$133122.50,233,$308.75
2024-11-22,20:26:00,20827.25,BUY,1,0.02h,Break Even,$0.25,$309.00,$133122.75,233,$309.00
2024-11-22,20:40:00,20823.0,SELL,1,0.02h,Stop Loss,$9.00,$318.00,$133131.75,233,$318.00
2024-11-22,20:48:00,20833.0,BUY,1,0.02h,Break Even,$0.25,$318.25,$133132.00,233,$318.25
Final P&L Day: 318.25,,,,,,,,,,,
2024-11-25,12:33:00,20946.75,SELL,1,0.02h,Stop Loss,$-6.00,$-6.00,$133126.00,234,$-6.00
2024-11-25,12:35:00,20958.0,BUY,1,0.02h,Break Even,$0.25,$-5.75,$133126.25,234,$-5.75
2024-11-25,13:02:00,20956.25,SELL,1,0.02h,Break Even,$0.25,$-5.50,$133126.50,234,$-5.50
2024-11-25,13:27:00,20955.75,BUY,1,0.02h,Break Even,$0.25,$-5.25,$133126.75,234,$-5.25
2024-11-25,13:32:00,20949.0,SELL,1,0.02h,Stop Loss,$-6.00,$-11.25,$133120.75,234,$-11.25
2024-11-25,13:35:00,20953.5,BUY,1,0.02h,Break Even,$0.25,$-11.00,$133121.00,234,$-11.00
2024-11-25,14:30:00,21016.25,SELL,1,0.02h,Stop Loss,$187.75,$176.75,$133308.75,234,$176.75
2024-11-25,14:40:00,21054.75,BUY,1,0.02h,Stop Loss,$35.25,$212.00,$133344.00,234,$212.00
2024-11-25,14:52:00,20973.25,SELL,1,0.02h,Stop Loss,$130.25,$342.25,$133474.25,234,$342.25
2024-11-25,15:31:00,20940.25,BUY,1,0.02h,Stop Loss,$-6.00,$336.25,$133468.25,234,$336.25
2024-11-25,15:34:00,20890.75,SELL,1,0.02h,Stop Loss,$42.75,$379.00,$133511.00,234,$379.00
2024-11-25,15:44:00,20936.0,BUY,1,0.02h,Stop Loss,$29.00,$408.00,$133540.00,234,$408.00
2024-11-25,15:56:00,20911.25,SELL,1,0.02h,Stop Loss,$65.25,$473.25,$133605.25,234,$473.25
2024-11-25,16:13:00,20917.5,BUY,1,0.02h,Stop Loss,$7.75,$481.00,$133613.00,234,$481.00
2024-11-25,16:37:00,20907.0,SELL,1,0.02h,Stop Loss,$35.25,$516.25,$133648.25,234,$516.25
2024-11-25,17:54:00,20845.0,BUY,1,0.02h,Stop Loss,$12.75,$529.00,$133661.00,234,$529.00
2024-11-25,18:32:00,20864.5,SELL,1,0.02h,Stop Loss,$-6.00,$523.00,$133655.00,234,$523.00
2024-11-25,18:33:00,20874.75,BUY,1,0.02h,Stop Loss,$36.50,$559.50,$133691.50,234,$559.50
2024-11-25,18:44:00,20866.25,SELL,1,0.02h,Stop Loss,$39.00,$598.50,$133730.50,234,$598.50
2024-11-25,19:11:00,20864.25,BUY,1,0.02h,Break Even,$0.25,$598.75,$133730.75,234,$598.75
2024-11-25,19:23:00,20844.25,SELL,1,0.02h,Stop Loss,$77.75,$676.50,$133808.50,234,$676.50
2024-11-25,19:44:00,20857.25,BUY,1,0.02h,Break Even,$0.25,$676.75,$133808.75,234,$676.75
2024-11-25,20:03:00,20848.75,SELL,1,0.02h,Stop Loss,$27.75,$704.50,$133836.50,234,$704.50
2024-11-25,20:26:00,20856.5,BUY,1,0.02h,Break Even,$0.25,$704.75,$133836.75,234,$704.75
2024-11-25,21:42:00,20897.5,SELL,1,0.02h,Stop Loss,$-6.00,$698.75,$133830.75,234,$698.75
2024-11-25,21:58:00,20902.5,BUY,1,0.02h,Stop Loss,$-6.00,$692.75,$133824.75,234,$692.75
Final P&L Day: 692.75,,,,,,,,,,,
2024-11-26,12:58:00,20938.25,SELL,1,0.02h,Stop Loss,$-6.00,$-6.00,$133818.75,235,$-6.00
2024-11-26,12:59:00,20947.25,BUY,1,0.02h,Break Even,$0.25,$-5.75,$133819.00,235,$-5.75
2024-11-26,13:02:00,20941.75,SELL,1,0.02h,Stop Loss,$16.50,$10.75,$133835.50,235,$10.75
2024-11-26,13:34:00,20936.5,BUY,1,0.02h,Stop Loss,$-6.00,$4.75,$133829.50,235,$4.75
2024-11-26,14:24:00,20947.0,SELL,1,0.02h,Break Even,$0.25,$5.00,$133829.75,235,$5.00
2024-11-26,14:33:00,20981.0,BUY,1,0.02h,Stop Loss,$27.75,$32.75,$133857.50,235,$32.75
2024-11-26,14:57:00,20957.0,SELL,1,0.02h,Break Even,$0.25,$33.00,$133857.75,235,$33.00
2024-11-26,15:32:00,20966.0,BUY,1,0.02h,Stop Loss,$25.25,$58.25,$133883.00,235,$58.25
2024-11-26,15:54:00,20957.5,SELL,1,0.02h,Stop Loss,$-6.00,$52.25,$133877.00,235,$52.25
2024-11-26,15:58:00,20971.0,BUY,1,0.02h,Stop Loss,$20.25,$72.50,$133897.25,235,$72.50
2024-11-26,16:00:00,20950.0,SELL,1,0.02h,Stop Loss,$-6.00,$66.50,$133891.25,235,$66.50
2024-11-26,16:03:00,20977.5,BUY,1,0.02h,Stop Loss,$15.25,$81.75,$133906.50,235,$81.75
2024-11-26,16:12:00,20957.5,SELL,1,0.02h,Stop Loss,$11.50,$93.25,$133918.00,235,$93.25
2024-11-26,16:33:00,20960.5,BUY,1,0.02h,Stop Loss,$-6.00,$87.25,$133912.00,235,$87.25
2024-11-26,16:34:00,20953.75,SELL,1,0.02h,Break Even,$0.25,$87.50,$133912.25,235,$87.50
2024-11-26,16:35:00,20959.25,BUY,1,0.02h,Stop Loss,$-6.00,$81.50,$133906.25,235,$81.50
2024-11-26,16:36:00,20956.0,SELL,1,0.02h,Stop Loss,$45.25,$126.75,$133951.50,235,$126.75
2024-11-26,16:40:00,20963.75,BUY,1,0.02h,Stop Loss,$-6.00,$120.75,$133945.50,235,$120.75
2024-11-26,16:42:00,20948.5,SELL,1,0.02h,Break Even,$0.25,$121.00,$133945.75,235,$121.00
2024-11-26,16:55:00,20961.0,BUY,1,0.02h,Stop Loss,$9.00,$130.00,$133954.75,235,$130.00
2024-11-26,17:07:00,20945.75,SELL,1,0.02h,Break Even,$0.25,$130.25,$133955.00,235,$130.25
2024-11-26,17:11:00,20958.25,BUY,1,0.02h,Stop Loss,$-6.00,$124.25,$133949.00,235,$124.25
2024-11-26,17:13:00,20943.5,SELL,1,0.02h,Stop Loss,$7.75,$132.00,$133956.75,235,$132.00
2024-11-26,17:33:00,20947.0,BUY,1,0.02h,Stop Loss,$20.25,$152.25,$133977.00,235,$152.25
2024-11-26,18:11:00,20965.5,SELL,1,0.02h,Break Even,$0.25,$152.50,$133977.25,235,$152.50
2024-11-26,18:34:00,20966.25,BUY,1,0.02h,Break Even,$0.25,$152.75,$133977.50,235,$152.75
2024-11-26,18:37:00,20954.75,SELL,1,0.02h,Stop Loss,$4.00,$156.75,$133981.50,235,$156.75
2024-11-26,18:41:00,20966.75,BUY,1,0.02h,Stop Loss,$21.50,$178.25,$134003.00,235,$178.25
2024-11-26,18:58:00,20963.0,SELL,1,0.02h,Stop Loss,$-6.00,$172.25,$133997.00,235,$172.25
2024-11-26,18:59:00,20968.25,BUY,1,0.02h,Break Even,$0.25,$172.50,$133997.25,235,$172.50
2024-11-26,19:08:00,20958.75,SELL,1,0.02h,Break Even,$0.25,$172.75,$133997.50,235,$172.75
2024-11-26,19:41:00,20933.25,BUY,1,0.02h,Stop Loss,$26.50,$199.25,$134024.00,235,$199.25
2024-11-26,19:44:00,20925.75,SELL,1,0.02h,Stop Loss,$-6.00,$193.25,$134018.00,235,$193.25
2024-11-26,19:49:00,20935.0,BUY,1,0.02h,Break Even,$0.25,$193.50,$134018.25,235,$193.50
2024-11-26,19:55:00,20925.75,SELL,1,0.02h,Break Even,$0.25,$193.75,$134018.50,235,$193.75
2024-11-26,20:02:00,20936.75,BUY,1,0.02h,Break Even,$0.25,$194.00,$134018.75,235,$194.00
2024-11-26,20:23:00,20938.5,SELL,1,0.02h,Break Even,$0.25,$194.25,$134019.00,235,$194.25
2024-11-26,20:25:00,20945.0,BUY,1,0.02h,Stop Loss,$19.00,$213.25,$134038.00,235,$213.25
2024-11-26,21:33:00,20993.5,SELL,1,0.02h,Break Even,$0.25,$213.50,$134038.25,235,$213.50
2024-11-26,21:38:00,21001.0,BUY,1,0.02h,Break Even,$0.25,$213.75,$134038.50,235,$213.75
Final P&L Day: 213.75,,,,,,,,,,,
2024-11-27,12:00:00,20930.25,SELL,1,0.02h,Stop Loss,$-6.00,$-6.00,$134032.50,236,$-6.00
2024-11-27,12:39:00,20941.5,BUY,1,0.02h,Stop Loss,$-6.00,$-12.00,$134026.50,236,$-12.00
2024-11-27,13:35:00,20947.0,SELL,1,0.02h,Stop Loss,$7.75,$-4.25,$134034.25,236,$-4.25
2024-11-27,13:44:00,20962.25,BUY,1,0.02h,Stop Loss,$-6.00,$-10.25,$134028.25,236,$-10.25
2024-11-27,13:48:00,20949.5,SELL,1,0.02h,Break Even,$0.25,$-10.00,$134028.50,236,$-10.00
2024-11-27,13:55:00,20959.25,BUY,1,0.02h,Break Even,$0.25,$-9.75,$134028.75,236,$-9.75
2024-11-27,13:59:00,20951.25,SELL,1,0.02h,Stop Loss,$-6.00,$-15.75,$134022.75,236,$-15.75
2024-11-27,14:18:00,20950.75,BUY,1,0.02h,Stop Loss,$-6.00,$-21.75,$134016.75,236,$-21.75
2024-11-27,14:25:00,20945.0,SELL,1,0.02h,Stop Loss,$-6.00,$-27.75,$134010.75,236,$-27.75
2024-11-27,14:27:00,20953.0,BUY,1,0.02h,Stop Loss,$-6.00,$-33.75,$134004.75,236,$-33.75
2024-11-27,14:28:00,20941.5,SELL,1,0.02h,Stop Loss,$27.75,$-6.00,$134032.50,236,$-6.00
2024-11-27,16:33:00,20736.75,BUY,1,0.02h,Break Even,$0.25,$-5.75,$134032.75,236,$-5.75
2024-11-27,16:47:00,20714.25,SELL,1,0.02h,Stop Loss,$10.25,$4.50,$134043.00,236,$4.50
2024-11-27,17:20:00,20717.0,BUY,1,0.02h,Stop Loss,$26.50,$31.00,$134069.50,236,$31.00
2024-11-27,19:30:00,20801.5,SELL,1,0.02h,Break Even,$0.25,$31.25,$134069.75,236,$31.25
2024-11-27,19:43:00,20810.25,BUY,1,0.02h,Stop Loss,$24.00,$55.25,$134093.75,236,$55.25
2024-11-27,20:00:00,20804.25,SELL,1,0.02h,Break Even,$0.25,$55.50,$134094.00,236,$55.50
2024-11-27,20:05:00,20823.25,BUY,1,0.02h,Stop Loss,$17.75,$73.25,$134111.75,236,$73.25
2024-11-27,20:19:00,20808.5,SELL,1,0.02h,Stop Loss,$20.25,$93.50,$134132.00,236,$93.50
2024-11-27,20:50:00,20803.5,BUY,1,0.02h,Stop Loss,$34.00,$127.50,$134166.00,236,$127.50
2024-11-27,21:17:00,20803.0,SELL,1,0.02h,Stop Loss,$-6.00,$121.50,$134160.00,236,$121.50
2024-11-27,21:23:00,20811.0,BUY,1,0.02h,Break Even,$0.25,$121.75,$134160.25,236,$121.75
2024-11-27,21:28:00,20806.5,SELL,1,0.02h,Stop Loss,$-6.00,$115.75,$134154.25,236,$115.75
2024-11-27,21:50:00,20806.25,BUY,1,0.02h,Stop Loss,$-6.00,$109.75,$134148.25,236,$109.75
Final P&L Day: 109.75,,,,,,,,,,,
2024-11-28,13:19:00,20869.75,SELL,1,0.02h,Break Even,$0.25,$0.25,$134148.50,237,$0.25
2024-11-28,13:41:00,20872.25,BUY,1,0.03h,Break Even,$0.25,$0.50,$134148.75,237,$0.50
2024-11-28,14:02:00,20871.5,SELL,1,0.02h,Stop Loss,$4.00,$4.50,$134152.75,237,$4.50
2024-11-28,14:16:00,20874.0,BUY,1,0.02h,Break Even,$0.25,$4.75,$134153.00,237,$4.75
2024-11-28,15:11:00,20885.5,SELL,1,0.02h,Stop Loss,$-6.00,$-1.25,$134147.00,237,$-1.25
2024-11-28,15:19:00,20894.75,BUY,1,0.02h,Break Even,$0.25,$-1.00,$134147.25,237,$-1.00
2024-11-28,15:38:00,20889.25,SELL,1,0.02h,Break Even,$0.25,$-0.75,$134147.50,237,$-0.75
2024-11-28,15:46:00,20898.25,BUY,1,0.02h,Break Even,$0.25,$-0.50,$134147.75,237,$-0.50
2024-11-28,16:25:00,20901.0,SELL,1,0.02h,Break Even,$0.25,$-0.25,$134148.00,237,$-0.25
2024-11-28,17:03:00,20888.25,BUY,1,0.02h,Break Even,$0.25,$0.00,$134148.25,237,$0.00
2024-11-28,17:47:00,20888.25,SELL,1,0.02h,Stop Loss,$10.25,$10.25,$134158.50,237,$10.25
Final P&L Day: 10.25,,,,,,,,,,,
2024-11-29,13:10:00,20860.0,BUY,1,0.02h,Break Even,$0.25,$0.25,$134158.75,238,$0.25
2024-11-29,13:17:00,20845.75,SELL,1,0.02h,Break Even,$0.25,$0.50,$134159.00,238,$0.50
2024-11-29,14:02:00,20842.0,BUY,1,0.02h,Stop Loss,$6.50,$7.00,$134165.50,238,$7.00
2024-11-29,14:29:00,20828.0,SELL,1,0.02h,Stop Loss,$14.00,$21.00,$134179.50,238,$21.00
2024-11-29,14:40:00,20865.25,BUY,1,0.02h,Stop Loss,$-6.00,$15.00,$134173.50,238,$15.00
2024-11-29,15:50:00,20943.5,SELL,1,0.02h,Stop Loss,$19.00,$34.00,$134192.50,238,$34.00
2024-11-29,16:02:00,20965.5,BUY,1,0.02h,Stop Loss,$16.50,$50.50,$134209.00,238,$50.50
2024-11-29,16:36:00,20976.0,SELL,1,0.02h,Stop Loss,$22.75,$73.25,$134231.75,238,$73.25
2024-11-29,16:45:00,20986.0,BUY,1,0.02h,Break Even,$0.25,$73.50,$134232.00,238,$73.50
2024-11-29,17:03:00,20983.0,SELL,1,0.02h,Stop Loss,$-6.00,$67.50,$134226.00,238,$67.50
2024-11-29,17:09:00,20996.0,BUY,1,0.02h,Stop Loss,$11.50,$79.00,$134237.50,238,$79.00
2024-11-29,17:15:00,20991.0,SELL,1,0.02h,Break Even,$0.25,$79.25,$134237.75,238,$79.25
2024-11-29,17:16:00,20996.75,BUY,1,0.02h,Break Even,$0.25,$79.50,$134238.00,238,$79.50
2024-11-29,17:28:00,20984.25,SELL,1,0.02h,Stop Loss,$5.25,$84.75,$134243.25,238,$84.75
2024-11-29,17:34:00,21000.75,BUY,1,0.02h,Stop Loss,$5.25,$90.00,$134248.50,238,$90.00
2024-11-29,17:47:00,20993.25,SELL,1,0.02h,Stop Loss,$7.75,$97.75,$134256.25,238,$97.75
2024-11-29,17:51:00,21015.25,BUY,1,0.02h,Break Even,$0.25,$98.00,$134256.50,238,$98.00
2024-11-29,18:00:00,20991.25,SELL,1,0.02h,Stop Loss,$7.75,$105.75,$134264.25,238,$105.75
Final P&L Day: 105.75,,,,,,,,,,,
2024-12-02,12:11:00,20995.25,BUY,1,0.02h,Break Even,$0.25,$0.25,$134264.50,239,$0.25
2024-12-02,13:41:00,21021.0,SELL,1,0.02h,Stop Loss,$36.50,$36.75,$134301.00,239,$36.75
2024-12-02,13:59:00,21024.75,BUY,1,0.02h,Break Even,$0.25,$37.00,$134301.25,239,$37.00
2024-12-02,14:27:00,21027.75,SELL,1,0.02h,Stop Loss,$-6.00,$31.00,$134295.25,239,$31.00
2024-12-02,14:30:00,21043.0,BUY,1,0.02h,Stop Loss,$85.25,$116.25,$134380.50,239,$116.25
2024-12-02,15:49:00,21181.0,SELL,1,0.02h,Stop Loss,$11.50,$127.75,$134392.00,239,$127.75
2024-12-02,16:08:00,21181.5,BUY,1,0.02h,Break Even,$0.25,$128.00,$134392.25,239,$128.00
2024-12-02,16:26:00,21177.25,SELL,1,0.02h,Stop Loss,$-6.00,$122.00,$134386.25,239,$122.00
2024-12-02,16:27:00,21183.75,BUY,1,0.02h,Break Even,$0.25,$122.25,$134386.50,239,$122.25
2024-12-02,17:30:00,21233.5,SELL,1,0.02h,Stop Loss,$24.00,$146.25,$134410.50,239,$146.25
2024-12-02,17:47:00,21244.5,BUY,1,0.02h,Stop Loss,$-6.00,$140.25,$134404.50,239,$140.25
2024-12-02,17:55:00,21235.5,SELL,1,0.02h,Break Even,$0.25,$140.50,$134404.75,239,$140.50
2024-12-02,18:25:00,21232.75,BUY,1,0.02h,Stop Loss,$-6.00,$134.50,$134398.75,239,$134.50
2024-12-02,18:30:00,21212.25,SELL,1,0.02h,Stop Loss,$62.75,$197.25,$134461.50,239,$197.25
2024-12-02,18:43:00,21221.5,BUY,1,0.02h,Break Even,$0.25,$197.50,$134461.75,239,$197.50
2024-12-02,18:54:00,21211.25,SELL,1,0.02h,Break Even,$0.25,$197.75,$134462.00,239,$197.75
2024-12-02,19:33:00,21198.75,BUY,1,0.02h,Stop Loss,$-6.00,$191.75,$134456.00,239,$191.75
2024-12-02,20:45:00,21224.0,SELL,1,0.02h,Break Even,$0.25,$192.00,$134456.25,239,$192.00
2024-12-02,21:07:00,21225.5,BUY,1,0.02h,Break Even,$0.25,$192.25,$134456.50,239,$192.25
2024-12-02,21:30:00,21225.0,SELL,1,0.02h,Break Even,$0.25,$192.50,$134456.75,239,$192.50
2024-12-02,21:40:00,21229.0,BUY,1,0.02h,Stop Loss,$-6.00,$186.50,$134450.75,239,$186.50
2024-12-02,21:43:00,21218.0,SELL,1,0.02h,Stop Loss,$17.75,$204.25,$134468.50,239,$204.25
Final P&L Day: 204.25,,,,,,,,,,,
2024-12-03,12:26:00,21208.75,BUY,1,0.02h,Break Even,$0.25,$0.25,$134468.75,240,$0.25
2024-12-03,12:49:00,21208.5,SELL,1,0.02h,Break Even,$0.25,$0.50,$134469.00,240,$0.50
2024-12-03,13:09:00,21213.25,BUY,1,0.02h,Stop Loss,$-6.00,$-5.50,$134463.00,240,$-5.50
2024-12-03,13:10:00,21207.75,SELL,1,0.02h,Stop Loss,$-6.00,$-11.50,$134457.00,240,$-11.50
2024-12-03,13:11:00,21211.0,BUY,1,0.02h,Break Even,$0.25,$-11.25,$134457.25,240,$-11.25
2024-12-03,13:19:00,21204.75,SELL,1,0.02h,Stop Loss,$-6.00,$-17.25,$134451.25,240,$-17.25
2024-12-03,13:26:00,21213.0,BUY,1,0.02h,Stop Loss,$-6.00,$-23.25,$134445.25,240,$-23.25
2024-12-03,13:28:00,21208.5,SELL,1,0.02h,Stop Loss,$-6.00,$-29.25,$134439.25,240,$-29.25
2024-12-03,13:29:00,21209.75,BUY,1,0.02h,Break Even,$0.25,$-29.00,$134439.50,240,$-29.00
2024-12-03,13:30:00,21207.0,SELL,1,0.02h,Break Even,$0.25,$-28.75,$134439.75,240,$-28.75
2024-12-03,13:36:00,21211.25,BUY,1,0.02h,Stop Loss,$-6.00,$-34.75,$134433.75,240,$-34.75
2024-12-03,13:57:00,21209.0,SELL,1,0.02h,Stop Loss,$17.75,$-17.00,$134451.50,240,$-17.00
2024-12-03,14:36:00,21186.0,BUY,1,0.02h,Stop Loss,$31.50,$14.50,$134483.00,240,$14.50
2024-12-03,15:21:00,21188.5,SELL,1,0.02h,Stop Loss,$24.00,$38.50,$134507.00,240,$38.50
2024-12-03,15:37:00,21207.0,BUY,1,0.02h,Stop Loss,$-6.00,$32.50,$134501.00,240,$32.50
2024-12-03,15:43:00,21192.75,SELL,1,0.02h,Stop Loss,$25.25,$57.75,$134526.25,240,$57.75
2024-12-03,16:00:00,21207.5,BUY,1,0.02h,Stop Loss,$10.25,$68.00,$134536.50,240,$68.00
2024-12-03,16:38:00,21216.5,SELL,1,0.02h,Stop Loss,$4.00,$72.00,$134540.50,240,$72.00
2024-12-03,16:55:00,21223.75,BUY,1,0.02h,Break Even,$0.25,$72.25,$134540.75,240,$72.25
2024-12-03,16:58:00,21217.0,SELL,1,0.02h,Stop Loss,$16.50,$88.75,$134557.25,240,$88.75
2024-12-03,17:23:00,21215.0,BUY,1,0.02h,Stop Loss,$-6.00,$82.75,$134551.25,240,$82.75
2024-12-03,17:25:00,21206.25,SELL,1,0.02h,Break Even,$0.25,$83.00,$134551.50,240,$83.00
2024-12-03,17:45:00,21208.75,BUY,1,0.02h,Stop Loss,$10.25,$93.25,$134561.75,240,$93.25
2024-12-03,18:30:00,21227.5,SELL,1,0.02h,Stop Loss,$5.25,$98.50,$134567.00,240,$98.50
2024-12-03,18:54:00,21235.25,BUY,1,0.02h,Break Even,$0.25,$98.75,$134567.25,240,$98.75
2024-12-03,19:05:00,21226.75,SELL,1,0.02h,Break Even,$0.25,$99.00,$134567.50,240,$99.00
2024-12-03,19:10:00,21233.75,BUY,1,0.02h,Stop Loss,$-6.00,$93.00,$134561.50,240,$93.00
2024-12-03,19:17:00,21226.25,SELL,1,0.02h,Break Even,$0.25,$93.25,$134561.75,240,$93.25
2024-12-03,19:19:00,21232.75,BUY,1,0.02h,Break Even,$0.25,$93.50,$134562.00,240,$93.50
2024-12-03,20:19:00,21250.75,SELL,1,0.02h,Stop Loss,$-6.00,$87.50,$134556.00,240,$87.50
2024-12-03,20:21:00,21257.0,BUY,1,0.02h,Break Even,$0.25,$87.75,$134556.25,240,$87.75
2024-12-03,20:33:00,21251.0,SELL,1,0.02h,Stop Loss,$-6.00,$81.75,$134550.25,240,$81.75
2024-12-03,20:50:00,21256.0,BUY,1,0.02h,Stop Loss,$36.50,$118.25,$134586.75,240,$118.25
Final P&L Day: 118.25,,,,,,,,,,,
2024-12-04,12:56:00,21414.75,SELL,1,0.02h,Break Even,$0.25,$0.25,$134587.00,241,$0.25
2024-12-04,13:09:00,21420.75,BUY,1,0.02h,Break Even,$0.25,$0.50,$134587.25,241,$0.50
2024-12-04,14:21:00,21437.75,SELL,1,0.02h,Stop Loss,$12.75,$13.25,$134600.00,241,$13.25
2024-12-04,14:51:00,21430.5,BUY,1,0.02h,Stop Loss,$-6.00,$7.25,$134594.00,241,$7.25
2024-12-04,15:01:00,21397.75,SELL,1,0.02h,Break Even,$0.25,$7.50,$134594.25,241,$7.50
2024-12-04,15:06:00,21434.0,BUY,1,0.02h,Break Even,$0.25,$7.75,$134594.50,241,$7.75
2024-12-04,16:17:00,21474.5,SELL,1,0.02h,Break Even,$0.25,$8.00,$134594.75,241,$8.00
2024-12-04,16:53:00,21464.25,BUY,1,0.02h,Break Even,$0.25,$8.25,$134595.00,241,$8.25
2024-12-04,17:33:00,21470.25,SELL,1,0.02h,Stop Loss,$7.75,$16.00,$134602.75,241,$16.00
2024-12-04,17:51:00,21480.5,BUY,1,0.02h,Break Even,$0.25,$16.25,$134603.00,241,$16.25
2024-12-04,18:18:00,21479.0,SELL,1,0.02h,Break Even,$0.25,$16.50,$134603.25,241,$16.50
2024-12-04,18:49:00,21468.5,BUY,1,0.02h,Break Even,$0.25,$16.75,$134603.50,241,$16.75
2024-12-04,21:03:00,21525.25,SELL,1,0.02h,Stop Loss,$12.75,$29.50,$134616.25,241,$29.50
2024-12-04,21:43:00,21519.5,BUY,1,0.02h,Break Even,$0.25,$29.75,$134616.50,241,$29.75
2024-12-04,21:45:00,21516.0,SELL,1,0.02h,Stop Loss,$19.00,$48.75,$134635.50,241,$48.75
2024-12-04,21:59:00,21516.5,BUY,1,0.02h,Break Even,$0.25,$49.00,$134635.75,241,$49.00
Final P&L Day: 49.00,,,,,,,,,,,
2024-12-05,12:29:00,21521.25,SELL,1,0.02h,Stop Loss,$-6.00,$-6.00,$134629.75,242,$-6.00
2024-12-05,12:36:00,21526.5,BUY,1,0.02h,Stop Loss,$-6.00,$-12.00,$134623.75,242,$-12.00
2024-12-05,13:07:00,21526.75,SELL,1,0.02h,Break Even,$0.25,$-11.75,$134624.00,242,$-11.75
2024-12-05,13:31:00,21530.5,BUY,1,0.02h,Break Even,$0.25,$-11.50,$134624.25,242,$-11.50
2024-12-05,13:44:00,21523.5,SELL,1,0.02h,Stop Loss,$14.00,$2.50,$134638.25,242,$2.50
2024-12-05,13:58:00,21529.25,BUY,1,0.02h,Stop Loss,$-6.00,$-3.50,$134632.25,242,$-3.50
2024-12-05,14:42:00,21520.75,SELL,1,0.02h,Stop Loss,$-6.00,$-9.50,$134626.25,242,$-9.50
2024-12-05,14:46:00,21537.25,BUY,1,0.02h,Stop Loss,$14.00,$4.50,$134640.25,242,$4.50
2024-12-05,14:50:00,21517.5,SELL,1,0.02h,Stop Loss,$31.50,$36.00,$134671.75,242,$36.00
2024-12-05,15:10:00,21530.75,BUY,1,0.02h,Break Even,$0.25,$36.25,$134672.00,242,$36.25
2024-12-05,15:23:00,21512.75,SELL,1,0.02h,Break Even,$0.25,$36.50,$134672.25,242,$36.50
2024-12-05,15:34:00,21523.25,BUY,1,0.02h,Stop Loss,$-6.00,$30.50,$134666.25,242,$30.50
2024-12-05,15:42:00,21513.25,SELL,1,0.02h,Break Even,$0.25,$30.75,$134666.50,242,$30.75
2024-12-05,15:45:00,21527.75,BUY,1,0.02h,Break Even,$0.25,$31.00,$134666.75,242,$31.00
2024-12-05,15:49:00,21508.25,SELL,1,0.02h,Stop Loss,$30.25,$61.25,$134697.00,242,$61.25
2024-12-05,16:13:00,21513.75,BUY,1,0.02h,Stop Loss,$-6.00,$55.25,$134691.00,242,$55.25
2024-12-05,16:40:00,21518.5,SELL,1,0.02h,Break Even,$0.25,$55.50,$134691.25,242,$55.50
2024-12-05,16:52:00,21525.75,BUY,1,0.02h,Stop Loss,$-6.00,$49.50,$134685.25,242,$49.50
2024-12-05,16:54:00,21521.75,SELL,1,0.02h,Break Even,$0.25,$49.75,$134685.50,242,$49.75
2024-12-05,17:00:00,21530.0,BUY,1,0.02h,Break Even,$0.25,$50.00,$134685.75,242,$50.00
2024-12-05,18:03:00,21549.0,SELL,1,0.02h,Stop Loss,$5.25,$55.25,$134691.00,242,$55.25
2024-12-05,18:42:00,21523.25,BUY,1,0.02h,Stop Loss,$-6.00,$49.25,$134685.00,242,$49.25
2024-12-05,18:50:00,21510.5,SELL,1,0.02h,Stop Loss,$25.25,$74.50,$134710.25,242,$74.50
2024-12-05,19:14:00,21503.0,BUY,1,0.02h,Stop Loss,$6.50,$81.00,$134716.75,242,$81.00
2024-12-05,19:31:00,21495.5,SELL,1,0.02h,Stop Loss,$-6.00,$75.00,$134710.75,242,$75.00
2024-12-05,20:05:00,21497.0,BUY,1,0.02h,Stop Loss,$32.75,$107.75,$134743.50,242,$107.75
2024-12-05,20:16:00,21491.0,SELL,1,0.02h,Stop Loss,$10.25,$118.00,$134753.75,242,$118.00
2024-12-05,20:42:00,21486.25,BUY,1,0.02h,Break Even,$0.25,$118.25,$134754.00,242,$118.25
2024-12-05,20:55:00,21469.75,SELL,1,0.02h,Stop Loss,$19.00,$137.25,$134773.00,242,$137.25
2024-12-05,21:32:00,21456.25,BUY,1,0.02h,Break Even,$0.25,$137.50,$134773.25,242,$137.50
2024-12-05,21:57:00,21455.25,SELL,1,0.03h,Break Even,$0.25,$137.75,$134773.50,242,$137.75
Final P&L Day: 137.75,,,,,,,,,,,
2024-12-06,12:01:00,21459.0,BUY,1,0.02h,Stop Loss,$-6.00,$-6.00,$134767.50,243,$-6.00
2024-12-06,12:41:00,21471.75,SELL,1,0.02h,Stop Loss,$-6.00,$-12.00,$134761.50,243,$-12.00
2024-12-06,12:47:00,21477.75,BUY,1,0.02h,Break Even,$0.25,$-11.75,$134761.75,243,$-11.75
2024-12-06,12:51:00,21472.5,SELL,1,0.02h,Stop Loss,$-6.00,$-17.75,$134755.75,243,$-17.75
2024-12-06,12:54:00,21477.25,BUY,1,0.02h,Break Even,$0.25,$-17.50,$134756.00,243,$-17.50
2024-12-06,13:15:00,21478.0,SELL,1,0.02h,Stop Loss,$-6.00,$-23.50,$134750.00,243,$-23.50
2024-12-06,13:16:00,21479.0,BUY,1,0.02h,Break Even,$0.25,$-23.25,$134750.25,243,$-23.25
2024-12-06,13:18:00,21478.0,SELL,1,0.02h,Stop Loss,$-6.00,$-29.25,$134744.25,243,$-29.25
2024-12-06,13:31:00,21508.0,BUY,1,0.02h,Stop Loss,$24.00,$-5.25,$134768.25,243,$-5.25
2024-12-06,13:51:00,21490.75,SELL,1,0.02h,Break Even,$0.25,$-5.00,$134768.50,243,$-5.00
2024-12-06,14:03:00,21505.5,BUY,1,0.02h,Break Even,$0.25,$-4.75,$134768.75,243,$-4.75
2024-12-06,14:07:00,21496.25,SELL,1,0.02h,Stop Loss,$-6.00,$-10.75,$134762.75,243,$-10.75
2024-12-06,14:09:00,21504.0,BUY,1,0.02h,Stop Loss,$5.25,$-5.50,$134768.00,243,$-5.50
2024-12-06,14:30:00,21491.75,SELL,1,0.02h,Stop Loss,$17.75,$12.25,$134785.75,243,$12.25
2024-12-06,14:32:00,21513.25,BUY,1,0.02h,Stop Loss,$27.75,$40.00,$134813.50,243,$40.00
2024-12-06,15:45:00,21619.75,SELL,1,0.02h,Stop Loss,$12.75,$52.75,$134826.25,243,$52.75
2024-12-06,16:03:00,21625.75,BUY,1,0.02h,Stop Loss,$-6.00,$46.75,$134820.25,243,$46.75
2024-12-06,16:11:00,21612.0,SELL,1,0.02h,Stop Loss,$31.50,$78.25,$134851.75,243,$78.25
2024-12-06,16:30:00,21620.25,BUY,1,0.02h,Stop Loss,$6.50,$84.75,$134858.25,243,$84.75
2024-12-06,16:48:00,21605.25,SELL,1,0.02h,Stop Loss,$-6.00,$78.75,$134852.25,243,$78.75
2024-12-06,17:10:00,21624.25,BUY,1,0.02h,Break Even,$0.25,$79.00,$134852.50,243,$79.00
2024-12-06,17:38:00,21622.5,SELL,1,0.02h,Break Even,$0.25,$79.25,$134852.75,243,$79.25
2024-12-06,17:55:00,21630.25,BUY,1,0.02h,Stop Loss,$-6.00,$73.25,$134846.75,243,$73.25
2024-12-06,18:34:00,21647.0,SELL,1,0.02h,Break Even,$0.25,$73.50,$134847.00,243,$73.50
2024-12-06,18:53:00,21653.5,BUY,1,0.02h,Break Even,$0.25,$73.75,$134847.25,243,$73.75
2024-12-06,19:04:00,21642.0,SELL,1,0.02h,Stop Loss,$-6.00,$67.75,$134841.25,243,$67.75
2024-12-06,19:41:00,21629.0,BUY,1,0.02h,Stop Loss,$-6.00,$61.75,$134835.25,243,$61.75
2024-12-06,19:43:00,21626.25,SELL,1,0.02h,Stop Loss,$-6.00,$55.75,$134829.25,243,$55.75
2024-12-06,19:44:00,21632.5,BUY,1,0.02h,Break Even,$0.25,$56.00,$134829.50,243,$56.00
2024-12-06,20:02:00,21631.5,SELL,1,0.02h,Break Even,$0.25,$56.25,$134829.75,243,$56.25
2024-12-06,20:08:00,21640.25,BUY,1,0.02h,Stop Loss,$-6.00,$50.25,$134823.75,243,$50.25
2024-12-06,20:50:00,21643.25,SELL,1,0.02h,Stop Loss,$16.50,$66.75,$134840.25,243,$66.75
2024-12-06,20:51:00,21653.25,BUY,1,0.02h,Stop Loss,$4.00,$70.75,$134844.25,243,$70.75
2024-12-06,21:03:00,21645.5,SELL,1,0.02h,Break Even,$0.25,$71.00,$134844.50,243,$71.00
2024-12-06,21:55:00,21635.5,BUY,1,0.02h,Stop Loss,$-6.00,$65.00,$134838.50,243,$65.00
2024-12-06,21:56:00,21633.0,SELL,1,0.02h,Stop Loss,$-6.00,$59.00,$134832.50,243,$59.00
2024-12-06,22:58:00,21634.0,BUY,1,61.03h,Stop Loss,$-6.00,$53.00,$134826.50,243,$53.00
Final P&L Day: 53.00,,,,,,,,,,,
2024-12-09,12:00:00,21615.75,SELL,1,0.02h,Stop Loss,$-6.00,$-6.00,$134820.50,244,$-6.00
2024-12-09,12:29:00,21622.25,BUY,1,0.02h,Stop Loss,$-6.00,$-12.00,$134814.50,244,$-12.00
2024-12-09,12:41:00,21617.75,SELL,1,0.02h,Break Even,$0.25,$-11.75,$134814.75,244,$-11.75
2024-12-09,12:57:00,21622.0,BUY,1,0.02h,Stop Loss,$5.25,$-6.50,$134820.00,244,$-6.50
2024-12-09,13:11:00,21614.5,SELL,1,0.02h,Break Even,$0.25,$-6.25,$134820.25,244,$-6.25
2024-12-09,13:23:00,21620.75,BUY,1,0.02h,Stop Loss,$-6.00,$-12.25,$134814.25,244,$-12.25
2024-12-09,13:34:00,21616.0,SELL,1,0.02h,Stop Loss,$-6.00,$-18.25,$134808.25,244,$-18.25
2024-12-09,13:40:00,21623.0,BUY,1,0.02h,Break Even,$0.25,$-18.00,$134808.50,244,$-18.00
2024-12-09,14:01:00,21617.0,SELL,1,0.02h,Stop Loss,$-6.00,$-24.00,$134802.50,244,$-24.00
2024-12-09,14:19:00,21621.25,BUY,1,0.02h,Stop Loss,$10.25,$-13.75,$134812.75,244,$-13.75
2024-12-09,14:31:00,21592.0,SELL,1,0.02h,Break Even,$0.25,$-13.50,$134813.00,244,$-13.50
2024-12-09,14:44:00,21620.25,BUY,1,0.02h,Stop Loss,$27.75,$14.25,$134840.75,244,$14.25
2024-12-09,15:00:00,21623.5,SELL,1,0.02h,Break Even,$0.25,$14.50,$134841.00,244,$14.50
2024-12-09,15:01:00,21628.5,BUY,1,0.02h,Break Even,$0.25,$14.75,$134841.25,244,$14.75
2024-12-09,15:03:00,21618.0,SELL,1,0.02h,Break Even,$0.25,$15.00,$134841.50,244,$15.00
2024-12-09,16:23:00,21498.0,BUY,1,0.02h,Stop Loss,$14.00,$29.00,$134855.50,244,$29.00
2024-12-09,16:43:00,21491.5,SELL,1,0.02h,Stop Loss,$19.00,$48.00,$134874.50,244,$48.00
2024-12-09,16:53:00,21509.75,BUY,1,0.02h,Break Even,$0.25,$48.25,$134874.75,244,$48.25
2024-12-09,17:07:00,21498.25,SELL,1,0.02h,Break Even,$0.25,$48.50,$134875.00,244,$48.50
2024-12-09,17:09:00,21510.25,BUY,1,0.02h,Stop Loss,$21.50,$70.00,$134896.50,244,$70.00
2024-12-09,17:17:00,21493.75,SELL,1,0.02h,Stop Loss,$4.00,$74.00,$134900.50,244,$74.00
2024-12-09,17:40:00,21502.75,BUY,1,0.02h,Stop Loss,$40.25,$114.25,$134940.75,244,$114.25
2024-12-09,17:58:00,21492.0,SELL,1,0.02h,Break Even,$0.25,$114.50,$134941.00,244,$114.50
2024-12-09,18:18:00,21495.25,BUY,1,0.02h,Stop Loss,$16.50,$131.00,$134957.50,244,$131.00
2024-12-09,19:00:00,21529.75,SELL,1,0.02h,Stop Loss,$26.50,$157.50,$134984.00,244,$157.50
2024-12-09,20:00:00,21476.75,BUY,1,0.02h,Break Even,$0.25,$157.75,$134984.25,244,$157.75
2024-12-09,20:02:00,21462.5,SELL,1,0.02h,Break Even,$0.25,$158.00,$134984.50,244,$158.00
2024-12-09,20:34:00,21459.75,BUY,1,0.02h,Stop Loss,$-6.00,$152.00,$134978.50,244,$152.00
2024-12-09,20:35:00,21450.5,SELL,1,0.02h,Stop Loss,$-6.00,$146.00,$134972.50,244,$146.00
2024-12-09,20:36:00,21454.0,BUY,1,0.02h,Break Even,$0.25,$146.25,$134972.75,244,$146.25
2024-12-09,20:46:00,21449.0,SELL,1,0.02h,Stop Loss,$-6.00,$140.25,$134966.75,244,$140.25
2024-12-09,20:51:00,21471.0,BUY,1,0.02h,Stop Loss,$-6.00,$134.25,$134960.75,244,$134.25
2024-12-09,21:48:00,21473.25,SELL,1,0.02h,Break Even,$0.25,$134.50,$134961.00,244,$134.50
2024-12-09,21:55:00,21477.0,BUY,1,0.02h,Stop Loss,$19.00,$153.50,$134980.00,244,$153.50
Final P&L Day: 153.50,,,,,,,,,,,
2024-12-10,12:57:00,21523.25,SELL,1,0.02h,Break Even,$0.25,$0.25,$134980.25,245,$0.25
2024-12-10,13:00:00,21529.0,BUY,1,0.02h,Stop Loss,$-6.00,$-5.75,$134974.25,245,$-5.75
2024-12-10,13:21:00,21523.5,SELL,1,0.02h,Stop Loss,$-6.00,$-11.75,$134968.25,245,$-11.75
2024-12-10,14:08:00,21512.75,BUY,1,0.02h,Break Even,$0.25,$-11.50,$134968.50,245,$-11.50
2024-12-10,14:34:00,21517.0,SELL,1,0.02h,Break Even,$0.25,$-11.25,$134968.75,245,$-11.25
2024-12-10,14:35:00,21526.25,BUY,1,0.02h,Break Even,$0.25,$-11.00,$134969.00,245,$-11.00
2024-12-10,14:56:00,21524.0,SELL,1,0.02h,Stop Loss,$27.75,$16.75,$134996.75,245,$16.75
2024-12-10,15:03:00,21569.25,BUY,1,0.02h,Break Even,$0.25,$17.00,$134997.00,245,$17.00
2024-12-10,15:28:00,21575.0,SELL,1,0.02h,Stop Loss,$15.25,$32.25,$135012.25,245,$32.25
2024-12-10,16:57:00,21481.5,BUY,1,0.02h,Stop Loss,$-6.00,$26.25,$135006.25,245,$26.25
2024-12-10,17:14:00,21463.0,SELL,1,0.02h,Stop Loss,$35.25,$61.50,$135041.50,245,$61.50
2024-12-10,17:24:00,21485.0,BUY,1,0.02h,Stop Loss,$9.00,$70.50,$135050.50,245,$70.50
2024-12-10,17:52:00,21478.0,SELL,1,0.02h,Stop Loss,$15.25,$85.75,$135065.75,245,$85.75
2024-12-10,18:22:00,21474.0,BUY,1,0.02h,Stop Loss,$-6.00,$79.75,$135059.75,245,$79.75
2024-12-10,18:45:00,21467.0,SELL,1,0.02h,Break Even,$0.25,$80.00,$135060.00,245,$80.00
2024-12-10,19:24:00,21452.75,BUY,1,0.02h,Stop Loss,$4.00,$84.00,$135064.00,245,$84.00
2024-12-10,19:33:00,21445.75,SELL,1,0.02h,Stop Loss,$6.50,$90.50,$135070.50,245,$90.50
2024-12-10,20:42:00,21397.25,BUY,1,0.02h,Stop Loss,$-6.00,$84.50,$135064.50,245,$84.50
Final P&L Day: 84.50,,,,,,,,,,,
2024-12-11,12:36:00,21432.5,SELL,1,0.02h,Stop Loss,$-6.00,$-6.00,$135058.50,246,$-6.00
2024-12-11,12:48:00,21443.5,BUY,1,0.02h,Stop Loss,$-6.00,$-12.00,$135052.50,246,$-12.00
2024-12-11,12:59:00,21438.75,SELL,1,0.02h,Stop Loss,$-6.00,$-18.00,$135046.50,246,$-18.00
2024-12-11,13:04:00,21445.0,BUY,1,0.02h,Break Even,$0.25,$-17.75,$135046.75,246,$-17.75
2024-12-11,15:30:00,21691.75,SELL,1,0.02h,Break Even,$0.25,$-17.50,$135047.00,246,$-17.50
2024-12-11,15:34:00,21716.25,BUY,1,0.02h,Stop Loss,$40.25,$22.75,$135087.25,246,$22.75
2024-12-11,15:50:00,21706.25,SELL,1,0.02h,Stop Loss,$-6.00,$16.75,$135081.25,246,$16.75
2024-12-11,16:06:00,21717.0,BUY,1,0.02h,Stop Loss,$35.25,$52.00,$135116.50,246,$52.00
2024-12-11,16:53:00,21744.0,SELL,1,0.02h,Break Even,$0.25,$52.25,$135116.75,246,$52.25
2024-12-11,17:00:00,21760.0,BUY,1,0.02h,Stop Loss,$27.75,$80.00,$135144.50,246,$80.00
2024-12-11,17:32:00,21764.5,SELL,1,0.02h,Stop Loss,$-6.00,$74.00,$135138.50,246,$74.00
2024-12-11,17:41:00,21784.0,BUY,1,0.02h,Stop Loss,$10.25,$84.25,$135148.75,246,$84.25
2024-12-11,17:53:00,21772.0,SELL,1,0.02h,Break Even,$0.25,$84.50,$135149.00,246,$84.50
2024-12-11,18:03:00,21790.25,BUY,1,0.02h,Stop Loss,$7.75,$92.25,$135156.75,246,$92.25
2024-12-11,18:55:00,21794.25,SELL,1,0.02h,Stop Loss,$7.75,$100.00,$135164.50,246,$100.00
2024-12-11,19:21:00,21795.25,BUY,1,0.02h,Break Even,$0.25,$100.25,$135164.75,246,$100.25
2024-12-11,19:48:00,21795.5,SELL,1,0.02h,Break Even,$0.25,$100.50,$135165.00,246,$100.50
2024-12-11,20:03:00,21805.0,BUY,1,0.02h,Break Even,$0.25,$100.75,$135165.25,246,$100.75
2024-12-11,20:36:00,21807.5,SELL,1,0.02h,Break Even,$0.25,$101.00,$135165.50,246,$101.00
Final P&L Day: 101.00,,,,,,,,,,,
2024-12-12,12:00:00,21996.5,BUY,1,0.02h,Break Even,$0.25,$0.25,$135165.75,247,$0.25
2024-12-12,12:05:00,21719.0,SELL,1,0.02h,Stop Loss,$-6.00,$-5.75,$135159.75,247,$-5.75
2024-12-12,12:11:00,21998.25,BUY,1,0.02h,Stop Loss,$-6.00,$-11.75,$135153.75,247,$-11.75
2024-12-12,12:16:00,21721.5,SELL,1,0.02h,Stop Loss,$-6.00,$-17.75,$135147.75,247,$-17.75
2024-12-12,12:17:00,21994.0,BUY,1,0.02h,Stop Loss,$-6.00,$-23.75,$135141.75,247,$-23.75
2024-12-12,12:29:00,21723.5,SELL,1,0.02h,Stop Loss,$-6.00,$-29.75,$135135.75,247,$-29.75
2024-12-12,12:30:00,21994.0,BUY,1,0.02h,Stop Loss,$-6.00,$-35.75,$135129.75,247,$-35.75
2024-12-12,12:38:00,21707.5,SELL,1,0.02h,Stop Loss,$-6.00,$-41.75,$135123.75,247,$-41.75
2024-12-12,12:51:00,21976.0,BUY,1,0.02h,Stop Loss,$-6.00,$-47.75,$135117.75,247,$-47.75
2024-12-12,12:55:00,21697.0,SELL,1,0.02h,Break Even,$0.25,$-47.50,$135118.00,247,$-47.50
2024-12-12,12:59:00,21969.0,BUY,1,0.03h,Stop Loss,$-6.00,$-53.50,$135112.00,247,$-53.50
2024-12-12,13:12:00,21705.0,SELL,1,0.02h,Stop Loss,$-6.00,$-59.50,$135106.00,247,$-59.50
2024-12-12,13:25:00,21986.5,BUY,1,0.02h,Break Even,$0.25,$-59.25,$135106.25,247,$-59.25
2024-12-12,13:30:00,21710.75,SELL,1,0.02h,Stop Loss,$-6.00,$-65.25,$135100.25,247,$-65.25
2024-12-12,13:31:00,21972.25,BUY,1,0.02h,Stop Loss,$-6.00,$-71.25,$135094.25,247,$-71.25
2024-12-12,13:33:00,21688.5,SELL,1,0.02h,Stop Loss,$-6.00,$-77.25,$135088.25,247,$-77.25
2024-12-12,13:34:00,21951.25,BUY,1,0.02h,Stop Loss,$5.25,$-72.00,$135093.50,247,$-72.00
2024-12-12,13:36:00,21668.5,SELL,1,0.02h,Stop Loss,$86.50,$14.50,$135180.00,247,$14.50
2024-12-12,13:44:00,21952.75,BUY,1,0.02h,Stop Loss,$27.75,$42.25,$135207.75,247,$42.25
2024-12-12,13:54:00,21681.25,SELL,1,0.02h,Break Even,$0.25,$42.50,$135208.00,247,$42.50
2024-12-12,14:08:00,21959.75,BUY,1,0.02h,Stop Loss,$-6.00,$36.50,$135202.00,247,$36.50
2024-12-12,14:09:00,21695.75,SELL,1,0.02h,Break Even,$0.25,$36.75,$135202.25,247,$36.75
2024-12-12,14:12:00,21953.0,BUY,1,0.02h,Stop Loss,$-6.00,$30.75,$135196.25,247,$30.75
2024-12-12,14:13:00,21676.75,SELL,1,0.02h,Stop Loss,$-6.00,$24.75,$135190.25,247,$24.75
2024-12-12,14:14:00,21949.75,BUY,1,0.02h,Stop Loss,$-6.00,$18.75,$135184.25,247,$18.75
2024-12-12,14:29:00,21695.0,SELL,1,0.02h,Break Even,$0.25,$19.00,$135184.50,247,$19.00
2024-12-12,14:32:00,21940.75,BUY,1,0.02h,Stop Loss,$24.00,$43.00,$135208.50,247,$43.00
2024-12-12,14:38:00,21665.75,SELL,1,0.02h,Break Even,$0.25,$43.25,$135208.75,247,$43.25
2024-12-12,14:49:00,21946.75,BUY,1,0.02h,Stop Loss,$-6.00,$37.25,$135202.75,247,$37.25
2024-12-12,15:07:00,21674.0,SELL,1,0.02h,Break Even,$0.25,$37.50,$135203.00,247,$37.50
2024-12-12,15:26:00,21972.75,BUY,1,0.02h,Stop Loss,$61.50,$99.00,$135264.50,247,$99.00
2024-12-12,15:37:00,21709.25,SELL,1,0.02h,Stop Loss,$-6.00,$93.00,$135258.50,247,$93.00
2024-12-12,15:38:00,21991.0,BUY,1,0.02h,Stop Loss,$-6.00,$87.00,$135252.50,247,$87.00
2024-12-12,15:46:00,21699.75,SELL,1,0.02h,Break Even,$0.25,$87.25,$135252.75,247,$87.25
2024-12-12,15:53:00,21982.0,BUY,1,0.02h,Stop Loss,$14.00,$101.25,$135266.75,247,$101.25
2024-12-12,15:57:00,21725.25,SELL,1,0.02h,Stop Loss,$-6.00,$95.25,$135260.75,247,$95.25
2024-12-12,15:58:00,21984.25,BUY,1,0.02h,Stop Loss,$-6.00,$89.25,$135254.75,247,$89.25
2024-12-12,15:59:00,21712.0,SELL,1,0.02h,Stop Loss,$-6.00,$83.25,$135248.75,247,$83.25
2024-12-12,16:00:00,21990.5,BUY,1,0.02h,Stop Loss,$15.25,$98.50,$135264.00,247,$98.50
2024-12-12,16:07:00,21734.75,SELL,1,0.02h,Stop Loss,$-6.00,$92.50,$135258.00,247,$92.50
2024-12-12,16:08:00,22002.0,BUY,1,0.02h,Stop Loss,$-6.00,$86.50,$135252.00,247,$86.50
2024-12-12,16:09:00,21731.5,SELL,1,0.02h,Stop Loss,$10.25,$96.75,$135262.25,247,$96.75
2024-12-12,16:21:00,21990.75,BUY,1,0.02h,Stop Loss,$-6.00,$90.75,$135256.25,247,$90.75
2024-12-12,16:22:00,21722.0,SELL,1,0.02h,Stop Loss,$19.00,$109.75,$135275.25,247,$109.75
2024-12-12,16:25:00,21991.5,BUY,1,0.02h,Stop Loss,$-6.00,$103.75,$135269.25,247,$103.75
2024-12-12,16:26:00,21719.5,SELL,1,0.02h,Stop Loss,$-6.00,$97.75,$135263.25,247,$97.75
2024-12-12,16:27:00,21989.5,BUY,1,0.02h,Stop Loss,$-6.00,$91.75,$135257.25,247,$91.75
2024-12-12,16:35:00,21710.25,SELL,1,0.02h,Break Even,$0.25,$92.00,$135257.50,247,$92.00
2024-12-12,16:37:00,21972.75,BUY,1,0.02h,Stop Loss,$-6.00,$86.00,$135251.50,247,$86.00
2024-12-12,16:38:00,21709.25,SELL,1,0.02h,Break Even,$0.25,$86.25,$135251.75,247,$86.25
2024-12-12,16:42:00,21967.25,BUY,1,0.02h,Stop Loss,$-6.00,$80.25,$135245.75,247,$80.25
2024-12-12,16:43:00,21696.75,SELL,1,0.02h,Stop Loss,$10.25,$90.50,$135256.00,247,$90.50
2024-12-12,16:53:00,21952.25,BUY,1,0.02h,Stop Loss,$-6.00,$84.50,$135250.00,247,$84.50
2024-12-12,16:54:00,21684.25,SELL,1,0.02h,Stop Loss,$-6.00,$78.50,$135244.00,247,$78.50
2024-12-12,16:55:00,21955.5,BUY,1,0.02h,Stop Loss,$6.50,$85.00,$135250.50,247,$85.00
2024-12-12,17:12:00,21722.5,SELL,1,0.02h,Break Even,$0.25,$85.25,$135250.75,247,$85.25
2024-12-12,17:20:00,21982.5,BUY,1,0.02h,Stop Loss,$6.50,$91.75,$135257.25,247,$91.75
2024-12-12,17:29:00,21717.25,SELL,1,0.02h,Break Even,$0.25,$92.00,$135257.50,247,$92.00
2024-12-12,17:33:00,21972.5,BUY,1,0.02h,Stop Loss,$-6.00,$86.00,$135251.50,247,$86.00
2024-12-12,17:34:00,21700.25,SELL,1,0.02h,Stop Loss,$10.25,$96.25,$135261.75,247,$96.25
2024-12-12,17:37:00,21959.5,BUY,1,0.02h,Stop Loss,$-6.00,$90.25,$135255.75,247,$90.25
2024-12-12,17:38:00,21699.5,SELL,1,0.02h,Break Even,$0.25,$90.50,$135256.00,247,$90.50
2024-12-12,17:45:00,21972.5,BUY,1,0.02h,Stop Loss,$-6.00,$84.50,$135250.00,247,$84.50
2024-12-12,17:46:00,21713.25,SELL,1,0.02h,Break Even,$0.25,$84.75,$135250.25,247,$84.75
2024-12-12,17:51:00,21988.25,BUY,1,0.02h,Break Even,$0.25,$85.00,$135250.50,247,$85.00
2024-12-12,17:55:00,21723.25,SELL,1,0.02h,Stop Loss,$-6.00,$79.00,$135244.50,247,$79.00
2024-12-12,17:56:00,21997.5,BUY,1,0.02h,Break Even,$0.25,$79.25,$135244.75,247,$79.25
2024-12-12,17:59:00,21737.75,SELL,1,0.02h,Stop Loss,$-6.00,$73.25,$135238.75,247,$73.25
2024-12-12,18:00:00,22009.5,BUY,1,0.02h,Stop Loss,$-6.00,$67.25,$135232.75,247,$67.25
2024-12-12,18:01:00,21741.25,SELL,1,0.02h,Stop Loss,$-6.00,$61.25,$135226.75,247,$61.25
2024-12-12,18:02:00,22006.0,BUY,1,0.02h,Stop Loss,$-6.00,$55.25,$135220.75,247,$55.25
2024-12-12,18:07:00,21733.25,SELL,1,0.02h,Stop Loss,$15.25,$70.50,$135236.00,247,$70.50
2024-12-12,18:10:00,21993.5,BUY,1,0.02h,Stop Loss,$-6.00,$64.50,$135230.00,247,$64.50
2024-12-12,18:11:00,21730.5,SELL,1,0.02h,Stop Loss,$47.75,$112.25,$135277.75,247,$112.25
2024-12-12,18:21:00,22006.0,BUY,1,0.02h,Stop Loss,$-6.00,$106.25,$135271.75,247,$106.25
2024-12-12,18:22:00,21732.25,SELL,1,0.02h,Break Even,$0.25,$106.50,$135272.00,247,$106.50
2024-12-12,18:24:00,22006.75,BUY,1,0.02h,Stop Loss,$-6.00,$100.50,$135266.00,247,$100.50
2024-12-12,18:26:00,21736.75,SELL,1,0.02h,Break Even,$0.25,$100.75,$135266.25,247,$100.75
2024-12-12,18:28:00,22011.5,BUY,1,0.02h,Stop Loss,$-6.00,$94.75,$135260.25,247,$94.75
2024-12-12,18:29:00,21739.0,SELL,1,0.02h,Stop Loss,$-6.00,$88.75,$135254.25,247,$88.75
2024-12-12,18:30:00,21997.0,BUY,1,0.02h,Stop Loss,$-6.00,$82.75,$135248.25,247,$82.75
2024-12-12,18:41:00,21719.75,SELL,1,0.02h,Stop Loss,$-6.00,$76.75,$135242.25,247,$76.75
2024-12-12,18:42:00,21974.0,BUY,1,0.02h,Stop Loss,$-6.00,$70.75,$135236.25,247,$70.75
2024-12-12,18:43:00,21706.5,SELL,1,0.02h,Stop Loss,$-6.00,$64.75,$135230.25,247,$64.75
2024-12-12,18:47:00,21980.25,BUY,1,0.02h,Stop Loss,$-6.00,$58.75,$135224.25,247,$58.75
2024-12-12,18:48:00,21712.0,SELL,1,0.02h,Stop Loss,$-6.00,$52.75,$135218.25,247,$52.75
2024-12-12,18:49:00,21977.0,BUY,1,0.02h,Stop Loss,$-6.00,$46.75,$135212.25,247,$46.75
2024-12-12,18:50:00,21714.25,SELL,1,0.02h,Stop Loss,$-6.00,$40.75,$135206.25,247,$40.75
2024-12-12,18:51:00,21980.25,BUY,1,0.02h,Stop Loss,$-6.00,$34.75,$135200.25,247,$34.75
2024-12-12,18:53:00,21705.25,SELL,1,0.02h,Stop Loss,$-6.00,$28.75,$135194.25,247,$28.75
2024-12-12,18:54:00,21971.5,BUY,1,0.02h,Break Even,$0.25,$29.00,$135194.50,247,$29.00
2024-12-12,19:03:00,21699.0,SELL,1,0.02h,Stop Loss,$-6.00,$23.00,$135188.50,247,$23.00
2024-12-12,19:04:00,21967.25,BUY,1,0.03h,Stop Loss,$10.25,$33.25,$135198.75,247,$33.25
2024-12-12,19:06:00,21711.0,SELL,1,0.02h,Stop Loss,$12.75,$46.00,$135211.50,247,$46.00
2024-12-12,19:20:00,21958.75,BUY,1,0.02h,Stop Loss,$-6.00,$40.00,$135205.50,247,$40.00
2024-12-12,19:21:00,21686.0,SELL,1,0.02h,Stop Loss,$-6.00,$34.00,$135199.50,247,$34.00
2024-12-12,19:22:00,21941.75,BUY,1,0.02h,Break Even,$0.25,$34.25,$135199.75,247,$34.25
2024-12-12,19:26:00,21674.75,SELL,1,0.02h,Stop Loss,$-6.00,$28.25,$135193.75,247,$28.25
2024-12-12,19:40:00,21957.75,BUY,1,0.02h,Stop Loss,$-6.00,$22.25,$135187.75,247,$22.25
2024-12-12,19:54:00,21684.5,SELL,1,0.02h,Stop Loss,$-6.00,$16.25,$135181.75,247,$16.25
2024-12-12,20:05:00,21947.75,BUY,1,0.02h,Stop Loss,$-6.00,$10.25,$135175.75,247,$10.25
2024-12-12,20:06:00,21683.5,SELL,1,0.02h,Break Even,$0.25,$10.50,$135176.00,247,$10.50
2024-12-12,20:09:00,21943.25,BUY,1,0.02h,Break Even,$0.25,$10.75,$135176.25,247,$10.75
2024-12-12,20:14:00,21663.0,SELL,1,0.02h,Stop Loss,$4.00,$14.75,$135180.25,247,$14.75
2024-12-12,20:17:00,21930.75,BUY,1,0.02h,Stop Loss,$-6.00,$8.75,$135174.25,247,$8.75
2024-12-12,20:20:00,21665.0,SELL,1,0.02h,Break Even,$0.25,$9.00,$135174.50,247,$9.00
2024-12-12,20:23:00,21924.75,BUY,1,0.02h,Stop Loss,$-6.00,$3.00,$135168.50,247,$3.00
2024-12-12,20:24:00,21659.75,SELL,1,0.02h,Stop Loss,$-6.00,$-3.00,$135162.50,247,$-3.00
2024-12-12,20:25:00,21924.25,BUY,1,0.02h,Stop Loss,$12.75,$9.75,$135175.25,247,$9.75
2024-12-12,20:28:00,21651.5,SELL,1,0.02h,Stop Loss,$-6.00,$3.75,$135169.25,247,$3.75
2024-12-12,20:30:00,21922.25,BUY,1,0.02h,Stop Loss,$22.75,$26.50,$135192.00,247,$26.50
2024-12-12,20:33:00,21664.0,SELL,1,0.02h,Stop Loss,$-6.00,$20.50,$135186.00,247,$20.50
2024-12-12,20:35:00,21938.75,BUY,1,0.02h,Stop Loss,$-6.00,$14.50,$135180.00,247,$14.50
2024-12-12,20:39:00,21664.0,SELL,1,0.02h,Stop Loss,$-6.00,$8.50,$135174.00,247,$8.50
2024-12-12,20:42:00,21925.0,BUY,1,0.02h,Stop Loss,$-6.00,$2.50,$135168.00,247,$2.50
2024-12-12,20:43:00,21661.25,SELL,1,0.02h,Stop Loss,$-6.00,$-3.50,$135162.00,247,$-3.50
2024-12-12,20:44:00,21929.75,BUY,1,0.02h,Stop Loss,$-6.00,$-9.50,$135156.00,247,$-9.50
2024-12-12,20:45:00,21664.25,SELL,1,0.02h,Stop Loss,$-6.00,$-15.50,$135150.00,247,$-15.50
2024-12-12,20:47:00,21939.75,BUY,1,0.03h,Break Even,$0.25,$-15.25,$135150.25,247,$-15.25
2024-12-12,21:00:00,21644.0,SELL,1,0.02h,Stop Loss,$34.00,$18.75,$135184.25,247,$18.75
2024-12-12,21:07:00,21885.25,BUY,1,0.02h,Break Even,$0.25,$19.00,$135184.50,247,$19.00
2024-12-12,21:10:00,21623.25,SELL,1,0.02h,Stop Loss,$-6.00,$13.00,$135178.50,247,$13.00
2024-12-12,21:11:00,21882.25,BUY,1,0.02h,Stop Loss,$-6.00,$7.00,$135172.50,247,$7.00
2024-12-12,21:12:00,21617.0,SELL,1,0.02h,Stop Loss,$7.75,$14.75,$135180.25,247,$14.75
2024-12-12,21:18:00,21926.5,BUY,1,0.02h,Stop Loss,$80.25,$95.00,$135260.50,247,$95.00
2024-12-12,21:33:00,21677.75,SELL,1,0.02h,Stop Loss,$17.75,$112.75,$135278.25,247,$112.75
2024-12-12,21:42:00,21914.0,BUY,1,0.02h,Stop Loss,$6.50,$119.25,$135284.75,247,$119.25
2024-12-12,21:44:00,21649.75,SELL,1,0.02h,Stop Loss,$-6.00,$113.25,$135278.75,247,$113.25
2024-12-12,21:45:00,21917.5,BUY,1,0.02h,Stop Loss,$-6.00,$107.25,$135272.75,247,$107.25
2024-12-12,21:52:00,21641.5,SELL,1,0.02h,Stop Loss,$-6.00,$101.25,$135266.75,247,$101.25
Final P&L Day: 101.25,,,,,,,,,,,
2024-12-13,12:00:00,22059.5,BUY,1,0.02h,Break Even,$0.25,$0.25,$135267.00,248,$0.25
2024-12-13,12:19:00,21810.75,SELL,1,0.02h,Break Even,$0.25,$0.50,$135267.25,248,$0.50
2024-12-13,12:23:00,22090.75,BUY,1,0.02h,Stop Loss,$6.50,$7.00,$135273.75,248,$7.00
2024-12-13,12:26:00,21824.0,SELL,1,0.02h,Stop Loss,$5.25,$12.25,$135279.00,248,$12.25
2024-12-13,12:31:00,22090.0,BUY,1,0.02h,Stop Loss,$-6.00,$6.25,$135273.00,248,$6.25
2024-12-13,12:37:00,21817.25,SELL,1,0.02h,Stop Loss,$-6.00,$0.25,$135267.00,248,$0.25
2024-12-13,12:38:00,22088.75,BUY,1,0.02h,Stop Loss,$-6.00,$-5.75,$135261.00,248,$-5.75
2024-12-13,12:39:00,21818.0,SELL,1,0.02h,Stop Loss,$-6.00,$-11.75,$135255.00,248,$-11.75
2024-12-13,12:40:00,22088.25,BUY,1,0.02h,Break Even,$0.25,$-11.50,$135255.25,248,$-11.50
2024-12-13,12:48:00,21825.75,SELL,1,0.02h,Stop Loss,$-6.00,$-17.50,$135249.25,248,$-17.50
2024-12-13,12:49:00,22095.25,BUY,1,0.02h,Stop Loss,$-6.00,$-23.50,$135243.25,248,$-23.50
2024-12-13,12:50:00,21823.75,SELL,1,0.02h,Stop Loss,$-6.00,$-29.50,$135237.25,248,$-29.50
2024-12-13,12:52:00,22095.5,BUY,1,0.03h,Break Even,$0.25,$-29.25,$135237.50,248,$-29.25
2024-12-13,12:54:00,21828.25,SELL,1,0.02h,Stop Loss,$-6.00,$-35.25,$135231.50,248,$-35.25
2024-12-13,13:07:00,22108.75,BUY,1,0.02h,Stop Loss,$-6.00,$-41.25,$135225.50,248,$-41.25
2024-12-13,13:20:00,21836.0,SELL,1,0.02h,Stop Loss,$-6.00,$-47.25,$135219.50,248,$-47.25
2024-12-13,13:28:00,22110.75,BUY,1,0.02h,Stop Loss,$-6.00,$-53.25,$135213.50,248,$-53.25
2024-12-13,13:52:00,21817.75,SELL,1,0.02h,Stop Loss,$-6.00,$-59.25,$135207.50,248,$-59.25
2024-12-13,13:53:00,22086.75,BUY,1,0.02h,Stop Loss,$21.50,$-37.75,$135229.00,248,$-37.75
2024-12-13,13:56:00,21822.5,SELL,1,0.02h,Break Even,$0.25,$-37.50,$135229.25,248,$-37.50
2024-12-13,14:06:00,22078.25,BUY,1,0.02h,Stop Loss,$-6.00,$-43.50,$135223.25,248,$-43.50
2024-12-13,14:07:00,21804.5,SELL,1,0.02h,Break Even,$0.25,$-43.25,$135223.50,248,$-43.25
2024-12-13,14:12:00,22069.0,BUY,1,0.02h,Stop Loss,$64.00,$20.75,$135287.50,248,$20.75
2024-12-13,14:14:00,21810.5,SELL,1,0.02h,Stop Loss,$-6.00,$14.75,$135281.50,248,$14.75
2024-12-13,14:15:00,22076.0,BUY,1,0.02h,Stop Loss,$-6.00,$8.75,$135275.50,248,$8.75
2024-12-13,14:16:00,21796.5,SELL,1,0.02h,Stop Loss,$-6.00,$2.75,$135269.50,248,$2.75
2024-12-13,14:18:00,22065.0,BUY,1,0.02h,Stop Loss,$-6.00,$-3.25,$135263.50,248,$-3.25
2024-12-13,14:19:00,21794.5,SELL,1,0.02h,Stop Loss,$-6.00,$-9.25,$135257.50,248,$-9.25
2024-12-13,14:30:00,22068.5,BUY,1,0.02h,Stop Loss,$79.00,$69.75,$135336.50,248,$69.75
2024-12-13,14:34:00,21814.25,SELL,1,0.02h,Break Even,$0.25,$70.00,$135336.75,248,$70.00
2024-12-13,14:36:00,22088.0,BUY,1,0.02h,Stop Loss,$-6.00,$64.00,$135330.75,248,$64.00
2024-12-13,14:37:00,21835.25,SELL,1,0.02h,Stop Loss,$24.00,$88.00,$135354.75,248,$88.00
2024-12-13,14:41:00,22107.5,BUY,1,0.02h,Stop Loss,$-6.00,$82.00,$135348.75,248,$82.00
2024-12-13,14:42:00,21842.5,SELL,1,0.02h,Break Even,$0.25,$82.25,$135349.00,248,$82.25
2024-12-13,14:45:00,22163.25,BUY,1,0.02h,Stop Loss,$70.25,$152.50,$135419.25,248,$152.50
2024-12-13,14:59:00,21886.5,SELL,1,0.02h,Stop Loss,$-6.00,$146.50,$135413.25,248,$146.50
2024-12-13,15:00:00,22156.0,BUY,1,0.02h,Stop Loss,$-6.00,$140.50,$135407.25,248,$140.50
2024-12-13,15:01:00,21877.5,SELL,1,0.02h,Stop Loss,$56.50,$197.00,$135463.75,248,$197.00
2024-12-13,15:04:00,22149.0,BUY,1,0.02h,Stop Loss,$-6.00,$191.00,$135457.75,248,$191.00
2024-12-13,15:05:00,21863.0,SELL,1,0.02h,Stop Loss,$11.50,$202.50,$135469.25,248,$202.50
2024-12-13,15:15:00,22137.25,BUY,1,0.02h,Break Even,$0.25,$202.75,$135469.50,248,$202.75
2024-12-13,15:30:00,21803.0,SELL,1,0.02h,Stop Loss,$-6.00,$196.75,$135463.50,248,$196.75
2024-12-13,15:49:00,22045.0,BUY,1,0.02h,Stop Loss,$-6.00,$190.75,$135457.50,248,$190.75
2024-12-13,15:50:00,21772.5,SELL,1,0.02h,Stop Loss,$110.25,$301.00,$135567.75,248,$301.00
2024-12-13,15:58:00,21983.0,BUY,1,0.02h,Stop Loss,$10.25,$311.25,$135578.00,248,$311.25
2024-12-13,16:00:00,21687.75,SELL,1,0.02h,Stop Loss,$20.25,$331.50,$135598.25,248,$331.50
2024-12-13,16:11:00,21965.0,BUY,1,0.02h,Stop Loss,$35.25,$366.75,$135633.50,248,$366.75
2024-12-13,16:15:00,21677.5,SELL,1,0.02h,Stop Loss,$-6.00,$360.75,$135627.50,248,$360.75
2024-12-13,16:16:00,21969.75,BUY,1,0.02h,Stop Loss,$104.00,$464.75,$135731.50,248,$464.75
2024-12-13,16:30:00,21699.0,SELL,1,0.02h,Stop Loss,$-6.00,$458.75,$135725.50,248,$458.75
2024-12-13,16:33:00,22020.75,BUY,1,0.02h,Stop Loss,$-6.00,$452.75,$135719.50,248,$452.75
2024-12-13,16:34:00,21747.25,SELL,1,0.02h,Break Even,$0.25,$453.00,$135719.75,248,$453.00
2024-12-13,16:44:00,22012.5,BUY,1,0.02h,Break Even,$0.25,$453.25,$135720.00,248,$453.25
2024-12-13,16:47:00,21703.25,SELL,1,0.02h,Break Even,$0.25,$453.50,$135720.25,248,$453.50
2024-12-13,16:52:00,21982.5,BUY,1,0.02h,Stop Loss,$5.25,$458.75,$135725.50,248,$458.75
2024-12-13,16:56:00,21686.5,SELL,1,0.02h,Stop Loss,$46.50,$505.25,$135772.00,248,$505.25
2024-12-13,16:59:00,21963.0,BUY,1,0.02h,Stop Loss,$76.50,$581.75,$135848.50,248,$581.75
2024-12-13,17:04:00,21710.25,SELL,1,0.02h,Break Even,$0.25,$582.00,$135848.75,248,$582.00
2024-12-13,17:12:00,22017.75,BUY,1,0.02h,Stop Loss,$-6.00,$576.00,$135842.75,248,$576.00
2024-12-13,17:13:00,21733.0,SELL,1,0.02h,Stop Loss,$60.25,$636.25,$135903.00,248,$636.25
2024-12-13,17:15:00,21996.75,BUY,1,0.02h,Stop Loss,$-6.00,$630.25,$135897.00,248,$630.25
2024-12-13,17:16:00,21714.5,SELL,1,0.02h,Stop Loss,$-6.00,$624.25,$135891.00,248,$624.25
2024-12-13,17:17:00,21995.0,BUY,1,0.02h,Stop Loss,$26.50,$650.75,$135917.50,248,$650.75
2024-12-13,17:20:00,21728.25,SELL,1,0.02h,Break Even,$0.25,$651.00,$135917.75,248,$651.00
2024-12-13,17:33:00,21970.75,BUY,1,0.02h,Stop Loss,$-6.00,$645.00,$135911.75,248,$645.00
2024-12-13,17:34:00,21687.0,SELL,1,0.02h,Stop Loss,$-6.00,$639.00,$135905.75,248,$639.00
2024-12-13,17:36:00,21972.5,BUY,1,0.02h,Stop Loss,$-6.00,$633.00,$135899.75,248,$633.00
2024-12-13,17:50:00,21701.0,SELL,1,0.02h,Stop Loss,$-6.00,$627.00,$135893.75,248,$627.00
2024-12-13,17:51:00,21970.0,BUY,1,0.02h,Stop Loss,$-6.00,$621.00,$135887.75,248,$621.00
2024-12-13,17:52:00,21698.75,SELL,1,0.02h,Stop Loss,$-6.00,$615.00,$135881.75,248,$615.00
2024-12-13,17:53:00,21994.5,BUY,1,0.02h,Stop Loss,$15.25,$630.25,$135897.00,248,$630.25
2024-12-13,18:00:00,21684.5,SELL,1,0.02h,Break Even,$0.25,$630.50,$135897.25,248,$630.50
2024-12-13,18:08:00,21998.25,BUY,1,0.02h,Stop Loss,$-6.00,$624.50,$135891.25,248,$624.50
2024-12-13,18:09:00,21715.0,SELL,1,0.02h,Stop Loss,$26.50,$651.00,$135917.75,248,$651.00
2024-12-13,18:11:00,21996.25,BUY,1,0.02h,Stop Loss,$-6.00,$645.00,$135911.75,248,$645.00
2024-12-13,18:14:00,21722.5,SELL,1,0.02h,Stop Loss,$15.25,$660.25,$135927.00,248,$660.25
2024-12-13,18:16:00,21998.5,BUY,1,0.02h,Break Even,$0.25,$660.50,$135927.25,248,$660.50
2024-12-13,18:21:00,21724.5,SELL,1,0.02h,Stop Loss,$49.00,$709.50,$135976.25,248,$709.50
2024-12-13,18:29:00,22022.25,BUY,1,0.02h,Stop Loss,$-6.00,$703.50,$135970.25,248,$703.50
2024-12-13,18:38:00,21741.75,SELL,1,0.02h,Stop Loss,$-6.00,$697.50,$135964.25,248,$697.50
2024-12-13,18:39:00,22030.25,BUY,1,0.02h,Stop Loss,$-6.00,$691.50,$135958.25,248,$691.50
2024-12-13,18:40:00,21745.25,SELL,1,0.02h,Break Even,$0.25,$691.75,$135958.50,248,$691.75
2024-12-13,18:42:00,22031.25,BUY,1,0.02h,Stop Loss,$-6.00,$685.75,$135952.50,248,$685.75
2024-12-13,18:43:00,21744.5,SELL,1,0.02h,Stop Loss,$-6.00,$679.75,$135946.50,248,$679.75
2024-12-13,18:44:00,22030.0,BUY,1,0.02h,Stop Loss,$-6.00,$673.75,$135940.50,248,$673.75
2024-12-13,18:45:00,21749.25,SELL,1,0.02h,Break Even,$0.25,$674.00,$135940.75,248,$674.00
2024-12-13,18:49:00,22049.5,BUY,1,0.02h,Stop Loss,$14.00,$688.00,$135954.75,248,$688.00
2024-12-13,18:52:00,21767.75,SELL,1,0.02h,Stop Loss,$9.00,$697.00,$135963.75,248,$697.00
2024-12-13,18:54:00,22050.0,BUY,1,0.02h,Stop Loss,$17.75,$714.75,$135981.50,248,$714.75
2024-12-13,19:03:00,21762.25,SELL,1,0.02h,Break Even,$0.25,$715.00,$135981.75,248,$715.00
2024-12-13,19:11:00,22064.0,BUY,1,0.02h,Stop Loss,$-6.00,$709.00,$135975.75,248,$709.00
2024-12-13,19:20:00,21785.5,SELL,1,0.02h,Stop Loss,$20.25,$729.25,$135996.00,248,$729.25
2024-12-13,19:30:00,22089.5,BUY,1,0.02h,Stop Loss,$25.25,$754.50,$136021.25,248,$754.50
2024-12-13,19:35:00,21810.25,SELL,1,0.02h,Stop Loss,$-6.00,$748.50,$136015.25,248,$748.50
2024-12-13,19:36:00,22088.25,BUY,1,0.02h,Break Even,$0.25,$748.75,$136015.50,248,$748.75
2024-12-13,19:40:00,21805.0,SELL,1,0.02h,Stop Loss,$6.50,$755.25,$136022.00,248,$755.25
2024-12-13,19:43:00,22090.5,BUY,1,0.02h,Stop Loss,$-6.00,$749.25,$136016.00,248,$749.25
2024-12-13,19:50:00,21805.25,SELL,1,0.02h,Stop Loss,$-6.00,$743.25,$136010.00,248,$743.25
2024-12-13,19:51:00,22087.25,BUY,1,0.02h,Stop Loss,$-6.00,$737.25,$136004.00,248,$737.25
2024-12-13,20:03:00,21805.0,SELL,1,0.02h,Stop Loss,$-6.00,$731.25,$135998.00,248,$731.25
2024-12-13,20:04:00,22089.0,BUY,1,0.02h,Stop Loss,$-6.00,$725.25,$135992.00,248,$725.25
2024-12-13,20:07:00,21801.25,SELL,1,0.02h,Break Even,$0.25,$725.50,$135992.25,248,$725.50
2024-12-13,20:24:00,22069.25,BUY,1,0.02h,Stop Loss,$4.00,$729.50,$135996.25,248,$729.50
2024-12-13,20:27:00,21799.0,SELL,1,0.02h,Stop Loss,$-6.00,$723.50,$135990.25,248,$723.50
2024-12-13,20:28:00,22085.25,BUY,1,0.02h,Stop Loss,$31.50,$755.00,$136021.75,248,$755.00
2024-12-13,20:32:00,21813.75,SELL,1,0.02h,Stop Loss,$-6.00,$749.00,$136015.75,248,$749.00
2024-12-13,20:33:00,22095.5,BUY,1,0.02h,Stop Loss,$-6.00,$743.00,$136009.75,248,$743.00
2024-12-13,20:34:00,21822.0,SELL,1,0.02h,Break Even,$0.25,$743.25,$136010.00,248,$743.25
2024-12-13,20:37:00,22104.5,BUY,1,0.02h,Stop Loss,$-6.00,$737.25,$136004.00,248,$737.25
2024-12-13,20:44:00,21798.0,SELL,1,0.02h,Stop Loss,$-6.00,$731.25,$135998.00,248,$731.25
2024-12-13,20:45:00,22081.25,BUY,1,0.02h,Stop Loss,$-6.00,$725.25,$135992.00,248,$725.25
2024-12-13,20:46:00,21803.5,SELL,1,0.02h,Stop Loss,$-6.00,$719.25,$135986.00,248,$719.25
2024-12-13,20:50:00,22093.25,BUY,1,0.02h,Stop Loss,$-6.00,$713.25,$135980.00,248,$713.25
2024-12-13,20:53:00,21794.25,SELL,1,0.02h,Break Even,$0.25,$713.50,$135980.25,248,$713.50
2024-12-13,20:56:00,22082.75,BUY,1,0.02h,Stop Loss,$-6.00,$707.50,$135974.25,248,$707.50
2024-12-13,20:58:00,21797.0,SELL,1,0.02h,Break Even,$0.25,$707.75,$135974.50,248,$707.75
2024-12-13,21:12:00,22063.5,BUY,1,0.02h,Break Even,$0.25,$708.00,$135974.75,248,$708.00
2024-12-13,21:18:00,21773.5,SELL,1,0.02h,Stop Loss,$17.75,$725.75,$135992.50,248,$725.75
2024-12-13,21:24:00,22052.25,BUY,1,0.02h,Stop Loss,$-6.00,$719.75,$135986.50,248,$719.75
2024-12-13,21:26:00,21764.25,SELL,1,0.02h,Stop Loss,$24.00,$743.75,$136010.50,248,$743.75
2024-12-13,21:28:00,22045.5,BUY,1,0.02h,Stop Loss,$-6.00,$737.75,$136004.50,248,$737.75
2024-12-13,21:29:00,21759.5,SELL,1,0.02h,Stop Loss,$-6.00,$731.75,$135998.50,248,$731.75
2024-12-13,21:30:00,22044.25,BUY,1,0.02h,Stop Loss,$-6.00,$725.75,$135992.50,248,$725.75
2024-12-13,21:34:00,21757.75,SELL,1,0.02h,Stop Loss,$-6.00,$719.75,$135986.50,248,$719.75
2024-12-13,21:35:00,22044.0,BUY,1,0.02h,Stop Loss,$-6.00,$713.75,$135980.50,248,$713.75
2024-12-13,21:37:00,21756.25,SELL,1,0.02h,Stop Loss,$-6.00,$707.75,$135974.50,248,$707.75
2024-12-13,21:38:00,22048.75,BUY,1,0.02h,Stop Loss,$-6.00,$701.75,$135968.50,248,$701.75
2024-12-13,21:45:00,21761.5,SELL,1,0.02h,Stop Loss,$-6.00,$695.75,$135962.50,248,$695.75
2024-12-13,21:46:00,22050.5,BUY,1,0.02h,Break Even,$0.25,$696.00,$135962.75,248,$696.00
2024-12-13,21:48:00,21763.75,SELL,1,0.02h,Break Even,$0.25,$696.25,$135963.00,248,$696.25
2024-12-13,21:54:00,22051.5,BUY,1,0.02h,Stop Loss,$-6.00,$690.25,$135957.00,248,$690.25
2024-12-13,21:55:00,21763.5,SELL,1,0.02h,Stop Loss,$-6.00,$684.25,$135951.00,248,$684.25
Final P&L Day: 684.25,,,,,,,,,,,
2024-12-16,12:00:00,22160.5,BUY,1,0.02h,Stop Loss,$-6.00,$-6.00,$135945.00,249,$-6.00
2024-12-16,12:51:00,22172.0,SELL,1,0.02h,Stop Loss,$-6.00,$-12.00,$135939.00,249,$-12.00
2024-12-16,12:52:00,22174.0,BUY,1,0.02h,Stop Loss,$-6.00,$-18.00,$135933.00,249,$-18.00
2024-12-16,12:53:00,22170.75,SELL,1,0.02h,Stop Loss,$9.00,$-9.00,$135942.00,249,$-9.00
2024-12-16,13:01:00,22174.75,BUY,1,0.02h,Stop Loss,$-6.00,$-15.00,$135936.00,249,$-15.00
2024-12-16,13:02:00,22172.25,SELL,1,0.03h,Stop Loss,$-6.00,$-21.00,$135930.00,249,$-21.00
2024-12-16,13:13:00,22178.25,BUY,1,0.02h,Stop Loss,$16.50,$-4.50,$135946.50,249,$-4.50
2024-12-16,13:56:00,22199.75,SELL,1,0.02h,Break Even,$0.25,$-4.25,$135946.75,249,$-4.25
2024-12-16,13:59:00,22207.25,BUY,1,0.02h,Stop Loss,$-6.00,$-10.25,$135940.75,249,$-10.25
2024-12-16,14:06:00,22196.0,SELL,1,0.02h,Stop Loss,$16.50,$6.25,$135957.25,249,$6.25
2024-12-16,14:31:00,22218.5,BUY,1,0.02h,Stop Loss,$51.50,$57.75,$136008.75,249,$57.75
2024-12-16,15:19:00,22256.5,SELL,1,0.02h,Stop Loss,$61.50,$119.25,$136070.25,249,$119.25
2024-12-16,15:26:00,22275.25,BUY,1,0.02h,Break Even,$0.25,$119.50,$136070.50,249,$119.50
2024-12-16,15:54:00,22281.25,SELL,1,0.02h,Break Even,$0.25,$119.75,$136070.75,249,$119.75
2024-12-16,15:57:00,22301.75,BUY,1,0.02h,Break Even,$0.25,$120.00,$136071.00,249,$120.00
2024-12-16,16:00:00,22287.25,SELL,1,0.02h,Break Even,$0.25,$120.25,$136071.25,249,$120.25
2024-12-16,16:01:00,22307.0,BUY,1,0.02h,Break Even,$0.25,$120.50,$136071.50,249,$120.50
2024-12-16,16:35:00,22314.0,SELL,1,0.02h,Stop Loss,$6.50,$127.00,$136078.00,249,$127.00
2024-12-16,16:52:00,22326.25,BUY,1,0.02h,Break Even,$0.25,$127.25,$136078.25,249,$127.25
2024-12-16,18:55:00,22412.5,SELL,1,0.02h,Break Even,$0.25,$127.50,$136078.50,249,$127.50
2024-12-16,18:56:00,22415.75,BUY,1,0.02h,Break Even,$0.25,$127.75,$136078.75,249,$127.75
2024-12-16,19:01:00,22404.0,SELL,1,0.02h,Break Even,$0.25,$128.00,$136079.00,249,$128.00
2024-12-16,19:11:00,22417.5,BUY,1,0.02h,Stop Loss,$-6.00,$122.00,$136073.00,249,$122.00
2024-12-16,19:32:00,22422.75,SELL,1,0.02h,Break Even,$0.25,$122.25,$136073.25,249,$122.25
2024-12-16,19:38:00,22430.5,BUY,1,0.02h,Stop Loss,$5.25,$127.50,$136078.50,249,$127.50
2024-12-16,20:00:00,22421.0,SELL,1,0.02h,Stop Loss,$-6.00,$121.50,$136072.50,249,$121.50
2024-12-16,20:06:00,22439.5,BUY,1,0.02h,Break Even,$0.25,$121.75,$136072.75,249,$121.75
2024-12-16,20:34:00,22429.25,SELL,1,0.02h,Break Even,$0.25,$122.00,$136073.00,249,$122.00
2024-12-16,21:37:00,22402.75,BUY,1,0.02h,Break Even,$0.25,$122.25,$136073.25,249,$122.25
Final P&L Day: 122.25,,,,,,,,,,,
2024-12-17,12:00:00,22389.25,SELL,1,0.02h,Stop Loss,$1496.50,$1496.50,$137569.75,250,$1496.50
2024-12-17,12:28:00,22368.25,BUY,1,0.02h,Stop Loss,$-6.00,$1490.50,$137563.75,250,$1490.50
2024-12-17,12:41:00,22056.25,SELL,1,0.02h,Stop Loss,$-6.00,$1484.50,$137557.75,250,$1484.50
2024-12-17,12:42:00,22358.75,BUY,1,0.02h,Stop Loss,$-6.00,$1478.50,$137551.75,250,$1478.50
2024-12-17,12:43:00,22064.5,SELL,1,0.02h,Stop Loss,$7.75,$1486.25,$137559.50,250,$1486.25
2024-12-17,12:46:00,22363.75,BUY,1,0.02h,Stop Loss,$-6.00,$1480.25,$137553.50,250,$1480.25
2024-12-17,12:47:00,22061.0,SELL,1,0.02h,Break Even,$0.25,$1480.50,$137553.75,250,$1480.50
2024-12-17,12:50:00,22360.75,BUY,1,0.02h,Stop Loss,$-6.00,$1474.50,$137547.75,250,$1474.50
2024-12-17,12:54:00,22060.25,SELL,1,0.02h,Stop Loss,$-6.00,$1468.50,$137541.75,250,$1468.50
2024-12-17,12:55:00,22360.25,BUY,1,0.02h,Stop Loss,$-6.00,$1462.50,$137535.75,250,$1462.50
2024-12-17,12:56:00,22055.0,SELL,1,0.02h,Stop Loss,$9.00,$1471.50,$137544.75,250,$1471.50
2024-12-17,13:11:00,22330.0,BUY,1,0.02h,Stop Loss,$-6.00,$1465.50,$137538.75,250,$1465.50
2024-12-17,13:12:00,22027.25,SELL,1,0.02h,Stop Loss,$-6.00,$1459.50,$137532.75,250,$1459.50
2024-12-17,13:13:00,22335.75,BUY,1,0.02h,Stop Loss,$-6.00,$1453.50,$137526.75,250,$1453.50
2024-12-17,13:14:00,22036.75,SELL,1,0.02h,Stop Loss,$6.50,$1460.00,$137533.25,250,$1460.00
2024-12-17,13:16:00,22340.25,BUY,1,0.02h,Stop Loss,$14.00,$1474.00,$137547.25,250,$1474.00
2024-12-17,13:19:00,22041.0,SELL,1,0.02h,Stop Loss,$-6.00,$1468.00,$137541.25,250,$1468.00
2024-12-17,13:20:00,22343.75,BUY,1,0.02h,Stop Loss,$-6.00,$1462.00,$137535.25,250,$1462.00
2024-12-17,13:21:00,22041.0,SELL,1,0.02h,Break Even,$0.25,$1462.25,$137535.50,250,$1462.25
2024-12-17,13:24:00,22354.0,BUY,1,0.02h,Stop Loss,$-6.00,$1456.25,$137529.50,250,$1456.25
2024-12-17,13:27:00,22043.25,SELL,1,0.02h,Stop Loss,$-6.00,$1450.25,$137523.50,250,$1450.25
2024-12-17,13:28:00,22346.75,BUY,1,0.02h,Stop Loss,$-6.00,$1444.25,$137517.50,250,$1444.25
2024-12-17,13:36:00,22044.25,SELL,1,0.02h,Stop Loss,$61.50,$1505.75,$137579.00,250,$1505.75
2024-12-17,13:52:00,22344.5,BUY,1,0.02h,Break Even,$0.25,$1506.00,$137579.25,250,$1506.00
2024-12-17,14:05:00,22062.75,SELL,1,0.02h,Stop Loss,$-6.00,$1500.00,$137573.25,250,$1500.00
2024-12-17,14:07:00,22365.5,BUY,1,0.02h,Stop Loss,$-6.00,$1494.00,$137567.25,250,$1494.00
2024-12-17,14:08:00,22061.5,SELL,1,0.02h,Stop Loss,$-6.00,$1488.00,$137561.25,250,$1488.00
2024-12-17,14:09:00,22364.0,BUY,1,0.02h,Stop Loss,$-6.00,$1482.00,$137555.25,250,$1482.00
2024-12-17,14:15:00,22052.25,SELL,1,0.02h,Stop Loss,$-6.00,$1476.00,$137549.25,250,$1476.00
2024-12-17,14:20:00,22354.75,BUY,1,0.02h,Stop Loss,$-6.00,$1470.00,$137543.25,250,$1470.00
2024-12-17,14:21:00,22047.5,SELL,1,0.02h,Stop Loss,$-6.00,$1464.00,$137537.25,250,$1464.00
2024-12-17,14:33:00,22324.75,BUY,1,0.02h,Stop Loss,$-6.00,$1458.00,$137531.25,250,$1458.00
2024-12-17,14:35:00,21994.75,SELL,1,0.02h,Stop Loss,$21.50,$1479.50,$137552.75,250,$1479.50
2024-12-17,14:45:00,22360.0,BUY,1,0.02h,Stop Loss,$20.25,$1499.75,$137573.00,250,$1499.75
2024-12-17,14:52:00,22042.25,SELL,1,0.02h,Stop Loss,$46.50,$1546.25,$137619.50,250,$1546.25
2024-12-17,14:55:00,22329.75,BUY,1,0.02h,Stop Loss,$-6.00,$1540.25,$137613.50,250,$1540.25
2024-12-17,14:56:00,22021.75,SELL,1,0.02h,Break Even,$0.25,$1540.50,$137613.75,250,$1540.50
2024-12-17,14:59:00,22334.5,BUY,1,0.02h,Stop Loss,$-6.00,$1534.50,$137607.75,250,$1534.50
2024-12-17,15:03:00,21991.0,SELL,1,0.02h,Stop Loss,$-6.00,$1528.50,$137601.75,250,$1528.50
2024-12-17,15:04:00,22272.75,BUY,1,0.02h,Stop Loss,$39.00,$1567.50,$137640.75,250,$1567.50
2024-12-17,15:09:00,22002.5,SELL,1,0.02h,Stop Loss,$-6.00,$1561.50,$137634.75,250,$1561.50
2024-12-17,15:10:00,22308.75,BUY,1,0.02h,Stop Loss,$32.75,$1594.25,$137667.50,250,$1594.25
2024-12-17,15:15:00,21976.0,SELL,1,0.02h,Stop Loss,$-6.00,$1588.25,$137661.50,250,$1588.25
2024-12-17,15:17:00,22274.0,BUY,1,0.02h,Stop Loss,$36.50,$1624.75,$137698.00,250,$1624.75
2024-12-17,15:20:00,21956.0,SELL,1,0.02h,Stop Loss,$45.25,$1670.00,$137743.25,250,$1670.00
2024-12-17,15:23:00,22251.25,BUY,1,0.02h,Stop Loss,$-6.00,$1664.00,$137737.25,250,$1664.00
2024-12-17,15:24:00,21954.25,SELL,1,0.02h,Stop Loss,$-6.00,$1658.00,$137731.25,250,$1658.00
2024-12-17,15:26:00,22254.5,BUY,1,0.02h,Stop Loss,$-6.00,$1652.00,$137725.25,250,$1652.00
2024-12-17,15:27:00,21957.25,SELL,1,0.02h,Stop Loss,$17.75,$1669.75,$137743.00,250,$1669.75
2024-12-17,15:34:00,22257.0,BUY,1,0.02h,Stop Loss,$37.75,$1707.50,$137780.75,250,$1707.50
2024-12-17,15:36:00,21953.25,SELL,1,0.02h,Stop Loss,$-6.00,$1701.50,$137774.75,250,$1701.50
2024-12-17,15:37:00,22253.0,BUY,1,0.02h,Stop Loss,$-6.00,$1695.50,$137768.75,250,$1695.50
2024-12-17,15:38:00,21968.0,SELL,1,0.02h,Stop Loss,$-6.00,$1689.50,$137762.75,250,$1689.50
2024-12-17,15:43:00,22268.0,BUY,1,0.02h,Stop Loss,$32.75,$1722.25,$137795.50,250,$1722.25
2024-12-17,15:57:00,21994.0,SELL,1,0.02h,Stop Loss,$-6.00,$1716.25,$137789.50,250,$1716.25
2024-12-17,15:58:00,22307.25,BUY,1,0.02h,Stop Loss,$19.00,$1735.25,$137808.50,250,$1735.25
2024-12-17,16:05:00,22005.5,SELL,1,0.02h,Stop Loss,$44.00,$1779.25,$137852.50,250,$1779.25
2024-12-17,16:16:00,22347.5,BUY,1,0.02h,Stop Loss,$-6.00,$1773.25,$137846.50,250,$1773.25
2024-12-17,16:18:00,22029.25,SELL,1,0.02h,Stop Loss,$7.75,$1781.00,$137854.25,250,$1781.00
2024-12-17,16:20:00,22336.0,BUY,1,0.02h,Stop Loss,$-6.00,$1775.00,$137848.25,250,$1775.00
2024-12-17,16:21:00,22023.5,SELL,1,0.02h,Stop Loss,$-6.00,$1769.00,$137842.25,250,$1769.00
2024-12-17,16:22:00,22337.0,BUY,1,0.02h,Stop Loss,$-6.00,$1763.00,$137836.25,250,$1763.00
2024-12-17,16:24:00,22029.25,SELL,1,0.02h,Break Even,$0.25,$1763.25,$137836.50,250,$1763.25
2024-12-17,16:27:00,22346.25,BUY,1,0.02h,Stop Loss,$29.00,$1792.25,$137865.50,250,$1792.25
2024-12-17,16:37:00,22073.0,SELL,1,0.02h,Stop Loss,$-6.00,$1786.25,$137859.50,250,$1786.25
2024-12-17,16:38:00,22382.0,BUY,1,0.02h,Stop Loss,$-6.00,$1780.25,$137853.50,250,$1780.25
2024-12-17,16:43:00,22079.25,SELL,1,0.02h,Stop Loss,$14.00,$1794.25,$137867.50,250,$1794.25
2024-12-17,16:46:00,22374.75,BUY,1,0.02h,Stop Loss,$26.50,$1820.75,$137894.00,250,$1820.75
2024-12-17,16:53:00,22050.5,SELL,1,0.02h,Stop Loss,$-6.00,$1814.75,$137888.00,250,$1814.75
2024-12-17,16:54:00,22341.75,BUY,1,0.02h,Stop Loss,$9.00,$1823.75,$137897.00,250,$1823.75
2024-12-17,17:03:00,22006.0,SELL,1,0.02h,Stop Loss,$40.25,$1864.00,$137937.25,250,$1864.00
2024-12-17,17:15:00,22327.75,BUY,1,0.02h,Stop Loss,$-6.00,$1858.00,$137931.25,250,$1858.00
2024-12-17,17:16:00,22029.25,SELL,1,0.02h,Stop Loss,$-6.00,$1852.00,$137925.25,250,$1852.00
2024-12-17,17:17:00,22322.0,BUY,1,0.02h,Stop Loss,$-6.00,$1846.00,$137919.25,250,$1846.00
2024-12-17,17:18:00,22024.5,SELL,1,0.02h,Stop Loss,$-6.00,$1840.00,$137913.25,250,$1840.00
2024-12-17,17:19:00,22324.0,BUY,1,0.02h,Stop Loss,$-6.00,$1834.00,$137907.25,250,$1834.00
2024-12-17,17:20:00,22012.0,SELL,1,0.02h,Stop Loss,$-6.00,$1828.00,$137901.25,250,$1828.00
2024-12-17,17:21:00,22318.5,BUY,1,0.02h,Stop Loss,$24.00,$1852.00,$137925.25,250,$1852.00
2024-12-17,17:24:00,22014.0,SELL,1,0.02h,Stop Loss,$24.00,$1876.00,$137949.25,250,$1876.00
2024-12-17,17:27:00,22319.25,BUY,1,0.02h,Stop Loss,$-6.00,$1870.00,$137943.25,250,$1870.00
2024-12-17,17:28:00,22028.0,SELL,1,0.02h,Stop Loss,$-6.00,$1864.00,$137937.25,250,$1864.00
2024-12-17,17:29:00,22334.25,BUY,1,0.02h,Stop Loss,$-6.00,$1858.00,$137931.25,250,$1858.00
2024-12-17,17:30:00,22036.75,SELL,1,0.02h,Stop Loss,$46.50,$1904.50,$137977.75,250,$1904.50
2024-12-17,17:32:00,22325.5,BUY,1,0.02h,Stop Loss,$34.00,$1938.50,$138011.75,250,$1938.50
2024-12-17,17:35:00,22040.5,SELL,1,0.02h,Stop Loss,$37.75,$1976.25,$138049.50,250,$1976.25
2024-12-17,17:40:00,22348.75,BUY,1,0.02h,Stop Loss,$-6.00,$1970.25,$138043.50,250,$1970.25
2024-12-17,17:51:00,22035.75,SELL,1,0.02h,Break Even,$0.25,$1970.50,$138043.75,250,$1970.50
2024-12-17,17:56:00,22341.25,BUY,1,0.02h,Stop Loss,$-6.00,$1964.50,$138037.75,250,$1964.50
2024-12-17,17:57:00,22029.25,SELL,1,0.02h,Stop Loss,$-6.00,$1958.50,$138031.75,250,$1958.50
2024-12-17,17:58:00,22338.5,BUY,1,0.02h,Stop Loss,$5.25,$1963.75,$138037.00,250,$1963.75
2024-12-17,18:02:00,22027.75,SELL,1,0.02h,Stop Loss,$-6.00,$1957.75,$138031.00,250,$1957.75
2024-12-17,18:03:00,22331.5,BUY,1,0.02h,Stop Loss,$-6.00,$1951.75,$138025.00,250,$1951.75
2024-12-17,18:04:00,22033.25,SELL,1,0.02h,Stop Loss,$-6.00,$1945.75,$138019.00,250,$1945.75
2024-12-17,18:05:00,22335.5,BUY,1,0.02h,Stop Loss,$6.50,$1952.25,$138025.50,250,$1952.25
2024-12-17,18:14:00,22038.75,SELL,1,0.02h,Stop Loss,$-6.00,$1946.25,$138019.50,250,$1946.25
2024-12-17,18:15:00,22341.75,BUY,1,0.02h,Stop Loss,$-6.00,$1940.25,$138013.50,250,$1940.25
2024-12-17,18:16:00,22033.75,SELL,1,0.02h,Stop Loss,$-6.00,$1934.25,$138007.50,250,$1934.25
2024-12-17,18:27:00,22326.0,BUY,1,0.02h,Stop Loss,$-6.00,$1928.25,$138001.50,250,$1928.25
2024-12-17,18:28:00,22025.25,SELL,1,0.02h,Stop Loss,$39.00,$1967.25,$138040.50,250,$1967.25
2024-12-17,18:31:00,22323.75,BUY,1,0.02h,Stop Loss,$-6.00,$1961.25,$138034.50,250,$1961.25
2024-12-17,18:32:00,22012.75,SELL,1,0.02h,Break Even,$0.25,$1961.50,$138034.75,250,$1961.50
2024-12-17,18:35:00,22329.25,BUY,1,0.02h,Break Even,$0.25,$1961.75,$138035.00,250,$1961.75
2024-12-17,18:43:00,22026.25,SELL,1,0.02h,Stop Loss,$-6.00,$1955.75,$138029.00,250,$1955.75
2024-12-17,18:44:00,22330.0,BUY,1,0.02h,Break Even,$0.25,$1956.00,$138029.25,250,$1956.00
2024-12-17,18:50:00,22000.75,SELL,1,0.02h,Stop Loss,$-6.00,$1950.00,$138023.25,250,$1950.00
2024-12-17,19:04:00,22294.75,BUY,1,0.02h,Stop Loss,$45.25,$1995.25,$138068.50,250,$1995.25
2024-12-17,19:06:00,21990.0,SELL,1,0.02h,Stop Loss,$-6.00,$1989.25,$138062.50,250,$1989.25
2024-12-17,19:07:00,22292.0,BUY,1,0.02h,Break Even,$0.25,$1989.50,$138062.75,250,$1989.50
2024-12-17,19:09:00,21993.0,SELL,1,0.02h,Stop Loss,$-6.00,$1983.50,$138056.75,250,$1983.50
2024-12-17,19:10:00,22295.0,BUY,1,0.02h,Stop Loss,$-6.00,$1977.50,$138050.75,250,$1977.50
2024-12-17,19:11:00,21999.75,SELL,1,0.02h,Break Even,$0.25,$1977.75,$138051.00,250,$1977.75
2024-12-17,19:21:00,22285.75,BUY,1,0.02h,Stop Loss,$12.75,$1990.50,$138063.75,250,$1990.50
2024-12-17,19:25:00,21984.0,SELL,1,0.02h,Stop Loss,$-6.00,$1984.50,$138057.75,250,$1984.50
2024-12-17,19:26:00,22283.0,BUY,1,0.02h,Stop Loss,$17.75,$2002.25,$138075.50,250,$2002.25
2024-12-17,19:28:00,21988.75,SELL,1,0.02h,Stop Loss,$15.25,$2017.50,$138090.75,250,$2017.50
2024-12-17,19:32:00,22282.25,BUY,1,0.02h,Stop Loss,$-6.00,$2011.50,$138084.75,250,$2011.50
2024-12-17,19:36:00,21981.0,SELL,1,0.02h,Stop Loss,$-6.00,$2005.50,$138078.75,250,$2005.50
2024-12-17,19:37:00,22274.5,BUY,1,0.02h,Stop Loss,$-6.00,$1999.50,$138072.75,250,$1999.50
2024-12-17,19:38:00,21968.0,SELL,1,0.02h,Break Even,$0.25,$1999.75,$138073.00,250,$1999.75
2024-12-17,19:48:00,22271.75,BUY,1,0.02h,Stop Loss,$4.00,$2003.75,$138077.00,250,$2003.75
2024-12-17,19:54:00,21974.5,SELL,1,0.02h,Stop Loss,$-6.00,$1997.75,$138071.00,250,$1997.75
2024-12-17,19:56:00,22283.25,BUY,1,0.02h,Stop Loss,$-6.00,$1991.75,$138065.00,250,$1991.75
2024-12-17,19:57:00,21986.75,SELL,1,0.02h,Stop Loss,$-6.00,$1985.75,$138059.00,250,$1985.75
2024-12-17,20:00:00,22281.25,BUY,1,0.02h,Stop Loss,$-6.00,$1979.75,$138053.00,250,$1979.75
2024-12-17,20:01:00,21979.75,SELL,1,0.02h,Stop Loss,$-6.00,$1973.75,$138047.00,250,$1973.75
2024-12-17,20:02:00,22287.5,BUY,1,0.02h,Stop Loss,$-6.00,$1967.75,$138041.00,250,$1967.75
2024-12-17,20:03:00,21984.0,SELL,1,0.02h,Stop Loss,$7.75,$1975.50,$138048.75,250,$1975.50
2024-12-17,20:10:00,22283.0,BUY,1,0.02h,Stop Loss,$14.00,$1989.50,$138062.75,250,$1989.50
2024-12-17,20:22:00,21966.75,SELL,1,0.02h,Break Even,$0.25,$1989.75,$138063.00,250,$1989.75
2024-12-17,20:29:00,22262.5,BUY,1,0.02h,Stop Loss,$27.75,$2017.50,$138090.75,250,$2017.50
2024-12-17,20:45:00,22007.75,SELL,1,0.02h,Stop Loss,$-6.00,$2011.50,$138084.75,250,$2011.50
2024-12-17,20:46:00,22310.0,BUY,1,0.02h,Stop Loss,$16.50,$2028.00,$138101.25,250,$2028.00
2024-12-17,20:48:00,21995.25,SELL,1,0.02h,Stop Loss,$-6.00,$2022.00,$138095.25,250,$2022.00
2024-12-17,20:49:00,22301.25,BUY,1,0.02h,Stop Loss,$-6.00,$2016.00,$138089.25,250,$2016.00
2024-12-17,20:50:00,21998.5,SELL,1,0.02h,Stop Loss,$-6.00,$2010.00,$138083.25,250,$2010.00
2024-12-17,20:55:00,22322.75,BUY,1,0.02h,Stop Loss,$15.25,$2025.25,$138098.50,250,$2025.25
2024-12-17,20:59:00,22026.5,SELL,1,0.02h,Stop Loss,$72.75,$2098.00,$138171.25,250,$2098.00
2024-12-17,21:03:00,22304.25,BUY,1,0.02h,Stop Loss,$-6.00,$2092.00,$138165.25,250,$2092.00
2024-12-17,21:04:00,21994.75,SELL,1,0.02h,Stop Loss,$-6.00,$2086.00,$138159.25,250,$2086.00
2024-12-17,21:05:00,22288.0,BUY,1,0.02h,Stop Loss,$-6.00,$2080.00,$138153.25,250,$2080.00
2024-12-17,21:06:00,21991.25,SELL,1,0.02h,Stop Loss,$-6.00,$2074.00,$138147.25,250,$2074.00
2024-12-17,21:12:00,22295.25,BUY,1,0.02h,Break Even,$0.25,$2074.25,$138147.50,250,$2074.25
2024-12-17,21:19:00,21994.0,SELL,1,0.02h,Stop Loss,$-6.00,$2068.25,$138141.50,250,$2068.25
2024-12-17,21:29:00,22314.25,BUY,1,0.02h,Stop Loss,$-6.00,$2062.25,$138135.50,250,$2062.25
2024-12-17,21:30:00,22011.5,SELL,1,0.02h,Stop Loss,$-6.00,$2056.25,$138129.50,250,$2056.25
2024-12-17,21:34:00,22312.75,BUY,1,0.02h,Stop Loss,$-6.00,$2050.25,$138123.50,250,$2050.25
2024-12-17,21:48:00,21997.75,SELL,1,0.02h,Stop Loss,$-6.00,$2044.25,$138117.50,250,$2044.25
2024-12-17,21:53:00,22305.5,BUY,1,0.02h,Stop Loss,$-6.00,$2038.25,$138111.50,250,$2038.25
2024-12-17,21:57:00,22005.0,SELL,1,0.03h,Break Even,$0.25,$2038.50,$138111.75,250,$2038.50
Final P&L Day: 2038.50,,,,,,,,,,,
2024-12-18,12:09:00,22375.75,BUY,1,0.02h,Stop Loss,$-6.00,$-6.00,$138105.75,251,$-6.00
2024-12-18,12:11:00,22076.5,SELL,1,0.02h,Break Even,$0.25,$-5.75,$138106.00,251,$-5.75
2024-12-18,12:18:00,22384.25,BUY,1,0.02h,Stop Loss,$-6.00,$-11.75,$138100.00,251,$-11.75
2024-12-18,12:25:00,22083.25,SELL,1,0.03h,Stop Loss,$4.00,$-7.75,$138104.00,251,$-7.75
2024-12-18,12:27:00,22378.75,BUY,1,0.02h,Stop Loss,$-6.00,$-13.75,$138098.00,251,$-13.75
2024-12-18,12:30:00,22070.75,SELL,1,0.02h,Stop Loss,$-6.00,$-19.75,$138092.00,251,$-19.75
2024-12-18,12:31:00,22378.25,BUY,1,0.02h,Stop Loss,$-6.00,$-25.75,$138086.00,251,$-25.75
2024-12-18,12:34:00,22071.75,SELL,1,0.03h,Stop Loss,$-6.00,$-31.75,$138080.00,251,$-31.75
2024-12-18,12:36:00,22377.75,BUY,1,0.02h,Stop Loss,$-6.00,$-37.75,$138074.00,251,$-37.75
2024-12-18,12:43:00,22069.75,SELL,1,0.02h,Break Even,$0.25,$-37.50,$138074.25,251,$-37.50
2024-12-18,12:49:00,22373.75,BUY,1,0.02h,Break Even,$0.25,$-37.25,$138074.50,251,$-37.25
2024-12-18,13:01:00,22070.5,SELL,1,0.02h,Stop Loss,$12.75,$-24.50,$138087.25,251,$-24.50
2024-12-18,13:03:00,22370.25,BUY,1,0.02h,Break Even,$0.25,$-24.25,$138087.50,251,$-24.25
2024-12-18,13:08:00,22067.0,SELL,1,0.02h,Break Even,$0.25,$-24.00,$138087.75,251,$-24.00
2024-12-18,13:10:00,22367.75,BUY,1,0.02h,Stop Loss,$-6.00,$-30.00,$138081.75,251,$-30.00
2024-12-18,13:11:00,22066.25,SELL,1,0.02h,Stop Loss,$-6.00,$-36.00,$138075.75,251,$-36.00
2024-12-18,13:13:00,22364.75,BUY,1,0.02h,Stop Loss,$-6.00,$-42.00,$138069.75,251,$-42.00
2024-12-18,13:14:00,22063.75,SELL,1,0.02h,Break Even,$0.25,$-41.75,$138070.00,251,$-41.75
2024-12-18,13:20:00,22358.5,BUY,1,0.02h,Stop Loss,$-6.00,$-47.75,$138064.00,251,$-47.75
2024-12-18,13:23:00,22054.5,SELL,1,0.02h,Stop Loss,$-6.00,$-53.75,$138058.00,251,$-53.75
2024-12-18,13:27:00,22368.5,BUY,1,0.02h,Stop Loss,$-6.00,$-59.75,$138052.00,251,$-59.75
2024-12-18,13:38:00,22050.25,SELL,1,0.02h,Stop Loss,$25.25,$-34.50,$138077.25,251,$-34.50
2024-12-18,13:41:00,22341.25,BUY,1,0.02h,Stop Loss,$-6.00,$-40.50,$138071.25,251,$-40.50
2024-12-18,13:42:00,22036.0,SELL,1,0.02h,Stop Loss,$45.25,$4.75,$138116.50,251,$4.75
2024-12-18,14:02:00,22297.0,BUY,1,0.02h,Stop Loss,$20.25,$25.00,$138136.75,251,$25.00
2024-12-18,14:05:00,21986.75,SELL,1,0.02h,Stop Loss,$-6.00,$19.00,$138130.75,251,$19.00
2024-12-18,14:08:00,22282.75,BUY,1,0.02h,Stop Loss,$-6.00,$13.00,$138124.75,251,$13.00
2024-12-18,14:09:00,21979.25,SELL,1,0.02h,Stop Loss,$5.25,$18.25,$138130.00,251,$18.25
2024-12-18,14:25:00,22281.5,BUY,1,0.02h,Stop Loss,$20.25,$38.50,$138150.25,251,$38.50
2024-12-18,14:34:00,21956.25,SELL,1,0.02h,Stop Loss,$140.25,$178.75,$138290.50,251,$178.75
2024-12-18,14:37:00,22233.0,BUY,1,0.02h,Stop Loss,$-6.00,$172.75,$138284.50,251,$172.75
2024-12-18,14:38:00,21935.75,SELL,1,0.02h,Stop Loss,$-6.00,$166.75,$138278.50,251,$166.75
2024-12-18,14:39:00,22232.75,BUY,1,0.02h,Stop Loss,$-6.00,$160.75,$138272.50,251,$160.75
2024-12-18,14:40:00,21954.25,SELL,1,0.02h,Stop Loss,$6.50,$167.25,$138279.00,251,$167.25
2024-12-18,14:42:00,22250.5,BUY,1,0.02h,Stop Loss,$102.75,$270.00,$138381.75,251,$270.00
2024-12-18,14:47:00,21955.5,SELL,1,0.02h,Break Even,$0.25,$270.25,$138382.00,251,$270.25
2024-12-18,14:57:00,22289.25,BUY,1,0.02h,Stop Loss,$27.75,$298.00,$138409.75,251,$298.00
2024-12-18,15:13:00,22007.5,SELL,1,0.02h,Stop Loss,$25.25,$323.25,$138435.00,251,$323.25
2024-12-18,15:15:00,22310.0,BUY,1,0.02h,Stop Loss,$-6.00,$317.25,$138429.00,251,$317.25
2024-12-18,15:35:00,22007.75,SELL,1,0.02h,Stop Loss,$-6.00,$311.25,$138423.00,251,$311.25
2024-12-18,15:37:00,22298.0,BUY,1,0.02h,Stop Loss,$27.75,$339.00,$138450.75,251,$339.00
2024-12-18,15:39:00,22016.0,SELL,1,0.02h,Stop Loss,$4.00,$343.00,$138454.75,251,$343.00
2024-12-18,15:49:00,22346.0,BUY,1,0.02h,Stop Loss,$-6.00,$337.00,$138448.75,251,$337.00
2024-12-18,15:50:00,22050.0,SELL,1,0.02h,Stop Loss,$15.25,$352.25,$138464.00,251,$352.25
2024-12-18,15:52:00,22337.0,BUY,1,0.02h,Break Even,$0.25,$352.50,$138464.25,251,$352.50
2024-12-18,15:54:00,22032.75,SELL,1,0.02h,Stop Loss,$-6.00,$346.50,$138458.25,251,$346.50
2024-12-18,15:55:00,22326.25,BUY,1,0.02h,Stop Loss,$34.00,$380.50,$138492.25,251,$380.50
2024-12-18,15:59:00,22031.75,SELL,1,0.02h,Stop Loss,$34.00,$414.50,$138526.25,251,$414.50
2024-12-18,16:10:00,22321.25,BUY,1,0.02h,Stop Loss,$-6.00,$408.50,$138520.25,251,$408.50
2024-12-18,16:11:00,22024.75,SELL,1,0.02h,Stop Loss,$41.50,$450.00,$138561.75,251,$450.00
2024-12-18,16:17:00,22288.25,BUY,1,0.02h,Stop Loss,$-6.00,$444.00,$138555.75,251,$444.00
2024-12-18,16:21:00,21964.5,SELL,1,0.02h,Stop Loss,$-6.00,$438.00,$138549.75,251,$438.00
2024-12-18,16:22:00,22252.5,BUY,1,0.02h,Stop Loss,$-6.00,$432.00,$138543.75,251,$432.00
2024-12-18,16:23:00,21961.5,SELL,1,0.02h,Stop Loss,$-6.00,$426.00,$138537.75,251,$426.00
2024-12-18,16:24:00,22261.25,BUY,1,0.02h,Stop Loss,$15.25,$441.25,$138553.00,251,$441.25
2024-12-18,16:31:00,22013.75,SELL,1,0.02h,Stop Loss,$-6.00,$435.25,$138547.00,251,$435.25
2024-12-18,16:32:00,22308.5,BUY,1,0.02h,Stop Loss,$24.00,$459.25,$138571.00,251,$459.25
2024-12-18,16:38:00,22012.5,SELL,1,0.02h,Break Even,$0.25,$459.50,$138571.25,251,$459.50
2024-12-18,16:41:00,22315.0,BUY,1,0.02h,Stop Loss,$7.75,$467.25,$138579.00,251,$467.25
2024-12-18,16:44:00,22020.5,SELL,1,0.02h,Break Even,$0.25,$467.50,$138579.25,251,$467.50
2024-12-18,16:49:00,22313.5,BUY,1,0.02h,Stop Loss,$-6.00,$461.50,$138573.25,251,$461.50
2024-12-18,16:52:00,22021.0,SELL,1,0.02h,Stop Loss,$-6.00,$455.50,$138567.25,251,$455.50
2024-12-18,16:53:00,22323.25,BUY,1,0.02h,Stop Loss,$5.25,$460.75,$138572.50,251,$460.75
2024-12-18,16:56:00,22018.0,SELL,1,0.02h,Stop Loss,$-6.00,$454.75,$138566.50,251,$454.75
2024-12-18,16:57:00,22309.5,BUY,1,0.02h,Stop Loss,$-6.00,$448.75,$138560.50,251,$448.75
2024-12-18,16:59:00,22011.5,SELL,1,0.02h,Stop Loss,$-6.00,$442.75,$138554.50,251,$442.75
2024-12-18,17:00:00,22305.0,BUY,1,0.02h,Stop Loss,$-6.00,$436.75,$138548.50,251,$436.75
2024-12-18,17:03:00,22003.75,SELL,1,0.02h,Break Even,$0.25,$437.00,$138548.75,251,$437.00
2024-12-18,17:07:00,22305.5,BUY,1,0.02h,Stop Loss,$15.25,$452.25,$138564.00,251,$452.25
2024-12-18,17:13:00,22005.0,SELL,1,0.02h,Stop Loss,$20.25,$472.50,$138584.25,251,$472.50
2024-12-18,17:17:00,22296.25,BUY,1,0.02h,Stop Loss,$41.50,$514.00,$138625.75,251,$514.00
2024-12-18,17:21:00,22016.25,SELL,1,0.02h,Break Even,$0.25,$514.25,$138626.00,251,$514.25
2024-12-18,17:30:00,22299.5,BUY,1,0.02h,Stop Loss,$-6.00,$508.25,$138620.00,251,$508.25
2024-12-18,17:31:00,22001.0,SELL,1,0.02h,Stop Loss,$-6.00,$502.25,$138614.00,251,$502.25
2024-12-18,17:32:00,22290.75,BUY,1,0.02h,Break Even,$0.25,$502.50,$138614.25,251,$502.50
2024-12-18,17:34:00,21996.5,SELL,1,0.02h,Stop Loss,$-6.00,$496.50,$138608.25,251,$496.50
2024-12-18,17:35:00,22296.5,BUY,1,0.02h,Stop Loss,$-6.00,$490.50,$138602.25,251,$490.50
2024-12-18,17:36:00,22010.0,SELL,1,0.02h,Stop Loss,$-6.00,$484.50,$138596.25,251,$484.50
2024-12-18,17:38:00,22305.25,BUY,1,0.02h,Stop Loss,$-6.00,$478.50,$138590.25,251,$478.50
2024-12-18,17:39:00,21997.75,SELL,1,0.02h,Stop Loss,$29.00,$507.50,$138619.25,251,$507.50
2024-12-18,17:54:00,22293.5,BUY,1,0.02h,Stop Loss,$-6.00,$501.50,$138613.25,251,$501.50
2024-12-18,17:55:00,22004.25,SELL,1,0.02h,Break Even,$0.25,$501.75,$138613.50,251,$501.75
2024-12-18,17:57:00,22301.0,BUY,1,0.02h,Break Even,$0.25,$502.00,$138613.75,251,$502.00
2024-12-18,18:03:00,21999.75,SELL,1,0.02h,Stop Loss,$-6.00,$496.00,$138607.75,251,$496.00
2024-12-18,18:04:00,22300.0,BUY,1,0.02h,Break Even,$0.25,$496.25,$138608.00,251,$496.25
2024-12-18,18:10:00,22012.25,SELL,1,0.02h,Stop Loss,$-6.00,$490.25,$138602.00,251,$490.25
2024-12-18,18:11:00,22306.25,BUY,1,0.02h,Stop Loss,$-6.00,$484.25,$138596.00,251,$484.25
2024-12-18,18:18:00,22006.25,SELL,1,0.02h,Break Even,$0.25,$484.50,$138596.25,251,$484.50
2024-12-18,18:24:00,22307.5,BUY,1,0.02h,Stop Loss,$-6.00,$478.50,$138590.25,251,$478.50
2024-12-18,18:25:00,22012.0,SELL,1,0.02h,Stop Loss,$-6.00,$472.50,$138584.25,251,$472.50
2024-12-18,18:26:00,22301.0,BUY,1,0.02h,Stop Loss,$-6.00,$466.50,$138578.25,251,$466.50
2024-12-18,18:27:00,22005.0,SELL,1,0.02h,Break Even,$0.25,$466.75,$138578.50,251,$466.75
2024-12-18,18:31:00,22290.5,BUY,1,0.02h,Stop Loss,$24.00,$490.75,$138602.50,251,$490.75
2024-12-18,18:41:00,21988.5,SELL,1,0.02h,Stop Loss,$-6.00,$484.75,$138596.50,251,$484.75
2024-12-18,18:42:00,22279.75,BUY,1,0.02h,Stop Loss,$-6.00,$478.75,$138590.50,251,$478.75
2024-12-18,18:43:00,21983.0,SELL,1,0.02h,Stop Loss,$-6.00,$472.75,$138584.50,251,$472.75
2024-12-18,18:44:00,22277.0,BUY,1,0.02h,Break Even,$0.25,$473.00,$138584.75,251,$473.00
2024-12-18,18:46:00,21980.75,SELL,1,0.02h,Stop Loss,$-6.00,$467.00,$138578.75,251,$467.00
2024-12-18,18:47:00,22278.25,BUY,1,0.02h,Stop Loss,$16.50,$483.50,$138595.25,251,$483.50
2024-12-18,18:49:00,21993.75,SELL,1,0.02h,Stop Loss,$-6.00,$477.50,$138589.25,251,$477.50
2024-12-18,18:50:00,22285.5,BUY,1,0.02h,Stop Loss,$-6.00,$471.50,$138583.25,251,$471.50
2024-12-18,18:51:00,21991.0,SELL,1,0.02h,Break Even,$0.25,$471.75,$138583.50,251,$471.75
2024-12-18,19:02:00,22229.75,BUY,1,0.02h,Stop Loss,$-6.00,$465.75,$138577.50,251,$465.75
2024-12-18,19:03:00,21963.25,SELL,1,0.02h,Stop Loss,$130.25,$596.00,$138707.75,251,$596.00
2024-12-18,19:15:00,22119.0,BUY,1,0.02h,Stop Loss,$44.00,$640.00,$138751.75,251,$640.00
2024-12-18,19:20:00,21807.75,SELL,1,0.02h,Stop Loss,$-6.00,$634.00,$138745.75,251,$634.00
2024-12-18,19:22:00,22136.25,BUY,1,0.02h,Stop Loss,$102.75,$736.75,$138848.50,251,$736.75
2024-12-18,19:26:00,21860.25,SELL,1,0.02h,Stop Loss,$-6.00,$730.75,$138842.50,251,$730.75
2024-12-18,19:27:00,22137.75,BUY,1,0.02h,Stop Loss,$-6.00,$724.75,$138836.50,251,$724.75
2024-12-18,19:28:00,21842.75,SELL,1,0.02h,Stop Loss,$-6.00,$718.75,$138830.50,251,$718.75
2024-12-18,19:44:00,22050.5,BUY,1,0.02h,Stop Loss,$-6.00,$712.75,$138824.50,251,$712.75
2024-12-18,19:45:00,21758.0,SELL,1,0.02h,Stop Loss,$-6.00,$706.75,$138818.50,251,$706.75
2024-12-18,20:15:00,21832.5,BUY,1,0.02h,Stop Loss,$-6.00,$700.75,$138812.50,251,$700.75
2024-12-18,20:16:00,21512.0,SELL,1,0.02h,Stop Loss,$19.00,$719.75,$138831.50,251,$719.75
2024-12-18,20:54:00,21647.0,BUY,1,0.02h,Stop Loss,$196.50,$916.25,$139028.00,251,$916.25
2024-12-18,20:59:00,21276.75,SELL,1,0.02h,Stop Loss,$412.75,$1329.00,$139440.75,251,$1329.00
2024-12-18,21:17:00,21453.5,BUY,1,0.02h,Break Even,$0.25,$1329.25,$139441.00,251,$1329.25
2024-12-18,21:20:00,21142.5,SELL,1,0.02h,Stop Loss,$-6.00,$1323.25,$139435.00,251,$1323.25
2024-12-18,21:21:00,21437.5,BUY,1,0.02h,Stop Loss,$-6.00,$1317.25,$139429.00,251,$1317.25
2024-12-18,21:22:00,21179.5,SELL,1,0.02h,Stop Loss,$-6.00,$1311.25,$139423.00,251,$1311.25
2024-12-18,21:25:00,21479.25,BUY,1,0.02h,Break Even,$0.25,$1311.50,$139423.25,251,$1311.50
2024-12-18,21:29:00,21168.75,SELL,1,0.02h,Stop Loss,$-6.00,$1305.50,$139417.25,251,$1305.50
2024-12-18,21:30:00,21456.0,BUY,1,0.02h,Stop Loss,$-6.00,$1299.50,$139411.25,251,$1299.50
2024-12-18,21:31:00,21181.5,SELL,1,0.02h,Stop Loss,$85.25,$1384.75,$139496.50,251,$1384.75
2024-12-18,21:43:00,21422.5,BUY,1,0.02h,Stop Loss,$-6.00,$1378.75,$139490.50,251,$1378.75
2024-12-18,21:44:00,21152.5,SELL,1,0.02h,Stop Loss,$-6.00,$1372.75,$139484.50,251,$1372.75
2024-12-18,21:49:00,21448.0,BUY,1,0.02h,Stop Loss,$79.00,$1451.75,$139563.50,251,$1451.75
2024-12-18,21:56:00,21184.0,SELL,1,0.02h,Stop Loss,$-6.00,$1445.75,$139557.50,251,$1445.75
2024-12-18,21:57:00,21466.5,BUY,1,0.02h,Stop Loss,$11.50,$1457.25,$139569.00,251,$1457.25
2024-12-18,22:00:00,21186.0,SELL,1,14.00h,Stop Loss,$-6.00,$1451.25,$139563.00,251,$1451.25
Final P&L Day: 1451.25,,,,,,,,,,,
2024-12-19,12:00:00,21575.25,BUY,1,0.02h,Stop Loss,$37.75,$37.75,$139600.75,252,$37.75
2024-12-19,12:19:00,21358.25,SELL,1,0.02h,Stop Loss,$11.50,$49.25,$139612.25,252,$49.25
2024-12-19,12:24:00,21656.25,BUY,1,0.02h,Stop Loss,$4.00,$53.25,$139616.25,252,$53.25
2024-12-19,12:37:00,21375.0,SELL,1,0.02h,Stop Loss,$27.75,$81.00,$139644.00,252,$81.00
2024-12-19,12:46:00,21665.0,BUY,1,0.02h,Stop Loss,$-6.00,$75.00,$139638.00,252,$75.00
2024-12-19,12:58:00,21397.5,SELL,1,0.02h,Break Even,$0.25,$75.25,$139638.25,252,$75.25
2024-12-19,13:03:00,21678.0,BUY,1,0.02h,Break Even,$0.25,$75.50,$139638.50,252,$75.50
2024-12-19,13:12:00,21392.0,SELL,1,0.02h,Stop Loss,$-6.00,$69.50,$139632.50,252,$69.50
2024-12-19,13:13:00,21671.5,BUY,1,0.02h,Break Even,$0.25,$69.75,$139632.75,252,$69.75
2024-12-19,13:15:00,21399.0,SELL,1,0.02h,Break Even,$0.25,$70.00,$139633.00,252,$70.00
2024-12-19,13:23:00,21671.5,BUY,1,0.02h,Stop Loss,$-6.00,$64.00,$139627.00,252,$64.00
2024-12-19,13:24:00,21397.0,SELL,1,0.02h,Break Even,$0.25,$64.25,$139627.25,252,$64.25
2024-12-19,13:35:00,21659.0,BUY,1,0.02h,Stop Loss,$-6.00,$58.25,$139621.25,252,$58.25
2024-12-19,13:41:00,21391.75,SELL,1,0.02h,Stop Loss,$70.25,$128.50,$139691.50,252,$128.50
2024-12-19,13:44:00,21649.25,BUY,1,0.02h,Stop Loss,$-6.00,$122.50,$139685.50,252,$122.50
2024-12-19,13:45:00,21362.5,SELL,1,0.02h,Stop Loss,$-6.00,$116.50,$139679.50,252,$116.50
2024-12-19,13:46:00,21638.0,BUY,1,0.02h,Stop Loss,$-6.00,$110.50,$139673.50,252,$110.50
2024-12-19,13:47:00,21367.25,SELL,1,0.02h,Break Even,$0.25,$110.75,$139673.75,252,$110.75
2024-12-19,13:50:00,21649.0,BUY,1,0.02h,Stop Loss,$-6.00,$104.75,$139667.75,252,$104.75
2024-12-19,14:03:00,21341.5,SELL,1,0.02h,Stop Loss,$10.25,$115.00,$139678.00,252,$115.00
2024-12-19,14:09:00,21651.0,BUY,1,0.02h,Stop Loss,$6.50,$121.50,$139684.50,252,$121.50
2024-12-19,14:17:00,21374.0,SELL,1,0.02h,Stop Loss,$-6.00,$115.50,$139678.50,252,$115.50
2024-12-19,14:23:00,21661.25,BUY,1,0.02h,Stop Loss,$-6.00,$109.50,$139672.50,252,$109.50
2024-12-19,14:25:00,21379.5,SELL,1,0.02h,Break Even,$0.25,$109.75,$139672.75,252,$109.75
2024-12-19,14:33:00,21647.25,BUY,1,0.02h,Stop Loss,$189.00,$298.75,$139861.75,252,$298.75
2024-12-19,14:41:00,21334.75,SELL,1,0.02h,Stop Loss,$106.50,$405.25,$139968.25,252,$405.25
2024-12-19,14:50:00,21603.75,BUY,1,0.02h,Stop Loss,$62.75,$468.00,$140031.00,252,$468.00
2024-12-19,14:54:00,21325.5,SELL,1,0.02h,Stop Loss,$-6.00,$462.00,$140025.00,252,$462.00
2024-12-19,14:58:00,21592.0,BUY,1,0.02h,Break Even,$0.25,$462.25,$140025.25,252,$462.25
2024-12-19,15:03:00,21304.5,SELL,1,0.02h,Stop Loss,$25.25,$487.50,$140050.50,252,$487.50
2024-12-19,15:12:00,21593.25,BUY,1,0.02h,Stop Loss,$-6.00,$481.50,$140044.50,252,$481.50
2024-12-19,15:13:00,21323.5,SELL,1,0.02h,Stop Loss,$-6.00,$475.50,$140038.50,252,$475.50
2024-12-19,15:15:00,21629.75,BUY,1,0.02h,Stop Loss,$-6.00,$469.50,$140032.50,252,$469.50
2024-12-19,15:16:00,21335.5,SELL,1,0.02h,Stop Loss,$39.00,$508.50,$140071.50,252,$508.50
2024-12-19,15:22:00,21587.75,BUY,1,0.02h,Break Even,$0.25,$508.75,$140071.75,252,$508.75
2024-12-19,15:24:00,21273.25,SELL,1,0.02h,Stop Loss,$24.00,$532.75,$140095.75,252,$532.75
2024-12-19,15:33:00,21507.75,BUY,1,0.02h,Stop Loss,$30.25,$563.00,$140126.00,252,$563.00
2024-12-19,15:35:00,21217.0,SELL,1,0.02h,Stop Loss,$14.00,$577.00,$140140.00,252,$577.00
2024-12-19,15:38:00,21515.5,BUY,1,0.02h,Stop Loss,$81.50,$658.50,$140221.50,252,$658.50
2024-12-19,15:44:00,21274.0,SELL,1,0.02h,Stop Loss,$19.00,$677.50,$140240.50,252,$677.50
2024-12-19,15:51:00,21576.5,BUY,1,0.02h,Stop Loss,$-6.00,$671.50,$140234.50,252,$671.50
2024-12-19,15:52:00,21280.75,SELL,1,0.02h,Stop Loss,$92.75,$764.25,$140327.25,252,$764.25
2024-12-19,15:57:00,21513.5,BUY,1,0.02h,Stop Loss,$70.25,$834.50,$140397.50,252,$834.50
2024-12-19,16:03:00,21233.0,SELL,1,0.02h,Break Even,$0.25,$834.75,$140397.75,252,$834.75
2024-12-19,16:08:00,21478.5,BUY,1,0.02h,Stop Loss,$-6.00,$828.75,$140391.75,252,$828.75
2024-12-19,16:09:00,21204.5,SELL,1,0.02h,Stop Loss,$-6.00,$822.75,$140385.75,252,$822.75
2024-12-19,16:10:00,21473.75,BUY,1,0.02h,Stop Loss,$-6.00,$816.75,$140379.75,252,$816.75
2024-12-19,16:11:00,21206.75,SELL,1,0.02h,Stop Loss,$36.50,$853.25,$140416.25,252,$853.25
2024-12-19,16:14:00,21480.0,BUY,1,0.02h,Stop Loss,$-6.00,$847.25,$140410.25,252,$847.25
2024-12-19,16:15:00,21211.0,SELL,1,0.02h,Stop Loss,$-6.00,$841.25,$140404.25,252,$841.25
2024-12-19,16:16:00,21508.25,BUY,1,0.02h,Stop Loss,$-6.00,$835.25,$140398.25,252,$835.25
2024-12-19,16:17:00,21234.0,SELL,1,0.02h,Break Even,$0.25,$835.50,$140398.50,252,$835.50
2024-12-19,16:22:00,21547.25,BUY,1,0.02h,Stop Loss,$-6.00,$829.50,$140392.50,252,$829.50
2024-12-19,16:24:00,21324.5,SELL,1,0.02h,Stop Loss,$21.50,$851.00,$140414.00,252,$851.00
2024-12-19,16:30:00,21602.0,BUY,1,0.02h,Stop Loss,$-6.00,$845.00,$140408.00,252,$845.00
2024-12-19,16:46:00,21303.25,SELL,1,0.02h,Break Even,$0.25,$845.25,$140408.25,252,$845.25
2024-12-19,16:48:00,21596.5,BUY,1,0.02h,Stop Loss,$-6.00,$839.25,$140402.25,252,$839.25
2024-12-19,16:49:00,21320.0,SELL,1,0.02h,Break Even,$0.25,$839.50,$140402.50,252,$839.50
2024-12-19,16:54:00,21552.5,BUY,1,0.02h,Stop Loss,$9.00,$848.50,$140411.50,252,$848.50
2024-12-19,17:01:00,21287.25,SELL,1,0.02h,Stop Loss,$-6.00,$842.50,$140405.50,252,$842.50
2024-12-19,17:02:00,21550.25,BUY,1,0.02h,Stop Loss,$65.25,$907.75,$140470.75,252,$907.75
2024-12-19,17:12:00,21262.5,SELL,1,0.02h,Break Even,$0.25,$908.00,$140471.00,252,$908.00
2024-12-19,17:21:00,21502.0,BUY,1,0.02h,Break Even,$0.25,$908.25,$140471.25,252,$908.25
2024-12-19,17:23:00,21207.75,SELL,1,0.02h,Stop Loss,$-6.00,$902.25,$140465.25,252,$902.25
2024-12-19,17:25:00,21485.5,BUY,1,0.02h,Break Even,$0.25,$902.50,$140465.50,252,$902.50
2024-12-19,17:27:00,21205.75,SELL,1,0.02h,Stop Loss,$-6.00,$896.50,$140459.50,252,$896.50
2024-12-19,17:30:00,21457.5,BUY,1,0.02h,Stop Loss,$75.25,$971.75,$140534.75,252,$971.75
2024-12-19,17:32:00,21177.75,SELL,1,0.02h,Stop Loss,$-6.00,$965.75,$140528.75,252,$965.75
2024-12-19,17:35:00,21455.0,BUY,1,0.02h,Stop Loss,$39.00,$1004.75,$140567.75,252,$1004.75
2024-12-19,17:38:00,21182.75,SELL,1,0.02h,Break Even,$0.25,$1005.00,$140568.00,252,$1005.00
2024-12-19,17:58:00,21508.0,BUY,1,0.02h,Stop Loss,$32.75,$1037.75,$140600.75,252,$1037.75
2024-12-19,18:05:00,21182.75,SELL,1,0.02h,Stop Loss,$-6.00,$1031.75,$140594.75,252,$1031.75
2024-12-19,18:06:00,21453.5,BUY,1,0.02h,Break Even,$0.25,$1032.00,$140595.00,252,$1032.00
2024-12-19,18:08:00,21212.75,SELL,1,0.02h,Stop Loss,$-6.00,$1026.00,$140589.00,252,$1026.00
2024-12-19,18:09:00,21482.0,BUY,1,0.02h,Stop Loss,$64.00,$1090.00,$140653.00,252,$1090.00
2024-12-19,18:15:00,21249.25,SELL,1,0.02h,Stop Loss,$81.50,$1171.50,$140734.50,252,$1171.50
2024-12-19,18:17:00,21513.0,BUY,1,0.02h,Break Even,$0.25,$1171.75,$140734.75,252,$1171.75
2024-12-19,18:22:00,21229.75,SELL,1,0.02h,Stop Loss,$-6.00,$1165.75,$140728.75,252,$1165.75
2024-12-19,18:23:00,21482.5,BUY,1,0.02h,Stop Loss,$-6.00,$1159.75,$140722.75,252,$1159.75
2024-12-19,18:24:00,21239.25,SELL,1,0.02h,Stop Loss,$-6.00,$1153.75,$140716.75,252,$1153.75
2024-12-19,18:25:00,21514.5,BUY,1,0.02h,Stop Loss,$-6.00,$1147.75,$140710.75,252,$1147.75
2024-12-19,18:26:00,21245.75,SELL,1,0.02h,Stop Loss,$-6.00,$1141.75,$140704.75,252,$1141.75
2024-12-19,18:28:00,21525.0,BUY,1,0.02h,Stop Loss,$-6.00,$1135.75,$140698.75,252,$1135.75
2024-12-19,18:29:00,21260.25,SELL,1,0.02h,Stop Loss,$-6.00,$1129.75,$140692.75,252,$1129.75
2024-12-19,18:30:00,21530.0,BUY,1,0.02h,Stop Loss,$-6.00,$1123.75,$140686.75,252,$1123.75
2024-12-19,18:32:00,21247.5,SELL,1,0.02h,Stop Loss,$-6.00,$1117.75,$140680.75,252,$1117.75
2024-12-19,18:33:00,21527.5,BUY,1,0.02h,Stop Loss,$11.50,$1129.25,$140692.25,252,$1129.25
2024-12-19,18:36:00,21259.5,SELL,1,0.02h,Stop Loss,$-6.00,$1123.25,$140686.25,252,$1123.25
2024-12-19,18:37:00,21522.75,BUY,1,0.02h,Stop Loss,$24.00,$1147.25,$140710.25,252,$1147.25
2024-12-19,18:44:00,21264.5,SELL,1,0.02h,Stop Loss,$-6.00,$1141.25,$140704.25,252,$1141.25
2024-12-19,18:45:00,21526.0,BUY,1,0.02h,Stop Loss,$-6.00,$1135.25,$140698.25,252,$1135.25
2024-12-19,18:46:00,21264.0,SELL,1,0.02h,Break Even,$0.25,$1135.50,$140698.50,252,$1135.50
2024-12-19,18:53:00,21549.0,BUY,1,0.02h,Stop Loss,$-6.00,$1129.50,$140692.50,252,$1129.50
2024-12-19,18:54:00,21275.5,SELL,1,0.02h,Stop Loss,$51.50,$1181.00,$140744.00,252,$1181.00
2024-12-19,18:59:00,21584.5,BUY,1,0.02h,Stop Loss,$60.25,$1241.25,$140804.25,252,$1241.25
2024-12-19,19:17:00,21247.0,SELL,1,0.02h,Stop Loss,$-6.00,$1235.25,$140798.25,252,$1235.25
2024-12-19,19:18:00,21508.0,BUY,1,0.02h,Stop Loss,$-6.00,$1229.25,$140792.25,252,$1229.25
2024-12-19,19:19:00,21243.0,SELL,1,0.02h,Stop Loss,$-6.00,$1223.25,$140786.25,252,$1223.25
2024-12-19,19:21:00,21501.75,BUY,1,0.02h,Stop Loss,$-6.00,$1217.25,$140780.25,252,$1217.25
2024-12-19,19:22:00,21229.0,SELL,1,0.02h,Stop Loss,$17.75,$1235.00,$140798.00,252,$1235.00
2024-12-19,19:34:00,21487.5,BUY,1,0.02h,Break Even,$0.25,$1235.25,$140798.25,252,$1235.25
2024-12-19,19:38:00,21207.75,SELL,1,0.02h,Stop Loss,$15.25,$1250.50,$140813.50,252,$1250.50
2024-12-19,19:50:00,21478.0,BUY,1,0.02h,Stop Loss,$-6.00,$1244.50,$140807.50,252,$1244.50
2024-12-19,19:51:00,21218.25,SELL,1,0.02h,Stop Loss,$-6.00,$1238.50,$140801.50,252,$1238.50
2024-12-19,19:52:00,21498.0,BUY,1,0.02h,Stop Loss,$-6.00,$1232.50,$140795.50,252,$1232.50
2024-12-19,19:53:00,21223.25,SELL,1,0.02h,Stop Loss,$6.50,$1239.00,$140802.00,252,$1239.00
2024-12-19,19:55:00,21485.5,BUY,1,0.02h,Stop Loss,$55.25,$1294.25,$140857.25,252,$1294.25
2024-12-19,19:59:00,21205.25,SELL,1,0.02h,Stop Loss,$-6.00,$1288.25,$140851.25,252,$1288.25
2024-12-19,20:00:00,21462.25,BUY,1,0.02h,Stop Loss,$61.50,$1349.75,$140912.75,252,$1349.75
2024-12-19,20:03:00,21192.25,SELL,1,0.02h,Stop Loss,$5.25,$1355.00,$140918.00,252,$1355.00
2024-12-19,20:11:00,21446.0,BUY,1,0.02h,Break Even,$0.25,$1355.25,$140918.25,252,$1355.25
2024-12-19,20:13:00,21180.75,SELL,1,0.02h,Stop Loss,$-6.00,$1349.25,$140912.25,252,$1349.25
2024-12-19,20:14:00,21454.75,BUY,1,0.02h,Stop Loss,$-6.00,$1343.25,$140906.25,252,$1343.25
2024-12-19,20:15:00,21198.0,SELL,1,0.02h,Stop Loss,$-6.00,$1337.25,$140900.25,252,$1337.25
2024-12-19,20:16:00,21479.0,BUY,1,0.02h,Stop Loss,$-6.00,$1331.25,$140894.25,252,$1331.25
2024-12-19,20:17:00,21206.5,SELL,1,0.02h,Stop Loss,$-6.00,$1325.25,$140888.25,252,$1325.25
2024-12-19,20:24:00,21516.5,BUY,1,0.02h,Stop Loss,$57.75,$1383.00,$140946.00,252,$1383.00
2024-12-19,20:28:00,21227.0,SELL,1,0.02h,Stop Loss,$-6.00,$1377.00,$140940.00,252,$1377.00
2024-12-19,20:29:00,21499.5,BUY,1,0.02h,Stop Loss,$-6.00,$1371.00,$140934.00,252,$1371.00
2024-12-19,20:30:00,21222.25,SELL,1,0.02h,Stop Loss,$-6.00,$1365.00,$140928.00,252,$1365.00
2024-12-19,20:31:00,21505.5,BUY,1,0.02h,Break Even,$0.25,$1365.25,$140928.25,252,$1365.25
2024-12-19,20:35:00,21173.75,SELL,1,0.02h,Stop Loss,$130.25,$1495.50,$141058.50,252,$1495.50
2024-12-19,20:39:00,21461.75,BUY,1,0.02h,Stop Loss,$-6.00,$1489.50,$141052.50,252,$1489.50
2024-12-19,20:40:00,21211.75,SELL,1,0.02h,Stop Loss,$-6.00,$1483.50,$141046.50,252,$1483.50
2024-12-19,20:41:00,21464.5,BUY,1,0.02h,Stop Loss,$-6.00,$1477.50,$141040.50,252,$1477.50
2024-12-19,20:42:00,21221.25,SELL,1,0.02h,Break Even,$0.25,$1477.75,$141040.75,252,$1477.75
2024-12-19,20:46:00,21438.75,BUY,1,0.02h,Stop Loss,$127.75,$1605.50,$141168.50,252,$1605.50
2024-12-19,20:52:00,21115.25,SELL,1,0.02h,Stop Loss,$-6.00,$1599.50,$141162.50,252,$1599.50
2024-12-19,21:04:00,21391.25,BUY,1,0.02h,Stop Loss,$9.00,$1608.50,$141171.50,252,$1608.50
2024-12-19,21:06:00,21113.5,SELL,1,0.02h,Stop Loss,$-6.00,$1602.50,$141165.50,252,$1602.50
2024-12-19,21:07:00,21382.0,BUY,1,0.02h,Stop Loss,$-6.00,$1596.50,$141159.50,252,$1596.50
2024-12-19,21:08:00,21117.5,SELL,1,0.02h,Break Even,$0.25,$1596.75,$141159.75,252,$1596.75
2024-12-19,21:13:00,21373.25,BUY,1,0.02h,Stop Loss,$-6.00,$1590.75,$141153.75,252,$1590.75
2024-12-19,21:14:00,21095.0,SELL,1,0.02h,Stop Loss,$-6.00,$1584.75,$141147.75,252,$1584.75
2024-12-19,21:16:00,21356.0,BUY,1,0.02h,Break Even,$0.25,$1585.00,$141148.00,252,$1585.00
2024-12-19,21:18:00,21088.25,SELL,1,0.02h,Stop Loss,$-6.00,$1579.00,$141142.00,252,$1579.00
2024-12-19,21:19:00,21377.25,BUY,1,0.02h,Stop Loss,$-6.00,$1573.00,$141136.00,252,$1573.00
2024-12-19,21:20:00,21095.75,SELL,1,0.02h,Break Even,$0.25,$1573.25,$141136.25,252,$1573.25
2024-12-19,21:24:00,21386.25,BUY,1,0.02h,Stop Loss,$-6.00,$1567.25,$141130.25,252,$1567.25
2024-12-19,21:25:00,21110.25,SELL,1,0.02h,Stop Loss,$-6.00,$1561.25,$141124.25,252,$1561.25
2024-12-19,21:26:00,21376.5,BUY,1,0.02h,Stop Loss,$-6.00,$1555.25,$141118.25,252,$1555.25
2024-12-19,21:27:00,21114.25,SELL,1,0.02h,Break Even,$0.25,$1555.50,$141118.50,252,$1555.50
2024-12-19,21:29:00,21385.75,BUY,1,0.02h,Stop Loss,$-6.00,$1549.50,$141112.50,252,$1549.50
2024-12-19,21:30:00,21115.75,SELL,1,0.02h,Stop Loss,$-6.00,$1543.50,$141106.50,252,$1543.50
2024-12-19,21:31:00,21392.5,BUY,1,0.02h,Stop Loss,$-6.00,$1537.50,$141100.50,252,$1537.50
2024-12-19,21:32:00,21126.75,SELL,1,0.02h,Stop Loss,$-6.00,$1531.50,$141094.50,252,$1531.50
2024-12-19,21:33:00,21395.25,BUY,1,0.02h,Stop Loss,$-6.00,$1525.50,$141088.50,252,$1525.50
2024-12-19,21:34:00,21131.25,SELL,1,0.02h,Stop Loss,$-6.00,$1519.50,$141082.50,252,$1519.50
2024-12-19,21:36:00,21400.75,BUY,1,0.02h,Stop Loss,$-6.00,$1513.50,$141076.50,252,$1513.50
2024-12-19,21:57:00,21140.0,SELL,1,0.02h,Stop Loss,$20.25,$1533.75,$141096.75,252,$1533.75
Final P&L Day: 1533.75,,,,,,,,,,,
2024-12-20,12:31:00,21019.25,BUY,1,0.02h,Stop Loss,$7.75,$7.75,$141104.50,253,$7.75
2024-12-20,12:34:00,20781.75,SELL,1,0.02h,Stop Loss,$-6.00,$1.75,$141098.50,253,$1.75
2024-12-20,12:35:00,21037.75,BUY,1,0.02h,Stop Loss,$55.25,$57.00,$141153.75,253,$57.00
2024-12-20,12:37:00,20780.0,SELL,1,0.02h,Stop Loss,$14.00,$71.00,$141167.75,253,$71.00
2024-12-20,12:41:00,21049.25,BUY,1,0.02h,Stop Loss,$50.25,$121.25,$141218.00,253,$121.25
2024-12-20,12:43:00,20803.5,SELL,1,0.02h,Stop Loss,$-6.00,$115.25,$141212.00,253,$115.25
2024-12-20,12:44:00,21066.75,BUY,1,0.02h,Stop Loss,$56.50,$171.75,$141268.50,253,$171.75
2024-12-20,12:47:00,20829.75,SELL,1,0.02h,Stop Loss,$77.75,$249.50,$141346.25,253,$249.50
2024-12-20,12:50:00,21073.75,BUY,1,0.02h,Break Even,$0.25,$249.75,$141346.50,253,$249.75
2024-12-20,12:59:00,20837.25,SELL,1,0.02h,Stop Loss,$6.50,$256.25,$141353.00,253,$256.25
2024-12-20,13:07:00,21091.0,BUY,1,0.02h,Stop Loss,$-6.00,$250.25,$141347.00,253,$250.25
2024-12-20,13:08:00,20829.0,SELL,1,0.02h,Stop Loss,$-6.00,$244.25,$141341.00,253,$244.25
2024-12-20,13:09:00,21086.75,BUY,1,0.02h,Stop Loss,$35.25,$279.50,$141376.25,253,$279.50
2024-12-20,13:28:00,20834.0,SELL,1,0.02h,Stop Loss,$-6.00,$273.50,$141370.25,253,$273.50
2024-12-20,13:35:00,21188.5,BUY,1,0.02h,Stop Loss,$75.25,$348.75,$141445.50,253,$348.75
2024-12-20,13:46:00,20922.0,SELL,1,0.02h,Stop Loss,$-6.00,$342.75,$141439.50,253,$342.75
2024-12-20,13:49:00,21218.5,BUY,1,0.02h,Break Even,$0.25,$343.00,$141439.75,253,$343.00
2024-12-20,14:00:00,20956.5,SELL,1,0.02h,Stop Loss,$130.25,$473.25,$141570.00,253,$473.25
2024-12-20,14:05:00,21202.25,BUY,1,0.02h,Stop Loss,$31.50,$504.75,$141601.50,253,$504.75
2024-12-20,14:14:00,20946.0,SELL,1,0.02h,Stop Loss,$-6.00,$498.75,$141595.50,253,$498.75
2024-12-20,14:21:00,21228.0,BUY,1,0.02h,Stop Loss,$36.50,$535.25,$141632.00,253,$535.25
2024-12-20,14:24:00,20937.5,SELL,1,0.02h,Stop Loss,$7.75,$543.00,$141639.75,253,$543.00
2024-12-20,14:30:00,21212.0,BUY,1,0.02h,Stop Loss,$55.25,$598.25,$141695.00,253,$598.25
2024-12-20,17:35:00,21756.5,SELL,1,0.02h,Stop Loss,$10.25,$608.50,$141705.25,253,$608.50
2024-12-20,17:39:00,21782.0,BUY,1,0.02h,Stop Loss,$49.00,$657.50,$141754.25,253,$657.50
2024-12-20,17:59:00,21768.25,SELL,1,0.02h,Stop Loss,$39.00,$696.50,$141793.25,253,$696.50
2024-12-20,18:56:00,21708.0,BUY,1,0.02h,Stop Loss,$9.00,$705.50,$141802.25,253,$705.50
2024-12-20,19:01:00,21665.75,SELL,1,0.02h,Stop Loss,$10.25,$715.75,$141812.50,253,$715.75
2024-12-20,19:19:00,21687.0,BUY,1,0.02h,Break Even,$0.25,$716.00,$141812.75,253,$716.00
2024-12-20,19:52:00,21702.0,SELL,1,0.02h,Stop Loss,$10.25,$726.25,$141823.00,253,$726.25
2024-12-20,21:05:00,21609.25,BUY,1,0.02h,Break Even,$0.25,$726.50,$141823.25,253,$726.50
2024-12-20,21:08:00,21569.5,SELL,1,0.02h,Break Even,$0.25,$726.75,$141823.50,253,$726.75
2024-12-20,21:54:00,21547.5,BUY,1,0.02h,Break Even,$0.25,$727.00,$141823.75,253,$727.00
Final P&L Day: 727.00,,,,,,,,,,,
2024-12-23,13:05:00,21646.25,SELL,1,0.02h,Stop Loss,$-6.00,$-6.00,$141817.75,254,$-6.00
2024-12-23,13:08:00,21666.25,BUY,1,0.02h,Stop Loss,$-6.00,$-12.00,$141811.75,254,$-12.00
2024-12-23,13:10:00,21656.0,SELL,1,0.02h,Stop Loss,$-6.00,$-18.00,$141805.75,254,$-18.00
2024-12-23,13:11:00,21660.0,BUY,1,0.02h,Break Even,$0.25,$-17.75,$141806.00,254,$-17.75
2024-12-23,13:12:00,21658.25,SELL,1,0.02h,Stop Loss,$5.25,$-12.50,$141811.25,254,$-12.50
2024-12-23,13:26:00,21661.0,BUY,1,0.02h,Stop Loss,$10.25,$-2.25,$141821.50,254,$-2.25
2024-12-23,13:32:00,21638.0,SELL,1,0.02h,Stop Loss,$35.25,$33.00,$141856.75,254,$33.00
2024-12-23,14:06:00,21591.25,BUY,1,0.02h,Break Even,$0.25,$33.25,$141857.00,254,$33.25
2024-12-23,14:18:00,21583.0,SELL,1,0.02h,Stop Loss,$31.50,$64.75,$141888.50,254,$64.75
2024-12-23,14:22:00,21593.25,BUY,1,0.02h,Stop Loss,$12.75,$77.50,$141901.25,254,$77.50
2024-12-23,14:47:00,21592.25,SELL,1,0.02h,Stop Loss,$-6.00,$71.50,$141895.25,254,$71.50
2024-12-23,15:00:00,21629.75,BUY,1,0.02h,Stop Loss,$55.25,$126.75,$141950.50,254,$126.75
2024-12-23,15:03:00,21583.75,SELL,1,0.02h,Stop Loss,$-6.00,$120.75,$141944.50,254,$120.75
2024-12-23,15:39:00,21584.75,BUY,1,0.02h,Stop Loss,$21.50,$142.25,$141966.00,254,$142.25
2024-12-23,15:49:00,21551.75,SELL,1,0.02h,Stop Loss,$25.25,$167.50,$141991.25,254,$167.50
2024-12-23,15:56:00,21575.75,BUY,1,0.02h,Stop Loss,$50.25,$217.75,$142041.50,254,$217.75
2024-12-23,17:15:00,21671.5,SELL,1,0.02h,Stop Loss,$41.50,$259.25,$142083.00,254,$259.25
2024-12-23,17:29:00,21687.0,BUY,1,0.02h,Break Even,$0.25,$259.50,$142083.25,254,$259.50
2024-12-23,17:30:00,21671.75,SELL,1,0.02h,Break Even,$0.25,$259.75,$142083.50,254,$259.75
2024-12-23,17:33:00,21685.75,BUY,1,0.02h,Stop Loss,$11.50,$271.25,$142095.00,254,$271.25
2024-12-23,17:37:00,21661.5,SELL,1,0.02h,Stop Loss,$-6.00,$265.25,$142089.00,254,$265.25
2024-12-23,17:38:00,21676.75,BUY,1,0.02h,Stop Loss,$50.25,$315.50,$142139.25,254,$315.50
2024-12-23,19:34:00,21752.25,SELL,1,0.02h,Break Even,$0.25,$315.75,$142139.50,254,$315.75
2024-12-23,20:29:00,21707.25,BUY,1,0.02h,Break Even,$0.25,$316.00,$142139.75,254,$316.00
2024-12-23,21:05:00,21723.25,SELL,1,0.02h,Stop Loss,$-6.00,$310.00,$142133.75,254,$310.00
2024-12-23,21:12:00,21749.5,BUY,1,0.02h,Stop Loss,$-6.00,$304.00,$142127.75,254,$304.00
2024-12-23,21:19:00,21741.75,SELL,1,0.02h,Stop Loss,$4.00,$308.00,$142131.75,254,$308.00
2024-12-23,21:20:00,21744.5,BUY,1,0.02h,Stop Loss,$-6.00,$302.00,$142125.75,254,$302.00
2024-12-23,21:22:00,21740.75,SELL,1,0.02h,Stop Loss,$29.00,$331.00,$142154.75,254,$331.00
2024-12-23,21:47:00,21741.5,BUY,1,0.02h,Break Even,$0.25,$331.25,$142155.00,254,$331.25
2024-12-23,21:53:00,21731.0,SELL,1,0.02h,Stop Loss,$-6.00,$325.25,$142149.00,254,$325.25
2024-12-23,21:58:00,21739.5,BUY,1,0.02h,Stop Loss,$-6.00,$319.25,$142143.00,254,$319.25
Final P&L Day: 319.25,,,,,,,,,,,
2024-12-24,12:41:00,21790.5,SELL,1,0.02h,Break Even,$0.25,$0.25,$142143.25,255,$0.25
2024-12-24,12:49:00,21797.0,BUY,1,0.02h,Break Even,$0.25,$0.50,$142143.50,255,$0.50
2024-12-24,13:03:00,21793.75,SELL,1,0.02h,Stop Loss,$-6.00,$-5.50,$142137.50,255,$-5.50
2024-12-24,13:05:00,21794.5,BUY,1,0.02h,Break Even,$0.25,$-5.25,$142137.75,255,$-5.25
2024-12-24,13:19:00,21795.0,SELL,1,0.02h,Break Even,$0.25,$-5.00,$142138.00,255,$-5.00
2024-12-24,13:20:00,21798.0,BUY,1,0.02h,Stop Loss,$-6.00,$-11.00,$142132.00,255,$-11.00
2024-12-24,14:25:00,21824.5,SELL,1,0.02h,Stop Loss,$6.50,$-4.50,$142138.50,255,$-4.50
2024-12-24,14:38:00,21843.5,BUY,1,0.02h,Stop Loss,$21.50,$17.00,$142160.00,255,$17.00
2024-12-24,16:54:00,21964.5,SELL,1,0.02h,Stop Loss,$41.50,$58.50,$142201.50,255,$58.50
2024-12-24,17:13:00,21983.75,BUY,1,0.02h,Break Even,$0.25,$58.75,$142201.75,255,$58.75
2024-12-24,17:35:00,21964.25,SELL,1,0.02h,Stop Loss,$32.75,$91.50,$142234.50,255,$91.50
2024-12-24,17:51:00,21988.25,BUY,1,0.02h,Break Even,$0.25,$91.75,$142234.75,255,$91.75
Final P&L Day: 91.75,,,,,,,,,,,
2024-12-26,12:01:00,21968.75,SELL,1,0.02h,Break Even,$0.25,$0.25,$142235.00,256,$0.25
2024-12-26,12:55:00,21956.75,BUY,1,0.02h,Stop Loss,$-6.00,$-5.75,$142229.00,256,$-5.75
2024-12-26,13:03:00,21945.5,SELL,1,0.02h,Stop Loss,$7.75,$2.00,$142236.75,256,$2.00
2024-12-26,13:08:00,21954.75,BUY,1,0.02h,Stop Loss,$-6.00,$-4.00,$142230.75,256,$-4.00
2024-12-26,13:25:00,21947.0,SELL,1,0.02h,Stop Loss,$16.50,$12.50,$142247.25,256,$12.50
2024-12-26,13:39:00,21955.0,BUY,1,0.02h,Stop Loss,$-6.00,$6.50,$142241.25,256,$6.50
2024-12-26,13:43:00,21935.25,SELL,1,0.02h,Break Even,$0.25,$6.75,$142241.50,256,$6.75
2024-12-26,13:50:00,21953.25,BUY,1,0.02h,Stop Loss,$-6.00,$0.75,$142235.50,256,$0.75
2024-12-26,13:52:00,21946.5,SELL,1,0.02h,Stop Loss,$4.00,$4.75,$142239.50,256,$4.75
2024-12-26,13:54:00,21957.25,BUY,1,0.02h,Break Even,$0.25,$5.00,$142239.75,256,$5.00
2024-12-26,14:21:00,21946.25,SELL,1,0.02h,Stop Loss,$15.25,$20.25,$142255.00,256,$20.25
2024-12-26,14:30:00,21960.75,BUY,1,0.02h,Stop Loss,$110.25,$130.50,$142365.25,256,$130.50
2024-12-26,14:50:00,21953.25,SELL,1,0.02h,Stop Loss,$100.25,$230.75,$142465.50,256,$230.75
2024-12-26,15:04:00,21965.25,BUY,1,0.02h,Stop Loss,$36.50,$267.25,$142502.00,256,$267.25
2024-12-26,15:10:00,21929.5,SELL,1,0.02h,Break Even,$0.25,$267.50,$142502.25,256,$267.50
2024-12-26,15:23:00,21974.25,BUY,1,0.02h,Stop Loss,$6.50,$274.00,$142508.75,256,$274.00
2024-12-26,16:25:00,21989.5,SELL,1,0.02h,Stop Loss,$37.75,$311.75,$142546.50,256,$311.75
2024-12-26,16:35:00,22006.25,BUY,1,0.02h,Stop Loss,$14.00,$325.75,$142560.50,256,$325.75
2024-12-26,17:28:00,22033.0,SELL,1,0.02h,Stop Loss,$29.00,$354.75,$142589.50,256,$354.75
2024-12-26,18:07:00,22020.25,BUY,1,0.02h,Stop Loss,$16.50,$371.25,$142606.00,256,$371.25
2024-12-26,18:15:00,22010.0,SELL,1,0.02h,Break Even,$0.25,$371.50,$142606.25,256,$371.50
2024-12-26,18:16:00,22018.5,BUY,1,0.02h,Stop Loss,$21.50,$393.00,$142627.75,256,$393.00
2024-12-26,18:36:00,22025.25,SELL,1,0.02h,Stop Loss,$21.50,$414.50,$142649.25,256,$414.50
2024-12-26,18:55:00,22027.25,BUY,1,0.02h,Stop Loss,$10.25,$424.75,$142659.50,256,$424.75
2024-12-26,18:58:00,22009.0,SELL,1,0.02h,Break Even,$0.25,$425.00,$142659.75,256,$425.00
2024-12-26,19:28:00,22014.25,BUY,1,0.02h,Stop Loss,$-6.00,$419.00,$142653.75,256,$419.00
2024-12-26,19:37:00,22004.25,SELL,1,0.02h,Break Even,$0.25,$419.25,$142654.00,256,$419.25
2024-12-26,19:39:00,22011.75,BUY,1,0.02h,Stop Loss,$19.00,$438.25,$142673.00,256,$438.25
2024-12-26,20:17:00,22034.5,SELL,1,0.02h,Break Even,$0.25,$438.50,$142673.25,256,$438.50
2024-12-26,20:23:00,22044.5,BUY,1,0.02h,Break Even,$0.25,$438.75,$142673.50,256,$438.75
2024-12-26,20:51:00,22039.75,SELL,1,0.02h,Stop Loss,$20.25,$459.00,$142693.75,256,$459.00
Final P&L Day: 459.00,,,,,,,,,,,
2024-12-27,13:55:00,21914.0,BUY,1,0.02h,Break Even,$0.25,$0.25,$142694.00,257,$0.25
2024-12-27,13:59:00,21904.25,SELL,1,0.02h,Stop Loss,$39.00,$39.25,$142733.00,257,$39.25
2024-12-27,15:43:00,21567.5,BUY,1,0.02h,Stop Loss,$102.75,$142.00,$142835.75,257,$142.00
2024-12-27,16:05:00,21555.75,SELL,1,0.02h,Stop Loss,$26.50,$168.50,$142862.25,257,$168.50
2024-12-27,16:25:00,21573.0,BUY,1,0.02h,Stop Loss,$110.25,$278.75,$142972.50,257,$278.75
2024-12-27,16:45:00,21581.75,SELL,1,0.02h,Break Even,$0.25,$279.00,$142972.75,257,$279.00
2024-12-27,17:31:00,21547.25,BUY,1,0.02h,Stop Loss,$121.50,$400.50,$143094.25,257,$400.50
2024-12-27,17:39:00,21511.5,SELL,1,0.02h,Stop Loss,$-6.00,$394.50,$143088.25,257,$394.50
2024-12-27,17:43:00,21545.75,BUY,1,0.02h,Stop Loss,$27.75,$422.25,$143116.00,257,$422.25
2024-12-27,19:24:00,21639.75,SELL,1,0.02h,Stop Loss,$-6.00,$416.25,$143110.00,257,$416.25
2024-12-27,19:35:00,21665.75,BUY,1,0.02h,Stop Loss,$55.25,$471.50,$143165.25,257,$471.50
2024-12-27,20:06:00,21678.25,SELL,1,0.02h,Stop Loss,$60.25,$531.75,$143225.50,257,$531.75
2024-12-27,20:51:00,21678.25,BUY,1,0.02h,Stop Loss,$126.50,$658.25,$143352.00,257,$658.25
2024-12-27,21:42:00,21716.75,SELL,1,0.02h,Break Even,$0.25,$658.50,$143352.25,257,$658.50
2024-12-27,21:57:00,21722.0,BUY,1,0.02h,Stop Loss,$-6.00,$652.50,$143346.25,257,$652.50
Final P&L Day: 652.50,,,,,,,,,,,
2024-12-30,12:00:00,21646.5,SELL,1,0.02h,Stop Loss,$5.25,$5.25,$143351.50,258,$5.25
2024-12-30,14:07:00,21410.25,BUY,1,0.02h,Break Even,$0.25,$5.50,$143351.75,258,$5.50
2024-12-30,14:25:00,21388.25,SELL,1,0.02h,Stop Loss,$9.00,$14.50,$143360.75,258,$14.50
2024-12-30,14:28:00,21405.25,BUY,1,0.02h,Stop Loss,$36.50,$51.00,$143397.25,258,$51.00
2024-12-30,14:32:00,21392.0,SELL,1,0.02h,Stop Loss,$51.50,$102.50,$143448.75,258,$102.50
2024-12-30,15:14:00,21325.75,BUY,1,0.02h,Stop Loss,$127.75,$230.25,$143576.50,258,$230.25
2024-12-30,15:19:00,21301.0,SELL,1,0.02h,Break Even,$0.25,$230.50,$143576.75,258,$230.50
2024-12-30,15:39:00,21324.0,BUY,1,0.02h,Stop Loss,$211.50,$442.00,$143788.25,258,$442.00
2024-12-30,17:58:00,21508.75,SELL,1,0.02h,Stop Loss,$11.50,$453.50,$143799.75,258,$453.50
2024-12-30,18:00:00,21552.75,BUY,1,0.02h,Break Even,$0.25,$453.75,$143800.00,258,$453.75
2024-12-30,18:01:00,21522.0,SELL,1,0.02h,Break Even,$0.25,$454.00,$143800.25,258,$454.00
2024-12-30,18:02:00,21534.25,BUY,1,0.02h,Break Even,$0.25,$454.25,$143800.50,258,$454.25
2024-12-30,18:03:00,21516.25,SELL,1,0.02h,Stop Loss,$-6.00,$448.25,$143794.50,258,$448.25
2024-12-30,18:11:00,21536.75,BUY,1,0.02h,Stop Loss,$50.25,$498.50,$143844.75,258,$498.50
2024-12-30,18:25:00,21511.0,SELL,1,0.02h,Break Even,$0.25,$498.75,$143845.00,258,$498.75
2024-12-30,18:35:00,21547.0,BUY,1,0.02h,Stop Loss,$36.50,$535.25,$143881.50,258,$535.25
2024-12-30,19:02:00,21536.25,SELL,1,0.02h,Stop Loss,$5.25,$540.50,$143886.75,258,$540.50
2024-12-30,19:32:00,21535.25,BUY,1,0.02h,Stop Loss,$-6.00,$534.50,$143880.75,258,$534.50
2024-12-30,20:06:00,21515.5,SELL,1,0.02h,Stop Loss,$57.75,$592.25,$143938.50,258,$592.25
2024-12-30,20:15:00,21527.25,BUY,1,0.02h,Break Even,$0.25,$592.50,$143938.75,258,$592.50
2024-12-30,20:26:00,21506.75,SELL,1,0.02h,Stop Loss,$32.75,$625.25,$143971.50,258,$625.25
2024-12-30,20:53:00,21493.25,BUY,1,0.02h,Stop Loss,$-6.00,$619.25,$143965.50,258,$619.25
2024-12-30,20:55:00,21466.0,SELL,1,0.02h,Stop Loss,$24.00,$643.25,$143989.50,258,$643.25
2024-12-30,21:46:00,21388.0,BUY,1,0.02h,Stop Loss,$5.25,$648.50,$143994.75,258,$648.50
2024-12-30,22:00:00,21389.0,SELL,1,14.00h,Stop Loss,$-6.00,$642.50,$143988.75,258,$642.50
Final P&L Day: 642.50,,,,,,,,,,,
2024-12-31,12:00:00,21501.75,BUY,1,0.02h,Stop Loss,$20.25,$20.25,$144009.00,259,$20.25
2024-12-31,12:39:00,21500.25,SELL,1,0.02h,Break Even,$0.25,$20.50,$144009.25,259,$20.50
2024-12-31,12:45:00,21507.5,BUY,1,0.02h,Stop Loss,$-6.00,$14.50,$144003.25,259,$14.50
2024-12-31,12:46:00,21502.25,SELL,1,0.02h,Stop Loss,$20.25,$34.75,$144023.50,259,$34.75
2024-12-31,13:16:00,21482.0,BUY,1,0.02h,Stop Loss,$-6.00,$28.75,$144017.50,259,$28.75
2024-12-31,13:22:00,21459.0,SELL,1,0.02h,Stop Loss,$4.00,$32.75,$144021.50,259,$32.75
2024-12-31,13:25:00,21475.0,BUY,1,0.02h,Stop Loss,$7.75,$40.50,$144029.25,259,$40.50
2024-12-31,13:27:00,21467.0,SELL,1,0.02h,Stop Loss,$-6.00,$34.50,$144023.25,259,$34.50
2024-12-31,13:28:00,21471.75,BUY,1,0.02h,Stop Loss,$11.50,$46.00,$144034.75,259,$46.00
2024-12-31,13:49:00,21469.5,SELL,1,0.02h,Stop Loss,$15.25,$61.25,$144050.00,259,$61.25
2024-12-31,14:12:00,21471.25,BUY,1,0.02h,Stop Loss,$12.75,$74.00,$144062.75,259,$74.00
2024-12-31,14:29:00,21464.25,SELL,1,0.02h,Stop Loss,$34.00,$108.00,$144096.75,259,$108.00
2024-12-31,15:01:00,21432.25,BUY,1,0.02h,Stop Loss,$24.00,$132.00,$144120.75,259,$132.00
2024-12-31,15:07:00,21402.0,SELL,1,0.02h,Stop Loss,$202.75,$334.75,$144323.50,259,$334.75
2024-12-31,15:21:00,21409.25,BUY,1,0.02h,Stop Loss,$66.50,$401.25,$144390.00,259,$401.25
2024-12-31,15:35:00,21386.5,SELL,1,0.02h,Stop Loss,$16.50,$417.75,$144406.50,259,$417.75
2024-12-31,16:44:00,21330.25,BUY,1,0.02h,Stop Loss,$5.25,$423.00,$144411.75,259,$423.00
2024-12-31,17:02:00,21314.25,SELL,1,0.02h,Stop Loss,$54.00,$477.00,$144465.75,259,$477.00
2024-12-31,17:09:00,21338.75,BUY,1,0.02h,Stop Loss,$11.50,$488.50,$144477.25,259,$488.50
2024-12-31,17:13:00,21308.5,SELL,1,0.02h,Stop Loss,$11.50,$500.00,$144488.75,259,$500.00
2024-12-31,17:21:00,21329.0,BUY,1,0.02h,Stop Loss,$-6.00,$494.00,$144482.75,259,$494.00
2024-12-31,17:22:00,21301.0,SELL,1,0.02h,Stop Loss,$5.25,$499.25,$144488.00,259,$499.25
2024-12-31,17:56:00,21271.5,BUY,1,0.02h,Stop Loss,$65.25,$564.50,$144553.25,259,$564.50
2024-12-31,18:20:00,21269.0,SELL,1,0.02h,Stop Loss,$14.00,$578.50,$144567.25,259,$578.50
2024-12-31,18:50:00,21242.25,BUY,1,0.02h,Stop Loss,$104.00,$682.50,$144671.25,259,$682.50
2024-12-31,18:55:00,21233.0,SELL,1,0.02h,Break Even,$0.25,$682.75,$144671.50,259,$682.75
2024-12-31,19:09:00,21249.5,BUY,1,0.02h,Stop Loss,$21.50,$704.25,$144693.00,259,$704.25
2024-12-31,19:21:00,21215.0,SELL,1,0.02h,Stop Loss,$45.25,$749.50,$144738.25,259,$749.50
2024-12-31,19:51:00,21213.25,BUY,1,0.02h,Stop Loss,$49.00,$798.50,$144787.25,259,$798.50
2024-12-31,20:14:00,21215.0,SELL,1,0.02h,Stop Loss,$-6.00,$792.50,$144781.25,259,$792.50
2024-12-31,20:22:00,21271.25,BUY,1,0.02h,Stop Loss,$70.25,$862.75,$144851.50,259,$862.75
2024-12-31,20:45:00,21267.0,SELL,1,0.02h,Stop Loss,$84.00,$946.75,$144935.50,259,$946.75
2024-12-31,21:14:00,21241.25,BUY,1,0.02h,Break Even,$0.25,$947.00,$144935.75,259,$947.00
2024-12-31,21:16:00,21231.5,SELL,1,0.02h,Stop Loss,$-6.00,$941.00,$144929.75,259,$941.00
2024-12-31,21:19:00,21245.75,BUY,1,0.02h,Stop Loss,$-6.00,$935.00,$144923.75,259,$935.00
2024-12-31,21:25:00,21236.25,SELL,1,0.02h,Break Even,$0.25,$935.25,$144924.00,259,$935.25
2024-12-31,21:38:00,21244.0,BUY,1,0.02h,Stop Loss,$6.50,$941.75,$144930.50,259,$941.75
2024-12-31,21:53:00,21237.5,SELL,1,0.02h,Break Even,$0.25,$942.00,$144930.75,259,$942.00
2024-12-31,21:54:00,21239.5,BUY,1,0.02h,Break Even,$0.25,$942.25,$144931.00,259,$942.25
2024-12-31,21:56:00,21233.0,SELL,1,0.02h,Stop Loss,$-6.00,$936.25,$144925.00,259,$936.25
Final P&L Day: 936.25,,,,,,,,,,,
2025-01-02,12:00:00,21467.5,BUY,1,0.02h,Break Even,$0.25,$0.25,$144925.25,260,$0.25
2025-01-02,12:43:00,21452.5,SELL,1,0.02h,Stop Loss,$20.25,$20.50,$144945.50,260,$20.50
2025-01-02,13:35:00,21442.5,BUY,1,0.02h,Break Even,$0.25,$20.75,$144945.75,260,$20.75
2025-01-02,13:51:00,21420.0,SELL,1,0.02h,Stop Loss,$11.50,$32.25,$144957.25,260,$32.25
2025-01-02,14:52:00,21309.5,BUY,1,0.02h,Stop Loss,$110.25,$142.50,$145067.50,260,$142.50
2025-01-02,15:21:00,21324.0,SELL,1,0.02h,Stop Loss,$161.50,$304.00,$145229.00,260,$304.00
2025-01-02,15:52:00,21312.0,BUY,1,0.02h,Stop Loss,$77.75,$381.75,$145306.75,260,$381.75
2025-01-02,16:03:00,21240.0,SELL,1,0.02h,Stop Loss,$109.00,$490.75,$145415.75,260,$490.75
2025-01-02,16:20:00,21271.0,BUY,1,0.02h,Stop Loss,$14.00,$504.75,$145429.75,260,$504.75
2025-01-02,16:23:00,21231.25,SELL,1,0.02h,Break Even,$0.25,$505.00,$145430.00,260,$505.00
2025-01-02,16:24:00,21264.25,BUY,1,0.02h,Stop Loss,$170.25,$675.25,$145600.25,260,$675.25
2025-01-02,17:08:00,21298.25,SELL,1,0.02h,Stop Loss,$79.00,$754.25,$145679.25,260,$754.25
2025-01-02,17:14:00,21339.0,BUY,1,0.02h,Break Even,$0.25,$754.50,$145679.50,260,$754.50
2025-01-02,17:18:00,21303.5,SELL,1,0.02h,Stop Loss,$39.00,$793.50,$145718.50,260,$793.50
2025-01-02,18:24:00,21052.25,BUY,1,0.02h,Break Even,$0.25,$793.75,$145718.75,260,$793.75
2025-01-02,18:27:00,21031.5,SELL,1,0.02h,Break Even,$0.25,$794.00,$145719.00,260,$794.00
2025-01-02,18:28:00,21052.25,BUY,1,0.02h,Stop Loss,$11.50,$805.50,$145730.50,260,$805.50
2025-01-02,18:32:00,20999.75,SELL,1,0.02h,Stop Loss,$29.00,$834.50,$145759.50,260,$834.50
2025-01-02,18:45:00,21064.25,BUY,1,0.02h,Stop Loss,$-6.00,$828.50,$145753.50,260,$828.50
2025-01-02,18:51:00,21013.0,SELL,1,0.02h,Stop Loss,$9.00,$837.50,$145762.50,260,$837.50
2025-01-02,19:00:00,21048.0,BUY,1,0.02h,Stop Loss,$16.50,$854.00,$145779.00,260,$854.00
2025-01-02,19:47:00,21068.75,SELL,1,0.02h,Stop Loss,$6.50,$860.50,$145785.50,260,$860.50
2025-01-02,19:49:00,21130.25,BUY,1,0.02h,Stop Loss,$41.50,$902.00,$145827.00,260,$902.00
2025-01-02,20:00:00,21063.25,SELL,1,0.02h,Stop Loss,$-6.00,$896.00,$145821.00,260,$896.00
2025-01-02,20:05:00,21128.5,BUY,1,0.02h,Stop Loss,$-6.00,$890.00,$145815.00,260,$890.00
2025-01-02,20:38:00,21134.5,SELL,1,0.02h,Stop Loss,$12.75,$902.75,$145827.75,260,$902.75
2025-01-02,20:48:00,21161.25,BUY,1,0.02h,Stop Loss,$25.25,$928.00,$145853.00,260,$928.00
2025-01-02,21:40:00,21187.5,SELL,1,0.02h,Break Even,$0.25,$928.25,$145853.25,260,$928.25
Final P&L Day: 928.25,,,,,,,,,,,
2025-01-03,12:00:00,21247.5,BUY,1,0.02h,Stop Loss,$-6.00,$-6.00,$145847.25,261,$-6.00
2025-01-03,12:21:00,21212.25,SELL,1,0.02h,Break Even,$0.25,$-5.75,$145847.50,261,$-5.75
2025-01-03,12:23:00,21223.25,BUY,1,0.02h,Break Even,$0.25,$-5.50,$145847.75,261,$-5.50
2025-01-03,13:22:00,21249.5,SELL,1,0.02h,Stop Loss,$-6.00,$-11.50,$145841.75,261,$-11.50
2025-01-03,13:25:00,21258.5,BUY,1,0.02h,Stop Loss,$-6.00,$-17.50,$145835.75,261,$-17.50
2025-01-03,13:47:00,21256.5,SELL,1,0.02h,Stop Loss,$41.50,$24.00,$145877.25,261,$24.00
2025-01-03,14:09:00,21256.75,BUY,1,0.02h,Stop Loss,$-6.00,$18.00,$145871.25,261,$18.00
2025-01-03,15:15:00,21349.0,SELL,1,0.02h,Stop Loss,$59.00,$77.00,$145930.25,261,$77.00
2025-01-03,15:36:00,21366.0,BUY,1,0.02h,Stop Loss,$77.75,$154.75,$146008.00,261,$154.75
2025-01-03,16:09:00,21351.0,SELL,1,0.02h,Stop Loss,$14.00,$168.75,$146022.00,261,$168.75
2025-01-03,16:20:00,21380.0,BUY,1,0.02h,Stop Loss,$55.25,$224.00,$146077.25,261,$224.00
2025-01-03,17:14:00,21469.75,SELL,1,0.02h,Stop Loss,$72.75,$296.75,$146150.00,261,$296.75
2025-01-03,17:52:00,21464.75,BUY,1,0.02h,Break Even,$0.25,$297.00,$146150.25,261,$297.00
2025-01-03,19:52:00,21537.5,SELL,1,0.02h,Stop Loss,$16.50,$313.50,$146166.75,261,$313.50
2025-01-03,20:59:00,21511.0,BUY,1,0.02h,Stop Loss,$65.25,$378.75,$146232.00,261,$378.75
2025-01-03,21:03:00,21493.5,SELL,1,0.02h,Break Even,$0.25,$379.00,$146232.25,261,$379.00
2025-01-03,21:39:00,21489.75,BUY,1,0.02h,Stop Loss,$-6.00,$373.00,$146226.25,261,$373.00
2025-01-03,21:46:00,21485.25,SELL,1,0.02h,Break Even,$0.25,$373.25,$146226.50,261,$373.25
2025-01-03,21:59:00,21489.25,BUY,1,0.02h,Break Even,$0.25,$373.50,$146226.75,261,$373.50
Final P&L Day: 373.50,,,,,,,,,,,
2025-01-06,13:02:00,21729.75,SELL,1,0.02h,Stop Loss,$-6.00,$-6.00,$146220.75,262,$-6.00
2025-01-06,13:29:00,21735.75,BUY,1,0.02h,Stop Loss,$16.50,$10.50,$146237.25,262,$10.50
2025-01-06,13:41:00,21724.25,SELL,1,0.02h,Stop Loss,$41.50,$52.00,$146278.75,262,$52.00
2025-01-06,13:50:00,21734.25,BUY,1,0.02h,Stop Loss,$-6.00,$46.00,$146272.75,262,$46.00
2025-01-06,14:08:00,21734.0,SELL,1,0.02h,Break Even,$0.25,$46.25,$146273.00,262,$46.25
2025-01-06,14:30:00,21732.0,BUY,1,0.02h,Stop Loss,$171.50,$217.75,$146444.50,262,$217.75
2025-01-06,16:19:00,21867.75,SELL,1,0.02h,Stop Loss,$-6.00,$211.75,$146438.50,262,$211.75
2025-01-06,16:21:00,21888.75,BUY,1,0.02h,Break Even,$0.25,$212.00,$146438.75,262,$212.00
2025-01-06,16:22:00,21874.5,SELL,1,0.02h,Break Even,$0.25,$212.25,$146439.00,262,$212.25
2025-01-06,16:29:00,21889.25,BUY,1,0.02h,Break Even,$0.25,$212.50,$146439.25,262,$212.50
2025-01-06,16:36:00,21870.5,SELL,1,0.02h,Stop Loss,$19.00,$231.50,$146458.25,262,$231.50
2025-01-06,18:26:00,21783.5,BUY,1,0.02h,Break Even,$0.25,$231.75,$146458.50,262,$231.75
2025-01-06,18:33:00,21765.0,SELL,1,0.02h,Stop Loss,$4.00,$235.75,$146462.50,262,$235.75
2025-01-06,19:26:00,21715.25,BUY,1,0.02h,Stop Loss,$25.25,$261.00,$146487.75,262,$261.00
2025-01-06,19:32:00,21702.0,SELL,1,0.02h,Stop Loss,$31.50,$292.50,$146519.25,262,$292.50
2025-01-06,19:49:00,21716.25,BUY,1,0.02h,Break Even,$0.25,$292.75,$146519.50,262,$292.75
2025-01-06,19:52:00,21699.0,SELL,1,0.02h,Stop Loss,$35.25,$328.00,$146554.75,262,$328.00
2025-01-06,20:14:00,21698.5,BUY,1,0.02h,Stop Loss,$-6.00,$322.00,$146548.75,262,$322.00
2025-01-06,20:47:00,21716.5,SELL,1,0.02h,Stop Loss,$75.25,$397.25,$146624.00,262,$397.25
2025-01-06,20:54:00,21733.5,BUY,1,0.02h,Stop Loss,$36.50,$433.75,$146660.50,262,$433.75
Final P&L Day: 433.75,,,,,,,,,,,
2025-01-07,12:00:00,21736.0,SELL,1,0.02h,Stop Loss,$52.75,$52.75,$146713.25,263,$52.75
2025-01-07,12:35:00,21745.25,BUY,1,0.02h,Stop Loss,$4.00,$56.75,$146717.25,263,$56.75
2025-01-07,12:59:00,21740.75,SELL,1,0.02h,Break Even,$0.25,$57.00,$146717.50,263,$57.00
2025-01-07,13:16:00,21752.75,BUY,1,0.02h,Break Even,$0.25,$57.25,$146717.75,263,$57.25
2025-01-07,13:27:00,21738.5,SELL,1,0.02h,Stop Loss,$-6.00,$51.25,$146711.75,263,$51.25
2025-01-07,13:35:00,21750.75,BUY,1,0.02h,Stop Loss,$-6.00,$45.25,$146705.75,263,$45.25
2025-01-07,14:23:00,21776.5,SELL,1,0.02h,Stop Loss,$-6.00,$39.25,$146699.75,263,$39.25
2025-01-07,14:28:00,21785.0,BUY,1,0.02h,Stop Loss,$22.75,$62.00,$146722.50,263,$62.00
2025-01-07,14:34:00,21764.25,SELL,1,0.02h,Stop Loss,$71.50,$133.50,$146794.00,263,$133.50
2025-01-07,14:49:00,21775.5,BUY,1,0.02h,Break Even,$0.25,$133.75,$146794.25,263,$133.75
2025-01-07,14:57:00,21734.5,SELL,1,0.02h,Stop Loss,$91.50,$225.25,$146885.75,263,$225.25
2025-01-07,15:29:00,21611.0,BUY,1,0.02h,Stop Loss,$9.00,$234.25,$146894.75,263,$234.25
2025-01-07,15:30:00,21577.5,SELL,1,0.02h,Stop Loss,$146.50,$380.75,$147041.25,263,$380.75
2025-01-07,15:58:00,21521.75,BUY,1,0.02h,Stop Loss,$76.50,$457.25,$147117.75,263,$457.25
2025-01-07,16:36:00,21499.75,SELL,1,0.02h,Stop Loss,$106.50,$563.75,$147224.25,263,$563.75
2025-01-07,16:41:00,21550.75,BUY,1,0.02h,Stop Loss,$4.00,$567.75,$147228.25,263,$567.75
2025-01-07,16:42:00,21516.75,SELL,1,0.02h,Stop Loss,$41.50,$609.25,$147269.75,263,$609.25
2025-01-07,17:20:00,21462.5,BUY,1,0.02h,Break Even,$0.25,$609.50,$147270.00,263,$609.50
2025-01-07,17:23:00,21437.25,SELL,1,0.02h,Stop Loss,$17.75,$627.25,$147287.75,263,$627.25
2025-01-07,17:35:00,21454.0,BUY,1,0.02h,Break Even,$0.25,$627.50,$147288.00,263,$627.50
2025-01-07,17:36:00,21442.5,SELL,1,0.02h,Stop Loss,$7.75,$635.25,$147295.75,263,$635.25
2025-01-07,17:37:00,21445.0,BUY,1,0.02h,Stop Loss,$12.75,$648.00,$147308.50,263,$648.00
2025-01-07,17:38:00,21431.5,SELL,1,0.02h,Stop Loss,$51.50,$699.50,$147360.00,263,$699.50
2025-01-07,18:00:00,21445.0,BUY,1,0.02h,Stop Loss,$29.00,$728.50,$147389.00,263,$728.50
2025-01-07,18:37:00,21475.25,SELL,1,0.02h,Stop Loss,$54.00,$782.50,$147443.00,263,$782.50
2025-01-07,19:09:00,21464.5,BUY,1,0.02h,Break Even,$0.25,$782.75,$147443.25,263,$782.75
2025-01-07,19:20:00,21449.5,SELL,1,0.02h,Stop Loss,$24.00,$806.75,$147467.25,263,$806.75
2025-01-07,20:49:00,21340.0,BUY,1,0.02h,Stop Loss,$45.25,$852.00,$147512.50,263,$852.00
2025-01-07,21:38:00,21379.0,SELL,1,0.02h,Break Even,$0.25,$852.25,$147512.75,263,$852.25
2025-01-07,21:50:00,21380.5,BUY,1,0.02h,Stop Loss,$-6.00,$846.25,$147506.75,263,$846.25
2025-01-07,21:53:00,21371.75,SELL,1,0.02h,Break Even,$0.25,$846.50,$147507.00,263,$846.50
Final P&L Day: 846.50,,,,,,,,,,,
2025-01-08,12:43:00,21281.0,BUY,1,0.02h,Break Even,$0.25,$0.25,$147507.25,264,$0.25
2025-01-08,12:50:00,21263.75,SELL,1,0.02h,Stop Loss,$29.00,$29.25,$147536.25,264,$29.25
2025-01-08,13:01:00,21311.25,BUY,1,0.02h,Stop Loss,$202.75,$232.00,$147739.00,264,$232.00
2025-01-08,13:39:00,21327.75,SELL,1,0.02h,Stop Loss,$16.50,$248.50,$147755.50,264,$248.50
2025-01-08,13:51:00,21349.5,BUY,1,0.02h,Stop Loss,$-6.00,$242.50,$147749.50,264,$242.50
2025-01-08,14:14:00,21349.5,SELL,1,0.02h,Stop Loss,$45.25,$287.75,$147794.75,264,$287.75
2025-01-08,14:29:00,21361.25,BUY,1,0.02h,Stop Loss,$14.00,$301.75,$147808.75,264,$301.75
2025-01-08,14:31:00,21334.0,SELL,1,0.02h,Stop Loss,$70.25,$372.00,$147879.00,264,$372.00
2025-01-08,14:32:00,21363.25,BUY,1,0.02h,Stop Loss,$22.75,$394.75,$147901.75,264,$394.75
2025-01-08,14:34:00,21326.0,SELL,1,0.02h,Stop Loss,$27.75,$422.50,$147929.50,264,$422.50
2025-01-08,14:35:00,21371.75,BUY,1,0.02h,Stop Loss,$49.00,$471.50,$147978.50,264,$471.50
2025-01-08,14:39:00,21324.25,SELL,1,0.02h,Stop Loss,$125.25,$596.75,$148103.75,264,$596.75
2025-01-08,14:50:00,21368.25,BUY,1,0.02h,Stop Loss,$51.50,$648.25,$148155.25,264,$648.25
2025-01-08,14:54:00,21295.5,SELL,1,0.02h,Stop Loss,$36.50,$684.75,$148191.75,264,$684.75
2025-01-08,15:01:00,21369.0,BUY,1,0.02h,Stop Loss,$35.25,$720.00,$148227.00,264,$720.00
2025-01-08,15:11:00,21308.5,SELL,1,0.02h,Stop Loss,$41.50,$761.50,$148268.50,264,$761.50
2025-01-08,15:36:00,21332.75,BUY,1,0.02h,Stop Loss,$96.50,$858.00,$148365.00,264,$858.00
2025-01-08,15:48:00,21299.25,SELL,1,0.02h,Break Even,$0.25,$858.25,$148365.25,264,$858.25
2025-01-08,15:50:00,21317.25,BUY,1,0.02h,Stop Loss,$71.50,$929.75,$148436.75,264,$929.75
2025-01-08,16:06:00,21315.25,SELL,1,0.02h,Stop Loss,$102.75,$1032.50,$148539.50,264,$1032.50
2025-01-08,16:15:00,21335.5,BUY,1,0.02h,Stop Loss,$10.25,$1042.75,$148549.75,264,$1042.75
2025-01-08,17:02:00,21382.0,SELL,1,0.02h,Stop Loss,$114.00,$1156.75,$148663.75,264,$1156.75
2025-01-08,17:53:00,21261.0,BUY,1,0.02h,Stop Loss,$-6.00,$1150.75,$148657.75,264,$1150.75
2025-01-08,18:48:00,21346.5,SELL,1,0.02h,Break Even,$0.25,$1151.00,$148658.00,264,$1151.00
2025-01-08,19:09:00,21380.75,BUY,1,0.02h,Stop Loss,$49.00,$1200.00,$148707.00,264,$1200.00
2025-01-08,19:37:00,21346.0,SELL,1,0.02h,Break Even,$0.25,$1200.25,$148707.25,264,$1200.25
2025-01-08,20:05:00,21353.0,BUY,1,0.02h,Break Even,$0.25,$1200.50,$148707.50,264,$1200.50
2025-01-08,20:07:00,21337.25,SELL,1,0.02h,Stop Loss,$36.50,$1237.00,$148744.00,264,$1237.00
2025-01-08,20:21:00,21343.25,BUY,1,0.02h,Break Even,$0.25,$1237.25,$148744.25,264,$1237.25
2025-01-08,20:37:00,21332.75,SELL,1,0.02h,Stop Loss,$19.00,$1256.25,$148763.25,264,$1256.25
2025-01-08,20:46:00,21346.25,BUY,1,0.02h,Break Even,$0.25,$1256.50,$148763.50,264,$1256.50
2025-01-08,21:14:00,21347.0,SELL,1,0.02h,Stop Loss,$-6.00,$1250.50,$148757.50,264,$1250.50
2025-01-08,21:28:00,21360.75,BUY,1,0.02h,Break Even,$0.25,$1250.75,$148757.75,264,$1250.75
2025-01-08,21:35:00,21336.5,SELL,1,0.02h,Stop Loss,$121.50,$1372.25,$148879.25,264,$1372.25
Final P&L Day: 1372.25,,,,,,,,,,,
2025-01-09,12:50:00,21305.25,BUY,1,0.02h,Stop Loss,$6.50,$6.50,$148885.75,265,$6.50
2025-01-09,13:25:00,21309.0,SELL,1,0.02h,Break Even,$0.25,$6.75,$148886.00,265,$6.75
2025-01-09,13:28:00,21322.0,BUY,1,0.02h,Break Even,$0.25,$7.00,$148886.25,265,$7.00
2025-01-09,13:31:00,21311.5,SELL,1,0.02h,Break Even,$0.25,$7.25,$148886.50,265,$7.25
2025-01-09,13:36:00,21327.5,BUY,1,0.02h,Stop Loss,$11.50,$18.75,$148898.00,265,$18.75
2025-01-09,13:50:00,21319.5,SELL,1,0.02h,Stop Loss,$-6.00,$12.75,$148892.00,265,$12.75
2025-01-09,14:22:00,21294.5,BUY,1,0.02h,Break Even,$0.25,$13.00,$148892.25,265,$13.00
Final P&L Day: 13.00,,,,,,,,,,,
2025-01-10,12:07:00,21282.5,SELL,1,0.02h,Break Even,$0.25,$0.25,$148892.50,266,$0.25
2025-01-10,12:26:00,21291.75,BUY,1,0.02h,Break Even,$0.25,$0.50,$148892.75,266,$0.50
2025-01-10,12:29:00,21281.5,SELL,1,0.02h,Stop Loss,$20.25,$20.75,$148913.00,266,$20.75
2025-01-10,12:33:00,21293.25,BUY,1,0.02h,Stop Loss,$27.75,$48.50,$148940.75,266,$48.50
2025-01-10,13:12:00,21300.0,SELL,1,0.02h,Stop Loss,$17.75,$66.25,$148958.50,266,$66.25
2025-01-10,14:06:00,21146.25,BUY,1,0.02h,Stop Loss,$87.75,$154.00,$149046.25,266,$154.00
2025-01-10,14:32:00,21141.75,SELL,1,0.02h,Stop Loss,$39.00,$193.00,$149085.25,266,$193.00
2025-01-10,15:24:00,20987.0,BUY,1,0.02h,Stop Loss,$67.75,$260.75,$149153.00,266,$260.75
2025-01-10,15:56:00,21014.0,SELL,1,0.02h,Stop Loss,$75.25,$336.00,$149228.25,266,$336.00
2025-01-10,16:45:00,20968.75,BUY,1,0.02h,Stop Loss,$52.75,$388.75,$149281.00,266,$388.75
2025-01-10,16:57:00,20924.25,SELL,1,0.02h,Stop Loss,$24.00,$412.75,$149305.00,266,$412.75
2025-01-10,17:20:00,20929.25,BUY,1,0.02h,Stop Loss,$22.75,$435.50,$149327.75,266,$435.50
2025-01-10,17:24:00,20903.5,SELL,1,0.02h,Break Even,$0.25,$435.75,$149328.00,266,$435.75
2025-01-10,17:25:00,20918.5,BUY,1,0.02h,Stop Loss,$74.00,$509.75,$149402.00,266,$509.75
2025-01-10,19:06:00,21091.75,SELL,1,0.02h,Stop Loss,$26.50,$536.25,$149428.50,266,$536.25
2025-01-10,19:30:00,21096.0,BUY,1,0.02h,Break Even,$0.25,$536.50,$149428.75,266,$536.50
2025-01-10,19:31:00,21078.5,SELL,1,0.02h,Stop Loss,$69.00,$605.50,$149497.75,266,$605.50
2025-01-10,19:56:00,21092.25,BUY,1,0.02h,Break Even,$0.25,$605.75,$149498.00,266,$605.75
2025-01-10,20:12:00,21070.5,SELL,1,0.02h,Stop Loss,$67.75,$673.50,$149565.75,266,$673.50
2025-01-10,20:53:00,21029.75,BUY,1,0.02h,Break Even,$0.25,$673.75,$149566.00,266,$673.75
2025-01-10,21:07:00,21007.75,SELL,1,0.02h,Stop Loss,$15.25,$689.00,$149581.25,266,$689.00
Final P&L Day: 689.00,,,,,,,,,,,
2025-01-13,12:34:00,20791.0,BUY,1,0.02h,Stop Loss,$21.50,$21.50,$149602.75,267,$21.50
2025-01-13,13:03:00,20810.25,SELL,1,0.02h,Break Even,$0.25,$21.75,$149603.00,267,$21.75
2025-01-13,13:19:00,20820.5,BUY,1,0.02h,Break Even,$0.25,$22.00,$149603.25,267,$22.00
2025-01-13,13:51:00,20818.25,SELL,1,0.02h,Break Even,$0.25,$22.25,$149603.50,267,$22.25
2025-01-13,14:52:00,20774.25,BUY,1,0.02h,Stop Loss,$9.00,$31.25,$149612.50,267,$31.25
2025-01-13,15:15:00,20772.75,SELL,1,0.02h,Stop Loss,$72.75,$104.00,$149685.25,267,$104.00
2025-01-13,15:38:00,20800.25,BUY,1,0.02h,Stop Loss,$69.00,$173.00,$149754.25,267,$173.00
2025-01-13,15:59:00,20799.5,SELL,1,0.02h,Stop Loss,$10.25,$183.25,$149764.50,267,$183.25
2025-01-13,16:36:00,20802.5,BUY,1,0.02h,Stop Loss,$15.25,$198.50,$149779.75,267,$198.50
2025-01-13,16:56:00,20757.25,SELL,1,0.02h,Stop Loss,$41.50,$240.00,$149821.25,267,$240.00
2025-01-13,17:11:00,20788.0,BUY,1,0.02h,Stop Loss,$49.00,$289.00,$149870.25,267,$289.00
2025-01-13,17:44:00,20823.5,SELL,1,0.02h,Stop Loss,$14.00,$303.00,$149884.25,267,$303.00
2025-01-13,17:48:00,20842.5,BUY,1,0.02h,Stop Loss,$24.00,$327.00,$149908.25,267,$327.00
2025-01-13,18:21:00,20866.0,SELL,1,0.02h,Stop Loss,$14.00,$341.00,$149922.25,267,$341.00
2025-01-13,18:30:00,20892.25,BUY,1,0.02h,Stop Loss,$62.75,$403.75,$149985.00,267,$403.75
2025-01-13,18:45:00,20868.25,SELL,1,0.02h,Break Even,$0.25,$404.00,$149985.25,267,$404.00
2025-01-13,18:48:00,20895.0,BUY,1,0.02h,Stop Loss,$6.50,$410.50,$149991.75,267,$410.50
2025-01-13,18:57:00,20882.25,SELL,1,0.02h,Stop Loss,$-6.00,$404.50,$149985.75,267,$404.50
2025-01-13,19:00:00,20892.25,BUY,1,0.02h,Stop Loss,$6.50,$411.00,$149992.25,267,$411.00
2025-01-13,19:04:00,20877.25,SELL,1,0.02h,Break Even,$0.25,$411.25,$149992.50,267,$411.25
2025-01-13,19:29:00,20886.25,BUY,1,0.02h,Stop Loss,$27.75,$439.00,$150020.25,267,$439.00
2025-01-13,19:52:00,20881.25,SELL,1,0.02h,Stop Loss,$45.25,$484.25,$150065.50,267,$484.25
2025-01-13,19:57:00,20909.75,BUY,1,0.02h,Stop Loss,$-6.00,$478.25,$150059.50,267,$478.25
2025-01-13,20:05:00,20888.25,SELL,1,0.02h,Break Even,$0.25,$478.50,$150059.75,267,$478.50
2025-01-13,20:06:00,20898.75,BUY,1,0.02h,Stop Loss,$11.50,$490.00,$150071.25,267,$490.00
2025-01-13,20:15:00,20893.0,SELL,1,0.02h,Stop Loss,$10.25,$500.25,$150081.50,267,$500.25
2025-01-13,20:16:00,20905.0,BUY,1,0.02h,Stop Loss,$7.75,$508.00,$150089.25,267,$508.00
2025-01-13,20:25:00,20879.5,SELL,1,0.02h,Stop Loss,$6.50,$514.50,$150095.75,267,$514.50
2025-01-13,20:38:00,20902.5,BUY,1,0.02h,Stop Loss,$5.25,$519.75,$150101.00,267,$519.75
2025-01-13,20:40:00,20883.5,SELL,1,0.02h,Stop Loss,$-6.00,$513.75,$150095.00,267,$513.75
2025-01-13,20:43:00,20897.75,BUY,1,0.02h,Break Even,$0.25,$514.00,$150095.25,267,$514.00
2025-01-13,21:56:00,20979.25,SELL,1,0.02h,Stop Loss,$-6.00,$508.00,$150089.25,267,$508.00
2025-01-13,21:57:00,20983.0,BUY,1,0.02h,Break Even,$0.25,$508.25,$150089.50,267,$508.25
Final P&L Day: 508.25,,,,,,,,,,,
2025-01-14,12:18:00,21011.5,SELL,1,0.02h,Stop Loss,$4.00,$4.00,$150093.50,268,$4.00
2025-01-14,12:33:00,21006.75,BUY,1,0.02h,Stop Loss,$27.75,$31.75,$150121.25,268,$31.75
2025-01-14,12:53:00,21002.5,SELL,1,0.02h,Break Even,$0.25,$32.00,$150121.50,268,$32.00
2025-01-14,13:31:00,21116.75,BUY,1,0.02h,Stop Loss,$95.25,$127.25,$150216.75,268,$127.25
2025-01-14,14:00:00,21057.0,SELL,1,0.02h,Stop Loss,$9.00,$136.25,$150225.75,268,$136.25
2025-01-14,14:19:00,21071.0,BUY,1,0.02h,Stop Loss,$30.25,$166.50,$150256.00,268,$166.50
2025-01-14,14:32:00,21023.25,SELL,1,0.02h,Stop Loss,$10.25,$176.75,$150266.25,268,$176.75
2025-01-14,14:36:00,21087.25,BUY,1,0.02h,Stop Loss,$55.25,$232.00,$150321.50,268,$232.00
2025-01-14,14:50:00,21075.25,SELL,1,0.02h,Stop Loss,$120.25,$352.25,$150441.75,268,$352.25
2025-01-14,15:10:00,21065.75,BUY,1,0.02h,Break Even,$0.25,$352.50,$150442.00,268,$352.50
2025-01-14,15:25:00,21040.5,SELL,1,0.02h,Stop Loss,$-6.00,$346.50,$150436.00,268,$346.50
2025-01-14,16:26:00,20933.0,BUY,1,0.02h,Stop Loss,$51.50,$398.00,$150487.50,268,$398.00
2025-01-14,16:33:00,20916.75,SELL,1,0.02h,Stop Loss,$12.75,$410.75,$150500.25,268,$410.75
2025-01-14,17:12:00,20869.0,BUY,1,0.02h,Break Even,$0.25,$411.00,$150500.50,268,$411.00
2025-01-14,17:23:00,20833.25,SELL,1,0.02h,Break Even,$0.25,$411.25,$150500.75,268,$411.25
2025-01-14,17:44:00,20871.25,BUY,1,0.02h,Stop Loss,$7.75,$419.00,$150508.50,268,$419.00
2025-01-14,19:30:00,20981.75,SELL,1,0.02h,Stop Loss,$16.50,$435.50,$150525.00,268,$435.50
2025-01-14,19:37:00,21001.75,BUY,1,0.02h,Stop Loss,$-6.00,$429.50,$150519.00,268,$429.50
2025-01-14,19:45:00,20983.0,SELL,1,0.02h,Stop Loss,$25.25,$454.75,$150544.25,268,$454.75
2025-01-14,20:30:00,20834.75,BUY,1,0.02h,Stop Loss,$85.25,$540.00,$150629.50,268,$540.00
2025-01-14,20:40:00,20801.75,SELL,1,0.02h,Break Even,$0.25,$540.25,$150629.75,268,$540.25
2025-01-14,20:46:00,20836.75,BUY,1,0.02h,Stop Loss,$60.25,$600.50,$150690.00,268,$600.50
2025-01-14,21:49:00,20973.5,SELL,1,0.02h,Break Even,$0.25,$600.75,$150690.25,268,$600.75
Final P&L Day: 600.75,,,,,,,,,,,
2025-01-15,12:00:00,20997.25,BUY,1,0.02h,Stop Loss,$19.00,$19.00,$150709.25,269,$19.00
2025-01-15,12:24:00,20990.0,SELL,1,0.02h,Break Even,$0.25,$19.25,$150709.50,269,$19.25
2025-01-15,12:40:00,21000.75,BUY,1,0.02h,Break Even,$0.25,$19.50,$150709.75,269,$19.50
2025-01-15,12:56:00,20986.0,SELL,1,0.02h,Break Even,$0.25,$19.75,$150710.00,269,$19.75
2025-01-15,13:03:00,20999.5,BUY,1,0.02h,Stop Loss,$-6.00,$13.75,$150704.00,269,$13.75
2025-01-15,13:12:00,20991.5,SELL,1,0.02h,Break Even,$0.25,$14.00,$150704.25,269,$14.00
2025-01-15,13:25:00,20999.5,BUY,1,0.02h,Break Even,$0.25,$14.25,$150704.50,269,$14.25
2025-01-15,14:12:00,21250.75,SELL,1,0.02h,Stop Loss,$-6.00,$8.25,$150698.50,269,$8.25
2025-01-15,14:42:00,21282.5,BUY,1,0.02h,Stop Loss,$31.50,$39.75,$150730.00,269,$39.75
2025-01-15,15:36:00,21365.5,SELL,1,0.02h,Stop Loss,$67.75,$107.50,$150797.75,269,$107.50
2025-01-15,15:42:00,21385.75,BUY,1,0.02h,Stop Loss,$14.00,$121.50,$150811.75,269,$121.50
2025-01-15,15:44:00,21375.5,SELL,1,0.02h,Stop Loss,$44.00,$165.50,$150855.75,269,$165.50
2025-01-15,17:06:00,21291.0,BUY,1,0.02h,Stop Loss,$79.00,$244.50,$150934.75,269,$244.50
2025-01-15,17:56:00,21330.25,SELL,1,0.02h,Stop Loss,$-6.00,$238.50,$150928.75,269,$238.50
2025-01-15,18:04:00,21354.5,BUY,1,0.02h,Stop Loss,$-6.00,$232.50,$150922.75,269,$232.50
2025-01-15,19:51:00,21407.0,SELL,1,0.02h,Break Even,$0.25,$232.75,$150923.00,269,$232.75
2025-01-15,19:53:00,21419.75,BUY,1,0.02h,Stop Loss,$-6.00,$226.75,$150917.00,269,$226.75
2025-01-15,20:38:00,21426.25,SELL,1,0.02h,Stop Loss,$9.00,$235.75,$150926.00,269,$235.75
Final P&L Day: 235.75,,,,,,,,,,,
2025-01-16,12:00:00,21506.75,BUY,1,0.02h,Break Even,$0.25,$0.25,$150926.25,270,$0.25
2025-01-16,12:30:00,21463.0,SELL,1,0.02h,Stop Loss,$4.00,$4.25,$150930.25,270,$4.25
2025-01-16,12:32:00,21473.0,BUY,1,0.02h,Break Even,$0.25,$4.50,$150930.50,270,$4.50
2025-01-16,12:48:00,21462.25,SELL,1,0.02h,Stop Loss,$16.50,$21.00,$150947.00,270,$21.00
2025-01-16,13:18:00,21444.25,BUY,1,0.02h,Stop Loss,$-6.00,$15.00,$150941.00,270,$15.00
2025-01-16,13:20:00,21429.25,SELL,1,0.02h,Stop Loss,$14.00,$29.00,$150955.00,270,$29.00
2025-01-16,13:24:00,21449.0,BUY,1,0.02h,Stop Loss,$4.00,$33.00,$150959.00,270,$33.00
2025-01-16,14:08:00,21458.5,SELL,1,0.02h,Stop Loss,$11.50,$44.50,$150970.50,270,$44.50
2025-01-16,14:14:00,21479.0,BUY,1,0.02h,Stop Loss,$14.00,$58.50,$150984.50,270,$58.50
2025-01-16,14:32:00,21450.75,SELL,1,0.02h,Stop Loss,$65.25,$123.75,$151049.75,270,$123.75
2025-01-16,15:21:00,21399.25,BUY,1,0.02h,Stop Loss,$61.50,$185.25,$151111.25,270,$185.25
2025-01-16,15:28:00,21371.75,SELL,1,0.02h,Break Even,$0.25,$185.50,$151111.50,270,$185.50
2025-01-16,15:56:00,21385.0,BUY,1,0.02h,Stop Loss,$61.50,$247.00,$151173.00,270,$247.00
2025-01-16,16:21:00,21395.5,SELL,1,0.02h,Stop Loss,$29.00,$276.00,$151202.00,270,$276.00
2025-01-16,16:59:00,21399.75,BUY,1,0.02h,Stop Loss,$9.00,$285.00,$151211.00,270,$285.00
2025-01-16,17:18:00,21383.0,SELL,1,0.02h,Stop Loss,$37.75,$322.75,$151248.75,270,$322.75
2025-01-16,17:19:00,21397.0,BUY,1,0.02h,Break Even,$0.25,$323.00,$151249.00,270,$323.00
2025-01-16,17:20:00,21383.75,SELL,1,0.02h,Break Even,$0.25,$323.25,$151249.25,270,$323.25
2025-01-16,17:25:00,21404.75,BUY,1,0.02h,Stop Loss,$14.00,$337.25,$151263.25,270,$337.25
2025-01-16,17:39:00,21392.0,SELL,1,0.02h,Stop Loss,$14.00,$351.25,$151277.25,270,$351.25
2025-01-16,17:59:00,21399.0,BUY,1,0.02h,Stop Loss,$-6.00,$345.25,$151271.25,270,$345.25
2025-01-16,18:00:00,21385.5,SELL,1,0.02h,Break Even,$0.25,$345.50,$151271.50,270,$345.50
2025-01-16,18:04:00,21399.75,BUY,1,0.02h,Stop Loss,$16.50,$362.00,$151288.00,270,$362.00
2025-01-16,18:16:00,21388.0,SELL,1,0.02h,Stop Loss,$24.00,$386.00,$151312.00,270,$386.00
2025-01-16,19:06:00,21320.75,BUY,1,0.02h,Stop Loss,$41.50,$427.50,$151353.50,270,$427.50
2025-01-16,20:18:00,21355.75,SELL,1,0.02h,Stop Loss,$42.75,$470.25,$151396.25,270,$470.25
2025-01-16,21:41:00,21208.25,BUY,1,0.02h,Break Even,$0.25,$470.50,$151396.50,270,$470.50
2025-01-16,21:45:00,21201.5,SELL,1,0.02h,Stop Loss,$-6.00,$464.50,$151390.50,270,$464.50
2025-01-16,21:46:00,21211.0,BUY,1,0.02h,Stop Loss,$-6.00,$458.50,$151384.50,270,$458.50
2025-01-16,21:53:00,21203.0,SELL,1,0.02h,Break Even,$0.25,$458.75,$151384.75,270,$458.75
2025-01-16,21:56:00,21210.5,BUY,1,0.02h,Stop Loss,$4.00,$462.75,$151388.75,270,$462.75
Final P&L Day: 462.75,,,,,,,,,,,
2025-01-17,14:34:00,21566.75,SELL,1,0.02h,Stop Loss,$76.50,$76.50,$151465.25,271,$76.50
2025-01-17,15:06:00,21563.75,BUY,1,0.02h,Stop Loss,$74.00,$150.50,$151539.25,271,$150.50
2025-01-17,15:23:00,21501.25,SELL,1,0.02h,Break Even,$0.25,$150.75,$151539.50,271,$150.75
2025-01-17,15:35:00,21549.5,BUY,1,0.02h,Stop Loss,$94.00,$244.75,$151633.50,271,$244.75
2025-01-17,16:44:00,21594.75,SELL,1,0.02h,Stop Loss,$-6.00,$238.75,$151627.50,271,$238.75
2025-01-17,17:11:00,21596.5,BUY,1,0.02h,Stop Loss,$-6.00,$232.75,$151621.50,271,$232.75
2025-01-17,18:34:00,21643.25,SELL,1,0.02h,Break Even,$0.25,$233.00,$151621.75,271,$233.00
2025-01-17,19:23:00,21639.0,BUY,1,0.02h,Stop Loss,$12.75,$245.75,$151634.50,271,$245.75
2025-01-17,19:34:00,21626.25,SELL,1,0.02h,Break Even,$0.25,$246.00,$151634.75,271,$246.00
2025-01-17,19:36:00,21636.5,BUY,1,0.02h,Stop Loss,$-6.00,$240.00,$151628.75,271,$240.00
2025-01-17,19:51:00,21629.25,SELL,1,0.02h,Stop Loss,$-6.00,$234.00,$151622.75,271,$234.00
2025-01-17,20:22:00,21616.5,BUY,1,0.02h,Stop Loss,$9.00,$243.00,$151631.75,271,$243.00
2025-01-17,20:29:00,21602.0,SELL,1,0.02h,Break Even,$0.25,$243.25,$151632.00,271,$243.25
2025-01-17,20:35:00,21618.25,BUY,1,0.02h,Stop Loss,$22.75,$266.00,$151654.75,271,$266.00
2025-01-17,20:52:00,21605.0,SELL,1,0.02h,Stop Loss,$-6.00,$260.00,$151648.75,271,$260.00
2025-01-17,20:54:00,21622.5,BUY,1,0.02h,Stop Loss,$65.25,$325.25,$151714.00,271,$325.25
2025-01-17,20:56:00,21603.25,SELL,1,0.02h,Stop Loss,$72.75,$398.00,$151786.75,271,$398.00
2025-01-17,21:27:00,21592.5,BUY,1,0.02h,Stop Loss,$-6.00,$392.00,$151780.75,271,$392.00
2025-01-17,21:36:00,21585.5,SELL,1,0.02h,Stop Loss,$12.75,$404.75,$151793.50,271,$404.75
2025-01-17,21:45:00,21589.0,BUY,1,0.02h,Stop Loss,$-6.00,$398.75,$151787.50,271,$398.75
2025-01-17,21:46:00,21583.0,SELL,1,0.02h,Break Even,$0.25,$399.00,$151787.75,271,$399.00
2025-01-17,22:00:00,21590.25,BUY,1,62.00h,Stop Loss,$166.50,$565.50,$151954.25,271,$565.50
Final P&L Day: 565.50,,,,,,,,,,,
2025-01-20,12:19:00,21596.5,SELL,1,0.02h,Stop Loss,$21.50,$21.50,$151975.75,272,$21.50
2025-01-20,13:32:00,21625.25,BUY,1,0.02h,Stop Loss,$45.25,$66.75,$152021.00,272,$66.75
2025-01-20,14:17:00,21661.25,SELL,1,0.02h,Break Even,$0.25,$67.00,$152021.25,272,$67.00
2025-01-20,14:22:00,21700.0,BUY,1,0.02h,Stop Loss,$24.00,$91.00,$152045.25,272,$91.00
2025-01-20,14:59:00,21736.75,SELL,1,0.02h,Stop Loss,$-6.00,$85.00,$152039.25,272,$85.00
2025-01-20,15:58:00,21683.5,BUY,1,0.02h,Break Even,$0.25,$85.25,$152039.50,272,$85.25
2025-01-20,15:59:00,21678.25,SELL,1,0.02h,Break Even,$0.25,$85.50,$152039.75,272,$85.50
2025-01-20,16:00:00,21682.75,BUY,1,0.02h,Stop Loss,$17.75,$103.25,$152057.50,272,$103.25
2025-01-20,16:59:00,21700.0,SELL,1,0.02h,Stop Loss,$49.00,$152.25,$152106.50,272,$152.25
2025-01-20,17:38:00,21693.75,BUY,1,0.02h,Stop Loss,$22.75,$175.00,$152129.25,272,$175.00
2025-01-20,17:44:00,21680.0,SELL,1,0.02h,Break Even,$0.25,$175.25,$152129.50,272,$175.25
2025-01-20,17:47:00,21692.75,BUY,1,0.02h,Stop Loss,$12.75,$188.00,$152142.25,272,$188.00
2025-01-20,17:53:00,21683.5,SELL,1,0.02h,Break Even,$0.25,$188.25,$152142.50,272,$188.25
2025-01-20,17:55:00,21702.5,BUY,1,0.02h,Stop Loss,$5.25,$193.50,$152147.75,272,$193.50
2025-01-20,18:00:00,21680.5,SELL,1,18.00h,Stop Loss,$34.00,$227.50,$152181.75,272,$227.50
Final P&L Day: 227.50,,,,,,,,,,,
2025-01-21,12:17:00,21682.5,BUY,1,0.02h,Stop Loss,$-6.00,$-6.00,$152175.75,273,$-6.00
2025-01-21,12:50:00,21687.0,SELL,1,0.02h,Stop Loss,$5.25,$-0.75,$152181.00,273,$-0.75
2025-01-21,13:00:00,21694.5,BUY,1,0.02h,Stop Loss,$-6.00,$-6.75,$152175.00,273,$-6.75
2025-01-21,13:01:00,21685.0,SELL,1,0.02h,Break Even,$0.25,$-6.50,$152175.25,273,$-6.50
2025-01-21,13:04:00,21694.5,BUY,1,0.02h,Stop Loss,$19.00,$12.50,$152194.25,273,$12.50
2025-01-21,13:29:00,21694.75,SELL,1,0.02h,Stop Loss,$9.00,$21.50,$152203.25,273,$21.50
2025-01-21,13:33:00,21705.0,BUY,1,0.02h,Stop Loss,$14.00,$35.50,$152217.25,273,$35.50
2025-01-21,14:13:00,21718.75,SELL,1,0.02h,Break Even,$0.25,$35.75,$152217.50,273,$35.75
2025-01-21,14:15:00,21724.5,BUY,1,0.02h,Break Even,$0.25,$36.00,$152217.75,273,$36.00
2025-01-21,14:19:00,21713.75,SELL,1,0.02h,Stop Loss,$15.25,$51.25,$152233.00,273,$51.25
2025-01-21,15:24:00,21605.75,BUY,1,0.02h,Stop Loss,$44.00,$95.25,$152277.00,273,$95.25
2025-01-21,15:52:00,21604.0,SELL,1,0.02h,Stop Loss,$77.75,$173.00,$152354.75,273,$173.00
2025-01-21,15:58:00,21623.5,BUY,1,0.02h,Stop Loss,$45.25,$218.25,$152400.00,273,$218.25
2025-01-21,16:02:00,21611.25,SELL,1,0.02h,Stop Loss,$16.50,$234.75,$152416.50,273,$234.75
2025-01-21,16:07:00,21638.75,BUY,1,0.02h,Break Even,$0.25,$235.00,$152416.75,273,$235.00
2025-01-21,16:26:00,21626.0,SELL,1,0.02h,Stop Loss,$5.25,$240.25,$152422.00,273,$240.25
2025-01-21,16:34:00,21638.0,BUY,1,0.02h,Break Even,$0.25,$240.50,$152422.25,273,$240.50
2025-01-21,16:37:00,21620.75,SELL,1,0.02h,Stop Loss,$42.75,$283.25,$152465.00,273,$283.25
2025-01-21,16:50:00,21637.5,BUY,1,0.02h,Stop Loss,$7.75,$291.00,$152472.75,273,$291.00
2025-01-21,17:20:00,21658.75,SELL,1,0.02h,Break Even,$0.25,$291.25,$152473.00,273,$291.25
2025-01-21,17:23:00,21673.75,BUY,1,0.02h,Break Even,$0.25,$291.50,$152473.25,273,$291.50
2025-01-21,18:43:00,21744.25,SELL,1,0.02h,Stop Loss,$-6.00,$285.50,$152467.25,273,$285.50
2025-01-21,18:56:00,21753.0,BUY,1,0.02h,Stop Loss,$14.00,$299.50,$152481.25,273,$299.50
2025-01-21,19:15:00,21745.25,SELL,1,0.02h,Stop Loss,$47.75,$347.25,$152529.00,273,$347.25
2025-01-21,19:59:00,21723.75,BUY,1,0.02h,Break Even,$0.25,$347.50,$152529.25,273,$347.50
2025-01-21,20:38:00,21718.75,SELL,1,0.02h,Stop Loss,$-6.00,$341.50,$152523.25,273,$341.50
2025-01-21,20:40:00,21735.5,BUY,1,0.02h,Break Even,$0.25,$341.75,$152523.50,273,$341.75
2025-01-21,20:42:00,21720.5,SELL,1,0.02h,Stop Loss,$-6.00,$335.75,$152517.50,273,$335.75
2025-01-21,21:01:00,21752.75,BUY,1,0.02h,Stop Loss,$95.25,$431.00,$152612.75,273,$431.00
Final P&L Day: 431.00,,,,,,,,,,,
2025-01-22,13:06:00,21907.5,SELL,1,0.02h,Stop Loss,$-6.00,$-6.00,$152606.75,274,$-6.00
2025-01-22,13:07:00,21910.75,BUY,1,0.02h,Break Even,$0.25,$-5.75,$152607.00,274,$-5.75
2025-01-22,14:04:00,21922.5,SELL,1,0.02h,Break Even,$0.25,$-5.50,$152607.25,274,$-5.50
2025-01-22,14:32:00,21953.0,BUY,1,0.02h,Stop Loss,$129.00,$123.50,$152736.25,274,$123.50
2025-01-22,15:27:00,22009.5,SELL,1,0.02h,Stop Loss,$20.25,$143.75,$152756.50,274,$143.75
2025-01-22,15:29:00,22018.25,BUY,1,0.02h,Stop Loss,$7.75,$151.50,$152764.25,274,$151.50
2025-01-22,15:30:00,22012.75,SELL,1,0.02h,Stop Loss,$20.25,$171.75,$152784.50,274,$171.75
2025-01-22,15:31:00,22017.5,BUY,1,0.02h,Stop Loss,$32.75,$204.50,$152817.25,274,$204.50
2025-01-22,15:52:00,22014.25,SELL,1,0.02h,Stop Loss,$22.75,$227.25,$152840.00,274,$227.25
2025-01-22,16:09:00,22028.25,BUY,1,0.02h,Stop Loss,$-6.00,$221.25,$152834.00,274,$221.25
2025-01-22,16:11:00,22003.5,SELL,1,0.02h,Break Even,$0.25,$221.50,$152834.25,274,$221.50
2025-01-22,16:18:00,22020.25,BUY,1,0.02h,Stop Loss,$20.25,$241.75,$152854.50,274,$241.75
2025-01-22,17:16:00,22067.75,SELL,1,0.02h,Break Even,$0.25,$242.00,$152854.75,274,$242.00
2025-01-22,17:55:00,22067.0,BUY,1,0.02h,Stop Loss,$-6.00,$236.00,$152848.75,274,$236.00
2025-01-22,17:56:00,22061.0,SELL,1,0.02h,Stop Loss,$26.50,$262.50,$152875.25,274,$262.50
2025-01-22,18:41:00,22032.0,BUY,1,0.02h,Stop Loss,$4.00,$266.50,$152879.25,274,$266.50
2025-01-22,18:58:00,22022.5,SELL,1,0.02h,Stop Loss,$-6.00,$260.50,$152873.25,274,$260.50
2025-01-22,19:16:00,22033.0,BUY,1,0.02h,Break Even,$0.25,$260.75,$152873.50,274,$260.75
2025-01-22,19:27:00,22023.5,SELL,1,0.02h,Break Even,$0.25,$261.00,$152873.75,274,$261.00
2025-01-22,19:50:00,22029.5,BUY,1,0.02h,Break Even,$0.25,$261.25,$152874.00,274,$261.25
2025-01-22,20:08:00,22026.5,SELL,1,0.02h,Break Even,$0.25,$261.50,$152874.25,274,$261.50
2025-01-22,20:36:00,22026.0,BUY,1,0.02h,Stop Loss,$-6.00,$255.50,$152868.25,274,$255.50
2025-01-22,20:37:00,22014.5,SELL,1,0.02h,Stop Loss,$5.25,$260.75,$152873.50,274,$260.75
2025-01-22,21:56:00,21975.25,BUY,1,0.02h,Break Even,$0.25,$261.00,$152873.75,274,$261.00
Final P&L Day: 261.00,,,,,,,,,,,
2025-01-23,12:00:00,21898.0,SELL,1,0.02h,Stop Loss,$12.75,$12.75,$152886.50,275,$12.75
2025-01-23,12:32:00,21895.5,BUY,1,0.02h,Break Even,$0.25,$13.00,$152886.75,275,$13.00
2025-01-23,12:50:00,21888.75,SELL,1,0.02h,Stop Loss,$-6.00,$7.00,$152880.75,275,$7.00
2025-01-23,12:52:00,21900.75,BUY,1,0.02h,Stop Loss,$-6.00,$1.00,$152874.75,275,$1.00
2025-01-23,13:11:00,21882.5,SELL,1,0.02h,Stop Loss,$-6.00,$-5.00,$152868.75,275,$-5.00
2025-01-23,13:27:00,21898.5,BUY,1,0.02h,Break Even,$0.25,$-4.75,$152869.00,275,$-4.75
2025-01-23,13:37:00,21890.5,SELL,1,0.02h,Stop Loss,$25.25,$20.50,$152894.25,275,$20.50
2025-01-23,13:47:00,21897.0,BUY,1,0.02h,Break Even,$0.25,$20.75,$152894.50,275,$20.75
2025-01-23,14:06:00,21892.75,SELL,1,0.02h,Break Even,$0.25,$21.00,$152894.75,275,$21.00
2025-01-23,14:35:00,21897.75,BUY,1,0.02h,Stop Loss,$30.25,$51.25,$152925.00,275,$51.25
2025-01-23,14:57:00,21881.25,SELL,1,0.02h,Stop Loss,$-6.00,$45.25,$152919.00,275,$45.25
2025-01-23,15:14:00,21898.5,BUY,1,0.02h,Stop Loss,$9.00,$54.25,$152928.00,275,$54.25
2025-01-23,15:20:00,21882.25,SELL,1,0.02h,Break Even,$0.25,$54.50,$152928.25,275,$54.50
2025-01-23,15:24:00,21907.75,BUY,1,0.02h,Stop Loss,$-6.00,$48.50,$152922.25,275,$48.50
2025-01-23,16:10:00,21919.25,SELL,1,0.02h,Stop Loss,$-6.00,$42.50,$152916.25,275,$42.50
2025-01-23,16:15:00,21939.5,BUY,1,0.02h,Stop Loss,$19.00,$61.50,$152935.25,275,$61.50
2025-01-23,16:18:00,21922.5,SELL,1,0.02h,Stop Loss,$20.25,$81.75,$152955.50,275,$81.75
2025-01-23,16:28:00,21937.75,BUY,1,0.02h,Stop Loss,$20.25,$102.00,$152975.75,275,$102.00
2025-01-23,17:01:00,21935.5,SELL,1,0.02h,Break Even,$0.25,$102.25,$152976.00,275,$102.25
2025-01-23,17:19:00,21944.75,BUY,1,0.02h,Stop Loss,$-6.00,$96.25,$152970.00,275,$96.25
2025-01-23,17:24:00,21934.5,SELL,1,0.02h,Break Even,$0.25,$96.50,$152970.25,275,$96.50
2025-01-23,17:49:00,21925.25,BUY,1,0.02h,Break Even,$0.25,$96.75,$152970.50,275,$96.75
2025-01-23,18:48:00,21960.25,SELL,1,0.02h,Break Even,$0.25,$97.00,$152970.75,275,$97.00
2025-01-23,19:27:00,21947.5,BUY,1,0.02h,Break Even,$0.25,$97.25,$152971.00,275,$97.25
2025-01-23,19:55:00,21948.75,SELL,1,0.02h,Stop Loss,$4.00,$101.25,$152975.00,275,$101.25
2025-01-23,19:57:00,21955.75,BUY,1,0.02h,Stop Loss,$16.50,$117.75,$152991.50,275,$117.75
2025-01-23,20:02:00,21945.5,SELL,1,0.02h,Stop Loss,$-6.00,$111.75,$152985.50,275,$111.75
2025-01-23,20:08:00,21958.25,BUY,1,0.02h,Stop Loss,$5.25,$117.00,$152990.75,275,$117.00
2025-01-23,20:36:00,21962.0,SELL,1,0.02h,Break Even,$0.25,$117.25,$152991.00,275,$117.25
2025-01-23,20:37:00,21970.5,BUY,1,0.02h,Stop Loss,$15.25,$132.50,$153006.25,275,$132.50
2025-01-23,20:42:00,21962.0,SELL,1,0.02h,Break Even,$0.25,$132.75,$153006.50,275,$132.75
2025-01-23,20:48:00,21976.75,BUY,1,0.02h,Break Even,$0.25,$133.00,$153006.75,275,$133.00
2025-01-23,21:22:00,22011.25,SELL,1,0.02h,Stop Loss,$-6.00,$127.00,$153000.75,275,$127.00
2025-01-23,21:38:00,22019.0,BUY,1,0.02h,Stop Loss,$-6.00,$121.00,$152994.75,275,$121.00
2025-01-23,21:49:00,22013.75,SELL,1,0.02h,Stop Loss,$-6.00,$115.00,$152988.75,275,$115.00
2025-01-23,21:53:00,22016.75,BUY,1,0.02h,Break Even,$0.25,$115.25,$152989.00,275,$115.25
Final P&L Day: 115.25,,,,,,,,,,,
2025-01-24,12:02:00,22010.75,SELL,1,0.02h,Stop Loss,$-6.00,$-6.00,$152983.00,276,$-6.00
2025-01-24,12:06:00,22019.0,BUY,1,0.02h,Stop Loss,$11.50,$5.50,$152994.50,276,$5.50
2025-01-24,12:10:00,22015.75,SELL,1,0.02h,Stop Loss,$-6.00,$-0.50,$152988.50,276,$-0.50
2025-01-24,12:12:00,22018.0,BUY,1,0.02h,Break Even,$0.25,$-0.25,$152988.75,276,$-0.25
2025-01-24,12:40:00,22026.25,SELL,1,0.02h,Stop Loss,$-6.00,$-6.25,$152982.75,276,$-6.25
2025-01-24,13:01:00,22029.0,BUY,1,0.02h,Stop Loss,$-6.00,$-12.25,$152976.75,276,$-12.25
2025-01-24,13:05:00,22023.75,SELL,1,0.02h,Stop Loss,$-6.00,$-18.25,$152970.75,276,$-18.25
2025-01-24,13:07:00,22027.5,BUY,1,0.02h,Stop Loss,$-6.00,$-24.25,$152964.75,276,$-24.25
2025-01-24,13:08:00,22024.25,SELL,1,0.02h,Stop Loss,$11.50,$-12.75,$152976.25,276,$-12.75
2025-01-24,13:57:00,22007.75,BUY,1,0.02h,Break Even,$0.25,$-12.50,$152976.50,276,$-12.50
2025-01-24,14:33:00,22017.75,SELL,1,0.02h,Stop Loss,$14.00,$1.50,$152990.50,276,$1.50
2025-01-24,14:46:00,22048.75,BUY,1,0.02h,Stop Loss,$15.25,$16.75,$153005.75,276,$16.75
2025-01-24,15:04:00,22030.25,SELL,1,0.02h,Stop Loss,$50.25,$67.00,$153056.00,276,$67.00
2025-01-24,16:11:00,22000.25,BUY,1,0.02h,Stop Loss,$12.75,$79.75,$153068.75,276,$79.75
2025-01-24,16:18:00,21988.0,SELL,1,0.02h,Break Even,$0.25,$80.00,$153069.00,276,$80.00
2025-01-24,16:21:00,22003.5,BUY,1,0.02h,Stop Loss,$6.50,$86.50,$153075.50,276,$86.50
2025-01-24,16:57:00,21995.0,SELL,1,0.02h,Break Even,$0.25,$86.75,$153075.75,276,$86.75
2025-01-24,17:23:00,22001.0,BUY,1,0.02h,Stop Loss,$21.50,$108.25,$153097.25,276,$108.25
2025-01-24,17:29:00,21979.75,SELL,1,0.02h,Stop Loss,$56.50,$164.75,$153153.75,276,$164.75
2025-01-24,18:24:00,21947.75,BUY,1,0.02h,Stop Loss,$-6.00,$158.75,$153147.75,276,$158.75
2025-01-24,18:30:00,21935.0,SELL,1,0.02h,Stop Loss,$12.75,$171.50,$153160.50,276,$171.50
2025-01-24,18:32:00,21943.5,BUY,1,0.02h,Stop Loss,$-6.00,$165.50,$153154.50,276,$165.50
2025-01-24,18:33:00,21937.0,SELL,1,0.02h,Stop Loss,$39.00,$204.50,$153193.50,276,$204.50
2025-01-24,19:27:00,21875.0,BUY,1,0.02h,Stop Loss,$4.00,$208.50,$153197.50,276,$208.50
2025-01-24,20:01:00,21866.5,SELL,1,0.02h,Break Even,$0.25,$208.75,$153197.75,276,$208.75
2025-01-24,20:04:00,21885.75,BUY,1,0.02h,Break Even,$0.25,$209.00,$153198.00,276,$209.00
2025-01-24,20:11:00,21874.75,SELL,1,0.02h,Stop Loss,$-6.00,$203.00,$153192.00,276,$203.00
2025-01-24,20:12:00,21885.0,BUY,1,0.02h,Stop Loss,$14.00,$217.00,$153206.00,276,$217.00
2025-01-24,20:20:00,21871.75,SELL,1,0.02h,Break Even,$0.25,$217.25,$153206.25,276,$217.25
2025-01-24,20:37:00,21875.75,BUY,1,0.02h,Stop Loss,$6.50,$223.75,$153212.75,276,$223.75
2025-01-24,20:40:00,21874.25,SELL,1,0.02h,Stop Loss,$21.50,$245.25,$153234.25,276,$245.25
2025-01-24,20:49:00,21876.5,BUY,1,0.02h,Stop Loss,$7.75,$253.00,$153242.00,276,$253.00
2025-01-24,21:16:00,21897.0,SELL,1,0.02h,Break Even,$0.25,$253.25,$153242.25,276,$253.25
2025-01-24,21:27:00,21900.75,BUY,1,0.05h,Break Even,$0.25,$253.50,$153242.50,276,$253.50
2025-01-24,21:42:00,21898.25,SELL,1,0.02h,Stop Loss,$-6.00,$247.50,$153236.50,276,$247.50
2025-01-24,21:47:00,21904.75,BUY,1,0.02h,Stop Loss,$-6.00,$241.50,$153230.50,276,$241.50
Final P&L Day: 241.50,,,,,,,,,,,
2025-01-27,12:00:00,20999.75,SELL,1,0.02h,Break Even,$0.25,$0.25,$153230.75,277,$0.25
2025-01-27,12:47:00,21099.25,BUY,1,0.02h,Stop Loss,$14.00,$14.25,$153244.75,277,$14.25
2025-01-27,12:59:00,21078.75,SELL,1,0.02h,Stop Loss,$26.50,$40.75,$153271.25,277,$40.75
2025-01-27,13:08:00,21105.75,BUY,1,0.02h,Stop Loss,$59.00,$99.75,$153330.25,277,$99.75
2025-01-27,13:44:00,21130.5,SELL,1,0.02h,Break Even,$0.25,$100.00,$153330.50,277,$100.00
2025-01-27,13:47:00,21144.5,BUY,1,0.02h,Stop Loss,$21.50,$121.50,$153352.00,277,$121.50
2025-01-27,14:08:00,21140.5,SELL,1,0.02h,Stop Loss,$20.25,$141.75,$153372.25,277,$141.75
2025-01-27,14:31:00,21172.5,BUY,1,0.02h,Stop Loss,$400.25,$542.00,$153772.50,277,$542.00
2025-01-27,15:16:00,21282.25,SELL,1,0.02h,Stop Loss,$109.00,$651.00,$153881.50,277,$651.00
2025-01-27,15:26:00,21318.5,BUY,1,0.02h,Stop Loss,$67.75,$718.75,$153949.25,277,$718.75
2025-01-27,15:53:00,21351.5,SELL,1,0.02h,Stop Loss,$76.50,$795.25,$154025.75,277,$795.25
2025-01-27,16:48:00,21268.5,BUY,1,0.02h,Stop Loss,$22.75,$818.00,$154048.50,277,$818.00
2025-01-27,16:55:00,21193.25,SELL,1,0.02h,Stop Loss,$30.25,$848.25,$154078.75,277,$848.25
2025-01-27,17:03:00,21250.25,BUY,1,0.02h,Stop Loss,$70.25,$918.50,$154149.00,277,$918.50
2025-01-27,17:10:00,21204.25,SELL,1,0.02h,Stop Loss,$22.75,$941.25,$154171.75,277,$941.25
2025-01-27,17:30:00,21227.0,BUY,1,0.02h,Stop Loss,$-6.00,$935.25,$154165.75,277,$935.25
2025-01-27,17:46:00,21206.25,SELL,1,0.02h,Stop Loss,$49.00,$984.25,$154214.75,277,$984.25
2025-01-27,18:17:00,21186.0,BUY,1,0.02h,Stop Loss,$10.25,$994.50,$154225.00,277,$994.50
2025-01-27,18:19:00,21161.25,SELL,1,0.02h,Stop Loss,$17.75,$1012.25,$154242.75,277,$1012.25
2025-01-27,18:21:00,21178.5,BUY,1,0.02h,Break Even,$0.25,$1012.50,$154243.00,277,$1012.50
2025-01-27,18:22:00,21166.5,SELL,1,0.02h,Stop Loss,$4.00,$1016.50,$154247.00,277,$1016.50
2025-01-27,18:34:00,21194.25,BUY,1,0.02h,Stop Loss,$24.00,$1040.50,$154271.00,277,$1040.50
2025-01-27,18:55:00,21180.25,SELL,1,0.02h,Stop Loss,$49.00,$1089.50,$154320.00,277,$1089.50
2025-01-27,19:14:00,21180.0,BUY,1,0.02h,Stop Loss,$16.50,$1106.00,$154336.50,277,$1106.00
2025-01-27,19:15:00,21171.5,SELL,1,0.02h,Stop Loss,$4.00,$1110.00,$154340.50,277,$1110.00
2025-01-27,19:16:00,21187.75,BUY,1,0.02h,Stop Loss,$15.25,$1125.25,$154355.75,277,$1125.25
2025-01-27,19:41:00,21205.0,SELL,1,0.02h,Stop Loss,$64.00,$1189.25,$154419.75,277,$1189.25
2025-01-27,20:09:00,21172.25,BUY,1,0.02h,Stop Loss,$49.00,$1238.25,$154468.75,277,$1238.25
2025-01-27,21:44:00,21305.0,SELL,1,0.02h,Break Even,$0.25,$1238.50,$154469.00,277,$1238.50
Final P&L Day: 1238.50,,,,,,,,,,,
2025-01-28,12:00:00,21341.5,BUY,1,0.02h,Stop Loss,$17.75,$17.75,$154486.75,278,$17.75
2025-01-28,12:11:00,21291.5,SELL,1,0.02h,Break Even,$0.25,$18.00,$154487.00,278,$18.00
2025-01-28,12:47:00,21287.75,BUY,1,0.02h,Break Even,$0.25,$18.25,$154487.25,278,$18.25
2025-01-28,13:36:00,21299.5,SELL,1,0.02h,Stop Loss,$9.00,$27.25,$154496.25,278,$27.25
2025-01-28,14:26:00,21307.25,BUY,1,0.02h,Break Even,$0.25,$27.50,$154496.50,278,$27.50
2025-01-28,14:32:00,21251.75,SELL,1,0.02h,Stop Loss,$39.00,$66.50,$154535.50,278,$66.50
2025-01-28,14:55:00,21265.0,BUY,1,0.02h,Stop Loss,$24.00,$90.50,$154559.50,278,$90.50
2025-01-28,15:54:00,21415.75,SELL,1,0.02h,Stop Loss,$26.50,$117.00,$154586.00,278,$117.00
2025-01-28,15:59:00,21451.0,BUY,1,0.02h,Stop Loss,$22.75,$139.75,$154608.75,278,$139.75
2025-01-28,16:21:00,21444.25,SELL,1,0.02h,Stop Loss,$27.75,$167.50,$154636.50,278,$167.50
2025-01-28,16:48:00,21436.0,BUY,1,0.02h,Stop Loss,$40.25,$207.75,$154676.75,278,$207.75
2025-01-28,17:44:00,21531.0,SELL,1,0.02h,Break Even,$0.25,$208.00,$154677.00,278,$208.00
2025-01-28,17:56:00,21552.25,BUY,1,0.02h,Stop Loss,$-6.00,$202.00,$154671.00,278,$202.00
2025-01-28,18:27:00,21551.75,SELL,1,0.02h,Stop Loss,$10.25,$212.25,$154681.25,278,$212.25
2025-01-28,19:19:00,21545.75,BUY,1,0.02h,Stop Loss,$31.50,$243.75,$154712.75,278,$243.75
2025-01-28,20:06:00,21594.75,SELL,1,0.02h,Stop Loss,$16.50,$260.25,$154729.25,278,$260.25
2025-01-28,20:16:00,21608.5,BUY,1,0.02h,Stop Loss,$27.75,$288.00,$154757.00,278,$288.00
2025-01-28,20:38:00,21600.75,SELL,1,0.02h,Stop Loss,$4.00,$292.00,$154761.00,278,$292.00
2025-01-28,21:49:00,21562.25,BUY,1,0.02h,Break Even,$0.25,$292.25,$154761.25,278,$292.25
2025-01-28,21:57:00,21558.0,SELL,1,0.02h,Break Even,$0.25,$292.50,$154761.50,278,$292.50
Final P&L Day: 292.50,,,,,,,,,,,
2025-01-29,12:00:00,21681.25,BUY,1,0.02h,Break Even,$0.25,$0.25,$154761.75,279,$0.25
2025-01-29,12:44:00,21655.75,SELL,1,0.02h,Stop Loss,$-6.00,$-5.75,$154755.75,279,$-5.75
2025-01-29,13:58:00,21588.0,BUY,1,0.02h,Stop Loss,$39.00,$33.25,$154794.75,279,$33.25
2025-01-29,14:31:00,21583.5,SELL,1,0.02h,Stop Loss,$79.00,$112.25,$154873.75,279,$112.25
2025-01-29,15:03:00,21556.5,BUY,1,0.02h,Stop Loss,$6.50,$118.75,$154880.25,279,$118.75
2025-01-29,15:05:00,21529.5,SELL,1,0.02h,Break Even,$0.25,$119.00,$154880.50,279,$119.00
2025-01-29,15:07:00,21547.75,BUY,1,0.02h,Stop Loss,$41.50,$160.50,$154922.00,279,$160.50
2025-01-29,15:14:00,21522.25,SELL,1,0.02h,Stop Loss,$-6.00,$154.50,$154916.00,279,$154.50
2025-01-29,15:23:00,21547.25,BUY,1,0.02h,Break Even,$0.25,$154.75,$154916.25,279,$154.75
2025-01-29,15:26:00,21507.0,SELL,1,0.02h,Stop Loss,$74.00,$228.75,$154990.25,279,$228.75
2025-01-29,15:54:00,21518.25,BUY,1,0.02h,Stop Loss,$41.50,$270.25,$155031.75,279,$270.25
2025-01-29,16:08:00,21492.25,SELL,1,0.02h,Stop Loss,$25.25,$295.50,$155057.00,279,$295.50
2025-01-29,16:26:00,21509.25,BUY,1,0.02h,Stop Loss,$-6.00,$289.50,$155051.00,279,$289.50
2025-01-29,16:31:00,21488.0,SELL,1,0.02h,Stop Loss,$15.25,$304.75,$155066.25,279,$304.75
2025-01-29,16:36:00,21502.5,BUY,1,0.02h,Stop Loss,$20.25,$325.00,$155086.50,279,$325.00
2025-01-29,16:39:00,21486.75,SELL,1,0.02h,Stop Loss,$66.50,$391.50,$155153.00,279,$391.50
2025-01-29,16:50:00,21505.25,BUY,1,0.02h,Stop Loss,$5.25,$396.75,$155158.25,279,$396.75
2025-01-29,16:57:00,21472.75,SELL,1,0.02h,Stop Loss,$6.50,$403.25,$155164.75,279,$403.25
2025-01-29,17:02:00,21514.0,BUY,1,0.02h,Break Even,$0.25,$403.50,$155165.00,279,$403.50
2025-01-29,17:46:00,21515.5,SELL,1,0.02h,Stop Loss,$31.50,$435.00,$155196.50,279,$435.00
2025-01-29,18:27:00,21468.5,BUY,1,0.02h,Stop Loss,$16.50,$451.50,$155213.00,279,$451.50
2025-01-29,18:43:00,21458.5,SELL,1,0.02h,Break Even,$0.25,$451.75,$155213.25,279,$451.75
2025-01-29,18:49:00,21487.75,BUY,1,0.02h,Stop Loss,$16.50,$468.25,$155229.75,279,$468.25
2025-01-29,19:01:00,21416.5,SELL,1,0.02h,Stop Loss,$27.75,$496.00,$155257.50,279,$496.00
2025-01-29,19:33:00,21469.0,BUY,1,0.02h,Stop Loss,$27.75,$523.75,$155285.25,279,$523.75
2025-01-29,19:37:00,21400.0,SELL,1,0.02h,Stop Loss,$9.00,$532.75,$155294.25,279,$532.75
2025-01-29,19:38:00,21445.75,BUY,1,0.02h,Stop Loss,$209.00,$741.75,$155503.25,279,$741.75
2025-01-29,20:05:00,21496.25,SELL,1,0.02h,Stop Loss,$26.50,$768.25,$155529.75,279,$768.25
2025-01-29,20:12:00,21527.25,BUY,1,0.02h,Stop Loss,$15.25,$783.50,$155545.00,279,$783.50
2025-01-29,20:14:00,21499.5,SELL,1,0.02h,Stop Loss,$85.25,$868.75,$155630.25,279,$868.75
2025-01-29,20:23:00,21551.5,BUY,1,0.02h,Stop Loss,$26.50,$895.25,$155656.75,279,$895.25
2025-01-29,20:40:00,21521.5,SELL,1,0.02h,Stop Loss,$11.50,$906.75,$155668.25,279,$906.75
2025-01-29,21:17:00,21511.25,BUY,1,0.02h,Stop Loss,$5.25,$912.00,$155673.50,279,$912.00
2025-01-29,21:19:00,21484.25,SELL,1,0.02h,Break Even,$0.25,$912.25,$155673.75,279,$912.25
2025-01-29,21:20:00,21507.75,BUY,1,0.02h,Stop Loss,$60.25,$972.50,$155734.00,279,$972.50
Final P&L Day: 972.50,,,,,,,,,,,
2025-01-30,12:18:00,21586.75,SELL,1,0.02h,Break Even,$0.25,$0.25,$155734.25,280,$0.25
2025-01-30,12:37:00,21605.75,BUY,1,0.02h,Stop Loss,$39.00,$39.25,$155773.25,280,$39.25
2025-01-30,13:25:00,21630.5,SELL,1,0.02h,Stop Loss,$-6.00,$33.25,$155767.25,280,$33.25
2025-01-30,13:31:00,21639.25,BUY,1,0.02h,Stop Loss,$112.75,$146.00,$155880.00,280,$146.00
2025-01-30,13:38:00,21620.5,SELL,1,0.02h,Stop Loss,$24.00,$170.00,$155904.00,280,$170.00
2025-01-30,13:53:00,21636.5,BUY,1,0.02h,Stop Loss,$30.25,$200.25,$155934.25,280,$200.25
2025-01-30,14:17:00,21640.25,SELL,1,0.02h,Stop Loss,$32.75,$233.00,$155967.00,280,$233.00
2025-01-30,14:32:00,21661.75,BUY,1,0.02h,Stop Loss,$19.00,$252.00,$155986.00,280,$252.00
2025-01-30,14:35:00,21619.75,SELL,1,0.02h,Stop Loss,$96.50,$348.50,$156082.50,280,$348.50
2025-01-30,14:41:00,21654.25,BUY,1,0.02h,Break Even,$0.25,$348.75,$156082.75,280,$348.75
2025-01-30,14:43:00,21627.25,SELL,1,0.02h,Stop Loss,$25.25,$374.00,$156108.00,280,$374.00
2025-01-30,14:44:00,21647.25,BUY,1,0.02h,Stop Loss,$14.00,$388.00,$156122.00,280,$388.00
2025-01-30,15:02:00,21648.0,SELL,1,0.02h,Stop Loss,$272.75,$660.75,$156394.75,280,$660.75
2025-01-30,15:49:00,21579.25,BUY,1,0.02h,Stop Loss,$-6.00,$654.75,$156388.75,280,$654.75
2025-01-30,15:51:00,21557.0,SELL,1,0.02h,Stop Loss,$44.00,$698.75,$156432.75,280,$698.75
2025-01-30,16:23:00,21500.5,BUY,1,0.02h,Stop Loss,$71.50,$770.25,$156504.25,280,$770.25
2025-01-30,17:13:00,21571.25,SELL,1,0.02h,Stop Loss,$89.00,$859.25,$156593.25,280,$859.25
2025-01-30,17:49:00,21540.5,BUY,1,0.02h,Stop Loss,$-6.00,$853.25,$156587.25,280,$853.25
2025-01-30,19:32:00,21602.5,SELL,1,0.02h,Stop Loss,$6.50,$859.75,$156593.75,280,$859.75
2025-01-30,19:39:00,21611.75,BUY,1,0.02h,Stop Loss,$9.00,$868.75,$156602.75,280,$868.75
2025-01-30,20:37:00,21653.0,SELL,1,0.02h,Stop Loss,$165.25,$1034.00,$156768.00,280,$1034.00
2025-01-30,20:57:00,21648.25,BUY,1,0.02h,Stop Loss,$27.75,$1061.75,$156795.75,280,$1061.75
2025-01-30,21:20:00,21628.75,SELL,1,0.02h,Break Even,$0.25,$1062.00,$156796.00,280,$1062.00
2025-01-30,21:31:00,21643.75,BUY,1,0.02h,Stop Loss,$70.25,$1132.25,$156866.25,280,$1132.25
2025-01-30,21:34:00,21619.5,SELL,1,0.02h,Stop Loss,$31.50,$1163.75,$156897.75,280,$1163.75
Final P&L Day: 1163.75,,,,,,,,,,,
2025-01-31,12:00:00,21804.5,BUY,1,0.02h,Stop Loss,$30.25,$30.25,$156928.00,281,$30.25
2025-01-31,12:57:00,21787.25,SELL,1,0.02h,Stop Loss,$10.25,$40.50,$156938.25,281,$40.50
2025-01-31,13:19:00,21789.0,BUY,1,0.02h,Stop Loss,$4.00,$44.50,$156942.25,281,$44.50
2025-01-31,13:33:00,21780.75,SELL,1,0.02h,Break Even,$0.25,$44.75,$156942.50,281,$44.75
2025-01-31,13:49:00,21797.75,BUY,1,0.02h,Stop Loss,$4.00,$48.75,$156946.50,281,$48.75
2025-01-31,14:02:00,21780.5,SELL,1,0.02h,Stop Loss,$25.25,$74.00,$156971.75,281,$74.00
2025-01-31,14:30:00,21775.0,BUY,1,0.02h,Stop Loss,$71.50,$145.50,$157043.25,281,$145.50
2025-01-31,16:21:00,21935.5,SELL,1,0.02h,Stop Loss,$41.50,$187.00,$157084.75,281,$187.00
2025-01-31,17:15:00,21912.0,BUY,1,0.02h,Stop Loss,$-6.00,$181.00,$157078.75,281,$181.00
2025-01-31,17:44:00,21917.0,SELL,1,0.02h,Stop Loss,$11.50,$192.50,$157090.25,281,$192.50
2025-01-31,17:51:00,21927.25,BUY,1,0.02h,Stop Loss,$6.50,$199.00,$157096.75,281,$199.00
2025-01-31,17:59:00,21914.0,SELL,1,0.02h,Break Even,$0.25,$199.25,$157097.00,281,$199.25
2025-01-31,18:07:00,21923.0,BUY,1,0.02h,Break Even,$0.25,$199.50,$157097.25,281,$199.50
2025-01-31,18:10:00,21911.75,SELL,1,0.02h,Break Even,$0.25,$199.75,$157097.50,281,$199.75
2025-01-31,20:00:00,21661.75,BUY,1,0.02h,Stop Loss,$-6.00,$193.75,$157091.50,281,$193.75
2025-01-31,20:01:00,21631.0,SELL,1,0.02h,Stop Loss,$51.50,$245.25,$157143.00,281,$245.25
2025-01-31,20:48:00,21593.25,BUY,1,0.02h,Stop Loss,$94.00,$339.25,$157237.00,281,$339.25
2025-01-31,21:03:00,21565.25,SELL,1,0.02h,Stop Loss,$126.50,$465.75,$157363.50,281,$465.75
2025-01-31,21:22:00,21578.75,BUY,1,0.02h,Break Even,$0.25,$466.00,$157363.75,281,$466.00
2025-01-31,21:31:00,21562.5,SELL,1,0.02h,Stop Loss,$15.25,$481.25,$157379.00,281,$481.25
2025-01-31,21:51:00,21575.5,BUY,1,0.02h,Break Even,$0.25,$481.50,$157379.25,281,$481.50
2025-01-31,21:56:00,21557.75,SELL,1,0.02h,Stop Loss,$4.00,$485.50,$157383.25,281,$485.50
Final P&L Day: 485.50,,,,,,,,,,,
2025-02-03,13:04:00,21206.75,BUY,1,0.02h,Stop Loss,$4.00,$4.00,$157387.25,282,$4.00
2025-02-03,13:35:00,21203.5,SELL,1,0.02h,Stop Loss,$61.50,$65.50,$157448.75,282,$65.50
2025-02-03,14:00:00,21202.25,BUY,1,0.02h,Stop Loss,$17.75,$83.25,$157466.50,282,$83.25
2025-02-03,14:11:00,21190.0,SELL,1,0.02h,Stop Loss,$15.25,$98.50,$157481.75,282,$98.50
2025-02-03,14:12:00,21206.5,BUY,1,0.02h,Stop Loss,$110.25,$208.75,$157592.00,282,$208.75
2025-02-03,14:27:00,21188.75,SELL,1,0.02h,Stop Loss,$19.00,$227.75,$157611.00,282,$227.75
2025-02-03,14:32:00,21228.75,BUY,1,0.02h,Stop Loss,$116.50,$344.25,$157727.50,282,$344.25
2025-02-03,14:49:00,21214.0,SELL,1,0.02h,Stop Loss,$19.00,$363.25,$157746.50,282,$363.25
2025-02-03,15:24:00,21229.75,BUY,1,0.02h,Stop Loss,$470.25,$833.50,$158216.75,282,$833.50
2025-02-03,16:06:00,21346.25,SELL,1,0.02h,Stop Loss,$9.00,$842.50,$158225.75,282,$842.50
2025-02-03,16:07:00,21411.5,BUY,1,0.02h,Break Even,$0.25,$842.75,$158226.00,282,$842.75
2025-02-03,16:29:00,21409.25,SELL,1,0.02h,Stop Loss,$72.75,$915.50,$158298.75,282,$915.50
2025-02-03,16:40:00,21433.25,BUY,1,0.02h,Stop Loss,$37.75,$953.25,$158336.50,282,$953.25
2025-02-03,16:43:00,21408.5,SELL,1,0.02h,Stop Loss,$35.25,$988.50,$158371.75,282,$988.50
2025-02-03,16:46:00,21433.5,BUY,1,0.02h,Stop Loss,$65.25,$1053.75,$158437.00,282,$1053.75
2025-02-03,16:58:00,21383.5,SELL,1,0.02h,Stop Loss,$66.50,$1120.25,$158503.50,282,$1120.25
2025-02-03,17:22:00,21414.5,BUY,1,0.02h,Stop Loss,$26.50,$1146.75,$158530.00,282,$1146.75
2025-02-03,17:32:00,21383.0,SELL,1,0.02h,Stop Loss,$30.25,$1177.00,$158560.25,282,$1177.00
2025-02-03,17:52:00,21401.5,BUY,1,0.02h,Stop Loss,$11.50,$1188.50,$158571.75,282,$1188.50
2025-02-03,18:02:00,21371.25,SELL,1,0.02h,Stop Loss,$86.50,$1275.00,$158658.25,282,$1275.00
2025-02-03,18:05:00,21407.0,BUY,1,0.02h,Break Even,$0.25,$1275.25,$158658.50,282,$1275.25
2025-02-03,18:11:00,21369.0,SELL,1,0.02h,Stop Loss,$39.00,$1314.25,$158697.50,282,$1314.25
2025-02-03,18:14:00,21417.75,BUY,1,0.02h,Stop Loss,$12.75,$1327.00,$158710.25,282,$1327.00
2025-02-03,19:37:00,21486.75,SELL,1,0.02h,Stop Loss,$29.00,$1356.00,$158739.25,282,$1356.00
2025-02-03,19:42:00,21504.75,BUY,1,0.02h,Break Even,$0.25,$1356.25,$158739.50,282,$1356.25
2025-02-03,19:58:00,21486.0,SELL,1,0.02h,Stop Loss,$29.00,$1385.25,$158768.50,282,$1385.25
2025-02-03,20:22:00,21491.75,BUY,1,0.02h,Break Even,$0.25,$1385.50,$158768.75,282,$1385.50
2025-02-03,20:27:00,21471.75,SELL,1,0.02h,Stop Loss,$15.25,$1400.75,$158784.00,282,$1400.75
2025-02-03,21:13:00,21434.0,BUY,1,0.02h,Stop Loss,$-6.00,$1394.75,$158778.00,282,$1394.75
Final P&L Day: 1394.75,,,,,,,,,,,
2025-02-04,12:00:00,21400.0,SELL,1,0.02h,Stop Loss,$-6.00,$-6.00,$158772.00,283,$-6.00
2025-02-04,12:33:00,21450.5,BUY,1,0.02h,Break Even,$0.25,$-5.75,$158772.25,283,$-5.75
2025-02-04,12:50:00,21445.0,SELL,1,0.02h,Stop Loss,$19.00,$13.25,$158791.25,283,$13.25
2025-02-04,12:59:00,21477.25,BUY,1,0.02h,Stop Loss,$11.50,$24.75,$158802.75,283,$24.75
2025-02-04,13:01:00,21436.5,SELL,1,0.02h,Stop Loss,$31.50,$56.25,$158834.25,283,$56.25
2025-02-04,13:09:00,21456.75,BUY,1,0.02h,Stop Loss,$47.75,$104.00,$158882.00,283,$104.00
2025-02-04,13:30:00,21459.0,SELL,1,0.02h,Stop Loss,$35.25,$139.25,$158917.25,283,$139.25
2025-02-04,14:08:00,21443.0,BUY,1,0.02h,Stop Loss,$5.25,$144.50,$158922.50,283,$144.50
2025-02-04,14:16:00,21422.25,SELL,1,0.02h,Break Even,$0.25,$144.75,$158922.75,283,$144.75
2025-02-04,14:34:00,21449.0,BUY,1,0.02h,Stop Loss,$62.75,$207.50,$158985.50,283,$207.50
2025-02-04,15:52:00,21645.75,SELL,1,0.02h,Stop Loss,$9.00,$216.50,$158994.50,283,$216.50
2025-02-04,16:04:00,21657.0,BUY,1,0.02h,Stop Loss,$39.00,$255.50,$159033.50,283,$255.50
2025-02-04,16:24:00,21642.5,SELL,1,0.02h,Stop Loss,$-6.00,$249.50,$159027.50,283,$249.50
2025-02-04,16:28:00,21659.5,BUY,1,0.02h,Stop Loss,$70.25,$319.75,$159097.75,283,$319.75
2025-02-04,16:49:00,21663.5,SELL,1,0.02h,Stop Loss,$76.50,$396.25,$159174.25,283,$396.25
2025-02-04,17:47:00,21595.25,BUY,1,0.02h,Break Even,$0.25,$396.50,$159174.50,283,$396.50
2025-02-04,17:49:00,21584.0,SELL,1,0.02h,Break Even,$0.25,$396.75,$159174.75,283,$396.75
2025-02-04,17:51:00,21597.5,BUY,1,0.02h,Stop Loss,$-6.00,$390.75,$159168.75,283,$390.75
2025-02-04,18:06:00,21571.5,SELL,1,0.02h,Stop Loss,$-6.00,$384.75,$159162.75,283,$384.75
2025-02-04,18:14:00,21605.75,BUY,1,0.02h,Break Even,$0.25,$385.00,$159163.00,283,$385.00
2025-02-04,18:59:00,21626.25,SELL,1,0.02h,Stop Loss,$5.25,$390.25,$159168.25,283,$390.25
2025-02-04,19:06:00,21645.5,BUY,1,0.02h,Stop Loss,$20.25,$410.50,$159188.50,283,$410.50
2025-02-04,19:48:00,21652.5,SELL,1,0.02h,Stop Loss,$6.50,$417.00,$159195.00,283,$417.00
2025-02-04,20:13:00,21651.25,BUY,1,0.02h,Break Even,$0.25,$417.25,$159195.25,283,$417.25
2025-02-04,20:21:00,21637.0,SELL,1,0.02h,Stop Loss,$4.00,$421.25,$159199.25,283,$421.25
2025-02-04,20:38:00,21650.5,BUY,1,0.02h,Break Even,$0.25,$421.50,$159199.50,283,$421.50
2025-02-04,21:03:00,21613.5,SELL,1,0.02h,Stop Loss,$94.00,$515.50,$159293.50,283,$515.50
Final P&L Day: 515.50,,,,,,,,,,,
2025-02-05,12:43:00,21497.75,BUY,1,0.02h,Break Even,$0.25,$0.25,$159293.75,284,$0.25
2025-02-05,13:17:00,21497.5,SELL,1,0.02h,Break Even,$0.25,$0.50,$159294.00,284,$0.50
2025-02-05,13:21:00,21511.5,BUY,1,0.02h,Stop Loss,$37.75,$38.25,$159331.75,284,$38.25
2025-02-05,13:57:00,21518.75,SELL,1,0.02h,Stop Loss,$-6.00,$32.25,$159325.75,284,$32.25
2025-02-05,13:59:00,21531.5,BUY,1,0.02h,Stop Loss,$-6.00,$26.25,$159319.75,284,$26.25
2025-02-05,14:03:00,21513.5,SELL,1,0.02h,Break Even,$0.25,$26.50,$159320.00,284,$26.50
2025-02-05,14:07:00,21531.5,BUY,1,0.02h,Stop Loss,$-6.00,$20.50,$159314.00,284,$20.50
2025-02-05,14:56:00,21554.75,SELL,1,0.02h,Break Even,$0.25,$20.75,$159314.25,284,$20.75
2025-02-05,15:01:00,21589.25,BUY,1,0.02h,Stop Loss,$5.25,$26.00,$159319.50,284,$26.00
2025-02-05,15:04:00,21520.0,SELL,1,0.02h,Stop Loss,$79.00,$105.00,$159398.50,284,$105.00
2025-02-05,15:26:00,21554.75,BUY,1,0.02h,Stop Loss,$59.00,$164.00,$159457.50,284,$164.00
2025-02-05,16:18:00,21571.75,SELL,1,0.02h,Break Even,$0.25,$164.25,$159457.75,284,$164.25
2025-02-05,16:29:00,21605.0,BUY,1,0.02h,Stop Loss,$71.50,$235.75,$159529.25,284,$235.75
2025-02-05,17:22:00,21708.0,SELL,1,0.02h,Break Even,$0.25,$236.00,$159529.50,284,$236.00
2025-02-05,17:49:00,21710.25,BUY,1,0.02h,Break Even,$0.25,$236.25,$159529.75,284,$236.25
2025-02-05,17:52:00,21689.25,SELL,1,0.02h,Stop Loss,$-6.00,$230.25,$159523.75,284,$230.25
2025-02-05,18:02:00,21713.0,BUY,1,0.02h,Break Even,$0.25,$230.50,$159524.00,284,$230.50
2025-02-05,18:09:00,21699.75,SELL,1,0.02h,Stop Loss,$5.25,$235.75,$159529.25,284,$235.75
2025-02-05,18:22:00,21705.75,BUY,1,0.02h,Stop Loss,$-6.00,$229.75,$159523.25,284,$229.75
2025-02-05,18:23:00,21701.0,SELL,1,0.02h,Stop Loss,$7.75,$237.50,$159531.00,284,$237.50
2025-02-05,18:37:00,21704.5,BUY,1,0.02h,Stop Loss,$10.25,$247.75,$159541.25,284,$247.75
2025-02-05,18:53:00,21695.0,SELL,1,0.02h,Stop Loss,$29.00,$276.75,$159570.25,284,$276.75
2025-02-05,18:59:00,21709.75,BUY,1,0.02h,Break Even,$0.25,$277.00,$159570.50,284,$277.00
2025-02-05,19:29:00,21718.75,SELL,1,0.02h,Break Even,$0.25,$277.25,$159570.75,284,$277.25
2025-02-05,20:02:00,21720.25,BUY,1,0.02h,Stop Loss,$5.25,$282.50,$159576.00,284,$282.50
2025-02-05,20:38:00,21729.25,SELL,1,0.02h,Stop Loss,$17.75,$300.25,$159593.75,284,$300.25
2025-02-05,20:56:00,21743.0,BUY,1,0.02h,Stop Loss,$37.75,$338.00,$159631.50,284,$338.00
2025-02-05,21:31:00,21764.75,SELL,1,0.02h,Stop Loss,$6.50,$344.50,$159638.00,284,$344.50
2025-02-05,21:56:00,21770.25,BUY,1,0.02h,Stop Loss,$-6.00,$338.50,$159632.00,284,$338.50
Final P&L Day: 338.50,,,,,,,,,,,
2025-02-06,12:00:00,21725.75,SELL,1,0.02h,Stop Loss,$47.75,$47.75,$159679.75,285,$47.75
2025-02-06,12:24:00,21734.25,BUY,1,0.02h,Break Even,$0.25,$48.00,$159680.00,285,$48.00
2025-02-06,13:32:00,21761.0,SELL,1,0.02h,Stop Loss,$4.00,$52.00,$159684.00,285,$52.00
2025-02-06,13:56:00,21771.25,BUY,1,0.02h,Stop Loss,$15.25,$67.25,$159699.25,285,$67.25
2025-02-06,14:16:00,21766.0,SELL,1,0.02h,Break Even,$0.25,$67.50,$159699.50,285,$67.50
2025-02-06,14:19:00,21772.5,BUY,1,0.02h,Stop Loss,$4.00,$71.50,$159703.50,285,$71.50
2025-02-06,14:32:00,21742.25,SELL,1,0.02h,Stop Loss,$5.25,$76.75,$159708.75,285,$76.75
2025-02-06,14:45:00,21788.75,BUY,1,0.02h,Stop Loss,$81.50,$158.25,$159790.25,285,$158.25
2025-02-06,15:03:00,21779.5,SELL,1,0.02h,Break Even,$0.25,$158.50,$159790.50,285,$158.50
2025-02-06,15:09:00,21800.75,BUY,1,0.02h,Stop Loss,$86.50,$245.00,$159877.00,285,$245.00
2025-02-06,15:27:00,21791.25,SELL,1,0.02h,Stop Loss,$14.00,$259.00,$159891.00,285,$259.00
2025-02-06,15:39:00,21832.0,BUY,1,0.02h,Break Even,$0.25,$259.25,$159891.25,285,$259.25
2025-02-06,15:40:00,21763.25,SELL,1,0.02h,Stop Loss,$5.25,$264.50,$159896.50,285,$264.50
2025-02-06,16:04:00,21785.0,BUY,1,0.02h,Break Even,$0.25,$264.75,$159896.75,285,$264.75
2025-02-06,16:06:00,21775.0,SELL,1,0.02h,Stop Loss,$-6.00,$258.75,$159890.75,285,$258.75
2025-02-06,16:07:00,21777.0,BUY,1,0.02h,Stop Loss,$17.75,$276.50,$159908.50,285,$276.50
2025-02-06,16:08:00,21772.75,SELL,1,0.02h,Stop Loss,$4.00,$280.50,$159912.50,285,$280.50
2025-02-06,16:09:00,21782.0,BUY,1,0.02h,Stop Loss,$26.50,$307.00,$159939.00,285,$307.00
2025-02-06,16:33:00,21793.75,SELL,1,0.02h,Stop Loss,$24.00,$331.00,$159963.00,285,$331.00
2025-02-06,17:10:00,21776.0,BUY,1,0.02h,Stop Loss,$-6.00,$325.00,$159957.00,285,$325.00
2025-02-06,17:11:00,21772.25,SELL,1,0.02h,Stop Loss,$14.00,$339.00,$159971.00,285,$339.00
2025-02-06,17:18:00,21786.0,BUY,1,0.02h,Stop Loss,$7.75,$346.75,$159978.75,285,$346.75
2025-02-06,17:34:00,21784.75,SELL,1,0.02h,Break Even,$0.25,$347.00,$159979.00,285,$347.00
2025-02-06,17:36:00,21788.75,BUY,1,0.02h,Break Even,$0.25,$347.25,$159979.25,285,$347.25
2025-02-06,18:17:00,21813.75,SELL,1,0.02h,Stop Loss,$41.50,$388.75,$160020.75,285,$388.75
2025-02-06,18:19:00,21822.5,BUY,1,0.02h,Break Even,$0.25,$389.00,$160021.00,285,$389.00
2025-02-06,18:39:00,21817.25,SELL,1,0.02h,Break Even,$0.25,$389.25,$160021.25,285,$389.25
2025-02-06,18:50:00,21828.75,BUY,1,0.02h,Break Even,$0.25,$389.50,$160021.50,285,$389.50
2025-02-06,18:51:00,21822.5,SELL,1,0.02h,Stop Loss,$4.00,$393.50,$160025.50,285,$393.50
2025-02-06,19:10:00,21823.5,BUY,1,0.02h,Stop Loss,$12.75,$406.25,$160038.25,285,$406.25
2025-02-06,19:23:00,21816.75,SELL,1,0.02h,Stop Loss,$-6.00,$400.25,$160032.25,285,$400.25
2025-02-06,19:54:00,21768.5,BUY,1,0.02h,Break Even,$0.25,$400.50,$160032.50,285,$400.50
2025-02-06,19:59:00,21750.5,SELL,1,0.02h,Stop Loss,$37.75,$438.25,$160070.25,285,$438.25
2025-02-06,20:14:00,21759.75,BUY,1,0.02h,Break Even,$0.25,$438.50,$160070.50,285,$438.50
2025-02-06,21:06:00,21819.75,SELL,1,0.02h,Stop Loss,$55.25,$493.75,$160125.75,285,$493.75
2025-02-06,21:20:00,21844.0,BUY,1,0.02h,Stop Loss,$14.00,$507.75,$160139.75,285,$507.75
2025-02-06,21:47:00,21840.25,SELL,1,0.02h,Stop Loss,$14.00,$521.75,$160153.75,285,$521.75
2025-02-06,22:01:00,21844.25,BUY,1,13.98h,Stop Loss,$126.50,$648.25,$160280.25,285,$648.25
Final P&L Day: 648.25,,,,,,,,,,,
2025-02-07,12:31:00,21859.75,SELL,1,0.02h,Break Even,$0.25,$0.25,$160280.50,286,$0.25
2025-02-07,12:46:00,21870.5,BUY,1,0.02h,Stop Loss,$-6.00,$-5.75,$160274.50,286,$-5.75
2025-02-07,13:00:00,21865.0,SELL,1,0.02h,Break Even,$0.25,$-5.50,$160274.75,286,$-5.50
2025-02-07,13:18:00,21869.5,BUY,1,0.02h,Stop Loss,$-6.00,$-11.50,$160268.75,286,$-11.50
2025-02-07,13:21:00,21853.25,SELL,1,0.02h,Break Even,$0.25,$-11.25,$160269.00,286,$-11.25
2025-02-07,13:41:00,21878.25,BUY,1,0.02h,Stop Loss,$34.00,$22.75,$160303.00,286,$22.75
2025-02-07,14:58:00,21905.25,SELL,1,0.02h,Stop Loss,$29.00,$51.75,$160332.00,286,$51.75
2025-02-07,15:38:00,21792.0,BUY,1,0.02h,Stop Loss,$15.25,$67.00,$160347.25,286,$67.00
2025-02-07,15:45:00,21751.0,SELL,1,0.02h,Stop Loss,$39.00,$106.00,$160386.25,286,$106.00
2025-02-07,15:48:00,21775.5,BUY,1,0.02h,Stop Loss,$7.75,$113.75,$160394.00,286,$113.75
2025-02-07,15:54:00,21654.5,SELL,1,0.02h,Stop Loss,$179.00,$292.75,$160573.00,286,$292.75
2025-02-07,16:21:00,21730.5,BUY,1,0.02h,Stop Loss,$21.50,$314.25,$160594.50,286,$314.25
2025-02-07,16:27:00,21679.25,SELL,1,0.02h,Stop Loss,$71.50,$385.75,$160666.00,286,$385.75
2025-02-07,17:10:00,21658.25,BUY,1,0.02h,Break Even,$0.25,$386.00,$160666.25,286,$386.00
2025-02-07,17:19:00,21613.5,SELL,1,0.02h,Stop Loss,$81.50,$467.50,$160747.75,286,$467.50
2025-02-07,17:38:00,21644.75,BUY,1,0.02h,Stop Loss,$70.25,$537.75,$160818.00,286,$537.75
2025-02-07,18:42:00,21688.75,SELL,1,0.02h,Stop Loss,$35.25,$573.00,$160853.25,286,$573.00
2025-02-07,19:41:00,21604.5,BUY,1,0.02h,Stop Loss,$-6.00,$567.00,$160847.25,286,$567.00
2025-02-07,20:02:00,21583.5,SELL,1,0.02h,Stop Loss,$11.50,$578.50,$160858.75,286,$578.50
2025-02-07,20:35:00,21596.0,BUY,1,0.02h,Break Even,$0.25,$578.75,$160859.00,286,$578.75
2025-02-07,21:06:00,21588.25,SELL,1,0.02h,Stop Loss,$-6.00,$572.75,$160853.00,286,$572.75
Final P&L Day: 572.75,,,,,,,,,,,
2025-02-10,12:00:00,21742.25,BUY,1,0.02h,Stop Loss,$5.25,$5.25,$160858.25,287,$5.25
2025-02-10,14:12:00,21773.0,SELL,1,0.02h,Stop Loss,$6.50,$11.75,$160864.75,287,$11.75
2025-02-10,14:39:00,21777.5,BUY,1,0.02h,Stop Loss,$31.50,$43.25,$160896.25,287,$43.25
2025-02-10,15:58:00,21866.75,SELL,1,0.02h,Stop Loss,$-6.00,$37.25,$160890.25,287,$37.25
2025-02-10,16:01:00,21879.0,BUY,1,0.02h,Stop Loss,$20.25,$57.50,$160910.50,287,$57.50
2025-02-10,16:08:00,21866.0,SELL,1,0.02h,Stop Loss,$31.50,$89.00,$160942.00,287,$89.00
2025-02-10,16:55:00,21855.5,BUY,1,0.02h,Stop Loss,$34.00,$123.00,$160976.00,287,$123.00
2025-02-10,17:06:00,21846.75,SELL,1,0.02h,Break Even,$0.25,$123.25,$160976.25,287,$123.25
2025-02-10,17:35:00,21841.25,BUY,1,0.02h,Stop Loss,$15.25,$138.50,$160991.50,287,$138.50
2025-02-10,18:36:00,21867.0,SELL,1,0.02h,Break Even,$0.25,$138.75,$160991.75,287,$138.75
2025-02-10,18:37:00,21869.75,BUY,1,0.02h,Break Even,$0.25,$139.00,$160992.00,287,$139.00
2025-02-10,18:41:00,21863.5,SELL,1,0.02h,Stop Loss,$4.00,$143.00,$160996.00,287,$143.00
2025-02-10,18:50:00,21870.75,BUY,1,0.02h,Stop Loss,$7.75,$150.75,$161003.75,287,$150.75
2025-02-10,19:03:00,21865.5,SELL,1,0.02h,Stop Loss,$-6.00,$144.75,$160997.75,287,$144.75
2025-02-10,19:13:00,21874.5,BUY,1,0.02h,Stop Loss,$11.50,$156.25,$161009.25,287,$156.25
2025-02-10,19:28:00,21866.0,SELL,1,0.02h,Stop Loss,$9.00,$165.25,$161018.25,287,$165.25
2025-02-10,20:07:00,21864.75,BUY,1,0.02h,Stop Loss,$19.00,$184.25,$161037.25,287,$184.25
2025-02-10,20:25:00,21860.5,SELL,1,0.02h,Stop Loss,$-6.00,$178.25,$161031.25,287,$178.25
2025-02-10,21:32:00,21835.25,BUY,1,0.03h,Break Even,$0.25,$178.50,$161031.50,287,$178.50
2025-02-10,21:57:00,21834.75,SELL,1,0.02h,Stop Loss,$-6.00,$172.50,$161025.50,287,$172.50
2025-02-10,21:59:00,21837.0,BUY,1,0.02h,Stop Loss,$-6.00,$166.50,$161019.50,287,$166.50
Final P&L Day: 166.50,,,,,,,,,,,
2025-02-11,12:00:00,21763.75,SELL,1,0.02h,Stop Loss,$42.75,$42.75,$161062.25,288,$42.75
2025-02-11,12:46:00,21749.5,BUY,1,0.02h,Stop Loss,$-6.00,$36.75,$161056.25,288,$36.75
2025-02-11,12:56:00,21743.25,SELL,1,0.02h,Break Even,$0.25,$37.00,$161056.50,288,$37.00
2025-02-11,13:02:00,21750.0,BUY,1,0.02h,Break Even,$0.25,$37.25,$161056.75,288,$37.25
2025-02-11,13:09:00,21743.75,SELL,1,0.02h,Stop Loss,$-6.00,$31.25,$161050.75,288,$31.25
2025-02-11,14:17:00,21702.25,BUY,1,0.02h,Stop Loss,$-6.00,$25.25,$161044.75,288,$25.25
2025-02-11,14:18:00,21694.75,SELL,1,0.02h,Break Even,$0.25,$25.50,$161045.00,288,$25.50
2025-02-11,14:19:00,21700.75,BUY,1,0.02h,Break Even,$0.25,$25.75,$161045.25,288,$25.75
2025-02-11,14:24:00,21695.75,SELL,1,0.02h,Stop Loss,$10.25,$36.00,$161055.50,288,$36.00
2025-02-11,14:28:00,21706.5,BUY,1,0.02h,Break Even,$0.25,$36.25,$161055.75,288,$36.25
2025-02-11,16:03:00,21837.0,SELL,1,0.02h,Stop Loss,$-6.00,$30.25,$161049.75,288,$30.25
2025-02-11,16:40:00,21836.75,BUY,1,0.02h,Break Even,$0.25,$30.50,$161050.00,288,$30.50
2025-02-11,16:49:00,21827.75,SELL,1,0.02h,Break Even,$0.25,$30.75,$161050.25,288,$30.75
2025-02-11,17:24:00,21783.5,BUY,1,0.02h,Stop Loss,$12.75,$43.50,$161063.00,288,$43.50
2025-02-11,17:45:00,21768.25,SELL,1,0.02h,Break Even,$0.25,$43.75,$161063.25,288,$43.75
2025-02-11,18:19:00,21772.5,BUY,1,0.02h,Break Even,$0.25,$44.00,$161063.50,288,$44.00
2025-02-11,18:57:00,21802.25,SELL,1,0.02h,Break Even,$0.25,$44.25,$161063.75,288,$44.25
2025-02-11,19:05:00,21814.25,BUY,1,0.02h,Break Even,$0.25,$44.50,$161064.00,288,$44.50
2025-02-11,19:12:00,21797.75,SELL,1,0.02h,Stop Loss,$7.75,$52.25,$161071.75,288,$52.25
2025-02-11,19:39:00,21805.0,BUY,1,0.02h,Stop Loss,$21.50,$73.75,$161093.25,288,$73.75
2025-02-11,20:11:00,21823.0,SELL,1,0.02h,Stop Loss,$5.25,$79.00,$161098.50,288,$79.00
2025-02-11,21:05:00,21793.25,BUY,1,0.02h,Stop Loss,$-6.00,$73.00,$161092.50,288,$73.00
2025-02-11,21:07:00,21784.5,SELL,1,0.02h,Break Even,$0.25,$73.25,$161092.75,288,$73.25
2025-02-11,21:09:00,21788.0,BUY,1,0.02h,Break Even,$0.25,$73.50,$161093.00,288,$73.50
2025-02-11,21:37:00,21790.5,SELL,1,0.02h,Stop Loss,$-6.00,$67.50,$161087.00,288,$67.50
2025-02-11,21:39:00,21794.75,BUY,1,0.02h,Stop Loss,$-6.00,$61.50,$161081.00,288,$61.50
2025-02-11,21:44:00,21789.5,SELL,1,0.02h,Stop Loss,$-6.00,$55.50,$161075.00,288,$55.50
2025-02-11,21:52:00,21793.25,BUY,1,0.02h,Stop Loss,$-6.00,$49.50,$161069.00,288,$49.50
Final P&L Day: 49.50,,,,,,,,,,,
2025-02-12,12:01:00,21789.0,SELL,1,0.02h,Stop Loss,$-6.00,$-6.00,$161063.00,289,$-6.00
2025-02-12,12:08:00,21794.5,BUY,1,0.02h,Stop Loss,$-6.00,$-12.00,$161057.00,289,$-12.00
2025-02-12,12:10:00,21790.5,SELL,1,0.02h,Stop Loss,$-6.00,$-18.00,$161051.00,289,$-18.00
2025-02-12,12:12:00,21794.75,BUY,1,0.02h,Break Even,$0.25,$-17.75,$161051.25,289,$-17.75
2025-02-12,13:22:00,21818.75,SELL,1,0.02h,Stop Loss,$11.50,$-6.25,$161062.75,289,$-6.25
2025-02-12,14:23:00,21557.5,BUY,1,0.02h,Break Even,$0.25,$-6.00,$161063.00,289,$-6.00
2025-02-12,15:05:00,21615.0,SELL,1,0.02h,Stop Loss,$19.00,$13.00,$161082.00,289,$13.00
2025-02-12,15:19:00,21663.5,BUY,1,0.02h,Stop Loss,$39.00,$52.00,$161121.00,289,$52.00
2025-02-12,15:51:00,21700.5,SELL,1,0.02h,Break Even,$0.25,$52.25,$161121.25,289,$52.25
2025-02-12,15:53:00,21716.0,BUY,1,0.02h,Break Even,$0.25,$52.50,$161121.50,289,$52.50
2025-02-12,16:08:00,21697.25,SELL,1,0.02h,Stop Loss,$35.25,$87.75,$161156.75,289,$87.75
2025-02-12,16:37:00,21695.5,BUY,1,0.02h,Stop Loss,$41.50,$129.25,$161198.25,289,$129.25
2025-02-12,17:34:00,21773.75,SELL,1,0.02h,Stop Loss,$-6.00,$123.25,$161192.25,289,$123.25
2025-02-12,17:49:00,21791.75,BUY,1,0.02h,Break Even,$0.25,$123.50,$161192.50,289,$123.50
2025-02-12,18:22:00,21799.25,SELL,1,0.02h,Break Even,$0.25,$123.75,$161192.75,289,$123.75
2025-02-12,18:34:00,21809.0,BUY,1,0.02h,Break Even,$0.25,$124.00,$161193.00,289,$124.00
2025-02-12,18:40:00,21798.5,SELL,1,0.02h,Break Even,$0.25,$124.25,$161193.25,289,$124.25
2025-02-12,18:56:00,21800.0,BUY,1,0.02h,Stop Loss,$9.00,$133.25,$161202.25,289,$133.25
2025-02-12,19:01:00,21790.25,SELL,1,0.02h,Break Even,$0.25,$133.50,$161202.50,289,$133.50
2025-02-12,19:25:00,21785.5,BUY,1,0.02h,Stop Loss,$-6.00,$127.50,$161196.50,289,$127.50
2025-02-12,20:11:00,21821.5,SELL,1,0.02h,Stop Loss,$-6.00,$121.50,$161190.50,289,$121.50
2025-02-12,20:12:00,21825.75,BUY,1,0.02h,Stop Loss,$11.50,$133.00,$161202.00,289,$133.00
2025-02-12,20:15:00,21819.75,SELL,1,0.02h,Stop Loss,$16.50,$149.50,$161218.50,289,$149.50
2025-02-12,20:22:00,21823.75,BUY,1,0.02h,Break Even,$0.25,$149.75,$161218.75,289,$149.75
2025-02-12,20:30:00,21815.5,SELL,1,0.02h,Stop Loss,$9.00,$158.75,$161227.75,289,$158.75
2025-02-12,21:01:00,21810.5,BUY,1,0.02h,Break Even,$0.25,$159.00,$161228.00,289,$159.00
2025-02-12,21:03:00,21792.25,SELL,1,0.02h,Break Even,$0.25,$159.25,$161228.25,289,$159.25
2025-02-12,21:06:00,21813.75,BUY,1,0.02h,Stop Loss,$19.00,$178.25,$161247.25,289,$178.25
Final P&L Day: 178.25,,,,,,,,,,,
2025-02-13,12:01:00,21815.0,SELL,1,0.02h,Stop Loss,$21.50,$21.50,$161268.75,290,$21.50
2025-02-13,12:28:00,21817.5,BUY,1,0.02h,Stop Loss,$-6.00,$15.50,$161262.75,290,$15.50
2025-02-13,12:49:00,21810.75,SELL,1,0.02h,Stop Loss,$-6.00,$9.50,$161256.75,290,$9.50
2025-02-13,12:58:00,21822.5,BUY,1,0.02h,Break Even,$0.25,$9.75,$161257.00,290,$9.75
2025-02-13,13:06:00,21813.0,SELL,1,0.02h,Stop Loss,$11.50,$21.25,$161268.50,290,$21.25
2025-02-13,13:22:00,21820.5,BUY,1,0.02h,Break Even,$0.25,$21.50,$161268.75,290,$21.50
2025-02-13,14:16:00,21866.0,SELL,1,0.02h,Stop Loss,$15.25,$36.75,$161284.00,290,$36.75
2025-02-13,14:24:00,21872.5,BUY,1,0.02h,Stop Loss,$24.00,$60.75,$161308.00,290,$60.75
2025-02-13,14:41:00,21863.5,SELL,1,0.02h,Stop Loss,$66.50,$127.25,$161374.50,290,$127.25
2025-02-13,14:54:00,21889.75,BUY,1,0.02h,Stop Loss,$9.00,$136.25,$161383.50,290,$136.25
2025-02-13,16:21:00,22033.0,SELL,1,0.02h,Stop Loss,$40.25,$176.50,$161423.75,290,$176.50
2025-02-13,17:09:00,21992.25,BUY,1,0.02h,Break Even,$0.25,$176.75,$161424.00,290,$176.75
2025-02-13,17:13:00,21972.25,SELL,1,0.02h,Stop Loss,$20.25,$197.00,$161444.25,290,$197.00
2025-02-13,17:42:00,21975.5,BUY,1,0.02h,Stop Loss,$7.75,$204.75,$161452.00,290,$204.75
2025-02-13,17:58:00,21961.5,SELL,1,0.02h,Stop Loss,$49.00,$253.75,$161501.00,290,$253.75
2025-02-13,18:36:00,21955.75,BUY,1,0.02h,Stop Loss,$26.50,$280.25,$161527.50,290,$280.25
2025-02-13,18:44:00,21937.5,SELL,1,0.02h,Stop Loss,$26.50,$306.75,$161554.00,290,$306.75
2025-02-13,18:46:00,21956.75,BUY,1,0.02h,Stop Loss,$45.25,$352.00,$161599.25,290,$352.00
2025-02-13,20:32:00,22072.75,SELL,1,0.02h,Stop Loss,$-6.00,$346.00,$161593.25,290,$346.00
2025-02-13,20:47:00,22076.75,BUY,1,0.02h,Stop Loss,$4.00,$350.00,$161597.25,290,$350.00
2025-02-13,21:07:00,22078.5,SELL,1,0.02h,Break Even,$0.25,$350.25,$161597.50,290,$350.25
2025-02-13,21:42:00,22083.5,BUY,1,0.03h,Stop Loss,$4.00,$354.25,$161601.50,290,$354.25
2025-02-13,21:57:00,22081.0,SELL,1,0.02h,Stop Loss,$-6.00,$348.25,$161595.50,290,$348.25
Final P&L Day: 348.25,,,,,,,,,,,
2025-02-14,12:16:00,22083.25,BUY,1,0.02h,Break Even,$0.25,$0.25,$161595.75,291,$0.25
2025-02-14,12:44:00,22073.25,SELL,1,0.02h,Break Even,$0.25,$0.50,$161596.00,291,$0.50
2025-02-14,12:58:00,22078.5,BUY,1,0.02h,Stop Loss,$7.75,$8.25,$161603.75,291,$8.25
2025-02-14,13:30:00,22081.75,SELL,1,0.02h,Stop Loss,$9.00,$17.25,$161612.75,291,$17.25
2025-02-14,13:32:00,22097.5,BUY,1,0.02h,Stop Loss,$40.25,$57.50,$161653.00,291,$57.50
2025-02-14,14:12:00,22100.5,SELL,1,0.02h,Stop Loss,$15.25,$72.75,$161668.25,291,$72.75
2025-02-14,14:21:00,22106.75,BUY,1,0.02h,Stop Loss,$14.00,$86.75,$161682.25,291,$86.75
2025-02-14,14:36:00,22100.5,SELL,1,0.02h,Stop Loss,$30.25,$117.00,$161712.50,291,$117.00
2025-02-14,14:48:00,22122.25,BUY,1,0.02h,Stop Loss,$26.50,$143.50,$161739.00,291,$143.50
2025-02-14,15:32:00,22133.5,SELL,1,0.02h,Stop Loss,$30.25,$173.75,$161769.25,291,$173.75
2025-02-14,15:51:00,22134.0,BUY,1,0.02h,Stop Loss,$11.50,$185.25,$161780.75,291,$185.25
2025-02-14,16:18:00,22145.0,SELL,1,0.02h,Stop Loss,$37.75,$223.00,$161818.50,291,$223.00
2025-02-14,16:46:00,22138.0,BUY,1,0.02h,Break Even,$0.25,$223.25,$161818.75,291,$223.25
2025-02-14,16:48:00,22123.75,SELL,1,0.02h,Stop Loss,$15.25,$238.50,$161834.00,291,$238.50
2025-02-14,16:58:00,22134.25,BUY,1,0.02h,Stop Loss,$25.25,$263.75,$161859.25,291,$263.75
2025-02-14,17:08:00,22126.0,SELL,1,0.02h,Stop Loss,$27.75,$291.50,$161887.00,291,$291.50
2025-02-14,17:48:00,22121.5,BUY,1,0.02h,Stop Loss,$25.25,$316.75,$161912.25,291,$316.75
2025-02-14,18:25:00,22155.0,SELL,1,0.02h,Stop Loss,$17.75,$334.50,$161930.00,291,$334.50
2025-02-14,18:32:00,22164.75,BUY,1,0.02h,Stop Loss,$21.50,$356.00,$161951.50,291,$356.00
2025-02-14,19:05:00,22184.5,SELL,1,0.02h,Stop Loss,$-6.00,$350.00,$161945.50,291,$350.00
2025-02-14,19:08:00,22192.5,BUY,1,0.02h,Stop Loss,$-6.00,$344.00,$161939.50,291,$344.00
2025-02-14,19:22:00,22187.5,SELL,1,0.02h,Break Even,$0.25,$344.25,$161939.75,291,$344.25
2025-02-14,20:00:00,22179.0,BUY,1,0.02h,Stop Loss,$-6.00,$338.25,$161933.75,291,$338.25
2025-02-14,20:01:00,22166.5,SELL,1,0.02h,Break Even,$0.25,$338.50,$161934.00,291,$338.50
2025-02-14,20:14:00,22176.5,BUY,1,0.02h,Break Even,$0.25,$338.75,$161934.25,291,$338.75
2025-02-14,21:02:00,22191.25,SELL,1,0.02h,Stop Loss,$-6.00,$332.75,$161928.25,291,$332.75
2025-02-14,21:07:00,22207.5,BUY,1,0.02h,Break Even,$0.25,$333.00,$161928.50,291,$333.00
2025-02-14,21:34:00,22200.25,SELL,1,0.02h,Break Even,$0.25,$333.25,$161928.75,291,$333.25
2025-02-14,21:59:00,22206.75,BUY,1,0.02h,Break Even,$0.25,$333.50,$161929.00,291,$333.50
2025-02-14,22:00:00,22203.0,SELL,1,62.00h,Stop Loss,$-6.00,$327.50,$161923.00,291,$327.50
Final P&L Day: 327.50,,,,,,,,,,,
2025-02-17,12:00:00,22243.5,BUY,1,0.02h,Break Even,$0.25,$0.25,$161923.25,292,$0.25
2025-02-17,12:54:00,22251.25,SELL,1,0.02h,Stop Loss,$4.00,$4.25,$161927.25,292,$4.25
2025-02-17,13:10:00,22252.0,BUY,1,0.02h,Break Even,$0.25,$4.50,$161927.50,292,$4.50
2025-02-17,13:31:00,22250.25,SELL,1,0.02h,Stop Loss,$5.25,$9.75,$161932.75,292,$9.75
2025-02-17,13:50:00,22249.5,BUY,1,0.02h,Break Even,$0.25,$10.00,$161933.00,292,$10.00
2025-02-17,14:16:00,22250.25,SELL,1,0.02h,Stop Loss,$-6.00,$4.00,$161927.00,292,$4.00
2025-02-17,15:05:00,22216.0,BUY,1,0.02h,Break Even,$0.25,$4.25,$161927.25,292,$4.25
2025-02-17,16:35:00,22239.5,SELL,1,0.02h,Stop Loss,$-6.00,$-1.75,$161921.25,292,$-1.75
2025-02-17,16:51:00,22243.0,BUY,1,0.02h,Stop Loss,$-6.00,$-7.75,$161915.25,292,$-7.75
2025-02-17,16:55:00,22239.25,SELL,1,0.02h,Stop Loss,$5.25,$-2.50,$161920.50,292,$-2.50
2025-02-17,17:30:00,22231.0,BUY,1,0.02h,Break Even,$0.25,$-2.25,$161920.75,292,$-2.25
2025-02-17,17:48:00,22231.75,SELL,1,0.02h,Stop Loss,$-6.00,$-8.25,$161914.75,292,$-8.25
2025-02-17,17:49:00,22235.75,BUY,1,0.02h,Stop Loss,$4.00,$-4.25,$161918.75,292,$-4.25
2025-02-17,17:59:00,22233.25,SELL,1,0.02h,Break Even,$0.25,$-4.00,$161919.00,292,$-4.00
Final P&L Day: -4.00,,,,,,,,,,,
2025-02-18,12:00:00,22276.75,BUY,1,0.02h,Stop Loss,$-6.00,$-6.00,$161913.00,293,$-6.00
2025-02-18,12:50:00,22288.75,SELL,1,0.02h,Break Even,$0.25,$-5.75,$161913.25,293,$-5.75
2025-02-18,13:18:00,22288.0,BUY,1,0.02h,Break Even,$0.25,$-5.50,$161913.50,293,$-5.50
2025-02-18,14:22:00,22305.5,SELL,1,0.02h,Stop Loss,$-6.00,$-11.50,$161907.50,293,$-11.50
2025-02-18,15:44:00,22170.25,BUY,1,0.02h,Break Even,$0.25,$-11.25,$161907.75,293,$-11.25
2025-02-18,15:46:00,22154.25,SELL,1,0.02h,Stop Loss,$85.25,$74.00,$161993.00,293,$74.00
2025-02-18,15:53:00,22173.25,BUY,1,0.02h,Stop Loss,$6.50,$80.50,$161999.50,293,$80.50
2025-02-18,16:23:00,22168.75,SELL,1,0.02h,Stop Loss,$4.00,$84.50,$162003.50,293,$84.50
2025-02-18,16:29:00,22199.25,BUY,1,0.02h,Stop Loss,$15.25,$99.75,$162018.75,293,$99.75
2025-02-18,16:34:00,22181.0,SELL,1,0.02h,Break Even,$0.25,$100.00,$162019.00,293,$100.00
2025-02-18,16:48:00,22203.5,BUY,1,0.02h,Stop Loss,$14.00,$114.00,$162033.00,293,$114.00
2025-02-18,17:01:00,22181.5,SELL,1,0.02h,Break Even,$0.25,$114.25,$162033.25,293,$114.25
2025-02-18,17:33:00,22183.75,BUY,1,0.02h,Stop Loss,$-6.00,$108.25,$162027.25,293,$108.25
2025-02-18,18:10:00,22182.5,SELL,1,0.02h,Stop Loss,$9.00,$117.25,$162036.25,293,$117.25
2025-02-18,18:52:00,22162.0,BUY,1,0.02h,Stop Loss,$16.50,$133.75,$162052.75,293,$133.75
2025-02-18,19:08:00,22124.0,SELL,1,0.02h,Stop Loss,$89.00,$222.75,$162141.75,293,$222.75
2025-02-18,19:26:00,22151.0,BUY,1,0.02h,Stop Loss,$4.00,$226.75,$162145.75,293,$226.75
2025-02-18,20:17:00,22168.75,SELL,1,0.02h,Stop Loss,$-6.00,$220.75,$162139.75,293,$220.75
2025-02-18,20:26:00,22178.75,BUY,1,0.02h,Break Even,$0.25,$221.00,$162140.00,293,$221.00
2025-02-18,20:30:00,22170.0,SELL,1,0.02h,Stop Loss,$5.25,$226.25,$162145.25,293,$226.25
2025-02-18,20:33:00,22177.0,BUY,1,0.02h,Stop Loss,$-6.00,$220.25,$162139.25,293,$220.25
2025-02-18,20:35:00,22170.0,SELL,1,0.02h,Stop Loss,$16.50,$236.75,$162155.75,293,$236.75
2025-02-18,20:43:00,22174.75,BUY,1,0.02h,Break Even,$0.25,$237.00,$162156.00,293,$237.00
2025-02-18,20:44:00,22164.75,SELL,1,0.02h,Break Even,$0.25,$237.25,$162156.25,293,$237.25
2025-02-18,20:53:00,22176.5,BUY,1,0.02h,Break Even,$0.25,$237.50,$162156.50,293,$237.50
2025-02-18,21:34:00,22221.5,SELL,1,0.02h,Break Even,$0.25,$237.75,$162156.75,293,$237.75
2025-02-18,22:00:00,22225.0,BUY,1,14.00h,Stop Loss,$-6.00,$231.75,$162150.75,293,$231.75
Final P&L Day: 231.75,,,,,,,,,,,
2025-02-19,12:00:00,22212.75,SELL,1,0.02h,Break Even,$0.25,$0.25,$162151.00,294,$0.25
2025-02-19,12:02:00,22235.5,BUY,1,0.02h,Break Even,$0.25,$0.50,$162151.25,294,$0.50
2025-02-19,12:35:00,22239.25,SELL,1,0.02h,Stop Loss,$-6.00,$-5.50,$162145.25,294,$-5.50
2025-02-19,12:37:00,22244.25,BUY,1,0.02h,Stop Loss,$-6.00,$-11.50,$162139.25,294,$-11.50
2025-02-19,12:38:00,22238.0,SELL,1,0.02h,Break Even,$0.25,$-11.25,$162139.50,294,$-11.25
2025-02-19,12:44:00,22243.0,BUY,1,0.02h,Stop Loss,$-6.00,$-17.25,$162133.50,294,$-17.25
2025-02-19,12:46:00,22240.5,SELL,1,0.02h,Stop Loss,$-6.00,$-23.25,$162127.50,294,$-23.25
2025-02-19,12:47:00,22248.25,BUY,1,0.02h,Stop Loss,$15.25,$-8.00,$162142.75,294,$-8.00
2025-02-19,13:00:00,22228.5,SELL,1,0.02h,Stop Loss,$41.50,$33.50,$162184.25,294,$33.50
2025-02-19,13:50:00,22206.5,BUY,1,0.02h,Stop Loss,$-6.00,$27.50,$162178.25,294,$27.50
2025-02-19,14:02:00,22198.5,SELL,1,0.02h,Stop Loss,$-6.00,$21.50,$162172.25,294,$21.50
2025-02-19,14:03:00,22208.0,BUY,1,0.02h,Break Even,$0.25,$21.75,$162172.50,294,$21.75
2025-02-19,14:18:00,22196.25,SELL,1,0.02h,Break Even,$0.25,$22.00,$162172.75,294,$22.00
2025-02-19,14:37:00,22215.75,BUY,1,0.02h,Stop Loss,$12.75,$34.75,$162185.50,294,$34.75
2025-02-19,14:42:00,22187.0,SELL,1,0.02h,Stop Loss,$27.75,$62.50,$162213.25,294,$62.50
2025-02-19,15:31:00,22162.0,BUY,1,0.02h,Stop Loss,$119.00,$181.50,$162332.25,294,$181.50
2025-02-19,15:57:00,22157.0,SELL,1,0.02h,Stop Loss,$36.50,$218.00,$162368.75,294,$218.00
2025-02-19,16:03:00,22193.25,BUY,1,0.02h,Stop Loss,$16.50,$234.50,$162385.25,294,$234.50
2025-02-19,17:17:00,22235.25,SELL,1,0.02h,Break Even,$0.25,$234.75,$162385.50,294,$234.75
2025-02-19,17:44:00,22234.25,BUY,1,0.02h,Stop Loss,$-6.00,$228.75,$162379.50,294,$228.75
2025-02-19,18:06:00,22222.25,SELL,1,0.02h,Stop Loss,$5.25,$234.00,$162384.75,294,$234.00
2025-02-19,18:20:00,22238.75,BUY,1,0.02h,Break Even,$0.25,$234.25,$162385.00,294,$234.25
2025-02-19,18:50:00,22244.5,SELL,1,0.02h,Stop Loss,$11.50,$245.75,$162396.50,294,$245.75
2025-02-19,19:14:00,22250.25,BUY,1,0.02h,Stop Loss,$85.25,$331.00,$162481.75,294,$331.00
2025-02-19,20:05:00,22277.5,SELL,1,0.02h,Stop Loss,$10.25,$341.25,$162492.00,294,$341.25
2025-02-19,20:56:00,22250.25,BUY,1,0.02h,Stop Loss,$4.00,$345.25,$162496.00,294,$345.25
2025-02-19,21:03:00,22227.5,SELL,1,0.02h,Stop Loss,$35.25,$380.50,$162531.25,294,$380.50
2025-02-19,21:38:00,22226.25,BUY,1,0.02h,Stop Loss,$-6.00,$374.50,$162525.25,294,$374.50
2025-02-19,21:39:00,22221.0,SELL,1,0.02h,Stop Loss,$-6.00,$368.50,$162519.25,294,$368.50
2025-02-19,21:59:00,22223.25,BUY,1,0.02h,Stop Loss,$-6.00,$362.50,$162513.25,294,$362.50
Final P&L Day: 362.50,,,,,,,,,,,
2025-02-20,12:00:00,22186.75,SELL,1,0.02h,Stop Loss,$6.50,$6.50,$162519.75,295,$6.50
2025-02-20,12:35:00,22200.0,BUY,1,0.02h,Break Even,$0.25,$6.75,$162520.00,295,$6.75
2025-02-20,13:07:00,22199.0,SELL,1,0.02h,Break Even,$0.25,$7.00,$162520.25,295,$7.00
2025-02-20,13:44:00,22201.75,BUY,1,0.02h,Stop Loss,$5.25,$12.25,$162525.50,295,$12.25
2025-02-20,13:53:00,22193.0,SELL,1,0.02h,Break Even,$0.25,$12.50,$162525.75,295,$12.50
2025-02-20,13:59:00,22201.25,BUY,1,0.02h,Break Even,$0.25,$12.75,$162526.00,295,$12.75
2025-02-20,14:27:00,22209.75,SELL,1,0.02h,Stop Loss,$16.50,$29.25,$162542.50,295,$29.25
2025-02-20,15:19:00,22081.25,BUY,1,0.02h,Stop Loss,$15.25,$44.50,$162557.75,295,$44.50
2025-02-20,15:43:00,22073.25,SELL,1,0.02h,Stop Loss,$35.25,$79.75,$162593.00,295,$79.75
2025-02-20,16:10:00,22053.5,BUY,1,0.02h,Stop Loss,$35.25,$115.00,$162628.25,295,$115.00
2025-02-20,16:20:00,22029.0,SELL,1,0.02h,Stop Loss,$-6.00,$109.00,$162622.25,295,$109.00
2025-02-20,16:22:00,22050.0,BUY,1,0.02h,Stop Loss,$-6.00,$103.00,$162616.25,295,$103.00
2025-02-20,16:37:00,22033.5,SELL,1,0.02h,Stop Loss,$62.75,$165.75,$162679.00,295,$165.75
2025-02-20,16:45:00,22055.5,BUY,1,0.02h,Break Even,$0.25,$166.00,$162679.25,295,$166.00
2025-02-20,16:48:00,22033.0,SELL,1,0.02h,Stop Loss,$6.50,$172.50,$162685.75,295,$172.50
2025-02-20,16:53:00,22055.0,BUY,1,0.02h,Stop Loss,$-6.00,$166.50,$162679.75,295,$166.50
2025-02-20,16:54:00,22038.25,SELL,1,0.02h,Break Even,$0.25,$166.75,$162680.00,295,$166.75
2025-02-20,17:04:00,22061.25,BUY,1,0.02h,Stop Loss,$20.25,$187.00,$162700.25,295,$187.00
2025-02-20,17:50:00,22068.25,SELL,1,0.02h,Stop Loss,$6.50,$193.50,$162706.75,295,$193.50
2025-02-20,18:14:00,22065.75,BUY,1,0.02h,Break Even,$0.25,$193.75,$162707.00,295,$193.75
2025-02-20,18:19:00,22052.25,SELL,1,0.02h,Stop Loss,$9.00,$202.75,$162716.00,295,$202.75
2025-02-20,18:34:00,22059.0,BUY,1,0.02h,Stop Loss,$-6.00,$196.75,$162710.00,295,$196.75
2025-02-20,18:52:00,22052.0,SELL,1,0.02h,Stop Loss,$7.75,$204.50,$162717.75,295,$204.50
2025-02-20,18:58:00,22063.5,BUY,1,0.02h,Stop Loss,$41.50,$246.00,$162759.25,295,$246.00
2025-02-20,19:33:00,22083.5,SELL,1,0.02h,Stop Loss,$11.50,$257.50,$162770.75,295,$257.50
2025-02-20,19:48:00,22102.0,BUY,1,0.02h,Stop Loss,$35.25,$292.75,$162806.00,295,$292.75
2025-02-20,20:13:00,22103.25,SELL,1,0.02h,Break Even,$0.25,$293.00,$162806.25,295,$293.00
2025-02-20,20:23:00,22118.5,BUY,1,0.02h,Stop Loss,$-6.00,$287.00,$162800.25,295,$287.00
2025-02-20,20:28:00,22095.0,SELL,1,0.02h,Stop Loss,$-6.00,$281.00,$162794.25,295,$281.00
2025-02-20,20:44:00,22111.75,BUY,1,0.02h,Stop Loss,$22.75,$303.75,$162817.00,295,$303.75
2025-02-20,21:16:00,22127.5,SELL,1,0.02h,Stop Loss,$-6.00,$297.75,$162811.00,295,$297.75
2025-02-20,21:25:00,22135.0,BUY,1,0.02h,Stop Loss,$-6.00,$291.75,$162805.00,295,$291.75
2025-02-20,21:52:00,22134.0,SELL,1,0.02h,Break Even,$0.25,$292.00,$162805.25,295,$292.00
Final P&L Day: 292.00,,,,,,,,,,,
2025-02-21,12:00:00,22165.0,BUY,1,0.02h,Stop Loss,$6.50,$6.50,$162811.75,296,$6.50
2025-02-21,13:07:00,22208.25,SELL,1,0.02h,Stop Loss,$-6.00,$0.50,$162805.75,296,$0.50
2025-02-21,13:11:00,22216.75,BUY,1,0.02h,Stop Loss,$-6.00,$-5.50,$162799.75,296,$-5.50
2025-02-21,13:58:00,22225.75,SELL,1,0.02h,Break Even,$0.25,$-5.25,$162800.00,296,$-5.25
2025-02-21,14:19:00,22229.0,BUY,1,0.02h,Stop Loss,$-6.00,$-11.25,$162794.00,296,$-11.25
2025-02-21,14:21:00,22224.75,SELL,1,0.02h,Stop Loss,$-6.00,$-17.25,$162788.00,296,$-17.25
2025-02-21,14:22:00,22226.25,BUY,1,0.02h,Stop Loss,$-6.00,$-23.25,$162782.00,296,$-23.25
2025-02-21,14:23:00,22223.5,SELL,1,0.02h,Stop Loss,$20.25,$-3.00,$162802.25,296,$-3.00
2025-02-21,16:01:00,22015.25,BUY,1,0.02h,Stop Loss,$14.00,$11.00,$162816.25,296,$11.00
2025-02-21,16:07:00,21980.75,SELL,1,0.02h,Stop Loss,$27.75,$38.75,$162844.00,296,$38.75
2025-02-21,16:15:00,22015.25,BUY,1,0.02h,Stop Loss,$9.00,$47.75,$162853.00,296,$47.75
2025-02-21,16:30:00,21992.75,SELL,1,0.02h,Stop Loss,$50.25,$98.00,$162903.25,296,$98.00
2025-02-21,16:34:00,22015.0,BUY,1,0.02h,Stop Loss,$22.75,$120.75,$162926.00,296,$120.75
2025-02-21,16:44:00,21990.5,SELL,1,0.02h,Stop Loss,$10.25,$131.00,$162936.25,296,$131.00
2025-02-21,17:06:00,21991.5,BUY,1,0.02h,Break Even,$0.25,$131.25,$162936.50,296,$131.25
2025-02-21,17:09:00,21978.25,SELL,1,0.02h,Stop Loss,$54.00,$185.25,$162990.50,296,$185.25
2025-02-21,18:39:00,21832.25,BUY,1,0.02h,Stop Loss,$-6.00,$179.25,$162984.50,296,$179.25
2025-02-21,18:42:00,21794.25,SELL,1,0.02h,Stop Loss,$-6.00,$173.25,$162978.50,296,$173.25
2025-02-21,19:54:00,21706.5,BUY,1,0.02h,Stop Loss,$-6.00,$167.25,$162972.50,296,$167.25
2025-02-21,19:55:00,21690.25,SELL,1,0.02h,Stop Loss,$-6.00,$161.25,$162966.50,296,$161.25
2025-02-21,19:56:00,21706.25,BUY,1,0.02h,Break Even,$0.25,$161.50,$162966.75,296,$161.50
2025-02-21,19:59:00,21692.0,SELL,1,0.02h,Stop Loss,$32.75,$194.25,$162999.50,296,$194.25
2025-02-21,20:16:00,21699.0,BUY,1,0.02h,Break Even,$0.25,$194.50,$162999.75,296,$194.50
2025-02-21,20:19:00,21691.0,SELL,1,0.02h,Stop Loss,$-6.00,$188.50,$162993.75,296,$188.50
2025-02-21,20:20:00,21699.25,BUY,1,0.02h,Break Even,$0.25,$188.75,$162994.00,296,$188.75
2025-02-21,20:40:00,21696.5,SELL,1,0.02h,Stop Loss,$5.25,$194.00,$162999.25,296,$194.00
2025-02-21,20:56:00,21695.0,BUY,1,0.02h,Stop Loss,$-6.00,$188.00,$162993.25,296,$188.00
2025-02-21,20:57:00,21682.5,SELL,1,0.02h,Stop Loss,$21.50,$209.50,$163014.75,296,$209.50
2025-02-21,21:02:00,21688.5,BUY,1,0.02h,Stop Loss,$5.25,$214.75,$163020.00,296,$214.75
2025-02-21,21:05:00,21683.75,SELL,1,0.02h,Stop Loss,$9.00,$223.75,$163029.00,296,$223.75
2025-02-21,21:08:00,21690.75,BUY,1,0.02h,Break Even,$0.25,$224.00,$163029.25,296,$224.00
2025-02-21,21:12:00,21683.0,SELL,1,0.02h,Stop Loss,$10.25,$234.25,$163039.50,296,$234.25
Final P&L Day: 234.25,,,,,,,,,,,
2025-02-24,12:00:00,21777.5,BUY,1,0.02h,Stop Loss,$-6.00,$-6.00,$163033.50,297,$-6.00
2025-02-24,12:47:00,21750.75,SELL,1,0.02h,Stop Loss,$19.00,$13.00,$163052.50,297,$13.00
2025-02-24,13:00:00,21763.25,BUY,1,0.02h,Break Even,$0.25,$13.25,$163052.75,297,$13.25
2025-02-24,14:07:00,21774.5,SELL,1,0.02h,Stop Loss,$11.50,$24.75,$163064.25,297,$24.75
2025-02-24,16:03:00,21495.75,BUY,1,0.02h,Stop Loss,$61.50,$86.25,$163125.75,297,$86.25
2025-02-24,16:59:00,21572.25,SELL,1,0.02h,Break Even,$0.25,$86.50,$163126.00,297,$86.50
2025-02-24,17:04:00,21606.25,BUY,1,0.02h,Stop Loss,$6.50,$93.00,$163132.50,297,$93.00
2025-02-24,17:55:00,21614.75,SELL,1,0.02h,Break Even,$0.25,$93.25,$163132.75,297,$93.25
2025-02-24,18:15:00,21628.25,BUY,1,0.02h,Stop Loss,$16.50,$109.75,$163149.25,297,$109.75
2025-02-24,18:48:00,21630.5,SELL,1,0.02h,Stop Loss,$24.00,$133.75,$163173.25,297,$133.75
2025-02-24,20:16:00,21561.25,BUY,1,0.02h,Stop Loss,$10.25,$144.00,$163183.50,297,$144.00
2025-02-24,20:24:00,21542.25,SELL,1,0.02h,Stop Loss,$45.25,$189.25,$163228.75,297,$189.25
2025-02-24,20:38:00,21551.5,BUY,1,0.02h,Stop Loss,$-6.00,$183.25,$163222.75,297,$183.25
2025-02-24,20:39:00,21538.5,SELL,1,0.02h,Stop Loss,$34.00,$217.25,$163256.75,297,$217.25
2025-02-24,21:59:00,21428.25,BUY,1,0.02h,Stop Loss,$4.00,$221.25,$163260.75,297,$221.25
Final P&L Day: 221.25,,,,,,,,,,,
2025-02-25,12:00:00,21370.5,SELL,1,0.02h,Stop Loss,$20.25,$20.25,$163281.00,298,$20.25
2025-02-25,12:27:00,21397.75,BUY,1,0.02h,Stop Loss,$-6.00,$14.25,$163275.00,298,$14.25
2025-02-25,12:33:00,21378.25,SELL,1,0.02h,Break Even,$0.25,$14.50,$163275.25,298,$14.50
2025-02-25,12:53:00,21390.25,BUY,1,0.02h,Stop Loss,$6.50,$21.00,$163281.75,298,$21.00
2025-02-25,13:38:00,21414.75,SELL,1,0.02h,Stop Loss,$12.75,$33.75,$163294.50,298,$33.75
2025-02-25,15:44:00,21115.75,BUY,1,0.02h,Break Even,$0.25,$34.00,$163294.75,298,$34.00
2025-02-25,15:48:00,21088.5,SELL,1,0.02h,Stop Loss,$10.25,$44.25,$163305.00,298,$44.25
2025-02-25,15:50:00,21112.0,BUY,1,0.02h,Stop Loss,$39.00,$83.25,$163344.00,298,$83.25
2025-02-25,16:02:00,21084.0,SELL,1,0.02h,Stop Loss,$90.25,$173.50,$163434.25,298,$173.50
2025-02-25,16:43:00,21057.75,BUY,1,0.02h,Stop Loss,$-6.00,$167.50,$163428.25,298,$167.50
2025-02-25,17:22:00,21120.0,SELL,1,0.02h,Stop Loss,$34.00,$201.50,$163462.25,298,$201.50
2025-02-25,17:27:00,21154.0,BUY,1,0.02h,Stop Loss,$47.75,$249.25,$163510.00,298,$249.25
2025-02-25,18:18:00,21226.0,SELL,1,0.02h,Stop Loss,$69.00,$318.25,$163579.00,298,$318.25
2025-02-25,18:40:00,21243.0,BUY,1,0.02h,Stop Loss,$7.75,$326.00,$163586.75,298,$326.00
2025-02-25,18:56:00,21204.25,SELL,1,0.02h,Break Even,$0.25,$326.25,$163587.00,298,$326.25
2025-02-25,19:38:00,21173.25,BUY,1,0.02h,Stop Loss,$75.25,$401.50,$163662.25,298,$401.50
2025-02-25,20:13:00,21198.75,SELL,1,0.02h,Stop Loss,$16.50,$418.00,$163678.75,298,$418.00
2025-02-25,20:15:00,21203.5,BUY,1,0.02h,Stop Loss,$19.00,$437.00,$163697.75,298,$437.00
2025-02-25,20:18:00,21196.0,SELL,1,0.02h,Break Even,$0.25,$437.25,$163698.00,298,$437.25
2025-02-25,20:19:00,21208.75,BUY,1,0.02h,Stop Loss,$91.50,$528.75,$163789.50,298,$528.75
2025-02-25,20:36:00,21211.25,SELL,1,0.02h,Stop Loss,$115.25,$644.00,$163904.75,298,$644.00
2025-02-25,21:05:00,21187.75,BUY,1,0.02h,Stop Loss,$61.50,$705.50,$163966.25,298,$705.50
2025-02-25,21:39:00,21189.0,SELL,1,0.02h,Break Even,$0.25,$705.75,$163966.50,298,$705.75
2025-02-25,21:46:00,21205.0,BUY,1,0.02h,Break Even,$0.25,$706.00,$163966.75,298,$706.00
2025-02-25,21:58:00,21191.0,SELL,1,0.02h,Break Even,$0.25,$706.25,$163967.00,298,$706.25
Final P&L Day: 706.25,,,,,,,,,,,
2025-02-26,12:00:00,21288.0,BUY,1,0.02h,Stop Loss,$12.75,$12.75,$163979.75,299,$12.75
2025-02-26,12:47:00,21294.5,SELL,1,0.02h,Stop Loss,$6.50,$19.25,$163986.25,299,$19.25
2025-02-26,13:14:00,21292.0,BUY,1,0.02h,Stop Loss,$19.00,$38.25,$164005.25,299,$38.25
2025-02-26,13:44:00,21306.75,SELL,1,0.02h,Break Even,$0.25,$38.50,$164005.50,299,$38.50
2025-02-26,14:40:00,21265.0,BUY,1,0.02h,Stop Loss,$9.00,$47.50,$164014.50,299,$47.50
2025-02-26,14:43:00,21212.5,SELL,1,0.02h,Stop Loss,$67.75,$115.25,$164082.25,299,$115.25
2025-02-26,14:48:00,21256.75,BUY,1,0.02h,Stop Loss,$60.25,$175.50,$164142.50,299,$175.50
2025-02-26,15:30:00,21282.75,SELL,1,0.02h,Stop Loss,$-6.00,$169.50,$164136.50,299,$169.50
2025-02-26,15:38:00,21345.25,BUY,1,0.02h,Stop Loss,$10.25,$179.75,$164146.75,299,$179.75
2025-02-26,16:28:00,21362.0,SELL,1,0.02h,Break Even,$0.25,$180.00,$164147.00,299,$180.00
2025-02-26,16:38:00,21389.75,BUY,1,0.02h,Stop Loss,$30.25,$210.25,$164177.25,299,$210.25
2025-02-26,16:59:00,21357.75,SELL,1,0.02h,Stop Loss,$77.75,$288.00,$164255.00,299,$288.00
2025-02-26,17:08:00,21391.25,BUY,1,0.02h,Stop Loss,$32.75,$320.75,$164287.75,299,$320.75
2025-02-26,17:23:00,21366.25,SELL,1,0.02h,Stop Loss,$4.00,$324.75,$164291.75,299,$324.75
2025-02-26,19:21:00,21130.0,BUY,1,0.02h,Break Even,$0.25,$325.00,$164292.00,299,$325.00
2025-02-26,19:56:00,21139.0,SELL,1,0.02h,Stop Loss,$26.50,$351.50,$164318.50,299,$351.50
2025-02-26,20:14:00,21130.0,BUY,1,0.02h,Stop Loss,$-6.00,$345.50,$164312.50,299,$345.50
2025-02-26,20:15:00,21115.75,SELL,1,0.02h,Stop Loss,$24.00,$369.50,$164336.50,299,$369.50
2025-02-26,20:20:00,21131.75,BUY,1,0.02h,Break Even,$0.25,$369.75,$164336.75,299,$369.75
2025-02-26,21:30:00,21205.0,SELL,1,0.02h,Stop Loss,$41.50,$411.25,$164378.25,299,$411.25
2025-02-26,21:42:00,21224.25,BUY,1,0.02h,Stop Loss,$-6.00,$405.25,$164372.25,299,$405.25
Final P&L Day: 405.25,,,,,,,,,,,
2025-02-27,12:53:00,21356.75,SELL,1,0.02h,Stop Loss,$4.00,$4.00,$164376.25,300,$4.00
2025-02-27,13:18:00,21365.0,BUY,1,0.02h,Stop Loss,$5.25,$9.25,$164381.50,300,$9.25
2025-02-27,13:26:00,21352.0,SELL,1,0.02h,Stop Loss,$5.25,$14.50,$164386.75,300,$14.50
2025-02-27,13:42:00,21363.25,BUY,1,0.02h,Stop Loss,$4.00,$18.50,$164390.75,300,$18.50
2025-02-27,13:47:00,21316.0,SELL,1,0.02h,Stop Loss,$140.25,$158.75,$164531.00,300,$158.75
2025-02-27,14:04:00,21344.75,BUY,1,0.02h,Break Even,$0.25,$159.00,$164531.25,300,$159.00
2025-02-27,14:30:00,21340.5,SELL,1,0.02h,Stop Loss,$67.75,$226.75,$164599.00,300,$226.75
2025-02-27,14:31:00,21352.25,BUY,1,0.02h,Break Even,$0.25,$227.00,$164599.25,300,$227.00
2025-02-27,14:32:00,21329.75,SELL,1,0.02h,Stop Loss,$-6.00,$221.00,$164593.25,300,$221.00
2025-02-27,14:34:00,21354.0,BUY,1,0.02h,Stop Loss,$16.50,$237.50,$164609.75,300,$237.50
2025-02-27,14:40:00,21308.25,SELL,1,0.02h,Stop Loss,$165.25,$402.75,$164775.00,300,$402.75
2025-02-27,15:18:00,21069.75,BUY,1,0.02h,Stop Loss,$139.00,$541.75,$164914.00,300,$541.75
2025-02-27,15:35:00,21067.5,SELL,1,0.02h,Stop Loss,$92.75,$634.50,$165006.75,300,$634.50
2025-02-27,15:40:00,21113.5,BUY,1,0.02h,Stop Loss,$7.75,$642.25,$165014.50,300,$642.25
2025-02-27,15:53:00,21058.0,SELL,1,0.02h,Stop Loss,$51.50,$693.75,$165066.00,300,$693.75
2025-02-27,16:12:00,21082.5,BUY,1,0.02h,Stop Loss,$56.50,$750.25,$165122.50,300,$750.25
2025-02-27,16:30:00,21065.0,SELL,1,0.02h,Stop Loss,$26.50,$776.75,$165149.00,300,$776.75
2025-02-27,17:28:00,21039.25,BUY,1,0.02h,Stop Loss,$27.75,$804.50,$165176.75,300,$804.50
2025-02-27,17:44:00,21001.25,SELL,1,0.02h,Stop Loss,$12.75,$817.25,$165189.50,300,$817.25
2025-02-27,18:00:00,21038.25,BUY,1,0.02h,Stop Loss,$87.75,$905.00,$165277.25,300,$905.00
2025-02-27,18:44:00,21075.75,SELL,1,0.02h,Break Even,$0.25,$905.25,$165277.50,300,$905.25
2025-02-27,21:20:00,20634.5,BUY,1,0.02h,Break Even,$0.25,$905.50,$165277.75,300,$905.50
2025-02-27,21:54:00,20633.75,SELL,1,0.02h,Stop Loss,$17.75,$923.25,$165295.50,300,$923.25
Final P&L Day: 923.25,,,,,,,,,,,
2025-02-28,12:01:00,20651.5,BUY,1,0.02h,Break Even,$0.25,$0.25,$165295.75,301,$0.25
2025-02-28,12:03:00,20632.25,SELL,1,0.02h,Stop Loss,$44.00,$44.25,$165339.75,301,$44.25
2025-02-28,12:22:00,20632.0,BUY,1,0.02h,Stop Loss,$17.75,$62.00,$165357.50,301,$62.00
2025-02-28,12:32:00,20603.25,SELL,1,0.02h,Stop Loss,$-6.00,$56.00,$165351.50,301,$56.00
2025-02-28,12:51:00,20622.0,BUY,1,0.02h,Break Even,$0.25,$56.25,$165351.75,301,$56.25
2025-02-28,13:11:00,20611.25,SELL,1,0.02h,Stop Loss,$49.00,$105.25,$165400.75,301,$105.25
2025-02-28,13:32:00,20659.75,BUY,1,0.02h,Break Even,$0.25,$105.50,$165401.00,301,$105.50
2025-02-28,13:53:00,20609.5,SELL,1,0.02h,Stop Loss,$11.50,$117.00,$165412.50,301,$117.00
2025-02-28,14:10:00,20620.5,BUY,1,0.02h,Break Even,$0.25,$117.25,$165412.75,301,$117.25
2025-02-28,14:12:00,20604.0,SELL,1,0.02h,Stop Loss,$11.50,$128.75,$165424.25,301,$128.75
2025-02-28,14:17:00,20615.0,BUY,1,0.02h,Stop Loss,$-6.00,$122.75,$165418.25,301,$122.75
2025-02-28,14:18:00,20611.5,SELL,1,0.02h,Stop Loss,$-6.00,$116.75,$165412.25,301,$116.75
2025-02-28,14:19:00,20620.25,BUY,1,0.02h,Stop Loss,$26.50,$143.25,$165438.75,301,$143.25
2025-02-28,14:22:00,20603.5,SELL,1,0.02h,Stop Loss,$21.50,$164.75,$165460.25,301,$164.75
2025-02-28,14:44:00,20628.25,BUY,1,0.02h,Break Even,$0.25,$165.00,$165460.50,301,$165.00
2025-02-28,14:57:00,20550.25,SELL,1,0.02h,Stop Loss,$29.00,$194.00,$165489.50,301,$194.00
2025-02-28,15:01:00,20623.0,BUY,1,0.02h,Stop Loss,$40.25,$234.25,$165529.75,301,$234.25
2025-02-28,15:44:00,20680.25,SELL,1,0.02h,Break Even,$0.25,$234.50,$165530.00,301,$234.50
2025-02-28,15:47:00,20735.75,BUY,1,0.02h,Stop Loss,$-6.00,$228.50,$165524.00,301,$228.50
2025-02-28,15:49:00,20693.25,SELL,1,0.02h,Stop Loss,$37.75,$266.25,$165561.75,301,$266.25
2025-02-28,15:52:00,20730.75,BUY,1,0.02h,Stop Loss,$31.50,$297.75,$165593.25,301,$297.75
2025-02-28,16:13:00,20702.0,SELL,1,0.02h,Stop Loss,$32.75,$330.50,$165626.00,301,$330.50
2025-02-28,16:38:00,20705.5,BUY,1,0.02h,Stop Loss,$49.00,$379.50,$165675.00,301,$379.50
2025-02-28,16:59:00,20708.5,SELL,1,0.02h,Stop Loss,$81.50,$461.00,$165756.50,301,$461.00
2025-02-28,17:15:00,20712.75,BUY,1,0.02h,Stop Loss,$-6.00,$455.00,$165750.50,301,$455.00
2025-02-28,17:26:00,20695.0,SELL,1,0.02h,Stop Loss,$-6.00,$449.00,$165744.50,301,$449.00
2025-02-28,18:30:00,20593.0,BUY,1,0.02h,Stop Loss,$137.75,$586.75,$165882.25,301,$586.75
2025-02-28,18:57:00,20574.5,SELL,1,0.02h,Stop Loss,$36.50,$623.25,$165918.75,301,$623.25
2025-02-28,19:20:00,20613.25,BUY,1,0.02h,Break Even,$0.25,$623.50,$165919.00,301,$623.50
2025-02-28,20:22:00,20705.25,SELL,1,0.02h,Stop Loss,$67.75,$691.25,$165986.75,301,$691.25
2025-02-28,20:28:00,20749.5,BUY,1,0.02h,Stop Loss,$71.50,$762.75,$166058.25,301,$762.75
2025-02-28,20:36:00,20689.75,SELL,1,0.02h,Stop Loss,$-6.00,$756.75,$166052.25,301,$756.75
2025-02-28,20:41:00,20756.5,BUY,1,0.02h,Stop Loss,$15.25,$772.00,$166067.50,301,$772.00
Final P&L Day: 772.00,,,,,,,,,,,
2025-03-03,12:39:00,21069.25,SELL,1,0.02h,Stop Loss,$-6.00,$-6.00,$166061.50,302,$-6.00
2025-03-03,12:46:00,21079.5,BUY,1,0.02h,Stop Loss,$-6.00,$-12.00,$166055.50,302,$-12.00
2025-03-03,12:55:00,21068.25,SELL,1,0.02h,Stop Loss,$31.50,$19.50,$166087.00,302,$19.50
2025-03-03,13:25:00,21074.0,BUY,1,0.02h,Stop Loss,$7.75,$27.25,$166094.75,302,$27.25
2025-03-03,13:36:00,21052.75,SELL,1,0.02h,Break Even,$0.25,$27.50,$166095.00,302,$27.50
2025-03-03,13:54:00,21061.75,BUY,1,0.02h,Stop Loss,$12.75,$40.25,$166107.75,302,$40.25
2025-03-03,14:26:00,21061.75,SELL,1,0.02h,Break Even,$0.25,$40.50,$166108.00,302,$40.50
2025-03-03,14:35:00,21088.0,BUY,1,0.02h,Stop Loss,$51.50,$92.00,$166159.50,302,$92.00
2025-03-03,14:38:00,21037.75,SELL,1,0.02h,Stop Loss,$252.75,$344.75,$166412.25,302,$344.75
2025-03-03,15:24:00,20909.5,BUY,1,0.02h,Stop Loss,$39.00,$383.75,$166451.25,302,$383.75
2025-03-03,15:51:00,20906.25,SELL,1,0.02h,Break Even,$0.25,$384.00,$166451.50,302,$384.00
2025-03-03,15:54:00,20938.75,BUY,1,0.02h,Stop Loss,$6.50,$390.50,$166458.00,302,$390.50
2025-03-03,15:56:00,20910.0,SELL,1,0.02h,Stop Loss,$72.75,$463.25,$166530.75,302,$463.25
2025-03-03,16:15:00,20913.0,BUY,1,0.02h,Stop Loss,$22.75,$486.00,$166553.50,302,$486.00
2025-03-03,16:16:00,20892.75,SELL,1,0.02h,Break Even,$0.25,$486.25,$166553.75,302,$486.25
2025-03-03,16:17:00,20916.0,BUY,1,0.02h,Stop Loss,$94.00,$580.25,$166647.75,302,$580.25
2025-03-03,16:30:00,20886.5,SELL,1,0.02h,Stop Loss,$21.50,$601.75,$166669.25,302,$601.75
2025-03-03,16:51:00,20928.75,BUY,1,0.02h,Break Even,$0.25,$602.00,$166669.50,302,$602.00
2025-03-03,17:37:00,20919.5,SELL,1,0.02h,Stop Loss,$50.25,$652.25,$166719.75,302,$652.25
2025-03-03,17:42:00,20944.25,BUY,1,0.02h,Stop Loss,$89.00,$741.25,$166808.75,302,$741.25
2025-03-03,17:47:00,20905.75,SELL,1,0.02h,Stop Loss,$104.00,$845.25,$166912.75,302,$845.25
2025-03-03,18:51:00,20734.5,BUY,1,0.02h,Stop Loss,$22.75,$868.00,$166935.50,302,$868.00
2025-03-03,19:18:00,20724.0,SELL,1,0.02h,Stop Loss,$92.75,$960.75,$167028.25,302,$960.75
2025-03-03,19:33:00,20757.75,BUY,1,0.02h,Stop Loss,$80.25,$1041.00,$167108.50,302,$1041.00
2025-03-03,19:50:00,20721.75,SELL,1,0.02h,Break Even,$0.25,$1041.25,$167108.75,302,$1041.25
2025-03-03,20:53:00,20418.75,BUY,1,0.02h,Stop Loss,$14.00,$1055.25,$167122.75,302,$1055.25
2025-03-03,21:55:00,20520.25,SELL,1,0.02h,Break Even,$0.25,$1055.50,$167123.00,302,$1055.50
2025-03-03,21:59:00,20527.0,BUY,1,0.02h,Stop Loss,$7.75,$1063.25,$167130.75,302,$1063.25
Final P&L Day: 1063.25,,,,,,,,,,,
2025-03-04,12:00:00,20475.25,SELL,1,0.02h,Stop Loss,$67.75,$67.75,$167198.50,303,$67.75
2025-03-04,13:36:00,20327.25,BUY,1,0.02h,Stop Loss,$51.50,$119.25,$167250.00,303,$119.25
2025-03-04,14:00:00,20325.0,SELL,1,0.02h,Stop Loss,$6.50,$125.75,$167256.50,303,$125.75
2025-03-04,14:01:00,20337.0,BUY,1,0.02h,Stop Loss,$29.00,$154.75,$167285.50,303,$154.75
2025-03-04,14:21:00,20343.0,SELL,1,0.02h,Stop Loss,$30.25,$185.00,$167315.75,303,$185.00
2025-03-04,14:38:00,20399.5,BUY,1,0.02h,Stop Loss,$136.50,$321.50,$167452.25,303,$321.50
2025-03-04,14:43:00,20278.25,SELL,1,0.02h,Stop Loss,$67.75,$389.25,$167520.00,303,$389.25
2025-03-04,14:48:00,20370.5,BUY,1,0.02h,Stop Loss,$194.00,$583.25,$167714.00,303,$583.25
2025-03-04,14:51:00,20305.25,SELL,1,0.02h,Stop Loss,$152.75,$736.00,$167866.75,303,$736.00
2025-03-04,15:33:00,20211.25,BUY,1,0.02h,Stop Loss,$144.00,$880.00,$168010.75,303,$880.00
2025-03-04,15:55:00,20175.0,SELL,1,0.02h,Stop Loss,$74.00,$954.00,$168084.75,303,$954.00
2025-03-04,16:16:00,20220.75,BUY,1,0.02h,Stop Loss,$32.75,$986.75,$168117.50,303,$986.75
2025-03-04,16:22:00,20176.0,SELL,1,0.02h,Stop Loss,$44.00,$1030.75,$168161.50,303,$1030.75
2025-03-04,16:23:00,20186.0,BUY,1,0.02h,Stop Loss,$-6.00,$1024.75,$168155.50,303,$1024.75
2025-03-04,16:24:00,20148.25,SELL,1,0.02h,Stop Loss,$-6.00,$1018.75,$168149.50,303,$1018.75
2025-03-04,16:34:00,20186.0,BUY,1,0.02h,Stop Loss,$39.00,$1057.75,$168188.50,303,$1057.75
2025-03-04,17:53:00,20322.0,SELL,1,0.02h,Stop Loss,$4.00,$1061.75,$168192.50,303,$1061.75
2025-03-04,18:09:00,20407.25,BUY,1,0.02h,Stop Loss,$85.25,$1147.00,$168277.75,303,$1147.00
2025-03-04,18:27:00,20390.5,SELL,1,0.02h,Stop Loss,$27.75,$1174.75,$168305.50,303,$1174.75
2025-03-04,18:38:00,20420.0,BUY,1,0.02h,Stop Loss,$22.75,$1197.50,$168328.25,303,$1197.50
2025-03-04,19:35:00,20549.5,SELL,1,0.02h,Stop Loss,$4.00,$1201.50,$168332.25,303,$1201.50
2025-03-04,19:38:00,20583.0,BUY,1,0.02h,Stop Loss,$12.75,$1214.25,$168345.00,303,$1214.25
2025-03-04,20:32:00,20610.5,SELL,1,0.02h,Stop Loss,$134.00,$1348.25,$168479.00,303,$1348.25
2025-03-04,21:11:00,20453.0,BUY,1,0.02h,Stop Loss,$141.50,$1489.75,$168620.50,303,$1489.75
2025-03-04,21:41:00,20494.5,SELL,1,0.02h,Stop Loss,$17.75,$1507.50,$168638.25,303,$1507.50
2025-03-04,21:48:00,20535.0,BUY,1,0.02h,Break Even,$0.25,$1507.75,$168638.50,303,$1507.75
Final P&L Day: 1507.75,,,,,,,,,,,
2025-03-05,12:00:00,20492.5,SELL,1,0.02h,Stop Loss,$11.50,$11.50,$168650.00,304,$11.50
2025-03-05,12:33:00,20502.0,BUY,1,0.02h,Stop Loss,$16.50,$28.00,$168666.50,304,$28.00
2025-03-05,12:48:00,20488.0,SELL,1,0.02h,Stop Loss,$6.50,$34.50,$168673.00,304,$34.50
2025-03-05,13:12:00,20507.75,BUY,1,0.02h,Break Even,$0.25,$34.75,$168673.25,304,$34.75
2025-03-05,13:15:00,20485.5,SELL,1,0.02h,Stop Loss,$256.50,$291.25,$168929.75,304,$291.25
2025-03-05,14:15:00,20440.5,BUY,1,0.02h,Stop Loss,$109.00,$400.25,$169038.75,304,$400.25
2025-03-05,14:32:00,20418.0,SELL,1,0.02h,Stop Loss,$130.25,$530.50,$169169.00,304,$530.50
2025-03-05,14:44:00,20443.5,BUY,1,0.02h,Break Even,$0.25,$530.75,$169169.25,304,$530.75
2025-03-05,14:48:00,20376.25,SELL,1,0.02h,Stop Loss,$90.25,$621.00,$169259.50,304,$621.00
2025-03-05,15:03:00,20421.0,BUY,1,0.02h,Stop Loss,$106.50,$727.50,$169366.00,304,$727.50
2025-03-05,15:19:00,20384.0,SELL,1,0.02h,Stop Loss,$95.25,$822.75,$169461.25,304,$822.75
2025-03-05,15:38:00,20388.5,BUY,1,0.02h,Stop Loss,$147.75,$970.50,$169609.00,304,$970.50
2025-03-05,15:52:00,20359.5,SELL,1,0.02h,Stop Loss,$40.25,$1010.75,$169649.25,304,$1010.75
2025-03-05,15:54:00,20401.5,BUY,1,0.02h,Stop Loss,$76.50,$1087.25,$169725.75,304,$1087.25
2025-03-05,16:02:00,20354.75,SELL,1,0.02h,Stop Loss,$36.50,$1123.75,$169762.25,304,$1123.75
2025-03-05,16:57:00,20274.5,BUY,1,0.02h,Stop Loss,$281.50,$1405.25,$170043.75,304,$1405.25
2025-03-05,18:10:00,20469.25,SELL,1,0.02h,Stop Loss,$21.50,$1426.75,$170065.25,304,$1426.75
2025-03-05,18:48:00,20522.0,BUY,1,0.02h,Stop Loss,$132.75,$1559.50,$170198.00,304,$1559.50
2025-03-05,19:37:00,20649.75,SELL,1,0.02h,Stop Loss,$154.00,$1713.50,$170352.00,304,$1713.50
2025-03-05,19:50:00,20668.5,BUY,1,0.02h,Stop Loss,$56.50,$1770.00,$170408.50,304,$1770.00
2025-03-05,20:18:00,20623.5,SELL,1,0.02h,Break Even,$0.25,$1770.25,$170408.75,304,$1770.25
2025-03-05,20:30:00,20690.0,BUY,1,0.02h,Break Even,$0.25,$1770.50,$170409.00,304,$1770.50
2025-03-05,20:31:00,20660.0,SELL,1,0.02h,Stop Loss,$22.75,$1793.25,$170431.75,304,$1793.25
2025-03-05,20:42:00,20683.25,BUY,1,0.02h,Stop Loss,$27.75,$1821.00,$170459.50,304,$1821.00
2025-03-05,20:48:00,20662.75,SELL,1,0.02h,Stop Loss,$34.00,$1855.00,$170493.50,304,$1855.00
2025-03-05,20:55:00,20690.0,BUY,1,0.02h,Stop Loss,$-6.00,$1849.00,$170487.50,304,$1849.00
2025-03-05,21:00:00,20659.5,SELL,1,0.02h,Stop Loss,$42.75,$1891.75,$170530.25,304,$1891.75
2025-03-05,21:59:00,20616.75,BUY,1,0.02h,Break Even,$0.25,$1892.00,$170530.50,304,$1892.00
Final P&L Day: 1892.00,,,,,,,,,,,
2025-03-06,12:00:00,20424.5,SELL,1,0.02h,Stop Loss,$19.00,$19.00,$170549.50,305,$19.00
2025-03-06,12:57:00,20387.5,BUY,1,0.02h,Stop Loss,$-6.00,$13.00,$170543.50,305,$13.00
2025-03-06,13:00:00,20370.75,SELL,1,0.02h,Stop Loss,$16.50,$29.50,$170560.00,305,$29.50
2025-03-06,13:34:00,20356.0,BUY,1,0.02h,Stop Loss,$25.25,$54.75,$170585.25,305,$54.75
2025-03-06,13:48:00,20334.75,SELL,1,0.02h,Stop Loss,$4.00,$58.75,$170589.25,305,$58.75
2025-03-06,14:07:00,20351.25,BUY,1,0.02h,Stop Loss,$-6.00,$52.75,$170583.25,305,$52.75
2025-03-06,14:23:00,20331.75,SELL,1,0.02h,Stop Loss,$29.00,$81.75,$170612.25,305,$81.75
2025-03-06,14:52:00,20324.5,BUY,1,0.02h,Stop Loss,$31.50,$113.25,$170643.75,305,$113.25
2025-03-06,14:59:00,20281.0,SELL,1,0.02h,Stop Loss,$6.50,$119.75,$170650.25,305,$119.75
2025-03-06,15:02:00,20304.0,BUY,1,0.02h,Stop Loss,$52.75,$172.50,$170703.00,305,$172.50
2025-03-06,15:53:00,20442.25,SELL,1,0.02h,Stop Loss,$7.75,$180.25,$170710.75,305,$180.25
2025-03-06,16:04:00,20472.5,BUY,1,0.02h,Stop Loss,$6.50,$186.75,$170717.25,305,$186.75
2025-03-06,16:08:00,20434.0,SELL,1,0.02h,Break Even,$0.25,$187.00,$170717.50,305,$187.00
2025-03-06,16:09:00,20462.0,BUY,1,0.02h,Stop Loss,$126.50,$313.50,$170844.00,305,$313.50
2025-03-06,16:21:00,20425.0,SELL,1,0.02h,Stop Loss,$130.25,$443.75,$170974.25,305,$443.75
2025-03-06,17:59:00,20187.0,BUY,1,0.02h,Stop Loss,$16.50,$460.25,$170990.75,305,$460.25
2025-03-06,18:11:00,20127.0,SELL,1,0.02h,Break Even,$0.25,$460.50,$170991.00,305,$460.50
2025-03-06,18:13:00,20163.5,BUY,1,0.02h,Break Even,$0.25,$460.75,$170991.25,305,$460.75
2025-03-06,18:30:00,20135.75,SELL,1,0.02h,Stop Loss,$65.25,$526.00,$171056.50,305,$526.00
2025-03-06,18:54:00,20135.25,BUY,1,0.02h,Break Even,$0.25,$526.25,$171056.75,305,$526.25
2025-03-06,19:02:00,20088.0,SELL,1,0.02h,Stop Loss,$107.75,$634.00,$171164.50,305,$634.00
2025-03-06,19:43:00,20077.5,BUY,1,0.02h,Stop Loss,$-6.00,$628.00,$171158.50,305,$628.00
2025-03-06,20:01:00,20065.0,SELL,1,0.02h,Stop Loss,$29.00,$657.00,$171187.50,305,$657.00
2025-03-06,20:11:00,20118.25,BUY,1,0.02h,Stop Loss,$54.00,$711.00,$171241.50,305,$711.00
2025-03-06,20:23:00,20081.0,SELL,1,0.02h,Stop Loss,$116.50,$827.50,$171358.00,305,$827.50
2025-03-06,20:32:00,20119.5,BUY,1,0.02h,Stop Loss,$69.00,$896.50,$171427.00,305,$896.50
2025-03-06,20:41:00,20090.0,SELL,1,0.02h,Stop Loss,$115.25,$1011.75,$171542.25,305,$1011.75
2025-03-06,20:54:00,20092.5,BUY,1,0.02h,Stop Loss,$99.00,$1110.75,$171641.25,305,$1110.75
2025-03-06,21:41:00,20163.75,SELL,1,0.02h,Stop Loss,$-6.00,$1104.75,$171635.25,305,$1104.75
2025-03-06,21:47:00,20185.25,BUY,1,0.02h,Stop Loss,$11.50,$1116.25,$171646.75,305,$1116.25
Final P&L Day: 1116.25,,,,,,,,,,,
2025-03-07,12:01:00,20169.5,SELL,1,0.02h,Stop Loss,$16.50,$16.50,$171663.25,306,$16.50
2025-03-07,12:59:00,20130.0,BUY,1,0.02h,Stop Loss,$-6.00,$10.50,$171657.25,306,$10.50
2025-03-07,13:05:00,20116.5,SELL,1,0.02h,Stop Loss,$24.00,$34.50,$171681.25,306,$34.50
2025-03-07,13:06:00,20123.5,BUY,1,0.02h,Stop Loss,$27.75,$62.25,$171709.00,306,$62.25
2025-03-07,13:13:00,20106.0,SELL,1,0.02h,Stop Loss,$21.50,$83.75,$171730.50,306,$83.75
2025-03-07,13:31:00,20217.5,BUY,1,0.02h,Stop Loss,$250.25,$334.00,$171980.75,306,$334.00
2025-03-07,13:49:00,20152.75,SELL,1,0.02h,Stop Loss,$111.50,$445.50,$172092.25,306,$445.50
2025-03-07,14:35:00,20101.25,BUY,1,0.02h,Stop Loss,$110.25,$555.75,$172202.50,306,$555.75
2025-03-07,14:38:00,20048.75,SELL,1,0.02h,Stop Loss,$11.50,$567.25,$172214.00,306,$567.25
2025-03-07,14:39:00,20098.25,BUY,1,0.02h,Stop Loss,$47.75,$615.00,$172261.75,306,$615.00
2025-03-07,15:02:00,20129.25,SELL,1,0.02h,Stop Loss,$26.50,$641.50,$172288.25,306,$641.50
2025-03-07,15:07:00,20159.5,BUY,1,0.02h,Stop Loss,$105.25,$746.75,$172393.50,306,$746.75
2025-03-07,15:14:00,20118.5,SELL,1,0.02h,Stop Loss,$36.50,$783.25,$172430.00,306,$783.25
2025-03-07,15:52:00,19993.0,BUY,1,0.02h,Stop Loss,$147.75,$931.00,$172577.75,306,$931.00
2025-03-07,16:05:00,19986.0,SELL,1,0.02h,Stop Loss,$30.25,$961.25,$172608.00,306,$961.25
2025-03-07,16:08:00,20010.25,BUY,1,0.02h,Break Even,$0.25,$961.50,$172608.25,306,$961.50
2025-03-07,16:11:00,19980.75,SELL,1,0.02h,Stop Loss,$41.50,$1003.00,$172649.75,306,$1003.00
2025-03-07,17:02:00,19845.0,BUY,1,0.02h,Stop Loss,$86.50,$1089.50,$172736.25,306,$1089.50
2025-03-07,17:09:00,19808.75,SELL,1,0.02h,Stop Loss,$72.75,$1162.25,$172809.00,306,$1162.25
2025-03-07,17:25:00,19849.25,BUY,1,0.02h,Stop Loss,$65.25,$1227.50,$172874.25,306,$1227.50
2025-03-07,18:30:00,20053.75,SELL,1,0.02h,Stop Loss,$47.75,$1275.25,$172922.00,306,$1275.25
2025-03-07,18:33:00,20077.75,BUY,1,0.02h,Stop Loss,$45.25,$1320.50,$172967.25,306,$1320.50
2025-03-07,19:10:00,20122.5,SELL,1,0.02h,Stop Loss,$-6.00,$1314.50,$172961.25,306,$1314.50
2025-03-07,19:15:00,20168.5,BUY,1,0.02h,Stop Loss,$11.50,$1326.00,$172972.75,306,$1326.00
2025-03-07,19:45:00,20206.5,SELL,1,0.02h,Stop Loss,$175.25,$1501.25,$173148.00,306,$1501.25
2025-03-07,20:09:00,20235.75,BUY,1,0.02h,Stop Loss,$26.50,$1527.75,$173174.50,306,$1527.75
2025-03-07,20:24:00,20205.75,SELL,1,0.02h,Stop Loss,$46.50,$1574.25,$173221.00,306,$1574.25
2025-03-07,20:28:00,20224.25,BUY,1,0.02h,Break Even,$0.25,$1574.50,$173221.25,306,$1574.50
2025-03-07,20:33:00,20195.5,SELL,1,0.02h,Stop Loss,$-6.00,$1568.50,$173215.25,306,$1568.50
2025-03-07,20:35:00,20230.0,BUY,1,0.02h,Break Even,$0.25,$1568.75,$173215.50,306,$1568.75
2025-03-07,20:37:00,20194.25,SELL,1,0.02h,Stop Loss,$189.00,$1757.75,$173404.50,306,$1757.75
2025-03-07,20:50:00,20219.25,BUY,1,0.02h,Stop Loss,$-6.00,$1751.75,$173398.50,306,$1751.75
2025-03-07,21:04:00,20159.25,SELL,1,0.02h,Break Even,$0.25,$1752.00,$173398.75,306,$1752.00
2025-03-07,21:15:00,20208.75,BUY,1,0.02h,Break Even,$0.25,$1752.25,$173399.00,306,$1752.25
2025-03-07,21:43:00,20201.75,SELL,1,0.02h,Stop Loss,$-6.00,$1746.25,$173393.00,306,$1746.25
2025-03-07,21:50:00,20209.75,BUY,1,0.02h,Break Even,$0.25,$1746.50,$173393.25,306,$1746.50
Final P&L Day: 1746.50,,,,,,,,,,,
2025-03-10,12:00:00,19951.0,SELL,1,0.02h,Stop Loss,$41.50,$41.50,$173434.75,307,$41.50
2025-03-10,12:53:00,19903.75,BUY,1,0.02h,Break Even,$0.25,$41.75,$173435.00,307,$41.75
2025-03-10,13:06:00,19888.5,SELL,1,0.02h,Stop Loss,$56.50,$98.25,$173491.50,307,$98.25
2025-03-10,13:11:00,19917.5,BUY,1,0.02h,Break Even,$0.25,$98.50,$173491.75,307,$98.50
2025-03-10,13:22:00,19893.75,SELL,1,0.02h,Break Even,$0.25,$98.75,$173492.00,307,$98.75
2025-03-10,13:46:00,19880.75,BUY,1,0.02h,Stop Loss,$74.00,$172.75,$173566.00,307,$172.75
2025-03-10,13:48:00,19850.5,SELL,1,0.02h,Stop Loss,$156.50,$329.25,$173722.50,307,$329.25
2025-03-10,15:11:00,19602.0,BUY,1,0.02h,Stop Loss,$6.50,$335.75,$173729.00,307,$335.75
2025-03-10,15:20:00,19569.5,SELL,1,0.02h,Stop Loss,$29.00,$364.75,$173758.00,307,$364.75
2025-03-10,15:24:00,19612.25,BUY,1,0.02h,Stop Loss,$95.25,$460.00,$173853.25,307,$460.00
2025-03-10,15:45:00,19604.25,SELL,1,0.02h,Break Even,$0.25,$460.25,$173853.50,307,$460.25
2025-03-10,15:50:00,19650.75,BUY,1,0.02h,Stop Loss,$5.25,$465.50,$173858.75,307,$465.50
2025-03-10,15:51:00,19622.25,SELL,1,0.02h,Stop Loss,$-6.00,$459.50,$173852.75,307,$459.50
2025-03-10,16:32:00,19605.5,BUY,1,0.02h,Stop Loss,$30.25,$489.75,$173883.00,307,$489.75
2025-03-10,16:40:00,19538.25,SELL,1,0.02h,Break Even,$0.25,$490.00,$173883.25,307,$490.00
2025-03-10,17:23:00,19547.5,BUY,1,0.02h,Stop Loss,$9.00,$499.00,$173892.25,307,$499.00
2025-03-10,17:31:00,19503.0,SELL,1,0.02h,Stop Loss,$94.00,$593.00,$173986.25,307,$593.00
2025-03-10,18:15:00,19452.5,BUY,1,0.02h,Stop Loss,$117.75,$710.75,$174104.00,307,$710.75
2025-03-10,18:26:00,19437.25,SELL,1,0.02h,Stop Loss,$109.00,$819.75,$174213.00,307,$819.75
2025-03-10,18:32:00,19467.0,BUY,1,0.02h,Break Even,$0.25,$820.00,$174213.25,307,$820.00
2025-03-10,18:35:00,19442.0,SELL,1,0.02h,Stop Loss,$45.25,$865.25,$174258.50,307,$865.25
2025-03-10,19:18:00,19364.0,BUY,1,0.02h,Stop Loss,$41.50,$906.75,$174300.00,307,$906.75
2025-03-10,19:45:00,19393.75,SELL,1,0.02h,Stop Loss,$-6.00,$900.75,$174294.00,307,$900.75
2025-03-10,19:52:00,19458.5,BUY,1,0.02h,Stop Loss,$100.25,$1001.00,$174394.25,307,$1001.00
2025-03-10,19:54:00,19427.75,SELL,1,0.02h,Stop Loss,$134.00,$1135.00,$174528.25,307,$1135.00
2025-03-10,19:56:00,19470.25,BUY,1,0.02h,Stop Loss,$25.25,$1160.25,$174553.50,307,$1160.25
2025-03-10,20:38:00,19466.75,SELL,1,0.02h,Break Even,$0.25,$1160.50,$174553.75,307,$1160.50
2025-03-10,20:46:00,19474.75,BUY,1,0.02h,Stop Loss,$10.25,$1170.75,$174564.00,307,$1170.75
2025-03-10,22:01:00,19440.0,SELL,1,0.02h,Stop Loss,$-6.00,$1164.75,$174558.00,307,$1164.75
2025-03-10,22:30:00,19418.0,BUY,1,0.02h,Stop Loss,$46.50,$1211.25,$174604.50,307,$1211.25
2025-03-10,22:50:00,19418.25,SELL,1,0.02h,Break Even,$0.25,$1211.50,$174604.75,307,$1211.50
Final P&L Day: 1211.50,,,,,,,,,,,
2025-03-11,12:00:00,19577.25,BUY,1,0.02h,Stop Loss,$16.50,$16.50,$174621.25,308,$16.50
2025-03-11,12:32:00,19484.0,SELL,1,0.02h,Stop Loss,$-6.00,$10.50,$174615.25,308,$10.50
2025-03-11,13:22:00,19461.5,BUY,1,0.02h,Break Even,$0.25,$10.75,$174615.50,308,$10.75
2025-03-11,13:24:00,19450.5,SELL,1,0.02h,Stop Loss,$26.50,$37.25,$174642.00,308,$37.25
2025-03-11,13:38:00,19528.25,BUY,1,0.02h,Stop Loss,$5.25,$42.50,$174647.25,308,$42.50
2025-03-11,14:04:00,19423.5,SELL,1,0.02h,Stop Loss,$334.00,$376.50,$174981.25,308,$376.50
2025-03-11,14:54:00,19388.5,BUY,1,0.02h,Stop Loss,$134.00,$510.50,$175115.25,308,$510.50
2025-03-11,15:01:00,19316.25,SELL,1,0.02h,Stop Loss,$25.25,$535.75,$175140.50,308,$535.75
2025-03-11,15:07:00,19392.75,BUY,1,0.02h,Stop Loss,$280.25,$816.00,$175420.75,308,$816.00
2025-03-11,15:59:00,19440.5,SELL,1,0.02h,Stop Loss,$121.50,$937.50,$175542.25,308,$937.50
2025-03-11,16:28:00,19403.5,BUY,1,0.02h,Stop Loss,$30.25,$967.75,$175572.50,308,$967.75
2025-03-11,16:30:00,19385.75,SELL,1,0.02h,Stop Loss,$-6.00,$961.75,$175566.50,308,$961.75
2025-03-11,16:31:00,19401.25,BUY,1,0.02h,Stop Loss,$9.00,$970.75,$175575.50,308,$970.75
2025-03-11,16:40:00,19375.5,SELL,1,0.02h,Stop Loss,$116.50,$1087.25,$175692.00,308,$1087.25
2025-03-11,17:43:00,19276.75,BUY,1,0.02h,Break Even,$0.25,$1087.50,$175692.25,308,$1087.50
2025-03-11,19:15:00,19577.75,SELL,1,0.02h,Stop Loss,$117.75,$1205.25,$175810.00,308,$1205.25
2025-03-11,20:49:00,19409.75,BUY,1,0.02h,Break Even,$0.25,$1205.50,$175810.25,308,$1205.50
2025-03-11,20:52:00,19394.0,SELL,1,0.02h,Stop Loss,$34.00,$1239.50,$175844.25,308,$1239.50
2025-03-11,22:01:00,19422.25,BUY,1,0.02h,Stop Loss,$47.75,$1287.25,$175892.00,308,$1287.25
2025-03-11,22:28:00,19426.0,SELL,1,0.02h,Stop Loss,$-6.00,$1281.25,$175886.00,308,$1281.25
2025-03-11,22:30:00,19434.5,BUY,1,0.02h,Break Even,$0.25,$1281.50,$175886.25,308,$1281.50
2025-03-11,22:36:00,19427.75,SELL,1,0.02h,Break Even,$0.25,$1281.75,$175886.50,308,$1281.75
2025-03-11,22:37:00,19436.5,BUY,1,0.02h,Stop Loss,$11.50,$1293.25,$175898.00,308,$1293.25
Final P&L Day: 1293.25,,,,,,,,,,,
2025-03-12,13:14:00,19681.25,SELL,1,0.02h,Stop Loss,$35.25,$35.25,$175933.25,309,$35.25
2025-03-12,13:31:00,19694.25,BUY,1,0.02h,Stop Loss,$187.75,$223.00,$176121.00,309,$223.00
2025-03-12,13:48:00,19689.75,SELL,1,0.02h,Stop Loss,$251.50,$474.50,$176372.50,309,$474.50
2025-03-12,14:08:00,19693.0,BUY,1,0.02h,Stop Loss,$62.75,$537.25,$176435.25,309,$537.25
2025-03-12,14:15:00,19641.75,SELL,1,0.02h,Stop Loss,$122.75,$660.00,$176558.00,309,$660.00
2025-03-12,15:24:00,19493.5,BUY,1,0.02h,Stop Loss,$124.00,$784.00,$176682.00,309,$784.00
2025-03-12,16:42:00,19638.0,SELL,1,0.02h,Stop Loss,$107.75,$891.75,$176789.75,309,$891.75
2025-03-12,16:51:00,19709.0,BUY,1,0.02h,Break Even,$0.25,$892.00,$176790.00,309,$892.00
2025-03-12,16:58:00,19658.25,SELL,1,0.02h,Stop Loss,$70.25,$962.25,$176860.25,309,$962.25
2025-03-12,17:15:00,19672.75,BUY,1,0.02h,Stop Loss,$-6.00,$956.25,$176854.25,309,$956.25
2025-03-12,17:43:00,19680.75,SELL,1,0.02h,Break Even,$0.25,$956.50,$176854.50,309,$956.50
2025-03-12,18:18:00,19603.5,BUY,1,0.02h,Stop Loss,$59.00,$1015.50,$176913.50,309,$1015.50
2025-03-12,19:02:00,19630.5,SELL,1,0.02h,Break Even,$0.25,$1015.75,$176913.75,309,$1015.75
2025-03-12,19:56:00,19630.0,BUY,1,0.02h,Stop Loss,$6.50,$1022.25,$176920.25,309,$1022.25
2025-03-12,20:04:00,19595.25,SELL,1,0.02h,Stop Loss,$9.00,$1031.25,$176929.25,309,$1031.25
2025-03-12,20:31:00,19592.75,BUY,1,0.02h,Stop Loss,$-6.00,$1025.25,$176923.25,309,$1025.25
2025-03-12,20:39:00,19580.5,SELL,1,0.02h,Break Even,$0.25,$1025.50,$176923.50,309,$1025.50
2025-03-12,22:03:00,19585.25,BUY,1,0.02h,Stop Loss,$39.00,$1064.50,$176962.50,309,$1064.50
2025-03-12,22:51:00,19611.5,SELL,1,0.02h,Stop Loss,$21.50,$1086.00,$176984.00,309,$1086.00
2025-03-12,22:59:00,19622.25,BUY,1,0.02h,Stop Loss,$10.25,$1096.25,$176994.25,309,$1096.25
Final P&L Day: 1096.25,,,,,,,,,,,
2025-03-13,12:00:00,19531.25,SELL,1,0.02h,Stop Loss,$19.00,$19.00,$177013.25,310,$19.00
2025-03-13,12:11:00,19706.0,BUY,1,0.02h,Stop Loss,$-6.00,$13.00,$177007.25,310,$13.00
2025-03-13,12:15:00,19479.25,SELL,1,0.02h,Stop Loss,$-6.00,$7.00,$177001.25,310,$7.00
2025-03-13,12:16:00,19698.5,BUY,1,0.02h,Round Number,$6.50,$13.50,$177007.75,310,$13.50
2025-03-13,12:30:00,19512.0,SELL,1,0.02h,Stop Loss,$-6.00,$7.50,$177001.75,310,$7.50
2025-03-13,12:31:00,19780.25,BUY,1,0.02h,Stop Loss,$-6.00,$1.50,$176995.75,310,$1.50
2025-03-13,12:39:00,19537.5,SELL,1,0.02h,Break Even,$0.25,$1.75,$176996.00,310,$1.75
2025-03-13,12:42:00,19769.0,BUY,1,0.02h,Stop Loss,$-6.00,$-4.25,$176990.00,310,$-4.25
2025-03-13,12:50:00,19519.0,SELL,1,0.02h,Stop Loss,$-6.00,$-10.25,$176984.00,310,$-10.25
2025-03-13,12:51:00,19738.25,BUY,1,0.02h,Stop Loss,$52.75,$42.50,$177036.75,310,$42.50
2025-03-13,12:53:00,19540.75,SELL,1,0.02h,Break Even,$0.25,$42.75,$177037.00,310,$42.75
2025-03-13,13:02:00,19782.25,BUY,1,0.02h,Stop Loss,$-6.00,$36.75,$177031.00,310,$36.75
2025-03-13,13:03:00,19573.5,SELL,1,0.02h,Break Even,$0.25,$37.00,$177031.25,310,$37.00
2025-03-13,13:08:00,19792.25,BUY,1,0.02h,Stop Loss,$-6.00,$31.00,$177025.25,310,$31.00
2025-03-13,13:09:00,19581.75,SELL,1,0.02h,Stop Loss,$-6.00,$25.00,$177019.25,310,$25.00
2025-03-13,13:10:00,19787.0,BUY,1,0.02h,Stop Loss,$-6.00,$19.00,$177013.25,310,$19.00
2025-03-13,13:23:00,19575.25,SELL,1,0.02h,Stop Loss,$-6.00,$13.00,$177007.25,310,$13.00
2025-03-13,13:24:00,19787.25,BUY,1,0.02h,Stop Loss,$-6.00,$7.00,$177001.25,310,$7.00
2025-03-13,13:25:00,19578.75,SELL,1,0.02h,Stop Loss,$-6.00,$1.00,$176995.25,310,$1.00
2025-03-13,13:26:00,19794.0,BUY,1,0.02h,Stop Loss,$-6.00,$-5.00,$176989.25,310,$-5.00
2025-03-13,13:27:00,19581.75,SELL,1,0.02h,Stop Loss,$40.25,$35.25,$177029.50,310,$35.25
2025-03-13,13:35:00,19769.75,BUY,1,0.02h,Stop Loss,$17.75,$53.00,$177047.25,310,$53.00
2025-03-13,13:41:00,19519.75,SELL,1,0.02h,Stop Loss,$25.25,$78.25,$177072.50,310,$78.25
2025-03-13,14:07:00,19639.25,BUY,1,0.02h,Stop Loss,$27.75,$106.00,$177100.25,310,$106.00
2025-03-13,14:12:00,19405.75,SELL,1,0.02h,Break Even,$0.25,$106.25,$177100.50,310,$106.25
2025-03-13,14:21:00,19733.25,BUY,1,0.02h,Stop Loss,$-6.00,$100.25,$177094.50,310,$100.25
2025-03-13,14:29:00,19489.25,SELL,1,0.02h,Stop Loss,$79.00,$179.25,$177173.50,310,$179.25
2025-03-13,14:31:00,19717.75,BUY,1,0.02h,Stop Loss,$61.50,$240.75,$177235.00,310,$240.75
2025-03-13,14:34:00,19484.0,SELL,1,0.02h,Stop Loss,$-6.00,$234.75,$177229.00,310,$234.75
2025-03-13,14:35:00,19692.0,BUY,1,0.02h,Stop Loss,$-6.00,$228.75,$177223.00,310,$228.75
2025-03-13,14:36:00,19471.25,SELL,1,0.02h,Stop Loss,$144.00,$372.75,$177367.00,310,$372.75
2025-03-13,14:48:00,19625.75,BUY,1,0.02h,Stop Loss,$5.25,$378.00,$177372.25,310,$378.00
2025-03-13,15:02:00,19460.75,SELL,1,0.02h,Stop Loss,$17.75,$395.75,$177390.00,310,$395.75
2025-03-13,15:26:00,19569.0,BUY,1,0.02h,Stop Loss,$59.00,$454.75,$177449.00,310,$454.75
2025-03-13,15:33:00,19367.0,SELL,1,0.02h,Stop Loss,$9.00,$463.75,$177458.00,310,$463.75
2025-03-13,15:47:00,19541.25,BUY,1,0.02h,Stop Loss,$-6.00,$457.75,$177452.00,310,$457.75
2025-03-13,15:48:00,19354.5,SELL,1,0.02h,Stop Loss,$-6.00,$451.75,$177446.00,310,$451.75
2025-03-13,15:49:00,19550.0,BUY,1,0.02h,Stop Loss,$126.50,$578.25,$177572.50,310,$578.25
2025-03-13,16:03:00,19311.5,SELL,1,0.02h,Stop Loss,$-6.00,$572.25,$177566.50,310,$572.25
2025-03-13,16:05:00,19529.0,BUY,1,0.02h,Stop Loss,$-6.00,$566.25,$177560.50,310,$566.25
2025-03-13,16:06:00,19304.25,SELL,1,0.02h,Stop Loss,$35.25,$601.50,$177595.75,310,$601.50
2025-03-13,16:18:00,19513.0,BUY,1,0.02h,Stop Loss,$32.75,$634.25,$177628.50,310,$634.25
2025-03-13,16:20:00,19312.75,SELL,1,0.02h,Stop Loss,$-6.00,$628.25,$177622.50,310,$628.25
2025-03-13,16:21:00,19517.5,BUY,1,0.02h,Stop Loss,$40.25,$668.50,$177662.75,310,$668.50
2025-03-13,16:27:00,19288.0,SELL,1,0.02h,Break Even,$0.25,$668.75,$177663.00,310,$668.75
2025-03-13,16:32:00,19547.5,BUY,1,0.02h,Stop Loss,$-6.00,$662.75,$177657.00,310,$662.75
2025-03-13,16:33:00,19329.0,SELL,1,0.02h,Break Even,$0.25,$663.00,$177657.25,310,$663.00
2025-03-13,16:39:00,19589.0,BUY,1,0.02h,Break Even,$0.25,$663.25,$177657.50,310,$663.25
2025-03-13,16:45:00,19323.5,SELL,1,0.02h,Stop Loss,$-6.00,$657.25,$177651.50,310,$657.25
2025-03-13,16:46:00,19507.25,BUY,1,0.02h,Stop Loss,$-6.00,$651.25,$177645.50,310,$651.25
2025-03-13,16:51:00,19276.0,SELL,1,0.02h,Stop Loss,$-6.00,$645.25,$177639.50,310,$645.25
2025-03-13,16:52:00,19475.5,BUY,1,0.02h,Stop Loss,$167.75,$813.00,$177807.25,310,$813.00
2025-03-13,16:54:00,19282.75,SELL,1,0.02h,Stop Loss,$-6.00,$807.00,$177801.25,310,$807.00
2025-03-13,16:56:00,19470.5,BUY,1,0.02h,Break Even,$0.25,$807.25,$177801.50,310,$807.25
2025-03-13,17:02:00,19266.0,SELL,1,0.02h,Break Even,$0.25,$807.50,$177801.75,310,$807.50
2025-03-13,17:07:00,19463.0,BUY,1,0.02h,Stop Loss,$-6.00,$801.50,$177795.75,310,$801.50
2025-03-13,17:08:00,19263.75,SELL,1,0.02h,Stop Loss,$10.25,$811.75,$177806.00,310,$811.75
2025-03-13,17:40:00,19392.0,BUY,1,0.02h,Stop Loss,$-6.00,$805.75,$177800.00,310,$805.75
2025-03-13,17:41:00,19208.75,SELL,1,0.02h,Stop Loss,$-6.00,$799.75,$177794.00,310,$799.75
2025-03-13,17:42:00,19396.25,BUY,1,0.02h,Stop Loss,$-6.00,$793.75,$177788.00,310,$793.75
2025-03-13,17:43:00,19194.0,SELL,1,0.02h,Break Even,$0.25,$794.00,$177788.25,310,$794.00
2025-03-13,17:46:00,19383.0,BUY,1,0.02h,Stop Loss,$-6.00,$788.00,$177782.25,310,$788.00
2025-03-13,17:47:00,19178.75,SELL,1,0.02h,Stop Loss,$-6.00,$782.00,$177776.25,310,$782.00
2025-03-13,17:49:00,19379.0,BUY,1,0.02h,Stop Loss,$24.00,$806.00,$177800.25,310,$806.00
2025-03-13,17:54:00,19220.5,SELL,1,0.02h,Stop Loss,$44.00,$850.00,$177844.25,310,$850.00
2025-03-13,18:02:00,19438.25,BUY,1,0.02h,Stop Loss,$-6.00,$844.00,$177838.25,310,$844.00
2025-03-13,18:03:00,19249.75,SELL,1,0.02h,Stop Loss,$-6.00,$838.00,$177832.25,310,$838.00
2025-03-13,18:04:00,19457.0,BUY,1,0.02h,Stop Loss,$-6.00,$832.00,$177826.25,310,$832.00
2025-03-13,18:09:00,19272.5,SELL,1,0.02h,Stop Loss,$54.00,$886.00,$177880.25,310,$886.00
2025-03-13,18:12:00,19486.0,BUY,1,0.02h,Stop Loss,$-6.00,$880.00,$177874.25,310,$880.00
2025-03-13,18:49:00,19375.0,SELL,1,0.02h,Stop Loss,$20.25,$900.25,$177894.50,310,$900.25
2025-03-13,18:52:00,19559.0,BUY,1,0.02h,Break Even,$0.25,$900.50,$177894.75,310,$900.50
2025-03-13,18:54:00,19317.25,SELL,1,0.02h,Stop Loss,$5.25,$905.75,$177900.00,310,$905.75
2025-03-13,18:56:00,19554.75,BUY,1,0.02h,Stop Loss,$10.25,$916.00,$177910.25,310,$916.00
2025-03-13,19:08:00,19315.75,SELL,1,0.02h,Stop Loss,$-6.00,$910.00,$177904.25,310,$910.00
2025-03-13,19:09:00,19515.25,BUY,1,0.02h,Stop Loss,$42.75,$952.75,$177947.00,310,$952.75
2025-03-13,19:11:00,19314.25,SELL,1,0.02h,Stop Loss,$-6.00,$946.75,$177941.00,310,$946.75
2025-03-13,19:13:00,19521.25,BUY,1,0.02h,Stop Loss,$-6.00,$940.75,$177935.00,310,$940.75
2025-03-13,19:14:00,19313.0,SELL,1,0.02h,Stop Loss,$5.25,$946.00,$177940.25,310,$946.00
2025-03-13,19:19:00,19516.5,BUY,1,0.02h,Stop Loss,$81.50,$1027.50,$178021.75,310,$1027.50
2025-03-13,19:22:00,19307.5,SELL,1,0.02h,Break Even,$0.25,$1027.75,$178022.00,310,$1027.75
2025-03-13,19:42:00,19428.5,BUY,1,0.02h,Break Even,$0.25,$1028.00,$178022.25,310,$1028.00
2025-03-13,19:45:00,19226.75,SELL,1,0.02h,Stop Loss,$-6.00,$1022.00,$178016.25,310,$1022.00
2025-03-13,19:46:00,19413.5,BUY,1,0.02h,Stop Loss,$134.00,$1156.00,$178150.25,310,$1156.00
2025-03-13,19:48:00,19231.0,SELL,1,0.02h,Stop Loss,$37.75,$1193.75,$178188.00,310,$1193.75
2025-03-13,20:01:00,19472.0,BUY,1,0.02h,Stop Loss,$-6.00,$1187.75,$178182.00,310,$1187.75
2025-03-13,20:03:00,19280.0,SELL,1,0.02h,Stop Loss,$-6.00,$1181.75,$178176.00,310,$1181.75
2025-03-13,20:04:00,19495.25,BUY,1,0.02h,Stop Loss,$-6.00,$1175.75,$178170.00,310,$1175.75
2025-03-13,20:32:00,19317.75,SELL,1,0.02h,Break Even,$0.25,$1176.00,$178170.25,310,$1176.00
2025-03-13,20:47:00,19504.75,BUY,1,0.02h,Stop Loss,$-6.00,$1170.00,$178164.25,310,$1170.00
2025-03-13,20:48:00,19299.75,SELL,1,0.02h,Stop Loss,$22.75,$1192.75,$178187.00,310,$1192.75
2025-03-13,20:53:00,19504.0,BUY,1,0.02h,Stop Loss,$-6.00,$1186.75,$178181.00,310,$1186.75
2025-03-13,20:55:00,19298.5,SELL,1,0.02h,Break Even,$0.25,$1187.00,$178181.25,310,$1187.00
2025-03-13,21:00:00,19500.0,BUY,1,1.02h,Stop Loss,$-6.00,$1181.00,$178175.25,310,$1181.00
2025-03-13,22:10:00,19337.75,SELL,1,0.02h,Stop Loss,$9.00,$1190.00,$178184.25,310,$1190.00
2025-03-13,22:14:00,19548.75,BUY,1,0.02h,Stop Loss,$7.75,$1197.75,$178192.00,310,$1197.75
2025-03-13,22:25:00,19323.5,SELL,1,0.02h,Stop Loss,$-6.00,$1191.75,$178186.00,310,$1191.75
2025-03-13,22:26:00,19534.5,BUY,1,0.02h,Stop Loss,$-6.00,$1185.75,$178180.00,310,$1185.75
2025-03-13,22:28:00,19326.25,SELL,1,0.02h,Stop Loss,$-6.00,$1179.75,$178174.00,310,$1179.75
2025-03-13,22:29:00,19540.0,BUY,1,0.02h,Stop Loss,$-6.00,$1173.75,$178168.00,310,$1173.75
2025-03-13,22:30:00,19338.0,SELL,1,0.02h,Stop Loss,$-6.00,$1167.75,$178162.00,310,$1167.75
2025-03-13,22:33:00,19543.25,BUY,1,0.02h,Stop Loss,$-6.00,$1161.75,$178156.00,310,$1161.75
2025-03-13,22:40:00,19367.25,SELL,1,0.02h,Stop Loss,$-6.00,$1155.75,$178150.00,310,$1155.75
2025-03-13,22:45:00,19567.75,BUY,1,0.02h,Stop Loss,$-6.00,$1149.75,$178144.00,310,$1149.75
2025-03-13,22:51:00,19371.0,SELL,1,0.02h,Stop Loss,$5.25,$1155.00,$178149.25,310,$1155.00
2025-03-13,22:53:00,19574.25,BUY,1,0.02h,Stop Loss,$-6.00,$1149.00,$178143.25,310,$1149.00
2025-03-13,22:54:00,19380.0,SELL,1,0.02h,Break Even,$0.25,$1149.25,$178143.50,310,$1149.25
2025-03-13,22:56:00,19581.25,BUY,1,0.02h,Stop Loss,$-6.00,$1143.25,$178137.50,310,$1143.25
2025-03-13,22:57:00,19378.75,SELL,1,0.02h,Stop Loss,$-6.00,$1137.25,$178131.50,310,$1137.25
2025-03-13,22:58:00,19568.25,BUY,1,0.02h,Break Even,$0.25,$1137.50,$178131.75,310,$1137.50
Final P&L Day: 1137.50,,,,,,,,,,,
2025-03-14,12:22:00,19498.25,SELL,1,0.02h,Stop Loss,$-6.00,$-6.00,$178125.75,311,$-6.00
2025-03-14,12:29:00,19720.0,BUY,1,0.02h,Stop Loss,$-6.00,$-12.00,$178119.75,311,$-12.00
2025-03-14,12:36:00,19515.0,SELL,1,0.02h,Break Even,$0.25,$-11.75,$178120.00,311,$-11.75
2025-03-14,12:39:00,19717.5,BUY,1,0.02h,Stop Loss,$-6.00,$-17.75,$178114.00,311,$-17.75
2025-03-14,12:56:00,19501.5,SELL,1,0.02h,Stop Loss,$6.50,$-11.25,$178120.50,311,$-11.25
2025-03-14,13:15:00,19685.25,BUY,1,0.02h,Stop Loss,$-6.00,$-17.25,$178114.50,311,$-17.25
2025-03-14,13:16:00,19479.0,SELL,1,0.02h,Stop Loss,$9.00,$-8.25,$178123.50,311,$-8.25
2025-03-14,13:27:00,19679.5,BUY,1,0.02h,Stop Loss,$-6.00,$-14.25,$178117.50,311,$-14.25
2025-03-14,13:33:00,19492.75,SELL,1,0.02h,Stop Loss,$-6.00,$-20.25,$178111.50,311,$-20.25
2025-03-14,13:36:00,19565.25,BUY,1,0.02h,Stop Loss,$1077.75,$1057.50,$179189.25,311,$1057.50
2025-03-14,13:58:00,19555.0,SELL,1,0.02h,Stop Loss,$17.75,$1075.25,$179207.00,311,$1075.25
2025-03-14,14:06:00,19752.75,BUY,1,0.02h,Stop Loss,$165.25,$1240.50,$179372.25,311,$1240.50
2025-03-14,14:11:00,19516.5,SELL,1,0.02h,Stop Loss,$-6.00,$1234.50,$179366.25,311,$1234.50
2025-03-14,14:14:00,19704.5,BUY,1,0.02h,Stop Loss,$-6.00,$1228.50,$179360.25,311,$1228.50
2025-03-14,14:15:00,19478.75,SELL,1,0.02h,Stop Loss,$5.25,$1233.75,$179365.50,311,$1233.75
2025-03-14,14:25:00,19721.25,BUY,1,0.02h,Stop Loss,$-6.00,$1227.75,$179359.50,311,$1227.75
2025-03-14,14:26:00,19501.0,SELL,1,0.02h,Stop Loss,$75.25,$1303.00,$179434.75,311,$1303.00
2025-03-14,14:30:00,19681.5,BUY,1,0.02h,Stop Loss,$-6.00,$1297.00,$179428.75,311,$1297.00
2025-03-14,14:31:00,19490.25,SELL,1,0.02h,Stop Loss,$-6.00,$1291.00,$179422.75,311,$1291.00
2025-03-14,14:32:00,19706.25,BUY,1,0.02h,Stop Loss,$-6.00,$1285.00,$179416.75,311,$1285.00
2025-03-14,14:33:00,19492.25,SELL,1,0.02h,Stop Loss,$45.25,$1330.25,$179462.00,311,$1330.25
2025-03-14,14:36:00,19683.0,BUY,1,0.02h,Stop Loss,$102.75,$1433.00,$179564.75,311,$1433.00
2025-03-14,14:44:00,19539.5,SELL,1,0.02h,Stop Loss,$21.50,$1454.50,$179586.25,311,$1454.50
2025-03-14,14:46:00,19763.5,BUY,1,0.02h,Stop Loss,$27.75,$1482.25,$179614.00,311,$1482.25
2025-03-14,14:54:00,19564.5,SELL,1,0.02h,Stop Loss,$17.75,$1500.00,$179631.75,311,$1500.00
2025-03-14,15:00:00,19817.0,BUY,1,0.02h,Stop Loss,$136.50,$1636.50,$179768.25,311,$1636.50
2025-03-14,15:07:00,19632.5,SELL,1,0.02h,Stop Loss,$26.50,$1663.00,$179794.75,311,$1663.00
2025-03-14,15:09:00,19833.0,BUY,1,0.02h,Stop Loss,$-6.00,$1657.00,$179788.75,311,$1657.00
2025-03-14,15:30:00,19644.75,SELL,1,0.02h,Stop Loss,$4.00,$1661.00,$179792.75,311,$1661.00
2025-03-14,15:36:00,19870.5,BUY,1,0.02h,Stop Loss,$25.25,$1686.25,$179818.00,311,$1686.25
2025-03-14,15:40:00,19681.75,SELL,1,0.02h,Stop Loss,$-6.00,$1680.25,$179812.00,311,$1680.25
2025-03-14,15:41:00,19894.5,BUY,1,0.02h,Stop Loss,$21.50,$1701.75,$179833.50,311,$1701.75
2025-03-14,15:45:00,19696.75,SELL,1,0.02h,Stop Loss,$129.00,$1830.75,$179962.50,311,$1830.75
2025-03-14,15:47:00,19878.0,BUY,1,0.02h,Break Even,$0.25,$1831.00,$179962.75,311,$1831.00
2025-03-14,15:59:00,19667.5,SELL,1,0.02h,Stop Loss,$-6.00,$1825.00,$179956.75,311,$1825.00
2025-03-14,16:12:00,19845.25,BUY,1,0.02h,Stop Loss,$7.75,$1832.75,$179964.50,311,$1832.75
2025-03-14,16:19:00,19638.5,SELL,1,0.02h,Stop Loss,$34.00,$1866.75,$179998.50,311,$1866.75
2025-03-14,16:36:00,19857.0,BUY,1,0.02h,Stop Loss,$-6.00,$1860.75,$179992.50,311,$1860.75
2025-03-14,16:51:00,19690.5,SELL,1,0.02h,Stop Loss,$-6.00,$1854.75,$179986.50,311,$1854.75
2025-03-14,16:52:00,19900.5,BUY,1,0.02h,Stop Loss,$-6.00,$1848.75,$179980.50,311,$1848.75
2025-03-14,17:05:00,19675.0,SELL,1,0.02h,Stop Loss,$16.50,$1865.25,$179997.00,311,$1865.25
2025-03-14,17:34:00,19845.5,BUY,1,0.02h,Stop Loss,$9.00,$1874.25,$180006.00,311,$1874.25
2025-03-14,17:43:00,19634.5,SELL,1,0.02h,Break Even,$0.25,$1874.50,$180006.25,311,$1874.50
2025-03-14,17:46:00,19833.0,BUY,1,0.02h,Stop Loss,$34.00,$1908.50,$180040.25,311,$1908.50
2025-03-14,18:07:00,19669.0,SELL,1,0.02h,Stop Loss,$67.75,$1976.25,$180108.00,311,$1976.25
2025-03-14,18:23:00,19838.75,BUY,1,0.02h,Stop Loss,$-6.00,$1970.25,$180102.00,311,$1970.25
2025-03-14,18:24:00,19622.25,SELL,1,0.02h,Stop Loss,$34.00,$2004.25,$180136.00,311,$2004.25
2025-03-14,18:32:00,19867.25,BUY,1,0.02h,Break Even,$0.25,$2004.50,$180136.25,311,$2004.50
2025-03-14,18:45:00,19687.5,SELL,1,0.02h,Stop Loss,$-6.00,$1998.50,$180130.25,311,$1998.50
2025-03-14,18:46:00,19894.0,BUY,1,0.02h,Stop Loss,$41.50,$2040.00,$180171.75,311,$2040.00
2025-03-14,18:51:00,19693.25,SELL,1,0.02h,Stop Loss,$-6.00,$2034.00,$180165.75,311,$2034.00
2025-03-14,18:52:00,19885.0,BUY,1,0.02h,Stop Loss,$-6.00,$2028.00,$180159.75,311,$2028.00
2025-03-14,18:54:00,19688.25,SELL,1,0.02h,Stop Loss,$45.25,$2073.25,$180205.00,311,$2073.25
2025-03-14,18:58:00,19866.25,BUY,1,0.02h,Stop Loss,$-6.00,$2067.25,$180199.00,311,$2067.25
2025-03-14,18:59:00,19678.25,SELL,1,0.02h,Stop Loss,$25.25,$2092.50,$180224.25,311,$2092.50
2025-03-14,19:06:00,19897.5,BUY,1,0.02h,Stop Loss,$37.75,$2130.25,$180262.00,311,$2130.25
2025-03-14,19:11:00,19700.75,SELL,1,0.02h,Break Even,$0.25,$2130.50,$180262.25,311,$2130.50
2025-03-14,19:13:00,19917.0,BUY,1,0.02h,Break Even,$0.25,$2130.75,$180262.50,311,$2130.75
2025-03-14,19:24:00,19679.5,SELL,1,0.02h,Stop Loss,$-6.00,$2124.75,$180256.50,311,$2124.75
2025-03-14,19:27:00,19895.0,BUY,1,0.02h,Break Even,$0.25,$2125.00,$180256.75,311,$2125.00
2025-03-14,19:35:00,19682.25,SELL,1,0.02h,Stop Loss,$-6.00,$2119.00,$180250.75,311,$2119.00
2025-03-14,19:36:00,19881.25,BUY,1,0.02h,Stop Loss,$-6.00,$2113.00,$180244.75,311,$2113.00
2025-03-14,19:37:00,19673.25,SELL,1,0.02h,Stop Loss,$10.25,$2123.25,$180255.00,311,$2123.25
2025-03-14,19:41:00,19875.25,BUY,1,0.02h,Stop Loss,$-6.00,$2117.25,$180249.00,311,$2117.25
2025-03-14,19:43:00,19665.0,SELL,1,0.02h,Stop Loss,$-6.00,$2111.25,$180243.00,311,$2111.25
2025-03-14,19:44:00,19872.0,BUY,1,0.02h,Stop Loss,$-6.00,$2105.25,$180237.00,311,$2105.25
2025-03-14,19:45:00,19668.5,SELL,1,0.02h,Stop Loss,$27.75,$2133.00,$180264.75,311,$2133.00
2025-03-14,19:50:00,19902.0,BUY,1,0.02h,Stop Loss,$-6.00,$2127.00,$180258.75,311,$2127.00
2025-03-14,19:52:00,19696.25,SELL,1,0.02h,Break Even,$0.25,$2127.25,$180259.00,311,$2127.25
2025-03-14,19:58:00,19937.5,BUY,1,0.02h,Stop Loss,$-6.00,$2121.25,$180253.00,311,$2121.25
2025-03-14,19:59:00,19731.5,SELL,1,0.02h,Stop Loss,$-6.00,$2115.25,$180247.00,311,$2115.25
2025-03-14,20:00:00,19912.5,BUY,1,0.02h,Stop Loss,$-6.00,$2109.25,$180241.00,311,$2109.25
2025-03-14,20:03:00,19676.5,SELL,1,0.02h,Stop Loss,$32.75,$2142.00,$180273.75,311,$2142.00
2025-03-14,20:13:00,19865.75,BUY,1,0.02h,Stop Loss,$11.50,$2153.50,$180285.25,311,$2153.50
2025-03-14,20:17:00,19659.75,SELL,1,0.02h,Stop Loss,$-6.00,$2147.50,$180279.25,311,$2147.50
2025-03-14,20:22:00,19854.0,BUY,1,0.02h,Stop Loss,$-6.00,$2141.50,$180273.25,311,$2141.50
2025-03-14,20:23:00,19644.75,SELL,1,0.02h,Stop Loss,$5.25,$2146.75,$180278.50,311,$2146.75
2025-03-14,20:31:00,19870.5,BUY,1,0.02h,Stop Loss,$-6.00,$2140.75,$180272.50,311,$2140.75
2025-03-14,20:32:00,19666.5,SELL,1,0.02h,Stop Loss,$-6.00,$2134.75,$180266.50,311,$2134.75
2025-03-14,20:33:00,19865.75,BUY,1,0.02h,Stop Loss,$-6.00,$2128.75,$180260.50,311,$2128.75
2025-03-14,20:53:00,19663.5,SELL,1,0.02h,Stop Loss,$-6.00,$2122.75,$180254.50,311,$2122.75
2025-03-14,20:54:00,19874.0,BUY,1,0.02h,Stop Loss,$-6.00,$2116.75,$180248.50,311,$2116.75
2025-03-14,20:57:00,19668.25,SELL,1,0.02h,Stop Loss,$-6.00,$2110.75,$180242.50,311,$2110.75
Final P&L Day: 2110.75,,,,,,,,,,,
2025-03-17,12:01:00,19892.5,BUY,1,0.02h,Break Even,$0.25,$0.25,$180242.75,312,$0.25
2025-03-17,13:02:00,19939.0,SELL,1,0.02h,Break Even,$0.25,$0.50,$180243.00,312,$0.50
2025-03-17,13:34:00,19962.25,BUY,1,0.02h,Stop Loss,$14.00,$14.50,$180257.00,312,$14.50
2025-03-17,14:02:00,19956.25,SELL,1,0.02h,Stop Loss,$42.75,$57.25,$180299.75,312,$57.25
2025-03-17,14:14:00,20010.5,BUY,1,0.02h,Stop Loss,$52.75,$110.00,$180352.50,312,$110.00
2025-03-17,14:27:00,19966.75,SELL,1,0.02h,Stop Loss,$72.75,$182.75,$180425.25,312,$182.75
2025-03-17,14:49:00,19955.0,BUY,1,0.02h,Stop Loss,$17.75,$200.50,$180443.00,312,$200.50
2025-03-17,14:52:00,19932.5,SELL,1,0.02h,Stop Loss,$32.75,$233.25,$180475.75,312,$233.25
2025-03-17,15:18:00,19923.75,BUY,1,0.02h,Stop Loss,$21.50,$254.75,$180497.25,312,$254.75
2025-03-17,15:30:00,19885.75,SELL,1,0.02h,Stop Loss,$21.50,$276.25,$180518.75,312,$276.25
2025-03-17,15:52:00,19894.25,BUY,1,0.02h,Stop Loss,$9.00,$285.25,$180527.75,312,$285.25
2025-03-17,16:02:00,19867.0,SELL,1,0.02h,Stop Loss,$15.25,$300.50,$180543.00,312,$300.50
2025-03-17,16:05:00,19896.75,BUY,1,0.02h,Stop Loss,$26.50,$327.00,$180569.50,312,$327.00
2025-03-17,16:23:00,19894.0,SELL,1,0.02h,Stop Loss,$69.00,$396.00,$180638.50,312,$396.00
2025-03-17,16:39:00,19905.75,BUY,1,0.02h,Break Even,$0.25,$396.25,$180638.75,312,$396.25
2025-03-17,16:42:00,19871.25,SELL,1,0.02h,Stop Loss,$27.75,$424.00,$180666.50,312,$424.00
2025-03-17,16:52:00,19906.25,BUY,1,0.02h,Stop Loss,$29.00,$453.00,$180695.50,312,$453.00
2025-03-17,17:04:00,19883.75,SELL,1,0.02h,Break Even,$0.25,$453.25,$180695.75,312,$453.25
2025-03-17,17:07:00,19910.0,BUY,1,0.02h,Stop Loss,$52.75,$506.00,$180748.50,312,$506.00
2025-03-17,19:03:00,20131.75,SELL,1,0.02h,Stop Loss,$14.00,$520.00,$180762.50,312,$520.00
2025-03-17,20:29:00,20036.0,BUY,1,0.02h,Stop Loss,$11.50,$531.50,$180774.00,312,$531.50
2025-03-17,20:49:00,20032.75,SELL,1,0.02h,Stop Loss,$-6.00,$525.50,$180768.00,312,$525.50
2025-03-17,20:52:00,20037.5,BUY,1,0.03h,Break Even,$0.25,$525.75,$180768.25,312,$525.75
2025-03-17,22:51:00,20058.25,SELL,1,0.02h,Stop Loss,$-6.00,$519.75,$180762.25,312,$519.75
Final P&L Day: 519.75,,,,,,,,,,,
2025-03-18,12:28:00,19960.5,BUY,1,0.02h,Stop Loss,$-6.00,$-6.00,$180756.25,313,$-6.00
2025-03-18,12:29:00,19755.5,SELL,1,0.02h,Break Even,$0.25,$-5.75,$180756.50,313,$-5.75
2025-03-18,12:43:00,19944.75,BUY,1,0.02h,Stop Loss,$22.75,$17.00,$180779.25,313,$17.00
2025-03-18,12:50:00,19733.75,SELL,1,0.02h,Stop Loss,$10.25,$27.25,$180789.50,313,$27.25
2025-03-18,13:01:00,19893.5,BUY,1,0.02h,Stop Loss,$-6.00,$21.25,$180783.50,313,$21.25
2025-03-18,13:02:00,19691.25,SELL,1,0.02h,Stop Loss,$-6.00,$15.25,$180777.50,313,$15.25
2025-03-18,13:03:00,19905.75,BUY,1,0.02h,Stop Loss,$30.25,$45.50,$180807.75,313,$45.50
2025-03-18,13:16:00,19714.75,SELL,1,0.02h,Stop Loss,$-6.00,$39.50,$180801.75,313,$39.50
2025-03-18,13:17:00,19922.75,BUY,1,0.02h,Stop Loss,$-6.00,$33.50,$180795.75,313,$33.50
2025-03-18,13:18:00,19711.0,SELL,1,0.02h,Stop Loss,$56.50,$90.00,$180852.25,313,$90.00
2025-03-18,13:28:00,19891.5,BUY,1,0.02h,Stop Loss,$17.75,$107.75,$180870.00,313,$107.75
2025-03-18,13:33:00,19666.75,SELL,1,0.02h,Stop Loss,$5.25,$113.00,$180875.25,313,$113.00
2025-03-18,14:08:00,19705.5,BUY,1,0.02h,Stop Loss,$19.00,$132.00,$180894.25,313,$132.00
2025-03-18,14:10:00,19508.5,SELL,1,0.02h,Stop Loss,$-6.00,$126.00,$180888.25,313,$126.00
2025-03-18,14:11:00,19697.0,BUY,1,0.02h,Stop Loss,$62.75,$188.75,$180951.00,313,$188.75
2025-03-18,14:17:00,19464.25,SELL,1,0.02h,Stop Loss,$55.25,$244.00,$181006.25,313,$244.00
2025-03-18,14:28:00,19703.0,BUY,1,0.02h,Stop Loss,$17.75,$261.75,$181024.00,313,$261.75
2025-03-18,14:39:00,19503.5,SELL,1,0.02h,Stop Loss,$5.25,$267.00,$181029.25,313,$267.00
2025-03-18,14:45:00,19689.75,BUY,1,0.02h,Stop Loss,$-6.00,$261.00,$181023.25,313,$261.00
2025-03-18,14:46:00,19473.0,SELL,1,0.02h,Stop Loss,$-6.00,$255.00,$181017.25,313,$255.00
2025-03-18,14:50:00,19660.75,BUY,1,0.02h,Stop Loss,$125.25,$380.25,$181142.50,313,$380.25
2025-03-18,14:56:00,19486.75,SELL,1,0.02h,Stop Loss,$9.00,$389.25,$181151.50,313,$389.25
2025-03-18,15:20:00,19673.75,BUY,1,0.02h,Stop Loss,$5.25,$394.50,$181156.75,313,$394.50
2025-03-18,15:41:00,19479.0,SELL,1,0.02h,Stop Loss,$-6.00,$388.50,$181150.75,313,$388.50
2025-03-18,15:42:00,19668.75,BUY,1,0.02h,Stop Loss,$-6.00,$382.50,$181144.75,313,$382.50
2025-03-18,15:43:00,19462.5,SELL,1,0.02h,Stop Loss,$-6.00,$376.50,$181138.75,313,$376.50
2025-03-18,15:54:00,19656.25,BUY,1,0.02h,Stop Loss,$-6.00,$370.50,$181132.75,313,$370.50
2025-03-18,15:55:00,19447.25,SELL,1,0.02h,Stop Loss,$-6.00,$364.50,$181126.75,313,$364.50
2025-03-18,15:56:00,19649.25,BUY,1,0.02h,Stop Loss,$-6.00,$358.50,$181120.75,313,$358.50
2025-03-18,16:12:00,19505.0,SELL,1,0.02h,Stop Loss,$-6.00,$352.50,$181114.75,313,$352.50
2025-03-18,16:13:00,19717.75,BUY,1,0.02h,Stop Loss,$-6.00,$346.50,$181108.75,313,$346.50
2025-03-18,16:14:00,19509.75,SELL,1,0.02h,Stop Loss,$-6.00,$340.50,$181102.75,313,$340.50
2025-03-18,16:15:00,19724.5,BUY,1,0.02h,Stop Loss,$-6.00,$334.50,$181096.75,313,$334.50
2025-03-18,16:16:00,19522.0,SELL,1,0.02h,Stop Loss,$-6.00,$328.50,$181090.75,313,$328.50
2025-03-18,16:17:00,19726.5,BUY,1,0.02h,Stop Loss,$-6.00,$322.50,$181084.75,313,$322.50
2025-03-18,16:28:00,19523.75,SELL,1,0.02h,Stop Loss,$20.25,$342.75,$181105.00,313,$342.75
2025-03-18,16:36:00,19745.5,BUY,1,0.02h,Stop Loss,$-6.00,$336.75,$181099.00,313,$336.75
2025-03-18,16:37:00,19537.25,SELL,1,0.02h,Stop Loss,$69.00,$405.75,$181168.00,313,$405.75
2025-03-18,16:41:00,19740.5,BUY,1,0.02h,Break Even,$0.25,$406.00,$181168.25,313,$406.00
2025-03-18,16:45:00,19484.75,SELL,1,0.02h,Stop Loss,$-6.00,$400.00,$181162.25,313,$400.00
2025-03-18,16:57:00,19693.0,BUY,1,0.02h,Stop Loss,$-6.00,$394.00,$181156.25,313,$394.00
2025-03-18,16:58:00,19502.5,SELL,1,0.02h,Stop Loss,$-6.00,$388.00,$181150.25,313,$388.00
2025-03-18,16:59:00,19727.25,BUY,1,0.02h,Stop Loss,$-6.00,$382.00,$181144.25,313,$382.00
2025-03-18,17:01:00,19527.0,SELL,1,0.02h,Stop Loss,$47.75,$429.75,$181192.00,313,$429.75
2025-03-18,17:04:00,19735.0,BUY,1,0.02h,Stop Loss,$-6.00,$423.75,$181186.00,313,$423.75
2025-03-18,17:05:00,19527.0,SELL,1,0.02h,Stop Loss,$57.75,$481.50,$181243.75,313,$481.50
2025-03-18,17:07:00,19700.25,BUY,1,0.02h,Stop Loss,$9.00,$490.50,$181252.75,313,$490.50
2025-03-18,17:19:00,19510.0,SELL,1,0.02h,Stop Loss,$314.00,$804.50,$181566.75,313,$804.50
2025-03-18,17:25:00,19706.75,BUY,1,0.02h,Stop Loss,$77.75,$882.25,$181644.50,313,$882.25
2025-03-18,17:29:00,19492.0,SELL,1,0.02h,Stop Loss,$-6.00,$876.25,$181638.50,313,$876.25
2025-03-18,17:30:00,19701.25,BUY,1,0.02h,Stop Loss,$-6.00,$870.25,$181632.50,313,$870.25
2025-03-18,17:31:00,19485.5,SELL,1,0.02h,Stop Loss,$-6.00,$864.25,$181626.50,313,$864.25
2025-03-18,17:49:00,19724.0,BUY,1,0.02h,Stop Loss,$-6.00,$858.25,$181620.50,313,$858.25
2025-03-18,17:52:00,19525.5,SELL,1,0.02h,Stop Loss,$-6.00,$852.25,$181614.50,313,$852.25
2025-03-18,17:57:00,19706.0,BUY,1,0.02h,Stop Loss,$12.75,$865.00,$181627.25,313,$865.00
2025-03-18,18:02:00,19491.5,SELL,1,0.02h,Stop Loss,$-6.00,$859.00,$181621.25,313,$859.00
2025-03-18,18:09:00,19687.75,BUY,1,0.02h,Stop Loss,$-6.00,$853.00,$181615.25,313,$853.00
2025-03-18,18:10:00,19488.5,SELL,1,0.02h,Stop Loss,$-6.00,$847.00,$181609.25,313,$847.00
2025-03-18,18:11:00,19677.0,BUY,1,0.02h,Stop Loss,$-6.00,$841.00,$181603.25,313,$841.00
2025-03-18,18:14:00,19466.75,SELL,1,0.02h,Stop Loss,$40.25,$881.25,$181643.50,313,$881.25
2025-03-18,18:18:00,19670.75,BUY,1,0.02h,Stop Loss,$-6.00,$875.25,$181637.50,313,$875.25
2025-03-18,18:19:00,19478.75,SELL,1,0.02h,Stop Loss,$32.75,$908.00,$181670.25,313,$908.00
2025-03-18,18:24:00,19721.5,BUY,1,0.02h,Stop Loss,$-6.00,$902.00,$181664.25,313,$902.00
2025-03-18,18:48:00,19522.0,SELL,1,0.02h,Stop Loss,$-6.00,$896.00,$181658.25,313,$896.00
2025-03-18,18:49:00,19730.25,BUY,1,0.02h,Stop Loss,$130.25,$1026.25,$181788.50,313,$1026.25
2025-03-18,18:58:00,19539.0,SELL,1,0.02h,Stop Loss,$34.00,$1060.25,$181822.50,313,$1060.25
2025-03-18,19:01:00,19726.75,BUY,1,0.02h,Stop Loss,$26.50,$1086.75,$181849.00,313,$1086.75
2025-03-18,19:03:00,19536.0,SELL,1,0.02h,Stop Loss,$-6.00,$1080.75,$181843.00,313,$1080.75
2025-03-18,19:04:00,19742.25,BUY,1,0.02h,Stop Loss,$12.75,$1093.50,$181855.75,313,$1093.50
2025-03-18,19:06:00,19524.5,SELL,1,0.02h,Stop Loss,$-6.00,$1087.50,$181849.75,313,$1087.50
2025-03-18,19:08:00,19721.5,BUY,1,0.02h,Stop Loss,$52.75,$1140.25,$181902.50,313,$1140.25
2025-03-18,19:12:00,19510.5,SELL,1,0.02h,Stop Loss,$-6.00,$1134.25,$181896.50,313,$1134.25
2025-03-18,19:21:00,19746.0,BUY,1,0.02h,Stop Loss,$-6.00,$1128.25,$181890.50,313,$1128.25
2025-03-18,19:22:00,19529.25,SELL,1,0.02h,Stop Loss,$45.25,$1173.50,$181935.75,313,$1173.50
2025-03-18,19:27:00,19704.25,BUY,1,0.02h,Stop Loss,$36.50,$1210.00,$181972.25,313,$1210.00
2025-03-18,19:30:00,19503.5,SELL,1,0.02h,Stop Loss,$4.00,$1214.00,$181976.25,313,$1214.00
2025-03-18,19:43:00,19702.75,BUY,1,0.02h,Stop Loss,$20.25,$1234.25,$181996.50,313,$1234.25
2025-03-18,19:52:00,19497.75,SELL,1,0.02h,Stop Loss,$24.00,$1258.25,$182020.50,313,$1258.25
2025-03-18,19:56:00,19694.0,BUY,1,0.02h,Stop Loss,$45.25,$1303.50,$182065.75,313,$1303.50
2025-03-18,20:07:00,19519.5,SELL,1,0.02h,Stop Loss,$9.00,$1312.50,$182074.75,313,$1312.50
2025-03-18,20:09:00,19727.25,BUY,1,0.02h,Break Even,$0.25,$1312.75,$182075.00,313,$1312.75
2025-03-18,20:14:00,19518.0,SELL,1,0.02h,Stop Loss,$-6.00,$1306.75,$182069.00,313,$1306.75
2025-03-18,20:27:00,19705.0,BUY,1,0.02h,Stop Loss,$-6.00,$1300.75,$182063.00,313,$1300.75
2025-03-18,20:28:00,19498.25,SELL,1,0.02h,Break Even,$0.25,$1301.00,$182063.25,313,$1301.00
2025-03-18,20:31:00,19710.75,BUY,1,0.02h,Stop Loss,$-6.00,$1295.00,$182057.25,313,$1295.00
2025-03-18,20:32:00,19509.5,SELL,1,0.02h,Break Even,$0.25,$1295.25,$182057.50,313,$1295.25
2025-03-18,20:35:00,19715.0,BUY,1,0.02h,Break Even,$0.25,$1295.50,$182057.75,313,$1295.50
2025-03-18,20:47:00,19507.0,SELL,1,0.02h,Stop Loss,$-6.00,$1289.50,$182051.75,313,$1289.50
2025-03-18,20:48:00,19714.5,BUY,1,0.02h,Stop Loss,$-6.00,$1283.50,$182045.75,313,$1283.50
2025-03-18,20:54:00,19502.5,SELL,1,0.02h,Stop Loss,$-6.00,$1277.50,$182039.75,313,$1277.50
2025-03-18,22:01:00,19698.5,BUY,1,0.02h,Stop Loss,$-6.00,$1271.50,$182033.75,313,$1271.50
2025-03-18,22:02:00,19493.0,SELL,1,0.02h,Stop Loss,$-6.00,$1265.50,$182027.75,313,$1265.50
2025-03-18,22:03:00,19698.0,BUY,1,0.02h,Stop Loss,$-6.00,$1259.50,$182021.75,313,$1259.50
2025-03-18,22:04:00,19499.25,SELL,1,0.02h,Stop Loss,$-6.00,$1253.50,$182015.75,313,$1253.50
2025-03-18,22:05:00,19705.25,BUY,1,0.02h,Stop Loss,$-6.00,$1247.50,$182009.75,313,$1247.50
2025-03-18,22:13:00,19487.75,SELL,1,0.02h,Stop Loss,$36.50,$1284.00,$182046.25,313,$1284.00
2025-03-18,22:16:00,19683.75,BUY,1,0.02h,Stop Loss,$-6.00,$1278.00,$182040.25,313,$1278.00
2025-03-18,22:19:00,19484.75,SELL,1,0.02h,Stop Loss,$32.75,$1310.75,$182073.00,313,$1310.75
2025-03-18,22:26:00,19690.0,BUY,1,0.02h,Stop Loss,$-6.00,$1304.75,$182067.00,313,$1304.75
2025-03-18,22:27:00,19485.5,SELL,1,0.02h,Stop Loss,$-6.00,$1298.75,$182061.00,313,$1298.75
2025-03-18,22:28:00,19679.75,BUY,1,0.02h,Break Even,$0.25,$1299.00,$182061.25,313,$1299.00
2025-03-18,22:31:00,19469.5,SELL,1,0.02h,Stop Loss,$-6.00,$1293.00,$182055.25,313,$1293.00
2025-03-18,22:32:00,19671.25,BUY,1,0.02h,Stop Loss,$9.00,$1302.00,$182064.25,313,$1302.00
2025-03-18,22:41:00,19482.5,SELL,1,0.02h,Stop Loss,$-6.00,$1296.00,$182058.25,313,$1296.00
2025-03-18,22:45:00,19699.5,BUY,1,0.02h,Stop Loss,$16.50,$1312.50,$182074.75,313,$1312.50
2025-03-18,22:52:00,19505.75,SELL,1,0.02h,Stop Loss,$-6.00,$1306.50,$182068.75,313,$1306.50
2025-03-18,22:53:00,19711.25,BUY,1,0.02h,Stop Loss,$26.50,$1333.00,$182095.25,313,$1333.00
2025-03-18,22:55:00,19513.0,SELL,1,0.02h,Stop Loss,$-6.00,$1327.00,$182089.25,313,$1327.00
Final P&L Day: 1327.00,,,,,,,,,,,
2025-03-19,12:04:00,19765.25,BUY,1,0.02h,Break Even,$0.25,$0.25,$182089.50,314,$0.25
2025-03-19,12:20:00,19559.75,SELL,1,0.02h,Stop Loss,$15.25,$15.50,$182104.75,314,$15.50
2025-03-19,12:24:00,19758.25,BUY,1,0.02h,Stop Loss,$-6.00,$9.50,$182098.75,314,$9.50
2025-03-19,12:26:00,19550.75,SELL,1,0.02h,Break Even,$0.25,$9.75,$182099.00,314,$9.75
2025-03-19,12:29:00,19752.5,BUY,1,0.02h,Break Even,$0.25,$10.00,$182099.25,314,$10.00
2025-03-19,12:34:00,19552.75,SELL,1,0.02h,Stop Loss,$-6.00,$4.00,$182093.25,314,$4.00
2025-03-19,12:37:00,19758.0,BUY,1,0.02h,Stop Loss,$-6.00,$-2.00,$182087.25,314,$-2.00
2025-03-19,12:38:00,19551.5,SELL,1,0.02h,Stop Loss,$-6.00,$-8.00,$182081.25,314,$-8.00
2025-03-19,12:39:00,19750.0,BUY,1,0.02h,Stop Loss,$4.00,$-4.00,$182085.25,314,$-4.00
2025-03-19,12:42:00,19541.0,SELL,1,0.02h,Stop Loss,$-6.00,$-10.00,$182079.25,314,$-10.00
2025-03-19,12:43:00,19754.25,BUY,1,0.02h,Break Even,$0.25,$-9.75,$182079.50,314,$-9.75
2025-03-19,12:45:00,19557.5,SELL,1,0.02h,Break Even,$0.25,$-9.50,$182079.75,314,$-9.50
2025-03-19,12:48:00,19768.25,BUY,1,0.02h,Stop Loss,$9.00,$-0.50,$182088.75,314,$-0.50
2025-03-19,12:53:00,19562.75,SELL,1,0.02h,Break Even,$0.25,$-0.25,$182089.00,314,$-0.25
2025-03-19,13:01:00,19763.5,BUY,1,0.02h,Stop Loss,$-6.00,$-6.25,$182083.00,314,$-6.25
2025-03-19,13:02:00,19560.75,SELL,1,0.02h,Stop Loss,$-6.00,$-12.25,$182077.00,314,$-12.25
2025-03-19,13:03:00,19763.5,BUY,1,0.02h,Stop Loss,$-6.00,$-18.25,$182071.00,314,$-18.25
2025-03-19,13:09:00,19561.5,SELL,1,0.02h,Break Even,$0.25,$-18.00,$182071.25,314,$-18.00
2025-03-19,13:23:00,19758.0,BUY,1,0.02h,Stop Loss,$-6.00,$-24.00,$182065.25,314,$-24.00
2025-03-19,13:24:00,19556.25,SELL,1,0.02h,Break Even,$0.25,$-23.75,$182065.50,314,$-23.75
2025-03-19,13:29:00,19785.5,BUY,1,0.02h,Stop Loss,$15.25,$-8.50,$182080.75,314,$-8.50
2025-03-19,13:38:00,19554.5,SELL,1,0.02h,Stop Loss,$7.75,$-0.75,$182088.50,314,$-0.75
2025-03-19,13:49:00,19777.75,BUY,1,0.02h,Stop Loss,$24.00,$23.25,$182112.50,314,$23.25
2025-03-19,14:10:00,19689.5,SELL,1,0.02h,Stop Loss,$-6.00,$17.25,$182106.50,314,$17.25
2025-03-19,14:11:00,19892.25,BUY,1,0.02h,Break Even,$0.25,$17.50,$182106.75,314,$17.50
2025-03-19,14:14:00,19666.75,SELL,1,0.02h,Stop Loss,$25.25,$42.75,$182132.00,314,$42.75
2025-03-19,14:16:00,19883.75,BUY,1,0.02h,Stop Loss,$-6.00,$36.75,$182126.00,314,$36.75
2025-03-19,14:17:00,19673.0,SELL,1,0.02h,Stop Loss,$42.75,$79.50,$182168.75,314,$79.50
2025-03-19,14:24:00,19872.25,BUY,1,0.02h,Break Even,$0.25,$79.75,$182169.00,314,$79.75
2025-03-19,14:28:00,19653.0,SELL,1,0.02h,Stop Loss,$11.50,$91.25,$182180.50,314,$91.25
2025-03-19,14:32:00,19847.5,BUY,1,0.02h,Stop Loss,$-6.00,$85.25,$182174.50,314,$85.25
2025-03-19,14:33:00,19651.5,SELL,1,0.02h,Stop Loss,$27.75,$113.00,$182202.25,314,$113.00
2025-03-19,14:35:00,19852.25,BUY,1,0.02h,Stop Loss,$31.50,$144.50,$182233.75,314,$144.50
2025-03-19,14:37:00,19650.0,SELL,1,0.02h,Stop Loss,$-6.00,$138.50,$182227.75,314,$138.50
2025-03-19,14:38:00,19860.0,BUY,1,0.02h,Stop Loss,$14.00,$152.50,$182241.75,314,$152.50
2025-03-19,14:56:00,19595.25,SELL,1,0.02h,Stop Loss,$24.00,$176.50,$182265.75,314,$176.50
2025-03-19,15:04:00,19815.0,BUY,1,0.02h,Stop Loss,$15.25,$191.75,$182281.00,314,$191.75
2025-03-19,15:06:00,19619.75,SELL,1,0.02h,Break Even,$0.25,$192.00,$182281.25,314,$192.00
2025-03-19,15:16:00,19860.5,BUY,1,0.02h,Stop Loss,$-6.00,$186.00,$182275.25,314,$186.00
2025-03-19,15:17:00,19646.75,SELL,1,0.02h,Stop Loss,$-6.00,$180.00,$182269.25,314,$180.00
2025-03-19,15:18:00,19836.0,BUY,1,0.02h,Stop Loss,$-6.00,$174.00,$182263.25,314,$174.00
2025-03-19,15:34:00,19680.75,SELL,1,0.02h,Stop Loss,$-6.00,$168.00,$182257.25,314,$168.00
2025-03-19,15:35:00,19883.0,BUY,1,0.02h,Stop Loss,$-6.00,$162.00,$182251.25,314,$162.00
2025-03-19,15:36:00,19671.0,SELL,1,0.02h,Stop Loss,$-6.00,$156.00,$182245.25,314,$156.00
2025-03-19,15:37:00,19877.0,BUY,1,0.02h,Stop Loss,$4.00,$160.00,$182249.25,314,$160.00
2025-03-19,15:41:00,19685.25,SELL,1,0.02h,Stop Loss,$-6.00,$154.00,$182243.25,314,$154.00
2025-03-19,15:42:00,19891.0,BUY,1,0.02h,Stop Loss,$-6.00,$148.00,$182237.25,314,$148.00
2025-03-19,15:43:00,19690.0,SELL,1,0.02h,Stop Loss,$-6.00,$142.00,$182231.25,314,$142.00
2025-03-19,15:45:00,19900.0,BUY,1,0.02h,Stop Loss,$-6.00,$136.00,$182225.25,314,$136.00
2025-03-19,15:46:00,19696.0,SELL,1,0.02h,Stop Loss,$-6.00,$130.00,$182219.25,314,$130.00
2025-03-19,15:47:00,19894.75,BUY,1,0.02h,Stop Loss,$-6.00,$124.00,$182213.25,314,$124.00
2025-03-19,15:48:00,19686.25,SELL,1,0.02h,Break Even,$0.25,$124.25,$182213.50,314,$124.25
2025-03-19,15:50:00,19903.25,BUY,1,0.02h,Stop Loss,$-6.00,$118.25,$182207.50,314,$118.25
2025-03-19,15:51:00,19710.75,SELL,1,0.02h,Break Even,$0.25,$118.50,$182207.75,314,$118.50
2025-03-19,15:54:00,19929.25,BUY,1,0.02h,Stop Loss,$-6.00,$112.50,$182201.75,314,$112.50
2025-03-19,15:55:00,19720.0,SELL,1,0.02h,Break Even,$0.25,$112.75,$182202.00,314,$112.75
2025-03-19,16:00:00,19920.25,BUY,1,0.02h,Stop Loss,$17.75,$130.50,$182219.75,314,$130.50
2025-03-19,16:03:00,19709.75,SELL,1,0.02h,Stop Loss,$-6.00,$124.50,$182213.75,314,$124.50
2025-03-19,16:04:00,19913.25,BUY,1,0.02h,Stop Loss,$5.25,$129.75,$182219.00,314,$129.75
2025-03-19,16:11:00,19698.25,SELL,1,0.02h,Stop Loss,$-6.00,$123.75,$182213.00,314,$123.75
2025-03-19,16:12:00,19907.5,BUY,1,0.02h,Stop Loss,$-6.00,$117.75,$182207.00,314,$117.75
2025-03-19,16:19:00,19688.25,SELL,1,0.02h,Stop Loss,$-6.00,$111.75,$182201.00,314,$111.75
2025-03-19,16:20:00,19892.75,BUY,1,0.02h,Stop Loss,$-6.00,$105.75,$182195.00,314,$105.75
2025-03-19,16:22:00,19684.5,SELL,1,0.02h,Stop Loss,$-6.00,$99.75,$182189.00,314,$99.75
2025-03-19,16:27:00,19894.25,BUY,1,0.02h,Stop Loss,$-6.00,$93.75,$182183.00,314,$93.75
2025-03-19,16:28:00,19696.75,SELL,1,0.02h,Break Even,$0.25,$94.00,$182183.25,314,$94.00
2025-03-19,16:32:00,19890.5,BUY,1,0.02h,Stop Loss,$-6.00,$88.00,$182177.25,314,$88.00
2025-03-19,16:39:00,19680.25,SELL,1,0.02h,Stop Loss,$17.75,$105.75,$182195.00,314,$105.75
2025-03-19,16:42:00,19874.5,BUY,1,0.02h,Stop Loss,$4.00,$109.75,$182199.00,314,$109.75
2025-03-19,16:44:00,19664.5,SELL,1,0.02h,Stop Loss,$-6.00,$103.75,$182193.00,314,$103.75
2025-03-19,16:45:00,19875.25,BUY,1,0.02h,Stop Loss,$-6.00,$97.75,$182187.00,314,$97.75
2025-03-19,16:46:00,19666.75,SELL,1,0.02h,Stop Loss,$9.00,$106.75,$182196.00,314,$106.75
2025-03-19,16:51:00,19866.75,BUY,1,0.02h,Stop Loss,$-6.00,$100.75,$182190.00,314,$100.75
2025-03-19,16:58:00,19662.0,SELL,1,0.02h,Stop Loss,$26.50,$127.25,$182216.50,314,$127.25
2025-03-19,17:01:00,19881.5,BUY,1,0.02h,Stop Loss,$4.00,$131.25,$182220.50,314,$131.25
2025-03-19,17:03:00,19660.5,SELL,1,0.02h,Stop Loss,$-6.00,$125.25,$182214.50,314,$125.25
2025-03-19,17:04:00,19863.0,BUY,1,0.02h,Stop Loss,$20.25,$145.50,$182234.75,314,$145.50
2025-03-19,17:08:00,19647.25,SELL,1,0.02h,Stop Loss,$-6.00,$139.50,$182228.75,314,$139.50
2025-03-19,17:10:00,19839.5,BUY,1,0.02h,Stop Loss,$-6.00,$133.50,$182222.75,314,$133.50
2025-03-19,17:11:00,19640.5,SELL,1,0.02h,Stop Loss,$4.00,$137.50,$182226.75,314,$137.50
2025-03-19,17:29:00,19816.5,BUY,1,0.02h,Break Even,$0.25,$137.75,$182227.00,314,$137.75
2025-03-19,17:32:00,19594.5,SELL,1,0.02h,Stop Loss,$30.25,$168.00,$182257.25,314,$168.00
2025-03-19,17:42:00,19843.25,BUY,1,0.02h,Stop Loss,$19.00,$187.00,$182276.25,314,$187.00
2025-03-19,17:50:00,19596.0,SELL,1,0.02h,Stop Loss,$-6.00,$181.00,$182270.25,314,$181.00
2025-03-19,17:51:00,19811.25,BUY,1,0.02h,Stop Loss,$-6.00,$175.00,$182264.25,314,$175.00
2025-03-19,17:52:00,19620.75,SELL,1,0.02h,Stop Loss,$-6.00,$169.00,$182258.25,314,$169.00
2025-03-19,17:53:00,19812.75,BUY,1,0.02h,Stop Loss,$-6.00,$163.00,$182252.25,314,$163.00
2025-03-19,17:58:00,19613.0,SELL,1,0.02h,Stop Loss,$-6.00,$157.00,$182246.25,314,$157.00
2025-03-19,18:00:00,19806.0,BUY,1,0.02h,Stop Loss,$432.75,$589.75,$182679.00,314,$589.75
2025-03-19,18:05:00,19656.5,SELL,1,0.02h,Stop Loss,$191.50,$781.25,$182870.50,314,$781.25
2025-03-19,18:09:00,19850.0,BUY,1,0.02h,Stop Loss,$75.25,$856.50,$182945.75,314,$856.50
2025-03-19,18:12:00,19681.5,SELL,1,0.02h,Stop Loss,$-6.00,$850.50,$182939.75,314,$850.50
2025-03-19,18:13:00,19899.5,BUY,1,0.02h,Stop Loss,$37.75,$888.25,$182977.50,314,$888.25
2025-03-19,18:19:00,19700.75,SELL,1,0.02h,Stop Loss,$11.50,$899.75,$182989.00,314,$899.75
2025-03-19,18:22:00,19884.5,BUY,1,0.02h,Stop Loss,$-6.00,$893.75,$182983.00,314,$893.75
2025-03-19,18:23:00,19700.5,SELL,1,0.02h,Stop Loss,$-6.00,$887.75,$182977.00,314,$887.75
2025-03-19,18:24:00,19904.25,BUY,1,0.02h,Stop Loss,$6.50,$894.25,$182983.50,314,$894.25
2025-03-19,18:41:00,19695.0,SELL,1,0.02h,Stop Loss,$-6.00,$888.25,$182977.50,314,$888.25
2025-03-19,18:42:00,19929.0,BUY,1,0.02h,Stop Loss,$111.50,$999.75,$183089.00,314,$999.75
2025-03-19,18:48:00,19755.0,SELL,1,0.02h,Stop Loss,$-6.00,$993.75,$183083.00,314,$993.75
2025-03-19,18:51:00,19959.25,BUY,1,0.02h,Stop Loss,$15.25,$1009.00,$183098.25,314,$1009.00
2025-03-19,19:20:00,19859.5,SELL,1,0.02h,Stop Loss,$132.75,$1141.75,$183231.00,314,$1141.75
2025-03-19,19:23:00,20023.0,BUY,1,0.02h,Stop Loss,$5.25,$1147.00,$183236.25,314,$1147.00
2025-03-19,19:25:00,19818.5,SELL,1,0.02h,Stop Loss,$86.50,$1233.50,$183322.75,314,$1233.50
2025-03-19,19:47:00,20026.25,BUY,1,0.02h,Break Even,$0.25,$1233.75,$183323.00,314,$1233.75
2025-03-19,19:51:00,19766.5,SELL,1,0.02h,Stop Loss,$52.75,$1286.50,$183375.75,314,$1286.50
2025-03-19,19:57:00,19948.75,BUY,1,0.02h,Stop Loss,$-6.00,$1280.50,$183369.75,314,$1280.50
2025-03-19,19:58:00,19741.25,SELL,1,0.02h,Stop Loss,$32.75,$1313.25,$183402.50,314,$1313.25
2025-03-19,20:08:00,19976.75,BUY,1,0.02h,Stop Loss,$7.75,$1321.00,$183410.25,314,$1321.00
2025-03-19,20:14:00,19760.75,SELL,1,0.02h,Stop Loss,$-6.00,$1315.00,$183404.25,314,$1315.00
2025-03-19,20:16:00,19970.25,BUY,1,0.02h,Break Even,$0.25,$1315.25,$183404.50,314,$1315.25
2025-03-19,20:18:00,19758.25,SELL,1,0.02h,Stop Loss,$-6.00,$1309.25,$183398.50,314,$1309.25
2025-03-19,20:19:00,19965.75,BUY,1,0.02h,Stop Loss,$-6.00,$1303.25,$183392.50,314,$1303.25
2025-03-19,20:23:00,19752.5,SELL,1,0.02h,Break Even,$0.25,$1303.50,$183392.75,314,$1303.50
2025-03-19,20:31:00,19946.25,BUY,1,0.02h,Stop Loss,$-6.00,$1297.50,$183386.75,314,$1297.50
2025-03-19,20:32:00,19744.75,SELL,1,0.02h,Stop Loss,$-6.00,$1291.50,$183380.75,314,$1291.50
2025-03-19,20:33:00,19949.75,BUY,1,0.02h,Stop Loss,$-6.00,$1285.50,$183374.75,314,$1285.50
2025-03-19,20:34:00,19742.0,SELL,1,0.02h,Stop Loss,$-6.00,$1279.50,$183368.75,314,$1279.50
2025-03-19,20:35:00,19951.0,BUY,1,0.02h,Stop Loss,$-6.00,$1273.50,$183362.75,314,$1273.50
2025-03-19,20:50:00,19744.0,SELL,1,0.02h,Stop Loss,$-6.00,$1267.50,$183356.75,314,$1267.50
2025-03-19,20:51:00,19947.0,BUY,1,0.02h,Stop Loss,$-6.00,$1261.50,$183350.75,314,$1261.50
2025-03-19,20:53:00,19737.0,SELL,1,0.02h,Break Even,$0.25,$1261.75,$183351.00,314,$1261.75
2025-03-19,22:08:00,19968.0,BUY,1,0.02h,Stop Loss,$10.25,$1272.00,$183361.25,314,$1272.00
2025-03-19,22:17:00,19778.75,SELL,1,0.02h,Stop Loss,$-6.00,$1266.00,$183355.25,314,$1266.00
2025-03-19,22:18:00,19982.75,BUY,1,0.02h,Stop Loss,$16.50,$1282.50,$183371.75,314,$1282.50
2025-03-19,22:29:00,19790.75,SELL,1,0.02h,Break Even,$0.25,$1282.75,$183372.00,314,$1282.75
2025-03-19,22:31:00,19989.25,BUY,1,0.02h,Stop Loss,$-6.00,$1276.75,$183366.00,314,$1276.75
2025-03-19,22:32:00,19787.75,SELL,1,0.02h,Stop Loss,$-6.00,$1270.75,$183360.00,314,$1270.75
2025-03-19,22:33:00,19997.5,BUY,1,0.02h,Stop Loss,$-6.00,$1264.75,$183354.00,314,$1264.75
2025-03-19,22:34:00,19793.0,SELL,1,0.02h,Stop Loss,$7.75,$1272.50,$183361.75,314,$1272.50
2025-03-19,22:42:00,20007.75,BUY,1,0.02h,Stop Loss,$-6.00,$1266.50,$183355.75,314,$1266.50
2025-03-19,22:43:00,19802.5,SELL,1,0.02h,Break Even,$0.25,$1266.75,$183356.00,314,$1266.75
2025-03-19,22:47:00,20013.25,BUY,1,0.02h,Stop Loss,$22.75,$1289.50,$183378.75,314,$1289.50
2025-03-19,22:51:00,19817.5,SELL,1,0.02h,Break Even,$0.25,$1289.75,$183379.00,314,$1289.75
2025-03-19,22:54:00,20022.75,BUY,1,0.02h,Stop Loss,$-6.00,$1283.75,$183373.00,314,$1283.75
Final P&L Day: 1283.75,,,,,,,,,,,
2025-03-20,12:02:00,19644.5,SELL,1,0.02h,Stop Loss,$-6.00,$-6.00,$183367.00,315,$-6.00
2025-03-20,12:30:00,19836.75,BUY,1,0.02h,Stop Loss,$15.25,$9.25,$183382.25,315,$9.25
2025-03-20,12:35:00,19644.75,SELL,1,0.02h,Stop Loss,$-6.00,$3.25,$183376.25,315,$3.25
2025-03-20,12:36:00,19854.75,BUY,1,0.02h,Stop Loss,$-6.00,$-2.75,$183370.25,315,$-2.75
2025-03-20,12:37:00,19651.25,SELL,1,0.02h,Stop Loss,$-6.00,$-8.75,$183364.25,315,$-8.75
2025-03-20,12:38:00,19848.75,BUY,1,0.02h,Stop Loss,$-6.00,$-14.75,$183358.25,315,$-14.75
2025-03-20,12:53:00,19630.75,SELL,1,0.02h,Stop Loss,$-6.00,$-20.75,$183352.25,315,$-20.75
2025-03-20,13:03:00,19809.5,BUY,1,0.02h,Stop Loss,$-6.00,$-26.75,$183346.25,315,$-26.75
2025-03-20,13:04:00,19595.5,SELL,1,0.02h,Break Even,$0.25,$-26.50,$183346.50,315,$-26.50
2025-03-20,13:14:00,19819.75,BUY,1,0.02h,Break Even,$0.25,$-26.25,$183346.75,315,$-26.25
2025-03-20,13:17:00,19609.5,SELL,1,0.02h,Break Even,$0.25,$-26.00,$183347.00,315,$-26.00
2025-03-20,13:22:00,19805.0,BUY,1,0.02h,Break Even,$0.25,$-25.75,$183347.25,315,$-25.75
2025-03-20,13:38:00,19654.5,SELL,1,0.02h,Break Even,$0.25,$-25.50,$183347.50,315,$-25.50
2025-03-20,13:40:00,19894.0,BUY,1,0.02h,Stop Loss,$9.00,$-16.50,$183356.50,315,$-16.50
2025-03-20,13:48:00,19701.5,SELL,1,0.02h,Stop Loss,$30.25,$13.75,$183386.75,315,$13.75
2025-03-20,13:50:00,19908.5,BUY,1,0.02h,Stop Loss,$-6.00,$7.75,$183380.75,315,$7.75
2025-03-20,13:51:00,19712.25,SELL,1,0.02h,Stop Loss,$21.50,$29.25,$183402.25,315,$29.25
2025-03-20,13:54:00,19927.0,BUY,1,0.02h,Break Even,$0.25,$29.50,$183402.50,315,$29.50
2025-03-20,14:22:00,19819.75,SELL,1,0.02h,Stop Loss,$-6.00,$23.50,$183396.50,315,$23.50
2025-03-20,14:23:00,20032.0,BUY,1,0.02h,Stop Loss,$-6.00,$17.50,$183390.50,315,$17.50
2025-03-20,14:45:00,19884.5,SELL,1,0.02h,Stop Loss,$-6.00,$11.50,$183384.50,315,$11.50
2025-03-20,14:46:00,20090.0,BUY,1,0.02h,Stop Loss,$50.25,$61.75,$183434.75,315,$61.75
2025-03-20,14:52:00,19865.75,SELL,1,0.02h,Stop Loss,$87.75,$149.50,$183522.50,315,$149.50
2025-03-20,15:01:00,20025.25,BUY,1,0.02h,Stop Loss,$27.75,$177.25,$183550.25,315,$177.25
2025-03-20,15:05:00,19820.0,SELL,1,0.02h,Stop Loss,$-6.00,$171.25,$183544.25,315,$171.25
2025-03-20,15:07:00,20040.25,BUY,1,0.02h,Stop Loss,$-6.00,$165.25,$183538.25,315,$165.25
2025-03-20,15:08:00,19836.0,SELL,1,0.02h,Stop Loss,$-6.00,$159.25,$183532.25,315,$159.25
2025-03-20,15:12:00,20045.75,BUY,1,0.02h,Stop Loss,$-6.00,$153.25,$183526.25,315,$153.25
2025-03-20,15:13:00,19845.25,SELL,1,0.02h,Stop Loss,$-6.00,$147.25,$183520.25,315,$147.25
2025-03-20,15:18:00,20031.0,BUY,1,0.02h,Stop Loss,$-6.00,$141.25,$183514.25,315,$141.25
2025-03-20,15:19:00,19834.25,SELL,1,0.02h,Stop Loss,$-6.00,$135.25,$183508.25,315,$135.25
2025-03-20,15:20:00,20026.5,BUY,1,0.02h,Stop Loss,$29.00,$164.25,$183537.25,315,$164.25
2025-03-20,15:26:00,19826.75,SELL,1,0.02h,Stop Loss,$24.00,$188.25,$183561.25,315,$188.25
2025-03-20,15:29:00,20027.0,BUY,1,0.02h,Stop Loss,$-6.00,$182.25,$183555.25,315,$182.25
2025-03-20,15:30:00,19828.0,SELL,1,0.02h,Stop Loss,$-6.00,$176.25,$183549.25,315,$176.25
2025-03-20,15:41:00,20018.5,BUY,1,0.02h,Break Even,$0.25,$176.50,$183549.50,315,$176.50
2025-03-20,15:44:00,19821.0,SELL,1,0.02h,Stop Loss,$9.00,$185.50,$183558.50,315,$185.50
2025-03-20,15:48:00,20046.5,BUY,1,0.02h,Stop Loss,$30.25,$215.75,$183588.75,315,$215.75
2025-03-20,15:50:00,19841.75,SELL,1,0.02h,Stop Loss,$-6.00,$209.75,$183582.75,315,$209.75
2025-03-20,15:51:00,20033.5,BUY,1,0.02h,Stop Loss,$70.25,$280.00,$183653.00,315,$280.00
2025-03-20,15:57:00,19810.5,SELL,1,0.02h,Stop Loss,$-6.00,$274.00,$183647.00,315,$274.00
2025-03-20,16:12:00,19955.25,BUY,1,0.02h,Break Even,$0.25,$274.25,$183647.25,315,$274.25
2025-03-20,16:15:00,19771.0,SELL,1,0.02h,Stop Loss,$-6.00,$268.25,$183641.25,315,$268.25
2025-03-20,16:16:00,19964.25,BUY,1,0.02h,Stop Loss,$31.50,$299.75,$183672.75,315,$299.75
2025-03-20,16:19:00,19765.5,SELL,1,0.02h,Stop Loss,$-6.00,$293.75,$183666.75,315,$293.75
2025-03-20,16:20:00,19964.0,BUY,1,0.02h,Stop Loss,$-6.00,$287.75,$183660.75,315,$287.75
2025-03-20,16:29:00,19682.0,SELL,1,0.02h,Stop Loss,$56.50,$344.25,$183717.25,315,$344.25
2025-03-20,16:40:00,19915.25,BUY,1,0.02h,Stop Loss,$-6.00,$338.25,$183711.25,315,$338.25
2025-03-20,16:46:00,19676.5,SELL,1,0.02h,Stop Loss,$-6.00,$332.25,$183705.25,315,$332.25
2025-03-20,17:12:00,19917.25,BUY,1,0.02h,Stop Loss,$55.25,$387.50,$183760.50,315,$387.50
2025-03-20,17:29:00,19637.75,SELL,1,0.02h,Stop Loss,$15.25,$402.75,$183775.75,315,$402.75
2025-03-20,17:35:00,19857.75,BUY,1,0.02h,Stop Loss,$34.00,$436.75,$183809.75,315,$436.75
2025-03-20,17:40:00,19679.5,SELL,1,0.02h,Stop Loss,$-6.00,$430.75,$183803.75,315,$430.75
2025-03-20,17:41:00,19870.75,BUY,1,0.02h,Stop Loss,$-6.00,$424.75,$183797.75,315,$424.75
2025-03-20,17:42:00,19671.25,SELL,1,0.02h,Stop Loss,$55.25,$480.00,$183853.00,315,$480.00
2025-03-20,17:49:00,19876.0,BUY,1,0.02h,Stop Loss,$-6.00,$474.00,$183847.00,315,$474.00
2025-03-20,17:50:00,19676.0,SELL,1,0.02h,Stop Loss,$30.25,$504.25,$183877.25,315,$504.25
2025-03-20,18:00:00,19848.25,BUY,1,0.02h,Stop Loss,$59.00,$563.25,$183936.25,315,$563.25
2025-03-20,18:12:00,19690.5,SELL,1,0.02h,Break Even,$0.25,$563.50,$183936.50,315,$563.50
2025-03-20,18:30:00,19807.75,BUY,1,0.02h,Stop Loss,$4.00,$567.50,$183940.50,315,$567.50
2025-03-20,18:38:00,19636.75,SELL,1,0.02h,Stop Loss,$24.00,$591.50,$183964.50,315,$591.50
2025-03-20,18:40:00,19835.0,BUY,1,0.02h,Stop Loss,$-6.00,$585.50,$183958.50,315,$585.50
2025-03-20,18:41:00,19632.25,SELL,1,0.02h,Stop Loss,$49.00,$634.50,$184007.50,315,$634.50
2025-03-20,18:50:00,19842.0,BUY,1,0.02h,Stop Loss,$-6.00,$628.50,$184001.50,315,$628.50
2025-03-20,19:04:00,19648.75,SELL,1,0.02h,Stop Loss,$-6.00,$622.50,$183995.50,315,$622.50
2025-03-20,19:05:00,19848.75,BUY,1,0.02h,Stop Loss,$64.00,$686.50,$184059.50,315,$686.50
2025-03-20,19:12:00,19660.5,SELL,1,0.02h,Stop Loss,$-6.00,$680.50,$184053.50,315,$680.50
2025-03-20,19:13:00,19863.0,BUY,1,0.02h,Stop Loss,$-6.00,$674.50,$184047.50,315,$674.50
2025-03-20,19:14:00,19656.25,SELL,1,0.02h,Stop Loss,$5.25,$679.75,$184052.75,315,$679.75
2025-03-20,19:23:00,19889.75,BUY,1,0.02h,Stop Loss,$27.75,$707.50,$184080.50,315,$707.50
2025-03-20,19:51:00,19690.0,SELL,1,0.02h,Stop Loss,$-6.00,$701.50,$184074.50,315,$701.50
2025-03-20,19:56:00,19903.0,BUY,1,0.02h,Break Even,$0.25,$701.75,$184074.75,315,$701.75
2025-03-20,19:58:00,19696.0,SELL,1,0.02h,Stop Loss,$-6.00,$695.75,$184068.75,315,$695.75
2025-03-20,19:59:00,19886.75,BUY,1,0.02h,Stop Loss,$6.50,$702.25,$184075.25,315,$702.25
2025-03-20,20:02:00,19703.0,SELL,1,0.02h,Stop Loss,$17.75,$720.00,$184093.00,315,$720.00
2025-03-20,20:06:00,19905.75,BUY,1,0.02h,Break Even,$0.25,$720.25,$184093.25,315,$720.25
2025-03-20,20:14:00,19706.75,SELL,1,0.02h,Stop Loss,$-6.00,$714.25,$184087.25,315,$714.25
2025-03-20,20:15:00,19905.25,BUY,1,0.02h,Break Even,$0.25,$714.50,$184087.50,315,$714.50
2025-03-20,20:18:00,19708.0,SELL,1,0.02h,Stop Loss,$-6.00,$708.50,$184081.50,315,$708.50
2025-03-20,20:32:00,19903.5,BUY,1,0.02h,Stop Loss,$-6.00,$702.50,$184075.50,315,$702.50
2025-03-20,20:41:00,19692.25,SELL,1,0.02h,Stop Loss,$-6.00,$696.50,$184069.50,315,$696.50
2025-03-20,20:45:00,19896.25,BUY,1,0.02h,Stop Loss,$-6.00,$690.50,$184063.50,315,$690.50
2025-03-20,20:46:00,19695.25,SELL,1,0.02h,Stop Loss,$-6.00,$684.50,$184057.50,315,$684.50
2025-03-20,20:47:00,19896.25,BUY,1,0.02h,Break Even,$0.25,$684.75,$184057.75,315,$684.75
2025-03-20,20:53:00,19700.0,SELL,1,0.02h,Stop Loss,$-6.00,$678.75,$184051.75,315,$678.75
2025-03-20,20:54:00,19898.0,BUY,1,0.02h,Stop Loss,$-6.00,$672.75,$184045.75,315,$672.75
2025-03-20,20:55:00,19698.25,SELL,1,0.02h,Stop Loss,$-6.00,$666.75,$184039.75,315,$666.75
2025-03-20,20:56:00,19898.75,BUY,1,0.02h,Stop Loss,$-6.00,$660.75,$184033.75,315,$660.75
2025-03-20,20:57:00,19697.0,SELL,1,0.02h,Stop Loss,$-6.00,$654.75,$184027.75,315,$654.75
2025-03-20,20:58:00,19898.5,BUY,1,0.02h,Stop Loss,$-6.00,$648.75,$184021.75,315,$648.75
2025-03-20,20:59:00,19695.75,SELL,1,0.02h,Stop Loss,$-6.00,$642.75,$184015.75,315,$642.75
2025-03-20,21:00:00,19894.25,BUY,1,1.02h,Stop Loss,$-6.00,$636.75,$184009.75,315,$636.75
2025-03-20,22:01:00,19693.5,SELL,1,0.02h,Stop Loss,$-6.00,$630.75,$184003.75,315,$630.75
2025-03-20,22:02:00,19899.5,BUY,1,0.02h,Stop Loss,$-6.00,$624.75,$183997.75,315,$624.75
2025-03-20,22:03:00,19694.0,SELL,1,0.02h,Stop Loss,$-6.00,$618.75,$183991.75,315,$618.75
2025-03-20,22:09:00,19886.5,BUY,1,0.02h,Break Even,$0.25,$619.00,$183992.00,315,$619.00
2025-03-20,22:15:00,19681.0,SELL,1,0.02h,Stop Loss,$-6.00,$613.00,$183986.00,315,$613.00
2025-03-20,22:18:00,19899.0,BUY,1,0.02h,Stop Loss,$-6.00,$607.00,$183980.00,315,$607.00
2025-03-20,22:19:00,19699.25,SELL,1,0.02h,Stop Loss,$-6.00,$601.00,$183974.00,315,$601.00
2025-03-20,22:20:00,19902.25,BUY,1,0.02h,Stop Loss,$-6.00,$595.00,$183968.00,315,$595.00
2025-03-20,22:21:00,19694.75,SELL,1,0.02h,Stop Loss,$-6.00,$589.00,$183962.00,315,$589.00
2025-03-20,22:22:00,19891.5,BUY,1,0.02h,Break Even,$0.25,$589.25,$183962.25,315,$589.25
2025-03-20,22:27:00,19690.5,SELL,1,0.02h,Stop Loss,$-6.00,$583.25,$183956.25,315,$583.25
2025-03-20,22:31:00,19899.5,BUY,1,0.02h,Stop Loss,$-6.00,$577.25,$183950.25,315,$577.25
2025-03-20,22:32:00,19692.0,SELL,1,0.02h,Stop Loss,$-6.00,$571.25,$183944.25,315,$571.25
2025-03-20,22:37:00,19905.5,BUY,1,0.02h,Stop Loss,$-6.00,$565.25,$183938.25,315,$565.25
2025-03-20,22:54:00,19687.25,SELL,1,0.02h,Break Even,$0.25,$565.50,$183938.50,315,$565.50
2025-03-20,22:58:00,19886.25,BUY,1,0.02h,Stop Loss,$-6.00,$559.50,$183932.50,315,$559.50
2025-03-20,22:59:00,19685.25,SELL,1,0.02h,Break Even,$0.25,$559.75,$183932.75,315,$559.75
Final P&L Day: 559.75,,,,,,,,,,,
2025-03-21,12:14:00,19822.25,BUY,1,0.02h,Stop Loss,$22.75,$22.75,$183955.50,316,$22.75
2025-03-21,12:16:00,19614.5,SELL,1,0.02h,Stop Loss,$-6.00,$16.75,$183949.50,316,$16.75
2025-03-21,12:17:00,19807.5,BUY,1,0.02h,Stop Loss,$5.25,$22.00,$183954.75,316,$22.00
2025-03-21,12:21:00,19599.5,SELL,1,0.02h,Stop Loss,$-6.00,$16.00,$183948.75,316,$16.00
2025-03-21,12:22:00,19802.25,BUY,1,0.02h,Break Even,$0.25,$16.25,$183949.00,316,$16.25
2025-03-21,12:25:00,19601.5,SELL,1,0.02h,Stop Loss,$-6.00,$10.25,$183943.00,316,$10.25
2025-03-21,12:27:00,19793.0,BUY,1,0.02h,Stop Loss,$-6.00,$4.25,$183937.00,316,$4.25
2025-03-21,12:28:00,19596.25,SELL,1,0.02h,Stop Loss,$10.25,$14.50,$183947.25,316,$14.50
2025-03-21,12:35:00,19774.0,BUY,1,0.02h,Stop Loss,$19.00,$33.50,$183966.25,316,$33.50
2025-03-21,12:37:00,19560.5,SELL,1,0.02h,Stop Loss,$96.50,$130.00,$184062.75,316,$130.00
2025-03-21,12:49:00,19711.75,BUY,1,0.02h,Stop Loss,$-6.00,$124.00,$184056.75,316,$124.00
2025-03-21,12:50:00,19511.75,SELL,1,0.02h,Stop Loss,$17.75,$141.75,$184074.50,316,$141.75
2025-03-21,12:59:00,19683.75,BUY,1,0.02h,Break Even,$0.25,$142.00,$184074.75,316,$142.00
2025-03-21,13:02:00,19477.75,SELL,1,0.02h,Stop Loss,$66.50,$208.50,$184141.25,316,$208.50
2025-03-21,13:10:00,19661.25,BUY,1,0.02h,Stop Loss,$25.25,$233.75,$184166.50,316,$233.75
2025-03-21,13:12:00,19459.5,SELL,1,0.02h,Stop Loss,$16.50,$250.25,$184183.00,316,$250.25
2025-03-21,13:18:00,19669.5,BUY,1,0.02h,Stop Loss,$-6.00,$244.25,$184177.00,316,$244.25
2025-03-21,13:19:00,19469.5,SELL,1,0.02h,Break Even,$0.25,$244.50,$184177.25,316,$244.50
2025-03-21,13:24:00,19638.5,BUY,1,0.02h,Stop Loss,$-6.00,$238.50,$184171.25,316,$238.50
2025-03-21,13:26:00,19436.25,SELL,1,0.02h,Stop Loss,$22.75,$261.25,$184194.00,316,$261.25
2025-03-21,13:32:00,19654.75,BUY,1,0.02h,Stop Loss,$-6.00,$255.25,$184188.00,316,$255.25
2025-03-21,14:12:00,19669.25,SELL,1,0.02h,Stop Loss,$-6.00,$249.25,$184182.00,316,$249.25
2025-03-21,14:15:00,19717.25,BUY,1,0.02h,Stop Loss,$42.75,$292.00,$184224.75,316,$292.00
2025-03-21,14:41:00,19728.75,SELL,1,0.02h,Stop Loss,$82.75,$374.75,$184307.50,316,$374.75
2025-03-21,14:47:00,19741.0,BUY,1,0.02h,Stop Loss,$10.25,$385.00,$184317.75,316,$385.00
2025-03-21,14:54:00,19730.75,SELL,1,0.02h,Stop Loss,$20.25,$405.25,$184338.00,316,$405.25
2025-03-21,14:55:00,19741.25,BUY,1,0.02h,Stop Loss,$26.50,$431.75,$184364.50,316,$431.75
2025-03-21,15:16:00,19733.75,SELL,1,0.02h,Stop Loss,$10.25,$442.00,$184374.75,316,$442.00
2025-03-21,15:57:00,19736.0,BUY,1,0.02h,Break Even,$0.25,$442.25,$184375.00,316,$442.25
2025-03-21,16:03:00,19700.5,SELL,1,0.02h,Stop Loss,$-6.00,$436.25,$184369.00,316,$436.25
2025-03-21,16:05:00,19727.0,BUY,1,0.02h,Stop Loss,$26.50,$462.75,$184395.50,316,$462.75
2025-03-21,17:14:00,19851.75,SELL,1,0.02h,Stop Loss,$25.25,$488.00,$184420.75,316,$488.00
2025-03-21,17:40:00,19855.75,BUY,1,0.02h,Stop Loss,$9.00,$497.00,$184429.75,316,$497.00
2025-03-21,18:07:00,19849.75,SELL,1,0.02h,Stop Loss,$-6.00,$491.00,$184423.75,316,$491.00
2025-03-21,18:38:00,19871.5,BUY,1,0.02h,Break Even,$0.25,$491.25,$184424.00,316,$491.25
2025-03-21,18:52:00,19851.5,SELL,1,0.02h,Stop Loss,$9.00,$500.25,$184433.00,316,$500.25
2025-03-21,18:57:00,19868.25,BUY,1,0.02h,Stop Loss,$19.00,$519.25,$184452.00,316,$519.25
2025-03-21,19:01:00,19849.25,SELL,1,0.02h,Stop Loss,$45.25,$564.50,$184497.25,316,$564.50
2025-03-21,19:30:00,19840.75,BUY,1,0.02h,Stop Loss,$15.25,$579.75,$184512.50,316,$579.75
2025-03-21,20:52:00,19958.25,SELL,1,0.02h,Break Even,$0.25,$580.00,$184512.75,316,$580.00
2025-03-21,20:56:00,19966.0,BUY,1,0.02h,Stop Loss,$15.25,$595.25,$184528.00,316,$595.25
Final P&L Day: 595.25,,,,,,,,,,,
2025-03-24,13:23:00,20275.0,SELL,1,0.02h,Stop Loss,$32.75,$32.75,$184560.75,317,$32.75
2025-03-24,13:40:00,20282.25,BUY,1,0.02h,Stop Loss,$20.25,$53.00,$184581.00,317,$53.00
2025-03-24,13:45:00,20238.25,SELL,1,0.02h,Stop Loss,$-6.00,$47.00,$184575.00,317,$47.00
2025-03-24,13:46:00,20276.0,BUY,1,0.02h,Stop Loss,$94.00,$141.00,$184669.00,317,$141.00
2025-03-24,14:10:00,20281.5,SELL,1,0.02h,Stop Loss,$-6.00,$135.00,$184663.00,317,$135.00
2025-03-24,14:15:00,20319.0,BUY,1,0.02h,Stop Loss,$35.25,$170.25,$184698.25,317,$170.25
2025-03-24,14:41:00,20327.25,SELL,1,0.02h,Break Even,$0.25,$170.50,$184698.50,317,$170.50
2025-03-24,14:42:00,20331.25,BUY,1,0.02h,Stop Loss,$15.25,$185.75,$184713.75,317,$185.75
2025-03-24,15:28:00,20351.75,SELL,1,0.02h,Stop Loss,$20.25,$206.00,$184734.00,317,$206.00
2025-03-24,15:55:00,20351.75,BUY,1,0.02h,Stop Loss,$10.25,$216.25,$184744.25,317,$216.25
2025-03-24,16:27:00,20343.0,SELL,1,0.02h,Stop Loss,$32.75,$249.00,$184777.00,317,$249.00
2025-03-24,16:49:00,20355.75,BUY,1,0.02h,Stop Loss,$-6.00,$243.00,$184771.00,317,$243.00
2025-03-24,16:57:00,20339.5,SELL,1,0.02h,Stop Loss,$6.50,$249.50,$184777.50,317,$249.50
2025-03-24,17:30:00,20337.5,BUY,1,0.02h,Stop Loss,$11.50,$261.00,$184789.00,317,$261.00
2025-03-24,17:56:00,20332.5,SELL,1,0.02h,Stop Loss,$10.25,$271.25,$184799.25,317,$271.25
2025-03-24,18:23:00,20329.25,BUY,1,0.02h,Break Even,$0.25,$271.50,$184799.50,317,$271.50
2025-03-24,18:33:00,20320.75,SELL,1,0.02h,Break Even,$0.25,$271.75,$184799.75,317,$271.75
2025-03-24,18:40:00,20346.5,BUY,1,0.02h,Stop Loss,$36.50,$308.25,$184836.25,317,$308.25
2025-03-24,19:27:00,20369.75,SELL,1,0.02h,Break Even,$0.25,$308.50,$184836.50,317,$308.50
2025-03-24,19:47:00,20376.0,BUY,1,0.02h,Stop Loss,$51.50,$360.00,$184888.00,317,$360.00
2025-03-24,20:02:00,20368.75,SELL,1,0.02h,Stop Loss,$7.75,$367.75,$184895.75,317,$367.75
2025-03-24,20:18:00,20375.5,BUY,1,0.02h,Stop Loss,$-6.00,$361.75,$184889.75,317,$361.75
2025-03-24,20:28:00,20368.25,SELL,1,0.02h,Break Even,$0.25,$362.00,$184890.00,317,$362.00
2025-03-24,22:37:00,20352.75,BUY,1,0.02h,Stop Loss,$-6.00,$356.00,$184884.00,317,$356.00
2025-03-24,22:50:00,20347.0,SELL,1,0.02h,Break Even,$0.25,$356.25,$184884.25,317,$356.25
Final P&L Day: 356.25,,,,,,,,,,,
2025-03-25,12:00:00,20411.75,BUY,1,0.02h,Stop Loss,$21.50,$21.50,$184905.75,318,$21.50
2025-03-25,12:51:00,20421.75,SELL,1,0.02h,Stop Loss,$29.00,$50.50,$184934.75,318,$50.50
2025-03-25,13:09:00,20425.5,BUY,1,0.02h,Break Even,$0.25,$50.75,$184935.00,318,$50.75
2025-03-25,13:28:00,20421.75,SELL,1,0.02h,Stop Loss,$97.75,$148.50,$185032.75,318,$148.50
2025-03-25,13:57:00,20410.5,BUY,1,0.02h,Stop Loss,$17.75,$166.25,$185050.50,318,$166.25
2025-03-25,14:03:00,20379.75,SELL,1,0.02h,Stop Loss,$27.75,$194.00,$185078.25,318,$194.00
2025-03-25,14:08:00,20413.0,BUY,1,0.02h,Stop Loss,$19.00,$213.00,$185097.25,318,$213.00
2025-03-25,15:17:00,20472.75,SELL,1,0.02h,Break Even,$0.25,$213.25,$185097.50,318,$213.25
2025-03-25,15:26:00,20486.25,BUY,1,0.02h,Stop Loss,$-6.00,$207.25,$185091.50,318,$207.25
2025-03-25,15:31:00,20471.75,SELL,1,0.02h,Stop Loss,$14.00,$221.25,$185105.50,318,$221.25
2025-03-25,16:44:00,20438.25,BUY,1,0.02h,Stop Loss,$16.50,$237.75,$185122.00,318,$237.75
2025-03-25,17:18:00,20446.5,SELL,1,0.02h,Stop Loss,$16.50,$254.25,$185138.50,318,$254.25
2025-03-25,18:11:00,20434.25,BUY,1,0.02h,Break Even,$0.25,$254.50,$185138.75,318,$254.50
2025-03-25,18:32:00,20428.5,SELL,1,0.02h,Stop Loss,$5.25,$259.75,$185144.00,318,$259.75
2025-03-25,18:59:00,20431.5,BUY,1,0.02h,Stop Loss,$-6.00,$253.75,$185138.00,318,$253.75
2025-03-25,19:17:00,20429.5,SELL,1,0.02h,Stop Loss,$-6.00,$247.75,$185132.00,318,$247.75
2025-03-25,19:20:00,20441.5,BUY,1,0.02h,Break Even,$0.25,$248.00,$185132.25,318,$248.00
2025-03-25,20:54:00,20515.75,SELL,1,0.02h,Stop Loss,$-6.00,$242.00,$185126.25,318,$242.00
2025-03-25,22:10:00,20519.25,BUY,1,0.02h,Stop Loss,$35.25,$277.25,$185161.50,318,$277.25
2025-03-25,22:21:00,20514.5,SELL,1,0.02h,Stop Loss,$-6.00,$271.25,$185155.50,318,$271.25
2025-03-25,22:54:00,20512.25,BUY,1,0.02h,Break Even,$0.25,$271.50,$185155.75,318,$271.50
2025-03-25,22:59:00,20509.5,SELL,1,0.02h,Break Even,$0.25,$271.75,$185156.00,318,$271.75
Final P&L Day: 271.75,,,,,,,,,,,
2025-03-26,12:47:00,20468.5,BUY,1,0.02h,Stop Loss,$15.25,$15.25,$185171.25,319,$15.25
2025-03-26,13:15:00,20473.5,SELL,1,0.02h,Break Even,$0.25,$15.50,$185171.50,319,$15.50
2025-03-26,13:40:00,20458.25,BUY,1,0.02h,Stop Loss,$55.25,$70.75,$185226.75,319,$70.75
2025-03-26,13:43:00,20439.25,SELL,1,0.02h,Stop Loss,$54.00,$124.75,$185280.75,319,$124.75
2025-03-26,14:42:00,20291.75,BUY,1,0.02h,Stop Loss,$-6.00,$118.75,$185274.75,319,$118.75
2025-03-26,14:43:00,20280.75,SELL,1,0.02h,Break Even,$0.25,$119.00,$185275.00,319,$119.00
2025-03-26,14:54:00,20310.5,BUY,1,0.02h,Stop Loss,$-6.00,$113.00,$185269.00,319,$113.00
2025-03-26,15:25:00,20288.25,SELL,1,0.02h,Stop Loss,$85.25,$198.25,$185354.25,319,$198.25
2025-03-26,16:30:00,20205.0,BUY,1,0.02h,Stop Loss,$47.75,$246.00,$185402.00,319,$246.00
2025-03-26,16:43:00,20189.5,SELL,1,0.02h,Stop Loss,$40.25,$286.25,$185442.25,319,$286.25
2025-03-26,18:11:00,20109.5,BUY,1,0.02h,Stop Loss,$30.25,$316.50,$185472.50,319,$316.50
2025-03-26,18:37:00,20115.0,SELL,1,0.02h,Stop Loss,$4.00,$320.50,$185476.50,319,$320.50
2025-03-26,19:19:00,20079.0,BUY,1,0.02h,Stop Loss,$51.50,$372.00,$185528.00,319,$372.00
2025-03-26,19:32:00,20065.25,SELL,1,0.02h,Stop Loss,$-6.00,$366.00,$185522.00,319,$366.00
2025-03-26,19:36:00,20079.75,BUY,1,0.02h,Break Even,$0.25,$366.25,$185522.25,319,$366.25
2025-03-26,20:18:00,20105.75,SELL,1,0.02h,Stop Loss,$-6.00,$360.25,$185516.25,319,$360.25
2025-03-26,20:50:00,20099.5,BUY,1,0.02h,Stop Loss,$-6.00,$354.25,$185510.25,319,$354.25
2025-03-26,20:53:00,20093.75,SELL,1,0.02h,Stop Loss,$16.50,$370.75,$185526.75,319,$370.75
Final P&L Day: 370.75,,,,,,,,,,,
2025-03-27,12:00:00,20088.75,BUY,1,0.02h,Break Even,$0.25,$0.25,$185527.00,320,$0.25
2025-03-27,12:27:00,20056.0,SELL,1,0.02h,Stop Loss,$19.00,$19.25,$185546.00,320,$19.25
2025-03-27,12:31:00,20082.25,BUY,1,0.02h,Stop Loss,$67.75,$87.00,$185613.75,320,$87.00
2025-03-27,12:49:00,20065.25,SELL,1,0.02h,Stop Loss,$5.25,$92.25,$185619.00,320,$92.25
2025-03-27,13:08:00,20080.75,BUY,1,0.02h,Stop Loss,$-6.00,$86.25,$185613.00,320,$86.25
2025-03-27,13:11:00,20067.5,SELL,1,0.02h,Stop Loss,$10.25,$96.50,$185623.25,320,$96.50
2025-03-27,13:51:00,20028.25,BUY,1,0.02h,Stop Loss,$34.00,$130.50,$185657.25,320,$130.50
2025-03-27,14:24:00,20050.0,SELL,1,0.02h,Break Even,$0.25,$130.75,$185657.50,320,$130.75
2025-03-27,14:26:00,20080.25,BUY,1,0.02h,Stop Loss,$9.00,$139.75,$185666.50,320,$139.75
2025-03-27,15:14:00,20157.75,SELL,1,0.02h,Stop Loss,$-6.00,$133.75,$185660.50,320,$133.75
2025-03-27,16:08:00,20085.75,BUY,1,0.02h,Break Even,$0.25,$134.00,$185660.75,320,$134.00
2025-03-27,16:30:00,20079.5,SELL,1,0.02h,Break Even,$0.25,$134.25,$185661.00,320,$134.25
2025-03-27,17:13:00,20049.75,BUY,1,0.02h,Stop Loss,$26.50,$160.75,$185687.50,320,$160.75
2025-03-27,17:26:00,20034.25,SELL,1,0.02h,Stop Loss,$12.75,$173.50,$185700.25,320,$173.50
2025-03-27,17:48:00,20050.75,BUY,1,0.02h,Stop Loss,$-6.00,$167.50,$185694.25,320,$167.50
2025-03-27,17:55:00,20011.0,SELL,1,0.02h,Break Even,$0.25,$167.75,$185694.50,320,$167.75
2025-03-27,18:05:00,20042.5,BUY,1,0.02h,Stop Loss,$34.00,$201.75,$185728.50,320,$201.75
2025-03-27,18:34:00,20058.5,SELL,1,0.02h,Break Even,$0.25,$202.00,$185728.75,320,$202.00
2025-03-27,18:35:00,20065.0,BUY,1,0.02h,Stop Loss,$21.50,$223.50,$185750.25,320,$223.50
2025-03-27,18:58:00,20061.0,SELL,1,0.02h,Stop Loss,$16.50,$240.00,$185766.75,320,$240.00
2025-03-27,19:15:00,20096.75,BUY,1,0.02h,Stop Loss,$34.00,$274.00,$185800.75,320,$274.00
2025-03-27,19:34:00,20073.25,SELL,1,0.02h,Stop Loss,$12.75,$286.75,$185813.50,320,$286.75
2025-03-27,20:35:00,20004.25,BUY,1,0.02h,Break Even,$0.25,$287.00,$185813.75,320,$287.00
2025-03-27,20:57:00,20004.0,SELL,1,0.02h,Break Even,$0.25,$287.25,$185814.00,320,$287.25
2025-03-27,22:25:00,19997.0,BUY,1,0.02h,Stop Loss,$-6.00,$281.25,$185808.00,320,$281.25
2025-03-27,22:30:00,19993.25,SELL,1,0.02h,Stop Loss,$-6.00,$275.25,$185802.00,320,$275.25
2025-03-27,22:31:00,19997.5,BUY,1,0.02h,Stop Loss,$-6.00,$269.25,$185796.00,320,$269.25
2025-03-27,22:32:00,19995.0,SELL,1,0.02h,Stop Loss,$-6.00,$263.25,$185790.00,320,$263.25
2025-03-27,22:33:00,19998.5,BUY,1,0.02h,Break Even,$0.25,$263.50,$185790.25,320,$263.50
2025-03-27,22:35:00,19992.75,SELL,1,0.02h,Stop Loss,$-6.00,$257.50,$185784.25,320,$257.50
2025-03-27,22:36:00,19997.75,BUY,1,0.02h,Stop Loss,$12.75,$270.25,$185797.00,320,$270.25
2025-03-27,22:52:00,19997.5,SELL,1,0.02h,Stop Loss,$6.50,$276.75,$185803.50,320,$276.75
Final P&L Day: 276.75,,,,,,,,,,,
2025-03-28,13:11:00,19893.75,BUY,1,0.02h,Stop Loss,$80.25,$80.25,$185883.75,321,$80.25
2025-03-28,13:31:00,19889.0,SELL,1,0.02h,Stop Loss,$139.00,$219.25,$186022.75,321,$219.25
2025-03-28,13:43:00,19934.5,BUY,1,0.02h,Stop Loss,$17.75,$237.00,$186040.50,321,$237.00
2025-03-28,13:45:00,19881.75,SELL,1,0.02h,Stop Loss,$22.75,$259.75,$186063.25,321,$259.75
2025-03-28,13:50:00,19909.0,BUY,1,0.02h,Stop Loss,$54.00,$313.75,$186117.25,321,$313.75
2025-03-28,13:52:00,19883.5,SELL,1,0.02h,Stop Loss,$109.00,$422.75,$186226.25,321,$422.75
2025-03-28,15:15:00,19608.5,BUY,1,0.02h,Stop Loss,$17.75,$440.50,$186244.00,321,$440.50
2025-03-28,15:20:00,19587.75,SELL,1,0.02h,Stop Loss,$11.50,$452.00,$186255.50,321,$452.00
2025-03-28,15:31:00,19594.5,BUY,1,0.02h,Stop Loss,$82.75,$534.75,$186338.25,321,$534.75
2025-03-28,15:46:00,19598.75,SELL,1,0.02h,Stop Loss,$11.50,$546.25,$186349.75,321,$546.25
2025-03-28,16:52:00,19525.75,BUY,1,0.02h,Stop Loss,$20.25,$566.50,$186370.00,321,$566.50
2025-03-28,16:57:00,19501.0,SELL,1,0.02h,Stop Loss,$11.50,$578.00,$186381.50,321,$578.00
2025-03-28,17:44:00,19472.75,BUY,1,0.02h,Stop Loss,$-6.00,$572.00,$186375.50,321,$572.00
2025-03-28,17:45:00,19456.5,SELL,1,0.02h,Stop Loss,$5.25,$577.25,$186380.75,321,$577.25
2025-03-28,17:47:00,19464.75,BUY,1,0.02h,Stop Loss,$41.50,$618.75,$186422.25,321,$618.75
2025-03-28,17:52:00,19449.5,SELL,1,0.02h,Stop Loss,$-6.00,$612.75,$186416.25,321,$612.75
2025-03-28,17:58:00,19478.0,BUY,1,0.02h,Stop Loss,$-6.00,$606.75,$186410.25,321,$606.75
2025-03-28,18:24:00,19473.5,SELL,1,0.02h,Stop Loss,$16.50,$623.25,$186426.75,321,$623.25
2025-03-28,18:35:00,19485.75,BUY,1,0.02h,Stop Loss,$7.75,$631.00,$186434.50,321,$631.00
2025-03-28,18:36:00,19477.75,SELL,1,0.02h,Stop Loss,$26.50,$657.50,$186461.00,321,$657.50
2025-03-28,18:58:00,19477.0,BUY,1,0.02h,Break Even,$0.25,$657.75,$186461.25,321,$657.75
2025-03-28,19:17:00,19471.75,SELL,1,0.02h,Stop Loss,$34.00,$691.75,$186495.25,321,$691.75
2025-03-28,19:55:00,19470.5,BUY,1,0.02h,Stop Loss,$32.75,$724.50,$186528.00,321,$724.50
2025-03-28,20:06:00,19438.75,SELL,1,0.02h,Break Even,$0.25,$724.75,$186528.25,321,$724.75
Final P&L Day: 724.75,,,,,,,,,,,
2025-03-31,12:35:00,19197.5,BUY,1,0.02h,Stop Loss,$4.00,$4.00,$186532.25,322,$4.00
2025-03-31,13:15:00,19208.5,SELL,1,0.02h,Stop Loss,$15.25,$19.25,$186547.50,322,$19.25
2025-03-31,13:57:00,19099.25,BUY,1,0.02h,Stop Loss,$125.25,$144.50,$186672.75,322,$144.50
2025-03-31,14:20:00,19095.75,SELL,1,0.02h,Stop Loss,$-6.00,$138.50,$186666.75,322,$138.50
2025-03-31,14:35:00,19157.25,BUY,1,0.02h,Stop Loss,$25.25,$163.75,$186692.00,322,$163.75
2025-03-31,15:15:00,19121.0,SELL,1,0.02h,Stop Loss,$20.25,$184.00,$186712.25,322,$184.00
2025-03-31,15:18:00,19150.25,BUY,1,0.02h,Stop Loss,$27.75,$211.75,$186740.00,322,$211.75
2025-03-31,16:07:00,19214.75,SELL,1,0.02h,Stop Loss,$39.00,$250.75,$186779.00,322,$250.75
2025-03-31,16:23:00,19229.75,BUY,1,0.02h,Break Even,$0.25,$251.00,$186779.25,322,$251.00
2025-03-31,16:49:00,19246.0,SELL,1,0.02h,Break Even,$0.25,$251.25,$186779.50,322,$251.25
2025-03-31,16:55:00,19264.5,BUY,1,0.02h,Stop Loss,$-6.00,$245.25,$186773.50,322,$245.25
2025-03-31,16:56:00,19249.25,SELL,1,0.02h,Stop Loss,$86.50,$331.75,$186860.00,322,$331.75
2025-03-31,17:07:00,19261.5,BUY,1,0.02h,Stop Loss,$55.25,$387.00,$186915.25,322,$387.00
2025-03-31,17:21:00,19241.0,SELL,1,0.02h,Stop Loss,$59.00,$446.00,$186974.25,322,$446.00
2025-03-31,17:39:00,19266.0,BUY,1,0.02h,Stop Loss,$10.25,$456.25,$186984.50,322,$456.25
2025-03-31,17:44:00,19225.75,SELL,1,0.02h,Stop Loss,$20.25,$476.50,$187004.75,322,$476.50
2025-03-31,17:54:00,19259.25,BUY,1,0.02h,Stop Loss,$27.75,$504.25,$187032.50,322,$504.25
2025-03-31,17:59:00,19227.0,SELL,1,0.02h,Stop Loss,$21.50,$525.75,$187054.00,322,$525.75
2025-03-31,18:02:00,19262.5,BUY,1,0.02h,Stop Loss,$46.50,$572.25,$187100.50,322,$572.25
2025-03-31,18:49:00,19361.25,SELL,1,0.02h,Stop Loss,$5.25,$577.50,$187105.75,322,$577.50
2025-03-31,18:51:00,19396.75,BUY,1,0.02h,Break Even,$0.25,$577.75,$187106.00,322,$577.75
2025-03-31,19:00:00,19348.25,SELL,1,0.02h,Break Even,$0.25,$578.00,$187106.25,322,$578.00
2025-03-31,19:06:00,19387.0,BUY,1,0.02h,Stop Loss,$72.75,$650.75,$187179.00,322,$650.75
2025-03-31,19:29:00,19371.0,SELL,1,0.02h,Stop Loss,$56.50,$707.25,$187235.50,322,$707.25
2025-03-31,19:36:00,19422.5,BUY,1,0.02h,Break Even,$0.25,$707.50,$187235.75,322,$707.50
2025-03-31,20:03:00,19409.5,SELL,1,0.02h,Stop Loss,$7.75,$715.25,$187243.50,322,$715.25
2025-03-31,20:18:00,19429.5,BUY,1,0.02h,Stop Loss,$-6.00,$709.25,$187237.50,322,$709.25
2025-03-31,20:24:00,19421.0,SELL,1,0.02h,Break Even,$0.25,$709.50,$187237.75,322,$709.50
2025-03-31,20:45:00,19424.0,BUY,1,0.02h,Stop Loss,$-6.00,$703.50,$187231.75,322,$703.50
2025-03-31,20:51:00,19413.75,SELL,1,0.03h,Stop Loss,$-6.00,$697.50,$187225.75,322,$697.50
2025-03-31,22:37:00,19370.0,BUY,1,0.02h,Break Even,$0.25,$697.75,$187226.00,322,$697.75
Final P&L Day: 697.75,,,,,,,,,,,
2025-04-01,12:00:00,19354.5,SELL,1,0.02h,Stop Loss,$21.50,$21.50,$187247.50,323,$21.50
2025-04-01,12:12:00,19371.5,BUY,1,0.02h,Break Even,$0.25,$21.75,$187247.75,323,$21.75
2025-04-01,12:13:00,19356.0,SELL,1,0.02h,Stop Loss,$4.00,$25.75,$187251.75,323,$25.75
2025-04-01,12:17:00,19379.0,BUY,1,0.02h,Stop Loss,$-6.00,$19.75,$187245.75,323,$19.75
2025-04-01,12:20:00,19362.25,SELL,1,0.02h,Stop Loss,$15.25,$35.00,$187261.00,323,$35.00
2025-04-01,12:33:00,19372.5,BUY,1,0.02h,Stop Loss,$7.75,$42.75,$187268.75,323,$42.75
2025-04-01,13:29:00,19383.25,SELL,1,0.02h,Stop Loss,$42.75,$85.50,$187311.50,323,$85.50
2025-04-01,13:45:00,19400.75,BUY,1,0.02h,Stop Loss,$69.00,$154.50,$187380.50,323,$154.50
2025-04-01,14:00:00,19367.5,SELL,1,0.02h,Stop Loss,$-6.00,$148.50,$187374.50,323,$148.50
2025-04-01,14:31:00,19352.5,BUY,1,0.02h,Stop Loss,$66.50,$215.00,$187441.00,323,$215.00
2025-04-01,15:37:00,19558.0,SELL,1,0.02h,Stop Loss,$81.50,$296.50,$187522.50,323,$296.50
2025-04-01,15:46:00,19585.0,BUY,1,0.02h,Stop Loss,$47.75,$344.25,$187570.25,323,$344.25
2025-04-01,16:27:00,19570.75,SELL,1,0.02h,Stop Loss,$35.25,$379.50,$187605.50,323,$379.50
2025-04-01,16:53:00,19576.75,BUY,1,0.02h,Stop Loss,$71.50,$451.00,$187677.00,323,$451.00
2025-04-01,17:07:00,19535.0,SELL,1,0.02h,Stop Loss,$6.50,$457.50,$187683.50,323,$457.50
2025-04-01,17:41:00,19560.25,BUY,1,0.02h,Stop Loss,$39.00,$496.50,$187722.50,323,$496.50
2025-04-01,17:56:00,19517.75,SELL,1,0.02h,Break Even,$0.25,$496.75,$187722.75,323,$496.75
2025-04-01,18:45:00,19432.5,BUY,1,0.02h,Stop Loss,$-6.00,$490.75,$187716.75,323,$490.75
2025-04-01,18:48:00,19408.75,SELL,1,0.02h,Stop Loss,$15.25,$506.00,$187732.00,323,$506.00
2025-04-01,18:56:00,19440.25,BUY,1,0.02h,Stop Loss,$27.75,$533.75,$187759.75,323,$533.75
2025-04-01,20:26:00,19594.0,SELL,1,0.02h,Stop Loss,$5.25,$539.00,$187765.00,323,$539.00
2025-04-01,20:47:00,19597.5,BUY,1,0.02h,Stop Loss,$145.25,$684.25,$187910.25,323,$684.25
2025-04-01,22:35:00,19645.25,SELL,1,0.02h,Stop Loss,$5.25,$689.50,$187915.50,323,$689.50
2025-04-01,22:41:00,19660.5,BUY,1,0.02h,Stop Loss,$-6.00,$683.50,$187909.50,323,$683.50
2025-04-01,22:50:00,19652.25,SELL,1,0.02h,Stop Loss,$-6.00,$677.50,$187903.50,323,$677.50
2025-04-01,22:51:00,19656.0,BUY,1,0.02h,Stop Loss,$-6.00,$671.50,$187897.50,323,$671.50
2025-04-01,22:52:00,19650.5,SELL,1,0.02h,Stop Loss,$7.75,$679.25,$187905.25,323,$679.25
Final P&L Day: 679.25,,,,,,,,,,,
2025-04-02,12:49:00,19393.5,BUY,1,0.02h,Stop Loss,$-6.00,$-6.00,$187899.25,324,$-6.00
2025-04-02,13:03:00,19367.25,SELL,1,0.02h,Stop Loss,$56.50,$50.50,$187955.75,324,$50.50
2025-04-02,13:34:00,19394.5,BUY,1,0.02h,Stop Loss,$107.75,$158.25,$188063.50,324,$158.25
2025-04-02,14:12:00,19517.75,SELL,1,0.02h,Stop Loss,$26.50,$184.75,$188090.00,324,$184.75
2025-04-02,14:19:00,19568.75,BUY,1,0.02h,Stop Loss,$-6.00,$178.75,$188084.00,324,$178.75
2025-04-02,15:15:00,19584.5,SELL,1,0.02h,Stop Loss,$6.50,$185.25,$188090.50,324,$185.25
2025-04-02,15:21:00,19650.25,BUY,1,0.02h,Stop Loss,$67.75,$253.00,$188158.25,324,$253.00
2025-04-02,15:47:00,19655.0,SELL,1,0.02h,Stop Loss,$80.25,$333.25,$188238.50,324,$333.25
2025-04-02,16:02:00,19673.25,BUY,1,0.02h,Stop Loss,$51.50,$384.75,$188290.00,324,$384.75
2025-04-02,17:30:00,19832.25,SELL,1,0.02h,Stop Loss,$42.75,$427.50,$188332.75,324,$427.50
2025-04-02,18:39:00,19693.0,BUY,1,0.02h,Stop Loss,$17.75,$445.25,$188350.50,324,$445.25
2025-04-02,18:55:00,19674.75,SELL,1,0.02h,Stop Loss,$44.00,$489.25,$188394.50,324,$489.25
2025-04-02,19:10:00,19665.5,BUY,1,0.02h,Break Even,$0.25,$489.50,$188394.75,324,$489.50
2025-04-02,19:11:00,19661.5,SELL,1,0.02h,Stop Loss,$70.25,$559.75,$188465.00,324,$559.75
2025-04-02,19:27:00,19670.25,BUY,1,0.02h,Stop Loss,$51.50,$611.25,$188516.50,324,$611.25
2025-04-02,20:08:00,19740.25,SELL,1,0.02h,Stop Loss,$85.25,$696.50,$188601.75,324,$696.50
2025-04-02,20:14:00,19925.25,BUY,1,0.02h,Stop Loss,$271.50,$968.00,$188873.25,324,$968.00
2025-04-02,20:28:00,19606.0,SELL,1,0.02h,Stop Loss,$764.00,$1732.00,$189637.25,324,$1732.00
2025-04-02,22:37:00,18940.0,BUY,1,0.02h,Stop Loss,$141.50,$1873.50,$189778.75,324,$1873.50
2025-04-02,22:45:00,18907.0,SELL,1,0.02h,Stop Loss,$25.25,$1898.75,$189804.00,324,$1898.75
2025-04-02,22:49:00,18929.0,BUY,1,0.02h,Stop Loss,$14.00,$1912.75,$189818.00,324,$1912.75
Final P&L Day: 1912.75,,,,,,,,,,,
2025-04-03,12:26:00,18994.5,SELL,1,0.02h,Stop Loss,$4.00,$4.00,$189822.00,325,$4.00
2025-04-03,13:15:00,18882.0,BUY,1,0.02h,Stop Loss,$27.75,$31.75,$189849.75,325,$31.75
2025-04-03,13:22:00,18864.75,SELL,1,0.02h,Stop Loss,$-6.00,$25.75,$189843.75,325,$25.75
2025-04-03,13:26:00,18905.5,BUY,1,0.02h,Stop Loss,$37.75,$63.50,$189881.50,325,$63.50
2025-04-03,14:02:00,18978.25,SELL,1,0.02h,Stop Loss,$64.00,$127.50,$189945.50,325,$127.50
2025-04-03,14:31:00,18929.25,BUY,1,0.02h,Stop Loss,$10.25,$137.75,$189955.75,325,$137.75
2025-04-03,14:35:00,18893.0,SELL,1,0.02h,Stop Loss,$41.50,$179.25,$189997.25,325,$179.25
2025-04-03,15:15:00,18797.75,BUY,1,0.02h,Stop Loss,$159.00,$338.25,$190156.25,325,$338.25
2025-04-03,15:53:00,18844.0,SELL,1,0.02h,Stop Loss,$12.75,$351.00,$190169.00,325,$351.00
2025-04-03,15:55:00,18893.25,BUY,1,0.02h,Stop Loss,$44.00,$395.00,$190213.00,325,$395.00
2025-04-03,16:35:00,18902.25,SELL,1,0.02h,Stop Loss,$10.25,$405.25,$190223.25,325,$405.25
2025-04-03,16:44:00,18958.5,BUY,1,0.02h,Stop Loss,$10.25,$415.50,$190233.50,325,$415.50
2025-04-03,16:45:00,18916.0,SELL,1,0.02h,Stop Loss,$29.00,$444.50,$190262.50,325,$444.50
2025-04-03,17:38:00,18876.5,BUY,1,0.02h,Stop Loss,$81.50,$526.00,$190344.00,325,$526.00
2025-04-03,17:52:00,18846.5,SELL,1,0.02h,Break Even,$0.25,$526.25,$190344.25,325,$526.25
2025-04-03,18:38:00,18803.25,BUY,1,0.02h,Stop Loss,$34.00,$560.25,$190378.25,325,$560.25
2025-04-03,19:12:00,18817.0,SELL,1,0.02h,Break Even,$0.25,$560.50,$190378.50,325,$560.50
2025-04-03,20:56:00,18650.0,BUY,1,0.02h,Break Even,$0.25,$560.75,$190378.75,325,$560.75
2025-04-03,22:15:00,18652.75,SELL,1,0.02h,Break Even,$0.25,$561.00,$190379.00,325,$561.00
2025-04-03,22:16:00,18669.5,BUY,1,0.02h,Stop Loss,$-6.00,$555.00,$190373.00,325,$555.00
2025-04-03,22:18:00,18651.25,SELL,1,0.02h,Stop Loss,$30.25,$585.25,$190403.25,325,$585.25
2025-04-03,22:42:00,18642.5,BUY,1,0.02h,Break Even,$0.25,$585.50,$190403.50,325,$585.50
Final P&L Day: 585.50,,,,,,,,,,,
2025-04-04,12:00:00,18127.75,SELL,1,0.02h,Stop Loss,$167.75,$167.75,$190571.25,326,$167.75
2025-04-04,12:34:00,18226.25,BUY,1,0.02h,Break Even,$0.25,$168.00,$190571.50,326,$168.00
2025-04-04,12:39:00,18072.0,SELL,1,0.02h,Stop Loss,$51.50,$219.50,$190623.00,326,$219.50
2025-04-04,12:45:00,18200.0,BUY,1,0.02h,Stop Loss,$30.25,$249.75,$190653.25,326,$249.75
2025-04-04,13:16:00,18189.75,SELL,1,0.02h,Stop Loss,$179.00,$428.75,$190832.25,326,$428.75
2025-04-04,13:53:00,18144.5,BUY,1,0.02h,Stop Loss,$241.50,$670.25,$191073.75,326,$670.25
2025-04-04,13:56:00,18080.0,SELL,1,0.02h,Stop Loss,$49.00,$719.25,$191122.75,326,$719.25
2025-04-04,13:57:00,18143.5,BUY,1,0.02h,Stop Loss,$261.50,$980.75,$191384.25,326,$980.75
2025-04-04,14:08:00,18099.0,SELL,1,0.02h,Stop Loss,$150.25,$1131.00,$191534.50,326,$1131.00
2025-04-04,15:01:00,17876.25,BUY,1,0.02h,Stop Loss,$576.50,$1707.50,$192111.00,326,$1707.50
2025-04-04,15:29:00,17994.0,SELL,1,0.02h,Stop Loss,$294.00,$2001.50,$192405.00,326,$2001.50
2025-04-04,15:50:00,18001.0,BUY,1,0.02h,Break Even,$0.25,$2001.75,$192405.25,326,$2001.75
2025-04-04,15:59:00,17889.75,SELL,1,0.02h,Stop Loss,$62.75,$2064.50,$192468.00,326,$2064.50
2025-04-04,16:42:00,17823.25,BUY,1,0.02h,Stop Loss,$55.25,$2119.75,$192523.25,326,$2119.75
2025-04-04,16:45:00,17755.75,SELL,1,0.02h,Stop Loss,$67.75,$2187.50,$192591.00,326,$2187.50
2025-04-04,17:03:00,17803.25,BUY,1,0.02h,Stop Loss,$14.00,$2201.50,$192605.00,326,$2201.50
2025-04-04,17:07:00,17732.75,SELL,1,0.02h,Break Even,$0.25,$2201.75,$192605.25,326,$2201.75
2025-04-04,17:27:00,17735.25,BUY,1,0.02h,Stop Loss,$46.50,$2248.25,$192651.75,326,$2248.25
2025-04-04,17:32:00,17675.25,SELL,1,0.02h,Stop Loss,$20.25,$2268.50,$192672.00,326,$2268.50
2025-04-04,17:34:00,17725.75,BUY,1,0.02h,Stop Loss,$159.00,$2427.50,$192831.00,326,$2427.50
2025-04-04,18:11:00,17797.25,SELL,1,0.02h,Stop Loss,$114.00,$2541.50,$192945.00,326,$2541.50
2025-04-04,18:53:00,17665.0,BUY,1,0.02h,Stop Loss,$52.75,$2594.25,$192997.75,326,$2594.25
2025-04-04,19:01:00,17617.75,SELL,1,0.02h,Stop Loss,$157.75,$2752.00,$193155.50,326,$2752.00
2025-04-04,19:12:00,17661.75,BUY,1,0.02h,Stop Loss,$160.25,$2912.25,$193315.75,326,$2912.25
2025-04-04,19:49:00,17720.75,SELL,1,0.02h,Stop Loss,$75.25,$2987.50,$193391.00,326,$2987.50
2025-04-04,20:40:00,17484.0,BUY,1,0.02h,Stop Loss,$21.50,$3009.00,$193412.50,326,$3009.00
Final P&L Day: 3009.00,,,,,,,,,,,
2025-04-07,12:00:00,17063.75,SELL,1,0.02h,Break Even,$0.25,$0.25,$193412.75,327,$0.25
2025-04-07,12:30:00,17179.5,BUY,1,0.02h,Stop Loss,$247.75,$248.00,$193660.50,327,$248.00
2025-04-07,12:46:00,17013.75,SELL,1,0.02h,Stop Loss,$10.25,$258.25,$193670.75,327,$258.25
2025-04-07,12:53:00,17150.5,BUY,1,0.02h,Stop Loss,$147.75,$406.00,$193818.50,327,$406.00
2025-04-07,13:06:00,17114.25,SELL,1,0.02h,Stop Loss,$291.50,$697.50,$194110.00,327,$697.50
2025-04-07,13:51:00,16978.25,BUY,1,0.02h,Stop Loss,$235.25,$932.75,$194345.25,327,$932.75
2025-04-07,14:29:00,17392.5,SELL,1,0.02h,Stop Loss,$246.50,$1179.25,$194591.75,327,$1179.25
2025-04-07,14:51:00,17598.75,BUY,1,0.02h,Stop Loss,$37.75,$1217.00,$194629.50,327,$1217.00
2025-04-07,15:11:00,17551.25,SELL,1,0.02h,Stop Loss,$124.00,$1341.00,$194753.50,327,$1341.00
2025-04-07,15:39:00,17426.5,BUY,1,0.02h,Stop Loss,$9.00,$1350.00,$194762.50,327,$1350.00
2025-04-07,16:00:00,17390.75,SELL,1,0.02h,Stop Loss,$301.50,$1651.50,$195064.00,327,$1651.50
2025-04-07,16:27:00,17427.5,BUY,1,0.02h,Stop Loss,$14.00,$1665.50,$195078.00,327,$1665.50
2025-04-07,16:44:00,17327.75,SELL,1,0.02h,Stop Loss,$95.25,$1760.75,$195173.25,327,$1760.75
2025-04-07,17:02:00,17453.5,BUY,1,0.02h,Stop Loss,$4.00,$1764.75,$195177.25,327,$1764.75
2025-04-07,17:07:00,17297.25,SELL,1,0.02h,Stop Loss,$240.25,$2005.00,$195417.50,327,$2005.00
2025-04-07,17:13:00,17386.0,BUY,1,0.02h,Stop Loss,$151.50,$2156.50,$195569.00,327,$2156.50
2025-04-07,18:12:00,17680.0,SELL,1,0.02h,Stop Loss,$317.75,$2474.25,$195886.75,327,$2474.25
2025-04-07,18:19:00,17795.25,BUY,1,0.02h,Stop Loss,$35.25,$2509.50,$195922.00,327,$2509.50
2025-04-07,18:28:00,17652.5,SELL,1,0.02h,Stop Loss,$232.75,$2742.25,$196154.75,327,$2742.25
2025-04-07,18:40:00,17713.25,BUY,1,0.02h,Stop Loss,$145.25,$2887.50,$196300.00,327,$2887.50
2025-04-07,18:46:00,17653.5,SELL,1,0.02h,Stop Loss,$29.00,$2916.50,$196329.00,327,$2916.50
2025-04-07,19:34:00,17608.5,BUY,1,0.02h,Stop Loss,$142.75,$3059.25,$196471.75,327,$3059.25
2025-04-07,19:45:00,17461.5,SELL,1,0.02h,Stop Loss,$21.50,$3080.75,$196493.25,327,$3080.75
2025-04-07,19:58:00,17539.5,BUY,1,0.02h,Stop Loss,$117.75,$3198.50,$196611.00,327,$3198.50
2025-04-07,20:28:00,17652.25,SELL,1,0.02h,Stop Loss,$-6.00,$3192.50,$196605.00,327,$3192.50
2025-04-07,22:02:00,17682.0,BUY,1,0.02h,Stop Loss,$10.25,$3202.75,$196615.25,327,$3202.75
Final P&L Day: 3202.75,,,,,,,,,,,
2025-04-08,12:37:00,17967.25,SELL,1,0.02h,Stop Loss,$-6.00,$-6.00,$196609.25,328,$-6.00
2025-04-08,12:59:00,17989.75,BUY,1,0.02h,Stop Loss,$16.50,$10.50,$196625.75,328,$10.50
2025-04-08,13:40:00,18103.25,SELL,1,0.02h,Stop Loss,$134.00,$144.50,$196759.75,328,$144.50
2025-04-08,13:44:00,18145.75,BUY,1,0.02h,Stop Loss,$49.00,$193.50,$196808.75,328,$193.50
2025-04-08,14:33:00,18287.25,SELL,1,0.02h,Stop Loss,$95.25,$288.75,$196904.00,328,$288.75
2025-04-08,14:35:00,18310.75,BUY,1,0.02h,Stop Loss,$57.75,$346.50,$196961.75,328,$346.50
2025-04-08,14:43:00,18274.75,SELL,1,0.02h,Stop Loss,$175.25,$521.75,$197137.00,328,$521.75
2025-04-08,15:39:00,18091.0,BUY,1,0.02h,Stop Loss,$56.50,$578.25,$197193.50,328,$578.25
2025-04-08,15:51:00,17998.25,SELL,1,0.02h,Stop Loss,$57.75,$636.00,$197251.25,328,$636.00
2025-04-08,16:13:00,18052.75,BUY,1,0.02h,Stop Loss,$59.00,$695.00,$197310.25,328,$695.00
2025-04-08,16:15:00,17999.75,SELL,1,0.02h,Stop Loss,$82.75,$777.75,$197393.00,328,$777.75
2025-04-08,17:41:00,17651.25,BUY,1,0.02h,Stop Loss,$140.25,$918.00,$197533.25,328,$918.00
2025-04-08,18:07:00,17595.5,SELL,1,0.02h,Stop Loss,$174.00,$1092.00,$197707.25,328,$1092.00
2025-04-08,18:21:00,17626.0,BUY,1,0.02h,Break Even,$0.25,$1092.25,$197707.50,328,$1092.25
2025-04-08,18:22:00,17592.25,SELL,1,0.02h,Stop Loss,$80.25,$1172.50,$197787.75,328,$1172.50
2025-04-08,19:55:00,17227.5,BUY,1,0.02h,Stop Loss,$-6.00,$1166.50,$197781.75,328,$1166.50
2025-04-08,20:22:00,17214.75,SELL,1,0.02h,Stop Loss,$104.00,$1270.50,$197885.75,328,$1270.50
2025-04-08,20:47:00,17205.5,BUY,1,0.02h,Stop Loss,$54.00,$1324.50,$197939.75,328,$1324.50
2025-04-08,22:02:00,17167.25,SELL,1,0.02h,Stop Loss,$267.75,$1592.25,$198207.50,328,$1592.25
2025-04-08,22:47:00,17054.0,BUY,1,0.02h,Stop Loss,$9.00,$1601.25,$198216.50,328,$1601.25
Final P&L Day: 1601.25,,,,,,,,,,,
2025-04-09,12:00:00,16958.0,SELL,1,0.02h,Stop Loss,$57.75,$57.75,$198274.25,329,$57.75
2025-04-09,12:43:00,16997.75,BUY,1,0.02h,Stop Loss,$134.00,$191.75,$198408.25,329,$191.75
2025-04-09,13:28:00,17191.5,SELL,1,0.02h,Stop Loss,$16.50,$208.25,$198424.75,329,$208.25
2025-04-09,13:31:00,17245.25,BUY,1,0.02h,Stop Loss,$402.75,$611.00,$198827.50,329,$611.00
2025-04-09,14:10:00,17399.5,SELL,1,0.02h,Stop Loss,$56.50,$667.50,$198884.00,329,$667.50
2025-04-09,14:25:00,17446.5,BUY,1,0.02h,Stop Loss,$101.50,$769.00,$198985.50,329,$769.00
2025-04-09,14:28:00,17404.75,SELL,1,0.02h,Stop Loss,$159.00,$928.00,$199144.50,329,$928.00
2025-04-09,14:31:00,17460.25,BUY,1,0.02h,Stop Loss,$262.75,$1190.75,$199407.25,329,$1190.75
2025-04-09,14:42:00,17431.75,SELL,1,0.02h,Stop Loss,$31.50,$1222.25,$199438.75,329,$1222.25
2025-04-09,15:10:00,17374.0,BUY,1,0.02h,Stop Loss,$54.00,$1276.25,$199492.75,329,$1276.25
2025-04-09,15:35:00,17353.75,SELL,1,0.02h,Stop Loss,$122.75,$1399.00,$199615.50,329,$1399.00
2025-04-09,15:51:00,17395.75,BUY,1,0.02h,Stop Loss,$25.25,$1424.25,$199640.75,329,$1424.25
2025-04-09,15:56:00,17324.75,SELL,1,0.02h,Stop Loss,$142.75,$1567.00,$199783.50,329,$1567.00
2025-04-09,16:09:00,17362.75,BUY,1,0.02h,Stop Loss,$127.75,$1694.75,$199911.25,329,$1694.75
2025-04-09,18:44:00,18914.75,SELL,1,0.02h,Stop Loss,$354.00,$2048.75,$200265.25,329,$2048.75
2025-04-09,19:11:00,18949.0,BUY,1,0.02h,Stop Loss,$131.50,$2180.25,$200396.75,329,$2180.25
2025-04-09,20:15:00,19244.5,SELL,1,0.02h,Break Even,$0.25,$2180.50,$200397.00,329,$2180.50
2025-04-09,20:19:00,19298.0,BUY,1,0.02h,Break Even,$0.25,$2180.75,$200397.25,329,$2180.75
2025-04-09,20:34:00,19285.75,SELL,1,0.02h,Stop Loss,$62.75,$2243.50,$200460.00,329,$2243.50
2025-04-09,20:35:00,19300.5,BUY,1,0.02h,Break Even,$0.25,$2243.75,$200460.25,329,$2243.75
2025-04-09,20:36:00,19287.75,SELL,1,0.02h,Stop Loss,$-6.00,$2237.75,$200454.25,329,$2237.75
2025-04-09,20:37:00,19296.5,BUY,1,0.02h,Break Even,$0.25,$2238.00,$200454.50,329,$2238.00
2025-04-09,22:02:00,19279.75,SELL,1,0.02h,Stop Loss,$55.25,$2293.25,$200509.75,329,$2293.25
2025-04-09,22:16:00,19316.5,BUY,1,0.02h,Stop Loss,$19.00,$2312.25,$200528.75,329,$2312.25
Final P&L Day: 2312.25,,,,,,,,,,,
2025-04-10,12:00:00,18926.75,SELL,1,0.02h,Stop Loss,$117.75,$117.75,$200646.50,330,$117.75
2025-04-10,12:33:00,18926.75,BUY,1,0.02h,Stop Loss,$189.00,$306.75,$200835.50,330,$306.75
2025-04-10,12:38:00,18835.5,SELL,1,0.02h,Stop Loss,$109.00,$415.75,$200944.50,330,$415.75
2025-04-10,13:02:00,18825.25,BUY,1,0.02h,Stop Loss,$81.50,$497.25,$201026.00,330,$497.25
2025-04-10,13:29:00,18785.5,SELL,1,0.02h,Break Even,$0.25,$497.50,$201026.25,330,$497.50
2025-04-10,13:51:00,18844.25,BUY,1,0.02h,Stop Loss,$14.00,$511.50,$201040.25,330,$511.50
2025-04-10,13:52:00,18767.0,SELL,1,0.02h,Stop Loss,$119.00,$630.50,$201159.25,330,$630.50
2025-04-10,14:25:00,18705.25,BUY,1,0.02h,Stop Loss,$100.25,$730.75,$201259.50,330,$730.75
2025-04-10,14:49:00,18665.5,SELL,1,0.02h,Stop Loss,$116.50,$847.25,$201376.00,330,$847.25
2025-04-10,16:36:00,18137.5,BUY,1,0.02h,Stop Loss,$215.25,$1062.50,$201591.25,330,$1062.50
2025-04-10,17:11:00,18168.5,SELL,1,0.02h,Stop Loss,$162.75,$1225.25,$201754.00,330,$1225.25
2025-04-10,17:28:00,18256.5,BUY,1,0.02h,Stop Loss,$125.25,$1350.50,$201879.25,330,$1350.50
2025-04-10,18:12:00,18373.0,SELL,1,0.02h,Stop Loss,$62.75,$1413.25,$201942.00,330,$1413.25
2025-04-10,18:23:00,18544.0,BUY,1,0.02h,Stop Loss,$71.50,$1484.75,$202013.50,330,$1484.75
2025-04-10,18:52:00,18552.25,SELL,1,0.02h,Stop Loss,$276.50,$1761.25,$202290.00,330,$1761.25
2025-04-10,19:02:00,18616.75,BUY,1,0.02h,Stop Loss,$185.25,$1946.50,$202475.25,330,$1946.50
2025-04-10,19:09:00,18489.25,SELL,1,0.02h,Stop Loss,$151.50,$2098.00,$202626.75,330,$2098.00
2025-04-10,19:22:00,18595.5,BUY,1,0.02h,Stop Loss,$34.00,$2132.00,$202660.75,330,$2132.00
2025-04-10,19:26:00,18507.5,SELL,1,0.02h,Stop Loss,$142.75,$2274.75,$202803.50,330,$2274.75
2025-04-10,19:54:00,18468.5,BUY,1,0.02h,Stop Loss,$290.25,$2565.00,$203093.75,330,$2565.00
2025-04-10,20:23:00,18489.75,SELL,1,0.02h,Break Even,$0.25,$2565.25,$203094.00,330,$2565.25
2025-04-10,20:53:00,18488.5,BUY,1,0.02h,Stop Loss,$-6.00,$2559.25,$203088.00,330,$2559.25
2025-04-10,22:27:00,18512.75,SELL,1,0.02h,Break Even,$0.25,$2559.50,$203088.25,330,$2559.50
2025-04-10,22:28:00,18530.5,BUY,1,0.02h,Break Even,$0.25,$2559.75,$203088.50,330,$2559.75
2025-04-10,22:54:00,18547.75,SELL,1,0.02h,Break Even,$0.25,$2560.00,$203088.75,330,$2560.00
Final P&L Day: 2560.00,,,,,,,,,,,
2025-04-11,12:01:00,18576.75,BUY,1,0.02h,Stop Loss,$35.25,$35.25,$203124.00,331,$35.25
2025-04-11,12:22:00,18558.25,SELL,1,0.02h,Stop Loss,$149.00,$184.25,$203273.00,331,$184.25
2025-04-11,12:31:00,18591.75,BUY,1,0.02h,Stop Loss,$77.75,$262.00,$203350.75,331,$262.00
2025-04-11,12:47:00,18572.25,SELL,1,0.02h,Stop Loss,$179.00,$441.00,$203529.75,331,$441.00
2025-04-11,13:40:00,18506.5,BUY,1,0.02h,Stop Loss,$32.75,$473.75,$203562.50,331,$473.75
2025-04-11,14:03:00,18484.5,SELL,1,0.02h,Stop Loss,$245.25,$719.00,$203807.75,331,$719.00
2025-04-11,14:09:00,18568.0,BUY,1,0.02h,Stop Loss,$140.25,$859.25,$203948.00,331,$859.25
2025-04-11,14:13:00,18482.75,SELL,1,0.02h,Stop Loss,$36.50,$895.75,$203984.50,331,$895.75
2025-04-11,14:16:00,18573.0,BUY,1,0.02h,Stop Loss,$49.00,$944.75,$204033.50,331,$944.75
2025-04-11,14:18:00,18475.0,SELL,1,0.02h,Stop Loss,$109.00,$1053.75,$204142.50,331,$1053.75
2025-04-11,14:39:00,18442.0,BUY,1,0.02h,Stop Loss,$150.25,$1204.00,$204292.75,331,$1204.00
2025-04-11,15:00:00,18413.5,SELL,1,0.02h,Stop Loss,$67.75,$1271.75,$204360.50,331,$1271.75
2025-04-11,15:30:00,18414.25,BUY,1,0.02h,Stop Loss,$91.50,$1363.25,$204452.00,331,$1363.25
2025-04-11,16:27:00,18551.75,SELL,1,0.02h,Stop Loss,$11.50,$1374.75,$204463.50,331,$1374.75
2025-04-11,16:32:00,18632.0,BUY,1,0.02h,Stop Loss,$89.00,$1463.75,$204552.50,331,$1463.75
2025-04-11,17:11:00,18715.0,SELL,1,0.02h,Stop Loss,$111.50,$1575.25,$204664.00,331,$1575.25
2025-04-11,17:40:00,18737.5,BUY,1,0.02h,Stop Loss,$261.50,$1836.75,$204925.50,331,$1836.75
2025-04-11,18:10:00,18780.0,SELL,1,0.02h,Stop Loss,$126.50,$1963.25,$205052.00,331,$1963.25
2025-04-11,18:14:00,18804.75,BUY,1,0.02h,Stop Loss,$16.50,$1979.75,$205068.50,331,$1979.75
2025-04-11,18:15:00,18793.0,SELL,1,0.02h,Stop Loss,$6.50,$1986.25,$205075.00,331,$1986.25
2025-04-11,18:16:00,18809.75,BUY,1,0.02h,Stop Loss,$9.00,$1995.25,$205084.00,331,$1995.25
2025-04-11,18:17:00,18791.0,SELL,1,0.02h,Stop Loss,$152.75,$2148.00,$205236.75,331,$2148.00
2025-04-11,18:37:00,18794.75,BUY,1,0.02h,Stop Loss,$54.00,$2202.00,$205290.75,331,$2202.00
2025-04-11,18:54:00,18780.75,SELL,1,0.02h,Break Even,$0.25,$2202.25,$205291.00,331,$2202.25
2025-04-11,18:55:00,18787.0,BUY,1,0.02h,Stop Loss,$52.75,$2255.00,$205343.75,331,$2255.00
2025-04-11,18:56:00,18773.0,SELL,1,0.02h,Stop Loss,$104.00,$2359.00,$205447.75,331,$2359.00
2025-04-11,19:04:00,18802.5,BUY,1,0.02h,Stop Loss,$51.50,$2410.50,$205499.25,331,$2410.50
2025-04-11,19:36:00,18810.0,SELL,1,0.02h,Break Even,$0.25,$2410.75,$205499.50,331,$2410.75
2025-04-11,19:45:00,18841.0,BUY,1,0.02h,Stop Loss,$11.50,$2422.25,$205511.00,331,$2422.25
2025-04-11,19:46:00,18815.0,SELL,1,0.02h,Stop Loss,$12.75,$2435.00,$205523.75,331,$2435.00
2025-04-11,19:48:00,18831.25,BUY,1,0.02h,Break Even,$0.25,$2435.25,$205524.00,331,$2435.25
2025-04-11,19:49:00,18812.0,SELL,1,0.02h,Stop Loss,$40.25,$2475.50,$205564.25,331,$2475.50
2025-04-11,19:56:00,18833.25,BUY,1,0.02h,Stop Loss,$57.75,$2533.25,$205622.00,331,$2533.25
2025-04-11,20:00:00,18808.75,SELL,1,0.02h,Stop Loss,$61.50,$2594.75,$205683.50,331,$2594.75
2025-04-11,20:18:00,18826.25,BUY,1,0.02h,Break Even,$0.25,$2595.00,$205683.75,331,$2595.00
2025-04-11,20:58:00,18810.75,SELL,1,0.02h,Stop Loss,$-6.00,$2589.00,$205677.75,331,$2589.00
Final P&L Day: 2589.00,,,,,,,,,,,
2025-04-14,12:00:00,19072.0,BUY,1,0.02h,Stop Loss,$117.75,$117.75,$205795.50,332,$117.75
2025-04-14,13:34:00,19183.5,SELL,1,0.02h,Stop Loss,$41.50,$159.25,$205837.00,332,$159.25
2025-04-14,14:04:00,19135.0,BUY,1,0.02h,Stop Loss,$109.00,$268.25,$205946.00,332,$268.25
2025-04-14,14:16:00,19068.25,SELL,1,0.02h,Stop Loss,$89.00,$357.25,$206035.00,332,$357.25
2025-04-14,14:26:00,19105.75,BUY,1,0.02h,Stop Loss,$95.25,$452.50,$206130.25,332,$452.50
2025-04-14,14:59:00,19125.75,SELL,1,0.02h,Break Even,$0.25,$452.75,$206130.50,332,$452.75
2025-04-14,16:21:00,18858.0,BUY,1,0.02h,Stop Loss,$194.00,$646.75,$206324.50,332,$646.75
2025-04-14,16:28:00,18793.0,SELL,1,0.02h,Break Even,$0.25,$647.00,$206324.75,332,$647.00
2025-04-14,16:34:00,18869.75,BUY,1,0.02h,Stop Loss,$52.75,$699.75,$206377.50,332,$699.75
2025-04-14,16:52:00,18826.25,SELL,1,0.02h,Stop Loss,$46.50,$746.25,$206424.00,332,$746.25
2025-04-14,17:14:00,18852.5,BUY,1,0.02h,Stop Loss,$-6.00,$740.25,$206418.00,332,$740.25
2025-04-14,17:17:00,18815.25,SELL,1,0.02h,Break Even,$0.25,$740.50,$206418.25,332,$740.50
2025-04-14,17:19:00,18869.75,BUY,1,0.02h,Stop Loss,$15.25,$755.75,$206433.50,332,$755.75
2025-04-14,17:41:00,18856.5,SELL,1,0.02h,Stop Loss,$9.00,$764.75,$206442.50,332,$764.75
2025-04-14,17:43:00,18893.25,BUY,1,0.02h,Stop Loss,$15.25,$780.00,$206457.75,332,$780.00
2025-04-14,17:47:00,18857.75,SELL,1,0.02h,Stop Loss,$77.75,$857.75,$206535.50,332,$857.75
2025-04-14,17:51:00,18880.5,BUY,1,0.02h,Stop Loss,$81.50,$939.25,$206617.00,332,$939.25
2025-04-14,19:27:00,19034.75,SELL,1,0.02h,Stop Loss,$4.00,$943.25,$206621.00,332,$943.25
2025-04-14,19:41:00,19066.5,BUY,1,0.02h,Break Even,$0.25,$943.50,$206621.25,332,$943.50
2025-04-14,19:49:00,19022.5,SELL,1,0.02h,Stop Loss,$70.25,$1013.75,$206691.50,332,$1013.75
2025-04-14,20:39:00,18887.75,BUY,1,0.02h,Stop Loss,$46.50,$1060.25,$206738.00,332,$1060.25
2025-04-14,22:06:00,18881.75,SELL,1,0.02h,Stop Loss,$-6.00,$1054.25,$206732.00,332,$1054.25
2025-04-14,22:27:00,18885.5,BUY,1,0.02h,Stop Loss,$-6.00,$1048.25,$206726.00,332,$1048.25
2025-04-14,22:28:00,18877.25,SELL,1,0.02h,Stop Loss,$14.00,$1062.25,$206740.00,332,$1062.25
Final P&L Day: 1062.25,,,,,,,,,,,
2025-04-15,12:01:00,18885.75,BUY,1,0.02h,Stop Loss,$44.00,$44.00,$206784.00,333,$44.00
2025-04-15,12:22:00,18863.5,SELL,1,0.02h,Stop Loss,$10.25,$54.25,$206794.25,333,$54.25
2025-04-15,12:38:00,18890.0,BUY,1,0.02h,Stop Loss,$26.50,$80.75,$206820.75,333,$80.75
2025-04-15,14:18:00,19049.75,SELL,1,0.02h,Stop Loss,$180.25,$261.00,$207001.00,333,$261.00
2025-04-15,14:44:00,19070.0,BUY,1,0.02h,Stop Loss,$22.75,$283.75,$207023.75,333,$283.75
2025-04-15,14:52:00,19023.25,SELL,1,0.02h,Stop Loss,$51.50,$335.25,$207075.25,333,$335.25
2025-04-15,14:55:00,19034.75,BUY,1,0.02h,Stop Loss,$54.00,$389.25,$207129.25,333,$389.25
2025-04-15,15:10:00,19030.75,SELL,1,0.02h,Stop Loss,$80.25,$469.50,$207209.50,333,$469.50
2025-04-15,15:11:00,19042.25,BUY,1,0.02h,Stop Loss,$27.75,$497.25,$207237.25,333,$497.25
2025-04-15,15:12:00,19016.5,SELL,1,0.02h,Break Even,$0.25,$497.50,$207237.50,333,$497.50
2025-04-15,15:13:00,19054.5,BUY,1,0.02h,Break Even,$0.25,$497.75,$207237.75,333,$497.75
2025-04-15,15:28:00,19029.75,SELL,1,0.02h,Stop Loss,$50.25,$548.00,$207288.00,333,$548.00
2025-04-15,15:55:00,19048.5,BUY,1,0.02h,Stop Loss,$-6.00,$542.00,$207282.00,333,$542.00
2025-04-15,16:38:00,19053.0,SELL,1,0.02h,Stop Loss,$37.75,$579.75,$207319.75,333,$579.75
2025-04-15,16:48:00,19069.0,BUY,1,0.02h,Stop Loss,$-6.00,$573.75,$207313.75,333,$573.75
2025-04-15,16:49:00,19052.25,SELL,1,0.02h,Stop Loss,$27.75,$601.50,$207341.50,333,$601.50
2025-04-15,17:40:00,18968.0,BUY,1,0.02h,Stop Loss,$82.75,$684.25,$207424.25,333,$684.25
2025-04-15,17:54:00,18920.25,SELL,1,0.02h,Stop Loss,$9.00,$693.25,$207433.25,333,$693.25
2025-04-15,18:32:00,18934.0,BUY,1,0.02h,Stop Loss,$44.00,$737.25,$207477.25,333,$737.25
2025-04-15,19:26:00,18955.0,SELL,1,0.02h,Stop Loss,$27.75,$765.00,$207505.00,333,$765.00
2025-04-15,19:53:00,18979.25,BUY,1,0.02h,Break Even,$0.25,$765.25,$207505.25,333,$765.25
2025-04-15,20:15:00,18960.25,SELL,1,0.02h,Stop Loss,$9.00,$774.25,$207514.25,333,$774.25
2025-04-15,22:33:00,18776.25,BUY,1,0.02h,Stop Loss,$-6.00,$768.25,$207508.25,333,$768.25
2025-04-15,22:51:00,18752.75,SELL,1,0.02h,Stop Loss,$17.75,$786.00,$207526.00,333,$786.00
Final P&L Day: 786.00,,,,,,,,,,,
2025-04-16,13:33:00,18644.5,BUY,1,0.02h,Stop Loss,$61.50,$61.50,$207587.50,334,$61.50
2025-04-16,13:47:00,18599.25,SELL,1,0.02h,Stop Loss,$27.75,$89.25,$207615.25,334,$89.25
2025-04-16,14:11:00,18596.75,BUY,1,0.02h,Stop Loss,$4.00,$93.25,$207619.25,334,$93.25
2025-04-16,14:15:00,18552.0,SELL,1,0.02h,Stop Loss,$12.75,$106.00,$207632.00,334,$106.00
2025-04-16,14:23:00,18592.0,BUY,1,0.02h,Stop Loss,$4.00,$110.00,$207636.00,334,$110.00
2025-04-16,14:57:00,18601.25,SELL,1,0.02h,Stop Loss,$-6.00,$104.00,$207630.00,334,$104.00
2025-04-16,15:01:00,18639.75,BUY,1,0.02h,Stop Loss,$7.75,$111.75,$207637.75,334,$111.75
2025-04-16,15:03:00,18614.25,SELL,1,0.02h,Stop Loss,$24.00,$135.75,$207661.75,334,$135.75
2025-04-16,15:11:00,18626.25,BUY,1,0.02h,Stop Loss,$40.25,$176.00,$207702.00,334,$176.00
2025-04-16,15:17:00,18613.5,SELL,1,0.02h,Break Even,$0.25,$176.25,$207702.25,334,$176.25
2025-04-16,15:23:00,18663.75,BUY,1,0.02h,Stop Loss,$42.75,$219.00,$207745.00,334,$219.00
2025-04-16,15:43:00,18654.75,SELL,1,0.02h,Stop Loss,$42.75,$261.75,$207787.75,334,$261.75
2025-04-16,16:27:00,18602.5,BUY,1,0.02h,Break Even,$0.25,$262.00,$207788.00,334,$262.00
2025-04-16,16:38:00,18573.5,SELL,1,0.02h,Stop Loss,$24.00,$286.00,$207812.00,334,$286.00
2025-04-16,17:19:00,18576.75,BUY,1,0.02h,Stop Loss,$34.00,$320.00,$207846.00,334,$320.00
2025-04-16,17:32:00,18485.5,SELL,1,0.02h,Stop Loss,$71.50,$391.50,$207917.50,334,$391.50
2025-04-16,18:25:00,18363.5,BUY,1,0.02h,Stop Loss,$5.25,$396.75,$207922.75,334,$396.75
2025-04-16,18:33:00,18339.25,SELL,1,0.02h,Stop Loss,$49.00,$445.75,$207971.75,334,$445.75
2025-04-16,19:35:00,18192.5,BUY,1,0.02h,Stop Loss,$54.00,$499.75,$208025.75,334,$499.75
2025-04-16,20:43:00,18401.75,SELL,1,0.02h,Stop Loss,$15.25,$515.00,$208041.00,334,$515.00
2025-04-16,22:03:00,18418.5,BUY,1,0.02h,Stop Loss,$16.50,$531.50,$208057.50,334,$531.50
2025-04-16,22:17:00,18374.0,SELL,1,0.02h,Break Even,$0.25,$531.75,$208057.75,334,$531.75
2025-04-16,22:30:00,18400.5,BUY,1,0.02h,Stop Loss,$11.50,$543.25,$208069.25,334,$543.25
Final P&L Day: 543.25,,,,,,,,,,,
2025-04-17,12:47:00,18537.75,SELL,1,0.02h,Stop Loss,$16.50,$16.50,$208085.75,335,$16.50
2025-04-17,12:50:00,18553.25,BUY,1,0.02h,Stop Loss,$34.00,$50.50,$208119.75,335,$50.50
2025-04-17,12:57:00,18535.25,SELL,1,0.02h,Stop Loss,$30.25,$80.75,$208150.00,335,$80.75
2025-04-17,13:22:00,18528.25,BUY,1,0.02h,Stop Loss,$52.75,$133.50,$208202.75,335,$133.50
2025-04-17,13:28:00,18486.25,SELL,1,0.02h,Stop Loss,$-6.00,$127.50,$208196.75,335,$127.50
2025-04-17,13:53:00,18485.75,BUY,1,0.02h,Stop Loss,$34.00,$161.50,$208230.75,335,$161.50
2025-04-17,14:07:00,18424.5,SELL,1,0.02h,Stop Loss,$189.00,$350.50,$208419.75,335,$350.50
2025-04-17,14:47:00,18355.0,BUY,1,0.02h,Stop Loss,$20.25,$370.75,$208440.00,335,$370.75
2025-04-17,14:53:00,18315.0,SELL,1,0.02h,Stop Loss,$6.50,$377.25,$208446.50,335,$377.25
2025-04-17,15:07:00,18389.0,BUY,1,0.02h,Stop Loss,$134.00,$511.25,$208580.50,335,$511.25
2025-04-17,15:29:00,18341.75,SELL,1,0.02h,Stop Loss,$51.50,$562.75,$208632.00,335,$562.75
2025-04-17,15:38:00,18416.75,BUY,1,0.02h,Stop Loss,$10.25,$573.00,$208642.25,335,$573.00
2025-04-17,15:44:00,18371.0,SELL,1,0.02h,Stop Loss,$66.50,$639.50,$208708.75,335,$639.50
2025-04-17,16:08:00,18398.75,BUY,1,0.02h,Stop Loss,$147.75,$787.25,$208856.50,335,$787.25
2025-04-17,16:43:00,18412.75,SELL,1,0.02h,Stop Loss,$144.00,$931.25,$209000.50,335,$931.25
2025-04-17,16:53:00,18452.25,BUY,1,0.02h,Stop Loss,$22.75,$954.00,$209023.25,335,$954.00
2025-04-17,17:12:00,18427.0,SELL,1,0.02h,Stop Loss,$22.75,$976.75,$209046.00,335,$976.75
2025-04-17,17:37:00,18421.25,BUY,1,0.02h,Break Even,$0.25,$977.00,$209046.25,335,$977.00
2025-04-17,17:44:00,18398.5,SELL,1,0.02h,Break Even,$0.25,$977.25,$209046.50,335,$977.25
2025-04-17,17:45:00,18410.25,BUY,1,0.02h,Stop Loss,$60.25,$1037.50,$209106.75,335,$1037.50
2025-04-17,18:43:00,18484.75,SELL,1,0.02h,Break Even,$0.25,$1037.75,$209107.00,335,$1037.75
2025-04-17,19:36:00,18398.5,BUY,1,0.02h,Stop Loss,$49.00,$1086.75,$209156.00,335,$1086.75
2025-04-17,19:47:00,18380.0,SELL,1,0.02h,Stop Loss,$57.75,$1144.50,$209213.75,335,$1144.50
2025-04-17,20:02:00,18408.25,BUY,1,0.02h,Break Even,$0.25,$1144.75,$209214.00,335,$1144.75
2025-04-17,20:32:00,18404.5,SELL,1,0.02h,Stop Loss,$10.25,$1155.00,$209224.25,335,$1155.00
2025-04-17,20:37:00,18410.5,BUY,1,0.02h,Stop Loss,$10.25,$1165.25,$209234.50,335,$1165.25
Final P&L Day: 1165.25,,,,,,,,,,,
2025-04-21,12:00:00,18106.0,SELL,1,0.02h,Stop Loss,$25.25,$25.25,$209259.75,336,$25.25
2025-04-21,12:41:00,18138.0,BUY,1,0.02h,Break Even,$0.25,$25.50,$209260.00,336,$25.50
2025-04-21,12:48:00,18122.5,SELL,1,0.02h,Break Even,$0.25,$25.75,$209260.25,336,$25.75
2025-04-21,12:51:00,18131.75,BUY,1,0.02h,Stop Loss,$-6.00,$19.75,$209254.25,336,$19.75
2025-04-21,12:52:00,18123.25,SELL,1,0.02h,Stop Loss,$19.00,$38.75,$209273.25,336,$38.75
2025-04-21,13:29:00,18118.75,BUY,1,0.02h,Stop Loss,$37.75,$76.50,$209311.00,336,$76.50
2025-04-21,13:39:00,18090.0,SELL,1,0.02h,Stop Loss,$36.50,$113.00,$209347.50,336,$113.00
2025-04-21,14:38:00,17963.5,BUY,1,0.02h,Break Even,$0.25,$113.25,$209347.75,336,$113.25
2025-04-21,14:48:00,17925.25,SELL,1,0.02h,Stop Loss,$31.50,$144.75,$209379.25,336,$144.75
2025-04-21,16:07:00,17826.0,BUY,1,0.02h,Stop Loss,$-6.00,$138.75,$209373.25,336,$138.75
2025-04-21,16:28:00,17812.5,SELL,1,0.02h,Stop Loss,$26.50,$165.25,$209399.75,336,$165.25
2025-04-21,16:32:00,17836.25,BUY,1,0.02h,Stop Loss,$54.00,$219.25,$209453.75,336,$219.25
2025-04-21,16:51:00,17829.0,SELL,1,0.02h,Stop Loss,$29.00,$248.25,$209482.75,336,$248.25
2025-04-21,18:14:00,17725.0,BUY,1,0.02h,Stop Loss,$29.00,$277.25,$209511.75,336,$277.25
2025-04-21,18:43:00,17733.5,SELL,1,0.02h,Stop Loss,$11.50,$288.75,$209523.25,336,$288.75
2025-04-21,19:03:00,17745.25,BUY,1,0.02h,Stop Loss,$6.50,$295.25,$209529.75,336,$295.25
2025-04-21,22:02:00,17903.25,SELL,1,0.02h,Stop Loss,$25.25,$320.50,$209555.00,336,$320.50
2025-04-21,22:36:00,17898.75,BUY,1,0.02h,Stop Loss,$42.75,$363.25,$209597.75,336,$363.25
2025-04-21,22:57:00,17896.5,SELL,1,0.02h,Break Even,$0.25,$363.50,$209598.00,336,$363.50
Final P&L Day: 363.50,,,,,,,,,,,
2025-04-22,12:00:00,18055.25,BUY,1,0.02h,Stop Loss,$41.50,$41.50,$209639.50,337,$41.50
2025-04-22,13:35:00,18111.25,SELL,1,0.02h,Stop Loss,$39.00,$80.50,$209678.50,337,$80.50
2025-04-22,13:40:00,18153.0,BUY,1,0.02h,Stop Loss,$59.00,$139.50,$209737.50,337,$139.50
2025-04-22,15:30:00,18352.0,SELL,1,0.02h,Stop Loss,$52.75,$192.25,$209790.25,337,$192.25
2025-04-22,16:00:00,18379.0,BUY,1,0.02h,Stop Loss,$272.75,$465.00,$210063.00,337,$465.00
2025-04-22,16:42:00,18451.25,SELL,1,0.02h,Break Even,$0.25,$465.25,$210063.25,337,$465.25
2025-04-22,17:09:00,18480.75,BUY,1,0.02h,Stop Loss,$45.25,$510.50,$210108.50,337,$510.50
2025-04-22,17:11:00,18415.0,SELL,1,0.02h,Stop Loss,$161.50,$672.00,$210270.00,337,$672.00
2025-04-22,18:06:00,18295.25,BUY,1,0.02h,Stop Loss,$44.00,$716.00,$210314.00,337,$716.00
2025-04-22,19:09:00,18365.0,SELL,1,0.02h,Stop Loss,$14.00,$730.00,$210328.00,337,$730.00
2025-04-22,19:45:00,18324.25,BUY,1,0.02h,Stop Loss,$101.50,$831.50,$210429.50,337,$831.50
2025-04-22,20:19:00,18359.25,SELL,1,0.02h,Stop Loss,$26.50,$858.00,$210456.00,337,$858.00
2025-04-22,20:28:00,18367.25,BUY,1,0.02h,Break Even,$0.25,$858.25,$210456.25,337,$858.25
2025-04-22,20:47:00,18361.75,SELL,1,0.02h,Break Even,$0.25,$858.50,$210456.50,337,$858.50
2025-04-22,22:01:00,18684.0,BUY,1,0.02h,Stop Loss,$111.50,$970.00,$210568.00,337,$970.00
Final P&L Day: 970.00,,,,,,,,,,,
2025-04-23,13:07:00,18926.5,SELL,1,0.02h,Stop Loss,$6.50,$6.50,$210574.50,338,$6.50
2025-04-23,13:22:00,18945.0,BUY,1,0.02h,Stop Loss,$12.75,$19.25,$210587.25,338,$19.25
2025-04-23,14:18:00,18996.0,SELL,1,0.02h,Stop Loss,$70.25,$89.50,$210657.50,338,$89.50
2025-04-23,14:26:00,19076.25,BUY,1,0.02h,Stop Loss,$135.25,$224.75,$210792.75,338,$224.75
2025-04-23,14:51:00,19076.5,SELL,1,0.02h,Stop Loss,$7.75,$232.50,$210800.50,338,$232.50
2025-04-23,16:32:00,18842.0,BUY,1,0.02h,Stop Loss,$-6.00,$226.50,$210794.50,338,$226.50
2025-04-23,17:33:00,18925.25,SELL,1,0.02h,Stop Loss,$89.00,$315.50,$210883.50,338,$315.50
2025-04-23,17:55:00,18925.5,BUY,1,0.02h,Stop Loss,$31.50,$347.00,$210915.00,338,$347.00
2025-04-23,18:26:00,18893.75,SELL,1,0.02h,Stop Loss,$54.00,$401.00,$210969.00,338,$401.00
2025-04-23,18:59:00,18896.75,BUY,1,0.02h,Break Even,$0.25,$401.25,$210969.25,338,$401.25
2025-04-23,19:00:00,18869.75,SELL,1,0.02h,Stop Loss,$32.75,$434.00,$211002.00,338,$434.00
2025-04-23,19:51:00,18824.25,BUY,1,0.02h,Break Even,$0.25,$434.25,$211002.25,338,$434.25
2025-04-23,20:04:00,18779.0,SELL,1,0.02h,Stop Loss,$-6.00,$428.25,$210996.25,338,$428.25
2025-04-23,20:11:00,18812.0,BUY,1,0.02h,Stop Loss,$20.25,$448.50,$211016.50,338,$448.50
2025-04-23,20:45:00,18850.75,SELL,1,0.02h,Break Even,$0.25,$448.75,$211016.75,338,$448.75
2025-04-23,22:32:00,18781.0,BUY,1,0.02h,Stop Loss,$29.00,$477.75,$211045.75,338,$477.75
Final P&L Day: 477.75,,,,,,,,,,,
2025-04-24,12:00:00,18770.0,SELL,1,0.02h,Break Even,$0.25,$0.25,$211046.00,339,$0.25
2025-04-24,12:16:00,18813.25,BUY,1,0.02h,Break Even,$0.25,$0.50,$211046.25,339,$0.50
2025-04-24,12:29:00,18796.25,SELL,1,0.02h,Stop Loss,$25.25,$25.75,$211071.50,339,$25.75
2025-04-24,12:32:00,18823.0,BUY,1,0.02h,Stop Loss,$17.75,$43.50,$211089.25,339,$43.50
2025-04-24,12:34:00,18799.0,SELL,1,0.02h,Stop Loss,$-6.00,$37.50,$211083.25,339,$37.50
2025-04-24,12:35:00,18816.0,BUY,1,0.02h,Stop Loss,$16.50,$54.00,$211099.75,339,$54.00
2025-04-24,13:07:00,18829.0,SELL,1,0.02h,Stop Loss,$12.75,$66.75,$211112.50,339,$66.75
2025-04-24,13:20:00,18840.0,BUY,1,0.02h,Stop Loss,$-6.00,$60.75,$211106.50,339,$60.75
2025-04-24,14:48:00,19097.5,SELL,1,0.02h,Stop Loss,$34.00,$94.75,$211140.50,339,$94.75
2025-04-24,14:57:00,19143.25,BUY,1,0.02h,Stop Loss,$9.00,$103.75,$211149.50,339,$103.75
2025-04-24,15:26:00,19154.0,SELL,1,0.02h,Stop Loss,$-6.00,$97.75,$211143.50,339,$97.75
2025-04-24,15:39:00,19176.0,BUY,1,0.02h,Break Even,$0.25,$98.00,$211143.75,339,$98.00
2025-04-24,15:45:00,19153.0,SELL,1,0.02h,Stop Loss,$27.75,$125.75,$211171.50,339,$125.75
2025-04-24,15:50:00,19173.75,BUY,1,0.02h,Break Even,$0.25,$126.00,$211171.75,339,$126.00
2025-04-24,16:02:00,19158.75,SELL,1,0.02h,Stop Loss,$44.00,$170.00,$211215.75,339,$170.00
2025-04-24,16:14:00,19185.25,BUY,1,0.02h,Stop Loss,$22.75,$192.75,$211238.50,339,$192.75
2025-04-24,17:17:00,19226.75,SELL,1,0.02h,Stop Loss,$52.75,$245.50,$211291.25,339,$245.50
2025-04-24,17:27:00,19255.0,BUY,1,0.02h,Stop Loss,$19.00,$264.50,$211310.25,339,$264.50
2025-04-24,17:38:00,19242.0,SELL,1,0.02h,Stop Loss,$-6.00,$258.50,$211304.25,339,$258.50
2025-04-24,17:39:00,19249.25,BUY,1,0.02h,Stop Loss,$-6.00,$252.50,$211298.25,339,$252.50
2025-04-24,17:41:00,19237.25,SELL,1,0.02h,Stop Loss,$56.50,$309.00,$211354.75,339,$309.00
2025-04-24,17:51:00,19247.25,BUY,1,0.02h,Stop Loss,$6.50,$315.50,$211361.25,339,$315.50
2025-04-24,19:00:00,19292.5,SELL,1,0.02h,Stop Loss,$47.75,$363.25,$211409.00,339,$363.25
2025-04-24,19:38:00,19274.25,BUY,1,0.02h,Stop Loss,$20.25,$383.50,$211429.25,339,$383.50
2025-04-24,20:20:00,19333.25,SELL,1,0.02h,Stop Loss,$10.25,$393.75,$211439.50,339,$393.75
2025-04-24,20:27:00,19344.75,BUY,1,0.02h,Stop Loss,$19.00,$412.75,$211458.50,339,$412.75
2025-04-24,20:31:00,19327.0,SELL,1,0.02h,Stop Loss,$-6.00,$406.75,$211452.50,339,$406.75
2025-04-24,20:36:00,19346.0,BUY,1,0.02h,Stop Loss,$4.00,$410.75,$211456.50,339,$410.75
2025-04-24,20:58:00,19349.0,SELL,1,0.02h,Break Even,$0.25,$411.00,$211456.75,339,$411.00
2025-04-24,22:01:00,19379.0,BUY,1,0.02h,Stop Loss,$10.25,$421.25,$211467.00,339,$421.25
2025-04-24,22:58:00,19402.75,SELL,1,0.02h,Stop Loss,$19.00,$440.25,$211486.00,339,$440.25
Final P&L Day: 440.25,,,,,,,,,,,
2025-04-25,12:38:00,19278.75,BUY,1,0.02h,Stop Loss,$30.25,$30.25,$211516.25,340,$30.25
2025-04-25,12:46:00,19270.25,SELL,1,0.02h,Stop Loss,$42.75,$73.00,$211559.00,340,$73.00
2025-04-25,13:10:00,19258.5,BUY,1,0.02h,Stop Loss,$5.25,$78.25,$211564.25,340,$78.25
2025-04-25,13:48:00,19275.5,SELL,1,0.02h,Stop Loss,$5.25,$83.50,$211569.50,340,$83.50
2025-04-25,14:02:00,19321.25,BUY,1,0.02h,Stop Loss,$91.50,$175.00,$211661.00,340,$175.00
2025-04-25,14:23:00,19271.5,SELL,1,0.02h,Stop Loss,$77.75,$252.75,$211738.75,340,$252.75
2025-04-25,14:40:00,19331.5,BUY,1,0.02h,Stop Loss,$111.50,$364.25,$211850.25,340,$364.25
2025-04-25,14:59:00,19308.5,SELL,1,0.02h,Break Even,$0.25,$364.50,$211850.50,340,$364.50
2025-04-25,15:05:00,19347.0,BUY,1,0.02h,Stop Loss,$37.75,$402.25,$211888.25,340,$402.25
2025-04-25,15:33:00,19356.5,SELL,1,0.02h,Stop Loss,$19.00,$421.25,$211907.25,340,$421.25
2025-04-25,15:53:00,19360.0,BUY,1,0.02h,Stop Loss,$-6.00,$415.25,$211901.25,340,$415.25
2025-04-25,17:39:00,19472.0,SELL,1,0.02h,Stop Loss,$130.25,$545.50,$212031.50,340,$545.50
2025-04-25,18:07:00,19458.5,BUY,1,0.02h,Stop Loss,$5.25,$550.75,$212036.75,340,$550.75
2025-04-25,19:00:00,19499.75,SELL,1,0.02h,Stop Loss,$16.50,$567.25,$212053.25,340,$567.25
2025-04-25,19:03:00,19512.5,BUY,1,0.02h,Stop Loss,$36.50,$603.75,$212089.75,340,$603.75
2025-04-25,19:12:00,19493.25,SELL,1,0.02h,Break Even,$0.25,$604.00,$212090.00,340,$604.00
2025-04-25,19:24:00,19509.25,BUY,1,0.02h,Stop Loss,$10.25,$614.25,$212100.25,340,$614.25
2025-04-25,19:29:00,19488.75,SELL,1,0.02h,Stop Loss,$15.25,$629.50,$212115.50,340,$629.50
2025-04-25,19:51:00,19511.75,BUY,1,0.02h,Stop Loss,$-6.00,$623.50,$212109.50,340,$623.50
2025-04-25,20:45:00,19542.75,SELL,1,0.02h,Break Even,$0.25,$623.75,$212109.75,340,$623.75
2025-04-25,21:00:00,19554.75,BUY,1,63.00h,Stop Loss,$-6.00,$617.75,$212103.75,340,$617.75
Final P&L Day: 617.75,,,,,,,,,,,
2025-04-28,12:00:00,19514.0,SELL,1,0.02h,Stop Loss,$5.25,$5.25,$212109.00,341,$5.25
2025-04-28,12:27:00,19509.25,BUY,1,0.02h,Stop Loss,$-6.00,$-0.75,$212103.00,341,$-0.75
2025-04-28,13:32:00,19541.25,SELL,1,0.02h,Stop Loss,$6.50,$5.75,$212109.50,341,$5.75
2025-04-28,13:44:00,19580.5,BUY,1,0.02h,Stop Loss,$76.50,$82.25,$212186.00,341,$82.25
2025-04-28,13:56:00,19518.5,SELL,1,0.02h,Stop Loss,$41.50,$123.75,$212227.50,341,$123.75
2025-04-28,14:25:00,19536.0,BUY,1,0.02h,Break Even,$0.25,$124.00,$212227.75,341,$124.00
2025-04-28,14:28:00,19503.75,SELL,1,0.02h,Stop Loss,$50.25,$174.25,$212278.00,341,$174.25
2025-04-28,14:39:00,19521.75,BUY,1,0.02h,Stop Loss,$5.25,$179.50,$212283.25,341,$179.50
2025-04-28,14:54:00,19485.5,SELL,1,0.02h,Break Even,$0.25,$179.75,$212283.50,341,$179.75
2025-04-28,15:43:00,19384.75,BUY,1,0.02h,Break Even,$0.25,$180.00,$212283.75,341,$180.00
2025-04-28,15:45:00,19352.25,SELL,1,0.02h,Stop Loss,$17.75,$197.75,$212301.50,341,$197.75
2025-04-28,16:36:00,19321.5,BUY,1,0.02h,Stop Loss,$24.00,$221.75,$212325.50,341,$221.75
2025-04-28,16:56:00,19303.25,SELL,1,0.02h,Stop Loss,$39.00,$260.75,$212364.50,341,$260.75
2025-04-28,17:02:00,19331.25,BUY,1,0.02h,Stop Loss,$-6.00,$254.75,$212358.50,341,$254.75
2025-04-28,17:03:00,19313.5,SELL,1,0.02h,Break Even,$0.25,$255.00,$212358.75,341,$255.00
2025-04-28,17:04:00,19325.5,BUY,1,0.02h,Stop Loss,$22.75,$277.75,$212381.50,341,$277.75
2025-04-28,17:05:00,19316.0,SELL,1,0.02h,Stop Loss,$26.50,$304.25,$212408.00,341,$304.25
2025-04-28,17:40:00,19305.25,BUY,1,0.02h,Stop Loss,$35.25,$339.50,$212443.25,341,$339.50
2025-04-28,20:02:00,19501.75,SELL,1,0.02h,Stop Loss,$12.75,$352.25,$212456.00,341,$352.25
2025-04-28,22:10:00,19487.5,BUY,1,0.02h,Break Even,$0.25,$352.50,$212456.25,341,$352.50
2025-04-28,22:14:00,19467.25,SELL,1,0.02h,Stop Loss,$-6.00,$346.50,$212450.25,341,$346.50
2025-04-28,22:32:00,19478.75,BUY,1,0.02h,Stop Loss,$37.75,$384.25,$212488.00,341,$384.25
2025-04-28,22:43:00,19464.5,SELL,1,0.02h,Stop Loss,$-6.00,$378.25,$212482.00,341,$378.25
2025-04-28,22:51:00,19482.0,BUY,1,0.02h,Break Even,$0.25,$378.50,$212482.25,341,$378.50
Final P&L Day: 378.50,,,,,,,,,,,
2025-04-29,12:19:00,19488.5,SELL,1,0.02h,Stop Loss,$44.00,$44.00,$212526.25,342,$44.00
2025-04-29,12:32:00,19490.25,BUY,1,0.02h,Break Even,$0.25,$44.25,$212526.50,342,$44.25
2025-04-29,12:55:00,19497.5,SELL,1,0.02h,Stop Loss,$37.75,$82.00,$212564.25,342,$82.00
2025-04-29,13:30:00,19427.25,BUY,1,0.02h,Stop Loss,$65.25,$147.25,$212629.50,342,$147.25
2025-04-29,14:22:00,19500.5,SELL,1,0.02h,Stop Loss,$19.00,$166.25,$212648.50,342,$166.25
2025-04-29,14:36:00,19556.0,BUY,1,0.02h,Stop Loss,$41.50,$207.75,$212690.00,342,$207.75
2025-04-29,15:13:00,19565.0,SELL,1,0.02h,Stop Loss,$81.50,$289.25,$212771.50,342,$289.25
2025-04-29,15:42:00,19555.0,BUY,1,0.02h,Stop Loss,$69.00,$358.25,$212840.50,342,$358.25
2025-04-29,15:58:00,19539.25,SELL,1,0.02h,Break Even,$0.25,$358.50,$212840.75,342,$358.50
2025-04-29,16:04:00,19579.5,BUY,1,0.02h,Break Even,$0.25,$358.75,$212841.00,342,$358.75
2025-04-29,16:20:00,19556.5,SELL,1,0.02h,Stop Loss,$30.25,$389.00,$212871.25,342,$389.00
2025-04-29,16:37:00,19581.25,BUY,1,0.02h,Stop Loss,$-6.00,$383.00,$212865.25,342,$383.00
2025-04-29,16:39:00,19550.0,SELL,1,0.02h,Stop Loss,$9.00,$392.00,$212874.25,342,$392.00
2025-04-29,16:43:00,19577.0,BUY,1,0.02h,Stop Loss,$11.50,$403.50,$212885.75,342,$403.50
2025-04-29,16:47:00,19547.5,SELL,1,0.02h,Stop Loss,$71.50,$475.00,$212957.25,342,$475.00
2025-04-29,17:18:00,19542.25,BUY,1,0.02h,Stop Loss,$35.25,$510.25,$212992.50,342,$510.25
2025-04-29,18:23:00,19644.0,SELL,1,0.02h,Stop Loss,$-6.00,$504.25,$212986.50,342,$504.25
2025-04-29,18:26:00,19663.5,BUY,1,0.02h,Stop Loss,$5.25,$509.50,$212991.75,342,$509.50
2025-04-29,18:27:00,19656.0,SELL,1,0.02h,Stop Loss,$-6.00,$503.50,$212985.75,342,$503.50
2025-04-29,18:28:00,19670.25,BUY,1,0.02h,Stop Loss,$67.75,$571.25,$213053.50,342,$571.25
2025-04-29,18:49:00,19665.25,SELL,1,0.02h,Stop Loss,$7.75,$579.00,$213061.25,342,$579.00
2025-04-29,19:12:00,19671.0,BUY,1,0.02h,Stop Loss,$-6.00,$573.00,$213055.25,342,$573.00
2025-04-29,19:16:00,19643.25,SELL,1,0.02h,Break Even,$0.25,$573.25,$213055.50,342,$573.25
2025-04-29,19:34:00,19657.25,BUY,1,0.02h,Break Even,$0.25,$573.50,$213055.75,342,$573.50
2025-04-29,19:37:00,19641.75,SELL,1,0.02h,Stop Loss,$21.50,$595.00,$213077.25,342,$595.00
2025-04-29,19:50:00,19663.0,BUY,1,0.02h,Stop Loss,$79.00,$674.00,$213156.25,342,$674.00
2025-04-29,20:04:00,19645.0,SELL,1,0.02h,Stop Loss,$17.75,$691.75,$213174.00,342,$691.75
2025-04-29,20:27:00,19639.25,BUY,1,0.02h,Stop Loss,$-6.00,$685.75,$213168.00,342,$685.75
2025-04-29,20:29:00,19620.0,SELL,1,0.02h,Stop Loss,$25.25,$711.00,$213193.25,342,$711.00
2025-04-29,20:57:00,19617.25,BUY,1,0.02h,Stop Loss,$17.75,$728.75,$213211.00,342,$728.75
2025-04-29,22:02:00,19580.5,SELL,1,0.02h,Stop Loss,$-6.00,$722.75,$213205.00,342,$722.75
2025-04-29,22:15:00,19603.5,BUY,1,0.02h,Break Even,$0.25,$723.00,$213205.25,342,$723.00
2025-04-29,22:23:00,19585.0,SELL,1,0.02h,Break Even,$0.25,$723.25,$213205.50,342,$723.25
Final P&L Day: 723.25,,,,,,,,,,,
2025-04-30,13:24:00,19280.25,BUY,1,0.02h,Break Even,$0.25,$0.25,$213205.75,343,$0.25
2025-04-30,13:32:00,19242.0,SELL,1,0.02h,Stop Loss,$15.25,$15.50,$213221.00,343,$15.50
2025-04-30,13:35:00,19295.5,BUY,1,0.02h,Stop Loss,$24.00,$39.50,$213245.00,343,$39.50
2025-04-30,13:37:00,19256.75,SELL,1,0.02h,Stop Loss,$195.25,$234.75,$213440.25,343,$234.75
2025-04-30,14:09:00,19200.0,BUY,1,0.02h,Stop Loss,$109.00,$343.75,$213549.25,343,$343.75
2025-04-30,16:14:00,19421.0,SELL,1,0.02h,Break Even,$0.25,$344.00,$213549.50,343,$344.00
2025-04-30,16:40:00,19426.75,BUY,1,0.02h,Stop Loss,$35.25,$379.25,$213584.75,343,$379.25
2025-04-30,17:07:00,19403.25,SELL,1,0.02h,Stop Loss,$7.75,$387.00,$213592.50,343,$387.00
2025-04-30,17:25:00,19405.0,BUY,1,0.02h,Stop Loss,$55.25,$442.25,$213647.75,343,$442.25
2025-04-30,18:02:00,19465.75,SELL,1,0.02h,Stop Loss,$32.75,$475.00,$213680.50,343,$475.00
2025-04-30,18:08:00,19528.75,BUY,1,0.02h,Stop Loss,$22.75,$497.75,$213703.25,343,$497.75
2025-04-30,18:30:00,19494.75,SELL,1,0.02h,Stop Loss,$22.75,$520.50,$213726.00,343,$520.50
2025-04-30,18:50:00,19515.25,BUY,1,0.02h,Stop Loss,$50.25,$570.75,$213776.25,343,$570.75
2025-04-30,18:59:00,19482.5,SELL,1,0.02h,Stop Loss,$41.50,$612.25,$213817.75,343,$612.25
2025-04-30,19:04:00,19504.0,BUY,1,0.02h,Break Even,$0.25,$612.50,$213818.00,343,$612.50
2025-04-30,19:26:00,19481.75,SELL,1,0.02h,Stop Loss,$26.50,$639.00,$213844.50,343,$639.00
2025-04-30,19:39:00,19513.75,BUY,1,0.02h,Break Even,$0.25,$639.25,$213844.75,343,$639.25
2025-04-30,22:29:00,19890.0,SELL,1,0.02h,Stop Loss,$9.00,$648.25,$213853.75,343,$648.25
2025-04-30,22:32:00,19913.0,BUY,1,0.02h,Stop Loss,$-6.00,$642.25,$213847.75,343,$642.25
2025-04-30,22:40:00,19894.25,SELL,1,0.02h,Stop Loss,$20.25,$662.50,$213868.00,343,$662.50
2025-04-30,22:58:00,19899.5,BUY,1,0.02h,Stop Loss,$5.25,$667.75,$213873.25,343,$667.75
Final P&L Day: 667.75,,,,,,,,,,,
2025-05-01,12:29:00,19990.0,SELL,1,0.02h,Break Even,$0.25,$0.25,$213873.50,344,$0.25
2025-05-01,13:12:00,19981.0,BUY,1,0.02h,Break Even,$0.25,$0.50,$213873.75,344,$0.50
2025-05-01,13:32:00,19921.75,SELL,1,0.02h,Stop Loss,$27.75,$28.25,$213901.50,344,$28.25
2025-05-01,13:49:00,19979.75,BUY,1,0.02h,Break Even,$0.25,$28.50,$213901.75,344,$28.50
2025-05-01,13:57:00,19932.75,SELL,1,0.02h,Stop Loss,$81.50,$110.00,$213983.25,344,$110.00
2025-05-01,14:18:00,19956.0,BUY,1,0.02h,Break Even,$0.25,$110.25,$213983.50,344,$110.25
2025-05-01,15:30:00,20077.5,SELL,1,0.02h,Stop Loss,$59.00,$169.25,$214042.50,344,$169.25
2025-05-01,16:32:00,19974.0,BUY,1,0.02h,Break Even,$0.25,$169.50,$214042.75,344,$169.50
2025-05-01,16:44:00,19961.25,SELL,1,0.02h,Break Even,$0.25,$169.75,$214043.00,344,$169.75
2025-05-01,17:03:00,19984.25,BUY,1,0.02h,Stop Loss,$25.25,$195.00,$214068.25,344,$195.00
2025-05-01,17:31:00,19999.25,SELL,1,0.02h,Stop Loss,$6.50,$201.50,$214074.75,344,$201.50
2025-05-01,17:37:00,20012.25,BUY,1,0.02h,Stop Loss,$-6.00,$195.50,$214068.75,344,$195.50
2025-05-01,17:39:00,19998.75,SELL,1,0.02h,Stop Loss,$31.50,$227.00,$214100.25,344,$227.00
2025-05-01,18:01:00,19982.75,BUY,1,0.02h,Stop Loss,$47.75,$274.75,$214148.00,344,$274.75
2025-05-01,18:27:00,19993.5,SELL,1,0.02h,Stop Loss,$10.25,$285.00,$214158.25,344,$285.00
2025-05-01,18:32:00,20028.75,BUY,1,0.02h,Stop Loss,$-6.00,$279.00,$214152.25,344,$279.00
2025-05-01,18:55:00,20012.25,SELL,1,0.02h,Stop Loss,$4.00,$283.00,$214156.25,344,$283.00
2025-05-01,19:20:00,20013.5,BUY,1,0.02h,Stop Loss,$26.50,$309.50,$214182.75,344,$309.50
2025-05-01,19:37:00,19997.0,SELL,1,0.02h,Stop Loss,$-6.00,$303.50,$214176.75,344,$303.50
2025-05-01,19:50:00,20008.75,BUY,1,0.02h,Stop Loss,$69.00,$372.50,$214245.75,344,$372.50
2025-05-01,19:51:00,19966.5,SELL,1,0.02h,Stop Loss,$109.00,$481.50,$214354.75,344,$481.50
2025-05-01,20:24:00,19852.25,BUY,1,0.02h,Break Even,$0.25,$481.75,$214355.00,344,$481.75
2025-05-01,20:28:00,19834.25,SELL,1,0.02h,Stop Loss,$30.25,$512.00,$214385.25,344,$512.00
2025-05-01,22:17:00,19794.75,BUY,1,0.02h,Break Even,$0.25,$512.25,$214385.50,344,$512.25
2025-05-01,22:32:00,19776.25,SELL,1,0.02h,Stop Loss,$-6.00,$506.25,$214379.50,344,$506.25
2025-05-01,22:36:00,19788.0,BUY,1,0.02h,Break Even,$0.25,$506.50,$214379.75,344,$506.50
2025-05-01,22:49:00,19784.5,SELL,1,0.02h,Stop Loss,$-6.00,$500.50,$214373.75,344,$500.50
2025-05-01,22:51:00,19790.0,BUY,1,0.02h,Break Even,$0.25,$500.75,$214374.00,344,$500.75
Final P&L Day: 500.75,,,,,,,,,,,
2025-05-02,13:26:00,20093.0,SELL,1,0.02h,Stop Loss,$22.75,$22.75,$214396.75,345,$22.75
2025-05-02,13:45:00,20100.25,BUY,1,0.02h,Stop Loss,$60.25,$83.00,$214457.00,345,$83.00
2025-05-02,13:48:00,20071.5,SELL,1,0.02h,Stop Loss,$110.25,$193.25,$214567.25,345,$193.25
2025-05-02,14:03:00,20104.0,BUY,1,0.02h,Stop Loss,$154.00,$347.25,$214721.25,345,$347.25
2025-05-02,14:44:00,20142.75,SELL,1,0.02h,Stop Loss,$10.25,$357.50,$214731.50,345,$357.50
2025-05-02,14:47:00,20159.25,BUY,1,0.02h,Stop Loss,$-6.00,$351.50,$214725.50,345,$351.50
2025-05-02,14:53:00,20141.5,SELL,1,0.02h,Stop Loss,$77.75,$429.25,$214803.25,345,$429.25
2025-05-02,14:57:00,20150.25,BUY,1,0.02h,Stop Loss,$-6.00,$423.25,$214797.25,345,$423.25
2025-05-02,14:58:00,20143.0,SELL,1,0.02h,Stop Loss,$4.00,$427.25,$214801.25,345,$427.25
2025-05-02,15:00:00,20166.0,BUY,1,0.02h,Stop Loss,$46.50,$473.75,$214847.75,345,$473.75
2025-05-02,15:25:00,20161.75,SELL,1,0.02h,Stop Loss,$47.75,$521.50,$214895.50,345,$521.50
2025-05-02,15:39:00,20173.25,BUY,1,0.02h,Break Even,$0.25,$521.75,$214895.75,345,$521.75
2025-05-02,16:30:00,20224.0,SELL,1,0.02h,Break Even,$0.25,$522.00,$214896.00,345,$522.00
2025-05-02,16:37:00,20246.0,BUY,1,0.02h,Stop Loss,$84.00,$606.00,$214980.00,345,$606.00
2025-05-02,16:58:00,20243.75,SELL,1,0.02h,Break Even,$0.25,$606.25,$214980.25,345,$606.25
2025-05-02,17:40:00,20219.0,BUY,1,0.02h,Stop Loss,$-6.00,$600.25,$214974.25,345,$600.25
2025-05-02,17:41:00,20204.25,SELL,1,0.02h,Stop Loss,$-6.00,$594.25,$214968.25,345,$594.25
2025-05-02,17:43:00,20217.25,BUY,1,0.02h,Break Even,$0.25,$594.50,$214968.50,345,$594.50
2025-05-02,17:52:00,20212.25,SELL,1,0.02h,Stop Loss,$-6.00,$588.50,$214962.50,345,$588.50
2025-05-02,17:54:00,20225.0,BUY,1,0.02h,Break Even,$0.25,$588.75,$214962.75,345,$588.75
2025-05-02,18:48:00,20242.75,SELL,1,0.02h,Stop Loss,$61.50,$650.25,$215024.25,345,$650.25
2025-05-02,19:22:00,20229.25,BUY,1,0.02h,Stop Loss,$16.50,$666.75,$215040.75,345,$666.75
2025-05-02,19:35:00,20211.5,SELL,1,0.02h,Stop Loss,$84.00,$750.75,$215124.75,345,$750.75
2025-05-02,20:06:00,20211.25,BUY,1,0.02h,Stop Loss,$21.50,$772.25,$215146.25,345,$772.25
2025-05-02,20:18:00,20193.25,SELL,1,0.02h,Stop Loss,$-6.00,$766.25,$215140.25,345,$766.25
2025-05-02,20:56:00,20202.25,BUY,1,0.02h,Break Even,$0.25,$766.50,$215140.50,345,$766.50
Final P&L Day: 766.50,,,,,,,,,,,
2025-05-05,12:00:00,19980.75,SELL,1,0.02h,Stop Loss,$-6.00,$-6.00,$215134.50,346,$-6.00
2025-05-05,12:54:00,20000.5,BUY,1,0.02h,Stop Loss,$14.00,$8.00,$215148.50,346,$8.00
2025-05-05,13:16:00,19995.25,SELL,1,0.02h,Stop Loss,$-6.00,$2.00,$215142.50,346,$2.00
2025-05-05,13:22:00,20005.0,BUY,1,0.02h,Stop Loss,$5.25,$7.25,$215147.75,346,$7.25
2025-05-05,13:28:00,19999.0,SELL,1,0.02h,Stop Loss,$-6.00,$1.25,$215141.75,346,$1.25
2025-05-05,13:29:00,20015.75,BUY,1,0.02h,Stop Loss,$-6.00,$-4.75,$215135.75,346,$-4.75
2025-05-05,14:25:00,20050.5,SELL,1,0.02h,Break Even,$0.25,$-4.50,$215136.00,346,$-4.50
2025-05-05,14:41:00,20073.0,BUY,1,0.02h,Stop Loss,$55.25,$50.75,$215191.25,346,$50.75
2025-05-05,15:16:00,20090.5,SELL,1,0.02h,Stop Loss,$26.50,$77.25,$215217.75,346,$77.25
2025-05-05,15:21:00,20103.0,BUY,1,0.02h,Stop Loss,$56.50,$133.75,$215274.25,346,$133.75
2025-05-05,15:29:00,20095.75,SELL,1,0.02h,Break Even,$0.25,$134.00,$215274.50,346,$134.00
2025-05-05,15:31:00,20105.75,BUY,1,0.02h,Stop Loss,$-6.00,$128.00,$215268.50,346,$128.00
2025-05-05,15:32:00,20096.5,SELL,1,0.02h,Stop Loss,$51.50,$179.50,$215320.00,346,$179.50
2025-05-05,15:53:00,20100.5,BUY,1,0.02h,Stop Loss,$17.75,$197.25,$215337.75,346,$197.25
2025-05-05,17:01:00,20124.0,SELL,1,0.02h,Break Even,$0.25,$197.50,$215338.00,346,$197.50
2025-05-05,17:28:00,20129.0,BUY,1,0.02h,Stop Loss,$6.50,$204.00,$215344.50,346,$204.00
2025-05-05,18:55:00,20169.5,SELL,1,0.02h,Stop Loss,$29.00,$233.00,$215373.50,346,$233.00
2025-05-05,19:39:00,20133.5,BUY,1,0.02h,Stop Loss,$-6.00,$227.00,$215367.50,346,$227.00
2025-05-05,19:44:00,20114.0,SELL,1,0.02h,Stop Loss,$60.25,$287.25,$215427.75,346,$287.25
2025-05-05,20:45:00,20028.0,BUY,1,0.02h,Stop Loss,$27.75,$315.00,$215455.50,346,$315.00
2025-05-05,22:03:00,20030.25,SELL,1,0.02h,Stop Loss,$26.50,$341.50,$215482.00,346,$341.50
2025-05-05,22:17:00,20033.75,BUY,1,0.02h,Break Even,$0.25,$341.75,$215482.25,346,$341.75
2025-05-05,22:29:00,20027.0,SELL,1,0.02h,Stop Loss,$-6.00,$335.75,$215476.25,346,$335.75
2025-05-05,22:37:00,20030.75,BUY,1,0.02h,Stop Loss,$4.00,$339.75,$215480.25,346,$339.75
2025-05-05,22:45:00,20024.0,SELL,1,0.02h,Stop Loss,$-6.00,$333.75,$215474.25,346,$333.75
Final P&L Day: 333.75,,,,,,,,,,,
2025-05-06,12:52:00,19831.75,BUY,1,0.02h,Break Even,$0.25,$0.25,$215474.50,347,$0.25
2025-05-06,13:07:00,19824.0,SELL,1,0.02h,Stop Loss,$31.50,$31.75,$215506.00,347,$31.75
2025-05-06,13:34:00,19828.75,BUY,1,0.02h,Stop Loss,$52.75,$84.50,$215558.75,347,$84.50
2025-05-06,13:50:00,19799.5,SELL,1,0.02h,Stop Loss,$60.25,$144.75,$215619.00,347,$144.75
2025-05-06,14:09:00,19813.5,BUY,1,0.02h,Stop Loss,$49.00,$193.75,$215668.00,347,$193.75
2025-05-06,15:11:00,19896.75,SELL,1,0.02h,Stop Loss,$-6.00,$187.75,$215662.00,347,$187.75
2025-05-06,15:16:00,19915.0,BUY,1,0.02h,Stop Loss,$-6.00,$181.75,$215656.00,347,$181.75
2025-05-06,15:17:00,19905.0,SELL,1,0.02h,Break Even,$0.25,$182.00,$215656.25,347,$182.00
2025-05-06,15:18:00,19916.75,BUY,1,0.02h,Stop Loss,$27.75,$209.75,$215684.00,347,$209.75
2025-05-06,15:43:00,19911.25,SELL,1,0.02h,Stop Loss,$21.50,$231.25,$215705.50,347,$231.25
2025-05-06,16:13:00,19946.25,BUY,1,0.02h,Stop Loss,$237.75,$469.00,$215943.25,347,$469.00
2025-05-06,16:25:00,19903.25,SELL,1,0.02h,Stop Loss,$5.25,$474.25,$215948.50,347,$474.25
2025-05-06,16:41:00,19932.5,BUY,1,0.02h,Stop Loss,$6.50,$480.75,$215955.00,347,$480.75
2025-05-06,16:44:00,19915.5,SELL,1,0.02h,Stop Loss,$101.50,$582.25,$216056.50,347,$582.25
2025-05-06,17:09:00,19907.5,BUY,1,0.02h,Stop Loss,$45.25,$627.50,$216101.75,347,$627.50
2025-05-06,17:22:00,19876.5,SELL,1,0.02h,Stop Loss,$24.00,$651.50,$216125.75,347,$651.50
2025-05-06,17:34:00,19897.75,BUY,1,0.02h,Stop Loss,$17.75,$669.25,$216143.50,347,$669.25
2025-05-06,17:39:00,19881.0,SELL,1,0.02h,Stop Loss,$66.50,$735.75,$216210.00,347,$735.75
2025-05-06,18:03:00,19884.5,BUY,1,0.02h,Stop Loss,$5.25,$741.00,$216215.25,347,$741.00
2025-05-06,19:09:00,19925.75,SELL,1,0.02h,Break Even,$0.25,$741.25,$216215.50,347,$741.25
2025-05-06,19:16:00,19940.75,BUY,1,0.02h,Stop Loss,$17.75,$759.00,$216233.25,347,$759.00
2025-05-06,19:21:00,19926.75,SELL,1,0.02h,Break Even,$0.25,$759.25,$216233.50,347,$759.25
2025-05-06,19:27:00,19938.0,BUY,1,0.02h,Stop Loss,$17.75,$777.00,$216251.25,347,$777.00
2025-05-06,19:52:00,19922.75,SELL,1,0.02h,Stop Loss,$56.50,$833.50,$216307.75,347,$833.50
2025-05-06,20:53:00,19856.75,BUY,1,0.02h,Break Even,$0.25,$833.75,$216308.00,347,$833.75
2025-05-06,21:00:00,19846.25,SELL,1,1.02h,Stop Loss,$209.00,$1042.75,$216517.00,347,$1042.75
2025-05-06,22:01:00,19953.0,BUY,1,0.02h,Stop Loss,$679.00,$1721.75,$217196.00,347,$1721.75
2025-05-06,22:38:00,20008.5,SELL,1,0.02h,Break Even,$0.25,$1722.00,$217196.25,347,$1722.00
2025-05-06,22:50:00,20052.75,BUY,1,0.02h,Stop Loss,$79.00,$1801.00,$217275.25,347,$1801.00
Final P&L Day: 1801.00,,,,,,,,,,,
2025-05-07,12:00:00,19996.25,SELL,1,0.02h,Break Even,$0.25,$0.25,$217275.50,348,$0.25
2025-05-07,12:45:00,19944.0,BUY,1,0.02h,Stop Loss,$11.50,$11.75,$217287.00,348,$11.75
2025-05-07,12:59:00,19930.25,SELL,1,0.02h,Stop Loss,$-6.00,$5.75,$217281.00,348,$5.75
2025-05-07,13:42:00,19915.0,BUY,1,0.02h,Stop Loss,$30.25,$36.00,$217311.25,348,$36.00
2025-05-07,13:51:00,19877.25,SELL,1,0.02h,Stop Loss,$-6.00,$30.00,$217305.25,348,$30.00
2025-05-07,13:56:00,19921.75,BUY,1,0.02h,Stop Loss,$27.75,$57.75,$217333.00,348,$57.75
2025-05-07,14:47:00,19952.75,SELL,1,0.02h,Stop Loss,$57.75,$115.50,$217390.75,348,$115.50
2025-05-07,15:41:00,19830.5,BUY,1,0.02h,Stop Loss,$45.25,$160.75,$217436.00,348,$160.75
2025-05-07,15:50:00,19796.75,SELL,1,0.02h,Stop Loss,$44.00,$204.75,$217480.00,348,$204.75
2025-05-07,15:54:00,19840.75,BUY,1,0.02h,Stop Loss,$12.75,$217.50,$217492.75,348,$217.50
2025-05-07,16:22:00,19823.0,SELL,1,0.02h,Stop Loss,$45.25,$262.75,$217538.00,348,$262.75
2025-05-07,16:40:00,19841.25,BUY,1,0.02h,Stop Loss,$70.25,$333.00,$217608.25,348,$333.00
2025-05-07,17:22:00,19886.25,SELL,1,0.02h,Break Even,$0.25,$333.25,$217608.50,348,$333.25
2025-05-07,17:25:00,19908.0,BUY,1,0.02h,Stop Loss,$9.00,$342.25,$217617.50,348,$342.25
2025-05-07,17:34:00,19889.0,SELL,1,0.02h,Break Even,$0.25,$342.50,$217617.75,348,$342.50
2025-05-07,18:28:00,19781.75,BUY,1,0.02h,Stop Loss,$11.50,$354.00,$217629.25,348,$354.00
2025-05-07,18:50:00,19777.25,SELL,1,0.02h,Stop Loss,$64.00,$418.00,$217693.25,348,$418.00
2025-05-07,18:57:00,19860.25,BUY,1,0.02h,Stop Loss,$201.50,$619.50,$217894.75,348,$619.50
2025-05-07,19:25:00,19832.0,SELL,1,0.02h,Stop Loss,$127.75,$747.25,$218022.50,348,$747.25
2025-05-07,19:42:00,19911.0,BUY,1,0.02h,Stop Loss,$525.25,$1272.50,$218547.75,348,$1272.50
2025-05-07,20:29:00,19943.25,SELL,1,0.02h,Break Even,$0.25,$1272.75,$218548.00,348,$1272.75
2025-05-07,20:40:00,19958.0,BUY,1,0.02h,Break Even,$0.25,$1273.00,$218548.25,348,$1273.00
2025-05-07,22:01:00,19933.0,SELL,1,0.02h,Stop Loss,$44.00,$1317.00,$218592.25,348,$1317.00
2025-05-07,22:26:00,19940.0,BUY,1,0.02h,Stop Loss,$4.00,$1321.00,$218596.25,348,$1321.00
2025-05-07,22:50:00,19942.75,SELL,1,0.02h,Break Even,$0.25,$1321.25,$218596.50,348,$1321.25
Final P&L Day: 1321.25,,,,,,,,,,,
2025-05-08,12:00:00,20198.0,BUY,1,0.02h,Stop Loss,$10.25,$10.25,$218606.75,349,$10.25
2025-05-08,12:38:00,20164.25,SELL,1,0.02h,Break Even,$0.25,$10.50,$218607.00,349,$10.50
2025-05-08,12:51:00,20200.75,BUY,1,0.02h,Stop Loss,$-6.00,$4.50,$218601.00,349,$4.50
2025-05-08,12:59:00,20176.5,SELL,1,0.02h,Break Even,$0.25,$4.75,$218601.25,349,$4.75
2025-05-08,13:22:00,20177.25,BUY,1,0.02h,Break Even,$0.25,$5.00,$218601.50,349,$5.00
2025-05-08,13:25:00,20169.5,SELL,1,0.02h,Stop Loss,$-6.00,$-1.00,$218595.50,349,$-1.00
2025-05-08,14:28:00,20091.0,BUY,1,0.02h,Stop Loss,$9.00,$8.00,$218604.50,349,$8.00
2025-05-08,14:40:00,20062.0,SELL,1,0.02h,Stop Loss,$17.75,$25.75,$218622.25,349,$25.75
2025-05-08,15:10:00,20059.25,BUY,1,0.02h,Stop Loss,$47.75,$73.50,$218670.00,349,$73.50
2025-05-08,16:29:00,20288.5,SELL,1,0.02h,Stop Loss,$17.75,$91.25,$218687.75,349,$91.25
2025-05-08,16:39:00,20306.0,BUY,1,0.02h,Stop Loss,$6.50,$97.75,$218694.25,349,$97.75
2025-05-08,17:06:00,20313.0,SELL,1,0.02h,Stop Loss,$34.00,$131.75,$218728.25,349,$131.75
2025-05-08,18:16:00,20276.5,BUY,1,0.02h,Stop Loss,$19.00,$150.75,$218747.25,349,$150.75
2025-05-08,18:56:00,20293.75,SELL,1,0.02h,Stop Loss,$21.50,$172.25,$218768.75,349,$172.25
2025-05-08,19:21:00,20298.5,BUY,1,0.02h,Stop Loss,$139.00,$311.25,$218907.75,349,$311.25
2025-05-08,19:37:00,20280.0,SELL,1,0.02h,Break Even,$0.25,$311.50,$218908.00,349,$311.50
2025-05-08,20:43:00,20163.0,BUY,1,0.02h,Break Even,$0.25,$311.75,$218908.25,349,$311.75
2025-05-08,21:00:00,20155.75,SELL,1,1.02h,Stop Loss,$-6.00,$305.75,$218902.25,349,$305.75
2025-05-08,22:01:00,20172.0,BUY,1,0.02h,Break Even,$0.25,$306.00,$218902.50,349,$306.00
2025-05-08,22:05:00,20150.75,SELL,1,0.02h,Stop Loss,$9.00,$315.00,$218911.50,349,$315.00
2025-05-08,22:17:00,20165.25,BUY,1,0.02h,Break Even,$0.25,$315.25,$218911.75,349,$315.25
2025-05-08,22:21:00,20153.0,SELL,1,0.02h,Stop Loss,$-6.00,$309.25,$218905.75,349,$309.25
2025-05-08,22:43:00,20158.0,BUY,1,0.02h,Stop Loss,$-6.00,$303.25,$218899.75,349,$303.25
Final P&L Day: 303.25,,,,,,,,,,,
2025-05-09,12:29:00,20197.75,SELL,1,0.02h,Stop Loss,$-6.00,$-6.00,$218893.75,350,$-6.00
2025-05-09,12:32:00,20216.0,BUY,1,0.02h,Stop Loss,$7.75,$1.75,$218901.50,350,$1.75
2025-05-09,13:26:00,20237.75,SELL,1,0.02h,Stop Loss,$17.75,$19.50,$218919.25,350,$19.50
2025-05-09,13:35:00,20260.5,BUY,1,0.02h,Stop Loss,$25.25,$44.75,$218944.50,350,$44.75
2025-05-09,13:45:00,20227.0,SELL,1,0.02h,Stop Loss,$19.00,$63.75,$218963.50,350,$63.75
2025-05-09,14:00:00,20254.25,BUY,1,0.02h,Break Even,$0.25,$64.00,$218963.75,350,$64.00
2025-05-09,14:16:00,20237.25,SELL,1,0.02h,Break Even,$0.25,$64.25,$218964.00,350,$64.25
2025-05-09,14:58:00,20139.0,BUY,1,0.02h,Stop Loss,$22.75,$87.00,$218986.75,350,$87.00
2025-05-09,15:23:00,20133.5,SELL,1,0.02h,Stop Loss,$51.50,$138.50,$219038.25,350,$138.50
2025-05-09,15:46:00,20144.25,BUY,1,0.02h,Stop Loss,$7.75,$146.25,$219046.00,350,$146.25
2025-05-09,16:05:00,20108.25,SELL,1,0.02h,Break Even,$0.25,$146.50,$219046.25,350,$146.50
2025-05-09,16:38:00,20131.25,BUY,1,0.02h,Stop Loss,$-6.00,$140.50,$219040.25,350,$140.50
2025-05-09,16:45:00,20107.25,SELL,1,0.02h,Stop Loss,$46.50,$187.00,$219086.75,350,$187.00
2025-05-09,17:11:00,20114.75,BUY,1,0.02h,Stop Loss,$-6.00,$181.00,$219080.75,350,$181.00
2025-05-09,17:32:00,20096.0,SELL,1,0.02h,Break Even,$0.25,$181.25,$219081.00,350,$181.25
2025-05-09,17:37:00,20113.5,BUY,1,0.02h,Stop Loss,$-6.00,$175.25,$219075.00,350,$175.25
2025-05-09,18:13:00,20139.5,SELL,1,0.02h,Stop Loss,$7.75,$183.00,$219082.75,350,$183.00
2025-05-09,18:34:00,20138.5,BUY,1,0.02h,Break Even,$0.25,$183.25,$219083.00,350,$183.25
2025-05-09,18:38:00,20130.75,SELL,1,0.02h,Stop Loss,$7.75,$191.00,$219090.75,350,$191.00
2025-05-09,18:41:00,20137.5,BUY,1,0.02h,Break Even,$0.25,$191.25,$219091.00,350,$191.25
2025-05-09,18:42:00,20128.25,SELL,1,0.02h,Break Even,$0.25,$191.50,$219091.25,350,$191.50
2025-05-09,18:48:00,20142.75,BUY,1,0.02h,Break Even,$0.25,$191.75,$219091.50,350,$191.75
2025-05-09,19:24:00,20156.75,SELL,1,0.02h,Stop Loss,$6.50,$198.25,$219098.00,350,$198.25
2025-05-09,19:44:00,20162.75,BUY,1,0.02h,Stop Loss,$-6.00,$192.25,$219092.00,350,$192.25
2025-05-09,19:46:00,20139.5,SELL,1,0.02h,Stop Loss,$6.50,$198.75,$219098.50,350,$198.75
2025-05-09,19:55:00,20164.75,BUY,1,0.02h,Stop Loss,$-6.00,$192.75,$219092.50,350,$192.75
2025-05-09,19:56:00,20138.5,SELL,1,0.02h,Stop Loss,$22.75,$215.50,$219115.25,350,$215.50
2025-05-09,20:42:00,20133.5,BUY,1,0.02h,Stop Loss,$-6.00,$209.50,$219109.25,350,$209.50
Final P&L Day: 209.50,,,,,,,,,,,
2025-05-12,12:47:00,20910.75,SELL,1,0.02h,Stop Loss,$-6.00,$-6.00,$219103.25,351,$-6.00
2025-05-12,12:52:00,20930.5,BUY,1,0.02h,Stop Loss,$-6.00,$-12.00,$219097.25,351,$-12.00
2025-05-12,13:00:00,20916.25,SELL,1,0.02h,Stop Loss,$-6.00,$-18.00,$219091.25,351,$-18.00
2025-05-12,13:01:00,20938.0,BUY,1,0.02h,Break Even,$0.25,$-17.75,$219091.50,351,$-17.75
2025-05-12,13:06:00,20910.75,SELL,1,0.02h,Stop Loss,$26.50,$8.75,$219118.00,351,$8.75
2025-05-12,13:20:00,20918.75,BUY,1,0.02h,Stop Loss,$16.50,$25.25,$219134.50,351,$25.25
2025-05-12,13:31:00,20865.5,SELL,1,0.02h,Stop Loss,$207.75,$233.00,$219342.25,351,$233.00
2025-05-12,14:08:00,20815.25,BUY,1,0.02h,Break Even,$0.25,$233.25,$219342.50,351,$233.25
2025-05-12,14:26:00,20799.0,SELL,1,0.02h,Stop Loss,$145.25,$378.50,$219487.75,351,$378.50
2025-05-12,14:45:00,20794.75,BUY,1,0.02h,Stop Loss,$20.25,$398.75,$219508.00,351,$398.75
2025-05-12,15:08:00,20775.25,SELL,1,0.02h,Stop Loss,$9.00,$407.75,$219517.00,351,$407.75
2025-05-12,15:13:00,20790.25,BUY,1,0.02h,Stop Loss,$26.50,$434.25,$219543.50,351,$434.25
2025-05-12,15:23:00,20769.0,SELL,1,0.02h,Stop Loss,$56.50,$490.75,$219600.00,351,$490.75
2025-05-12,15:31:00,20785.0,BUY,1,0.02h,Stop Loss,$45.25,$536.00,$219645.25,351,$536.00
2025-05-12,15:42:00,20765.25,SELL,1,0.02h,Break Even,$0.25,$536.25,$219645.50,351,$536.25
2025-05-12,15:49:00,20790.5,BUY,1,0.02h,Stop Loss,$-6.00,$530.25,$219639.50,351,$530.25
2025-05-12,15:51:00,20781.5,SELL,1,0.02h,Stop Loss,$100.25,$630.50,$219739.75,351,$630.50
2025-05-12,16:06:00,20785.5,BUY,1,0.02h,Stop Loss,$51.50,$682.00,$219791.25,351,$682.00
2025-05-12,17:25:00,20894.25,SELL,1,0.02h,Stop Loss,$10.25,$692.25,$219801.50,351,$692.25
2025-05-12,17:31:00,20906.75,BUY,1,0.02h,Stop Loss,$35.25,$727.50,$219836.75,351,$727.50
2025-05-12,18:11:00,20905.25,SELL,1,0.02h,Stop Loss,$39.00,$766.50,$219875.75,351,$766.50
2025-05-12,18:19:00,20924.25,BUY,1,0.02h,Stop Loss,$5.25,$771.75,$219881.00,351,$771.75
2025-05-12,18:49:00,20922.75,SELL,1,0.02h,Stop Loss,$20.25,$792.00,$219901.25,351,$792.00
2025-05-12,19:08:00,20921.75,BUY,1,0.02h,Break Even,$0.25,$792.25,$219901.50,351,$792.25
2025-05-12,19:15:00,20902.75,SELL,1,0.02h,Stop Loss,$40.25,$832.50,$219941.75,351,$832.50
2025-05-12,19:51:00,20908.75,BUY,1,0.02h,Stop Loss,$-6.00,$826.50,$219935.75,351,$826.50
2025-05-12,22:01:00,20934.5,SELL,1,0.02h,Stop Loss,$-6.00,$820.50,$219929.75,351,$820.50
Final P&L Day: 820.50,,,,,,,,,,,
2025-05-13,12:00:00,20941.5,BUY,1,0.02h,Stop Loss,$25.25,$25.25,$219955.00,352,$25.25
2025-05-13,12:48:00,20991.75,SELL,1,0.02h,Break Even,$0.25,$25.50,$219955.25,352,$25.50
2025-05-13,12:50:00,21006.0,BUY,1,0.02h,Break Even,$0.25,$25.75,$219955.50,352,$25.75
2025-05-13,13:27:00,20996.75,SELL,1,0.02h,Stop Loss,$10.25,$36.00,$219965.75,352,$36.00
2025-05-13,13:34:00,21033.5,BUY,1,0.02h,Stop Loss,$14.00,$50.00,$219979.75,352,$50.00
2025-05-13,14:45:00,21191.75,SELL,1,0.02h,Stop Loss,$10.25,$60.25,$219990.00,352,$60.25
2025-05-13,14:51:00,21228.0,BUY,1,0.02h,Break Even,$0.25,$60.50,$219990.25,352,$60.50
2025-05-13,15:54:00,21278.5,SELL,1,0.02h,Break Even,$0.25,$60.75,$219990.50,352,$60.75
2025-05-13,15:57:00,21290.0,BUY,1,0.02h,Stop Loss,$12.75,$73.50,$220003.25,352,$73.50
2025-05-13,16:01:00,21271.25,SELL,1,0.02h,Stop Loss,$6.50,$80.00,$220009.75,352,$80.00
2025-05-13,16:15:00,21288.5,BUY,1,0.02h,Stop Loss,$-6.00,$74.00,$220003.75,352,$74.00
2025-05-13,17:04:00,21316.0,SELL,1,0.02h,Stop Loss,$-6.00,$68.00,$219997.75,352,$68.00
2025-05-13,17:19:00,21326.25,BUY,1,0.02h,Break Even,$0.25,$68.25,$219998.00,352,$68.25
2025-05-13,17:22:00,21310.0,SELL,1,0.02h,Stop Loss,$-6.00,$62.25,$219992.00,352,$62.25
2025-05-13,17:28:00,21318.75,BUY,1,0.02h,Stop Loss,$-6.00,$56.25,$219986.00,352,$56.25
2025-05-13,17:29:00,21313.25,SELL,1,0.02h,Stop Loss,$-6.00,$50.25,$219980.00,352,$50.25
2025-05-13,17:31:00,21323.0,BUY,1,0.02h,Stop Loss,$35.25,$85.50,$220015.25,352,$85.50
2025-05-13,17:54:00,21319.5,SELL,1,0.02h,Stop Loss,$39.00,$124.50,$220054.25,352,$124.50
2025-05-13,18:21:00,21313.5,BUY,1,0.02h,Stop Loss,$-6.00,$118.50,$220048.25,352,$118.50
2025-05-13,18:32:00,21299.0,SELL,1,0.02h,Break Even,$0.25,$118.75,$220048.50,352,$118.75
2025-05-13,18:57:00,21315.25,BUY,1,0.02h,Stop Loss,$40.25,$159.00,$220088.75,352,$159.00
2025-05-13,19:28:00,21323.5,SELL,1,0.02h,Stop Loss,$-6.00,$153.00,$220082.75,352,$153.00
2025-05-13,19:29:00,21328.0,BUY,1,0.02h,Break Even,$0.25,$153.25,$220083.00,352,$153.25
2025-05-13,19:30:00,21321.0,SELL,1,0.02h,Stop Loss,$4.00,$157.25,$220087.00,352,$157.25
2025-05-13,19:31:00,21327.75,BUY,1,0.02h,Break Even,$0.25,$157.50,$220087.25,352,$157.50
2025-05-13,19:36:00,21318.75,SELL,1,0.02h,Stop Loss,$-6.00,$151.50,$220081.25,352,$151.50
2025-05-13,19:38:00,21337.75,BUY,1,0.02h,Stop Loss,$10.25,$161.75,$220091.50,352,$161.75
2025-05-13,19:44:00,21323.0,SELL,1,0.02h,Break Even,$0.25,$162.00,$220091.75,352,$162.00
2025-05-13,20:37:00,21260.5,BUY,1,0.02h,Break Even,$0.25,$162.25,$220092.00,352,$162.25
2025-05-13,20:56:00,21259.25,SELL,1,0.02h,Break Even,$0.25,$162.50,$220092.25,352,$162.50
2025-05-13,22:12:00,21260.75,BUY,1,0.02h,Stop Loss,$-6.00,$156.50,$220086.25,352,$156.50
2025-05-13,22:35:00,21259.75,SELL,1,0.02h,Break Even,$0.25,$156.75,$220086.50,352,$156.75
2025-05-13,22:46:00,21267.25,BUY,1,0.02h,Break Even,$0.25,$157.00,$220086.75,352,$157.00
2025-05-13,22:55:00,21261.25,SELL,1,0.02h,Stop Loss,$-6.00,$151.00,$220080.75,352,$151.00
2025-05-13,22:58:00,21264.0,BUY,1,0.02h,Stop Loss,$-6.00,$145.00,$220074.75,352,$145.00
2025-05-13,22:59:00,21260.75,SELL,1,0.02h,Break Even,$0.25,$145.25,$220075.00,352,$145.25
Final P&L Day: 145.25,,,,,,,,,,,
2025-05-14,12:00:00,21344.0,BUY,1,0.02h,Stop Loss,$9.00,$9.00,$220084.00,353,$9.00
2025-05-14,12:39:00,21338.25,SELL,1,0.02h,Stop Loss,$-6.00,$3.00,$220078.00,353,$3.00
2025-05-14,13:14:00,21335.25,BUY,1,0.02h,Stop Loss,$6.50,$9.50,$220084.50,353,$9.50
2025-05-14,13:29:00,21320.5,SELL,1,0.02h,Stop Loss,$31.50,$41.00,$220116.00,353,$41.00
2025-05-14,13:33:00,21361.25,BUY,1,0.02h,Stop Loss,$42.75,$83.75,$220158.75,353,$83.75
2025-05-14,13:47:00,21320.5,SELL,1,0.02h,Stop Loss,$74.00,$157.75,$220232.75,353,$157.75
2025-05-14,14:07:00,21340.25,BUY,1,0.02h,Break Even,$0.25,$158.00,$220233.00,353,$158.00
2025-05-14,14:21:00,21317.0,SELL,1,0.02h,Stop Loss,$30.25,$188.25,$220263.25,353,$188.25
2025-05-14,14:24:00,21332.5,BUY,1,0.02h,Stop Loss,$17.75,$206.00,$220281.00,353,$206.00
2025-05-14,14:42:00,21323.5,SELL,1,0.02h,Stop Loss,$9.00,$215.00,$220290.00,353,$215.00
2025-05-14,14:50:00,21344.25,BUY,1,0.02h,Stop Loss,$51.50,$266.50,$220341.50,353,$266.50
2025-05-14,15:04:00,21327.0,SELL,1,0.02h,Stop Loss,$150.25,$416.75,$220491.75,353,$416.75
2025-05-14,15:16:00,21344.5,BUY,1,0.02h,Stop Loss,$15.25,$432.00,$220507.00,353,$432.00
2025-05-14,15:52:00,21368.75,SELL,1,0.02h,Stop Loss,$-6.00,$426.00,$220501.00,353,$426.00
2025-05-14,15:54:00,21380.0,BUY,1,0.02h,Break Even,$0.25,$426.25,$220501.25,353,$426.25
2025-05-14,15:55:00,21368.5,SELL,1,0.02h,Stop Loss,$26.50,$452.75,$220527.75,353,$452.75
2025-05-14,15:57:00,21377.25,BUY,1,0.02h,Break Even,$0.25,$453.00,$220528.00,353,$453.00
2025-05-14,16:20:00,21370.5,SELL,1,0.02h,Stop Loss,$-6.00,$447.00,$220522.00,353,$447.00
2025-05-14,16:30:00,21384.75,BUY,1,0.02h,Stop Loss,$7.75,$454.75,$220529.75,353,$454.75
2025-05-14,16:42:00,21370.25,SELL,1,0.02h,Stop Loss,$-6.00,$448.75,$220523.75,353,$448.75
2025-05-14,17:39:00,21333.25,BUY,1,0.02h,Stop Loss,$15.25,$464.00,$220539.00,353,$464.00
2025-05-14,18:28:00,21349.25,SELL,1,0.02h,Stop Loss,$54.00,$518.00,$220593.00,353,$518.00
2025-05-14,18:35:00,21390.75,BUY,1,0.02h,Stop Loss,$5.25,$523.25,$220598.25,353,$523.25
2025-05-14,19:01:00,21361.75,SELL,1,0.02h,Stop Loss,$22.75,$546.00,$220621.00,353,$546.00
2025-05-14,19:15:00,21369.0,BUY,1,0.02h,Stop Loss,$21.50,$567.50,$220642.50,353,$567.50
2025-05-14,19:23:00,21354.0,SELL,1,0.02h,Stop Loss,$66.50,$634.00,$220709.00,353,$634.00
2025-05-14,19:51:00,21377.75,BUY,1,0.02h,Stop Loss,$42.75,$676.75,$220751.75,353,$676.75
2025-05-14,20:54:00,21398.5,SELL,1,0.02h,Stop Loss,$-6.00,$670.75,$220745.75,353,$670.75
2025-05-14,22:30:00,21378.25,BUY,1,0.02h,Break Even,$0.25,$671.00,$220746.00,353,$671.00
2025-05-14,22:46:00,21374.5,SELL,1,0.02h,Break Even,$0.25,$671.25,$220746.25,353,$671.25
2025-05-14,22:49:00,21380.25,BUY,1,0.02h,Stop Loss,$6.50,$677.75,$220752.75,353,$677.75
Final P&L Day: 677.75,,,,,,,,,,,
2025-05-15,12:00:00,21274.75,SELL,1,0.02h,Break Even,$0.25,$0.25,$220753.00,354,$0.25
2025-05-15,12:33:00,21309.0,BUY,1,0.02h,Stop Loss,$70.25,$70.50,$220823.25,354,$70.50
2025-05-15,12:50:00,21278.25,SELL,1,0.02h,Stop Loss,$42.75,$113.25,$220866.00,354,$113.25
2025-05-15,13:04:00,21301.25,BUY,1,0.02h,Stop Loss,$-6.00,$107.25,$220860.00,354,$107.25
2025-05-15,13:22:00,21294.75,SELL,1,0.02h,Stop Loss,$5.25,$112.50,$220865.25,354,$112.50
2025-05-15,13:30:00,21303.5,BUY,1,0.02h,Stop Loss,$6.50,$119.00,$220871.75,354,$119.00
2025-05-15,13:31:00,21287.25,SELL,1,0.02h,Stop Loss,$7.75,$126.75,$220879.50,354,$126.75
2025-05-15,13:32:00,21313.75,BUY,1,0.02h,Stop Loss,$90.25,$217.00,$220969.75,354,$217.00
2025-05-15,13:42:00,21294.75,SELL,1,0.02h,Stop Loss,$11.50,$228.50,$220981.25,354,$228.50
2025-05-15,13:45:00,21316.75,BUY,1,0.02h,Stop Loss,$6.50,$235.00,$220987.75,354,$235.00
2025-05-15,13:47:00,21269.0,SELL,1,0.02h,Stop Loss,$40.25,$275.25,$221028.00,354,$275.25
2025-05-15,14:01:00,21314.0,BUY,1,0.02h,Stop Loss,$149.00,$424.25,$221177.00,354,$424.25
2025-05-15,14:13:00,21297.5,SELL,1,0.02h,Stop Loss,$25.25,$449.50,$221202.25,354,$449.50
2025-05-15,14:21:00,21324.0,BUY,1,0.02h,Stop Loss,$9.00,$458.50,$221211.25,354,$458.50
2025-05-15,14:30:00,21288.5,SELL,1,0.02h,Stop Loss,$14.00,$472.50,$221225.25,354,$472.50
2025-05-15,14:46:00,21301.5,BUY,1,0.02h,Stop Loss,$15.25,$487.75,$221240.50,354,$487.75
2025-05-15,16:26:00,21432.75,SELL,1,0.02h,Stop Loss,$-6.00,$481.75,$221234.50,354,$481.75
2025-05-15,16:31:00,21441.25,BUY,1,0.02h,Stop Loss,$7.75,$489.50,$221242.25,354,$489.50
2025-05-15,16:33:00,21428.75,SELL,1,0.02h,Stop Loss,$-6.00,$483.50,$221236.25,354,$483.50
2025-05-15,16:37:00,21455.25,BUY,1,0.02h,Stop Loss,$16.50,$500.00,$221252.75,354,$500.00
2025-05-15,17:35:00,21491.5,SELL,1,0.02h,Stop Loss,$35.25,$535.25,$221288.00,354,$535.25
2025-05-15,18:33:00,21435.0,BUY,1,0.02h,Stop Loss,$9.00,$544.25,$221297.00,354,$544.25
2025-05-15,18:48:00,21411.5,SELL,1,0.02h,Stop Loss,$27.75,$572.00,$221324.75,354,$572.00
2025-05-15,19:42:00,21375.5,BUY,1,0.02h,Stop Loss,$16.50,$588.50,$221341.25,354,$588.50
2025-05-15,20:28:00,21403.75,SELL,1,0.02h,Stop Loss,$-6.00,$582.50,$221335.25,354,$582.50
2025-05-15,22:29:00,21398.25,BUY,1,0.02h,Stop Loss,$-6.00,$576.50,$221329.25,354,$576.50
2025-05-15,22:43:00,21394.25,SELL,1,0.02h,Break Even,$0.25,$576.75,$221329.50,354,$576.75
2025-05-15,22:46:00,21399.5,BUY,1,0.02h,Stop Loss,$-6.00,$570.75,$221323.50,354,$570.75
2025-05-15,22:47:00,21393.0,SELL,1,0.02h,Break Even,$0.25,$571.00,$221323.75,354,$571.00
Final P&L Day: 571.00,,,,,,,,,,,
2025-05-16,12:00:00,21481.0,BUY,1,0.02h,Stop Loss,$12.75,$12.75,$221336.50,355,$12.75
2025-05-16,12:35:00,21470.0,SELL,1,0.02h,Break Even,$0.25,$13.00,$221336.75,355,$13.00
2025-05-16,13:09:00,21453.5,BUY,1,0.02h,Stop Loss,$15.25,$28.25,$221352.00,355,$28.25
2025-05-16,13:28:00,21446.5,SELL,1,0.02h,Stop Loss,$-6.00,$22.25,$221346.00,355,$22.25
2025-05-16,13:29:00,21479.5,BUY,1,0.02h,Stop Loss,$5.25,$27.50,$221351.25,355,$27.50
2025-05-16,13:31:00,21435.25,SELL,1,0.02h,Stop Loss,$70.25,$97.75,$221421.50,355,$97.75
2025-05-16,13:57:00,21443.75,BUY,1,0.02h,Stop Loss,$-6.00,$91.75,$221415.50,355,$91.75
2025-05-16,14:01:00,21408.5,SELL,1,0.02h,Stop Loss,$11.50,$103.25,$221427.00,355,$103.25
2025-05-16,14:18:00,21438.0,BUY,1,0.02h,Stop Loss,$69.00,$172.25,$221496.00,355,$172.25
2025-05-16,14:30:00,21412.75,SELL,1,0.02h,Stop Loss,$76.50,$248.75,$221572.50,355,$248.75
2025-05-16,14:56:00,21402.75,BUY,1,0.02h,Stop Loss,$-6.00,$242.75,$221566.50,355,$242.75
2025-05-16,15:22:00,21387.0,SELL,1,0.02h,Stop Loss,$35.25,$278.00,$221601.75,355,$278.00
2025-05-16,15:29:00,21398.25,BUY,1,0.02h,Break Even,$0.25,$278.25,$221602.00,355,$278.25
2025-05-16,15:58:00,21415.75,SELL,1,0.02h,Stop Loss,$24.00,$302.25,$221626.00,355,$302.25
2025-05-16,16:02:00,21427.5,BUY,1,0.02h,Stop Loss,$15.25,$317.50,$221641.25,355,$317.50
2025-05-16,16:35:00,21425.25,SELL,1,0.02h,Stop Loss,$-6.00,$311.50,$221635.25,355,$311.50
2025-05-16,16:55:00,21438.0,BUY,1,0.02h,Stop Loss,$26.50,$338.00,$221661.75,355,$338.00
2025-05-16,17:01:00,21423.75,SELL,1,0.02h,Stop Loss,$-6.00,$332.00,$221655.75,355,$332.00
2025-05-16,17:05:00,21437.5,BUY,1,0.02h,Stop Loss,$-6.00,$326.00,$221649.75,355,$326.00
2025-05-16,17:46:00,21457.75,SELL,1,0.02h,Stop Loss,$19.00,$345.00,$221668.75,355,$345.00
2025-05-16,18:14:00,21457.5,BUY,1,0.02h,Break Even,$0.25,$345.25,$221669.00,355,$345.25
2025-05-16,19:32:00,21488.75,SELL,1,0.02h,Break Even,$0.25,$345.50,$221669.25,355,$345.50
2025-05-16,19:50:00,21493.5,BUY,1,0.02h,Stop Loss,$45.25,$390.75,$221714.50,355,$390.75
2025-05-16,20:17:00,21493.0,SELL,1,0.02h,Break Even,$0.25,$391.00,$221714.75,355,$391.00
2025-05-16,20:22:00,21501.0,BUY,1,0.02h,Break Even,$0.25,$391.25,$221715.00,355,$391.25
2025-05-16,20:43:00,21489.25,SELL,1,0.02h,Break Even,$0.25,$391.50,$221715.25,355,$391.50
Final P&L Day: 391.50,,,,,,,,,,,
2025-05-19,12:43:00,21194.5,BUY,1,0.02h,Stop Loss,$17.75,$17.75,$221733.00,356,$17.75
2025-05-19,13:08:00,21196.25,SELL,1,0.02h,Break Even,$0.25,$18.00,$221733.25,356,$18.00
2025-05-19,13:12:00,21207.5,BUY,1,0.02h,Stop Loss,$16.50,$34.50,$221749.75,356,$34.50
2025-05-19,13:14:00,21181.0,SELL,1,0.02h,Stop Loss,$109.00,$143.50,$221858.75,356,$143.50
2025-05-19,13:29:00,21196.25,BUY,1,0.02h,Stop Loss,$22.75,$166.25,$221881.50,356,$166.25
2025-05-19,14:29:00,21394.75,SELL,1,0.02h,Stop Loss,$-6.00,$160.25,$221875.50,356,$160.25
2025-05-19,14:41:00,21427.0,BUY,1,0.02h,Break Even,$0.25,$160.50,$221875.75,356,$160.50
2025-05-19,14:49:00,21396.0,SELL,1,0.02h,Stop Loss,$50.25,$210.75,$221926.00,356,$210.75
2025-05-19,15:12:00,21422.0,BUY,1,0.02h,Stop Loss,$12.75,$223.50,$221938.75,356,$223.50
2025-05-19,15:27:00,21405.0,SELL,1,0.02h,Break Even,$0.25,$223.75,$221939.00,356,$223.75
2025-05-19,15:33:00,21426.0,BUY,1,0.02h,Stop Loss,$-6.00,$217.75,$221933.00,356,$217.75
2025-05-19,15:52:00,21424.5,SELL,1,0.02h,Stop Loss,$-6.00,$211.75,$221927.00,356,$211.75
2025-05-19,16:04:00,21440.25,BUY,1,0.02h,Stop Loss,$22.75,$234.50,$221949.75,356,$234.50
2025-05-19,16:43:00,21450.5,SELL,1,0.02h,Break Even,$0.25,$234.75,$221950.00,356,$234.75
2025-05-19,16:48:00,21461.75,BUY,1,0.02h,Stop Loss,$4.00,$238.75,$221954.00,356,$238.75
2025-05-19,17:33:00,21519.25,SELL,1,0.02h,Stop Loss,$6.50,$245.25,$221960.50,356,$245.25
2025-05-19,17:34:00,21530.75,BUY,1,0.02h,Stop Loss,$44.00,$289.25,$222004.50,356,$289.25
2025-05-19,17:41:00,21518.25,SELL,1,0.02h,Break Even,$0.25,$289.50,$222004.75,356,$289.50
2025-05-19,18:36:00,21483.5,BUY,1,0.02h,Stop Loss,$19.00,$308.50,$222023.75,356,$308.50
2025-05-19,18:48:00,21472.5,SELL,1,0.02h,Stop Loss,$7.75,$316.25,$222031.50,356,$316.25
2025-05-19,18:51:00,21483.0,BUY,1,0.02h,Stop Loss,$17.75,$334.00,$222049.25,356,$334.00
2025-05-19,19:11:00,21474.25,SELL,1,0.02h,Stop Loss,$-6.00,$328.00,$222043.25,356,$328.00
2025-05-19,19:39:00,21475.25,BUY,1,0.02h,Stop Loss,$10.25,$338.25,$222053.50,356,$338.25
2025-05-19,19:45:00,21462.5,SELL,1,0.02h,Break Even,$0.25,$338.50,$222053.75,356,$338.50
2025-05-19,19:46:00,21473.25,BUY,1,0.02h,Break Even,$0.25,$338.75,$222054.00,356,$338.75
2025-05-19,20:09:00,21486.75,SELL,1,0.02h,Stop Loss,$-6.00,$332.75,$222048.00,356,$332.75
2025-05-19,20:25:00,21492.25,BUY,1,0.02h,Stop Loss,$5.25,$338.00,$222053.25,356,$338.00
2025-05-19,22:03:00,21499.75,SELL,1,0.02h,Stop Loss,$-6.00,$332.00,$222047.25,356,$332.00
2025-05-19,22:10:00,21509.0,BUY,1,0.02h,Break Even,$0.25,$332.25,$222047.50,356,$332.25
2025-05-19,22:20:00,21506.25,SELL,1,0.02h,Break Even,$0.25,$332.50,$222047.75,356,$332.50
2025-05-19,22:22:00,21510.5,BUY,1,0.02h,Break Even,$0.25,$332.75,$222048.00,356,$332.75
2025-05-19,22:28:00,21505.0,SELL,1,0.02h,Break Even,$0.25,$333.00,$222048.25,356,$333.00
Final P&L Day: 333.00,,,,,,,,,,,
2025-05-20,13:02:00,21442.5,BUY,1,0.02h,Break Even,$0.25,$0.25,$222048.50,357,$0.25
2025-05-20,13:25:00,21431.0,SELL,1,0.02h,Stop Loss,$9.00,$9.25,$222057.50,357,$9.25
2025-05-20,14:19:00,21407.25,BUY,1,0.02h,Stop Loss,$17.75,$27.00,$222075.25,357,$27.00
2025-05-20,14:33:00,21388.0,SELL,1,0.02h,Stop Loss,$16.50,$43.50,$222091.75,357,$43.50
2025-05-20,14:36:00,21407.5,BUY,1,0.02h,Break Even,$0.25,$43.75,$222092.00,357,$43.75
2025-05-20,14:59:00,21410.25,SELL,1,0.02h,Stop Loss,$22.75,$66.50,$222114.75,357,$66.50
2025-05-20,15:18:00,21424.5,BUY,1,0.02h,Break Even,$0.25,$66.75,$222115.00,357,$66.75
2025-05-20,15:25:00,21408.5,SELL,1,0.02h,Stop Loss,$9.00,$75.75,$222124.00,357,$75.75
2025-05-20,15:28:00,21423.25,BUY,1,0.02h,Break Even,$0.25,$76.00,$222124.25,357,$76.00
2025-05-20,15:36:00,21414.5,SELL,1,0.02h,Stop Loss,$5.25,$81.25,$222129.50,357,$81.25
2025-05-20,15:51:00,21420.75,BUY,1,0.02h,Stop Loss,$-6.00,$75.25,$222123.50,357,$75.25
2025-05-20,16:11:00,21411.75,SELL,1,0.02h,Stop Loss,$27.75,$103.00,$222151.25,357,$103.00
2025-05-20,16:21:00,21430.25,BUY,1,0.02h,Break Even,$0.25,$103.25,$222151.50,357,$103.25
2025-05-20,16:25:00,21413.5,SELL,1,0.02h,Stop Loss,$25.25,$128.50,$222176.75,357,$128.50
2025-05-20,16:28:00,21434.75,BUY,1,0.02h,Stop Loss,$9.00,$137.50,$222185.75,357,$137.50
2025-05-20,17:18:00,21460.25,SELL,1,0.02h,Stop Loss,$11.50,$149.00,$222197.25,357,$149.00
2025-05-20,18:05:00,21435.5,BUY,1,0.02h,Break Even,$0.25,$149.25,$222197.50,357,$149.25
2025-05-20,18:17:00,21419.5,SELL,1,0.02h,Stop Loss,$16.50,$165.75,$222214.00,357,$165.75
2025-05-20,19:15:00,21354.5,BUY,1,0.02h,Stop Loss,$-6.00,$159.75,$222208.00,357,$159.75
2025-05-20,20:11:00,21407.0,SELL,1,0.02h,Stop Loss,$-6.00,$153.75,$222202.00,357,$153.75
2025-05-20,20:21:00,21423.75,BUY,1,0.02h,Break Even,$0.25,$154.00,$222202.25,357,$154.00
2025-05-20,20:41:00,21424.25,SELL,1,0.02h,Break Even,$0.25,$154.25,$222202.50,357,$154.25
2025-05-20,22:31:00,21385.25,BUY,1,0.02h,Stop Loss,$-6.00,$148.25,$222196.50,357,$148.25
Final P&L Day: 148.25,,,,,,,,,,,
2025-05-21,12:00:00,21339.5,SELL,1,0.02h,Stop Loss,$14.00,$14.00,$222210.50,358,$14.00
2025-05-21,12:28:00,21335.25,BUY,1,0.02h,Break Even,$0.25,$14.25,$222210.75,358,$14.25
2025-05-21,12:31:00,21303.75,SELL,1,0.02h,Stop Loss,$6.50,$20.75,$222217.25,358,$20.75
2025-05-21,12:58:00,21309.25,BUY,1,0.02h,Stop Loss,$15.25,$36.00,$222232.50,358,$36.00
2025-05-21,13:07:00,21300.25,SELL,1,0.02h,Stop Loss,$24.00,$60.00,$222256.50,358,$60.00
2025-05-21,13:32:00,21324.25,BUY,1,0.02h,Stop Loss,$54.00,$114.00,$222310.50,358,$114.00
2025-05-21,14:30:00,21383.25,SELL,1,0.02h,Stop Loss,$-6.00,$108.00,$222304.50,358,$108.00
2025-05-21,14:31:00,21404.0,BUY,1,0.02h,Stop Loss,$17.75,$125.75,$222322.25,358,$125.75
2025-05-21,14:34:00,21381.25,SELL,1,0.02h,Stop Loss,$25.25,$151.00,$222347.50,358,$151.00
2025-05-21,14:40:00,21403.75,BUY,1,0.02h,Stop Loss,$51.50,$202.50,$222399.00,358,$202.50
2025-05-21,14:47:00,21390.5,SELL,1,0.02h,Stop Loss,$34.00,$236.50,$222433.00,358,$236.50
2025-05-21,14:50:00,21403.75,BUY,1,0.02h,Stop Loss,$44.00,$280.50,$222477.00,358,$280.50
2025-05-21,15:39:00,21505.25,SELL,1,0.02h,Break Even,$0.25,$280.75,$222477.25,358,$280.75
2025-05-21,15:40:00,21512.0,BUY,1,0.02h,Stop Loss,$30.25,$311.00,$222507.50,358,$311.00
2025-05-21,16:22:00,21520.5,SELL,1,0.02h,Stop Loss,$12.75,$323.75,$222520.25,358,$323.75
2025-05-21,16:31:00,21538.25,BUY,1,0.02h,Break Even,$0.25,$324.00,$222520.50,358,$324.00
2025-05-21,16:57:00,21521.0,SELL,1,0.02h,Stop Loss,$-6.00,$318.00,$222514.50,358,$318.00
2025-05-21,18:31:00,21244.25,BUY,1,0.02h,Stop Loss,$71.50,$389.50,$222586.00,358,$389.50
2025-05-21,18:49:00,21233.0,SELL,1,0.02h,Stop Loss,$117.75,$507.25,$222703.75,358,$507.25
2025-05-21,19:34:00,21155.25,BUY,1,0.02h,Break Even,$0.25,$507.50,$222704.00,358,$507.50
2025-05-21,20:00:00,21150.25,SELL,1,0.02h,Stop Loss,$52.75,$560.25,$222756.75,358,$560.25
2025-05-21,20:34:00,21142.25,BUY,1,0.02h,Stop Loss,$10.25,$570.50,$222767.00,358,$570.50
2025-05-21,22:09:00,21122.5,SELL,1,0.02h,Stop Loss,$4.00,$574.50,$222771.00,358,$574.50
2025-05-21,22:25:00,21142.0,BUY,1,0.02h,Stop Loss,$-6.00,$568.50,$222765.00,358,$568.50
2025-05-21,22:46:00,21139.5,SELL,1,0.02h,Stop Loss,$15.25,$583.75,$222780.25,358,$583.75
2025-05-21,22:59:00,21148.0,BUY,1,0.02h,Break Even,$0.25,$584.00,$222780.50,358,$584.00
Final P&L Day: 584.00,,,,,,,,,,,
2025-05-22,12:00:00,21082.25,SELL,1,0.02h,Break Even,$0.25,$0.25,$222780.75,359,$0.25
2025-05-22,12:36:00,21092.5,BUY,1,0.02h,Stop Loss,$32.75,$33.00,$222813.50,359,$33.00
2025-05-22,13:20:00,21170.0,SELL,1,0.02h,Stop Loss,$6.50,$39.50,$222820.00,359,$39.50
2025-05-22,13:51:00,21199.75,BUY,1,0.02h,Stop Loss,$49.00,$88.50,$222869.00,359,$88.50
2025-05-22,14:20:00,21261.5,SELL,1,0.02h,Stop Loss,$50.25,$138.75,$222919.25,359,$138.75
2025-05-22,15:03:00,21240.5,BUY,1,0.02h,Stop Loss,$6.50,$145.25,$222925.75,359,$145.25
2025-05-22,15:17:00,21215.0,SELL,1,0.02h,Stop Loss,$21.50,$166.75,$222947.25,359,$166.75
2025-05-22,15:22:00,21256.25,BUY,1,0.02h,Break Even,$0.25,$167.00,$222947.50,359,$167.00
2025-05-22,15:30:00,21207.0,SELL,1,0.02h,Stop Loss,$32.75,$199.75,$222980.25,359,$199.75
2025-05-22,15:36:00,21249.75,BUY,1,0.02h,Break Even,$0.25,$200.00,$222980.50,359,$200.00
2025-05-22,15:37:00,21233.0,SELL,1,0.02h,Break Even,$0.25,$200.25,$222980.75,359,$200.25
2025-05-22,15:38:00,21242.0,BUY,1,0.02h,Stop Loss,$64.00,$264.25,$223044.75,359,$264.25
2025-05-22,16:26:00,21278.5,SELL,1,0.02h,Stop Loss,$61.50,$325.75,$223106.25,359,$325.75
2025-05-22,17:19:00,21240.75,BUY,1,0.02h,Break Even,$0.25,$326.00,$223106.50,359,$326.00
2025-05-22,18:31:00,21286.75,SELL,1,0.02h,Stop Loss,$-6.00,$320.00,$223100.50,359,$320.00
2025-05-22,18:34:00,21298.25,BUY,1,0.02h,Break Even,$0.25,$320.25,$223100.75,359,$320.25
2025-05-22,18:39:00,21286.25,SELL,1,0.02h,Stop Loss,$19.00,$339.25,$223119.75,359,$339.25
2025-05-22,18:53:00,21305.5,BUY,1,0.02h,Stop Loss,$-6.00,$333.25,$223113.75,359,$333.25
2025-05-22,19:22:00,21307.25,SELL,1,0.02h,Break Even,$0.25,$333.50,$223114.00,359,$333.50
2025-05-22,19:28:00,21326.0,BUY,1,0.02h,Break Even,$0.25,$333.75,$223114.25,359,$333.75
2025-05-22,19:34:00,21296.25,SELL,1,0.02h,Break Even,$0.25,$334.00,$223114.50,359,$334.00
2025-05-22,20:38:00,21191.0,BUY,1,0.02h,Break Even,$0.25,$334.25,$223114.75,359,$334.25
2025-05-22,22:14:00,21200.5,SELL,1,0.02h,Stop Loss,$-6.00,$328.25,$223108.75,359,$328.25
Final P&L Day: 328.25,,,,,,,,,,,
2025-05-23,12:36:00,20828.75,BUY,1,0.02h,Break Even,$0.25,$0.25,$223109.00,360,$0.25
2025-05-23,12:53:00,20797.25,SELL,1,0.02h,Stop Loss,$15.25,$15.50,$223124.25,360,$15.50
2025-05-23,13:12:00,20805.25,BUY,1,0.02h,Stop Loss,$-6.00,$9.50,$223118.25,360,$9.50
2025-05-23,13:14:00,20779.5,SELL,1,0.02h,Break Even,$0.25,$9.75,$223118.50,360,$9.75
2025-05-23,13:19:00,20794.0,BUY,1,0.02h,Stop Loss,$64.00,$73.75,$223182.50,360,$73.75
2025-05-23,13:22:00,20779.5,SELL,1,0.02h,Stop Loss,$4.00,$77.75,$223186.50,360,$77.75
2025-05-23,13:26:00,20816.75,BUY,1,0.02h,Stop Loss,$69.00,$146.75,$223255.50,360,$146.75
2025-05-23,13:54:00,20858.25,SELL,1,0.02h,Stop Loss,$35.25,$182.00,$223290.75,360,$182.00
2025-05-23,13:58:00,20877.0,BUY,1,0.02h,Stop Loss,$45.25,$227.25,$223336.00,360,$227.25
2025-05-23,14:52:00,20941.25,SELL,1,0.02h,Stop Loss,$45.25,$272.50,$223381.25,360,$272.50
2025-05-23,15:21:00,20942.75,BUY,1,0.02h,Stop Loss,$50.25,$322.75,$223431.50,360,$322.75
2025-05-23,15:53:00,20945.75,SELL,1,0.02h,Stop Loss,$14.00,$336.75,$223445.50,360,$336.75
2025-05-23,16:22:00,20962.0,BUY,1,0.02h,Stop Loss,$35.25,$372.00,$223480.75,360,$372.00
2025-05-23,16:34:00,20942.75,SELL,1,0.02h,Stop Loss,$15.25,$387.25,$223496.00,360,$387.25
2025-05-23,16:38:00,20978.75,BUY,1,0.02h,Stop Loss,$5.25,$392.50,$223501.25,360,$392.50
2025-05-23,17:41:00,21027.0,SELL,1,0.02h,Stop Loss,$-6.00,$386.50,$223495.25,360,$386.50
2025-05-23,17:52:00,21058.75,BUY,1,0.02h,Stop Loss,$54.00,$440.50,$223549.25,360,$440.50
2025-05-23,18:20:00,21041.75,SELL,1,0.02h,Stop Loss,$112.75,$553.25,$223662.00,360,$553.25
2025-05-23,18:36:00,21064.25,BUY,1,0.02h,Break Even,$0.25,$553.50,$223662.25,360,$553.50
2025-05-23,18:46:00,21041.75,SELL,1,0.02h,Stop Loss,$54.00,$607.50,$223716.25,360,$607.50
2025-05-23,18:56:00,21052.75,BUY,1,0.02h,Break Even,$0.25,$607.75,$223716.50,360,$607.75
2025-05-23,18:58:00,21042.0,SELL,1,0.02h,Stop Loss,$30.25,$638.00,$223746.75,360,$638.00
2025-05-23,19:11:00,21048.5,BUY,1,0.02h,Stop Loss,$77.75,$715.75,$223824.50,360,$715.75
2025-05-23,19:20:00,21028.75,SELL,1,0.02h,Stop Loss,$29.00,$744.75,$223853.50,360,$744.75
2025-05-23,19:38:00,21030.75,BUY,1,0.02h,Stop Loss,$50.25,$795.00,$223903.75,360,$795.00
2025-05-23,19:49:00,21013.75,SELL,1,0.02h,Stop Loss,$26.50,$821.50,$223930.25,360,$821.50
2025-05-23,20:58:00,20946.25,BUY,1,0.02h,Stop Loss,$42.75,$864.25,$223973.00,360,$864.25
Final P&L Day: 864.25,,,,,,,,,,,
2025-05-26,12:49:00,21267.75,SELL,1,0.02h,Break Even,$0.25,$0.25,$223973.25,361,$0.25
2025-05-26,12:53:00,21273.25,BUY,1,0.02h,Stop Loss,$-6.00,$-5.75,$223967.25,361,$-5.75
2025-05-26,12:59:00,21264.25,SELL,1,0.02h,Stop Loss,$6.50,$0.75,$223973.75,361,$0.75
2025-05-26,13:03:00,21277.25,BUY,1,0.02h,Stop Loss,$-6.00,$-5.25,$223967.75,361,$-5.25
2025-05-26,13:08:00,21268.5,SELL,1,0.02h,Stop Loss,$-6.00,$-11.25,$223961.75,361,$-11.25
2025-05-26,13:12:00,21278.0,BUY,1,0.02h,Break Even,$0.25,$-11.00,$223962.00,361,$-11.00
2025-05-26,13:21:00,21264.5,SELL,1,0.02h,Break Even,$0.25,$-10.75,$223962.25,361,$-10.75
2025-05-26,13:33:00,21288.25,BUY,1,0.02h,Stop Loss,$60.25,$49.50,$224022.50,361,$49.50
2025-05-26,13:56:00,21278.25,SELL,1,0.02h,Stop Loss,$4.00,$53.50,$224026.50,361,$53.50
2025-05-26,15:20:00,21236.75,BUY,1,0.02h,Stop Loss,$7.75,$61.25,$224034.25,361,$61.25
2025-05-26,16:26:00,21272.75,SELL,1,0.02h,Break Even,$0.25,$61.50,$224034.50,361,$61.50
2025-05-26,16:40:00,21277.5,BUY,1,0.02h,Stop Loss,$-6.00,$55.50,$224028.50,361,$55.50
2025-05-26,22:02:00,21270.5,SELL,1,0.02h,Stop Loss,$52.75,$108.25,$224081.25,361,$108.25
2025-05-26,22:17:00,21278.0,BUY,1,0.02h,Stop Loss,$-6.00,$102.25,$224075.25,361,$102.25
2025-05-26,22:20:00,21270.75,SELL,1,0.02h,Stop Loss,$35.25,$137.50,$224110.50,361,$137.50
Final P&L Day: 137.50,,,,,,,,,,,
2025-05-27,12:00:00,21297.0,BUY,1,0.02h,Break Even,$0.25,$0.25,$224110.75,362,$0.25
2025-05-27,12:41:00,21278.25,SELL,1,0.02h,Stop Loss,$15.25,$15.50,$224126.00,362,$15.50
2025-05-27,13:03:00,21281.75,BUY,1,0.02h,Break Even,$0.25,$15.75,$224126.25,362,$15.75
2025-05-27,13:28:00,21266.0,SELL,1,0.02h,Stop Loss,$30.25,$46.00,$224156.50,362,$46.00
2025-05-27,13:50:00,21265.75,BUY,1,0.02h,Stop Loss,$64.00,$110.00,$224220.50,362,$110.00
2025-05-27,14:57:00,21363.5,SELL,1,0.02h,Break Even,$0.25,$110.25,$224220.75,362,$110.25
2025-05-27,15:12:00,21373.75,BUY,1,0.02h,Break Even,$0.25,$110.50,$224221.00,362,$110.50
2025-05-27,15:42:00,21375.5,SELL,1,0.02h,Stop Loss,$-6.00,$104.50,$224215.00,362,$104.50
2025-05-27,15:46:00,21385.5,BUY,1,0.02h,Break Even,$0.25,$104.75,$224215.25,362,$104.75
2025-05-27,17:34:00,21448.5,SELL,1,0.02h,Break Even,$0.25,$105.00,$224215.50,362,$105.00
2025-05-27,17:41:00,21456.5,BUY,1,0.02h,Stop Loss,$6.50,$111.50,$224222.00,362,$111.50
2025-05-27,18:19:00,21467.25,SELL,1,0.02h,Stop Loss,$-6.00,$105.50,$224216.00,362,$105.50
2025-05-27,19:25:00,21444.25,BUY,1,0.02h,Stop Loss,$-6.00,$99.50,$224210.00,362,$99.50
2025-05-27,19:28:00,21437.75,SELL,1,0.02h,Break Even,$0.25,$99.75,$224210.25,362,$99.75
2025-05-27,19:43:00,21442.75,BUY,1,0.02h,Stop Loss,$-6.00,$93.75,$224204.25,362,$93.75
2025-05-27,19:50:00,21426.5,SELL,1,0.02h,Stop Loss,$39.00,$132.75,$224243.25,362,$132.75
2025-05-27,19:54:00,21436.0,BUY,1,0.02h,Stop Loss,$89.00,$221.75,$224332.25,362,$221.75
2025-05-27,20:34:00,21464.0,SELL,1,0.02h,Break Even,$0.25,$222.00,$224332.50,362,$222.00
2025-05-27,20:36:00,21468.25,BUY,1,0.02h,Stop Loss,$-6.00,$216.00,$224326.50,362,$216.00
2025-05-27,22:03:00,21466.5,SELL,1,0.02h,Stop Loss,$-6.00,$210.00,$224320.50,362,$210.00
2025-05-27,22:42:00,21464.0,BUY,1,0.02h,Stop Loss,$-6.00,$204.00,$224314.50,362,$204.00
Final P&L Day: 204.00,,,,,,,,,,,
2025-05-28,12:52:00,21507.75,SELL,1,0.02h,Break Even,$0.25,$0.25,$224314.75,363,$0.25
2025-05-28,13:14:00,21516.25,BUY,1,0.02h,Break Even,$0.25,$0.50,$224315.00,363,$0.50
2025-05-28,13:18:00,21503.0,SELL,1,0.02h,Stop Loss,$-6.00,$-5.50,$224309.00,363,$-5.50
2025-05-28,13:34:00,21511.75,BUY,1,0.02h,Stop Loss,$57.75,$52.25,$224366.75,363,$52.25
2025-05-28,13:49:00,21491.5,SELL,1,0.02h,Stop Loss,$47.75,$100.00,$224414.50,363,$100.00
2025-05-28,15:05:00,21467.0,BUY,1,0.02h,Break Even,$0.25,$100.25,$224414.75,363,$100.25
2025-05-28,15:15:00,21438.25,SELL,1,0.02h,Stop Loss,$-6.00,$94.25,$224408.75,363,$94.25
2025-05-28,15:18:00,21454.0,BUY,1,0.02h,Stop Loss,$19.00,$113.25,$224427.75,363,$113.25
2025-05-28,15:35:00,21451.75,SELL,1,0.02h,Stop Loss,$6.50,$119.75,$224434.25,363,$119.75
2025-05-28,15:54:00,21461.75,BUY,1,0.02h,Break Even,$0.25,$120.00,$224434.50,363,$120.00
2025-05-28,15:57:00,21447.0,SELL,1,0.02h,Break Even,$0.25,$120.25,$224434.75,363,$120.25
2025-05-28,16:04:00,21462.25,BUY,1,0.02h,Break Even,$0.25,$120.50,$224435.00,363,$120.50
2025-05-28,16:47:00,21467.75,SELL,1,0.02h,Stop Loss,$-6.00,$114.50,$224429.00,363,$114.50
2025-05-28,16:48:00,21474.0,BUY,1,0.02h,Stop Loss,$-6.00,$108.50,$224423.00,363,$108.50
2025-05-28,16:53:00,21458.0,SELL,1,0.02h,Stop Loss,$9.00,$117.50,$224432.00,363,$117.50
2025-05-28,17:04:00,21475.75,BUY,1,0.02h,Break Even,$0.25,$117.75,$224432.25,363,$117.75
2025-05-28,17:27:00,21469.5,SELL,1,0.02h,Break Even,$0.25,$118.00,$224432.50,363,$118.00
2025-05-28,17:56:00,21476.25,BUY,1,0.02h,Break Even,$0.25,$118.25,$224432.75,363,$118.25
2025-05-28,18:21:00,21473.25,SELL,1,0.02h,Break Even,$0.25,$118.50,$224433.00,363,$118.50
2025-05-28,18:34:00,21488.75,BUY,1,0.02h,Stop Loss,$-6.00,$112.50,$224427.00,363,$112.50
2025-05-28,18:50:00,21479.0,SELL,1,0.02h,Stop Loss,$4.00,$116.50,$224431.00,363,$116.50
2025-05-28,19:04:00,21480.75,BUY,1,0.02h,Stop Loss,$12.75,$129.25,$224443.75,363,$129.25
2025-05-28,19:18:00,21460.25,SELL,1,0.02h,Break Even,$0.25,$129.50,$224444.00,363,$129.50
2025-05-28,20:17:00,21393.75,BUY,1,0.02h,Break Even,$0.25,$129.75,$224444.25,363,$129.75
2025-05-28,22:32:00,21511.75,SELL,1,0.02h,Stop Loss,$-6.00,$123.75,$224438.25,363,$123.75
2025-05-28,22:33:00,21515.75,BUY,1,0.02h,Stop Loss,$-6.00,$117.75,$224432.25,363,$117.75
Final P&L Day: 117.75,,,,,,,,,,,
2025-05-29,12:42:00,21638.5,SELL,1,0.02h,Stop Loss,$35.25,$35.25,$224467.50,364,$35.25
2025-05-29,12:54:00,21660.75,BUY,1,0.02h,Stop Loss,$9.00,$44.25,$224476.50,364,$44.25
2025-05-29,12:59:00,21641.25,SELL,1,0.02h,Stop Loss,$-6.00,$38.25,$224470.50,364,$38.25
2025-05-29,13:06:00,21655.5,BUY,1,0.02h,Stop Loss,$36.50,$74.75,$224507.00,364,$74.75
2025-05-29,13:31:00,21649.5,SELL,1,0.02h,Stop Loss,$171.50,$246.25,$224678.50,364,$246.25
2025-05-29,14:31:00,21457.0,BUY,1,0.02h,Stop Loss,$64.00,$310.25,$224742.50,364,$310.25
2025-05-29,15:14:00,21477.0,SELL,1,0.02h,Stop Loss,$74.00,$384.25,$224816.50,364,$384.25
2025-05-29,15:27:00,21497.0,BUY,1,0.02h,Break Even,$0.25,$384.50,$224816.75,364,$384.50
2025-05-29,15:33:00,21447.25,SELL,1,0.02h,Stop Loss,$32.75,$417.25,$224849.50,364,$417.25
2025-05-29,16:16:00,21416.75,BUY,1,0.02h,Stop Loss,$30.25,$447.50,$224879.75,364,$447.50
2025-05-29,17:16:00,21440.75,SELL,1,0.02h,Stop Loss,$5.25,$452.75,$224885.00,364,$452.75
2025-05-29,18:14:00,21400.5,BUY,1,0.02h,Stop Loss,$5.25,$458.00,$224890.25,364,$458.00
2025-05-29,18:17:00,21380.25,SELL,1,0.02h,Stop Loss,$41.50,$499.50,$224931.75,364,$499.50
2025-05-29,18:37:00,21380.0,BUY,1,0.02h,Break Even,$0.25,$499.75,$224932.00,364,$499.75
2025-05-29,19:00:00,21362.75,SELL,1,0.02h,Stop Loss,$14.00,$513.75,$224946.00,364,$513.75
2025-05-29,19:05:00,21382.0,BUY,1,0.02h,Break Even,$0.25,$514.00,$224946.25,364,$514.00
2025-05-29,19:07:00,21356.0,SELL,1,0.02h,Stop Loss,$44.00,$558.00,$224990.25,364,$558.00
2025-05-29,19:21:00,21385.5,BUY,1,0.02h,Stop Loss,$29.00,$587.00,$225019.25,364,$587.00
2025-05-29,20:06:00,21376.5,SELL,1,0.02h,Stop Loss,$16.50,$603.50,$225035.75,364,$603.50
2025-05-29,20:20:00,21405.0,BUY,1,0.02h,Break Even,$0.25,$603.75,$225036.00,364,$603.75
2025-05-29,20:44:00,21396.0,SELL,1,0.02h,Stop Loss,$-6.00,$597.75,$225030.00,364,$597.75
2025-05-29,22:13:00,21389.0,BUY,1,0.02h,Stop Loss,$24.00,$621.75,$225054.00,364,$621.75
2025-05-29,22:18:00,21374.25,SELL,1,0.02h,Break Even,$0.25,$622.00,$225054.25,364,$622.00
Final P&L Day: 622.00,,,,,,,,,,,
2025-05-30,12:00:00,21388.0,BUY,1,0.02h,Break Even,$0.25,$0.25,$225054.50,365,$0.25
2025-05-30,12:12:00,21258.5,SELL,1,0.02h,Stop Loss,$32.75,$33.00,$225087.25,365,$33.00
2025-05-30,12:35:00,21351.0,BUY,1,0.02h,Stop Loss,$26.50,$59.50,$225113.75,365,$59.50
2025-05-30,12:59:00,21335.75,SELL,1,0.02h,Break Even,$0.25,$59.75,$225114.00,365,$59.75
2025-05-30,13:17:00,21360.25,BUY,1,0.02h,Break Even,$0.25,$60.00,$225114.25,365,$60.00
2025-05-30,13:34:00,21337.0,SELL,1,0.02h,Stop Loss,$29.00,$89.00,$225143.25,365,$89.00
2025-05-30,14:05:00,21322.75,BUY,1,0.02h,Stop Loss,$100.25,$189.25,$225243.50,365,$189.25
2025-05-30,14:52:00,21369.0,SELL,1,0.02h,Stop Loss,$60.25,$249.50,$225303.75,365,$249.50
2025-05-30,15:28:00,21368.0,BUY,1,0.02h,Break Even,$0.25,$249.75,$225304.00,365,$249.75
2025-05-30,15:35:00,21326.25,SELL,1,0.02h,Stop Loss,$36.50,$286.25,$225340.50,365,$286.25
2025-05-30,15:56:00,21344.0,BUY,1,0.02h,Break Even,$0.25,$286.50,$225340.75,365,$286.50
2025-05-30,16:02:00,21305.0,SELL,1,0.02h,Stop Loss,$26.50,$313.00,$225367.25,365,$313.00
2025-05-30,16:10:00,21334.25,BUY,1,0.02h,Break Even,$0.25,$313.25,$225367.50,365,$313.25
2025-05-30,16:17:00,21293.75,SELL,1,0.02h,Stop Loss,$82.75,$396.00,$225450.25,365,$396.00
2025-05-30,17:06:00,21143.25,BUY,1,0.02h,Stop Loss,$70.25,$466.25,$225520.50,365,$466.25
2025-05-30,19:46:00,21358.5,SELL,1,0.02h,Stop Loss,$49.00,$515.25,$225569.50,365,$515.25
2025-05-30,19:49:00,21382.25,BUY,1,0.02h,Stop Loss,$12.75,$528.00,$225582.25,365,$528.00
2025-05-30,20:04:00,21344.25,SELL,1,0.02h,Stop Loss,$-6.00,$522.00,$225576.25,365,$522.00
2025-05-30,20:21:00,21377.75,BUY,1,0.02h,Stop Loss,$11.50,$533.50,$225587.75,365,$533.50
2025-05-30,20:26:00,21359.25,SELL,1,0.02h,Stop Loss,$12.75,$546.25,$225600.50,365,$546.25
2025-05-30,20:58:00,21363.75,BUY,1,0.02h,Stop Loss,$7.75,$554.00,$225608.25,365,$554.00
Final P&L Day: 554.00,,,,,,,,,,,
2025-06-02,12:00:00,21256.0,SELL,1,0.02h,Break Even,$0.25,$0.25,$225608.50,366,$0.25
2025-06-02,12:41:00,21274.5,BUY,1,0.02h,Stop Loss,$11.50,$11.75,$225620.00,366,$11.75
2025-06-02,12:56:00,21267.0,SELL,1,0.02h,Break Even,$0.25,$12.00,$225620.25,366,$12.00
2025-06-02,12:59:00,21282.25,BUY,1,0.02h,Stop Loss,$4.00,$16.00,$225624.25,366,$16.00
2025-06-02,13:07:00,21266.75,SELL,1,0.02h,Stop Loss,$9.00,$25.00,$225633.25,366,$25.00
2025-06-02,13:27:00,21280.5,BUY,1,0.02h,Stop Loss,$16.50,$41.50,$225649.75,366,$41.50
2025-06-02,13:53:00,21325.0,SELL,1,0.02h,Stop Loss,$70.25,$111.75,$225720.00,366,$111.75
2025-06-02,14:19:00,21323.5,BUY,1,0.02h,Stop Loss,$65.25,$177.00,$225785.25,366,$177.00
2025-06-02,15:11:00,21369.75,SELL,1,0.02h,Stop Loss,$-6.00,$171.00,$225779.25,366,$171.00
2025-06-02,15:14:00,21404.5,BUY,1,0.02h,Stop Loss,$-6.00,$165.00,$225773.25,366,$165.00
2025-06-02,15:27:00,21368.5,SELL,1,0.02h,Stop Loss,$15.25,$180.25,$225788.50,366,$180.25
2025-06-02,15:42:00,21388.0,BUY,1,0.02h,Stop Loss,$10.25,$190.50,$225798.75,366,$190.50
2025-06-02,16:28:00,21415.25,SELL,1,0.02h,Stop Loss,$4.00,$194.50,$225802.75,366,$194.50
2025-06-02,16:35:00,21432.75,BUY,1,0.02h,Stop Loss,$16.50,$211.00,$225819.25,366,$211.00
2025-06-02,16:37:00,21420.0,SELL,1,0.02h,Break Even,$0.25,$211.25,$225819.50,366,$211.25
2025-06-02,16:39:00,21435.75,BUY,1,0.02h,Stop Loss,$-6.00,$205.25,$225813.50,366,$205.25
2025-06-02,16:42:00,21425.25,SELL,1,0.02h,Stop Loss,$22.75,$228.00,$225836.25,366,$228.00
2025-06-02,16:54:00,21439.25,BUY,1,0.02h,Stop Loss,$60.25,$288.25,$225896.50,366,$288.25
2025-06-02,17:23:00,21442.0,SELL,1,0.02h,Stop Loss,$-6.00,$282.25,$225890.50,366,$282.25
2025-06-02,18:00:00,21445.5,BUY,1,0.02h,Break Even,$0.25,$282.50,$225890.75,366,$282.50
2025-06-02,19:20:00,21512.0,SELL,1,0.02h,Stop Loss,$16.50,$299.00,$225907.25,366,$299.00
2025-06-02,19:22:00,21519.75,BUY,1,0.02h,Stop Loss,$14.00,$313.00,$225921.25,366,$313.00
2025-06-02,19:36:00,21515.25,SELL,1,0.02h,Break Even,$0.25,$313.25,$225921.50,366,$313.25
2025-06-02,19:52:00,21524.75,BUY,1,0.02h,Stop Loss,$-6.00,$307.25,$225915.50,366,$307.25
2025-06-02,19:53:00,21511.25,SELL,1,0.02h,Stop Loss,$30.25,$337.50,$225945.75,366,$337.50
2025-06-02,19:59:00,21525.5,BUY,1,0.02h,Stop Loss,$56.50,$394.00,$226002.25,366,$394.00
2025-06-02,20:35:00,21555.75,SELL,1,0.02h,Break Even,$0.25,$394.25,$226002.50,366,$394.25
Final P&L Day: 394.25,,,,,,,,,,,
2025-06-03,12:01:00,21530.0,BUY,1,0.02h,Stop Loss,$34.00,$34.00,$226036.50,367,$34.00
2025-06-03,12:05:00,21519.75,SELL,1,0.02h,Stop Loss,$25.25,$59.25,$226061.75,367,$59.25
2025-06-03,12:14:00,21524.75,BUY,1,0.02h,Stop Loss,$-6.00,$53.25,$226055.75,367,$53.25
2025-06-03,12:19:00,21517.0,SELL,1,0.02h,Stop Loss,$-6.00,$47.25,$226049.75,367,$47.25
2025-06-03,12:25:00,21527.25,BUY,1,0.02h,Break Even,$0.25,$47.50,$226050.00,367,$47.50
2025-06-03,12:38:00,21515.0,SELL,1,0.02h,Break Even,$0.25,$47.75,$226050.25,367,$47.75
2025-06-03,12:57:00,21528.75,BUY,1,0.02h,Break Even,$0.25,$48.00,$226050.50,367,$48.00
2025-06-03,13:37:00,21537.25,SELL,1,0.02h,Stop Loss,$25.25,$73.25,$226075.75,367,$73.25
2025-06-03,13:43:00,21569.75,BUY,1,0.02h,Break Even,$0.25,$73.50,$226076.00,367,$73.50
2025-06-03,14:35:00,21597.0,SELL,1,0.02h,Stop Loss,$49.00,$122.50,$226125.00,367,$122.50
2025-06-03,14:41:00,21609.25,BUY,1,0.02h,Break Even,$0.25,$122.75,$226125.25,367,$122.75
2025-06-03,15:39:00,21663.75,SELL,1,0.02h,Stop Loss,$-6.00,$116.75,$226119.25,367,$116.75
2025-06-03,15:40:00,21671.25,BUY,1,0.02h,Break Even,$0.25,$117.00,$226119.50,367,$117.00
2025-06-03,15:51:00,21662.5,SELL,1,0.02h,Stop Loss,$11.50,$128.50,$226131.00,367,$128.50
2025-06-03,15:56:00,21674.75,BUY,1,0.02h,Stop Loss,$17.75,$146.25,$226148.75,367,$146.25
2025-06-03,17:32:00,21743.0,SELL,1,0.02h,Break Even,$0.25,$146.50,$226149.00,367,$146.50
2025-06-03,18:27:00,21686.0,BUY,1,0.02h,Stop Loss,$51.50,$198.00,$226200.50,367,$198.00
2025-06-03,19:12:00,21696.5,SELL,1,0.02h,Stop Loss,$-6.00,$192.00,$226194.50,367,$192.00
2025-06-03,19:19:00,21710.0,BUY,1,0.02h,Break Even,$0.25,$192.25,$226194.75,367,$192.25
2025-06-03,19:41:00,21700.25,SELL,1,0.02h,Stop Loss,$7.75,$200.00,$226202.50,367,$200.00
2025-06-03,19:57:00,21714.75,BUY,1,0.02h,Stop Loss,$40.25,$240.25,$226242.75,367,$240.25
2025-06-03,20:02:00,21684.5,SELL,1,0.02h,Stop Loss,$11.50,$251.75,$226254.25,367,$251.75
2025-06-03,20:38:00,21683.0,BUY,1,0.02h,Break Even,$0.25,$252.00,$226254.50,367,$252.00
2025-06-03,22:51:00,21710.5,SELL,1,0.02h,Stop Loss,$-6.00,$246.00,$226248.50,367,$246.00
2025-06-03,22:52:00,21712.5,BUY,1,0.02h,Break Even,$0.25,$246.25,$226248.75,367,$246.25
2025-06-03,23:00:00,21709.25,SELL,1,13.00h,Stop Loss,$-6.00,$240.25,$226242.75,367,$240.25
Final P&L Day: 240.25,,,,,,,,,,,
2025-06-04,12:00:00,21747.25,BUY,1,0.02h,Stop Loss,$15.25,$15.25,$226258.00,368,$15.25
2025-06-04,12:17:00,21712.25,SELL,1,0.02h,Stop Loss,$25.25,$40.50,$226283.25,368,$40.50
2025-06-04,12:50:00,21702.0,BUY,1,0.02h,Break Even,$0.25,$40.75,$226283.50,368,$40.75
2025-06-04,13:54:00,21742.0,SELL,1,0.02h,Break Even,$0.25,$41.00,$226283.75,368,$41.00
2025-06-04,14:21:00,21728.75,BUY,1,0.02h,Stop Loss,$12.75,$53.75,$226296.50,368,$53.75
2025-06-04,14:25:00,21712.5,SELL,1,0.02h,Break Even,$0.25,$54.00,$226296.75,368,$54.00
2025-06-04,14:27:00,21731.75,BUY,1,0.02h,Stop Loss,$47.75,$101.75,$226344.50,368,$101.75
2025-06-04,14:44:00,21715.75,SELL,1,0.02h,Break Even,$0.25,$102.00,$226344.75,368,$102.00
2025-06-04,14:56:00,21738.0,BUY,1,0.02h,Stop Loss,$19.00,$121.00,$226363.75,368,$121.00
2025-06-04,15:29:00,21760.25,SELL,1,0.02h,Stop Loss,$22.75,$143.75,$226386.50,368,$143.75
2025-06-04,15:43:00,21764.75,BUY,1,0.02h,Stop Loss,$34.00,$177.75,$226420.50,368,$177.75
2025-06-04,15:45:00,21740.0,SELL,1,0.02h,Break Even,$0.25,$178.00,$226420.75,368,$178.00
2025-06-04,16:45:00,21734.5,BUY,1,0.02h,Stop Loss,$26.50,$204.50,$226447.25,368,$204.50
2025-06-04,17:40:00,21766.25,SELL,1,0.02h,Stop Loss,$49.00,$253.50,$226496.25,368,$253.50
2025-06-04,17:46:00,21776.0,BUY,1,0.02h,Break Even,$0.25,$253.75,$226496.50,368,$253.75
2025-06-04,18:27:00,21782.5,SELL,1,0.02h,Break Even,$0.25,$254.00,$226496.75,368,$254.00
2025-06-04,18:30:00,21796.0,BUY,1,0.02h,Stop Loss,$17.75,$271.75,$226514.50,368,$271.75
2025-06-04,18:50:00,21786.25,SELL,1,0.02h,Stop Loss,$57.75,$329.50,$226572.25,368,$329.50
2025-06-04,19:04:00,21792.0,BUY,1,0.02h,Break Even,$0.25,$329.75,$226572.50,368,$329.75
2025-06-04,19:10:00,21777.25,SELL,1,0.02h,Break Even,$0.25,$330.00,$226572.75,368,$330.00
2025-06-04,19:15:00,21792.5,BUY,1,0.02h,Break Even,$0.25,$330.25,$226573.00,368,$330.25
2025-06-04,19:18:00,21783.75,SELL,1,0.02h,Break Even,$0.25,$330.50,$226573.25,368,$330.50
2025-06-04,20:29:00,21761.0,BUY,1,0.02h,Stop Loss,$-6.00,$324.50,$226567.25,368,$324.50
2025-06-04,20:33:00,21758.25,SELL,1,0.02h,Stop Loss,$-6.00,$318.50,$226561.25,368,$318.50
2025-06-04,20:46:00,21763.0,BUY,1,0.02h,Stop Loss,$-6.00,$312.50,$226555.25,368,$312.50
2025-06-04,20:55:00,21751.0,SELL,1,0.02h,Stop Loss,$-6.00,$306.50,$226549.25,368,$306.50
2025-06-04,22:11:00,21754.0,BUY,1,0.02h,Break Even,$0.25,$306.75,$226549.50,368,$306.75
2025-06-04,22:46:00,21753.0,SELL,1,0.02h,Break Even,$0.25,$307.00,$226549.75,368,$307.00
Final P&L Day: 307.00,,,,,,,,,,,
2025-06-05,12:01:00,21767.25,BUY,1,0.02h,Stop Loss,$-6.00,$-6.00,$226543.75,369,$-6.00
2025-06-05,12:29:00,21767.5,SELL,1,0.02h,Stop Loss,$9.00,$3.00,$226552.75,369,$3.00
2025-06-05,12:39:00,21775.0,BUY,1,0.02h,Stop Loss,$-6.00,$-3.00,$226546.75,369,$-3.00
2025-06-05,12:49:00,21754.75,SELL,1,0.02h,Stop Loss,$-6.00,$-9.00,$226540.75,369,$-9.00
2025-06-05,12:50:00,21845.25,BUY,1,0.02h,Stop Loss,$40.25,$31.25,$226581.00,369,$31.25
2025-06-05,13:17:00,21794.0,SELL,1,0.02h,Break Even,$0.25,$31.50,$226581.25,369,$31.50
2025-06-05,13:21:00,21817.5,BUY,1,0.02h,Break Even,$0.25,$31.75,$226581.50,369,$31.75
2025-06-05,13:27:00,21806.5,SELL,1,0.02h,Stop Loss,$14.00,$45.75,$226595.50,369,$45.75
2025-06-05,13:29:00,21814.25,BUY,1,0.02h,Break Even,$0.25,$46.00,$226595.75,369,$46.00
2025-06-05,13:33:00,21792.0,SELL,1,0.02h,Stop Loss,$65.25,$111.25,$226661.00,369,$111.25
2025-06-05,14:22:00,21753.75,BUY,1,0.02h,Stop Loss,$20.25,$131.50,$226681.25,369,$131.50
2025-06-05,14:36:00,21727.25,SELL,1,0.02h,Stop Loss,$37.75,$169.25,$226719.00,369,$169.25
2025-06-05,14:38:00,21782.5,BUY,1,0.02h,Stop Loss,$119.00,$288.25,$226838.00,369,$288.25
2025-06-05,16:09:00,21901.5,SELL,1,0.02h,Stop Loss,$80.25,$368.50,$226918.25,369,$368.50
2025-06-05,17:13:00,21755.75,BUY,1,0.02h,Break Even,$0.25,$368.75,$226918.50,369,$368.75
2025-06-05,17:50:00,21767.0,SELL,1,0.02h,Stop Loss,$24.00,$392.75,$226942.50,369,$392.75
2025-06-05,18:28:00,21703.25,BUY,1,0.02h,Break Even,$0.25,$393.00,$226942.75,369,$393.00
2025-06-05,18:54:00,21699.5,SELL,1,0.02h,Break Even,$0.25,$393.25,$226943.00,369,$393.25
2025-06-05,19:35:00,21609.75,BUY,1,0.02h,Stop Loss,$54.00,$447.25,$226997.00,369,$447.25
2025-06-05,19:54:00,21597.5,SELL,1,0.02h,Stop Loss,$54.00,$501.25,$227051.00,369,$501.25
2025-06-05,22:19:00,21523.0,BUY,1,0.02h,Stop Loss,$5.25,$506.50,$227056.25,369,$506.50
Final P&L Day: 506.50,,,,,,,,,,,
2025-06-06,14:04:00,21821.5,SELL,1,0.02h,Stop Loss,$22.75,$22.75,$227079.00,370,$22.75
2025-06-06,14:08:00,21832.75,BUY,1,0.02h,Stop Loss,$40.25,$63.00,$227119.25,370,$63.00
2025-06-06,14:12:00,21817.25,SELL,1,0.02h,Stop Loss,$11.50,$74.50,$227130.75,370,$74.50
2025-06-06,14:16:00,21834.5,BUY,1,0.02h,Break Even,$0.25,$74.75,$227131.00,370,$74.75
2025-06-06,14:20:00,21818.5,SELL,1,0.02h,Break Even,$0.25,$75.00,$227131.25,370,$75.00
2025-06-06,14:41:00,21831.75,BUY,1,0.02h,Break Even,$0.25,$75.25,$227131.50,370,$75.25
2025-06-06,15:17:00,21821.75,SELL,1,0.02h,Stop Loss,$79.00,$154.25,$227210.50,370,$154.25
2025-06-06,15:45:00,21800.0,BUY,1,0.02h,Break Even,$0.25,$154.50,$227210.75,370,$154.50
2025-06-06,16:21:00,21807.0,SELL,1,0.02h,Stop Loss,$54.00,$208.50,$227264.75,370,$208.50
2025-06-06,17:17:00,21763.75,BUY,1,0.02h,Break Even,$0.25,$208.75,$227265.00,370,$208.75
2025-06-06,18:30:00,21844.0,SELL,1,0.02h,Stop Loss,$-6.00,$202.75,$227259.00,370,$202.75
2025-06-06,18:31:00,21850.25,BUY,1,0.02h,Stop Loss,$25.25,$228.00,$227284.25,370,$228.00
2025-06-06,18:42:00,21844.0,SELL,1,0.02h,Stop Loss,$31.50,$259.50,$227315.75,370,$259.50
2025-06-06,19:54:00,21809.0,BUY,1,0.02h,Stop Loss,$85.25,$344.75,$227401.00,370,$344.75
2025-06-06,19:57:00,21802.0,SELL,1,0.02h,Stop Loss,$-6.00,$338.75,$227395.00,370,$338.75
2025-06-06,20:17:00,21805.0,BUY,1,0.02h,Break Even,$0.25,$339.00,$227395.25,370,$339.00
2025-06-06,20:50:00,21804.75,SELL,1,0.02h,Stop Loss,$-6.00,$333.00,$227389.25,370,$333.00
2025-06-06,21:00:00,21809.75,BUY,1,63.00h,Stop Loss,$11.50,$344.50,$227400.75,370,$344.50
Final P&L Day: 344.50,,,,,,,,,,,
2025-06-09,12:04:00,21806.25,SELL,1,0.02h,Stop Loss,$-6.00,$-6.00,$227394.75,371,$-6.00
2025-06-09,12:22:00,21811.5,BUY,1,0.02h,Break Even,$0.25,$-5.75,$227395.00,371,$-5.75
2025-06-09,12:43:00,21807.5,SELL,1,0.02h,Break Even,$0.25,$-5.50,$227395.25,371,$-5.50
2025-06-09,12:44:00,21811.75,BUY,1,0.02h,Break Even,$0.25,$-5.25,$227395.50,371,$-5.25
2025-06-09,12:51:00,21803.75,SELL,1,0.02h,Break Even,$0.25,$-5.00,$227395.75,371,$-5.00
2025-06-09,13:07:00,21811.5,BUY,1,0.02h,Break Even,$0.25,$-4.75,$227396.00,371,$-4.75
2025-06-09,13:17:00,21798.5,SELL,1,0.02h,Break Even,$0.25,$-4.50,$227396.25,371,$-4.50
2025-06-09,13:24:00,21813.0,BUY,1,0.02h,Stop Loss,$-6.00,$-10.50,$227390.25,371,$-10.50
2025-06-09,13:30:00,21797.5,SELL,1,0.02h,Stop Loss,$17.75,$7.25,$227408.00,371,$7.25
2025-06-09,13:31:00,21808.75,BUY,1,0.02h,Stop Loss,$15.25,$22.50,$227423.25,371,$22.50
2025-06-09,13:32:00,21787.25,SELL,1,0.02h,Stop Loss,$24.00,$46.50,$227447.25,371,$46.50
2025-06-09,13:50:00,21804.0,BUY,1,0.02h,Stop Loss,$17.75,$64.25,$227465.00,371,$64.25
2025-06-09,14:47:00,21847.25,SELL,1,0.02h,Break Even,$0.25,$64.50,$227465.25,371,$64.50
2025-06-09,15:07:00,21858.0,BUY,1,0.02h,Stop Loss,$6.50,$71.00,$227471.75,371,$71.00
2025-06-09,15:17:00,21843.5,SELL,1,0.02h,Break Even,$0.25,$71.25,$227472.00,371,$71.25
2025-06-09,15:40:00,21840.75,BUY,1,0.02h,Stop Loss,$-6.00,$65.25,$227466.00,371,$65.25
2025-06-09,15:41:00,21832.75,SELL,1,0.02h,Break Even,$0.25,$65.50,$227466.25,371,$65.50
2025-06-09,15:53:00,21839.25,BUY,1,0.02h,Stop Loss,$9.00,$74.50,$227475.25,371,$74.50
2025-06-09,16:09:00,21822.25,SELL,1,0.02h,Stop Loss,$16.50,$91.00,$227491.75,371,$91.00
2025-06-09,16:24:00,21835.75,BUY,1,0.02h,Stop Loss,$12.75,$103.75,$227504.50,371,$103.75
2025-06-09,17:14:00,21862.75,SELL,1,0.02h,Break Even,$0.25,$104.00,$227504.75,371,$104.00
2025-06-09,17:38:00,21863.0,BUY,1,0.02h,Stop Loss,$4.00,$108.00,$227508.75,371,$108.00
2025-06-09,18:05:00,21862.5,SELL,1,0.02h,Stop Loss,$16.50,$124.50,$227525.25,371,$124.50
2025-06-09,18:23:00,21869.75,BUY,1,0.02h,Stop Loss,$-6.00,$118.50,$227519.25,371,$118.50
2025-06-09,18:33:00,21864.5,SELL,1,0.02h,Break Even,$0.25,$118.75,$227519.50,371,$118.75
2025-06-09,18:50:00,21863.25,BUY,1,0.02h,Break Even,$0.25,$119.00,$227519.75,371,$119.00
2025-06-09,19:15:00,21859.75,SELL,1,0.02h,Stop Loss,$4.00,$123.00,$227523.75,371,$123.00
2025-06-09,20:34:00,21809.75,BUY,1,0.02h,Stop Loss,$-6.00,$117.00,$227517.75,371,$117.00
2025-06-09,22:32:00,21829.75,SELL,1,0.02h,Stop Loss,$-6.00,$111.00,$227511.75,371,$111.00
Final P&L Day: 111.00,,,,,,,,,,,
2025-06-10,12:00:00,21857.25,BUY,1,0.02h,Stop Loss,$4.00,$4.00,$227515.75,372,$4.00
2025-06-10,12:34:00,21851.25,SELL,1,0.02h,Stop Loss,$-6.00,$-2.00,$227509.75,372,$-2.00
2025-06-10,12:42:00,21863.0,BUY,1,0.02h,Break Even,$0.25,$-1.75,$227510.00,372,$-1.75
2025-06-10,12:52:00,21850.0,SELL,1,0.02h,Break Even,$0.25,$-1.50,$227510.25,372,$-1.50
2025-06-10,13:03:00,21857.75,BUY,1,0.02h,Stop Loss,$-6.00,$-7.50,$227504.25,372,$-7.50
2025-06-10,13:04:00,21854.0,SELL,1,0.02h,Break Even,$0.25,$-7.25,$227504.50,372,$-7.25
2025-06-10,13:22:00,21854.75,BUY,1,0.02h,Break Even,$0.25,$-7.00,$227504.75,372,$-7.00
2025-06-10,13:25:00,21851.0,SELL,1,0.02h,Stop Loss,$35.25,$28.25,$227540.00,372,$28.25
2025-06-10,13:40:00,21881.25,BUY,1,0.02h,Stop Loss,$9.00,$37.25,$227549.00,372,$37.25
2025-06-10,13:59:00,21857.75,SELL,1,0.02h,Stop Loss,$15.25,$52.50,$227564.25,372,$52.50
2025-06-10,14:01:00,21865.75,BUY,1,0.02h,Stop Loss,$32.75,$85.25,$227597.00,372,$85.25
2025-06-10,14:05:00,21855.0,SELL,1,0.02h,Stop Loss,$-6.00,$79.25,$227591.00,372,$79.25
2025-06-10,14:06:00,21862.5,BUY,1,0.02h,Stop Loss,$5.25,$84.50,$227596.25,372,$84.50
2025-06-10,14:08:00,21857.75,SELL,1,0.02h,Stop Loss,$34.00,$118.50,$227630.25,372,$118.50
2025-06-10,14:12:00,21873.5,BUY,1,0.02h,Stop Loss,$24.00,$142.50,$227654.25,372,$142.50
2025-06-10,14:41:00,21862.75,SELL,1,0.02h,Break Even,$0.25,$142.75,$227654.50,372,$142.75
2025-06-10,14:45:00,21881.25,BUY,1,0.02h,Stop Loss,$-6.00,$136.75,$227648.50,372,$136.75
2025-06-10,14:56:00,21860.5,SELL,1,0.02h,Stop Loss,$9.00,$145.75,$227657.50,372,$145.75
2025-06-10,15:17:00,21874.0,BUY,1,0.02h,Stop Loss,$5.25,$151.00,$227662.75,372,$151.00
2025-06-10,15:25:00,21863.0,SELL,1,0.02h,Break Even,$0.25,$151.25,$227663.00,372,$151.25
2025-06-10,15:26:00,21871.5,BUY,1,0.02h,Break Even,$0.25,$151.50,$227663.25,372,$151.50
2025-06-10,15:27:00,21866.5,SELL,1,0.02h,Stop Loss,$29.00,$180.50,$227692.25,372,$180.50
2025-06-10,15:47:00,21845.75,BUY,1,0.02h,Stop Loss,$29.00,$209.50,$227721.25,372,$209.50
2025-06-10,16:46:00,21897.25,SELL,1,0.02h,Break Even,$0.25,$209.75,$227721.50,372,$209.75
2025-06-10,16:48:00,21901.5,BUY,1,0.02h,Stop Loss,$-6.00,$203.75,$227715.50,372,$203.75
2025-06-10,16:49:00,21898.0,SELL,1,0.02h,Stop Loss,$4.00,$207.75,$227719.50,372,$207.75
2025-06-10,16:51:00,21904.25,BUY,1,0.02h,Stop Loss,$27.75,$235.50,$227747.25,372,$235.50
2025-06-10,17:04:00,21899.75,SELL,1,0.02h,Break Even,$0.25,$235.75,$227747.50,372,$235.75
2025-06-10,17:10:00,21909.5,BUY,1,0.02h,Stop Loss,$35.25,$271.00,$227782.75,372,$271.00
2025-06-10,17:27:00,21899.75,SELL,1,0.02h,Break Even,$0.25,$271.25,$227783.00,372,$271.25
2025-06-10,18:20:00,21873.75,BUY,1,0.02h,Break Even,$0.25,$271.50,$227783.25,372,$271.50
2025-06-10,19:32:00,21952.5,SELL,1,0.02h,Stop Loss,$19.00,$290.50,$227802.25,372,$290.50
2025-06-10,19:57:00,21958.0,BUY,1,0.02h,Break Even,$0.25,$290.75,$227802.50,372,$290.75
2025-06-10,20:07:00,21940.5,SELL,1,0.02h,Break Even,$0.25,$291.00,$227802.75,372,$291.00
2025-06-10,20:19:00,21964.25,BUY,1,0.02h,Stop Loss,$11.50,$302.50,$227814.25,372,$302.50
2025-06-10,20:34:00,21948.75,SELL,1,0.02h,Stop Loss,$-6.00,$296.50,$227808.25,372,$296.50
2025-06-10,20:37:00,21954.25,BUY,1,0.02h,Stop Loss,$-6.00,$290.50,$227802.25,372,$290.50
2025-06-10,20:51:00,21949.25,SELL,1,0.02h,Break Even,$0.25,$290.75,$227802.50,372,$290.75
2025-06-10,20:58:00,21953.0,BUY,1,0.02h,Stop Loss,$-6.00,$284.75,$227796.50,372,$284.75
2025-06-10,22:05:00,21950.5,SELL,1,0.02h,Break Even,$0.25,$285.00,$227796.75,372,$285.00
2025-06-10,22:07:00,21954.75,BUY,1,0.02h,Break Even,$0.25,$285.25,$227797.00,372,$285.25
2025-06-10,22:31:00,21947.75,SELL,1,0.02h,Break Even,$0.25,$285.50,$227797.25,372,$285.50
2025-06-10,22:43:00,21954.0,BUY,1,0.02h,Stop Loss,$-6.00,$279.50,$227791.25,372,$279.50
2025-06-10,22:48:00,21951.0,SELL,1,0.02h,Break Even,$0.25,$279.75,$227791.50,372,$279.75
2025-06-10,22:54:00,21967.75,BUY,1,0.02h,Stop Loss,$62.75,$342.50,$227854.25,372,$342.50
Final P&L Day: 342.50,,,,,,,,,,,
2025-06-11,12:01:00,21935.0,SELL,1,0.02h,Break Even,$0.25,$0.25,$227854.50,373,$0.25
2025-06-11,12:29:00,21948.75,BUY,1,0.02h,Stop Loss,$21.50,$21.75,$227876.00,373,$21.75
2025-06-11,12:54:00,22020.75,SELL,1,0.02h,Break Even,$0.25,$22.00,$227876.25,373,$22.00
2025-06-11,13:13:00,22033.5,BUY,1,0.02h,Break Even,$0.25,$22.25,$227876.50,373,$22.25
2025-06-11,13:15:00,22024.0,SELL,1,0.02h,Stop Loss,$14.00,$36.25,$227890.50,373,$36.25
2025-06-11,13:20:00,22030.5,BUY,1,0.02h,Stop Loss,$-6.00,$30.25,$227884.50,373,$30.25
2025-06-11,13:24:00,22021.25,SELL,1,0.02h,Break Even,$0.25,$30.50,$227884.75,373,$30.50
2025-06-11,13:56:00,21993.5,BUY,1,0.02h,Break Even,$0.25,$30.75,$227885.00,373,$30.75
2025-06-11,15:10:00,21999.25,SELL,1,0.02h,Stop Loss,$51.50,$82.25,$227936.50,373,$82.25
2025-06-11,16:30:00,21978.25,BUY,1,0.02h,Stop Loss,$22.75,$105.00,$227959.25,373,$105.00
2025-06-11,16:43:00,21961.25,SELL,1,0.02h,Break Even,$0.25,$105.25,$227959.50,373,$105.25
2025-06-11,16:44:00,21973.5,BUY,1,0.02h,Stop Loss,$-6.00,$99.25,$227953.50,373,$99.25
2025-06-11,16:45:00,21964.75,SELL,1,0.02h,Stop Loss,$20.25,$119.50,$227973.75,373,$119.50
2025-06-11,16:47:00,21973.0,BUY,1,0.02h,Stop Loss,$24.00,$143.50,$227997.75,373,$143.50
2025-06-11,17:35:00,21996.0,SELL,1,0.02h,Stop Loss,$4.00,$147.50,$228001.75,373,$147.50
2025-06-11,18:34:00,21879.5,BUY,1,0.02h,Stop Loss,$20.25,$167.75,$228022.00,373,$167.75
2025-06-11,18:57:00,21855.75,SELL,1,0.02h,Stop Loss,$17.75,$185.50,$228039.75,373,$185.50
2025-06-11,19:26:00,21871.0,BUY,1,0.02h,Break Even,$0.25,$185.75,$228040.00,373,$185.75
2025-06-11,19:33:00,21844.25,SELL,1,0.02h,Stop Loss,$36.50,$222.25,$228076.50,373,$222.25
2025-06-11,19:41:00,21863.0,BUY,1,0.02h,Stop Loss,$14.00,$236.25,$228090.50,373,$236.25
2025-06-11,20:35:00,21890.5,SELL,1,0.02h,Stop Loss,$19.00,$255.25,$228109.50,373,$255.25
2025-06-11,22:23:00,21875.25,BUY,1,0.02h,Break Even,$0.25,$255.50,$228109.75,373,$255.50
2025-06-11,22:43:00,21878.0,SELL,1,0.02h,Stop Loss,$-6.00,$249.50,$228103.75,373,$249.50
Final P&L Day: 249.50,,,,,,,,,,,
2025-06-12,12:00:00,21966.5,BUY,1,0.02h,Stop Loss,$-6.00,$-6.00,$228097.75,374,$-6.00
2025-06-12,12:01:00,21744.0,SELL,1,0.02h,Break Even,$0.25,$-5.75,$228098.00,374,$-5.75
2025-06-12,12:04:00,21975.0,BUY,1,0.02h,Stop Loss,$-6.00,$-11.75,$228092.00,374,$-11.75
2025-06-12,12:05:00,21748.0,SELL,1,0.02h,Break Even,$0.25,$-11.50,$228092.25,374,$-11.50
2025-06-12,12:14:00,21996.5,BUY,1,0.02h,Stop Loss,$-6.00,$-17.50,$228086.25,374,$-17.50
2025-06-12,12:15:00,21769.75,SELL,1,0.02h,Stop Loss,$-6.00,$-23.50,$228080.25,374,$-23.50
2025-06-12,12:16:00,21989.0,BUY,1,0.02h,Stop Loss,$-6.00,$-29.50,$228074.25,374,$-29.50
2025-06-12,12:20:00,21771.5,SELL,1,0.02h,Stop Loss,$-6.00,$-35.50,$228068.25,374,$-35.50
2025-06-12,12:21:00,21988.5,BUY,1,0.02h,Stop Loss,$16.50,$-19.00,$228084.75,374,$-19.00
2025-06-12,12:30:00,21762.0,SELL,1,0.02h,Stop Loss,$-6.00,$-25.00,$228078.75,374,$-25.00
2025-06-12,12:31:00,21999.75,BUY,1,0.02h,Stop Loss,$-6.00,$-31.00,$228072.75,374,$-31.00
2025-06-12,12:32:00,21775.75,SELL,1,0.02h,Break Even,$0.25,$-30.75,$228073.00,374,$-30.75
2025-06-12,12:34:00,22008.25,BUY,1,0.02h,Stop Loss,$-6.00,$-36.75,$228067.00,374,$-36.75
2025-06-12,12:35:00,21795.25,SELL,1,0.02h,Stop Loss,$-6.00,$-42.75,$228061.00,374,$-42.75
2025-06-12,12:36:00,22022.25,BUY,1,0.02h,Stop Loss,$129.00,$86.25,$228190.00,374,$86.25
2025-06-12,12:45:00,21839.75,SELL,1,0.02h,Stop Loss,$20.25,$106.50,$228210.25,374,$106.50
2025-06-12,12:49:00,22062.0,BUY,1,0.02h,Stop Loss,$-6.00,$100.50,$228204.25,374,$100.50
2025-06-12,12:50:00,21832.25,SELL,1,0.02h,Stop Loss,$-6.00,$94.50,$228198.25,374,$94.50
2025-06-12,12:51:00,22050.75,BUY,1,0.02h,Stop Loss,$5.25,$99.75,$228203.50,374,$99.75
2025-06-12,12:54:00,21833.5,SELL,1,0.02h,Break Even,$0.25,$100.00,$228203.75,374,$100.00
2025-06-12,12:57:00,22065.0,BUY,1,0.02h,Stop Loss,$-6.00,$94.00,$228197.75,374,$94.00
2025-06-12,12:58:00,21838.25,SELL,1,0.02h,Stop Loss,$-6.00,$88.00,$228191.75,374,$88.00
2025-06-12,12:59:00,22066.75,BUY,1,0.02h,Stop Loss,$-6.00,$82.00,$228185.75,374,$82.00
2025-06-12,13:08:00,21832.5,SELL,1,0.02h,Stop Loss,$-6.00,$76.00,$228179.75,374,$76.00
2025-06-12,13:09:00,22056.5,BUY,1,0.02h,Break Even,$0.25,$76.25,$228180.00,374,$76.25
2025-06-12,13:12:00,21841.75,SELL,1,0.02h,Stop Loss,$-6.00,$70.25,$228174.00,374,$70.25
2025-06-12,13:13:00,22066.0,BUY,1,0.02h,Stop Loss,$-6.00,$64.25,$228168.00,374,$64.25
2025-06-12,13:14:00,21839.25,SELL,1,0.02h,Stop Loss,$5.25,$69.50,$228173.25,374,$69.50
2025-06-12,13:16:00,22056.75,BUY,1,0.02h,Stop Loss,$-6.00,$63.50,$228167.25,374,$63.50
2025-06-12,13:20:00,21838.0,SELL,1,0.02h,Stop Loss,$-6.00,$57.50,$228161.25,374,$57.50
2025-06-12,13:21:00,22053.5,BUY,1,0.02h,Stop Loss,$-6.00,$51.50,$228155.25,374,$51.50
2025-06-12,13:22:00,21832.75,SELL,1,0.02h,Stop Loss,$-6.00,$45.50,$228149.25,374,$45.50
2025-06-12,13:23:00,22060.0,BUY,1,0.02h,Stop Loss,$-6.00,$39.50,$228143.25,374,$39.50
2025-06-12,13:24:00,21832.5,SELL,1,0.02h,Stop Loss,$16.50,$56.00,$228159.75,374,$56.00
2025-06-12,13:29:00,22051.25,BUY,1,0.02h,Stop Loss,$-6.00,$50.00,$228153.75,374,$50.00
2025-06-12,13:30:00,21829.0,SELL,1,0.02h,Stop Loss,$-6.00,$44.00,$228147.75,374,$44.00
2025-06-12,13:31:00,22086.5,BUY,1,0.02h,Stop Loss,$35.25,$79.25,$228183.00,374,$79.25
2025-06-12,13:44:00,21876.75,SELL,1,0.02h,Stop Loss,$17.75,$97.00,$228200.75,374,$97.00
2025-06-12,13:48:00,22102.5,BUY,1,0.02h,Stop Loss,$-6.00,$91.00,$228194.75,374,$91.00
2025-06-12,13:49:00,21883.75,SELL,1,0.02h,Stop Loss,$-6.00,$85.00,$228188.75,374,$85.00
2025-06-12,13:50:00,22110.5,BUY,1,0.02h,Stop Loss,$-6.00,$79.00,$228182.75,374,$79.00
2025-06-12,13:51:00,21877.75,SELL,1,0.02h,Stop Loss,$-6.00,$73.00,$228176.75,374,$73.00
2025-06-12,13:52:00,22101.0,BUY,1,0.02h,Stop Loss,$29.00,$102.00,$228205.75,374,$102.00
2025-06-12,13:56:00,21850.25,SELL,1,0.02h,Break Even,$0.25,$102.25,$228206.00,374,$102.25
2025-06-12,14:05:00,22079.5,BUY,1,0.02h,Stop Loss,$-6.00,$96.25,$228200.00,374,$96.25
2025-06-12,14:06:00,21852.5,SELL,1,0.02h,Break Even,$0.25,$96.50,$228200.25,374,$96.50
2025-06-12,14:08:00,22116.25,BUY,1,0.02h,Stop Loss,$-6.00,$90.50,$228194.25,374,$90.50
2025-06-12,14:09:00,21898.25,SELL,1,0.02h,Stop Loss,$40.25,$130.75,$228234.50,374,$130.75
2025-06-12,14:12:00,22117.75,BUY,1,0.02h,Stop Loss,$50.25,$181.00,$228284.75,374,$181.00
2025-06-12,14:16:00,21920.75,SELL,1,0.02h,Stop Loss,$39.00,$220.00,$228323.75,374,$220.00
2025-06-12,14:21:00,22140.0,BUY,1,0.02h,Stop Loss,$-6.00,$214.00,$228317.75,374,$214.00
2025-06-12,14:35:00,21921.25,SELL,1,0.02h,Stop Loss,$-6.00,$208.00,$228311.75,374,$208.00
2025-06-12,14:36:00,22141.75,BUY,1,0.02h,Stop Loss,$-6.00,$202.00,$228305.75,374,$202.00
2025-06-12,14:46:00,21941.0,SELL,1,0.02h,Stop Loss,$-6.00,$196.00,$228299.75,374,$196.00
2025-06-12,14:47:00,22165.0,BUY,1,0.02h,Break Even,$0.25,$196.25,$228300.00,374,$196.25
2025-06-12,14:49:00,21943.5,SELL,1,0.02h,Stop Loss,$-6.00,$190.25,$228294.00,374,$190.25
2025-06-12,14:53:00,22160.5,BUY,1,0.02h,Stop Loss,$-6.00,$184.25,$228288.00,374,$184.25
2025-06-12,14:54:00,21937.25,SELL,1,0.02h,Break Even,$0.25,$184.50,$228288.25,374,$184.50
2025-06-12,15:00:00,22159.5,BUY,1,0.02h,Stop Loss,$30.25,$214.75,$228318.50,374,$214.75
2025-06-12,15:10:00,21952.75,SELL,1,0.02h,Stop Loss,$-6.00,$208.75,$228312.50,374,$208.75
2025-06-12,15:11:00,22173.0,BUY,1,0.02h,Stop Loss,$-6.00,$202.75,$228306.50,374,$202.75
2025-06-12,15:12:00,21954.5,SELL,1,0.02h,Stop Loss,$11.50,$214.25,$228318.00,374,$214.25
2025-06-12,15:19:00,22145.25,BUY,1,0.02h,Stop Loss,$36.50,$250.75,$228354.50,374,$250.75
2025-06-12,15:24:00,21919.75,SELL,1,0.02h,Stop Loss,$94.00,$344.75,$228448.50,374,$344.75
2025-06-12,15:35:00,22135.25,BUY,1,0.02h,Stop Loss,$39.00,$383.75,$228487.50,374,$383.75
2025-06-12,15:43:00,21920.0,SELL,1,0.02h,Stop Loss,$-6.00,$377.75,$228481.50,374,$377.75
2025-06-12,15:44:00,22150.0,BUY,1,0.02h,Stop Loss,$-6.00,$371.75,$228475.50,374,$371.75
2025-06-12,15:49:00,21905.0,SELL,1,0.02h,Stop Loss,$-6.00,$365.75,$228469.50,374,$365.75
2025-06-12,15:50:00,22130.5,BUY,1,0.02h,Break Even,$0.25,$366.00,$228469.75,374,$366.00
2025-06-12,15:53:00,21910.0,SELL,1,0.02h,Stop Loss,$-6.00,$360.00,$228463.75,374,$360.00
2025-06-12,15:54:00,22136.25,BUY,1,0.02h,Stop Loss,$-6.00,$354.00,$228457.75,374,$354.00
2025-06-12,15:55:00,21914.75,SELL,1,0.02h,Break Even,$0.25,$354.25,$228458.00,374,$354.25
2025-06-12,15:58:00,22137.0,BUY,1,0.02h,Stop Loss,$-6.00,$348.25,$228452.00,374,$348.25
2025-06-12,15:59:00,21924.0,SELL,1,0.02h,Stop Loss,$-6.00,$342.25,$228446.00,374,$342.25
2025-06-12,16:00:00,22148.5,BUY,1,0.02h,Stop Loss,$44.00,$386.25,$228490.00,374,$386.25
2025-06-12,16:10:00,21932.5,SELL,1,0.02h,Stop Loss,$-6.00,$380.25,$228484.00,374,$380.25
2025-06-12,16:11:00,22155.0,BUY,1,0.02h,Stop Loss,$42.75,$423.00,$228526.75,374,$423.00
2025-06-12,16:13:00,21940.75,SELL,1,0.02h,Stop Loss,$15.25,$438.25,$228542.00,374,$438.25
2025-06-12,16:19:00,22161.0,BUY,1,0.02h,Stop Loss,$-6.00,$432.25,$228536.00,374,$432.25
2025-06-12,16:20:00,21940.75,SELL,1,0.02h,Stop Loss,$-6.00,$426.25,$228530.00,374,$426.25
2025-06-12,16:21:00,22171.0,BUY,1,0.02h,Stop Loss,$-6.00,$420.25,$228524.00,374,$420.25
2025-06-12,16:33:00,21937.25,SELL,1,0.02h,Break Even,$0.25,$420.50,$228524.25,374,$420.50
2025-06-12,16:37:00,22175.0,BUY,1,0.02h,Stop Loss,$-6.00,$414.50,$228518.25,374,$414.50
2025-06-12,16:38:00,21942.75,SELL,1,0.02h,Stop Loss,$-6.00,$408.50,$228512.25,374,$408.50
2025-06-12,16:56:00,22153.75,BUY,1,0.03h,Stop Loss,$-6.00,$402.50,$228506.25,374,$402.50
2025-06-12,16:59:00,21930.0,SELL,1,0.02h,Stop Loss,$36.50,$439.00,$228542.75,374,$439.00
2025-06-12,17:03:00,22163.0,BUY,1,0.02h,Stop Loss,$30.25,$469.25,$228573.00,374,$469.25
2025-06-12,17:10:00,21948.75,SELL,1,0.02h,Break Even,$0.25,$469.50,$228573.25,374,$469.50
2025-06-12,17:14:00,22173.75,BUY,1,0.02h,Stop Loss,$-6.00,$463.50,$228567.25,374,$463.50
2025-06-12,17:18:00,21946.25,SELL,1,0.02h,Stop Loss,$-6.00,$457.50,$228561.25,374,$457.50
2025-06-12,17:19:00,22178.0,BUY,1,0.03h,Stop Loss,$-6.00,$451.50,$228555.25,374,$451.50
2025-06-12,17:28:00,21944.75,SELL,1,0.02h,Stop Loss,$35.25,$486.75,$228590.50,374,$486.75
2025-06-12,17:33:00,22189.0,BUY,1,0.02h,Stop Loss,$-6.00,$480.75,$228584.50,374,$480.75
2025-06-12,17:34:00,21960.0,SELL,1,0.02h,Stop Loss,$-6.00,$474.75,$228578.50,374,$474.75
2025-06-12,17:44:00,22182.5,BUY,1,0.02h,Stop Loss,$-6.00,$468.75,$228572.50,374,$468.75
2025-06-12,17:45:00,21953.5,SELL,1,0.02h,Stop Loss,$26.50,$495.25,$228599.00,374,$495.25
2025-06-12,17:48:00,22177.5,BUY,1,0.02h,Stop Loss,$-6.00,$489.25,$228593.00,374,$489.25
2025-06-12,17:49:00,21943.25,SELL,1,0.02h,Break Even,$0.25,$489.50,$228593.25,374,$489.50
2025-06-12,17:51:00,22174.25,BUY,1,0.02h,Stop Loss,$-6.00,$483.50,$228587.25,374,$483.50
2025-06-12,17:52:00,21946.75,SELL,1,0.02h,Stop Loss,$-6.00,$477.50,$228581.25,374,$477.50
2025-06-12,17:53:00,22172.0,BUY,1,0.02h,Stop Loss,$-6.00,$471.50,$228575.25,374,$471.50
2025-06-12,17:54:00,21944.25,SELL,1,0.02h,Stop Loss,$5.25,$476.75,$228580.50,374,$476.75
2025-06-12,18:00:00,22161.0,BUY,1,0.02h,Stop Loss,$-6.00,$470.75,$228574.50,374,$470.75
2025-06-12,18:01:00,21938.75,SELL,1,0.02h,Break Even,$0.25,$471.00,$228574.75,374,$471.00
2025-06-12,18:03:00,22162.0,BUY,1,0.02h,Stop Loss,$-6.00,$465.00,$228568.75,374,$465.00
2025-06-12,18:06:00,21942.5,SELL,1,0.02h,Break Even,$0.25,$465.25,$228569.00,374,$465.25
2025-06-12,18:11:00,22169.75,BUY,1,0.02h,Stop Loss,$-6.00,$459.25,$228563.00,374,$459.25
2025-06-12,18:12:00,21945.25,SELL,1,0.02h,Break Even,$0.25,$459.50,$228563.25,374,$459.50
2025-06-12,18:16:00,22166.75,BUY,1,0.02h,Stop Loss,$-6.00,$453.50,$228557.25,374,$453.50
2025-06-12,18:34:00,21923.25,SELL,1,0.02h,Stop Loss,$12.75,$466.25,$228570.00,374,$466.25
2025-06-12,18:53:00,22153.75,BUY,1,0.02h,Stop Loss,$-6.00,$460.25,$228564.00,374,$460.25
2025-06-12,18:54:00,21929.0,SELL,1,0.02h,Break Even,$0.25,$460.50,$228564.25,374,$460.50
2025-06-12,18:59:00,22157.5,BUY,1,0.03h,Stop Loss,$4.00,$464.50,$228568.25,374,$464.50
2025-06-12,19:02:00,21935.5,SELL,1,0.02h,Stop Loss,$-6.00,$458.50,$228562.25,374,$458.50
2025-06-12,19:04:00,22167.75,BUY,1,0.02h,Stop Loss,$-6.00,$452.50,$228556.25,374,$452.50
2025-06-12,19:09:00,21939.75,SELL,1,0.02h,Stop Loss,$-6.00,$446.50,$228550.25,374,$446.50
2025-06-12,19:11:00,22166.25,BUY,1,0.02h,Stop Loss,$-6.00,$440.50,$228544.25,374,$440.50
2025-06-12,19:12:00,21939.0,SELL,1,0.02h,Stop Loss,$-6.00,$434.50,$228538.25,374,$434.50
2025-06-12,19:13:00,22163.75,BUY,1,0.02h,Stop Loss,$-6.00,$428.50,$228532.25,374,$428.50
2025-06-12,19:21:00,21948.75,SELL,1,0.02h,Stop Loss,$-6.00,$422.50,$228526.25,374,$422.50
2025-06-12,19:25:00,22164.75,BUY,1,0.02h,Stop Loss,$-6.00,$416.50,$228520.25,374,$416.50
2025-06-12,19:26:00,21931.0,SELL,1,0.02h,Break Even,$0.25,$416.75,$228520.50,374,$416.75
2025-06-12,19:30:00,22162.75,BUY,1,0.02h,Stop Loss,$-6.00,$410.75,$228514.50,374,$410.75
2025-06-12,19:34:00,21930.0,SELL,1,0.02h,Stop Loss,$-6.00,$404.75,$228508.50,374,$404.75
2025-06-12,19:35:00,22153.0,BUY,1,0.02h,Stop Loss,$-6.00,$398.75,$228502.50,374,$398.75
2025-06-12,19:36:00,21924.5,SELL,1,0.02h,Stop Loss,$-6.00,$392.75,$228496.50,374,$392.75
2025-06-12,19:37:00,22149.0,BUY,1,0.02h,Stop Loss,$-6.00,$386.75,$228490.50,374,$386.75
2025-06-12,19:38:00,21920.25,SELL,1,0.02h,Stop Loss,$-6.00,$380.75,$228484.50,374,$380.75
2025-06-12,19:42:00,22145.75,BUY,1,0.02h,Stop Loss,$-6.00,$374.75,$228478.50,374,$374.75
2025-06-12,19:46:00,21909.25,SELL,1,0.02h,Stop Loss,$-6.00,$368.75,$228472.50,374,$368.75
2025-06-12,19:48:00,22133.0,BUY,1,0.02h,Break Even,$0.25,$369.00,$228472.75,374,$369.00
2025-06-12,19:53:00,21906.5,SELL,1,0.02h,Stop Loss,$11.50,$380.50,$228484.25,374,$380.50
2025-06-12,20:02:00,22163.25,BUY,1,0.02h,Stop Loss,$-6.00,$374.50,$228478.25,374,$374.50
2025-06-12,20:03:00,21936.75,SELL,1,0.02h,Stop Loss,$-6.00,$368.50,$228472.25,374,$368.50
2025-06-12,20:04:00,22162.5,BUY,1,0.02h,Stop Loss,$-6.00,$362.50,$228466.25,374,$362.50
2025-06-12,20:05:00,21932.5,SELL,1,0.02h,Stop Loss,$-6.00,$356.50,$228460.25,374,$356.50
2025-06-12,20:06:00,22170.25,BUY,1,0.02h,Stop Loss,$-6.00,$350.50,$228454.25,374,$350.50
2025-06-12,20:17:00,21926.5,SELL,1,0.02h,Break Even,$0.25,$350.75,$228454.50,374,$350.75
2025-06-12,20:23:00,22143.25,BUY,1,0.02h,Break Even,$0.25,$351.00,$228454.75,374,$351.00
2025-06-12,20:31:00,21911.5,SELL,1,0.02h,Stop Loss,$-6.00,$345.00,$228448.75,374,$345.00
2025-06-12,20:38:00,22143.75,BUY,1,0.02h,Stop Loss,$-6.00,$339.00,$228442.75,374,$339.00
2025-06-12,20:39:00,21919.5,SELL,1,0.02h,Stop Loss,$-6.00,$333.00,$228436.75,374,$333.00
2025-06-12,20:56:00,22138.5,BUY,1,0.02h,Stop Loss,$-6.00,$327.00,$228430.75,374,$327.00
2025-06-12,21:00:00,21908.25,SELL,1,1.02h,Stop Loss,$37.75,$364.75,$228468.50,374,$364.75
2025-06-12,22:09:00,22114.75,BUY,1,0.02h,Stop Loss,$-6.00,$358.75,$228462.50,374,$358.75
2025-06-12,22:10:00,21892.75,SELL,1,0.02h,Stop Loss,$-6.00,$352.75,$228456.50,374,$352.75
2025-06-12,22:11:00,22119.25,BUY,1,0.02h,Stop Loss,$-6.00,$346.75,$228450.50,374,$346.75
2025-06-12,22:12:00,21897.25,SELL,1,0.02h,Break Even,$0.25,$347.00,$228450.75,374,$347.00
2025-06-12,22:19:00,22112.75,BUY,1,0.02h,Stop Loss,$-6.00,$341.00,$228444.75,374,$341.00
2025-06-12,22:24:00,21886.5,SELL,1,0.02h,Stop Loss,$-6.00,$335.00,$228438.75,374,$335.00
2025-06-12,22:30:00,22102.0,BUY,1,0.02h,Stop Loss,$-6.00,$329.00,$228432.75,374,$329.00
2025-06-12,22:33:00,21871.5,SELL,1,0.02h,Stop Loss,$-6.00,$323.00,$228426.75,374,$323.00
2025-06-12,22:35:00,22100.5,BUY,1,0.02h,Stop Loss,$-6.00,$317.00,$228420.75,374,$317.00
2025-06-12,22:38:00,21872.25,SELL,1,0.02h,Break Even,$0.25,$317.25,$228421.00,374,$317.25
2025-06-12,22:42:00,22096.75,BUY,1,0.02h,Stop Loss,$-6.00,$311.25,$228415.00,374,$311.25
2025-06-12,22:43:00,21870.5,SELL,1,0.02h,Break Even,$0.25,$311.50,$228415.25,374,$311.50
2025-06-12,22:45:00,22095.5,BUY,1,0.02h,Break Even,$0.25,$311.75,$228415.50,374,$311.75
2025-06-12,22:59:00,21882.5,SELL,1,0.02h,Stop Loss,$-6.00,$305.75,$228409.50,374,$305.75
2025-06-12,23:00:00,22105.75,BUY,1,13.00h,Stop Loss,$-6.00,$299.75,$228403.50,374,$299.75
Final P&L Day: 299.75,,,,,,,,,,,
2025-06-13,12:00:00,21905.5,SELL,1,0.02h,Stop Loss,$1101.50,$1101.50,$229505.00,375,$1101.50
2025-06-13,12:39:00,21913.25,BUY,1,0.02h,Stop Loss,$-6.00,$1095.50,$229499.00,375,$1095.50
2025-06-13,12:40:00,21687.25,SELL,1,0.02h,Stop Loss,$-6.00,$1089.50,$229493.00,375,$1089.50
2025-06-13,12:41:00,21905.5,BUY,1,0.02h,Stop Loss,$-6.00,$1083.50,$229487.00,375,$1083.50
2025-06-13,12:42:00,21684.75,SELL,1,0.02h,Stop Loss,$-6.00,$1077.50,$229481.00,375,$1077.50
2025-06-13,12:43:00,21897.0,BUY,1,0.02h,Stop Loss,$-6.00,$1071.50,$229475.00,375,$1071.50
2025-06-13,12:44:00,21674.75,SELL,1,0.02h,Stop Loss,$40.25,$1111.75,$229515.25,375,$1111.75
2025-06-13,12:46:00,21889.25,BUY,1,0.02h,Break Even,$0.25,$1112.00,$229515.50,375,$1112.00
2025-06-13,12:52:00,21651.5,SELL,1,0.02h,Break Even,$0.25,$1112.25,$229515.75,375,$1112.25
2025-06-13,12:55:00,21870.75,BUY,1,0.02h,Stop Loss,$21.50,$1133.75,$229537.25,375,$1133.75
2025-06-13,13:03:00,21649.25,SELL,1,0.02h,Stop Loss,$-6.00,$1127.75,$229531.25,375,$1127.75
2025-06-13,13:05:00,21874.25,BUY,1,0.02h,Stop Loss,$-6.00,$1121.75,$229525.25,375,$1121.75
2025-06-13,13:06:00,21650.0,SELL,1,0.02h,Stop Loss,$7.75,$1129.50,$229533.00,375,$1129.50
2025-06-13,13:20:00,21857.0,BUY,1,0.02h,Stop Loss,$-6.00,$1123.50,$229527.00,375,$1123.50
2025-06-13,13:21:00,21637.25,SELL,1,0.02h,Stop Loss,$-6.00,$1117.50,$229521.00,375,$1117.50
2025-06-13,13:22:00,21861.0,BUY,1,0.02h,Stop Loss,$-6.00,$1111.50,$229515.00,375,$1111.50
2025-06-13,13:23:00,21646.25,SELL,1,0.02h,Break Even,$0.25,$1111.75,$229515.25,375,$1111.75
2025-06-13,13:26:00,21877.5,BUY,1,0.02h,Stop Loss,$-6.00,$1105.75,$229509.25,375,$1105.75
2025-06-13,13:27:00,21668.5,SELL,1,0.02h,Stop Loss,$34.00,$1139.75,$229543.25,375,$1139.75
2025-06-13,13:30:00,21901.25,BUY,1,0.02h,Stop Loss,$-6.00,$1133.75,$229537.25,375,$1133.75
2025-06-13,13:49:00,21755.25,SELL,1,0.02h,Stop Loss,$50.25,$1184.00,$229587.50,375,$1184.00
2025-06-13,13:53:00,21982.0,BUY,1,0.02h,Stop Loss,$16.50,$1200.50,$229604.00,375,$1200.50
2025-06-13,14:05:00,21731.75,SELL,1,0.02h,Stop Loss,$30.25,$1230.75,$229634.25,375,$1230.75
2025-06-13,14:08:00,21953.0,BUY,1,0.02h,Stop Loss,$6.50,$1237.25,$229640.75,375,$1237.25
2025-06-13,14:10:00,21724.0,SELL,1,0.02h,Stop Loss,$-6.00,$1231.25,$229634.75,375,$1231.25
2025-06-13,14:12:00,21912.25,BUY,1,0.02h,Break Even,$0.25,$1231.50,$229635.00,375,$1231.50
2025-06-13,14:14:00,21694.0,SELL,1,0.02h,Stop Loss,$6.50,$1238.00,$229641.50,375,$1238.00
2025-06-13,14:26:00,21882.75,BUY,1,0.02h,Stop Loss,$16.50,$1254.50,$229658.00,375,$1254.50
2025-06-13,14:33:00,21658.0,SELL,1,0.02h,Stop Loss,$-6.00,$1248.50,$229652.00,375,$1248.50
2025-06-13,14:35:00,21883.25,BUY,1,0.02h,Stop Loss,$-6.00,$1242.50,$229646.00,375,$1242.50
2025-06-13,14:36:00,21676.25,SELL,1,0.02h,Stop Loss,$46.50,$1289.00,$229692.50,375,$1289.00
2025-06-13,14:44:00,21938.25,BUY,1,0.02h,Stop Loss,$-6.00,$1283.00,$229686.50,375,$1283.00
2025-06-13,14:45:00,21707.25,SELL,1,0.02h,Stop Loss,$12.75,$1295.75,$229699.25,375,$1295.75
2025-06-13,14:47:00,21933.0,BUY,1,0.02h,Stop Loss,$9.00,$1304.75,$229708.25,375,$1304.75
2025-06-13,15:07:00,21750.5,SELL,1,0.02h,Stop Loss,$-6.00,$1298.75,$229702.25,375,$1298.75
2025-06-13,15:08:00,21981.25,BUY,1,0.02h,Break Even,$0.25,$1299.00,$229702.50,375,$1299.00
2025-06-13,15:11:00,21737.0,SELL,1,0.02h,Stop Loss,$-6.00,$1293.00,$229696.50,375,$1293.00
2025-06-13,15:12:00,21966.0,BUY,1,0.02h,Stop Loss,$-6.00,$1287.00,$229690.50,375,$1287.00
2025-06-13,15:13:00,21751.5,SELL,1,0.02h,Stop Loss,$-6.00,$1281.00,$229684.50,375,$1281.00
2025-06-13,15:15:00,21984.0,BUY,1,0.02h,Stop Loss,$39.00,$1320.00,$229723.50,375,$1320.00
2025-06-13,15:25:00,21780.75,SELL,1,0.02h,Stop Loss,$31.50,$1351.50,$229755.00,375,$1351.50
2025-06-13,15:28:00,22013.75,BUY,1,0.02h,Break Even,$0.25,$1351.75,$229755.25,375,$1351.75
2025-06-13,15:31:00,21796.0,SELL,1,0.02h,Break Even,$0.25,$1352.00,$229755.50,375,$1352.00
2025-06-13,15:40:00,22018.25,BUY,1,0.02h,Stop Loss,$-6.00,$1346.00,$229749.50,375,$1346.00
2025-06-13,15:41:00,21792.75,SELL,1,0.02h,Break Even,$0.25,$1346.25,$229749.75,375,$1346.25
2025-06-13,15:51:00,22053.0,BUY,1,0.02h,Stop Loss,$-6.00,$1340.25,$229743.75,375,$1340.25
2025-06-13,15:52:00,21839.75,SELL,1,0.02h,Stop Loss,$19.00,$1359.25,$229762.75,375,$1359.25
2025-06-13,15:54:00,22056.5,BUY,1,0.02h,Stop Loss,$22.75,$1382.00,$229785.50,375,$1382.00
2025-06-13,16:02:00,21820.25,SELL,1,0.02h,Stop Loss,$-6.00,$1376.00,$229779.50,375,$1376.00
2025-06-13,16:03:00,22049.75,BUY,1,0.02h,Stop Loss,$-6.00,$1370.00,$229773.50,375,$1370.00
2025-06-13,16:05:00,21821.25,SELL,1,0.02h,Stop Loss,$7.75,$1377.75,$229781.25,375,$1377.75
2025-06-13,16:07:00,22052.0,BUY,1,0.02h,Stop Loss,$6.50,$1384.25,$229787.75,375,$1384.25
2025-06-13,16:18:00,21847.5,SELL,1,0.02h,Stop Loss,$-6.00,$1378.25,$229781.75,375,$1378.25
2025-06-13,16:19:00,22071.5,BUY,1,0.02h,Stop Loss,$-6.00,$1372.25,$229775.75,375,$1372.25
2025-06-13,16:20:00,21844.25,SELL,1,0.02h,Stop Loss,$50.25,$1422.50,$229826.00,375,$1422.50
2025-06-13,16:22:00,22060.0,BUY,1,0.02h,Stop Loss,$16.50,$1439.00,$229842.50,375,$1439.00
2025-06-13,16:25:00,21841.75,SELL,1,0.02h,Break Even,$0.25,$1439.25,$229842.75,375,$1439.25
2025-06-13,16:29:00,22043.0,BUY,1,0.02h,Stop Loss,$-6.00,$1433.25,$229836.75,375,$1433.25
2025-06-13,16:30:00,21820.25,SELL,1,0.02h,Stop Loss,$4.00,$1437.25,$229840.75,375,$1437.25
2025-06-13,16:32:00,22047.75,BUY,1,0.02h,Break Even,$0.25,$1437.50,$229841.00,375,$1437.50
2025-06-13,16:39:00,21816.75,SELL,1,0.02h,Stop Loss,$-6.00,$1431.50,$229835.00,375,$1431.50
2025-06-13,16:40:00,22028.0,BUY,1,0.02h,Stop Loss,$-6.00,$1425.50,$229829.00,375,$1425.50
2025-06-13,16:41:00,21811.0,SELL,1,0.02h,Break Even,$0.25,$1425.75,$229829.25,375,$1425.75
2025-06-13,16:44:00,22030.0,BUY,1,0.02h,Stop Loss,$-6.00,$1419.75,$229823.25,375,$1419.75
2025-06-13,16:45:00,21811.25,SELL,1,0.02h,Stop Loss,$-6.00,$1413.75,$229817.25,375,$1413.75
2025-06-13,16:46:00,22029.25,BUY,1,0.02h,Break Even,$0.25,$1414.00,$229817.50,375,$1414.00
2025-06-13,16:48:00,21800.25,SELL,1,0.02h,Stop Loss,$-6.00,$1408.00,$229811.50,375,$1408.00
2025-06-13,16:51:00,22027.0,BUY,1,0.02h,Stop Loss,$9.00,$1417.00,$229820.50,375,$1417.00
2025-06-13,16:53:00,21821.5,SELL,1,0.02h,Stop Loss,$9.00,$1426.00,$229829.50,375,$1426.00
2025-06-13,17:00:00,22048.0,BUY,1,0.02h,Stop Loss,$5.25,$1431.25,$229834.75,375,$1431.25
2025-06-13,17:09:00,21808.25,SELL,1,0.02h,Stop Loss,$-6.00,$1425.25,$229828.75,375,$1425.25
2025-06-13,17:10:00,22025.75,BUY,1,0.02h,Stop Loss,$-6.00,$1419.25,$229822.75,375,$1419.25
2025-06-13,17:13:00,21792.75,SELL,1,0.02h,Stop Loss,$-6.00,$1413.25,$229816.75,375,$1413.25
2025-06-13,17:17:00,21977.5,BUY,1,0.02h,Stop Loss,$-6.00,$1407.25,$229810.75,375,$1407.25
2025-06-13,17:18:00,21774.75,SELL,1,0.02h,Stop Loss,$-6.00,$1401.25,$229804.75,375,$1401.25
2025-06-13,17:32:00,22007.0,BUY,1,0.02h,Stop Loss,$-6.00,$1395.25,$229798.75,375,$1395.25
2025-06-13,17:44:00,21762.0,SELL,1,0.02h,Stop Loss,$45.25,$1440.50,$229844.00,375,$1440.50
2025-06-13,17:53:00,22013.5,BUY,1,0.02h,Break Even,$0.25,$1440.75,$229844.25,375,$1440.75
2025-06-13,17:58:00,21785.75,SELL,1,0.02h,Stop Loss,$-6.00,$1434.75,$229838.25,375,$1434.75
2025-06-13,17:59:00,22008.5,BUY,1,0.02h,Stop Loss,$-6.00,$1428.75,$229832.25,375,$1428.75
2025-06-13,18:00:00,21788.0,SELL,1,0.02h,Stop Loss,$-6.00,$1422.75,$229826.25,375,$1422.75
2025-06-13,18:01:00,22020.25,BUY,1,0.02h,Break Even,$0.25,$1423.00,$229826.50,375,$1423.00
2025-06-13,18:07:00,21751.0,SELL,1,0.02h,Stop Loss,$37.75,$1460.75,$229864.25,375,$1460.75
2025-06-13,18:23:00,21925.5,BUY,1,0.02h,Stop Loss,$-6.00,$1454.75,$229858.25,375,$1454.75
2025-06-13,18:24:00,21722.75,SELL,1,0.02h,Stop Loss,$20.25,$1475.00,$229878.50,375,$1475.00
2025-06-13,18:46:00,21865.75,BUY,1,0.02h,Stop Loss,$-6.00,$1469.00,$229872.50,375,$1469.00
2025-06-13,18:47:00,21645.25,SELL,1,0.02h,Stop Loss,$60.25,$1529.25,$229932.75,375,$1529.25
2025-06-13,18:56:00,21876.5,BUY,1,0.02h,Stop Loss,$15.25,$1544.50,$229948.00,375,$1544.50
2025-06-13,19:04:00,21656.0,SELL,1,0.02h,Stop Loss,$14.00,$1558.50,$229962.00,375,$1558.50
2025-06-13,19:16:00,21898.5,BUY,1,0.02h,Stop Loss,$-6.00,$1552.50,$229956.00,375,$1552.50
2025-06-13,19:23:00,21648.25,SELL,1,0.02h,Stop Loss,$25.25,$1577.75,$229981.25,375,$1577.75
2025-06-13,19:30:00,21850.0,BUY,1,0.02h,Stop Loss,$-6.00,$1571.75,$229975.25,375,$1571.75
2025-06-13,19:31:00,21646.75,SELL,1,0.02h,Stop Loss,$5.25,$1577.00,$229980.50,375,$1577.00
2025-06-13,19:37:00,21872.75,BUY,1,0.02h,Stop Loss,$-6.00,$1571.00,$229974.50,375,$1571.00
2025-06-13,19:38:00,21669.25,SELL,1,0.02h,Stop Loss,$-6.00,$1565.00,$229968.50,375,$1565.00
2025-06-13,19:39:00,21882.0,BUY,1,0.02h,Stop Loss,$-6.00,$1559.00,$229962.50,375,$1559.00
2025-06-13,19:44:00,21632.25,SELL,1,0.02h,Stop Loss,$-6.00,$1553.00,$229956.50,375,$1553.00
2025-06-13,19:45:00,21846.0,BUY,1,0.02h,Stop Loss,$-6.00,$1547.00,$229950.50,375,$1547.00
2025-06-13,19:46:00,21611.5,SELL,1,0.02h,Stop Loss,$-6.00,$1541.00,$229944.50,375,$1541.00
2025-06-13,19:47:00,21834.5,BUY,1,0.02h,Stop Loss,$-6.00,$1535.00,$229938.50,375,$1535.00
2025-06-13,19:48:00,21619.5,SELL,1,0.02h,Break Even,$0.25,$1535.25,$229938.75,375,$1535.25
2025-06-13,19:50:00,21854.0,BUY,1,0.02h,Stop Loss,$-6.00,$1529.25,$229932.75,375,$1529.25
2025-06-13,19:51:00,21638.0,SELL,1,0.02h,Stop Loss,$-6.00,$1523.25,$229926.75,375,$1523.25
2025-06-13,19:52:00,21851.25,BUY,1,0.02h,Break Even,$0.25,$1523.50,$229927.00,375,$1523.50
2025-06-13,19:55:00,21624.5,SELL,1,0.02h,Stop Loss,$-6.00,$1517.50,$229921.00,375,$1517.50
2025-06-13,19:56:00,21835.25,BUY,1,0.02h,Stop Loss,$-6.00,$1511.50,$229915.00,375,$1511.50
2025-06-13,19:57:00,21623.75,SELL,1,0.02h,Stop Loss,$20.25,$1531.75,$229935.25,375,$1531.75
2025-06-13,20:00:00,21868.25,BUY,1,0.02h,Stop Loss,$64.00,$1595.75,$229999.25,375,$1595.75
2025-06-13,20:06:00,21658.75,SELL,1,0.02h,Stop Loss,$-6.00,$1589.75,$229993.25,375,$1589.75
2025-06-13,20:07:00,21865.5,BUY,1,0.02h,Stop Loss,$-6.00,$1583.75,$229987.25,375,$1583.75
2025-06-13,20:08:00,21650.5,SELL,1,0.02h,Stop Loss,$-6.00,$1577.75,$229981.25,375,$1577.75
2025-06-13,20:17:00,21879.5,BUY,1,0.02h,Stop Loss,$-6.00,$1571.75,$229975.25,375,$1571.75
2025-06-13,20:18:00,21667.75,SELL,1,0.02h,Stop Loss,$-6.00,$1565.75,$229969.25,375,$1565.75
2025-06-13,20:19:00,21887.0,BUY,1,0.02h,Stop Loss,$-6.00,$1559.75,$229963.25,375,$1559.75
2025-06-13,20:21:00,21665.75,SELL,1,0.02h,Stop Loss,$-6.00,$1553.75,$229957.25,375,$1553.75
2025-06-13,20:22:00,21877.5,BUY,1,0.02h,Stop Loss,$-6.00,$1547.75,$229951.25,375,$1547.75
2025-06-13,20:24:00,21658.5,SELL,1,0.02h,Stop Loss,$-6.00,$1541.75,$229945.25,375,$1541.75
2025-06-13,20:25:00,21875.25,BUY,1,0.02h,Stop Loss,$-6.00,$1535.75,$229939.25,375,$1535.75
2025-06-13,20:28:00,21653.75,SELL,1,0.02h,Stop Loss,$-6.00,$1529.75,$229933.25,375,$1529.75
2025-06-13,20:29:00,21867.0,BUY,1,0.02h,Stop Loss,$-6.00,$1523.75,$229927.25,375,$1523.75
2025-06-13,20:38:00,21672.25,SELL,1,0.02h,Break Even,$0.25,$1524.00,$229927.50,375,$1524.00
2025-06-13,20:40:00,21882.75,BUY,1,0.02h,Stop Loss,$-6.00,$1518.00,$229921.50,375,$1518.00
2025-06-13,20:41:00,21662.0,SELL,1,0.02h,Stop Loss,$12.75,$1530.75,$229934.25,375,$1530.75
2025-06-13,20:46:00,21875.0,BUY,1,0.02h,Stop Loss,$-6.00,$1524.75,$229928.25,375,$1524.75
2025-06-13,20:52:00,21651.75,SELL,1,0.02h,Stop Loss,$-6.00,$1518.75,$229922.25,375,$1518.75
2025-06-13,20:53:00,21866.75,BUY,1,0.02h,Stop Loss,$-6.00,$1512.75,$229916.25,375,$1512.75
2025-06-13,20:54:00,21647.25,SELL,1,0.02h,Stop Loss,$-6.00,$1506.75,$229910.25,375,$1506.75
2025-06-13,20:55:00,21864.0,BUY,1,0.02h,Stop Loss,$-6.00,$1500.75,$229904.25,375,$1500.75
2025-06-13,20:56:00,21647.75,SELL,1,0.02h,Break Even,$0.25,$1501.00,$229904.50,375,$1501.00
Final P&L Day: 1501.00,,,,,,,,,,,
2025-06-16,12:00:00,22033.25,BUY,1,0.02h,Break Even,$0.25,$0.25,$229904.75,376,$0.25
2025-06-16,12:55:00,22038.75,SELL,1,0.02h,Stop Loss,$-6.00,$-5.75,$229898.75,376,$-5.75
2025-06-16,12:56:00,22041.75,BUY,1,0.02h,Break Even,$0.25,$-5.50,$229899.00,376,$-5.50
2025-06-16,12:59:00,22035.0,SELL,1,0.02h,Stop Loss,$-6.00,$-11.50,$229893.00,376,$-11.50
2025-06-16,13:02:00,22043.0,BUY,1,0.02h,Stop Loss,$9.00,$-2.50,$229902.00,376,$-2.50
2025-06-16,13:07:00,22035.5,SELL,1,0.02h,Stop Loss,$10.25,$7.75,$229912.25,376,$7.75
2025-06-16,13:14:00,22040.75,BUY,1,0.02h,Break Even,$0.25,$8.00,$229912.50,376,$8.00
2025-06-16,13:17:00,22037.5,SELL,1,0.02h,Stop Loss,$17.75,$25.75,$229930.25,376,$25.75
2025-06-16,13:32:00,22079.5,BUY,1,0.02h,Stop Loss,$80.25,$106.00,$230010.50,376,$106.00
2025-06-16,14:52:00,22187.75,SELL,1,0.02h,Stop Loss,$7.75,$113.75,$230018.25,376,$113.75
2025-06-16,15:03:00,22196.25,BUY,1,0.02h,Stop Loss,$-6.00,$107.75,$230012.25,376,$107.75
2025-06-16,15:04:00,22178.75,SELL,1,0.02h,Break Even,$0.25,$108.00,$230012.50,376,$108.00
2025-06-16,15:08:00,22191.75,BUY,1,0.02h,Break Even,$0.25,$108.25,$230012.75,376,$108.25
2025-06-16,15:29:00,22190.0,SELL,1,0.02h,Stop Loss,$12.75,$121.00,$230025.50,376,$121.00
2025-06-16,15:47:00,22203.75,BUY,1,0.02h,Stop Loss,$-6.00,$115.00,$230019.50,376,$115.00
2025-06-16,15:52:00,22187.0,SELL,1,0.02h,Stop Loss,$16.50,$131.50,$230036.00,376,$131.50
2025-06-16,16:15:00,22184.0,BUY,1,0.02h,Break Even,$0.25,$131.75,$230036.25,376,$131.75
2025-06-16,16:26:00,22169.5,SELL,1,0.02h,Stop Loss,$16.50,$148.25,$230052.75,376,$148.25
2025-06-16,16:54:00,22178.5,BUY,1,0.02h,Stop Loss,$-6.00,$142.25,$230046.75,376,$142.25
2025-06-16,17:03:00,22159.75,SELL,1,0.02h,Break Even,$0.25,$142.50,$230047.00,376,$142.50
2025-06-16,17:20:00,22169.5,BUY,1,0.02h,Stop Loss,$40.25,$182.75,$230087.25,376,$182.75
2025-06-16,17:54:00,22185.25,SELL,1,0.02h,Stop Loss,$35.25,$218.00,$230122.50,376,$218.00
2025-06-16,18:26:00,22173.75,BUY,1,0.02h,Break Even,$0.25,$218.25,$230122.75,376,$218.25
2025-06-16,18:31:00,22165.5,SELL,1,0.02h,Stop Loss,$9.00,$227.25,$230131.75,376,$227.25
2025-06-16,18:57:00,22171.0,BUY,1,0.02h,Stop Loss,$6.50,$233.75,$230138.25,376,$233.75
2025-06-16,19:08:00,22156.5,SELL,1,0.02h,Break Even,$0.25,$234.00,$230138.50,376,$234.00
2025-06-16,19:23:00,22176.5,BUY,1,0.02h,Stop Loss,$10.25,$244.25,$230148.75,376,$244.25
2025-06-16,19:34:00,22155.5,SELL,1,0.02h,Stop Loss,$-6.00,$238.25,$230142.75,376,$238.25
2025-06-16,19:46:00,22172.5,BUY,1,0.02h,Stop Loss,$-6.00,$232.25,$230136.75,376,$232.25
2025-06-16,19:52:00,22153.75,SELL,1,0.02h,Break Even,$0.25,$232.50,$230137.00,376,$232.50
2025-06-16,19:56:00,22173.25,BUY,1,0.02h,Break Even,$0.25,$232.75,$230137.25,376,$232.75
2025-06-16,19:58:00,22151.25,SELL,1,0.02h,Stop Loss,$19.00,$251.75,$230156.25,376,$251.75
2025-06-16,20:01:00,22172.5,BUY,1,0.02h,Stop Loss,$19.00,$270.75,$230175.25,376,$270.75
2025-06-16,20:22:00,22168.0,SELL,1,0.03h,Break Even,$0.25,$271.00,$230175.50,376,$271.00
2025-06-16,20:37:00,22172.0,BUY,1,0.02h,Break Even,$0.25,$271.25,$230175.75,376,$271.25
2025-06-16,20:55:00,22169.5,SELL,1,0.02h,Stop Loss,$7.75,$279.00,$230183.50,376,$279.00
Final P&L Day: 279.00,,,,,,,,,,,
2025-06-17,12:14:00,22082.75,BUY,1,0.02h,Stop Loss,$-6.00,$-6.00,$230177.50,377,$-6.00
2025-06-17,12:15:00,21858.0,SELL,1,0.02h,Stop Loss,$-6.00,$-12.00,$230171.50,377,$-12.00
2025-06-17,12:28:00,22083.75,BUY,1,0.02h,Stop Loss,$-6.00,$-18.00,$230165.50,377,$-18.00
2025-06-17,12:34:00,21848.5,SELL,1,0.02h,Stop Loss,$-6.00,$-24.00,$230159.50,377,$-24.00
2025-06-17,12:35:00,22073.75,BUY,1,0.02h,Break Even,$0.25,$-23.75,$230159.75,377,$-23.75
2025-06-17,12:38:00,21841.5,SELL,1,0.02h,Stop Loss,$-6.00,$-29.75,$230153.75,377,$-29.75
2025-06-17,12:39:00,22071.25,BUY,1,0.02h,Stop Loss,$56.50,$26.75,$230210.25,377,$26.75
2025-06-17,12:44:00,21855.75,SELL,1,0.02h,Stop Loss,$-6.00,$20.75,$230204.25,377,$20.75
2025-06-17,12:47:00,22074.0,BUY,1,0.02h,Stop Loss,$-6.00,$14.75,$230198.25,377,$14.75
2025-06-17,12:48:00,21842.5,SELL,1,0.02h,Stop Loss,$-6.00,$8.75,$230192.25,377,$8.75
2025-06-17,12:50:00,22057.5,BUY,1,0.02h,Stop Loss,$-6.00,$2.75,$230186.25,377,$2.75
2025-06-17,12:52:00,21831.0,SELL,1,0.02h,Stop Loss,$5.25,$8.00,$230191.50,377,$8.00
2025-06-17,13:02:00,22056.75,BUY,1,0.02h,Stop Loss,$5.25,$13.25,$230196.75,377,$13.25
2025-06-17,13:07:00,21825.75,SELL,1,0.02h,Stop Loss,$12.75,$26.00,$230209.50,377,$26.00
2025-06-17,13:11:00,22042.0,BUY,1,0.02h,Stop Loss,$10.25,$36.25,$230219.75,377,$36.25
2025-06-17,13:14:00,21822.5,SELL,1,0.02h,Break Even,$0.25,$36.50,$230220.00,377,$36.50
2025-06-17,13:30:00,22063.25,BUY,1,0.02h,Stop Loss,$189.00,$225.50,$230409.00,377,$225.50
2025-06-17,13:37:00,21854.75,SELL,1,0.02h,Stop Loss,$-6.00,$219.50,$230403.00,377,$219.50
2025-06-17,13:38:00,22070.25,BUY,1,0.02h,Stop Loss,$-6.00,$213.50,$230397.00,377,$213.50
2025-06-17,13:46:00,21817.5,SELL,1,0.02h,Stop Loss,$-6.00,$207.50,$230391.00,377,$207.50
2025-06-17,13:47:00,22055.0,BUY,1,0.02h,Stop Loss,$54.00,$261.50,$230445.00,377,$261.50
2025-06-17,13:59:00,21862.75,SELL,1,0.02h,Stop Loss,$-6.00,$255.50,$230439.00,377,$255.50
2025-06-17,14:06:00,22079.0,BUY,1,0.02h,Stop Loss,$37.75,$293.25,$230476.75,377,$293.25
2025-06-17,14:16:00,21899.75,SELL,1,0.02h,Break Even,$0.25,$293.50,$230477.00,377,$293.50
2025-06-17,14:32:00,22104.25,BUY,1,0.02h,Break Even,$0.25,$293.75,$230477.25,377,$293.75
2025-06-17,14:38:00,21861.5,SELL,1,0.02h,Stop Loss,$-6.00,$287.75,$230471.25,377,$287.75
2025-06-17,14:39:00,22097.75,BUY,1,0.02h,Break Even,$0.25,$288.00,$230471.50,377,$288.00
2025-06-17,14:42:00,21858.5,SELL,1,0.02h,Stop Loss,$-6.00,$282.00,$230465.50,377,$282.00
2025-06-17,14:43:00,22084.75,BUY,1,0.02h,Stop Loss,$-6.00,$276.00,$230459.50,377,$276.00
2025-06-17,14:44:00,21864.75,SELL,1,0.02h,Stop Loss,$-6.00,$270.00,$230453.50,377,$270.00
2025-06-17,14:45:00,22084.0,BUY,1,0.02h,Stop Loss,$86.50,$356.50,$230540.00,377,$356.50
2025-06-17,14:56:00,21867.0,SELL,1,0.02h,Stop Loss,$-6.00,$350.50,$230534.00,377,$350.50
2025-06-17,14:58:00,22075.75,BUY,1,0.02h,Stop Loss,$34.00,$384.50,$230568.00,377,$384.50
2025-06-17,15:00:00,21849.5,SELL,1,0.02h,Break Even,$0.25,$384.75,$230568.25,377,$384.75
2025-06-17,15:10:00,22110.25,BUY,1,0.02h,Stop Loss,$16.50,$401.25,$230584.75,377,$401.25
2025-06-17,15:18:00,21884.5,SELL,1,0.02h,Break Even,$0.25,$401.50,$230585.00,377,$401.50
2025-06-17,15:35:00,22089.0,BUY,1,0.02h,Break Even,$0.25,$401.75,$230585.25,377,$401.75
2025-06-17,15:42:00,21880.25,SELL,1,0.02h,Stop Loss,$-6.00,$395.75,$230579.25,377,$395.75
2025-06-17,15:45:00,22118.5,BUY,1,0.02h,Stop Loss,$5.25,$401.00,$230584.50,377,$401.00
2025-06-17,15:48:00,21885.25,SELL,1,0.02h,Stop Loss,$85.25,$486.25,$230669.75,377,$486.25
2025-06-17,15:51:00,22102.0,BUY,1,0.02h,Stop Loss,$-6.00,$480.25,$230663.75,377,$480.25
2025-06-17,15:52:00,21889.0,SELL,1,0.02h,Stop Loss,$-6.00,$474.25,$230657.75,377,$474.25
2025-06-17,15:59:00,22105.5,BUY,1,0.02h,Break Even,$0.25,$474.50,$230658.00,377,$474.50
2025-06-17,16:11:00,21894.0,SELL,1,0.02h,Stop Loss,$-6.00,$468.50,$230652.00,377,$468.50
2025-06-17,16:12:00,22129.5,BUY,1,0.02h,Stop Loss,$-6.00,$462.50,$230646.00,377,$462.50
2025-06-17,16:22:00,21895.25,SELL,1,0.02h,Stop Loss,$-6.00,$456.50,$230640.00,377,$456.50
2025-06-17,16:23:00,22117.0,BUY,1,0.02h,Stop Loss,$-6.00,$450.50,$230634.00,377,$450.50
2025-06-17,16:24:00,21888.25,SELL,1,0.02h,Stop Loss,$5.25,$455.75,$230639.25,377,$455.75
2025-06-17,16:27:00,22111.0,BUY,1,0.02h,Stop Loss,$-6.00,$449.75,$230633.25,377,$449.75
2025-06-17,16:28:00,21885.25,SELL,1,0.02h,Stop Loss,$-6.00,$443.75,$230627.25,377,$443.75
2025-06-17,16:29:00,22117.0,BUY,1,0.02h,Break Even,$0.25,$444.00,$230627.50,377,$444.00
2025-06-17,16:32:00,21886.5,SELL,1,0.02h,Break Even,$0.25,$444.25,$230627.75,377,$444.25
2025-06-17,16:35:00,22122.75,BUY,1,0.02h,Stop Loss,$-6.00,$438.25,$230621.75,377,$438.25
2025-06-17,16:36:00,21899.25,SELL,1,0.02h,Stop Loss,$-6.00,$432.25,$230615.75,377,$432.25
2025-06-17,16:37:00,22123.5,BUY,1,0.02h,Break Even,$0.25,$432.50,$230616.00,377,$432.50
2025-06-17,16:40:00,21885.75,SELL,1,0.02h,Stop Loss,$19.00,$451.50,$230635.00,377,$451.50
2025-06-17,16:50:00,22070.5,BUY,1,0.02h,Stop Loss,$17.75,$469.25,$230652.75,377,$469.25
2025-06-17,16:56:00,21820.25,SELL,1,0.02h,Break Even,$0.25,$469.50,$230653.00,377,$469.50
2025-06-17,17:15:00,22051.0,BUY,1,0.02h,Stop Loss,$4.00,$473.50,$230657.00,377,$473.50
2025-06-17,17:20:00,21815.25,SELL,1,0.02h,Stop Loss,$40.25,$513.75,$230697.25,377,$513.75
2025-06-17,17:24:00,22033.5,BUY,1,0.02h,Stop Loss,$60.25,$574.00,$230757.50,377,$574.00
2025-06-17,17:28:00,21803.5,SELL,1,0.02h,Stop Loss,$-6.00,$568.00,$230751.50,377,$568.00
2025-06-17,17:29:00,22020.75,BUY,1,0.02h,Stop Loss,$5.25,$573.25,$230756.75,377,$573.25
2025-06-17,17:36:00,21818.75,SELL,1,0.02h,Stop Loss,$-6.00,$567.25,$230750.75,377,$567.25
2025-06-17,17:37:00,22042.75,BUY,1,0.02h,Stop Loss,$10.25,$577.50,$230761.00,377,$577.50
2025-06-17,17:44:00,21793.0,SELL,1,0.02h,Stop Loss,$65.25,$642.75,$230826.25,377,$642.75
2025-06-17,18:08:00,21967.0,BUY,1,0.02h,Break Even,$0.25,$643.00,$230826.50,377,$643.00
2025-06-17,18:17:00,21721.25,SELL,1,0.02h,Stop Loss,$12.75,$655.75,$230839.25,377,$655.75
2025-06-17,18:24:00,21946.25,BUY,1,0.02h,Stop Loss,$-6.00,$649.75,$230833.25,377,$649.75
2025-06-17,18:25:00,21713.5,SELL,1,0.02h,Stop Loss,$27.75,$677.50,$230861.00,377,$677.50
2025-06-17,18:32:00,21955.5,BUY,1,0.02h,Break Even,$0.25,$677.75,$230861.25,377,$677.75
2025-06-17,18:53:00,21713.25,SELL,1,0.02h,Stop Loss,$-6.00,$671.75,$230855.25,377,$671.75
2025-06-17,18:57:00,21962.75,BUY,1,0.02h,Stop Loss,$-6.00,$665.75,$230849.25,377,$665.75
2025-06-17,18:58:00,21743.75,SELL,1,0.02h,Stop Loss,$-6.00,$659.75,$230843.25,377,$659.75
2025-06-17,18:59:00,21974.0,BUY,1,0.02h,Stop Loss,$-6.00,$653.75,$230837.25,377,$653.75
2025-06-17,19:00:00,21751.0,SELL,1,0.02h,Stop Loss,$-6.00,$647.75,$230831.25,377,$647.75
2025-06-17,19:01:00,21973.5,BUY,1,0.02h,Stop Loss,$-6.00,$641.75,$230825.25,377,$641.75
2025-06-17,19:02:00,21742.5,SELL,1,0.02h,Stop Loss,$-6.00,$635.75,$230819.25,377,$635.75
2025-06-17,19:03:00,21973.25,BUY,1,0.02h,Stop Loss,$-6.00,$629.75,$230813.25,377,$629.75
2025-06-17,19:04:00,21734.75,SELL,1,0.02h,Stop Loss,$-6.00,$623.75,$230807.25,377,$623.75
2025-06-17,19:05:00,21956.0,BUY,1,0.02h,Stop Loss,$-6.00,$617.75,$230801.25,377,$617.75
2025-06-17,19:11:00,21729.75,SELL,1,0.02h,Stop Loss,$-6.00,$611.75,$230795.25,377,$611.75
2025-06-17,19:12:00,21970.0,BUY,1,0.02h,Stop Loss,$-6.00,$605.75,$230789.25,377,$605.75
2025-06-17,19:13:00,21748.75,SELL,1,0.02h,Stop Loss,$20.25,$626.00,$230809.50,377,$626.00
2025-06-17,19:16:00,21974.75,BUY,1,0.02h,Break Even,$0.25,$626.25,$230809.75,377,$626.25
2025-06-17,19:18:00,21735.25,SELL,1,0.02h,Stop Loss,$-6.00,$620.25,$230803.75,377,$620.25
2025-06-17,19:21:00,21983.0,BUY,1,0.02h,Stop Loss,$-6.00,$614.25,$230797.75,377,$614.25
2025-06-17,19:22:00,21756.25,SELL,1,0.02h,Stop Loss,$-6.00,$608.25,$230791.75,377,$608.25
2025-06-17,19:23:00,21986.5,BUY,1,0.02h,Stop Loss,$-6.00,$602.25,$230785.75,377,$602.25
2025-06-17,19:24:00,21757.5,SELL,1,0.02h,Break Even,$0.25,$602.50,$230786.00,377,$602.50
2025-06-17,19:26:00,21986.25,BUY,1,0.02h,Stop Loss,$-6.00,$596.50,$230780.00,377,$596.50
2025-06-17,19:27:00,21760.0,SELL,1,0.02h,Stop Loss,$-6.00,$590.50,$230774.00,377,$590.50
2025-06-17,19:28:00,21982.25,BUY,1,0.02h,Stop Loss,$-6.00,$584.50,$230768.00,377,$584.50
2025-06-17,19:29:00,21757.0,SELL,1,0.02h,Stop Loss,$-6.00,$578.50,$230762.00,377,$578.50
2025-06-17,19:31:00,21987.0,BUY,1,0.02h,Stop Loss,$-6.00,$572.50,$230756.00,377,$572.50
2025-06-17,19:32:00,21751.5,SELL,1,0.02h,Stop Loss,$-6.00,$566.50,$230750.00,377,$566.50
2025-06-17,19:39:00,21987.25,BUY,1,0.02h,Break Even,$0.25,$566.75,$230750.25,377,$566.75
2025-06-17,19:44:00,21749.25,SELL,1,0.02h,Stop Loss,$11.50,$578.25,$230761.75,377,$578.25
2025-06-17,19:46:00,21986.5,BUY,1,0.02h,Break Even,$0.25,$578.50,$230762.00,377,$578.50
2025-06-17,19:53:00,21747.75,SELL,1,0.02h,Stop Loss,$14.00,$592.50,$230776.00,377,$592.50
2025-06-17,19:59:00,21954.0,BUY,1,0.02h,Stop Loss,$-6.00,$586.50,$230770.00,377,$586.50
2025-06-17,20:00:00,21730.5,SELL,1,0.02h,Stop Loss,$24.00,$610.50,$230794.00,377,$610.50
2025-06-17,20:03:00,21965.75,BUY,1,0.02h,Break Even,$0.25,$610.75,$230794.25,377,$610.75
2025-06-17,20:06:00,21735.5,SELL,1,0.02h,Stop Loss,$-6.00,$604.75,$230788.25,377,$604.75
2025-06-17,20:07:00,21963.0,BUY,1,0.02h,Break Even,$0.25,$605.00,$230788.50,377,$605.00
2025-06-17,20:21:00,21721.75,SELL,1,0.02h,Stop Loss,$-6.00,$599.00,$230782.50,377,$599.00
2025-06-17,20:22:00,21949.5,BUY,1,0.02h,Stop Loss,$-6.00,$593.00,$230776.50,377,$593.00
2025-06-17,20:25:00,21726.25,SELL,1,0.02h,Stop Loss,$-6.00,$587.00,$230770.50,377,$587.00
2025-06-17,20:43:00,21960.0,BUY,1,0.02h,Break Even,$0.25,$587.25,$230770.75,377,$587.25
2025-06-17,20:53:00,21715.0,SELL,1,0.02h,Break Even,$0.25,$587.50,$230771.00,377,$587.50
2025-06-17,20:57:00,21957.0,BUY,1,0.02h,Stop Loss,$-6.00,$581.50,$230765.00,377,$581.50
2025-06-17,20:59:00,21731.25,SELL,1,0.02h,Stop Loss,$-6.00,$575.50,$230759.00,377,$575.50
2025-06-17,21:00:00,21953.25,BUY,1,1.02h,Stop Loss,$-6.00,$569.50,$230753.00,377,$569.50
2025-06-17,22:01:00,21712.5,SELL,1,0.02h,Stop Loss,$55.25,$624.75,$230808.25,377,$624.75
2025-06-17,22:07:00,21911.25,BUY,1,0.02h,Break Even,$0.25,$625.00,$230808.50,377,$625.00
2025-06-17,22:10:00,21702.75,SELL,1,0.02h,Stop Loss,$44.00,$669.00,$230852.50,377,$669.00
2025-06-17,22:13:00,21920.0,BUY,1,0.02h,Stop Loss,$-6.00,$663.00,$230846.50,377,$663.00
2025-06-17,22:14:00,21689.75,SELL,1,0.02h,Stop Loss,$-6.00,$657.00,$230840.50,377,$657.00
2025-06-17,22:15:00,21919.5,BUY,1,0.02h,Break Even,$0.25,$657.25,$230840.75,377,$657.25
2025-06-17,22:22:00,21685.75,SELL,1,0.02h,Break Even,$0.25,$657.50,$230841.00,377,$657.50
2025-06-17,22:38:00,21896.5,BUY,1,0.02h,Break Even,$0.25,$657.75,$230841.25,377,$657.75
2025-06-17,22:43:00,21660.5,SELL,1,0.02h,Break Even,$0.25,$658.00,$230841.50,377,$658.00
2025-06-17,22:47:00,21887.0,BUY,1,0.02h,Stop Loss,$-6.00,$652.00,$230835.50,377,$652.00
2025-06-17,22:48:00,21660.25,SELL,1,0.02h,Stop Loss,$42.75,$694.75,$230878.25,377,$694.75
2025-06-17,22:50:00,21886.0,BUY,1,0.02h,Stop Loss,$-6.00,$688.75,$230872.25,377,$688.75
2025-06-17,22:51:00,21662.25,SELL,1,0.02h,Stop Loss,$-6.00,$682.75,$230866.25,377,$682.75
2025-06-17,22:52:00,21882.75,BUY,1,0.02h,Break Even,$0.25,$683.00,$230866.50,377,$683.00
2025-06-17,22:59:00,21646.25,SELL,1,0.02h,Break Even,$0.25,$683.25,$230866.75,377,$683.25
Final P&L Day: 683.25,,,,,,,,,,,
2025-06-18,12:02:00,22004.0,BUY,1,0.02h,Stop Loss,$-6.00,$-6.00,$230860.75,378,$-6.00
2025-06-18,12:22:00,21784.5,SELL,1,0.02h,Break Even,$0.25,$-5.75,$230861.00,378,$-5.75
2025-06-18,12:29:00,22001.0,BUY,1,0.02h,Stop Loss,$-6.00,$-11.75,$230855.00,378,$-11.75
2025-06-18,12:30:00,21779.75,SELL,1,0.02h,Stop Loss,$45.25,$33.50,$230900.25,378,$33.50
2025-06-18,12:37:00,22004.75,BUY,1,0.02h,Break Even,$0.25,$33.75,$230900.50,378,$33.75
2025-06-18,12:44:00,21765.5,SELL,1,0.02h,Break Even,$0.25,$34.00,$230900.75,378,$34.00
2025-06-18,12:47:00,21992.0,BUY,1,0.02h,Stop Loss,$-6.00,$28.00,$230894.75,378,$28.00
2025-06-18,12:58:00,21769.0,SELL,1,0.02h,Stop Loss,$-6.00,$22.00,$230888.75,378,$22.00
2025-06-18,12:59:00,21988.5,BUY,1,0.02h,Stop Loss,$-6.00,$16.00,$230882.75,378,$16.00
2025-06-18,13:00:00,21763.0,SELL,1,0.02h,Break Even,$0.25,$16.25,$230883.00,378,$16.25
2025-06-18,13:05:00,21999.25,BUY,1,0.02h,Stop Loss,$-6.00,$10.25,$230877.00,378,$10.25
2025-06-18,13:06:00,21778.0,SELL,1,0.02h,Break Even,$0.25,$10.50,$230877.25,378,$10.50
2025-06-18,13:12:00,22008.25,BUY,1,0.02h,Stop Loss,$-6.00,$4.50,$230871.25,378,$4.50
2025-06-18,13:16:00,21776.25,SELL,1,0.02h,Stop Loss,$-6.00,$-1.50,$230865.25,378,$-1.50
2025-06-18,13:21:00,22010.0,BUY,1,0.02h,Stop Loss,$-6.00,$-7.50,$230859.25,378,$-7.50
2025-06-18,13:22:00,21789.5,SELL,1,0.02h,Stop Loss,$-6.00,$-13.50,$230853.25,378,$-13.50
2025-06-18,13:23:00,22008.25,BUY,1,0.02h,Stop Loss,$-6.00,$-19.50,$230847.25,378,$-19.50
2025-06-18,13:25:00,21784.75,SELL,1,0.02h,Stop Loss,$-6.00,$-25.50,$230841.25,378,$-25.50
2025-06-18,13:26:00,22006.0,BUY,1,0.02h,Stop Loss,$-6.00,$-31.50,$230835.25,378,$-31.50
2025-06-18,13:28:00,21781.75,SELL,1,0.02h,Stop Loss,$32.75,$1.25,$230868.00,378,$1.25
2025-06-18,13:33:00,21947.5,BUY,1,0.02h,Break Even,$0.25,$1.50,$230868.25,378,$1.50
2025-06-18,13:38:00,21729.75,SELL,1,0.02h,Stop Loss,$-6.00,$-4.50,$230862.25,378,$-4.50
2025-06-18,13:39:00,21957.0,BUY,1,0.02h,Stop Loss,$-6.00,$-10.50,$230856.25,378,$-10.50
2025-06-18,13:40:00,21739.5,SELL,1,0.02h,Stop Loss,$12.75,$2.25,$230869.00,378,$2.25
2025-06-18,13:42:00,21975.25,BUY,1,0.02h,Stop Loss,$-6.00,$-3.75,$230863.00,378,$-3.75
2025-06-18,13:43:00,21745.25,SELL,1,0.02h,Break Even,$0.25,$-3.50,$230863.25,378,$-3.50
2025-06-18,13:51:00,22009.5,BUY,1,0.02h,Stop Loss,$15.25,$11.75,$230878.50,378,$11.75
2025-06-18,13:59:00,21784.25,SELL,1,0.02h,Stop Loss,$-6.00,$5.75,$230872.50,378,$5.75
2025-06-18,14:00:00,22001.25,BUY,1,0.02h,Stop Loss,$16.50,$22.25,$230889.00,378,$22.25
2025-06-18,14:26:00,21843.5,SELL,1,0.02h,Stop Loss,$-6.00,$16.25,$230883.00,378,$16.25
2025-06-18,14:27:00,22076.5,BUY,1,0.02h,Stop Loss,$10.25,$26.50,$230893.25,378,$26.50
2025-06-18,14:36:00,21867.75,SELL,1,0.02h,Stop Loss,$-6.00,$20.50,$230887.25,378,$20.50
2025-06-18,14:37:00,22085.5,BUY,1,0.02h,Break Even,$0.25,$20.75,$230887.50,378,$20.75
2025-06-18,14:41:00,21846.75,SELL,1,0.02h,Stop Loss,$15.25,$36.00,$230902.75,378,$36.00
2025-06-18,14:48:00,22086.25,BUY,1,0.02h,Stop Loss,$-6.00,$30.00,$230896.75,378,$30.00
2025-06-18,14:54:00,21836.0,SELL,1,0.02h,Stop Loss,$-6.00,$24.00,$230890.75,378,$24.00
2025-06-18,15:03:00,22076.25,BUY,1,0.02h,Stop Loss,$-6.00,$18.00,$230884.75,378,$18.00
2025-06-18,15:04:00,21852.75,SELL,1,0.02h,Stop Loss,$-6.00,$12.00,$230878.75,378,$12.00
2025-06-18,15:05:00,22082.0,BUY,1,0.02h,Stop Loss,$-6.00,$6.00,$230872.75,378,$6.00
2025-06-18,15:08:00,21842.75,SELL,1,0.02h,Stop Loss,$7.75,$13.75,$230880.50,378,$13.75
2025-06-18,15:13:00,22062.25,BUY,1,0.02h,Break Even,$0.25,$14.00,$230880.75,378,$14.00
2025-06-18,15:15:00,21834.75,SELL,1,0.02h,Stop Loss,$-6.00,$8.00,$230874.75,378,$8.00
2025-06-18,15:16:00,22055.0,BUY,1,0.02h,Stop Loss,$9.00,$17.00,$230883.75,378,$17.00
2025-06-18,15:18:00,21835.25,SELL,1,0.02h,Stop Loss,$-6.00,$11.00,$230877.75,378,$11.00
2025-06-18,15:19:00,22060.25,BUY,1,0.02h,Stop Loss,$-6.00,$5.00,$230871.75,378,$5.00
2025-06-18,15:23:00,21831.5,SELL,1,0.02h,Stop Loss,$-6.00,$-1.00,$230865.75,378,$-1.00
2025-06-18,15:24:00,22054.5,BUY,1,0.02h,Stop Loss,$-6.00,$-7.00,$230859.75,378,$-7.00
2025-06-18,15:25:00,21828.0,SELL,1,0.02h,Stop Loss,$16.50,$9.50,$230876.25,378,$9.50
2025-06-18,15:29:00,22048.5,BUY,1,0.02h,Break Even,$0.25,$9.75,$230876.50,378,$9.75
2025-06-18,15:32:00,21839.5,SELL,1,0.02h,Stop Loss,$-6.00,$3.75,$230870.50,378,$3.75
2025-06-18,15:33:00,22053.75,BUY,1,0.02h,Stop Loss,$-6.00,$-2.25,$230864.50,378,$-2.25
2025-06-18,15:34:00,21827.5,SELL,1,0.02h,Stop Loss,$-6.00,$-8.25,$230858.50,378,$-8.25
2025-06-18,15:40:00,22062.25,BUY,1,0.02h,Stop Loss,$5.25,$-3.00,$230863.75,378,$-3.00
2025-06-18,15:50:00,21833.5,SELL,1,0.02h,Stop Loss,$-6.00,$-9.00,$230857.75,378,$-9.00
2025-06-18,15:52:00,22068.5,BUY,1,0.02h,Stop Loss,$12.75,$3.75,$230870.50,378,$3.75
2025-06-18,15:55:00,21851.25,SELL,1,0.02h,Stop Loss,$-6.00,$-2.25,$230864.50,378,$-2.25
2025-06-18,15:56:00,22070.75,BUY,1,0.02h,Break Even,$0.25,$-2.00,$230864.75,378,$-2.00
2025-06-18,15:58:00,21826.75,SELL,1,0.02h,Stop Loss,$-6.00,$-8.00,$230858.75,378,$-8.00
2025-06-18,16:03:00,22048.5,BUY,1,0.02h,Stop Loss,$21.50,$13.50,$230880.25,378,$13.50
2025-06-18,16:05:00,21830.75,SELL,1,0.02h,Stop Loss,$-6.00,$7.50,$230874.25,378,$7.50
2025-06-18,16:07:00,22046.75,BUY,1,0.02h,Stop Loss,$6.50,$14.00,$230880.75,378,$14.00
2025-06-18,16:09:00,21836.75,SELL,1,0.02h,Break Even,$0.25,$14.25,$230881.00,378,$14.25
2025-06-18,16:16:00,22056.0,BUY,1,0.02h,Stop Loss,$-6.00,$8.25,$230875.00,378,$8.25
2025-06-18,16:18:00,21820.25,SELL,1,0.02h,Stop Loss,$-6.00,$2.25,$230869.00,378,$2.25
2025-06-18,16:23:00,22046.5,BUY,1,0.02h,Break Even,$0.25,$2.50,$230869.25,378,$2.50
2025-06-18,16:27:00,21818.25,SELL,1,0.02h,Stop Loss,$17.75,$20.25,$230887.00,378,$20.25
2025-06-18,16:38:00,22037.25,BUY,1,0.02h,Stop Loss,$-6.00,$14.25,$230881.00,378,$14.25
2025-06-18,16:44:00,21814.25,SELL,1,0.02h,Break Even,$0.25,$14.50,$230881.25,378,$14.50
2025-06-18,16:52:00,22047.5,BUY,1,0.02h,Stop Loss,$-6.00,$8.50,$230875.25,378,$8.50
2025-06-18,16:56:00,21809.0,SELL,1,0.02h,Stop Loss,$-6.00,$2.50,$230869.25,378,$2.50
2025-06-18,16:57:00,22033.25,BUY,1,0.02h,Break Even,$0.25,$2.75,$230869.50,378,$2.75
2025-06-18,16:59:00,21814.75,SELL,1,0.02h,Stop Loss,$42.75,$45.50,$230912.25,378,$45.50
2025-06-18,17:05:00,22030.5,BUY,1,0.02h,Stop Loss,$-6.00,$39.50,$230906.25,378,$39.50
2025-06-18,17:06:00,21804.75,SELL,1,0.02h,Stop Loss,$12.75,$52.25,$230919.00,378,$52.25
2025-06-18,17:10:00,22032.0,BUY,1,0.02h,Stop Loss,$17.75,$70.00,$230936.75,378,$70.00
2025-06-18,17:13:00,21808.75,SELL,1,0.02h,Stop Loss,$-6.00,$64.00,$230930.75,378,$64.00
2025-06-18,17:14:00,22023.5,BUY,1,0.02h,Stop Loss,$-6.00,$58.00,$230924.75,378,$58.00
2025-06-18,17:15:00,21803.75,SELL,1,0.02h,Stop Loss,$-6.00,$52.00,$230918.75,378,$52.00
2025-06-18,17:16:00,22031.75,BUY,1,0.02h,Stop Loss,$-6.00,$46.00,$230912.75,378,$46.00
2025-06-18,17:18:00,21798.75,SELL,1,0.02h,Stop Loss,$-6.00,$40.00,$230906.75,378,$40.00
2025-06-18,17:22:00,22002.5,BUY,1,0.02h,Stop Loss,$-6.00,$34.00,$230900.75,378,$34.00
2025-06-18,17:23:00,21773.75,SELL,1,0.02h,Stop Loss,$-6.00,$28.00,$230894.75,378,$28.00
2025-06-18,17:24:00,21994.0,BUY,1,0.02h,Stop Loss,$-6.00,$22.00,$230888.75,378,$22.00
2025-06-18,17:25:00,21772.25,SELL,1,0.02h,Stop Loss,$6.50,$28.50,$230895.25,378,$28.50
2025-06-18,17:36:00,21949.0,BUY,1,0.02h,Stop Loss,$55.25,$83.75,$230950.50,378,$83.75
2025-06-18,17:38:00,21745.0,SELL,1,0.02h,Stop Loss,$-6.00,$77.75,$230944.50,378,$77.75
2025-06-18,17:39:00,21976.25,BUY,1,0.02h,Stop Loss,$4.00,$81.75,$230948.50,378,$81.75
2025-06-18,17:54:00,21804.25,SELL,1,0.02h,Stop Loss,$-6.00,$75.75,$230942.50,378,$75.75
2025-06-18,17:55:00,22031.5,BUY,1,0.02h,Stop Loss,$-6.00,$69.75,$230936.50,378,$69.75
2025-06-18,17:56:00,21805.25,SELL,1,0.02h,Stop Loss,$-6.00,$63.75,$230930.50,378,$63.75
2025-06-18,18:02:00,22042.75,BUY,1,0.02h,Stop Loss,$-6.00,$57.75,$230924.50,378,$57.75
2025-06-18,18:03:00,21775.75,SELL,1,0.02h,Stop Loss,$-6.00,$51.75,$230918.50,378,$51.75
2025-06-18,18:04:00,22011.25,BUY,1,0.02h,Stop Loss,$39.00,$90.75,$230957.50,378,$90.75
2025-06-18,18:07:00,21775.0,SELL,1,0.02h,Stop Loss,$34.00,$124.75,$230991.50,378,$124.75
2025-06-18,18:12:00,22011.75,BUY,1,0.02h,Stop Loss,$12.75,$137.50,$231004.25,378,$137.50
2025-06-18,18:14:00,21780.5,SELL,1,0.02h,Stop Loss,$11.50,$149.00,$231015.75,378,$149.00
2025-06-18,18:33:00,22038.75,BUY,1,0.02h,Stop Loss,$40.25,$189.25,$231056.00,378,$189.25
2025-06-18,18:50:00,21792.75,SELL,1,0.02h,Stop Loss,$-6.00,$183.25,$231050.00,378,$183.25
2025-06-18,18:51:00,22008.5,BUY,1,0.02h,Stop Loss,$-6.00,$177.25,$231044.00,378,$177.25
2025-06-18,18:52:00,21781.25,SELL,1,0.02h,Stop Loss,$-6.00,$171.25,$231038.00,378,$171.25
2025-06-18,18:53:00,21995.25,BUY,1,0.02h,Stop Loss,$-6.00,$165.25,$231032.00,378,$165.25
2025-06-18,18:55:00,21752.5,SELL,1,0.02h,Stop Loss,$121.50,$286.75,$231153.50,378,$286.75
2025-06-18,19:06:00,21954.75,BUY,1,0.02h,Stop Loss,$52.75,$339.50,$231206.25,378,$339.50
2025-06-18,19:08:00,21718.5,SELL,1,0.02h,Stop Loss,$-6.00,$333.50,$231200.25,378,$333.50
2025-06-18,19:09:00,21932.5,BUY,1,0.02h,Stop Loss,$-6.00,$327.50,$231194.25,378,$327.50
2025-06-18,19:10:00,21709.25,SELL,1,0.02h,Stop Loss,$-6.00,$321.50,$231188.25,378,$321.50
2025-06-18,19:11:00,21939.5,BUY,1,0.02h,Stop Loss,$-6.00,$315.50,$231182.25,378,$315.50
2025-06-18,19:12:00,21723.25,SELL,1,0.02h,Stop Loss,$-6.00,$309.50,$231176.25,378,$309.50
2025-06-18,19:13:00,21927.5,BUY,1,0.02h,Stop Loss,$271.50,$581.00,$231447.75,378,$581.00
2025-06-18,19:22:00,21773.5,SELL,1,0.02h,Stop Loss,$-6.00,$575.00,$231441.75,378,$575.00
2025-06-18,19:23:00,22005.0,BUY,1,0.02h,Stop Loss,$24.00,$599.00,$231465.75,378,$599.00
2025-06-18,19:27:00,21750.0,SELL,1,0.02h,Stop Loss,$-6.00,$593.00,$231459.75,378,$593.00
2025-06-18,19:28:00,21952.5,BUY,1,0.02h,Stop Loss,$-6.00,$587.00,$231453.75,378,$587.00
2025-06-18,19:31:00,21713.25,SELL,1,0.02h,Stop Loss,$-6.00,$581.00,$231447.75,378,$581.00
2025-06-18,19:33:00,21957.0,BUY,1,0.02h,Stop Loss,$31.50,$612.50,$231479.25,378,$612.50
2025-06-18,19:36:00,21748.25,SELL,1,0.02h,Stop Loss,$-6.00,$606.50,$231473.25,378,$606.50
2025-06-18,19:37:00,21978.25,BUY,1,0.02h,Stop Loss,$-6.00,$600.50,$231467.25,378,$600.50
2025-06-18,19:38:00,21758.25,SELL,1,0.02h,Stop Loss,$50.25,$650.75,$231517.50,378,$650.75
2025-06-18,19:42:00,21991.5,BUY,1,0.02h,Stop Loss,$-6.00,$644.75,$231511.50,378,$644.75
2025-06-18,19:43:00,21757.25,SELL,1,0.02h,Stop Loss,$-6.00,$638.75,$231505.50,378,$638.75
2025-06-18,19:44:00,21999.0,BUY,1,0.02h,Stop Loss,$-6.00,$632.75,$231499.50,378,$632.75
2025-06-18,19:45:00,21777.25,SELL,1,0.02h,Stop Loss,$86.50,$719.25,$231586.00,378,$719.25
2025-06-18,19:55:00,21949.25,BUY,1,0.02h,Stop Loss,$70.25,$789.50,$231656.25,378,$789.50
2025-06-18,19:58:00,21721.75,SELL,1,0.02h,Stop Loss,$-6.00,$783.50,$231650.25,378,$783.50
2025-06-18,19:59:00,21943.75,BUY,1,0.02h,Stop Loss,$25.25,$808.75,$231675.50,378,$808.75
2025-06-18,20:06:00,21731.5,SELL,1,0.02h,Stop Loss,$-6.00,$802.75,$231669.50,378,$802.75
2025-06-18,20:07:00,21951.75,BUY,1,0.02h,Stop Loss,$25.25,$828.00,$231694.75,378,$828.00
2025-06-18,20:16:00,21738.75,SELL,1,0.02h,Stop Loss,$-6.00,$822.00,$231688.75,378,$822.00
2025-06-18,20:29:00,21954.25,BUY,1,0.02h,Stop Loss,$19.00,$841.00,$231707.75,378,$841.00
2025-06-18,20:45:00,21742.25,SELL,1,0.02h,Stop Loss,$-6.00,$835.00,$231701.75,378,$835.00
2025-06-18,20:46:00,21963.25,BUY,1,0.02h,Break Even,$0.25,$835.25,$231702.00,378,$835.25
2025-06-18,20:49:00,21739.25,SELL,1,0.02h,Stop Loss,$-6.00,$829.25,$231696.00,378,$829.25
2025-06-18,20:55:00,21974.25,BUY,1,0.02h,Stop Loss,$-6.00,$823.25,$231690.00,378,$823.25
2025-06-18,20:56:00,21748.0,SELL,1,0.02h,Stop Loss,$-6.00,$817.25,$231684.00,378,$817.25
2025-06-18,22:12:00,21932.0,BUY,1,0.02h,Break Even,$0.25,$817.50,$231684.25,378,$817.50
2025-06-18,22:14:00,21703.0,SELL,1,0.02h,Stop Loss,$-6.00,$811.50,$231678.25,378,$811.50
2025-06-18,22:15:00,21929.75,BUY,1,0.02h,Stop Loss,$-6.00,$805.50,$231672.25,378,$805.50
2025-06-18,22:17:00,21701.5,SELL,1,0.02h,Stop Loss,$-6.00,$799.50,$231666.25,378,$799.50
2025-06-18,22:18:00,21925.75,BUY,1,0.02h,Stop Loss,$-6.00,$793.50,$231660.25,378,$793.50
2025-06-18,22:19:00,21706.0,SELL,1,0.02h,Break Even,$0.25,$793.75,$231660.50,378,$793.75
2025-06-18,22:23:00,21927.5,BUY,1,0.02h,Stop Loss,$29.00,$822.75,$231689.50,378,$822.75
2025-06-18,22:29:00,21712.0,SELL,1,0.02h,Stop Loss,$-6.00,$816.75,$231683.50,378,$816.75
2025-06-18,22:30:00,21932.25,BUY,1,0.02h,Break Even,$0.25,$817.00,$231683.75,378,$817.00
2025-06-18,22:33:00,21695.25,SELL,1,0.02h,Stop Loss,$-6.00,$811.00,$231677.75,378,$811.00
2025-06-18,22:34:00,21918.25,BUY,1,0.02h,Break Even,$0.25,$811.25,$231678.00,378,$811.25
2025-06-18,22:36:00,21687.75,SELL,1,0.02h,Stop Loss,$-6.00,$805.25,$231672.00,378,$805.25
2025-06-18,22:48:00,21921.25,BUY,1,0.02h,Stop Loss,$-6.00,$799.25,$231666.00,378,$799.25
2025-06-18,22:52:00,21700.0,SELL,1,0.02h,Stop Loss,$-6.00,$793.25,$231660.00,378,$793.25
2025-06-18,22:54:00,21930.5,BUY,1,0.02h,Stop Loss,$12.75,$806.00,$231672.75,378,$806.00
2025-06-18,22:59:00,21707.0,SELL,1,0.02h,Stop Loss,$-6.00,$800.00,$231666.75,378,$800.00
Final P&L Day: 800.00,,,,,,,,,,,
2025-06-19,12:22:00,21805.5,BUY,1,0.02h,Stop Loss,$-6.00,$-6.00,$231660.75,379,$-6.00
2025-06-19,12:25:00,21595.75,SELL,1,0.02h,Stop Loss,$21.50,$15.50,$231682.25,379,$15.50
2025-06-19,12:31:00,21806.0,BUY,1,0.02h,Stop Loss,$19.00,$34.50,$231701.25,379,$34.50
2025-06-19,12:35:00,21575.25,SELL,1,0.02h,Stop Loss,$9.00,$43.50,$231710.25,379,$43.50
2025-06-19,12:37:00,21795.0,BUY,1,0.02h,Stop Loss,$-6.00,$37.50,$231704.25,379,$37.50
2025-06-19,12:38:00,21580.0,SELL,1,0.02h,Break Even,$0.25,$37.75,$231704.50,379,$37.75
2025-06-19,12:40:00,21793.75,BUY,1,0.02h,Stop Loss,$-6.00,$31.75,$231698.50,379,$31.75
2025-06-19,12:41:00,21577.5,SELL,1,0.02h,Stop Loss,$-6.00,$25.75,$231692.50,379,$25.75
2025-06-19,12:42:00,21792.25,BUY,1,0.02h,Stop Loss,$-6.00,$19.75,$231686.50,379,$19.75
2025-06-19,12:43:00,21571.75,SELL,1,0.02h,Stop Loss,$64.00,$83.75,$231750.50,379,$83.75
2025-06-19,12:56:00,21757.0,BUY,1,0.02h,Stop Loss,$-6.00,$77.75,$231744.50,379,$77.75
2025-06-19,13:08:00,21541.25,SELL,1,0.02h,Stop Loss,$20.25,$98.00,$231764.75,379,$98.00
2025-06-19,13:11:00,21762.75,BUY,1,0.02h,Stop Loss,$-6.00,$92.00,$231758.75,379,$92.00
2025-06-19,13:12:00,21547.0,SELL,1,0.02h,Stop Loss,$12.75,$104.75,$231771.50,379,$104.75
2025-06-19,13:15:00,21770.0,BUY,1,0.02h,Break Even,$0.25,$105.00,$231771.75,379,$105.00
2025-06-19,13:20:00,21555.75,SELL,1,0.02h,Stop Loss,$10.25,$115.25,$231782.00,379,$115.25
2025-06-19,13:22:00,21768.75,BUY,1,0.02h,Break Even,$0.25,$115.50,$231782.25,379,$115.50
2025-06-19,13:27:00,21563.0,SELL,1,0.02h,Stop Loss,$-6.00,$109.50,$231776.25,379,$109.50
2025-06-19,13:28:00,21781.0,BUY,1,0.02h,Break Even,$0.25,$109.75,$231776.50,379,$109.75
2025-06-19,13:31:00,21557.25,SELL,1,0.02h,Stop Loss,$17.75,$127.50,$231794.25,379,$127.50
2025-06-19,13:35:00,21755.5,BUY,1,0.02h,Stop Loss,$-6.00,$121.50,$231788.25,379,$121.50
2025-06-19,13:36:00,21532.5,SELL,1,0.02h,Stop Loss,$9.00,$130.50,$231797.25,379,$130.50
2025-06-19,13:43:00,21723.5,BUY,1,0.02h,Stop Loss,$-6.00,$124.50,$231791.25,379,$124.50
2025-06-19,13:44:00,21509.5,SELL,1,0.02h,Break Even,$0.25,$124.75,$231791.50,379,$124.75
2025-06-19,13:47:00,21708.0,BUY,1,0.02h,Stop Loss,$-6.00,$118.75,$231785.50,379,$118.75
2025-06-19,13:49:00,21438.75,SELL,1,0.02h,Stop Loss,$-6.00,$112.75,$231779.50,379,$112.75
2025-06-19,13:51:00,21685.0,BUY,1,0.02h,Stop Loss,$-6.00,$106.75,$231773.50,379,$106.75
2025-06-19,13:53:00,21465.75,SELL,1,0.02h,Stop Loss,$-6.00,$100.75,$231767.50,379,$100.75
2025-06-19,13:56:00,21695.25,BUY,1,0.02h,Stop Loss,$15.25,$116.00,$231782.75,379,$116.00
2025-06-19,14:01:00,21477.0,SELL,1,0.02h,Stop Loss,$-6.00,$110.00,$231776.75,379,$110.00
2025-06-19,14:02:00,21677.25,BUY,1,0.02h,Stop Loss,$39.00,$149.00,$231815.75,379,$149.00
2025-06-19,14:04:00,21467.25,SELL,1,0.02h,Stop Loss,$-6.00,$143.00,$231809.75,379,$143.00
2025-06-19,14:12:00,21707.75,BUY,1,0.02h,Stop Loss,$20.25,$163.25,$231830.00,379,$163.25
2025-06-19,14:16:00,21496.25,SELL,1,0.02h,Stop Loss,$-6.00,$157.25,$231824.00,379,$157.25
2025-06-19,14:17:00,21711.75,BUY,1,0.02h,Stop Loss,$-6.00,$151.25,$231818.00,379,$151.25
2025-06-19,14:18:00,21496.75,SELL,1,0.02h,Stop Loss,$-6.00,$145.25,$231812.00,379,$145.25
2025-06-19,14:19:00,21710.75,BUY,1,0.02h,Stop Loss,$-6.00,$139.25,$231806.00,379,$139.25
2025-06-19,14:23:00,21500.5,SELL,1,0.02h,Stop Loss,$-6.00,$133.25,$231800.00,379,$133.25
2025-06-19,14:24:00,21717.25,BUY,1,0.02h,Break Even,$0.25,$133.50,$231800.25,379,$133.50
2025-06-19,14:26:00,21502.5,SELL,1,0.02h,Stop Loss,$-6.00,$127.50,$231794.25,379,$127.50
2025-06-19,14:27:00,21720.5,BUY,1,0.02h,Stop Loss,$5.25,$132.75,$231799.50,379,$132.75
2025-06-19,14:31:00,21495.25,SELL,1,0.02h,Stop Loss,$-6.00,$126.75,$231793.50,379,$126.75
2025-06-19,14:32:00,21703.0,BUY,1,0.02h,Stop Loss,$-6.00,$120.75,$231787.50,379,$120.75
2025-06-19,14:33:00,21485.25,SELL,1,0.02h,Stop Loss,$-6.00,$114.75,$231781.50,379,$114.75
2025-06-19,14:34:00,21698.5,BUY,1,0.02h,Break Even,$0.25,$115.00,$231781.75,379,$115.00
2025-06-19,14:38:00,21482.25,SELL,1,0.02h,Stop Loss,$-6.00,$109.00,$231775.75,379,$109.00
2025-06-19,14:39:00,21710.5,BUY,1,0.02h,Stop Loss,$15.25,$124.25,$231791.00,379,$124.25
2025-06-19,14:42:00,21490.5,SELL,1,0.02h,Stop Loss,$36.50,$160.75,$231827.50,379,$160.75
2025-06-19,14:45:00,21682.0,BUY,1,0.02h,Stop Loss,$71.50,$232.25,$231899.00,379,$232.25
2025-06-19,14:47:00,21484.0,SELL,1,0.02h,Stop Loss,$14.00,$246.25,$231913.00,379,$246.25
2025-06-19,14:50:00,21697.0,BUY,1,0.02h,Stop Loss,$-6.00,$240.25,$231907.00,379,$240.25
2025-06-19,14:51:00,21485.75,SELL,1,0.02h,Stop Loss,$-6.00,$234.25,$231901.00,379,$234.25
2025-06-19,14:53:00,21707.75,BUY,1,0.02h,Stop Loss,$4.00,$238.25,$231905.00,379,$238.25
2025-06-19,14:55:00,21499.5,SELL,1,0.02h,Stop Loss,$-6.00,$232.25,$231899.00,379,$232.25
2025-06-19,14:59:00,21723.5,BUY,1,0.02h,Stop Loss,$11.50,$243.75,$231910.50,379,$243.75
2025-06-19,15:03:00,21505.75,SELL,1,0.02h,Stop Loss,$11.50,$255.25,$231922.00,379,$255.25
2025-06-19,15:10:00,21702.25,BUY,1,0.02h,Stop Loss,$50.25,$305.50,$231972.25,379,$305.50
2025-06-19,15:20:00,21516.75,SELL,1,0.02h,Stop Loss,$-6.00,$299.50,$231966.25,379,$299.50
2025-06-19,15:21:00,21724.5,BUY,1,0.02h,Stop Loss,$-6.00,$293.50,$231960.25,379,$293.50
2025-06-19,15:22:00,21497.5,SELL,1,0.02h,Stop Loss,$-6.00,$287.50,$231954.25,379,$287.50
2025-06-19,15:24:00,21708.5,BUY,1,0.02h,Stop Loss,$-6.00,$281.50,$231948.25,379,$281.50
2025-06-19,15:25:00,21494.5,SELL,1,0.02h,Stop Loss,$-6.00,$275.50,$231942.25,379,$275.50
2025-06-19,15:27:00,21711.0,BUY,1,0.02h,Stop Loss,$-6.00,$269.50,$231936.25,379,$269.50
2025-06-19,15:30:00,21503.75,SELL,1,0.02h,Stop Loss,$-6.00,$263.50,$231930.25,379,$263.50
2025-06-19,15:31:00,21716.75,BUY,1,0.02h,Break Even,$0.25,$263.75,$231930.50,379,$263.75
2025-06-19,15:33:00,21493.25,SELL,1,0.02h,Stop Loss,$-6.00,$257.75,$231924.50,379,$257.75
2025-06-19,15:44:00,21703.0,BUY,1,0.02h,Stop Loss,$41.50,$299.25,$231966.00,379,$299.25
2025-06-19,15:46:00,21499.75,SELL,1,0.02h,Stop Loss,$-6.00,$293.25,$231960.00,379,$293.25
2025-06-19,15:47:00,21716.75,BUY,1,0.02h,Stop Loss,$-6.00,$287.25,$231954.00,379,$287.25
2025-06-19,15:48:00,21505.5,SELL,1,0.02h,Stop Loss,$-6.00,$281.25,$231948.00,379,$281.25
2025-06-19,15:49:00,21715.75,BUY,1,0.02h,Stop Loss,$-6.00,$275.25,$231942.00,379,$275.25
2025-06-19,15:50:00,21498.75,SELL,1,0.02h,Stop Loss,$-6.00,$269.25,$231936.00,379,$269.25
2025-06-19,15:51:00,21715.25,BUY,1,0.02h,Stop Loss,$-6.00,$263.25,$231930.00,379,$263.25
2025-06-19,15:52:00,21484.75,SELL,1,0.02h,Stop Loss,$-6.00,$257.25,$231924.00,379,$257.25
2025-06-19,15:54:00,21692.25,BUY,1,0.02h,Stop Loss,$-6.00,$251.25,$231918.00,379,$251.25
2025-06-19,15:55:00,21479.0,SELL,1,0.02h,Stop Loss,$-6.00,$245.25,$231912.00,379,$245.25
2025-06-19,15:56:00,21699.5,BUY,1,0.02h,Break Even,$0.25,$245.50,$231912.25,379,$245.50
2025-06-19,15:58:00,21480.5,SELL,1,0.02h,Stop Loss,$74.00,$319.50,$231986.25,379,$319.50
2025-06-19,16:01:00,21688.75,BUY,1,0.02h,Stop Loss,$-6.00,$313.50,$231980.25,379,$313.50
2025-06-19,16:02:00,21475.25,SELL,1,0.02h,Stop Loss,$-6.00,$307.50,$231974.25,379,$307.50
2025-06-19,16:04:00,21699.75,BUY,1,0.02h,Break Even,$0.25,$307.75,$231974.50,379,$307.75
2025-06-19,16:08:00,21497.0,SELL,1,0.02h,Break Even,$0.25,$308.00,$231974.75,379,$308.00
2025-06-19,16:13:00,21714.25,BUY,1,0.02h,Stop Loss,$-6.00,$302.00,$231968.75,379,$302.00
2025-06-19,16:14:00,21496.75,SELL,1,0.02h,Stop Loss,$4.00,$306.00,$231972.75,379,$306.00
2025-06-19,16:19:00,21718.25,BUY,1,0.02h,Stop Loss,$-6.00,$300.00,$231966.75,379,$300.00
2025-06-19,16:20:00,21500.5,SELL,1,0.02h,Stop Loss,$-6.00,$294.00,$231960.75,379,$294.00
2025-06-19,16:23:00,21724.75,BUY,1,0.02h,Break Even,$0.25,$294.25,$231961.00,379,$294.25
2025-06-19,16:27:00,21512.25,SELL,1,0.02h,Stop Loss,$-6.00,$288.25,$231955.00,379,$288.25
2025-06-19,16:32:00,21735.25,BUY,1,0.02h,Stop Loss,$-6.00,$282.25,$231949.00,379,$282.25
2025-06-19,16:33:00,21514.5,SELL,1,0.02h,Stop Loss,$36.50,$318.75,$231985.50,379,$318.75
2025-06-19,16:36:00,21738.25,BUY,1,0.02h,Stop Loss,$-6.00,$312.75,$231979.50,379,$312.75
2025-06-19,16:37:00,21515.0,SELL,1,0.02h,Stop Loss,$-6.00,$306.75,$231973.50,379,$306.75
2025-06-19,16:41:00,21730.75,BUY,1,0.02h,Break Even,$0.25,$307.00,$231973.75,379,$307.00
2025-06-19,16:50:00,21510.25,SELL,1,0.02h,Stop Loss,$42.75,$349.75,$232016.50,379,$349.75
2025-06-19,16:54:00,21719.25,BUY,1,0.02h,Break Even,$0.25,$350.00,$232016.75,379,$350.00
2025-06-19,22:15:00,21607.25,SELL,1,0.02h,Stop Loss,$-6.00,$344.00,$232010.75,379,$344.00
2025-06-19,22:16:00,21831.5,BUY,1,0.02h,Stop Loss,$26.50,$370.50,$232037.25,379,$370.50
2025-06-19,22:31:00,21624.0,SELL,1,0.02h,Stop Loss,$-6.00,$364.50,$232031.25,379,$364.50
2025-06-19,22:34:00,21871.0,BUY,1,0.02h,Break Even,$0.25,$364.75,$232031.50,379,$364.75
2025-06-19,22:42:00,21672.5,SELL,1,0.02h,Break Even,$0.25,$365.00,$232031.75,379,$365.00
2025-06-19,22:44:00,21905.0,BUY,1,0.02h,Stop Loss,$-6.00,$359.00,$232025.75,379,$359.00
2025-06-19,22:45:00,21675.25,SELL,1,0.02h,Break Even,$0.25,$359.25,$232026.00,379,$359.25
2025-06-19,22:47:00,21909.5,BUY,1,0.02h,Stop Loss,$-6.00,$353.25,$232020.00,379,$353.25
2025-06-19,22:48:00,21700.75,SELL,1,0.02h,Stop Loss,$19.00,$372.25,$232039.00,379,$372.25
2025-06-19,22:56:00,21898.5,BUY,1,0.02h,Stop Loss,$-6.00,$366.25,$232033.00,379,$366.25
2025-06-19,22:57:00,21677.25,SELL,1,0.02h,Stop Loss,$-6.00,$360.25,$232027.00,379,$360.25
2025-06-19,22:58:00,21896.25,BUY,1,0.02h,Break Even,$0.25,$360.50,$232027.25,379,$360.50
Final P&L Day: 360.50,,,,,,,,,,,
2025-06-20,12:34:00,21769.25,SELL,1,0.02h,Stop Loss,$-6.00,$-6.00,$232021.25,380,$-6.00
2025-06-20,12:35:00,22015.0,BUY,1,0.02h,Stop Loss,$-6.00,$-12.00,$232015.25,380,$-12.00
2025-06-20,12:37:00,21777.0,SELL,1,0.02h,Stop Loss,$21.50,$9.50,$232036.75,380,$9.50
2025-06-20,12:42:00,22000.75,BUY,1,0.02h,Stop Loss,$35.25,$44.75,$232072.00,380,$44.75
2025-06-20,12:44:00,21789.0,SELL,1,0.02h,Stop Loss,$9.00,$53.75,$232081.00,380,$53.75
2025-06-20,12:49:00,22020.75,BUY,1,0.02h,Break Even,$0.25,$54.00,$232081.25,380,$54.00
2025-06-20,12:52:00,21804.75,SELL,1,0.02h,Stop Loss,$14.00,$68.00,$232095.25,380,$68.00
2025-06-20,12:57:00,22032.5,BUY,1,0.02h,Stop Loss,$4.00,$72.00,$232099.25,380,$72.00
2025-06-20,13:11:00,21802.5,SELL,1,0.02h,Stop Loss,$-6.00,$66.00,$232093.25,380,$66.00
2025-06-20,13:21:00,22051.25,BUY,1,0.02h,Stop Loss,$-6.00,$60.00,$232087.25,380,$60.00
2025-06-20,13:22:00,21830.25,SELL,1,0.02h,Stop Loss,$-6.00,$54.00,$232081.25,380,$54.00
2025-06-20,13:23:00,22058.75,BUY,1,0.02h,Stop Loss,$-6.00,$48.00,$232075.25,380,$48.00
2025-06-20,13:25:00,21835.5,SELL,1,0.02h,Stop Loss,$89.00,$137.00,$232164.25,380,$137.00
2025-06-20,13:31:00,22086.5,BUY,1,0.02h,Stop Loss,$39.00,$176.00,$232203.25,380,$176.00
2025-06-20,13:56:00,22036.5,SELL,1,0.02h,Stop Loss,$16.50,$192.50,$232219.75,380,$192.50
2025-06-20,15:15:00,21853.25,BUY,1,0.02h,Break Even,$0.25,$192.75,$232220.00,380,$192.75
2025-06-20,15:54:00,21868.5,SELL,1,0.02h,Stop Loss,$50.25,$243.00,$232270.25,380,$243.00
2025-06-20,16:13:00,21872.75,BUY,1,0.02h,Stop Loss,$-6.00,$237.00,$232264.25,380,$237.00
2025-06-20,16:15:00,21857.25,SELL,1,0.02h,Stop Loss,$30.25,$267.25,$232294.50,380,$267.25
2025-06-20,16:28:00,21872.25,BUY,1,0.02h,Break Even,$0.25,$267.50,$232294.75,380,$267.50
2025-06-20,17:06:00,21855.75,SELL,1,0.02h,Stop Loss,$20.25,$287.75,$232315.00,380,$287.75
2025-06-20,17:15:00,21886.25,BUY,1,0.02h,Stop Loss,$135.25,$423.00,$232450.25,380,$423.00
2025-06-20,17:19:00,21863.25,SELL,1,0.02h,Stop Loss,$7.75,$430.75,$232458.00,380,$430.75
2025-06-20,17:53:00,21818.75,BUY,1,0.02h,Stop Loss,$24.00,$454.75,$232482.00,380,$454.75
2025-06-20,18:44:00,21865.75,SELL,1,0.02h,Stop Loss,$-6.00,$448.75,$232476.00,380,$448.75
2025-06-20,19:55:00,21820.75,BUY,1,0.02h,Stop Loss,$180.25,$629.00,$232656.25,380,$629.00
2025-06-20,20:23:00,21849.5,SELL,1,0.02h,Stop Loss,$-6.00,$623.00,$232650.25,380,$623.00
2025-06-20,20:27:00,21861.5,BUY,1,0.02h,Stop Loss,$-6.00,$617.00,$232644.25,380,$617.00
Final P&L Day: 617.00,,,,,,,,,,,
2025-06-23,12:00:00,21824.75,SELL,1,0.02h,Stop Loss,$-6.00,$-6.00,$232638.25,381,$-6.00
2025-06-23,12:27:00,21849.5,BUY,1,0.02h,Break Even,$0.25,$-5.75,$232638.50,381,$-5.75
2025-06-23,12:30:00,21837.75,SELL,1,0.02h,Break Even,$0.25,$-5.50,$232638.75,381,$-5.50
2025-06-23,12:33:00,21848.0,BUY,1,0.02h,Stop Loss,$21.50,$16.00,$232660.25,381,$16.00
2025-06-23,13:12:00,21861.5,SELL,1,0.02h,Break Even,$0.25,$16.25,$232660.50,381,$16.25
2025-06-23,13:19:00,21883.5,BUY,1,0.02h,Stop Loss,$12.75,$29.00,$232673.25,381,$29.00
2025-06-23,13:28:00,21861.75,SELL,1,0.02h,Break Even,$0.25,$29.25,$232673.50,381,$29.25
2025-06-23,13:44:00,21874.25,BUY,1,0.02h,Stop Loss,$27.75,$57.00,$232701.25,381,$57.00
2025-06-23,14:53:00,21980.5,SELL,1,0.02h,Stop Loss,$10.25,$67.25,$232711.50,381,$67.25
2025-06-23,15:07:00,21995.25,BUY,1,0.02h,Stop Loss,$17.75,$85.00,$232729.25,381,$85.00
2025-06-23,15:23:00,21977.75,SELL,1,0.02h,Stop Loss,$-6.00,$79.00,$232723.25,381,$79.00
2025-06-23,16:46:00,21902.25,BUY,1,0.02h,Stop Loss,$24.00,$103.00,$232747.25,381,$103.00
2025-06-23,16:59:00,21851.75,SELL,1,0.02h,Stop Loss,$52.75,$155.75,$232800.00,381,$155.75
2025-06-23,17:03:00,21883.5,BUY,1,0.02h,Stop Loss,$30.25,$186.00,$232830.25,381,$186.00
2025-06-23,18:26:00,22054.25,SELL,1,0.02h,Break Even,$0.25,$186.25,$232830.50,381,$186.25
2025-06-23,19:02:00,22063.25,BUY,1,0.02h,Stop Loss,$15.25,$201.50,$232845.75,381,$201.50
2025-06-23,19:18:00,22029.0,SELL,1,0.02h,Break Even,$0.25,$201.75,$232846.00,381,$201.75
2025-06-23,19:27:00,22053.5,BUY,1,0.02h,Stop Loss,$12.75,$214.50,$232858.75,381,$214.50
2025-06-23,19:42:00,22047.0,SELL,1,0.02h,Break Even,$0.25,$214.75,$232859.00,381,$214.75
2025-06-23,19:51:00,22055.0,BUY,1,0.02h,Stop Loss,$26.50,$241.25,$232885.50,381,$241.25
2025-06-23,20:23:00,22064.25,SELL,1,0.02h,Stop Loss,$-6.00,$235.25,$232879.50,381,$235.25
2025-06-23,20:24:00,22068.75,BUY,1,0.02h,Break Even,$0.25,$235.50,$232879.75,381,$235.50
2025-06-23,20:56:00,22071.25,SELL,1,0.02h,Break Even,$0.25,$235.75,$232880.00,381,$235.75
2025-06-23,22:03:00,22090.5,BUY,1,0.02h,Stop Loss,$270.25,$506.00,$233150.25,381,$506.00
2025-06-23,22:46:00,22179.25,SELL,1,0.02h,Break Even,$0.25,$506.25,$233150.50,381,$506.25
2025-06-23,22:58:00,22192.75,BUY,1,0.02h,Stop Loss,$10.25,$516.50,$233160.75,381,$516.50
Final P&L Day: 516.50,,,,,,,,,,,
2025-06-24,12:51:00,22277.25,SELL,1,0.02h,Stop Loss,$6.50,$6.50,$233167.25,382,$6.50
2025-06-24,13:12:00,22287.0,BUY,1,0.02h,Stop Loss,$5.25,$11.75,$233172.50,382,$11.75
2025-06-24,13:31:00,22277.5,SELL,1,0.02h,Break Even,$0.25,$12.00,$233172.75,382,$12.00
2025-06-24,13:32:00,22303.75,BUY,1,0.02h,Stop Loss,$40.25,$52.25,$233213.00,382,$52.25
2025-06-24,13:34:00,22283.75,SELL,1,0.02h,Stop Loss,$7.75,$60.00,$233220.75,382,$60.00
2025-06-24,13:36:00,22301.5,BUY,1,0.02h,Stop Loss,$25.25,$85.25,$233246.00,382,$85.25
2025-06-24,13:54:00,22296.5,SELL,1,0.02h,Break Even,$0.25,$85.50,$233246.25,382,$85.50
2025-06-24,14:18:00,22316.75,BUY,1,0.02h,Stop Loss,$25.25,$110.75,$233271.50,382,$110.75
2025-06-24,15:00:00,22315.0,SELL,1,0.02h,Break Even,$0.25,$111.00,$233271.75,382,$111.00
2025-06-24,15:02:00,22330.0,BUY,1,0.02h,Stop Loss,$76.50,$187.50,$233348.25,382,$187.50
2025-06-24,15:57:00,22365.75,SELL,1,0.02h,Break Even,$0.25,$187.75,$233348.50,382,$187.75
2025-06-24,16:07:00,22375.5,BUY,1,0.02h,Stop Loss,$6.50,$194.25,$233355.00,382,$194.25
2025-06-24,16:56:00,22398.75,SELL,1,0.02h,Stop Loss,$16.50,$210.75,$233371.50,382,$210.75
2025-06-24,17:02:00,22407.5,BUY,1,0.02h,Break Even,$0.25,$211.00,$233371.75,382,$211.00
2025-06-24,17:22:00,22381.0,SELL,1,0.02h,Stop Loss,$-6.00,$205.00,$233365.75,382,$205.00
2025-06-24,17:34:00,22402.5,BUY,1,0.02h,Break Even,$0.25,$205.25,$233366.00,382,$205.25
2025-06-24,18:15:00,22412.75,SELL,1,0.02h,Stop Loss,$-6.00,$199.25,$233360.00,382,$199.25
2025-06-24,18:24:00,22422.0,BUY,1,0.02h,Break Even,$0.25,$199.50,$233360.25,382,$199.50
2025-06-24,18:30:00,22415.0,SELL,1,0.02h,Break Even,$0.25,$199.75,$233360.50,382,$199.75
2025-06-24,18:38:00,22426.75,BUY,1,0.02h,Stop Loss,$-6.00,$193.75,$233354.50,382,$193.75
2025-06-24,18:55:00,22417.0,SELL,1,0.02h,Break Even,$0.25,$194.00,$233354.75,382,$194.00
2025-06-24,18:58:00,22426.75,BUY,1,0.02h,Stop Loss,$-6.00,$188.00,$233348.75,382,$188.00
2025-06-24,19:22:00,22429.0,SELL,1,0.02h,Stop Loss,$-6.00,$182.00,$233342.75,382,$182.00
2025-06-24,20:25:00,22406.0,BUY,1,0.02h,Break Even,$0.25,$182.25,$233343.00,382,$182.25
2025-06-24,20:59:00,22410.5,SELL,1,0.02h,Break Even,$0.25,$182.50,$233343.25,382,$182.50
2025-06-24,22:28:00,22400.75,BUY,1,0.02h,Stop Loss,$-6.00,$176.50,$233337.25,382,$176.50
2025-06-24,22:37:00,22394.75,SELL,1,0.02h,Stop Loss,$-6.00,$170.50,$233331.25,382,$170.50
2025-06-24,22:45:00,22399.5,BUY,1,0.02h,Stop Loss,$-6.00,$164.50,$233325.25,382,$164.50
2025-06-24,22:56:00,22396.75,SELL,1,0.02h,Stop Loss,$-6.00,$158.50,$233319.25,382,$158.50
Final P&L Day: 158.50,,,,,,,,,,,
2025-06-25,12:00:00,22490.5,BUY,1,0.02h,Stop Loss,$11.50,$11.50,$233330.75,383,$11.50
2025-06-25,13:11:00,22498.5,SELL,1,0.02h,Break Even,$0.25,$11.75,$233331.00,383,$11.75
2025-06-25,13:14:00,22506.5,BUY,1,0.02h,Break Even,$0.25,$12.00,$233331.25,383,$12.00
2025-06-25,13:29:00,22498.5,SELL,1,0.02h,Stop Loss,$-6.00,$6.00,$233325.25,383,$6.00
2025-06-25,13:31:00,22517.75,BUY,1,0.02h,Stop Loss,$46.50,$52.50,$233371.75,383,$52.50
2025-06-25,13:51:00,22501.25,SELL,1,0.02h,Stop Loss,$35.25,$87.75,$233407.00,383,$87.75
2025-06-25,14:00:00,22522.5,BUY,1,0.02h,Stop Loss,$17.75,$105.50,$233424.75,383,$105.50
2025-06-25,14:02:00,22512.0,SELL,1,0.02h,Stop Loss,$51.50,$157.00,$233476.25,383,$157.00
2025-06-25,14:33:00,22494.5,BUY,1,0.02h,Stop Loss,$7.75,$164.75,$233484.00,383,$164.75
2025-06-25,14:51:00,22480.25,SELL,1,0.02h,Stop Loss,$4.00,$168.75,$233488.00,383,$168.75
2025-06-25,15:52:00,22456.75,BUY,1,0.02h,Stop Loss,$-6.00,$162.75,$233482.00,383,$162.75
2025-06-25,16:00:00,22444.25,SELL,1,0.02h,Stop Loss,$-6.00,$156.75,$233476.00,383,$156.75
2025-06-25,16:02:00,22454.25,BUY,1,0.02h,Break Even,$0.25,$157.00,$233476.25,383,$157.00
2025-06-25,16:05:00,22448.25,SELL,1,0.02h,Stop Loss,$5.25,$162.25,$233481.50,383,$162.25
2025-06-25,16:54:00,22436.75,BUY,1,0.02h,Break Even,$0.25,$162.50,$233481.75,383,$162.50
2025-06-25,17:09:00,22427.5,SELL,1,0.02h,Stop Loss,$4.00,$166.50,$233485.75,383,$166.50
2025-06-25,17:16:00,22445.5,BUY,1,0.02h,Break Even,$0.25,$166.75,$233486.00,383,$166.75
2025-06-25,17:34:00,22433.5,SELL,1,0.02h,Stop Loss,$41.50,$208.25,$233527.50,383,$208.25
2025-06-25,18:13:00,22424.75,BUY,1,0.02h,Stop Loss,$-6.00,$202.25,$233521.50,383,$202.25
2025-06-25,18:33:00,22416.75,SELL,1,0.02h,Break Even,$0.25,$202.50,$233521.75,383,$202.50
2025-06-25,18:58:00,22424.0,BUY,1,0.02h,Stop Loss,$-6.00,$196.50,$233515.75,383,$196.50
2025-06-25,19:32:00,22428.75,SELL,1,0.02h,Stop Loss,$-6.00,$190.50,$233509.75,383,$190.50
2025-06-25,19:45:00,22441.25,BUY,1,0.02h,Break Even,$0.25,$190.75,$233510.00,383,$190.75
2025-06-25,19:47:00,22434.0,SELL,1,0.02h,Break Even,$0.25,$191.00,$233510.25,383,$191.00
2025-06-25,19:51:00,22443.25,BUY,1,0.02h,Stop Loss,$10.25,$201.25,$233520.50,383,$201.25
2025-06-25,20:27:00,22461.25,SELL,1,0.02h,Stop Loss,$-6.00,$195.25,$233514.50,383,$195.25
2025-06-25,20:38:00,22464.75,BUY,1,0.02h,Stop Loss,$-6.00,$189.25,$233508.50,383,$189.25
2025-06-25,22:02:00,22460.25,SELL,1,0.02h,Break Even,$0.25,$189.50,$233508.75,383,$189.50
2025-06-25,22:05:00,22466.75,BUY,1,0.02h,Break Even,$0.25,$189.75,$233509.00,383,$189.75
2025-06-25,22:06:00,22465.0,SELL,1,0.02h,Stop Loss,$-6.00,$183.75,$233503.00,383,$183.75
2025-06-25,22:08:00,22468.25,BUY,1,0.02h,Stop Loss,$-6.00,$177.75,$233497.00,383,$177.75
2025-06-25,22:24:00,22465.5,SELL,1,0.02h,Break Even,$0.25,$178.00,$233497.25,383,$178.00
2025-06-25,22:57:00,22461.5,BUY,1,0.02h,Break Even,$0.25,$178.25,$233497.50,383,$178.25
Final P&L Day: 178.25,,,,,,,,,,,
2025-06-26,12:34:00,22538.25,SELL,1,0.02h,Stop Loss,$75.25,$75.25,$233572.75,384,$75.25
2025-06-26,13:21:00,22552.5,BUY,1,0.02h,Break Even,$0.25,$75.50,$233573.00,384,$75.50
2025-06-26,13:35:00,22535.75,SELL,1,0.02h,Stop Loss,$4.00,$79.50,$233577.00,384,$79.50
2025-06-26,13:59:00,22538.0,BUY,1,0.02h,Stop Loss,$29.00,$108.50,$233606.00,384,$108.50
2025-06-26,14:45:00,22561.75,SELL,1,0.02h,Stop Loss,$7.75,$116.25,$233613.75,384,$116.25
2025-06-26,14:48:00,22573.0,BUY,1,0.02h,Break Even,$0.25,$116.50,$233614.00,384,$116.50
2025-06-26,15:30:00,22565.0,SELL,1,0.02h,Stop Loss,$60.25,$176.75,$233674.25,384,$176.75
2025-06-26,15:40:00,22597.5,BUY,1,0.02h,Break Even,$0.25,$177.00,$233674.50,384,$177.00
2025-06-26,16:30:00,22614.0,SELL,1,0.02h,Break Even,$0.25,$177.25,$233674.75,384,$177.25
2025-06-26,17:04:00,22613.75,BUY,1,0.02h,Stop Loss,$9.00,$186.25,$233683.75,384,$186.25
2025-06-26,18:01:00,22635.5,SELL,1,0.02h,Stop Loss,$-6.00,$180.25,$233677.75,384,$180.25
2025-06-26,18:02:00,22643.75,BUY,1,0.02h,Stop Loss,$-6.00,$174.25,$233671.75,384,$174.25
2025-06-26,18:40:00,22668.5,SELL,1,0.02h,Break Even,$0.25,$174.50,$233672.00,384,$174.50
2025-06-26,19:03:00,22672.75,BUY,1,0.02h,Stop Loss,$-6.00,$168.50,$233666.00,384,$168.50
2025-06-26,19:08:00,22663.75,SELL,1,0.02h,Break Even,$0.25,$168.75,$233666.25,384,$168.75
2025-06-26,19:12:00,22670.5,BUY,1,0.02h,Stop Loss,$-6.00,$162.75,$233660.25,384,$162.75
2025-06-26,19:13:00,22665.25,SELL,1,0.02h,Break Even,$0.25,$163.00,$233660.50,384,$163.00
2025-06-26,19:21:00,22669.25,BUY,1,0.02h,Stop Loss,$-6.00,$157.00,$233654.50,384,$157.00
2025-06-26,19:38:00,22664.0,SELL,1,0.02h,Break Even,$0.25,$157.25,$233654.75,384,$157.25
2025-06-26,19:51:00,22683.75,BUY,1,0.02h,Stop Loss,$11.50,$168.75,$233666.25,384,$168.75
2025-06-26,20:02:00,22655.25,SELL,1,0.02h,Stop Loss,$21.50,$190.25,$233687.75,384,$190.25
2025-06-26,20:23:00,22664.75,BUY,1,0.02h,Stop Loss,$21.50,$211.75,$233709.25,384,$211.75
2025-06-26,20:57:00,22667.25,SELL,1,0.02h,Stop Loss,$-6.00,$205.75,$233703.25,384,$205.75
2025-06-26,22:01:00,22677.0,BUY,1,0.02h,Break Even,$0.25,$206.00,$233703.50,384,$206.00
2025-06-26,22:59:00,22694.5,SELL,1,0.02h,Stop Loss,$-6.00,$200.00,$233697.50,384,$200.00
Final P&L Day: 200.00,,,,,,,,,,,
2025-06-27,12:00:00,22779.5,BUY,1,0.02h,Stop Loss,$24.00,$24.00,$233721.50,385,$24.00
2025-06-27,12:33:00,22748.25,SELL,1,0.02h,Stop Loss,$-6.00,$18.00,$233715.50,385,$18.00
2025-06-27,13:27:00,22720.5,BUY,1,0.02h,Stop Loss,$16.50,$34.50,$233732.00,385,$34.50
2025-06-27,13:29:00,22709.5,SELL,1,0.02h,Stop Loss,$15.25,$49.75,$233747.25,385,$49.75
2025-06-27,13:38:00,22733.5,BUY,1,0.02h,Break Even,$0.25,$50.00,$233747.50,385,$50.00
2025-06-27,14:28:00,22774.5,SELL,1,0.02h,Stop Loss,$-6.00,$44.00,$233741.50,385,$44.00
2025-06-27,14:39:00,22811.25,BUY,1,0.02h,Break Even,$0.25,$44.25,$233741.75,385,$44.25
2025-06-27,14:52:00,22765.75,SELL,1,0.02h,Stop Loss,$56.50,$100.75,$233798.25,385,$100.75
2025-06-27,15:11:00,22776.25,BUY,1,0.02h,Stop Loss,$7.75,$108.50,$233806.00,385,$108.50
2025-06-27,15:18:00,22765.75,SELL,1,0.02h,Stop Loss,$19.00,$127.50,$233825.00,385,$127.50
2025-06-27,15:22:00,22781.25,BUY,1,0.02h,Stop Loss,$27.75,$155.25,$233852.75,385,$155.25
2025-06-27,16:02:00,22798.25,SELL,1,0.02h,Stop Loss,$-6.00,$149.25,$233846.75,385,$149.25
2025-06-27,16:57:00,22794.5,BUY,1,0.02h,Stop Loss,$4.00,$153.25,$233850.75,385,$153.25
2025-06-27,17:05:00,22783.0,SELL,1,0.02h,Break Even,$0.25,$153.50,$233851.00,385,$153.50
2025-06-27,17:10:00,22789.5,BUY,1,0.02h,Stop Loss,$14.00,$167.50,$233865.00,385,$167.50
2025-06-27,17:21:00,22782.5,SELL,1,0.02h,Break Even,$0.25,$167.75,$233865.25,385,$167.75
2025-06-27,19:07:00,22645.25,BUY,1,0.02h,Stop Loss,$27.75,$195.50,$233893.00,385,$195.50
2025-06-27,20:29:00,22734.75,SELL,1,0.02h,Stop Loss,$-6.00,$189.50,$233887.00,385,$189.50
2025-06-27,20:31:00,22740.0,BUY,1,0.02h,Stop Loss,$-6.00,$183.50,$233881.00,385,$183.50
2025-06-27,20:36:00,22735.75,SELL,1,0.02h,Break Even,$0.25,$183.75,$233881.25,385,$183.75
2025-06-27,20:53:00,22743.25,BUY,1,0.02h,Stop Loss,$-6.00,$177.75,$233875.25,385,$177.75
Final P&L Day: 177.75,,,,,,,,,,,
2025-06-30,12:37:00,22871.25,SELL,1,0.02h,Stop Loss,$5.25,$5.25,$233880.50,386,$5.25
2025-06-30,13:02:00,22873.5,BUY,1,0.02h,Break Even,$0.25,$5.50,$233880.75,386,$5.50
2025-06-30,13:31:00,22870.0,SELL,1,0.02h,Stop Loss,$96.50,$102.00,$233977.25,386,$102.00
2025-06-30,14:03:00,22829.0,BUY,1,0.02h,Stop Loss,$7.75,$109.75,$233985.00,386,$109.75
2025-06-30,14:21:00,22821.5,SELL,1,0.02h,Stop Loss,$52.75,$162.50,$234037.75,386,$162.50
2025-06-30,14:31:00,22838.0,BUY,1,0.02h,Break Even,$0.25,$162.75,$234038.00,386,$162.75
2025-06-30,14:37:00,22827.0,SELL,1,0.02h,Stop Loss,$42.75,$205.50,$234080.75,386,$205.50
2025-06-30,14:49:00,22832.75,BUY,1,0.02h,Break Even,$0.25,$205.75,$234081.00,386,$205.75
2025-06-30,14:53:00,22823.0,SELL,1,0.02h,Stop Loss,$17.75,$223.50,$234098.75,386,$223.50
2025-06-30,15:05:00,22829.75,BUY,1,0.02h,Stop Loss,$19.00,$242.50,$234117.75,386,$242.50
2025-06-30,15:14:00,22812.0,SELL,1,0.02h,Stop Loss,$4.00,$246.50,$234121.75,386,$246.50
2025-06-30,15:34:00,22832.5,BUY,1,0.02h,Stop Loss,$21.50,$268.00,$234143.25,386,$268.00
2025-06-30,16:19:00,22842.0,SELL,1,0.02h,Stop Loss,$40.25,$308.25,$234183.50,386,$308.25
2025-06-30,16:37:00,22850.25,BUY,1,0.02h,Stop Loss,$6.50,$314.75,$234190.00,386,$314.75
2025-06-30,16:59:00,22844.5,SELL,1,0.02h,Stop Loss,$15.25,$330.00,$234205.25,386,$330.00
2025-06-30,17:54:00,22828.25,BUY,1,0.02h,Stop Loss,$-6.00,$324.00,$234199.25,386,$324.00
2025-06-30,17:58:00,22812.75,SELL,1,0.02h,Break Even,$0.25,$324.25,$234199.50,386,$324.25
2025-06-30,18:02:00,22833.5,BUY,1,0.02h,Break Even,$0.25,$324.50,$234199.75,386,$324.50
2025-06-30,18:10:00,22817.5,SELL,1,0.02h,Stop Loss,$36.50,$361.00,$234236.25,386,$361.00
2025-06-30,18:18:00,22828.25,BUY,1,0.02h,Break Even,$0.25,$361.25,$234236.50,386,$361.25
2025-06-30,18:30:00,22819.5,SELL,1,0.02h,Stop Loss,$4.00,$365.25,$234240.50,386,$365.25
2025-06-30,18:52:00,22819.5,BUY,1,0.02h,Stop Loss,$5.25,$370.50,$234245.75,386,$370.50
2025-06-30,20:03:00,22879.5,SELL,1,0.02h,Break Even,$0.25,$370.75,$234246.00,386,$370.75
2025-06-30,20:34:00,22877.5,BUY,1,0.02h,Break Even,$0.25,$371.00,$234246.25,386,$371.00
2025-06-30,20:50:00,22874.25,SELL,1,0.02h,Stop Loss,$-6.00,$365.00,$234240.25,386,$365.00
2025-06-30,20:51:00,22876.5,BUY,1,0.02h,Stop Loss,$-6.00,$359.00,$234234.25,386,$359.00
2025-06-30,20:52:00,22874.75,SELL,1,0.02h,Stop Loss,$-6.00,$353.00,$234228.25,386,$353.00
2025-06-30,20:53:00,22877.25,BUY,1,0.02h,Stop Loss,$-6.00,$347.00,$234222.25,386,$347.00
2025-06-30,20:55:00,22872.5,SELL,1,0.02h,Break Even,$0.25,$347.25,$234222.50,386,$347.25
2025-06-30,22:09:00,22884.0,BUY,1,0.02h,Break Even,$0.25,$347.50,$234222.75,386,$347.50
2025-06-30,22:27:00,22872.0,SELL,1,0.02h,Break Even,$0.25,$347.75,$234223.00,386,$347.75
Final P&L Day: 347.75,,,,,,,,,,,
2025-07-01,12:49:00,22795.5,BUY,1,0.02h,Stop Loss,$-6.00,$-6.00,$234217.00,387,$-6.00
2025-07-01,13:22:00,22795.75,SELL,1,0.02h,Stop Loss,$7.75,$1.75,$234224.75,387,$1.75
2025-07-01,13:33:00,22814.5,BUY,1,0.02h,Stop Loss,$7.75,$9.50,$234232.50,387,$9.50
2025-07-01,13:44:00,22789.25,SELL,1,0.02h,Stop Loss,$31.50,$41.00,$234264.00,387,$41.00
2025-07-01,13:49:00,22813.5,BUY,1,0.02h,Stop Loss,$32.75,$73.75,$234296.75,387,$73.75
2025-07-01,14:00:00,22782.25,SELL,1,0.02h,Stop Loss,$-6.00,$67.75,$234290.75,387,$67.75
2025-07-01,14:14:00,22828.75,BUY,1,0.02h,Break Even,$0.25,$68.00,$234291.00,387,$68.00
2025-07-01,14:23:00,22790.75,SELL,1,0.02h,Stop Loss,$22.75,$90.75,$234313.75,387,$90.75
2025-07-01,15:26:00,22684.5,BUY,1,0.02h,Stop Loss,$26.50,$117.25,$234340.25,387,$117.25
2025-07-01,15:41:00,22638.5,SELL,1,0.02h,Stop Loss,$64.00,$181.25,$234404.25,387,$181.25
2025-07-01,15:54:00,22668.25,BUY,1,0.02h,Stop Loss,$5.25,$186.50,$234409.50,387,$186.50
2025-07-01,16:03:00,22652.5,SELL,1,0.02h,Break Even,$0.25,$186.75,$234409.75,387,$186.75
2025-07-01,16:12:00,22674.75,BUY,1,0.02h,Stop Loss,$44.00,$230.75,$234453.75,387,$230.75
2025-07-01,17:31:00,22718.25,SELL,1,0.02h,Stop Loss,$22.75,$253.50,$234476.50,387,$253.50
2025-07-01,17:44:00,22725.5,BUY,1,0.02h,Stop Loss,$6.50,$260.00,$234483.00,387,$260.00
2025-07-01,18:18:00,22735.5,SELL,1,0.02h,Stop Loss,$16.50,$276.50,$234499.50,387,$276.50
2025-07-01,18:35:00,22741.0,BUY,1,0.02h,Break Even,$0.25,$276.75,$234499.75,387,$276.75
2025-07-01,18:38:00,22729.25,SELL,1,0.02h,Stop Loss,$15.25,$292.00,$234515.00,387,$292.00
2025-07-01,19:20:00,22704.25,BUY,1,0.02h,Break Even,$0.25,$292.25,$234515.25,387,$292.25
2025-07-01,19:37:00,22701.25,SELL,1,0.02h,Stop Loss,$45.25,$337.50,$234560.50,387,$337.50
2025-07-01,19:46:00,22715.75,BUY,1,0.02h,Break Even,$0.25,$337.75,$234560.75,387,$337.75
2025-07-01,19:59:00,22702.5,SELL,1,0.02h,Stop Loss,$65.25,$403.00,$234626.00,387,$403.00
2025-07-01,20:32:00,22683.75,BUY,1,0.02h,Break Even,$0.25,$403.25,$234626.25,387,$403.25
2025-07-01,22:32:00,22697.5,SELL,1,0.02h,Stop Loss,$-6.00,$397.25,$234620.25,387,$397.25
2025-07-01,22:33:00,22704.25,BUY,1,0.02h,Stop Loss,$6.50,$403.75,$234626.75,387,$403.75
Final P&L Day: 403.75,,,,,,,,,,,
2025-07-02,12:00:00,22662.5,SELL,1,0.02h,Stop Loss,$54.00,$54.00,$234680.75,388,$54.00
2025-07-02,13:02:00,22629.0,BUY,1,0.02h,Break Even,$0.25,$54.25,$234681.00,388,$54.25
2025-07-02,15:21:00,22821.0,SELL,1,0.02h,Stop Loss,$24.00,$78.25,$234705.00,388,$78.25
2025-07-02,15:23:00,22827.0,BUY,1,0.02h,Break Even,$0.25,$78.50,$234705.25,388,$78.50
2025-07-02,15:25:00,22815.75,SELL,1,0.02h,Stop Loss,$6.50,$85.00,$234711.75,388,$85.00
2025-07-02,15:38:00,22824.25,BUY,1,0.02h,Stop Loss,$-6.00,$79.00,$234705.75,388,$79.00
2025-07-02,15:39:00,22814.0,SELL,1,0.02h,Stop Loss,$25.25,$104.25,$234731.00,388,$104.25
2025-07-02,15:48:00,22823.0,BUY,1,0.02h,Break Even,$0.25,$104.50,$234731.25,388,$104.50
2025-07-02,16:03:00,22810.25,SELL,1,0.02h,Stop Loss,$-6.00,$98.50,$234725.25,388,$98.50
2025-07-02,16:07:00,22825.0,BUY,1,0.02h,Stop Loss,$-6.00,$92.50,$234719.25,388,$92.50
2025-07-02,16:32:00,22822.5,SELL,1,0.02h,Stop Loss,$-6.00,$86.50,$234713.25,388,$86.50
2025-07-02,16:35:00,22833.25,BUY,1,0.02h,Stop Loss,$5.25,$91.75,$234718.50,388,$91.75
2025-07-02,16:53:00,22829.25,SELL,1,0.02h,Stop Loss,$-6.00,$85.75,$234712.50,388,$85.75
2025-07-02,16:57:00,22837.5,BUY,1,0.02h,Stop Loss,$6.50,$92.25,$234719.00,388,$92.25
2025-07-02,17:09:00,22831.75,SELL,1,0.02h,Stop Loss,$4.00,$96.25,$234723.00,388,$96.25
2025-07-02,17:51:00,22825.75,BUY,1,0.02h,Stop Loss,$17.75,$114.00,$234740.75,388,$114.00
2025-07-02,18:03:00,22815.25,SELL,1,0.02h,Break Even,$0.25,$114.25,$234741.00,388,$114.25
2025-07-02,18:06:00,22828.25,BUY,1,0.02h,Stop Loss,$-6.00,$108.25,$234735.00,388,$108.25
2025-07-02,18:18:00,22819.75,SELL,1,0.02h,Stop Loss,$-6.00,$102.25,$234729.00,388,$102.25
2025-07-02,18:19:00,22828.75,BUY,1,0.02h,Stop Loss,$20.25,$122.50,$234749.25,388,$122.50
2025-07-02,18:46:00,22825.5,SELL,1,0.02h,Stop Loss,$4.00,$126.50,$234753.25,388,$126.50
2025-07-02,18:49:00,22836.0,BUY,1,0.02h,Stop Loss,$-6.00,$120.50,$234747.25,388,$120.50
2025-07-02,18:50:00,22828.75,SELL,1,0.02h,Stop Loss,$14.00,$134.50,$234761.25,388,$134.50
2025-07-02,19:01:00,22833.5,BUY,1,0.02h,Stop Loss,$11.50,$146.00,$234772.75,388,$146.00
2025-07-02,19:14:00,22827.75,SELL,1,0.02h,Break Even,$0.25,$146.25,$234773.00,388,$146.25
2025-07-02,19:35:00,22831.0,BUY,1,0.02h,Stop Loss,$-6.00,$140.25,$234767.00,388,$140.25
2025-07-02,19:37:00,22824.75,SELL,1,0.02h,Stop Loss,$-6.00,$134.25,$234761.00,388,$134.25
2025-07-02,19:54:00,22831.25,BUY,1,0.02h,Stop Loss,$71.50,$205.75,$234832.50,388,$205.75
2025-07-02,20:17:00,22830.75,SELL,1,0.02h,Stop Loss,$-6.00,$199.75,$234826.50,388,$199.75
2025-07-02,20:30:00,22835.25,BUY,1,0.02h,Break Even,$0.25,$200.00,$234826.75,388,$200.00
2025-07-02,22:08:00,22843.25,SELL,1,0.02h,Stop Loss,$-6.00,$194.00,$234820.75,388,$194.00
2025-07-02,22:38:00,22839.25,BUY,1,0.03h,Break Even,$0.25,$194.25,$234821.00,388,$194.25
Final P&L Day: 194.25,,,,,,,,,,,
2025-07-03,12:21:00,22857.25,SELL,1,0.02h,Stop Loss,$5.25,$5.25,$234826.25,389,$5.25
2025-07-03,12:31:00,22901.25,BUY,1,0.02h,Stop Loss,$60.25,$65.50,$234886.50,389,$65.50
2025-07-03,12:49:00,22879.25,SELL,1,0.02h,Stop Loss,$-6.00,$59.50,$234880.50,389,$59.50
2025-07-03,12:56:00,22900.25,BUY,1,0.02h,Stop Loss,$-6.00,$53.50,$234874.50,389,$53.50
2025-07-03,14:45:00,23045.5,SELL,1,0.02h,Stop Loss,$-6.00,$47.50,$234868.50,389,$47.50
2025-07-03,14:59:00,23051.0,BUY,1,0.02h,Stop Loss,$-6.00,$41.50,$234862.50,389,$41.50
2025-07-03,16:00:00,23083.25,SELL,1,0.02h,Stop Loss,$-6.00,$35.50,$234856.50,389,$35.50
2025-07-03,16:01:00,23089.0,BUY,1,0.02h,Break Even,$0.25,$35.75,$234856.75,389,$35.75
2025-07-03,16:16:00,23079.25,SELL,1,0.02h,Stop Loss,$-6.00,$29.75,$234850.75,389,$29.75
2025-07-03,22:11:00,23052.5,BUY,1,0.02h,Stop Loss,$-6.00,$23.75,$234844.75,389,$23.75
2025-07-03,22:13:00,23042.75,SELL,1,0.02h,Break Even,$0.25,$24.00,$234845.00,389,$24.00
2025-07-03,22:19:00,23054.0,BUY,1,0.02h,Break Even,$0.25,$24.25,$234845.25,389,$24.25
2025-07-03,22:47:00,23049.5,SELL,1,0.03h,Break Even,$0.25,$24.50,$234845.50,389,$24.50
Final P&L Day: 24.50,,,,,,,,,,,
2025-07-04,12:44:00,22932.0,BUY,1,0.02h,Stop Loss,$-6.00,$-6.00,$234839.50,390,$-6.00
2025-07-04,12:46:00,22926.0,SELL,1,0.02h,Stop Loss,$-6.00,$-12.00,$234833.50,390,$-12.00
2025-07-04,13:31:00,22920.0,BUY,1,0.02h,Stop Loss,$4.00,$-8.00,$234837.50,390,$-8.00
2025-07-04,13:36:00,22901.0,SELL,1,0.02h,Stop Loss,$20.25,$12.25,$234857.75,390,$12.25
2025-07-04,13:43:00,22926.25,BUY,1,0.02h,Break Even,$0.25,$12.50,$234858.00,390,$12.50
2025-07-04,14:05:00,22916.75,SELL,1,0.02h,Stop Loss,$11.50,$24.00,$234869.50,390,$24.00
2025-07-04,14:20:00,22922.25,BUY,1,0.02h,Stop Loss,$-6.00,$18.00,$234863.50,390,$18.00
2025-07-04,14:57:00,22934.5,SELL,1,0.02h,Break Even,$0.25,$18.25,$234863.75,390,$18.25
2025-07-04,15:01:00,22940.5,BUY,1,0.02h,Stop Loss,$-6.00,$12.25,$234857.75,390,$12.25
2025-07-04,15:06:00,22935.5,SELL,1,0.02h,Stop Loss,$-6.00,$6.25,$234851.75,390,$6.25
2025-07-04,15:32:00,22932.0,BUY,1,0.02h,Break Even,$0.25,$6.50,$234852.00,390,$6.50
2025-07-04,16:03:00,22928.5,SELL,1,0.02h,Stop Loss,$-6.00,$0.50,$234846.00,390,$0.50
2025-07-04,16:05:00,22932.5,BUY,1,0.02h,Break Even,$0.25,$0.75,$234846.25,390,$0.75
2025-07-04,16:09:00,22928.0,SELL,1,0.02h,Break Even,$0.25,$1.00,$234846.50,390,$1.00
Final P&L Day: 1.00,,,,,,,,,,,
2025-07-07,12:00:00,22981.25,BUY,1,0.02h,Stop Loss,$-6.00,$-6.00,$234840.50,391,$-6.00
2025-07-07,12:39:00,22975.0,SELL,1,0.02h,Stop Loss,$-6.00,$-12.00,$234834.50,391,$-12.00
2025-07-07,13:31:00,22970.5,BUY,1,0.02h,Break Even,$0.25,$-11.75,$234834.75,391,$-11.75
2025-07-07,13:35:00,22926.5,SELL,1,0.02h,Stop Loss,$5.25,$-6.50,$234840.00,391,$-6.50
2025-07-07,13:43:00,22947.25,BUY,1,0.02h,Break Even,$0.25,$-6.25,$234840.25,391,$-6.25
2025-07-07,13:46:00,22926.0,SELL,1,0.02h,Stop Loss,$7.75,$1.50,$234848.00,391,$1.50
2025-07-07,13:50:00,22951.5,BUY,1,0.02h,Stop Loss,$35.25,$36.75,$234883.25,391,$36.75
2025-07-07,14:02:00,22925.25,SELL,1,0.02h,Stop Loss,$102.75,$139.50,$234986.00,391,$139.50
2025-07-07,14:24:00,22941.75,BUY,1,0.02h,Stop Loss,$21.50,$161.00,$235007.50,391,$161.00
2025-07-07,14:33:00,22926.5,SELL,1,0.02h,Break Even,$0.25,$161.25,$235007.75,391,$161.25
2025-07-07,15:16:00,22915.25,BUY,1,0.02h,Stop Loss,$-6.00,$155.25,$235001.75,391,$155.25
2025-07-07,15:20:00,22904.75,SELL,1,0.02h,Stop Loss,$6.50,$161.75,$235008.25,391,$161.75
2025-07-07,15:26:00,22907.75,BUY,1,0.02h,Stop Loss,$47.75,$209.50,$235056.00,391,$209.50
2025-07-07,15:47:00,22906.0,SELL,1,0.02h,Stop Loss,$19.00,$228.50,$235075.00,391,$228.50
2025-07-07,15:57:00,22923.25,BUY,1,0.02h,Stop Loss,$45.25,$273.75,$235120.25,391,$273.75
2025-07-07,16:21:00,22879.75,SELL,1,0.02h,Stop Loss,$171.50,$445.25,$235291.75,391,$445.25
2025-07-07,16:38:00,22917.5,BUY,1,0.02h,Break Even,$0.25,$445.50,$235292.00,391,$445.50
2025-07-07,16:39:00,22894.0,SELL,1,0.02h,Break Even,$0.25,$445.75,$235292.25,391,$445.75
2025-07-07,17:11:00,22890.75,BUY,1,0.02h,Stop Loss,$15.25,$461.00,$235307.50,391,$461.00
2025-07-07,17:28:00,22869.25,SELL,1,0.02h,Break Even,$0.25,$461.25,$235307.75,391,$461.25
2025-07-07,17:33:00,22891.5,BUY,1,0.02h,Stop Loss,$-6.00,$455.25,$235301.75,391,$455.25
2025-07-07,17:35:00,22883.0,SELL,1,0.02h,Stop Loss,$67.75,$523.00,$235369.50,391,$523.00
2025-07-07,18:00:00,22871.0,BUY,1,0.02h,Stop Loss,$10.25,$533.25,$235379.75,391,$533.25
2025-07-07,18:16:00,22859.0,SELL,1,0.02h,Stop Loss,$154.00,$687.25,$235533.75,391,$687.25
2025-07-07,18:42:00,22835.75,BUY,1,0.02h,Stop Loss,$54.00,$741.25,$235587.75,391,$741.25
2025-07-07,19:10:00,22851.5,SELL,1,0.02h,Break Even,$0.25,$741.50,$235588.00,391,$741.50
2025-07-07,19:14:00,22862.75,BUY,1,0.02h,Stop Loss,$7.75,$749.25,$235595.75,391,$749.25
2025-07-07,19:15:00,22857.0,SELL,1,0.02h,Break Even,$0.25,$749.50,$235596.00,391,$749.50
2025-07-07,19:34:00,22858.25,BUY,1,0.02h,Stop Loss,$9.00,$758.50,$235605.00,391,$758.50
2025-07-07,19:39:00,22849.5,SELL,1,0.02h,Break Even,$0.25,$758.75,$235605.25,391,$758.75
2025-07-07,19:51:00,22869.75,BUY,1,0.02h,Break Even,$0.25,$759.00,$235605.50,391,$759.00
2025-07-07,20:06:00,22856.75,SELL,1,0.02h,Break Even,$0.25,$759.25,$235605.75,391,$759.25
2025-07-07,20:20:00,22863.75,BUY,1,0.03h,Break Even,$0.25,$759.50,$235606.00,391,$759.50
2025-07-07,20:30:00,22858.5,SELL,1,0.02h,Stop Loss,$-6.00,$753.50,$235600.00,391,$753.50
2025-07-07,22:01:00,22848.0,BUY,1,0.02h,Stop Loss,$9.00,$762.50,$235609.00,391,$762.50
2025-07-07,22:05:00,22832.25,SELL,1,0.02h,Stop Loss,$-6.00,$756.50,$235603.00,391,$756.50
2025-07-07,22:08:00,22840.0,BUY,1,0.02h,Stop Loss,$10.25,$766.75,$235613.25,391,$766.75
2025-07-07,22:13:00,22834.75,SELL,1,0.02h,Break Even,$0.25,$767.00,$235613.50,391,$767.00
2025-07-07,22:34:00,22835.25,BUY,1,0.02h,Break Even,$0.25,$767.25,$235613.75,391,$767.25
Final P&L Day: 767.25,,,,,,,,,,,
2025-07-08,12:34:00,22932.0,SELL,1,0.02h,Break Even,$0.25,$0.25,$235614.00,392,$0.25
2025-07-08,12:57:00,22934.0,BUY,1,0.02h,Stop Loss,$6.50,$6.75,$235620.50,392,$6.75
2025-07-08,13:21:00,22937.25,SELL,1,0.02h,Stop Loss,$-6.00,$0.75,$235614.50,392,$0.75
2025-07-08,13:57:00,22919.0,BUY,1,0.02h,Break Even,$0.25,$1.00,$235614.75,392,$1.00
2025-07-08,13:58:00,22907.75,SELL,1,0.02h,Stop Loss,$62.75,$63.75,$235677.50,392,$63.75
2025-07-08,14:33:00,22909.25,BUY,1,0.02h,Break Even,$0.25,$64.00,$235677.75,392,$64.00
2025-07-08,14:52:00,22894.0,SELL,1,0.02h,Stop Loss,$187.75,$251.75,$235865.50,392,$251.75
2025-07-08,15:04:00,22902.0,BUY,1,0.02h,Stop Loss,$-6.00,$245.75,$235859.50,392,$245.75
2025-07-08,15:20:00,22888.0,SELL,1,0.02h,Stop Loss,$24.00,$269.75,$235883.50,392,$269.75
2025-07-08,15:39:00,22889.5,BUY,1,0.02h,Break Even,$0.25,$270.00,$235883.75,392,$270.00
2025-07-08,16:36:00,22897.75,SELL,1,0.02h,Stop Loss,$31.50,$301.50,$235915.25,392,$301.50
2025-07-08,17:29:00,22913.75,BUY,1,0.02h,Stop Loss,$-6.00,$295.50,$235909.25,392,$295.50
2025-07-08,17:36:00,22899.75,SELL,1,0.02h,Stop Loss,$4.00,$299.50,$235913.25,392,$299.50
2025-07-08,17:49:00,22907.75,BUY,1,0.02h,Stop Loss,$5.25,$304.75,$235918.50,392,$304.75
2025-07-08,18:22:00,22921.25,SELL,1,0.02h,Break Even,$0.25,$305.00,$235918.75,392,$305.00
2025-07-08,19:34:00,22890.25,BUY,1,0.02h,Break Even,$0.25,$305.25,$235919.00,392,$305.25
2025-07-08,19:40:00,22879.5,SELL,1,0.02h,Break Even,$0.25,$305.50,$235919.25,392,$305.50
2025-07-08,19:49:00,22892.75,BUY,1,0.02h,Stop Loss,$5.25,$310.75,$235924.50,392,$310.75
2025-07-08,20:36:00,22900.75,SELL,1,0.02h,Stop Loss,$-6.00,$304.75,$235918.50,392,$304.75
2025-07-08,20:44:00,22904.0,BUY,1,0.02h,Break Even,$0.25,$305.00,$235918.75,392,$305.00
2025-07-08,20:47:00,22902.25,SELL,1,0.02h,Stop Loss,$-6.00,$299.00,$235912.75,392,$299.00
2025-07-08,20:48:00,22903.0,BUY,1,0.02h,Stop Loss,$-6.00,$293.00,$235906.75,392,$293.00
2025-07-08,20:49:00,22901.5,SELL,1,0.02h,Stop Loss,$-6.00,$287.00,$235900.75,392,$287.00
2025-07-08,20:55:00,22904.0,BUY,1,0.02h,Stop Loss,$-6.00,$281.00,$235894.75,392,$281.00
2025-07-08,20:56:00,22901.25,SELL,1,0.03h,Break Even,$0.25,$281.25,$235895.00,392,$281.25
2025-07-08,22:01:00,22915.75,BUY,1,0.02h,Stop Loss,$11.50,$292.75,$235906.50,392,$292.75
2025-07-08,22:23:00,22910.0,SELL,1,0.02h,Break Even,$0.25,$293.00,$235906.75,392,$293.00
2025-07-08,22:29:00,22913.0,BUY,1,0.02h,Stop Loss,$-6.00,$287.00,$235900.75,392,$287.00
2025-07-08,22:30:00,22909.25,SELL,1,0.02h,Stop Loss,$-6.00,$281.00,$235894.75,392,$281.00
2025-07-08,22:31:00,22912.25,BUY,1,0.02h,Stop Loss,$-6.00,$275.00,$235888.75,392,$275.00
2025-07-08,22:32:00,22905.75,SELL,1,0.02h,Stop Loss,$7.75,$282.75,$235896.50,392,$282.75
2025-07-08,22:50:00,22910.0,BUY,1,0.03h,Break Even,$0.25,$283.00,$235896.75,392,$283.00
Final P&L Day: 283.00,,,,,,,,,,,
2025-07-09,12:38:00,22937.0,SELL,1,0.02h,Break Even,$0.25,$0.25,$235897.00,393,$0.25
2025-07-09,12:43:00,22941.5,BUY,1,0.02h,Break Even,$0.25,$0.50,$235897.25,393,$0.50
2025-07-09,12:58:00,22936.5,SELL,1,0.02h,Stop Loss,$34.00,$34.50,$235931.25,393,$34.50
2025-07-09,13:08:00,22951.0,BUY,1,0.02h,Break Even,$0.25,$34.75,$235931.50,393,$34.75
2025-07-09,14:20:00,23077.0,SELL,1,0.02h,Stop Loss,$15.25,$50.00,$235946.75,393,$50.00
2025-07-09,15:23:00,22970.5,BUY,1,0.02h,Break Even,$0.25,$50.25,$235947.00,393,$50.25
2025-07-09,15:53:00,22951.5,SELL,1,0.02h,Break Even,$0.25,$50.50,$235947.25,393,$50.50
2025-07-09,16:19:00,22972.25,BUY,1,0.02h,Stop Loss,$4.00,$54.50,$235951.25,393,$54.50
2025-07-09,17:01:00,22976.75,SELL,1,0.02h,Stop Loss,$56.50,$111.00,$236007.75,393,$111.00
2025-07-09,17:11:00,22991.75,BUY,1,0.02h,Stop Loss,$-6.00,$105.00,$236001.75,393,$105.00
2025-07-09,17:13:00,22980.75,SELL,1,0.02h,Stop Loss,$6.50,$111.50,$236008.25,393,$111.50
2025-07-09,17:27:00,22987.25,BUY,1,0.02h,Stop Loss,$-6.00,$105.50,$236002.25,393,$105.50
2025-07-09,17:28:00,22977.75,SELL,1,0.02h,Stop Loss,$12.75,$118.25,$236015.00,393,$118.25
2025-07-09,17:35:00,22987.75,BUY,1,0.02h,Stop Loss,$30.25,$148.50,$236045.25,393,$148.50
2025-07-09,17:46:00,22982.75,SELL,1,0.02h,Stop Loss,$62.75,$211.25,$236108.00,393,$211.25
2025-07-09,17:52:00,22992.75,BUY,1,0.02h,Stop Loss,$9.00,$220.25,$236117.00,393,$220.25
2025-07-09,17:54:00,22976.0,SELL,1,0.02h,Stop Loss,$39.00,$259.25,$236156.00,393,$259.25
2025-07-09,18:02:00,22993.5,BUY,1,0.02h,Break Even,$0.25,$259.50,$236156.25,393,$259.50
2025-07-09,18:46:00,23009.75,SELL,1,0.02h,Stop Loss,$-6.00,$253.50,$236150.25,393,$253.50
2025-07-09,18:47:00,23015.5,BUY,1,0.02h,Stop Loss,$-6.00,$247.50,$236144.25,393,$247.50
2025-07-09,18:49:00,23011.5,SELL,1,0.02h,Break Even,$0.25,$247.75,$236144.50,393,$247.75
2025-07-09,18:51:00,23016.25,BUY,1,0.02h,Stop Loss,$10.25,$258.00,$236154.75,393,$258.00
2025-07-09,19:36:00,23033.75,SELL,1,0.02h,Break Even,$0.25,$258.25,$236155.00,393,$258.25
2025-07-09,19:38:00,23040.5,BUY,1,0.02h,Break Even,$0.25,$258.50,$236155.25,393,$258.50
2025-07-09,19:52:00,23031.75,SELL,1,0.02h,Break Even,$0.25,$258.75,$236155.50,393,$258.75
2025-07-09,19:56:00,23052.5,BUY,1,0.02h,Stop Loss,$-6.00,$252.75,$236149.50,393,$252.75
2025-07-09,20:21:00,23034.25,SELL,1,0.02h,Stop Loss,$-6.00,$246.75,$236143.50,393,$246.75
2025-07-09,20:41:00,23042.75,BUY,1,0.02h,Break Even,$0.25,$247.00,$236143.75,393,$247.00
2025-07-09,20:45:00,23039.5,SELL,1,0.02h,Break Even,$0.25,$247.25,$236144.00,393,$247.25
2025-07-09,20:51:00,23042.75,BUY,1,0.02h,Stop Loss,$-6.00,$241.25,$236138.00,393,$241.25
2025-07-09,22:01:00,23035.25,SELL,1,0.02h,Stop Loss,$-6.00,$235.25,$236132.00,393,$235.25
2025-07-09,22:04:00,23045.25,BUY,1,0.02h,Stop Loss,$-6.00,$229.25,$236126.00,393,$229.25
2025-07-09,22:43:00,23056.75,SELL,1,0.02h,Stop Loss,$-6.00,$223.25,$236120.00,393,$223.25
2025-07-09,22:44:00,23059.0,BUY,1,0.02h,Stop Loss,$-6.00,$217.25,$236114.00,393,$217.25
2025-07-09,22:45:00,23057.0,SELL,1,0.02h,Stop Loss,$-6.00,$211.25,$236108.00,393,$211.25
2025-07-09,22:58:00,23058.25,BUY,1,0.03h,Stop Loss,$-6.00,$205.25,$236102.00,393,$205.25
Final P&L Day: 205.25,,,,,,,,,,,
2025-07-10,12:18:00,23057.25,SELL,1,0.02h,Stop Loss,$-6.00,$-6.00,$236096.00,394,$-6.00
2025-07-10,12:21:00,23061.25,BUY,1,0.02h,Break Even,$0.25,$-5.75,$236096.25,394,$-5.75
2025-07-10,12:22:00,23058.5,SELL,1,0.02h,Stop Loss,$-6.00,$-11.75,$236090.25,394,$-11.75
2025-07-10,13:00:00,23049.25,BUY,1,0.02h,Break Even,$0.25,$-11.50,$236090.50,394,$-11.50
2025-07-10,13:14:00,23042.25,SELL,1,0.02h,Break Even,$0.25,$-11.25,$236090.75,394,$-11.25
2025-07-10,13:16:00,23055.0,BUY,1,0.02h,Stop Loss,$-6.00,$-17.25,$236084.75,394,$-17.25
2025-07-10,13:34:00,23035.25,SELL,1,0.02h,Stop Loss,$50.25,$33.00,$236135.00,394,$33.00
2025-07-10,14:20:00,22964.0,BUY,1,0.02h,Break Even,$0.25,$33.25,$236135.25,394,$33.25
2025-07-10,14:21:00,22945.0,SELL,1,0.02h,Stop Loss,$60.25,$93.50,$236195.50,394,$93.50
2025-07-10,14:37:00,22956.0,BUY,1,0.02h,Stop Loss,$21.50,$115.00,$236217.00,394,$115.00
2025-07-10,15:01:00,22962.25,SELL,1,0.02h,Break Even,$0.25,$115.25,$236217.25,394,$115.25
2025-07-10,15:02:00,22971.25,BUY,1,0.02h,Stop Loss,$11.50,$126.75,$236228.75,394,$126.75
2025-07-10,15:10:00,22965.75,SELL,1,0.02h,Stop Loss,$72.75,$199.50,$236301.50,394,$199.50
2025-07-10,15:24:00,22971.75,BUY,1,0.02h,Stop Loss,$27.75,$227.25,$236329.25,394,$227.25
2025-07-10,16:07:00,23003.0,SELL,1,0.02h,Break Even,$0.25,$227.50,$236329.50,394,$227.50
2025-07-10,16:26:00,23005.75,BUY,1,0.02h,Stop Loss,$4.00,$231.50,$236333.50,394,$231.50
2025-07-10,16:37:00,22989.25,SELL,1,0.02h,Stop Loss,$-6.00,$225.50,$236327.50,394,$225.50
2025-07-10,16:41:00,23003.5,BUY,1,0.02h,Break Even,$0.25,$225.75,$236327.75,394,$225.75
2025-07-10,16:50:00,22990.0,SELL,1,0.02h,Stop Loss,$-6.00,$219.75,$236321.75,394,$219.75
2025-07-10,16:51:00,23002.75,BUY,1,0.02h,Stop Loss,$-6.00,$213.75,$236315.75,394,$213.75
2025-07-10,16:52:00,22997.5,SELL,1,0.02h,Break Even,$0.25,$214.00,$236316.00,394,$214.00
2025-07-10,16:58:00,23000.0,BUY,1,0.02h,Stop Loss,$-6.00,$208.00,$236310.00,394,$208.00
2025-07-10,17:00:00,22992.25,SELL,1,0.02h,Break Even,$0.25,$208.25,$236310.25,394,$208.25
2025-07-10,17:02:00,23002.0,BUY,1,0.02h,Stop Loss,$10.25,$218.50,$236320.50,394,$218.50
2025-07-10,17:03:00,22998.25,SELL,1,0.02h,Break Even,$0.25,$218.75,$236320.75,394,$218.75
2025-07-10,17:04:00,23000.75,BUY,1,0.02h,Break Even,$0.25,$219.00,$236321.00,394,$219.00
2025-07-10,17:09:00,22998.0,SELL,1,0.02h,Stop Loss,$-6.00,$213.00,$236315.00,394,$213.00
2025-07-10,17:10:00,23000.25,BUY,1,0.02h,Stop Loss,$15.25,$228.25,$236330.25,394,$228.25
2025-07-10,17:15:00,22996.75,SELL,1,0.02h,Stop Loss,$6.50,$234.75,$236336.75,394,$234.75
2025-07-10,17:21:00,23002.25,BUY,1,0.02h,Stop Loss,$4.00,$238.75,$236340.75,394,$238.75
2025-07-10,18:29:00,23033.75,SELL,1,0.02h,Break Even,$0.25,$239.00,$236341.00,394,$239.00
2025-07-10,18:59:00,23042.25,BUY,1,0.02h,Stop Loss,$-6.00,$233.00,$236335.00,394,$233.00
2025-07-10,19:16:00,23036.0,SELL,1,0.02h,Break Even,$0.25,$233.25,$236335.25,394,$233.25
2025-07-10,19:18:00,23038.75,BUY,1,0.02h,Stop Loss,$-6.00,$227.25,$236329.25,394,$227.25
2025-07-10,19:20:00,23034.25,SELL,1,0.02h,Stop Loss,$-6.00,$221.25,$236323.25,394,$221.25
2025-07-10,19:37:00,23037.25,BUY,1,0.02h,Stop Loss,$-6.00,$215.25,$236317.25,394,$215.25
2025-07-10,19:47:00,23028.5,SELL,1,0.02h,Break Even,$0.25,$215.50,$236317.50,394,$215.50
2025-07-10,20:31:00,23012.75,BUY,1,0.02h,Break Even,$0.25,$215.75,$236317.75,394,$215.75
2025-07-10,20:53:00,23011.0,SELL,1,0.02h,Stop Loss,$-6.00,$209.75,$236311.75,394,$209.75
2025-07-10,22:05:00,23022.5,BUY,1,0.02h,Break Even,$0.25,$210.00,$236312.00,394,$210.00
2025-07-10,22:35:00,23026.75,SELL,1,0.02h,Stop Loss,$-6.00,$204.00,$236306.00,394,$204.00
2025-07-10,22:45:00,23028.75,BUY,1,0.02h,Break Even,$0.25,$204.25,$236306.25,394,$204.25
Final P&L Day: 204.25,,,,,,,,,,,
2025-07-11,12:00:00,22908.75,SELL,1,0.02h,Stop Loss,$16.50,$16.50,$236322.75,395,$16.50
2025-07-11,12:49:00,22906.0,BUY,1,0.02h,Stop Loss,$15.25,$31.75,$236338.00,395,$31.75
2025-07-11,13:09:00,22901.5,SELL,1,0.02h,Break Even,$0.25,$32.00,$236338.25,395,$32.00
2025-07-11,13:29:00,22907.75,BUY,1,0.02h,Stop Loss,$46.50,$78.50,$236384.75,395,$78.50
2025-07-11,13:40:00,22892.75,SELL,1,0.02h,Stop Loss,$41.50,$120.00,$236426.25,395,$120.00
2025-07-11,13:50:00,22936.0,BUY,1,0.02h,Stop Loss,$24.00,$144.00,$236450.25,395,$144.00
2025-07-11,14:44:00,22984.25,SELL,1,0.02h,Stop Loss,$7.75,$151.75,$236458.00,395,$151.75
2025-07-11,15:31:00,22957.25,BUY,1,0.02h,Stop Loss,$9.00,$160.75,$236467.00,395,$160.75
2025-07-11,15:57:00,22964.25,SELL,1,0.02h,Stop Loss,$-6.00,$154.75,$236461.00,395,$154.75
2025-07-11,16:01:00,22994.25,BUY,1,0.02h,Stop Loss,$-6.00,$148.75,$236455.00,395,$148.75
2025-07-11,16:05:00,22972.25,SELL,1,0.02h,Stop Loss,$9.00,$157.75,$236464.00,395,$157.75
2025-07-11,16:17:00,22992.25,BUY,1,0.02h,Stop Loss,$-6.00,$151.75,$236458.00,395,$151.75
2025-07-11,16:44:00,22974.75,SELL,1,0.02h,Break Even,$0.25,$152.00,$236458.25,395,$152.00
2025-07-11,16:54:00,22989.75,BUY,1,0.02h,Stop Loss,$9.00,$161.00,$236467.25,395,$161.00
2025-07-11,17:32:00,23000.0,SELL,1,0.02h,Stop Loss,$19.00,$180.00,$236486.25,395,$180.00
2025-07-11,17:54:00,22996.0,BUY,1,0.02h,Break Even,$0.25,$180.25,$236486.50,395,$180.25
2025-07-11,18:21:00,22996.5,SELL,1,0.02h,Break Even,$0.25,$180.50,$236486.75,395,$180.50
2025-07-11,18:23:00,23001.25,BUY,1,0.02h,Break Even,$0.25,$180.75,$236487.00,395,$180.75
2025-07-11,18:24:00,22999.25,SELL,1,0.02h,Break Even,$0.25,$181.00,$236487.25,395,$181.00
2025-07-11,18:25:00,23003.0,BUY,1,0.02h,Break Even,$0.25,$181.25,$236487.50,395,$181.25
2025-07-11,18:31:00,22999.25,SELL,1,0.02h,Break Even,$0.25,$181.50,$236487.75,395,$181.50
2025-07-11,18:32:00,23004.75,BUY,1,0.02h,Break Even,$0.25,$181.75,$236488.00,395,$181.75
2025-07-11,18:50:00,23002.25,SELL,1,0.02h,Break Even,$0.25,$182.00,$236488.25,395,$182.00
2025-07-11,19:19:00,22983.75,BUY,1,0.02h,Break Even,$0.25,$182.25,$236488.50,395,$182.25
2025-07-11,19:35:00,22979.0,SELL,1,0.02h,Break Even,$0.25,$182.50,$236488.75,395,$182.50
2025-07-11,20:52:00,22941.5,BUY,1,0.02h,Break Even,$0.25,$182.75,$236489.00,395,$182.75
Final P&L Day: 182.75,,,,,,,,,,,
2025-07-14,12:00:00,22887.0,SELL,1,0.02h,Stop Loss,$17.75,$17.75,$236506.75,396,$17.75
2025-07-14,12:26:00,22907.75,BUY,1,0.02h,Break Even,$0.25,$18.00,$236507.00,396,$18.00
2025-07-14,12:34:00,22889.75,SELL,1,0.02h,Stop Loss,$-6.00,$12.00,$236501.00,396,$12.00
2025-07-14,12:42:00,22901.0,BUY,1,0.02h,Break Even,$0.25,$12.25,$236501.25,396,$12.25
2025-07-14,12:43:00,22898.75,SELL,1,0.02h,Stop Loss,$-6.00,$6.25,$236495.25,396,$6.25
2025-07-14,12:44:00,22905.25,BUY,1,0.02h,Break Even,$0.25,$6.50,$236495.50,396,$6.50
2025-07-14,12:59:00,22895.25,SELL,1,0.02h,Stop Loss,$-6.00,$0.50,$236489.50,396,$0.50
2025-07-14,13:15:00,22904.75,BUY,1,0.02h,Break Even,$0.25,$0.75,$236489.75,396,$0.75
2025-07-14,13:43:00,22878.75,SELL,1,0.02h,Stop Loss,$107.75,$108.50,$236597.50,396,$108.50
2025-07-14,13:53:00,22921.75,BUY,1,0.02h,Stop Loss,$19.00,$127.50,$236616.50,396,$127.50
2025-07-14,14:32:00,22937.75,SELL,1,0.02h,Stop Loss,$60.25,$187.75,$236676.75,396,$187.75
2025-07-14,14:44:00,22956.0,BUY,1,0.02h,Break Even,$0.25,$188.00,$236677.00,396,$188.00
2025-07-14,15:36:00,23000.25,SELL,1,0.02h,Stop Loss,$-6.00,$182.00,$236671.00,396,$182.00
2025-07-14,15:37:00,23009.75,BUY,1,0.02h,Stop Loss,$5.25,$187.25,$236676.25,396,$187.25
2025-07-14,15:47:00,22996.0,SELL,1,0.02h,Stop Loss,$-6.00,$181.25,$236670.25,396,$181.25
2025-07-14,15:52:00,23008.25,BUY,1,0.02h,Stop Loss,$-6.00,$175.25,$236664.25,396,$175.25
2025-07-14,15:56:00,22996.75,SELL,1,0.02h,Stop Loss,$-6.00,$169.25,$236658.25,396,$169.25
2025-07-14,16:00:00,23008.75,BUY,1,0.02h,Stop Loss,$-6.00,$163.25,$236652.25,396,$163.25
2025-07-14,16:03:00,23004.25,SELL,1,0.02h,Stop Loss,$6.50,$169.75,$236658.75,396,$169.75
2025-07-14,16:08:00,23016.0,BUY,1,0.02h,Break Even,$0.25,$170.00,$236659.00,396,$170.00
2025-07-14,16:30:00,23015.25,SELL,1,0.02h,Stop Loss,$4.00,$174.00,$236663.00,396,$174.00
2025-07-14,16:42:00,23027.0,BUY,1,0.02h,Stop Loss,$-6.00,$168.00,$236657.00,396,$168.00
2025-07-14,17:43:00,23047.25,SELL,1,0.02h,Stop Loss,$-6.00,$162.00,$236651.00,396,$162.00
2025-07-14,17:54:00,23054.75,BUY,1,0.02h,Stop Loss,$-6.00,$156.00,$236645.00,396,$156.00
2025-07-14,17:57:00,23047.5,SELL,1,0.02h,Break Even,$0.25,$156.25,$236645.25,396,$156.25
2025-07-14,18:28:00,23048.5,BUY,1,0.02h,Break Even,$0.25,$156.50,$236645.50,396,$156.50
2025-07-14,19:09:00,23045.25,SELL,1,0.02h,Break Even,$0.25,$156.75,$236645.75,396,$156.75
2025-07-14,19:59:00,23039.25,BUY,1,0.02h,Break Even,$0.25,$157.00,$236646.00,396,$157.00
2025-07-14,20:01:00,23023.75,SELL,1,0.02h,Break Even,$0.25,$157.25,$236646.25,396,$157.25
2025-07-14,20:02:00,23032.5,BUY,1,0.02h,Break Even,$0.25,$157.50,$236646.50,396,$157.50
2025-07-14,20:03:00,23029.75,SELL,1,0.02h,Break Even,$0.25,$157.75,$236646.75,396,$157.75
2025-07-14,20:21:00,23031.0,BUY,1,0.02h,Stop Loss,$-6.00,$151.75,$236640.75,396,$151.75
2025-07-14,20:27:00,23025.25,SELL,1,0.02h,Break Even,$0.25,$152.00,$236641.00,396,$152.00
2025-07-14,20:41:00,23028.75,BUY,1,0.03h,Break Even,$0.25,$152.25,$236641.25,396,$152.25
2025-07-14,22:02:00,23022.0,SELL,1,0.02h,Stop Loss,$-6.00,$146.25,$236635.25,396,$146.25
2025-07-14,22:53:00,23011.5,BUY,1,0.03h,Stop Loss,$-6.00,$140.25,$236629.25,396,$140.25
2025-07-14,22:58:00,23002.25,SELL,1,0.02h,Break Even,$0.25,$140.50,$236629.50,396,$140.50
Final P&L Day: 140.50,,,,,,,,,,,
2025-07-15,12:00:00,23167.0,BUY,1,0.02h,Stop Loss,$11.50,$11.50,$236641.00,397,$11.50
2025-07-15,13:33:00,23191.75,SELL,1,0.02h,Stop Loss,$89.00,$100.50,$236730.00,397,$100.50
2025-07-15,14:10:00,23162.75,BUY,1,0.02h,Stop Loss,$27.75,$128.25,$236757.75,397,$128.25
2025-07-15,14:33:00,23165.0,SELL,1,0.02h,Stop Loss,$14.00,$142.25,$236771.75,397,$142.25
2025-07-15,15:12:00,23140.75,BUY,1,0.02h,Stop Loss,$12.75,$155.00,$236784.50,397,$155.00
2025-07-15,15:57:00,23156.0,SELL,1,0.02h,Break Even,$0.25,$155.25,$236784.75,397,$155.25
2025-07-15,16:33:00,23154.0,BUY,1,0.02h,Break Even,$0.25,$155.50,$236785.00,397,$155.50
2025-07-15,16:35:00,23140.75,SELL,1,0.02h,Break Even,$0.25,$155.75,$236785.25,397,$155.75
2025-07-15,16:53:00,23144.0,BUY,1,0.02h,Stop Loss,$-6.00,$149.75,$236779.25,397,$149.75
2025-07-15,16:54:00,23138.5,SELL,1,0.02h,Stop Loss,$59.00,$208.75,$236838.25,397,$208.75
2025-07-15,17:28:00,23115.5,BUY,1,0.02h,Stop Loss,$4.00,$212.75,$236842.25,397,$212.75
2025-07-15,18:35:00,23168.75,SELL,1,0.02h,Stop Loss,$54.00,$266.75,$236896.25,397,$266.75
2025-07-15,19:42:00,23109.0,BUY,1,0.02h,Stop Loss,$4.00,$270.75,$236900.25,397,$270.75
2025-07-15,19:54:00,23094.0,SELL,1,0.02h,Stop Loss,$12.75,$283.50,$236913.00,397,$283.50
2025-07-15,22:01:00,23027.0,BUY,1,0.02h,Break Even,$0.25,$283.75,$236913.25,397,$283.75
2025-07-15,22:11:00,23011.5,SELL,1,0.02h,Stop Loss,$-6.00,$277.75,$236907.25,397,$277.75
2025-07-15,22:51:00,23002.75,BUY,1,0.02h,Stop Loss,$-6.00,$271.75,$236901.25,397,$271.75
Final P&L Day: 271.75,,,,,,,,,,,
2025-07-16,13:04:00,23060.5,SELL,1,0.02h,Stop Loss,$-6.00,$-6.00,$236895.25,398,$-6.00
2025-07-16,13:11:00,23071.25,BUY,1,0.02h,Break Even,$0.25,$-5.75,$236895.50,398,$-5.75
2025-07-16,13:17:00,23065.5,SELL,1,0.02h,Break Even,$0.25,$-5.50,$236895.75,398,$-5.50
2025-07-16,13:19:00,23069.75,BUY,1,0.02h,Break Even,$0.25,$-5.25,$236896.00,398,$-5.25
2025-07-16,13:32:00,23048.5,SELL,1,0.02h,Stop Loss,$59.00,$53.75,$236955.00,398,$53.75
2025-07-16,14:14:00,22992.25,BUY,1,0.02h,Stop Loss,$-6.00,$47.75,$236949.00,398,$47.75
2025-07-16,14:15:00,22975.5,SELL,1,0.02h,Stop Loss,$41.50,$89.25,$236990.50,398,$89.25
2025-07-16,14:20:00,22993.5,BUY,1,0.02h,Break Even,$0.25,$89.50,$236990.75,398,$89.50
2025-07-16,14:56:00,22993.25,SELL,1,0.02h,Stop Loss,$47.75,$137.25,$237038.50,398,$137.25
2025-07-16,14:57:00,23010.75,BUY,1,0.02h,Break Even,$0.25,$137.50,$237038.75,398,$137.50
2025-07-16,14:58:00,22992.0,SELL,1,0.02h,Stop Loss,$131.50,$269.00,$237170.25,398,$269.00
2025-07-16,15:05:00,23016.75,BUY,1,0.02h,Break Even,$0.25,$269.25,$237170.50,398,$269.25
2025-07-16,15:18:00,22983.0,SELL,1,0.02h,Stop Loss,$49.00,$318.25,$237219.50,398,$318.25
2025-07-16,15:48:00,22946.25,BUY,1,0.02h,Break Even,$0.25,$318.50,$237219.75,398,$318.50
2025-07-16,16:24:00,22971.0,SELL,1,0.02h,Break Even,$0.25,$318.75,$237220.00,398,$318.75
2025-07-16,16:30:00,22983.0,BUY,1,0.02h,Break Even,$0.25,$319.00,$237220.25,398,$319.00
2025-07-16,16:48:00,22978.25,SELL,1,0.02h,Stop Loss,$-6.00,$313.00,$237214.25,398,$313.00
2025-07-16,16:49:00,22996.75,BUY,1,0.02h,Stop Loss,$31.50,$344.50,$237245.75,398,$344.50
2025-07-16,17:30:00,23040.0,SELL,1,0.02h,Stop Loss,$5.25,$349.75,$237251.00,398,$349.75
2025-07-16,18:17:00,23042.0,BUY,1,0.02h,Stop Loss,$-6.00,$343.75,$237245.00,398,$343.75
2025-07-16,18:20:00,23026.5,SELL,1,0.02h,Stop Loss,$35.25,$379.00,$237280.25,398,$379.00
2025-07-16,18:23:00,23037.75,BUY,1,0.02h,Break Even,$0.25,$379.25,$237280.50,398,$379.25
2025-07-16,19:17:00,23062.75,SELL,1,0.02h,Break Even,$0.25,$379.50,$237280.75,398,$379.50
2025-07-16,19:27:00,23071.0,BUY,1,0.02h,Stop Loss,$-6.00,$373.50,$237274.75,398,$373.50
2025-07-16,20:00:00,23075.0,SELL,1,0.02h,Stop Loss,$40.25,$413.75,$237315.00,398,$413.75
2025-07-16,20:40:00,23065.0,BUY,1,0.02h,Stop Loss,$-6.00,$407.75,$237309.00,398,$407.75
2025-07-16,20:53:00,23060.75,SELL,1,0.02h,Stop Loss,$-6.00,$401.75,$237303.00,398,$401.75
2025-07-16,22:01:00,23064.5,BUY,1,0.02h,Stop Loss,$-6.00,$395.75,$237297.00,398,$395.75
2025-07-16,22:02:00,23061.5,SELL,1,0.02h,Stop Loss,$6.50,$402.25,$237303.50,398,$402.25
Final P&L Day: 402.25,,,,,,,,,,,
2025-07-17,12:00:00,23086.75,BUY,1,0.02h,Stop Loss,$27.75,$27.75,$237331.25,399,$27.75
2025-07-17,13:17:00,23129.5,SELL,1,0.02h,Stop Loss,$17.75,$45.50,$237349.00,399,$45.50
2025-07-17,13:44:00,23118.75,BUY,1,0.02h,Stop Loss,$20.25,$65.75,$237369.25,399,$65.75
2025-07-17,14:18:00,23145.0,SELL,1,0.02h,Stop Loss,$25.25,$91.00,$237394.50,399,$91.00
2025-07-17,14:31:00,23154.0,BUY,1,0.02h,Stop Loss,$-6.00,$85.00,$237388.50,399,$85.00
2025-07-17,15:35:00,23219.75,SELL,1,0.02h,Break Even,$0.25,$85.25,$237388.75,399,$85.25
2025-07-17,15:37:00,23225.75,BUY,1,0.02h,Break Even,$0.25,$85.50,$237389.00,399,$85.50
2025-07-17,16:40:00,23250.25,SELL,1,0.02h,Break Even,$0.25,$85.75,$237389.25,399,$85.75
2025-07-17,16:49:00,23259.75,BUY,1,0.02h,Break Even,$0.25,$86.00,$237389.50,399,$86.00
2025-07-17,16:57:00,23252.0,SELL,1,0.02h,Stop Loss,$-6.00,$80.00,$237383.50,399,$80.00
2025-07-17,17:15:00,23259.0,BUY,1,0.02h,Break Even,$0.25,$80.25,$237383.75,399,$80.25
2025-07-17,17:28:00,23249.0,SELL,1,0.02h,Stop Loss,$26.50,$106.75,$237410.25,399,$106.75
2025-07-17,17:32:00,23260.0,BUY,1,0.02h,Break Even,$0.25,$107.00,$237410.50,399,$107.00
2025-07-17,17:34:00,23255.0,SELL,1,0.02h,Stop Loss,$-6.00,$101.00,$237404.50,399,$101.00
2025-07-17,17:35:00,23258.0,BUY,1,0.02h,Break Even,$0.25,$101.25,$237404.75,399,$101.25
2025-07-17,18:07:00,23256.0,SELL,1,0.02h,Stop Loss,$14.00,$115.25,$237418.75,399,$115.25
2025-07-17,18:30:00,23256.0,BUY,1,0.02h,Break Even,$0.25,$115.50,$237419.00,399,$115.50
2025-07-17,18:37:00,23249.5,SELL,1,0.02h,Break Even,$0.25,$115.75,$237419.25,399,$115.75
2025-07-17,18:39:00,23256.5,BUY,1,0.02h,Break Even,$0.25,$116.00,$237419.50,399,$116.00
2025-07-17,19:00:00,23252.5,SELL,1,0.02h,Break Even,$0.25,$116.25,$237419.75,399,$116.25
2025-07-17,19:02:00,23258.5,BUY,1,0.02h,Stop Loss,$24.00,$140.25,$237443.75,399,$140.25
2025-07-17,19:19:00,23259.5,SELL,1,0.02h,Stop Loss,$-6.00,$134.25,$237437.75,399,$134.25
2025-07-17,19:20:00,23261.75,BUY,1,0.02h,Break Even,$0.25,$134.50,$237438.00,399,$134.50
2025-07-17,19:27:00,23259.75,SELL,1,0.02h,Stop Loss,$-6.00,$128.50,$237432.00,399,$128.50
2025-07-17,19:30:00,23261.75,BUY,1,0.02h,Stop Loss,$10.25,$138.75,$237442.25,399,$138.75
2025-07-17,19:44:00,23257.25,SELL,1,0.02h,Break Even,$0.25,$139.00,$237442.50,399,$139.00
2025-07-17,19:54:00,23270.25,BUY,1,0.02h,Stop Loss,$24.00,$163.00,$237466.50,399,$163.00
2025-07-17,19:56:00,23256.0,SELL,1,0.02h,Stop Loss,$26.50,$189.50,$237493.00,399,$189.50
2025-07-17,20:15:00,23255.5,BUY,1,0.02h,Break Even,$0.25,$189.75,$237493.25,399,$189.75
2025-07-17,20:52:00,23264.0,SELL,1,0.02h,Stop Loss,$-6.00,$183.75,$237487.25,399,$183.75
2025-07-17,20:57:00,23267.0,BUY,1,0.03h,Break Even,$0.25,$184.00,$237487.50,399,$184.00
2025-07-17,21:00:00,23265.5,SELL,1,1.02h,Stop Loss,$84.00,$268.00,$237571.50,399,$268.00
2025-07-17,22:22:00,23261.0,BUY,1,0.02h,Stop Loss,$-6.00,$262.00,$237565.50,399,$262.00
2025-07-17,22:23:00,23256.0,SELL,1,0.02h,Stop Loss,$-6.00,$256.00,$237559.50,399,$256.00
2025-07-17,22:24:00,23258.25,BUY,1,0.02h,Stop Loss,$-6.00,$250.00,$237553.50,399,$250.00
2025-07-17,22:32:00,23254.0,SELL,1,0.02h,Break Even,$0.25,$250.25,$237553.75,399,$250.25
2025-07-17,22:55:00,23257.0,BUY,1,0.02h,Stop Loss,$-6.00,$244.25,$237547.75,399,$244.25
Final P&L Day: 244.25,,,,,,,,,,,
2025-07-18,12:32:00,23258.5,SELL,1,0.02h,Stop Loss,$-6.00,$-6.00,$237541.75,400,$-6.00
2025-07-18,12:33:00,23263.25,BUY,1,0.02h,Break Even,$0.25,$-5.75,$237542.00,400,$-5.75
2025-07-18,12:34:00,23260.25,SELL,1,0.02h,Break Even,$0.25,$-5.50,$237542.25,400,$-5.50
2025-07-18,12:40:00,23267.0,BUY,1,0.02h,Stop Loss,$-6.00,$-11.50,$237536.25,400,$-11.50
2025-07-18,12:44:00,23260.25,SELL,1,0.02h,Stop Loss,$-6.00,$-17.50,$237530.25,400,$-17.50
2025-07-18,12:45:00,23265.25,BUY,1,0.02h,Stop Loss,$-6.00,$-23.50,$237524.25,400,$-23.50
2025-07-18,13:18:00,23264.5,SELL,1,0.02h,Stop Loss,$6.50,$-17.00,$237530.75,400,$-17.00
2025-07-18,13:27:00,23278.0,BUY,1,0.02h,Stop Loss,$76.50,$59.50,$237607.25,400,$59.50
2025-07-18,13:39:00,23261.25,SELL,1,0.02h,Stop Loss,$4.00,$63.50,$237611.25,400,$63.50
2025-07-18,13:48:00,23292.75,BUY,1,0.02h,Stop Loss,$9.00,$72.50,$237620.25,400,$72.50
2025-07-18,13:54:00,23269.25,SELL,1,0.02h,Stop Loss,$11.50,$84.00,$237631.75,400,$84.00
2025-07-18,14:45:00,23223.75,BUY,1,0.02h,Stop Loss,$20.25,$104.25,$237652.00,400,$104.25
2025-07-18,14:50:00,23209.75,SELL,1,0.02h,Break Even,$0.25,$104.50,$237652.25,400,$104.50
2025-07-18,14:51:00,23215.5,BUY,1,0.02h,Stop Loss,$6.50,$111.00,$237658.75,400,$111.00
2025-07-18,15:00:00,23205.0,SELL,1,0.02h,Stop Loss,$27.75,$138.75,$237686.50,400,$138.75
2025-07-18,15:17:00,23215.75,BUY,1,0.02h,Break Even,$0.25,$139.00,$237686.75,400,$139.00
2025-07-18,15:24:00,23202.25,SELL,1,0.02h,Stop Loss,$-6.00,$133.00,$237680.75,400,$133.00
2025-07-18,15:28:00,23213.5,BUY,1,0.02h,Stop Loss,$5.25,$138.25,$237686.00,400,$138.25
2025-07-18,16:08:00,23230.75,SELL,1,0.02h,Break Even,$0.25,$138.50,$237686.25,400,$138.50
2025-07-18,16:46:00,23212.5,BUY,1,0.02h,Break Even,$0.25,$138.75,$237686.50,400,$138.75
2025-07-18,16:49:00,23191.5,SELL,1,0.02h,Stop Loss,$-6.00,$132.75,$237680.50,400,$132.75
2025-07-18,16:52:00,23211.25,BUY,1,0.02h,Stop Loss,$-6.00,$126.75,$237674.50,400,$126.75
2025-07-18,16:54:00,23194.75,SELL,1,0.02h,Stop Loss,$-6.00,$120.75,$237668.50,400,$120.75
2025-07-18,17:15:00,23204.5,BUY,1,0.02h,Break Even,$0.25,$121.00,$237668.75,400,$121.00
2025-07-18,17:47:00,23199.25,SELL,1,0.02h,Stop Loss,$14.00,$135.00,$237682.75,400,$135.00
2025-07-18,18:03:00,23213.75,BUY,1,0.02h,Stop Loss,$-6.00,$129.00,$237676.75,400,$129.00
2025-07-18,18:13:00,23200.0,SELL,1,0.02h,Break Even,$0.25,$129.25,$237677.00,400,$129.25
2025-07-18,18:21:00,23211.0,BUY,1,0.02h,Stop Loss,$-6.00,$123.25,$237671.00,400,$123.25
2025-07-18,18:53:00,23210.5,SELL,1,0.02h,Stop Loss,$20.25,$143.50,$237691.25,400,$143.50
2025-07-18,19:13:00,23211.25,BUY,1,0.02h,Stop Loss,$-6.00,$137.50,$237685.25,400,$137.50
2025-07-18,19:31:00,23213.25,SELL,1,0.02h,Stop Loss,$21.50,$159.00,$237706.75,400,$159.00
2025-07-18,19:49:00,23213.25,BUY,1,0.02h,Break Even,$0.25,$159.25,$237707.00,400,$159.25
2025-07-18,20:26:00,23219.75,SELL,1,0.02h,Break Even,$0.25,$159.50,$237707.25,400,$159.50
2025-07-18,20:35:00,23225.25,BUY,1,0.03h,Break Even,$0.25,$159.75,$237707.50,400,$159.75
2025-07-18,20:46:00,23221.5,SELL,1,0.02h,Break Even,$0.25,$160.00,$237707.75,400,$160.00
2025-07-18,20:54:00,23224.0,BUY,1,0.02h,Stop Loss,$-6.00,$154.00,$237701.75,400,$154.00
Final P&L Day: 154.00,,,,,,,,,,,
2025-07-21,12:42:00,23267.5,SELL,1,0.02h,Break Even,$0.25,$0.25,$237702.00,401,$0.25
2025-07-21,13:23:00,23244.25,BUY,1,0.02h,Break Even,$0.25,$0.50,$237702.25,401,$0.50
2025-07-21,14:46:00,23397.75,SELL,1,0.02h,Stop Loss,$-6.00,$-5.50,$237696.25,401,$-5.50
2025-07-21,15:27:00,23396.5,BUY,1,0.02h,Break Even,$0.25,$-5.25,$237696.50,401,$-5.25
2025-07-21,15:56:00,23394.75,SELL,1,0.02h,Stop Loss,$22.75,$17.50,$237719.25,401,$17.50
2025-07-21,16:32:00,23384.5,BUY,1,0.02h,Break Even,$0.25,$17.75,$237719.50,401,$17.75
2025-07-21,17:43:00,23411.75,SELL,1,0.02h,Stop Loss,$-6.00,$11.75,$237713.50,401,$11.75
2025-07-21,17:49:00,23417.75,BUY,1,0.02h,Break Even,$0.25,$12.00,$237713.75,401,$12.00
2025-07-21,18:00:00,23411.75,SELL,1,0.02h,Stop Loss,$10.25,$22.25,$237724.00,401,$22.25
2025-07-21,18:24:00,23416.5,BUY,1,0.02h,Stop Loss,$-6.00,$16.25,$237718.00,401,$16.25
2025-07-21,18:31:00,23409.25,SELL,1,0.02h,Stop Loss,$6.50,$22.75,$237724.50,401,$22.75
2025-07-21,20:18:00,23352.25,BUY,1,0.02h,Break Even,$0.25,$23.00,$237724.75,401,$23.00
2025-07-21,20:27:00,23343.75,SELL,1,0.02h,Break Even,$0.25,$23.25,$237725.00,401,$23.25
2025-07-21,20:55:00,23346.5,BUY,1,0.02h,Stop Loss,$-6.00,$17.25,$237719.00,401,$17.25
2025-07-21,20:58:00,23345.0,SELL,1,0.03h,Stop Loss,$-6.00,$11.25,$237713.00,401,$11.25
2025-07-21,21:00:00,23346.75,BUY,1,1.02h,Stop Loss,$-6.00,$5.25,$237707.00,401,$5.25
2025-07-21,22:08:00,23345.0,SELL,1,0.02h,Stop Loss,$-6.00,$-0.75,$237701.00,401,$-0.75
2025-07-21,22:26:00,23349.0,BUY,1,0.02h,Stop Loss,$-6.00,$-6.75,$237695.00,401,$-6.75
2025-07-21,22:39:00,23344.25,SELL,1,0.02h,Stop Loss,$-6.00,$-12.75,$237689.00,401,$-12.75
2025-07-21,22:50:00,23346.5,BUY,1,0.02h,Stop Loss,$-6.00,$-18.75,$237683.00,401,$-18.75
2025-07-21,22:53:00,23343.75,SELL,1,0.02h,Stop Loss,$-6.00,$-24.75,$237677.00,401,$-24.75
Final P&L Day: -24.75,,,,,,,,,,,
2025-07-22,12:29:00,23338.0,BUY,1,0.02h,Break Even,$0.25,$0.25,$237677.25,402,$0.25
2025-07-22,12:44:00,23329.0,SELL,1,0.02h,Break Even,$0.25,$0.50,$237677.50,402,$0.50
2025-07-22,12:52:00,23333.75,BUY,1,0.02h,Break Even,$0.25,$0.75,$237677.75,402,$0.75
2025-07-22,13:23:00,23334.25,SELL,1,0.02h,Break Even,$0.25,$1.00,$237678.00,402,$1.00
2025-07-22,13:27:00,23339.5,BUY,1,0.02h,Stop Loss,$-6.00,$-5.00,$237672.00,402,$-5.00
2025-07-22,13:28:00,23333.75,SELL,1,0.02h,Stop Loss,$-6.00,$-11.00,$237666.00,402,$-11.00
2025-07-22,13:29:00,23341.5,BUY,1,0.02h,Stop Loss,$11.50,$0.50,$237677.50,402,$0.50
2025-07-22,13:31:00,23319.25,SELL,1,0.02h,Stop Loss,$117.75,$118.25,$237795.25,402,$118.25
2025-07-22,14:16:00,23195.5,BUY,1,0.02h,Break Even,$0.25,$118.50,$237795.50,402,$118.50
2025-07-22,14:25:00,23163.5,SELL,1,0.02h,Stop Loss,$-6.00,$112.50,$237789.50,402,$112.50
2025-07-22,14:32:00,23197.5,BUY,1,0.02h,Stop Loss,$-6.00,$106.50,$237783.50,402,$106.50
2025-07-22,15:16:00,23209.0,SELL,1,0.02h,Stop Loss,$41.50,$148.00,$237825.00,402,$148.00
2025-07-22,15:34:00,23223.0,BUY,1,0.02h,Stop Loss,$45.25,$193.25,$237870.25,402,$193.25
2025-07-22,15:56:00,23217.5,SELL,1,0.02h,Stop Loss,$41.50,$234.75,$237911.75,402,$234.75
2025-07-22,16:18:00,23222.75,BUY,1,0.02h,Break Even,$0.25,$235.00,$237912.00,402,$235.00
2025-07-22,16:25:00,23202.75,SELL,1,0.02h,Stop Loss,$67.75,$302.75,$237979.75,402,$302.75
2025-07-22,16:53:00,23195.25,BUY,1,0.02h,Break Even,$0.25,$303.00,$237980.00,402,$303.00
2025-07-22,17:44:00,23223.5,SELL,1,0.02h,Break Even,$0.25,$303.25,$237980.25,402,$303.25
2025-07-22,18:03:00,23226.75,BUY,1,0.02h,Break Even,$0.25,$303.50,$237980.50,402,$303.50
2025-07-22,18:07:00,23218.5,SELL,1,0.02h,Stop Loss,$-6.00,$297.50,$237974.50,402,$297.50
2025-07-22,18:08:00,23224.0,BUY,1,0.02h,Break Even,$0.25,$297.75,$237974.75,402,$297.75
2025-07-22,18:16:00,23215.0,SELL,1,0.02h,Stop Loss,$6.50,$304.25,$237981.25,402,$304.25
2025-07-22,18:28:00,23221.75,BUY,1,0.02h,Stop Loss,$-6.00,$298.25,$237975.25,402,$298.25
2025-07-22,19:10:00,23242.0,SELL,1,0.02h,Stop Loss,$-6.00,$292.25,$237969.25,402,$292.25
2025-07-22,19:27:00,23243.5,BUY,1,0.02h,Stop Loss,$-6.00,$286.25,$237963.25,402,$286.25
2025-07-22,19:31:00,23235.75,SELL,1,0.02h,Stop Loss,$-6.00,$280.25,$237957.25,402,$280.25
2025-07-22,19:34:00,23246.0,BUY,1,0.02h,Break Even,$0.25,$280.50,$237957.50,402,$280.50
2025-07-22,19:46:00,23240.0,SELL,1,0.02h,Stop Loss,$12.75,$293.25,$237970.25,402,$293.25
2025-07-22,20:49:00,23197.5,BUY,1,0.02h,Stop Loss,$-6.00,$287.25,$237964.25,402,$287.25
2025-07-22,20:50:00,23195.75,SELL,1,0.02h,Break Even,$0.25,$287.50,$237964.50,402,$287.50
2025-07-22,22:01:00,23203.0,BUY,1,0.02h,Break Even,$0.25,$287.75,$237964.75,402,$287.75
2025-07-22,22:10:00,23192.0,SELL,1,0.02h,Stop Loss,$17.75,$305.50,$237982.50,402,$305.50
2025-07-22,22:59:00,23181.0,BUY,1,0.02h,Break Even,$0.25,$305.75,$237982.75,402,$305.75
Final P&L Day: 305.75,,,,,,,,,,,
2025-07-23,12:33:00,23241.0,SELL,1,0.02h,Break Even,$0.25,$0.25,$237983.00,403,$0.25
2025-07-23,12:49:00,23247.75,BUY,1,0.02h,Break Even,$0.25,$0.50,$237983.25,403,$0.50
2025-07-23,12:51:00,23236.75,SELL,1,0.02h,Stop Loss,$15.25,$15.75,$237998.50,403,$15.75
2025-07-23,13:10:00,23242.5,BUY,1,0.02h,Stop Loss,$-6.00,$9.75,$237992.50,403,$9.75
2025-07-23,13:16:00,23237.75,SELL,1,0.02h,Break Even,$0.25,$10.00,$237992.75,403,$10.00
2025-07-23,13:19:00,23244.75,BUY,1,0.02h,Stop Loss,$-6.00,$4.00,$237986.75,403,$4.00
2025-07-23,13:32:00,23197.0,SELL,1,0.02h,Stop Loss,$54.00,$58.00,$238040.75,403,$58.00
2025-07-23,14:23:00,23181.75,BUY,1,0.02h,Break Even,$0.25,$58.25,$238041.00,403,$58.25
2025-07-23,14:35:00,23151.25,SELL,1,0.02h,Break Even,$0.25,$58.50,$238041.25,403,$58.50
2025-07-23,14:47:00,23178.0,BUY,1,0.02h,Break Even,$0.25,$58.75,$238041.50,403,$58.75
2025-07-23,15:17:00,23192.0,SELL,1,0.02h,Break Even,$0.25,$59.00,$238041.75,403,$59.00
2025-07-23,15:20:00,23196.75,BUY,1,0.02h,Stop Loss,$29.00,$88.00,$238070.75,403,$88.00
2025-07-23,16:15:00,23230.0,SELL,1,0.02h,Stop Loss,$-6.00,$82.00,$238064.75,403,$82.00
2025-07-23,16:44:00,23225.0,BUY,1,0.02h,Break Even,$0.25,$82.25,$238065.00,403,$82.25
2025-07-23,17:13:00,23222.25,SELL,1,0.02h,Break Even,$0.25,$82.50,$238065.25,403,$82.50
2025-07-23,17:24:00,23232.75,BUY,1,0.02h,Break Even,$0.25,$82.75,$238065.50,403,$82.75
2025-07-23,18:57:00,23294.5,SELL,1,0.02h,Stop Loss,$-6.00,$76.75,$238059.50,403,$76.75
2025-07-23,18:59:00,23299.25,BUY,1,0.02h,Break Even,$0.25,$77.00,$238059.75,403,$77.00
2025-07-23,19:05:00,23293.5,SELL,1,0.02h,Break Even,$0.25,$77.25,$238060.00,403,$77.25
2025-07-23,19:13:00,23298.75,BUY,1,0.02h,Break Even,$0.25,$77.50,$238060.25,403,$77.50
2025-07-23,19:14:00,23294.25,SELL,1,0.02h,Stop Loss,$7.75,$85.25,$238068.00,403,$85.25
2025-07-23,19:53:00,23295.25,BUY,1,0.02h,Stop Loss,$6.50,$91.75,$238074.50,403,$91.75
2025-07-23,22:04:00,23391.75,SELL,1,0.02h,Stop Loss,$-6.00,$85.75,$238068.50,403,$85.75
2025-07-23,22:28:00,23397.0,BUY,1,0.02h,Stop Loss,$-6.00,$79.75,$238062.50,403,$79.75
2025-07-23,22:32:00,23393.0,SELL,1,0.02h,Break Even,$0.25,$80.00,$238062.75,403,$80.00
2025-07-23,22:33:00,23396.25,BUY,1,0.02h,Break Even,$0.25,$80.25,$238063.00,403,$80.25
2025-07-23,22:37:00,23393.25,SELL,1,0.02h,Stop Loss,$5.25,$85.50,$238068.25,403,$85.50
Final P&L Day: 85.50,,,,,,,,,,,
2025-07-24,12:09:00,23391.25,BUY,1,0.02h,Stop Loss,$-6.00,$-6.00,$238062.25,404,$-6.00
2025-07-24,12:17:00,23382.75,SELL,1,0.02h,Break Even,$0.25,$-5.75,$238062.50,404,$-5.75
2025-07-24,13:00:00,23360.5,BUY,1,0.02h,Stop Loss,$-6.00,$-11.75,$238056.50,404,$-11.75
2025-07-24,13:12:00,23349.25,SELL,1,0.02h,Break Even,$0.25,$-11.50,$238056.75,404,$-11.50
2025-07-24,13:14:00,23357.75,BUY,1,0.02h,Break Even,$0.25,$-11.25,$238057.00,404,$-11.25
2025-07-24,13:17:00,23349.5,SELL,1,0.02h,Break Even,$0.25,$-11.00,$238057.25,404,$-11.00
2025-07-24,13:18:00,23357.75,BUY,1,0.02h,Stop Loss,$-6.00,$-17.00,$238051.25,404,$-17.00
2025-07-24,13:37:00,23352.0,SELL,1,0.02h,Stop Loss,$15.25,$-1.75,$238066.50,404,$-1.75
2025-07-24,13:47:00,23373.75,BUY,1,0.02h,Stop Loss,$110.25,$108.50,$238176.75,404,$108.50
2025-07-24,13:57:00,23362.25,SELL,1,0.02h,Break Even,$0.25,$108.75,$238177.00,404,$108.75
2025-07-24,13:58:00,23369.25,BUY,1,0.02h,Break Even,$0.25,$109.00,$238177.25,404,$109.00
2025-07-24,13:59:00,23359.5,SELL,1,0.02h,Break Even,$0.25,$109.25,$238177.50,404,$109.25
2025-07-24,14:32:00,23340.75,BUY,1,0.02h,Break Even,$0.25,$109.50,$238177.75,404,$109.50
2025-07-24,15:33:00,23375.75,SELL,1,0.02h,Stop Loss,$9.00,$118.50,$238186.75,404,$118.50
2025-07-24,15:47:00,23382.0,BUY,1,0.02h,Break Even,$0.25,$118.75,$238187.00,404,$118.75
2025-07-24,15:48:00,23376.5,SELL,1,0.02h,Stop Loss,$-6.00,$112.75,$238181.00,404,$112.75
2025-07-24,15:49:00,23387.25,BUY,1,0.02h,Stop Loss,$-6.00,$106.75,$238175.00,404,$106.75
2025-07-24,16:02:00,23369.75,SELL,1,0.02h,Break Even,$0.25,$107.00,$238175.25,404,$107.00
2025-07-24,16:42:00,23368.25,BUY,1,0.02h,Stop Loss,$-6.00,$101.00,$238169.25,404,$101.00
2025-07-24,17:36:00,23397.25,SELL,1,0.02h,Break Even,$0.25,$101.25,$238169.50,404,$101.25
2025-07-24,17:39:00,23398.25,BUY,1,0.02h,Stop Loss,$-6.00,$95.25,$238163.50,404,$95.25
2025-07-24,17:40:00,23397.0,SELL,1,0.02h,Stop Loss,$22.75,$118.00,$238186.25,404,$118.00
2025-07-24,17:53:00,23399.5,BUY,1,0.02h,Break Even,$0.25,$118.25,$238186.50,404,$118.25
2025-07-24,17:57:00,23390.0,SELL,1,0.02h,Stop Loss,$22.75,$141.00,$238209.25,404,$141.00
2025-07-24,18:05:00,23398.25,BUY,1,0.02h,Stop Loss,$-6.00,$135.00,$238203.25,404,$135.00
2025-07-24,18:40:00,23408.5,SELL,1,0.02h,Break Even,$0.25,$135.25,$238203.50,404,$135.25
2025-07-24,19:02:00,23404.0,BUY,1,0.02h,Break Even,$0.25,$135.50,$238203.75,404,$135.50
2025-07-24,19:41:00,23405.0,SELL,1,0.02h,Break Even,$0.25,$135.75,$238204.00,404,$135.75
2025-07-24,20:17:00,23390.25,BUY,1,0.02h,Stop Loss,$-6.00,$129.75,$238198.00,404,$129.75
2025-07-24,20:28:00,23386.75,SELL,1,0.02h,Break Even,$0.25,$130.00,$238198.25,404,$130.00
2025-07-24,20:29:00,23390.5,BUY,1,0.02h,Break Even,$0.25,$130.25,$238198.50,404,$130.25
2025-07-24,20:58:00,23393.25,SELL,1,0.02h,Stop Loss,$-6.00,$124.25,$238192.50,404,$124.25
2025-07-24,22:06:00,23398.75,BUY,1,0.02h,Stop Loss,$-6.00,$118.25,$238186.50,404,$118.25
2025-07-24,22:35:00,23403.0,SELL,1,0.02h,Stop Loss,$-6.00,$112.25,$238180.50,404,$112.25
2025-07-24,22:37:00,23406.75,BUY,1,0.03h,Break Even,$0.25,$112.50,$238180.75,404,$112.50
2025-07-24,22:51:00,23404.25,SELL,1,0.02h,Break Even,$0.25,$112.75,$238181.00,404,$112.75
Final P&L Day: 112.75,,,,,,,,,,,
2025-07-25,12:25:00,23379.0,BUY,1,0.02h,Break Even,$0.25,$0.25,$238181.25,405,$0.25
2025-07-25,12:43:00,23371.0,SELL,1,0.02h,Stop Loss,$-6.00,$-5.75,$238175.25,405,$-5.75
2025-07-25,13:21:00,23369.5,BUY,1,0.02h,Break Even,$0.25,$-5.50,$238175.50,405,$-5.50
2025-07-25,13:30:00,23360.25,SELL,1,0.02h,Stop Loss,$62.75,$57.25,$238238.25,405,$57.25
2025-07-25,13:36:00,23374.75,BUY,1,0.02h,Break Even,$0.25,$57.50,$238238.50,405,$57.50
2025-07-25,13:37:00,23362.25,SELL,1,0.02h,Stop Loss,$99.00,$156.50,$238337.50,405,$156.50
2025-07-25,13:47:00,23368.75,BUY,1,0.02h,Stop Loss,$29.00,$185.50,$238366.50,405,$185.50
2025-07-25,14:56:00,23401.0,SELL,1,0.02h,Stop Loss,$37.75,$223.25,$238404.25,405,$223.25
2025-07-25,15:13:00,23407.0,BUY,1,0.02h,Break Even,$0.25,$223.50,$238404.50,405,$223.50
2025-07-25,15:40:00,23408.25,SELL,1,0.02h,Stop Loss,$-6.00,$217.50,$238398.50,405,$217.50
2025-07-25,15:50:00,23415.75,BUY,1,0.02h,Stop Loss,$25.25,$242.75,$238423.75,405,$242.75
2025-07-25,16:47:00,23450.25,SELL,1,0.02h,Stop Loss,$-6.00,$236.75,$238417.75,405,$236.75
2025-07-25,16:55:00,23458.75,BUY,1,0.02h,Stop Loss,$-6.00,$230.75,$238411.75,405,$230.75
2025-07-25,17:00:00,23450.25,SELL,1,0.02h,Stop Loss,$6.50,$237.25,$238418.25,405,$237.25
2025-07-25,17:28:00,23449.0,BUY,1,0.02h,Stop Loss,$6.50,$243.75,$238424.75,405,$243.75
2025-07-25,17:44:00,23444.75,SELL,1,0.02h,Stop Loss,$-6.00,$237.75,$238418.75,405,$237.75
2025-07-25,18:15:00,23445.25,BUY,1,0.02h,Stop Loss,$11.50,$249.25,$238430.25,405,$249.25
2025-07-25,18:53:00,23447.0,SELL,1,0.02h,Stop Loss,$-6.00,$243.25,$238424.25,405,$243.25
2025-07-25,19:15:00,23447.25,BUY,1,0.02h,Stop Loss,$5.25,$248.50,$238429.50,405,$248.50
2025-07-25,19:27:00,23444.25,SELL,1,0.02h,Break Even,$0.25,$248.75,$238429.75,405,$248.75
2025-07-25,19:39:00,23449.0,BUY,1,0.02h,Stop Loss,$-6.00,$242.75,$238423.75,405,$242.75
2025-07-25,19:42:00,23443.75,SELL,1,0.02h,Break Even,$0.25,$243.00,$238424.00,405,$243.00
2025-07-25,20:15:00,23434.5,BUY,1,0.02h,Break Even,$0.25,$243.25,$238424.25,405,$243.25
Final P&L Day: 243.25,,,,,,,,,,,
2025-07-28,13:04:00,23502.5,SELL,1,0.02h,Stop Loss,$15.25,$15.25,$238439.50,406,$15.25
2025-07-28,13:35:00,23494.0,BUY,1,0.02h,Stop Loss,$14.00,$29.25,$238453.50,406,$29.25
2025-07-28,14:21:00,23507.5,SELL,1,0.02h,Stop Loss,$190.25,$219.50,$238643.75,406,$219.50
2025-07-28,14:42:00,23517.0,BUY,1,0.02h,Break Even,$0.25,$219.75,$238644.00,406,$219.75
2025-07-28,14:47:00,23500.5,SELL,1,0.02h,Break Even,$0.25,$220.00,$238644.25,406,$220.00
2025-07-28,15:33:00,23482.0,BUY,1,0.02h,Break Even,$0.25,$220.25,$238644.50,406,$220.25
2025-07-28,16:05:00,23488.0,SELL,1,0.02h,Break Even,$0.25,$220.50,$238644.75,406,$220.50
2025-07-28,16:18:00,23498.75,BUY,1,0.02h,Stop Loss,$4.00,$224.50,$238648.75,406,$224.50
2025-07-28,16:32:00,23485.25,SELL,1,0.02h,Break Even,$0.25,$224.75,$238649.00,406,$224.75
2025-07-28,17:15:00,23484.75,BUY,1,0.02h,Stop Loss,$-6.00,$218.75,$238643.00,406,$218.75
2025-07-28,17:16:00,23478.25,SELL,1,0.02h,Stop Loss,$-6.00,$212.75,$238637.00,406,$212.75
2025-07-28,17:33:00,23481.5,BUY,1,0.02h,Break Even,$0.25,$213.00,$238637.25,406,$213.00
2025-07-28,17:52:00,23469.5,SELL,1,0.02h,Stop Loss,$-6.00,$207.00,$238631.25,406,$207.00
2025-07-28,18:18:00,23469.5,BUY,1,0.02h,Break Even,$0.25,$207.25,$238631.50,406,$207.25
2025-07-28,18:22:00,23455.75,SELL,1,0.02h,Break Even,$0.25,$207.50,$238631.75,406,$207.50
2025-07-28,18:48:00,23459.25,BUY,1,0.02h,Break Even,$0.25,$207.75,$238632.00,406,$207.75
2025-07-28,19:06:00,23454.75,SELL,1,0.02h,Break Even,$0.25,$208.00,$238632.25,406,$208.00
2025-07-28,19:22:00,23463.0,BUY,1,0.02h,Break Even,$0.25,$208.25,$238632.50,406,$208.25
2025-07-28,22:45:00,23521.5,SELL,1,0.02h,Break Even,$0.25,$208.50,$238632.75,406,$208.50
2025-07-28,22:47:00,23523.25,BUY,1,0.02h,Break Even,$0.25,$208.75,$238633.00,406,$208.75
Final P&L Day: 208.75,,,,,,,,,,,
2025-07-29,12:43:00,23588.25,SELL,1,0.02h,Break Even,$0.25,$0.25,$238633.25,407,$0.25
2025-07-29,13:20:00,23587.0,BUY,1,0.02h,Stop Loss,$-6.00,$-5.75,$238627.25,407,$-5.75
2025-07-29,13:49:00,23606.0,SELL,1,0.02h,Stop Loss,$136.50,$130.75,$238763.75,407,$130.75
2025-07-29,14:41:00,23573.75,BUY,1,0.02h,Break Even,$0.25,$131.00,$238764.00,407,$131.00
2025-07-29,14:45:00,23554.25,SELL,1,0.02h,Break Even,$0.25,$131.25,$238764.25,407,$131.25
2025-07-29,15:50:00,23498.0,BUY,1,0.02h,Stop Loss,$30.25,$161.50,$238794.50,407,$161.50
2025-07-29,16:10:00,23489.25,SELL,1,0.02h,Break Even,$0.25,$161.75,$238794.75,407,$161.75
2025-07-29,16:48:00,23482.25,BUY,1,0.02h,Break Even,$0.25,$162.00,$238795.00,407,$162.00
2025-07-29,17:33:00,23506.0,SELL,1,0.02h,Stop Loss,$7.75,$169.75,$238802.75,407,$169.75
2025-07-29,17:59:00,23494.5,BUY,1,0.02h,Stop Loss,$-6.00,$163.75,$238796.75,407,$163.75
2025-07-29,18:21:00,23481.5,SELL,1,0.02h,Stop Loss,$-6.00,$157.75,$238790.75,407,$157.75
2025-07-29,18:34:00,23491.0,BUY,1,0.02h,Break Even,$0.25,$158.00,$238791.00,407,$158.00
2025-07-29,18:50:00,23486.25,SELL,1,0.02h,Break Even,$0.25,$158.25,$238791.25,407,$158.25
2025-07-29,19:54:00,23460.25,BUY,1,0.02h,Break Even,$0.25,$158.50,$238791.50,407,$158.50
2025-07-29,19:57:00,23439.0,SELL,1,0.02h,Stop Loss,$6.50,$165.00,$238798.00,407,$165.00
2025-07-29,20:02:00,23457.5,BUY,1,0.02h,Break Even,$0.25,$165.25,$238798.25,407,$165.25
2025-07-29,20:24:00,23447.75,SELL,1,0.02h,Stop Loss,$-6.00,$159.25,$238792.25,407,$159.25
2025-07-29,20:29:00,23455.25,BUY,1,0.02h,Stop Loss,$-6.00,$153.25,$238786.25,407,$153.25
2025-07-29,20:44:00,23450.5,SELL,1,0.02h,Break Even,$0.25,$153.50,$238786.50,407,$153.50
2025-07-29,22:01:00,23460.0,BUY,1,0.02h,Stop Loss,$12.75,$166.25,$238799.25,407,$166.25
2025-07-29,22:29:00,23460.0,SELL,1,0.02h,Break Even,$0.25,$166.50,$238799.50,407,$166.50
2025-07-29,22:31:00,23465.75,BUY,1,0.02h,Stop Loss,$-6.00,$160.50,$238793.50,407,$160.50
2025-07-29,22:38:00,23460.25,SELL,1,0.02h,Stop Loss,$-6.00,$154.50,$238787.50,407,$154.50
2025-07-29,22:40:00,23462.5,BUY,1,0.02h,Stop Loss,$-6.00,$148.50,$238781.50,407,$148.50
Final P&L Day: 148.50,,,,,,,,,,,
2025-07-30,12:21:00,23480.5,SELL,1,0.02h,Stop Loss,$6.50,$6.50,$238788.00,408,$6.50
2025-07-30,12:27:00,23487.75,BUY,1,0.02h,Stop Loss,$-6.00,$0.50,$238782.00,408,$0.50
2025-07-30,12:28:00,23483.0,SELL,1,0.02h,Stop Loss,$-6.00,$-5.50,$238776.00,408,$-5.50
2025-07-30,12:31:00,23487.25,BUY,1,0.02h,Stop Loss,$21.50,$16.00,$238797.50,408,$16.00
2025-07-30,12:32:00,23483.25,SELL,1,0.02h,Stop Loss,$7.75,$23.75,$238805.25,408,$23.75
2025-07-30,12:39:00,23496.25,BUY,1,0.02h,Break Even,$0.25,$24.00,$238805.50,408,$24.00
2025-07-30,13:01:00,23485.5,SELL,1,0.02h,Break Even,$0.25,$24.25,$238805.75,408,$24.25
2025-07-30,13:20:00,23486.75,BUY,1,0.02h,Break Even,$0.25,$24.50,$238806.00,408,$24.50
2025-07-30,13:24:00,23483.5,SELL,1,0.02h,Stop Loss,$-6.00,$18.50,$238800.00,408,$18.50
2025-07-30,13:37:00,23496.0,BUY,1,0.02h,Stop Loss,$36.50,$55.00,$238836.50,408,$55.00
2025-07-30,13:53:00,23486.5,SELL,1,0.02h,Stop Loss,$11.50,$66.50,$238848.00,408,$66.50
2025-07-30,14:09:00,23495.25,BUY,1,0.02h,Stop Loss,$-6.00,$60.50,$238842.00,408,$60.50
2025-07-30,14:11:00,23477.5,SELL,1,0.02h,Stop Loss,$30.25,$90.75,$238872.25,408,$90.75
2025-07-30,14:19:00,23490.0,BUY,1,0.02h,Stop Loss,$39.00,$129.75,$238911.25,408,$129.75
2025-07-30,15:03:00,23517.25,SELL,1,0.02h,Stop Loss,$47.75,$177.50,$238959.00,408,$177.50
2025-07-30,15:42:00,23501.0,BUY,1,0.02h,Stop Loss,$-6.00,$171.50,$238953.00,408,$171.50
2025-07-30,16:37:00,23530.0,SELL,1,0.02h,Break Even,$0.25,$171.75,$238953.25,408,$171.75
2025-07-30,16:53:00,23535.75,BUY,1,0.02h,Stop Loss,$-6.00,$165.75,$238947.25,408,$165.75
2025-07-30,17:11:00,23528.0,SELL,1,0.02h,Stop Loss,$-6.00,$159.75,$238941.25,408,$159.75
2025-07-30,17:17:00,23535.25,BUY,1,0.02h,Stop Loss,$-6.00,$153.75,$238935.25,408,$153.75
2025-07-30,17:24:00,23526.0,SELL,1,0.02h,Stop Loss,$-6.00,$147.75,$238929.25,408,$147.75
2025-07-30,17:36:00,23533.75,BUY,1,0.02h,Stop Loss,$-6.00,$141.75,$238923.25,408,$141.75
2025-07-30,17:52:00,23529.5,SELL,1,0.02h,Break Even,$0.25,$142.00,$238923.50,408,$142.00
2025-07-30,17:57:00,23543.5,BUY,1,0.02h,Break Even,$0.25,$142.25,$238923.75,408,$142.25
2025-07-30,18:03:00,23522.25,SELL,1,0.02h,Break Even,$0.25,$142.50,$238924.00,408,$142.50
2025-07-30,18:08:00,23544.75,BUY,1,0.02h,Break Even,$0.25,$142.75,$238924.25,408,$142.75
2025-07-30,18:20:00,23537.0,SELL,1,0.02h,Break Even,$0.25,$143.00,$238924.50,408,$143.00
2025-07-30,18:24:00,23545.5,BUY,1,0.02h,Break Even,$0.25,$143.25,$238924.75,408,$143.25
2025-07-30,18:41:00,23530.25,SELL,1,0.02h,Stop Loss,$66.50,$209.75,$238991.25,408,$209.75
2025-07-30,19:47:00,23427.75,BUY,1,0.02h,Break Even,$0.25,$210.00,$238991.50,408,$210.00
Final P&L Day: 210.00,,,,,,,,,,,
2025-07-31,13:11:00,23795.0,SELL,1,0.02h,Stop Loss,$-6.00,$-6.00,$238985.50,409,$-6.00
2025-07-31,13:57:00,23692.0,BUY,1,0.02h,Stop Loss,$26.50,$20.50,$239012.00,409,$20.50
2025-07-31,14:13:00,23658.75,SELL,1,0.02h,Break Even,$0.25,$20.75,$239012.25,409,$20.75
2025-07-31,15:32:00,23547.75,BUY,1,0.02h,Stop Loss,$35.25,$56.00,$239047.50,409,$56.00
2025-07-31,16:39:00,23588.25,SELL,1,0.02h,Break Even,$0.25,$56.25,$239047.75,409,$56.25
2025-07-31,18:26:00,23390.0,BUY,1,0.02h,Stop Loss,$27.75,$84.00,$239075.50,409,$84.00
2025-07-31,18:58:00,23415.75,SELL,1,0.02h,Stop Loss,$12.75,$96.75,$239088.25,409,$96.75
2025-07-31,19:07:00,23441.0,BUY,1,0.02h,Stop Loss,$-6.00,$90.75,$239082.25,409,$90.75
2025-07-31,19:08:00,23429.75,SELL,1,0.02h,Stop Loss,$27.75,$118.50,$239110.00,409,$118.50
2025-07-31,19:44:00,23402.0,BUY,1,0.02h,Stop Loss,$27.75,$146.25,$239137.75,409,$146.25
2025-07-31,19:48:00,23386.25,SELL,1,0.02h,Stop Loss,$100.25,$246.50,$239238.00,409,$246.50
2025-07-31,20:32:00,23349.5,BUY,1,0.02h,Stop Loss,$25.25,$271.75,$239263.25,409,$271.75
2025-07-31,20:56:00,23334.75,SELL,1,0.02h,Stop Loss,$21.50,$293.25,$239284.75,409,$293.25
2025-07-31,22:09:00,23344.25,BUY,1,0.02h,Stop Loss,$-6.00,$287.25,$239278.75,409,$287.25
2025-07-31,22:11:00,23329.0,SELL,1,0.02h,Stop Loss,$22.75,$310.00,$239301.50,409,$310.00
Final P&L Day: 310.00,,,,,,,,,,,
2025-08-01,12:42:00,23159.75,BUY,1,0.02h,Stop Loss,$21.50,$21.50,$239323.00,410,$21.50
2025-08-01,12:51:00,23103.0,SELL,1,0.02h,Stop Loss,$44.00,$65.50,$239367.00,410,$65.50
2025-08-01,14:13:00,22919.0,BUY,1,0.02h,Stop Loss,$27.75,$93.25,$239394.75,410,$93.25
2025-08-01,14:50:00,22955.25,SELL,1,0.02h,Stop Loss,$51.50,$144.75,$239446.25,410,$144.75
2025-08-01,15:39:00,22940.0,BUY,1,0.02h,Stop Loss,$67.75,$212.50,$239514.00,410,$212.50
2025-08-01,16:31:00,23004.25,SELL,1,0.02h,Stop Loss,$20.25,$232.75,$239534.25,410,$232.75
2025-08-01,17:51:00,22871.5,BUY,1,0.02h,Break Even,$0.25,$233.00,$239534.50,410,$233.00
2025-08-01,17:56:00,22833.0,SELL,1,0.02h,Stop Loss,$14.00,$247.00,$239548.50,410,$247.00
2025-08-01,18:24:00,22848.0,BUY,1,0.02h,Stop Loss,$46.50,$293.50,$239595.00,410,$293.50
2025-08-01,18:53:00,22864.75,SELL,1,0.02h,Stop Loss,$40.25,$333.75,$239635.25,410,$333.75
2025-08-01,19:18:00,22879.25,BUY,1,0.02h,Stop Loss,$57.75,$391.50,$239693.00,410,$391.50
2025-08-01,19:23:00,22870.0,SELL,1,0.02h,Break Even,$0.25,$391.75,$239693.25,410,$391.75
2025-08-01,19:24:00,22894.0,BUY,1,0.02h,Stop Loss,$-6.00,$385.75,$239687.25,410,$385.75
2025-08-01,19:31:00,22874.5,SELL,1,0.02h,Stop Loss,$17.75,$403.50,$239705.00,410,$403.50
2025-08-01,19:34:00,22885.25,BUY,1,0.02h,Break Even,$0.25,$403.75,$239705.25,410,$403.75
2025-08-01,19:39:00,22871.5,SELL,1,0.02h,Stop Loss,$6.50,$410.25,$239711.75,410,$410.25
2025-08-01,19:42:00,22887.25,BUY,1,0.02h,Break Even,$0.25,$410.50,$239712.00,410,$410.50
2025-08-01,20:01:00,22883.75,SELL,1,0.02h,Stop Loss,$9.00,$419.50,$239721.00,410,$419.50
2025-08-01,20:17:00,22891.5,BUY,1,0.02h,Break Even,$0.25,$419.75,$239721.25,410,$419.75
2025-08-01,20:18:00,22884.5,SELL,1,0.02h,Stop Loss,$20.25,$440.00,$239741.50,410,$440.00
2025-08-01,20:23:00,22889.25,BUY,1,0.02h,Stop Loss,$-6.00,$434.00,$239735.50,410,$434.00
2025-08-01,20:25:00,22884.75,SELL,1,0.02h,Break Even,$0.25,$434.25,$239735.75,410,$434.25
Final P&L Day: 434.25,,,,,,,,,,,
2025-08-04,12:00:00,23043.75,BUY,1,0.02h,Stop Loss,$26.50,$26.50,$239762.25,411,$26.50
2025-08-04,14:32:00,23230.25,SELL,1,0.02h,Stop Loss,$-6.00,$20.50,$239756.25,411,$20.50
2025-08-04,14:36:00,23250.0,BUY,1,0.02h,Stop Loss,$4.00,$24.50,$239760.25,411,$24.50
2025-08-04,14:42:00,23225.75,SELL,1,0.02h,Stop Loss,$-6.00,$18.50,$239754.25,411,$18.50
2025-08-04,15:27:00,23219.0,BUY,1,0.02h,Stop Loss,$5.25,$23.75,$239759.50,411,$23.75
2025-08-04,15:43:00,23201.5,SELL,1,0.02h,Break Even,$0.25,$24.00,$239759.75,411,$24.00
2025-08-04,15:50:00,23220.0,BUY,1,0.02h,Stop Loss,$40.25,$64.25,$239800.00,411,$64.25
2025-08-04,16:41:00,23259.5,SELL,1,0.02h,Stop Loss,$-6.00,$58.25,$239794.00,411,$58.25
2025-08-04,16:48:00,23270.0,BUY,1,0.02h,Break Even,$0.25,$58.50,$239794.25,411,$58.50
2025-08-04,17:38:00,23273.5,SELL,1,0.02h,Break Even,$0.25,$58.75,$239794.50,411,$58.75
2025-08-04,18:01:00,23274.0,BUY,1,0.02h,Stop Loss,$7.75,$66.50,$239802.25,411,$66.50
2025-08-04,18:15:00,23263.5,SELL,1,0.02h,Stop Loss,$-6.00,$60.50,$239796.25,411,$60.50
2025-08-04,18:34:00,23272.25,BUY,1,0.02h,Stop Loss,$-6.00,$54.50,$239790.25,411,$54.50
2025-08-04,18:41:00,23262.75,SELL,1,0.02h,Break Even,$0.25,$54.75,$239790.50,411,$54.75
2025-08-04,19:02:00,23266.25,BUY,1,0.02h,Stop Loss,$-6.00,$48.75,$239784.50,411,$48.75
2025-08-04,19:04:00,23261.5,SELL,1,0.02h,Break Even,$0.25,$49.00,$239784.75,411,$49.00
2025-08-04,19:10:00,23264.75,BUY,1,0.02h,Break Even,$0.25,$49.25,$239785.00,411,$49.25
2025-08-04,19:30:00,23266.5,SELL,1,0.02h,Break Even,$0.25,$49.50,$239785.25,411,$49.50
2025-08-04,19:45:00,23268.75,BUY,1,0.02h,Break Even,$0.25,$49.75,$239785.50,411,$49.75
2025-08-04,22:03:00,23340.75,SELL,1,0.02h,Break Even,$0.25,$50.00,$239785.75,411,$50.00
2025-08-04,22:53:00,23328.75,BUY,1,0.02h,Stop Loss,$-6.00,$44.00,$239779.75,411,$44.00
Final P&L Day: 44.00,,,,,,,,,,,
2025-08-05,12:24:00,23364.25,SELL,1,0.02h,Stop Loss,$5.25,$5.25,$239785.00,412,$5.25
2025-08-05,12:44:00,23369.75,BUY,1,0.02h,Stop Loss,$12.75,$18.00,$239797.75,412,$18.00
2025-08-05,12:53:00,23361.0,SELL,1,0.02h,Break Even,$0.25,$18.25,$239798.00,412,$18.25
2025-08-05,13:20:00,23365.0,BUY,1,0.02h,Stop Loss,$-6.00,$12.25,$239792.00,412,$12.25
2025-08-05,13:22:00,23354.5,SELL,1,0.02h,Break Even,$0.25,$12.50,$239792.25,412,$12.50
2025-08-05,13:41:00,23356.0,BUY,1,0.02h,Stop Loss,$7.75,$20.25,$239800.00,412,$20.25
2025-08-05,14:02:00,23337.0,SELL,1,0.02h,Stop Loss,$10.25,$30.50,$239810.25,412,$30.50
2025-08-05,15:07:00,23200.5,BUY,1,0.02h,Stop Loss,$51.50,$82.00,$239861.75,412,$82.00
2025-08-05,15:12:00,23177.5,SELL,1,0.02h,Break Even,$0.25,$82.25,$239862.00,412,$82.25
2025-08-05,15:14:00,23206.5,BUY,1,0.02h,Stop Loss,$46.50,$128.75,$239908.50,412,$128.75
2025-08-05,15:22:00,23186.0,SELL,1,0.02h,Stop Loss,$11.50,$140.25,$239920.00,412,$140.25
2025-08-05,16:00:00,23156.25,BUY,1,0.02h,Stop Loss,$40.25,$180.50,$239960.25,412,$180.50
2025-08-05,16:41:00,23168.5,SELL,1,0.02h,Stop Loss,$21.50,$202.00,$239981.75,412,$202.00
2025-08-05,16:55:00,23189.5,BUY,1,0.02h,Stop Loss,$9.00,$211.00,$239990.75,412,$211.00
2025-08-05,17:06:00,23174.25,SELL,1,0.02h,Stop Loss,$-6.00,$205.00,$239984.75,412,$205.00
2025-08-05,17:07:00,23182.75,BUY,1,0.02h,Stop Loss,$16.50,$221.50,$240001.25,412,$221.50
2025-08-05,18:13:00,23228.5,SELL,1,0.02h,Stop Loss,$15.25,$236.75,$240016.50,412,$236.75
2025-08-05,19:13:00,23157.0,BUY,1,0.02h,Break Even,$0.25,$237.00,$240016.75,412,$237.00
2025-08-05,19:38:00,23153.75,SELL,1,0.02h,Stop Loss,$12.75,$249.75,$240029.50,412,$249.75
2025-08-05,20:12:00,23148.5,BUY,1,0.02h,Stop Loss,$-6.00,$243.75,$240023.50,412,$243.75
2025-08-05,20:24:00,23127.0,SELL,1,0.02h,Stop Loss,$91.50,$335.25,$240115.00,412,$335.25
2025-08-05,22:32:00,23076.0,BUY,1,0.02h,Break Even,$0.25,$335.50,$240115.25,412,$335.50
Final P&L Day: 335.50,,,,,,,,,,,
2025-08-06,13:24:00,23170.0,SELL,1,0.02h,Break Even,$0.25,$0.25,$240115.50,413,$0.25
2025-08-06,13:33:00,23211.5,BUY,1,0.02h,Stop Loss,$24.00,$24.25,$240139.50,413,$24.25
2025-08-06,13:40:00,23159.5,SELL,1,0.02h,Stop Loss,$36.50,$60.75,$240176.00,413,$60.75
2025-08-06,13:46:00,23194.0,BUY,1,0.02h,Stop Loss,$36.50,$97.25,$240212.50,413,$97.25
2025-08-06,14:17:00,23219.75,SELL,1,0.02h,Stop Loss,$57.75,$155.00,$240270.25,413,$155.00
2025-08-06,14:37:00,23246.0,BUY,1,0.02h,Break Even,$0.25,$155.25,$240270.50,413,$155.25
2025-08-06,16:28:00,23360.75,SELL,1,0.02h,Break Even,$0.25,$155.50,$240270.75,413,$155.50
2025-08-06,16:37:00,23389.25,BUY,1,0.02h,Stop Loss,$-6.00,$149.50,$240264.75,413,$149.50
2025-08-06,16:43:00,23362.0,SELL,1,0.02h,Stop Loss,$41.50,$191.00,$240306.25,413,$191.00
2025-08-06,16:52:00,23378.5,BUY,1,0.02h,Stop Loss,$5.25,$196.25,$240311.50,413,$196.25
2025-08-06,17:08:00,23365.75,SELL,1,0.02h,Stop Loss,$-6.00,$190.25,$240305.50,413,$190.25
2025-08-06,17:12:00,23375.0,BUY,1,0.02h,Stop Loss,$-6.00,$184.25,$240299.50,413,$184.25
2025-08-06,17:13:00,23366.5,SELL,1,0.02h,Stop Loss,$6.50,$190.75,$240306.00,413,$190.75
2025-08-06,17:23:00,23373.0,BUY,1,0.02h,Stop Loss,$4.00,$194.75,$240310.00,413,$194.75
2025-08-06,17:51:00,23371.0,SELL,1,0.02h,Stop Loss,$17.75,$212.50,$240327.75,413,$212.50
2025-08-06,18:03:00,23395.25,BUY,1,0.02h,Stop Loss,$-6.00,$206.50,$240321.75,413,$206.50
2025-08-06,18:59:00,23413.0,SELL,1,0.02h,Break Even,$0.25,$206.75,$240322.00,413,$206.75
2025-08-06,19:05:00,23429.0,BUY,1,0.02h,Stop Loss,$-6.00,$200.75,$240316.00,413,$200.75
2025-08-06,19:07:00,23420.75,SELL,1,0.02h,Break Even,$0.25,$201.00,$240316.25,413,$201.00
2025-08-06,19:19:00,23427.25,BUY,1,0.02h,Stop Loss,$12.75,$213.75,$240329.00,413,$213.75
2025-08-06,19:43:00,23424.5,SELL,1,0.02h,Break Even,$0.25,$214.00,$240329.25,413,$214.00
2025-08-06,20:28:00,23415.75,BUY,1,0.02h,Break Even,$0.25,$214.25,$240329.50,413,$214.25
2025-08-06,20:37:00,23408.75,SELL,1,0.02h,Break Even,$0.25,$214.50,$240329.75,413,$214.50
2025-08-06,20:50:00,23412.75,BUY,1,0.02h,Stop Loss,$-6.00,$208.50,$240323.75,413,$208.50
2025-08-06,20:51:00,23407.0,SELL,1,0.02h,Break Even,$0.25,$208.75,$240324.00,413,$208.75
2025-08-06,21:00:00,23413.0,BUY,1,1.02h,Stop Loss,$104.00,$312.75,$240428.00,413,$312.75
2025-08-06,22:01:00,23403.25,SELL,1,0.02h,Stop Loss,$50.25,$363.00,$240478.25,413,$363.00
2025-08-06,22:12:00,23418.5,BUY,1,0.02h,Break Even,$0.25,$363.25,$240478.50,413,$363.25
Final P&L Day: 363.25,,,,,,,,,,,
2025-08-07,13:01:00,23598.75,SELL,1,0.02h,Stop Loss,$-6.00,$-6.00,$240472.50,414,$-6.00
2025-08-07,13:03:00,23604.25,BUY,1,0.02h,Stop Loss,$15.25,$9.25,$240487.75,414,$9.25
2025-08-07,13:27:00,23604.0,SELL,1,0.02h,Stop Loss,$14.00,$23.25,$240501.75,414,$23.25
2025-08-07,13:34:00,23624.75,BUY,1,0.02h,Stop Loss,$16.50,$39.75,$240518.25,414,$39.75
2025-08-07,13:46:00,23580.75,SELL,1,0.02h,Stop Loss,$40.25,$80.00,$240558.50,414,$80.00
2025-08-07,13:54:00,23615.5,BUY,1,0.02h,Stop Loss,$24.00,$104.00,$240582.50,414,$104.00
2025-08-07,14:11:00,23592.75,SELL,1,0.02h,Break Even,$0.25,$104.25,$240582.75,414,$104.25
2025-08-07,14:46:00,23589.75,BUY,1,0.02h,Stop Loss,$-6.00,$98.25,$240576.75,414,$98.25
2025-08-07,14:47:00,23560.0,SELL,1,0.02h,Stop Loss,$22.75,$121.00,$240599.50,414,$121.00
2025-08-07,15:21:00,23555.25,BUY,1,0.02h,Break Even,$0.25,$121.25,$240599.75,414,$121.25
2025-08-07,15:27:00,23512.75,SELL,1,0.02h,Stop Loss,$42.75,$164.00,$240642.50,414,$164.00
2025-08-07,15:57:00,23517.5,BUY,1,0.02h,Stop Loss,$9.00,$173.00,$240651.50,414,$173.00
2025-08-07,16:00:00,23497.75,SELL,1,0.02h,Break Even,$0.25,$173.25,$240651.75,414,$173.25
2025-08-07,16:17:00,23513.25,BUY,1,0.02h,Stop Loss,$-6.00,$167.25,$240645.75,414,$167.25
2025-08-07,16:37:00,23495.5,SELL,1,0.02h,Stop Loss,$75.25,$242.50,$240721.00,414,$242.50
2025-08-07,16:56:00,23477.5,BUY,1,0.02h,Stop Loss,$19.00,$261.50,$240740.00,414,$261.50
2025-08-07,17:05:00,23446.5,SELL,1,0.02h,Stop Loss,$29.00,$290.50,$240769.00,414,$290.50
2025-08-07,17:49:00,23422.0,BUY,1,0.02h,Break Even,$0.25,$290.75,$240769.25,414,$290.75
2025-08-07,17:51:00,23404.75,SELL,1,0.02h,Break Even,$0.25,$291.00,$240769.50,414,$291.00
2025-08-07,17:54:00,23427.25,BUY,1,0.02h,Stop Loss,$-6.00,$285.00,$240763.50,414,$285.00
2025-08-07,18:03:00,23405.25,SELL,1,0.02h,Stop Loss,$-6.00,$279.00,$240757.50,414,$279.00
2025-08-07,18:04:00,23425.0,BUY,1,0.02h,Stop Loss,$4.00,$283.00,$240761.50,414,$283.00
2025-08-07,18:05:00,23413.25,SELL,1,0.02h,Stop Loss,$7.75,$290.75,$240769.25,414,$290.75
2025-08-07,18:37:00,23367.25,BUY,1,0.02h,Stop Loss,$24.00,$314.75,$240793.25,414,$314.75
2025-08-07,18:45:00,23351.0,SELL,1,0.02h,Break Even,$0.25,$315.00,$240793.50,414,$315.00
2025-08-07,18:48:00,23378.0,BUY,1,0.02h,Stop Loss,$-6.00,$309.00,$240787.50,414,$309.00
2025-08-07,19:21:00,23395.25,SELL,1,0.02h,Break Even,$0.25,$309.25,$240787.75,414,$309.25
2025-08-07,19:22:00,23397.5,BUY,1,0.02h,Stop Loss,$6.50,$315.75,$240794.25,414,$315.75
2025-08-07,19:23:00,23394.25,SELL,1,0.02h,Stop Loss,$15.25,$331.00,$240809.50,414,$331.00
2025-08-07,19:31:00,23409.5,BUY,1,0.02h,Stop Loss,$57.75,$388.75,$240867.25,414,$388.75
2025-08-07,20:33:00,23505.0,SELL,1,0.02h,Stop Loss,$-6.00,$382.75,$240861.25,414,$382.75
2025-08-07,20:52:00,23512.0,BUY,1,0.02h,Stop Loss,$-6.00,$376.75,$240855.25,414,$376.75
2025-08-07,22:42:00,23546.5,SELL,1,0.02h,Stop Loss,$-6.00,$370.75,$240849.25,414,$370.75
2025-08-07,22:52:00,23555.5,BUY,1,0.02h,Break Even,$0.25,$371.00,$240849.50,414,$371.00
Final P&L Day: 371.00,,,,,,,,,,,
2025-08-08,12:11:00,23552.25,SELL,1,0.02h,Break Even,$0.25,$0.25,$240849.75,415,$0.25
2025-08-08,12:48:00,23537.75,BUY,1,0.02h,Break Even,$0.25,$0.50,$240850.00,415,$0.50
2025-08-08,12:58:00,23531.25,SELL,1,0.02h,Stop Loss,$-6.00,$-5.50,$240844.00,415,$-5.50
2025-08-08,13:01:00,23542.25,BUY,1,0.02h,Stop Loss,$10.25,$4.75,$240854.25,415,$4.75
2025-08-08,13:07:00,23530.25,SELL,1,0.02h,Break Even,$0.25,$5.00,$240854.50,415,$5.00
2025-08-08,13:25:00,23534.0,BUY,1,0.02h,Stop Loss,$16.50,$21.50,$240871.00,415,$21.50
2025-08-08,14:52:00,23670.75,SELL,1,0.02h,Stop Loss,$14.00,$35.50,$240885.00,415,$35.50
2025-08-08,15:10:00,23673.25,BUY,1,0.02h,Break Even,$0.25,$35.75,$240885.25,415,$35.75
2025-08-08,15:12:00,23656.0,SELL,1,0.02h,Stop Loss,$-6.00,$29.75,$240879.25,415,$29.75
2025-08-08,15:15:00,23679.5,BUY,1,0.02h,Break Even,$0.25,$30.00,$240879.50,415,$30.00
2025-08-08,15:30:00,23666.0,SELL,1,0.02h,Stop Loss,$70.25,$100.25,$240949.75,415,$100.25
2025-08-08,15:52:00,23651.5,BUY,1,0.02h,Stop Loss,$17.75,$118.00,$240967.50,415,$118.00
2025-08-08,16:38:00,23685.75,SELL,1,0.02h,Stop Loss,$-6.00,$112.00,$240961.50,415,$112.00
2025-08-08,16:39:00,23692.25,BUY,1,0.02h,Break Even,$0.25,$112.25,$240961.75,415,$112.25
2025-08-08,16:50:00,23687.5,SELL,1,0.02h,Stop Loss,$6.50,$118.75,$240968.25,415,$118.75
2025-08-08,17:25:00,23677.0,BUY,1,0.02h,Stop Loss,$-6.00,$112.75,$240962.25,415,$112.75
2025-08-08,17:26:00,23665.25,SELL,1,0.02h,Stop Loss,$21.50,$134.25,$240983.75,415,$134.25
2025-08-08,17:34:00,23676.75,BUY,1,0.02h,Stop Loss,$-6.00,$128.25,$240977.75,415,$128.25
2025-08-08,18:26:00,23696.25,SELL,1,0.02h,Stop Loss,$17.75,$146.00,$240995.50,415,$146.00
2025-08-08,18:33:00,23710.0,BUY,1,0.02h,Stop Loss,$4.00,$150.00,$240999.50,415,$150.00
2025-08-08,18:42:00,23707.25,SELL,1,0.02h,Break Even,$0.25,$150.25,$240999.75,415,$150.25
2025-08-08,18:49:00,23711.75,BUY,1,0.02h,Break Even,$0.25,$150.50,$241000.00,415,$150.50
2025-08-08,19:03:00,23704.5,SELL,1,0.02h,Stop Loss,$-6.00,$144.50,$240994.00,415,$144.50
2025-08-08,19:19:00,23711.5,BUY,1,0.02h,Stop Loss,$16.50,$161.00,$241010.50,415,$161.00
2025-08-08,19:28:00,23707.75,SELL,1,0.02h,Break Even,$0.25,$161.25,$241010.75,415,$161.25
2025-08-08,19:55:00,23712.0,BUY,1,0.02h,Stop Loss,$-6.00,$155.25,$241004.75,415,$155.25
2025-08-08,20:49:00,23748.5,SELL,1,0.02h,Break Even,$0.25,$155.50,$241005.00,415,$155.50
2025-08-08,20:56:00,23753.25,BUY,1,0.02h,Stop Loss,$12.75,$168.25,$241017.75,415,$168.25
Final P&L Day: 168.25,,,,,,,,,,,
2025-08-11,12:01:00,23745.5,SELL,1,0.02h,Break Even,$0.25,$0.25,$241018.00,416,$0.25
2025-08-11,13:16:00,23723.5,BUY,1,0.02h,Break Even,$0.25,$0.50,$241018.25,416,$0.50
2025-08-11,13:26:00,23714.0,SELL,1,0.02h,Break Even,$0.25,$0.75,$241018.50,416,$0.75
2025-08-11,13:43:00,23727.75,BUY,1,0.02h,Stop Loss,$35.25,$36.00,$241053.75,416,$36.00
2025-08-11,14:37:00,23748.75,SELL,1,0.02h,Break Even,$0.25,$36.25,$241054.00,416,$36.25
2025-08-11,14:38:00,23751.5,BUY,1,0.02h,Stop Loss,$26.50,$62.75,$241080.50,416,$62.75
2025-08-11,14:41:00,23743.75,SELL,1,0.02h,Break Even,$0.25,$63.00,$241080.75,416,$63.00
2025-08-11,14:42:00,23755.5,BUY,1,0.02h,Stop Loss,$-6.00,$57.00,$241074.75,416,$57.00
2025-08-11,14:43:00,23747.5,SELL,1,0.02h,Stop Loss,$-6.00,$51.00,$241068.75,416,$51.00
2025-08-11,14:46:00,23755.5,BUY,1,0.02h,Break Even,$0.25,$51.25,$241069.00,416,$51.25
2025-08-11,14:47:00,23742.25,SELL,1,0.02h,Stop Loss,$46.50,$97.75,$241115.50,416,$97.75
2025-08-11,15:15:00,23747.25,BUY,1,0.02h,Break Even,$0.25,$98.00,$241115.75,416,$98.00
2025-08-11,15:28:00,23736.5,SELL,1,0.02h,Break Even,$0.25,$98.25,$241116.00,416,$98.25
2025-08-11,15:35:00,23742.5,BUY,1,0.02h,Stop Loss,$-6.00,$92.25,$241110.00,416,$92.25
2025-08-11,15:38:00,23733.75,SELL,1,0.02h,Stop Loss,$34.00,$126.25,$241144.00,416,$126.25
2025-08-11,15:50:00,23739.75,BUY,1,0.02h,Stop Loss,$29.00,$155.25,$241173.00,416,$155.25
2025-08-11,16:37:00,23771.25,SELL,1,0.02h,Break Even,$0.25,$155.50,$241173.25,416,$155.50
2025-08-11,18:33:00,23695.5,BUY,1,0.02h,Break Even,$0.25,$155.75,$241173.50,416,$155.75
2025-08-11,18:44:00,23680.5,SELL,1,0.02h,Stop Loss,$104.00,$259.75,$241277.50,416,$259.75
2025-08-11,18:59:00,23691.75,BUY,1,0.02h,Stop Loss,$-6.00,$253.75,$241271.50,416,$253.75
2025-08-11,19:04:00,23678.5,SELL,1,0.02h,Stop Loss,$-6.00,$247.75,$241265.50,416,$247.75
2025-08-11,20:06:00,23639.5,BUY,1,0.02h,Stop Loss,$6.50,$254.25,$241272.00,416,$254.25
2025-08-11,20:16:00,23628.5,SELL,1,0.02h,Stop Loss,$11.50,$265.75,$241283.50,416,$265.75
2025-08-11,20:43:00,23626.5,BUY,1,0.02h,Stop Loss,$-6.00,$259.75,$241277.50,416,$259.75
2025-08-11,20:58:00,23624.25,SELL,1,0.02h,Stop Loss,$-6.00,$253.75,$241271.50,416,$253.75
2025-08-11,21:00:00,23630.0,BUY,1,1.02h,Stop Loss,$51.50,$305.25,$241323.00,416,$305.25
2025-08-11,22:19:00,23626.0,SELL,1,0.02h,Stop Loss,$21.50,$326.75,$241344.50,416,$326.75
2025-08-11,22:45:00,23625.5,BUY,1,0.02h,Stop Loss,$-6.00,$320.75,$241338.50,416,$320.75
2025-08-11,22:46:00,23618.25,SELL,1,0.02h,Stop Loss,$-6.00,$314.75,$241332.50,416,$314.75
2025-08-11,22:50:00,23626.25,BUY,1,0.02h,Stop Loss,$11.50,$326.25,$241344.00,416,$326.25
Final P&L Day: 326.25,,,,,,,,,,,
2025-08-12,13:03:00,23755.5,SELL,1,0.02h,Stop Loss,$34.00,$34.00,$241378.00,417,$34.00
2025-08-12,13:35:00,23780.0,BUY,1,0.02h,Stop Loss,$44.00,$78.00,$241422.00,417,$78.00
2025-08-12,13:49:00,23705.25,SELL,1,0.02h,Stop Loss,$97.75,$175.75,$241519.75,417,$175.75
2025-08-12,14:15:00,23721.75,BUY,1,0.02h,Stop Loss,$92.75,$268.50,$241612.50,417,$268.50
2025-08-12,16:08:00,23849.75,SELL,1,0.02h,Stop Loss,$-6.00,$262.50,$241606.50,417,$262.50
2025-08-12,16:15:00,23857.25,BUY,1,0.02h,Stop Loss,$21.50,$284.00,$241628.00,417,$284.00
2025-08-12,17:28:00,23892.0,SELL,1,0.02h,Stop Loss,$-6.00,$278.00,$241622.00,417,$278.00
2025-08-12,17:35:00,23906.25,BUY,1,0.02h,Stop Loss,$-6.00,$272.00,$241616.00,417,$272.00
2025-08-12,18:32:00,23911.75,SELL,1,0.02h,Stop Loss,$-6.00,$266.00,$241610.00,417,$266.00
2025-08-12,19:08:00,23916.0,BUY,1,0.02h,Stop Loss,$-6.00,$260.00,$241604.00,417,$260.00
2025-08-12,19:12:00,23903.0,SELL,1,0.02h,Stop Loss,$-6.00,$254.00,$241598.00,417,$254.00
2025-08-12,19:19:00,23916.0,BUY,1,0.02h,Break Even,$0.25,$254.25,$241598.25,417,$254.25
2025-08-12,19:47:00,23921.5,SELL,1,0.02h,Stop Loss,$-6.00,$248.25,$241592.25,417,$248.25
2025-08-12,19:51:00,23932.75,BUY,1,0.02h,Stop Loss,$12.75,$261.00,$241605.00,417,$261.00
2025-08-12,20:13:00,23929.25,SELL,1,0.02h,Stop Loss,$-6.00,$255.00,$241599.00,417,$255.00
2025-08-12,20:16:00,23933.75,BUY,1,0.02h,Stop Loss,$-6.00,$249.00,$241593.00,417,$249.00
2025-08-12,20:43:00,23934.75,SELL,1,0.02h,Stop Loss,$-6.00,$243.00,$241587.00,417,$243.00
2025-08-12,20:48:00,23938.0,BUY,1,0.02h,Break Even,$0.25,$243.25,$241587.25,417,$243.25
2025-08-12,22:03:00,23932.25,SELL,1,0.02h,Stop Loss,$-6.00,$237.25,$241581.25,417,$237.25
2025-08-12,22:46:00,23931.0,BUY,1,0.02h,Stop Loss,$-6.00,$231.25,$241575.25,417,$231.25
2025-08-12,22:47:00,23928.5,SELL,1,0.02h,Stop Loss,$-6.00,$225.25,$241569.25,417,$225.25
2025-08-12,22:48:00,23930.5,BUY,1,0.02h,Stop Loss,$-6.00,$219.25,$241563.25,417,$219.25
2025-08-12,22:49:00,23927.75,SELL,1,0.03h,Stop Loss,$-6.00,$213.25,$241557.25,417,$213.25
2025-08-12,22:58:00,23930.0,BUY,1,0.02h,Stop Loss,$-6.00,$207.25,$241551.25,417,$207.25
Final P&L Day: 207.25,,,,,,,,,,,
2025-08-13,13:46:00,24032.0,SELL,1,0.02h,Stop Loss,$4.00,$4.00,$241555.25,418,$4.00
2025-08-13,13:51:00,24057.5,BUY,1,0.02h,Break Even,$0.25,$4.25,$241555.50,418,$4.25
2025-08-13,13:56:00,24015.75,SELL,1,0.02h,Stop Loss,$37.75,$42.00,$241593.25,418,$42.00
2025-08-13,15:24:00,23945.0,BUY,1,0.02h,Stop Loss,$-6.00,$36.00,$241587.25,418,$36.00
2025-08-13,15:40:00,23930.5,SELL,1,0.02h,Stop Loss,$-6.00,$30.00,$241581.25,418,$30.00
2025-08-13,15:41:00,23939.5,BUY,1,0.02h,Stop Loss,$25.25,$55.25,$241606.50,418,$55.25
2025-08-13,15:54:00,23923.25,SELL,1,0.02h,Stop Loss,$11.50,$66.75,$241618.00,418,$66.75
2025-08-13,16:16:00,23936.75,BUY,1,0.02h,Break Even,$0.25,$67.00,$241618.25,418,$67.00
2025-08-13,16:19:00,23927.5,SELL,1,0.02h,Stop Loss,$17.75,$84.75,$241636.00,418,$84.75
2025-08-13,17:04:00,23920.0,BUY,1,0.02h,Break Even,$0.25,$85.00,$241636.25,418,$85.00
2025-08-13,17:10:00,23904.0,SELL,1,0.02h,Stop Loss,$4.00,$89.00,$241640.25,418,$89.00
2025-08-13,17:19:00,23915.25,BUY,1,0.02h,Stop Loss,$22.75,$111.75,$241663.00,418,$111.75
2025-08-13,17:35:00,23903.75,SELL,1,0.02h,Stop Loss,$-6.00,$105.75,$241657.00,418,$105.75
2025-08-13,17:54:00,23923.75,BUY,1,0.02h,Stop Loss,$-6.00,$99.75,$241651.00,418,$99.75
2025-08-13,18:27:00,23932.0,SELL,1,0.02h,Stop Loss,$9.00,$108.75,$241660.00,418,$108.75
2025-08-13,18:50:00,23928.25,BUY,1,0.02h,Break Even,$0.25,$109.00,$241660.25,418,$109.00
2025-08-13,19:08:00,23926.25,SELL,1,0.02h,Break Even,$0.25,$109.25,$241660.50,418,$109.25
2025-08-13,19:14:00,23934.0,BUY,1,0.02h,Stop Loss,$9.00,$118.25,$241669.50,418,$118.25
2025-08-13,19:31:00,23932.0,SELL,1,0.02h,Break Even,$0.25,$118.50,$241669.75,418,$118.50
2025-08-13,19:52:00,23936.5,BUY,1,0.02h,Stop Loss,$36.50,$155.00,$241706.25,418,$155.00
2025-08-13,20:10:00,23931.5,SELL,1,0.02h,Stop Loss,$-6.00,$149.00,$241700.25,418,$149.00
2025-08-13,20:51:00,23929.5,BUY,1,0.02h,Stop Loss,$-6.00,$143.00,$241694.25,418,$143.00
2025-08-13,22:02:00,23923.5,SELL,1,0.02h,Break Even,$0.25,$143.25,$241694.50,418,$143.25
2025-08-13,22:22:00,23926.25,BUY,1,0.02h,Stop Loss,$-6.00,$137.25,$241688.50,418,$137.25
Final P&L Day: 137.25,,,,,,,,,,,
2025-08-14,12:27:00,23946.5,SELL,1,0.02h,Break Even,$0.25,$0.25,$241688.75,419,$0.25
2025-08-14,13:14:00,23850.0,BUY,1,0.02h,Stop Loss,$-6.00,$-5.75,$241682.75,419,$-5.75
2025-08-14,13:20:00,23828.75,SELL,1,0.02h,Stop Loss,$6.50,$0.75,$241689.25,419,$0.75
2025-08-14,13:29:00,23853.25,BUY,1,0.02h,Stop Loss,$22.75,$23.50,$241712.00,419,$23.50
2025-08-14,14:12:00,23914.5,SELL,1,0.02h,Stop Loss,$24.00,$47.50,$241736.00,419,$47.50
2025-08-14,14:18:00,23933.75,BUY,1,0.02h,Stop Loss,$51.50,$99.00,$241787.50,419,$99.00
2025-08-14,14:58:00,23948.0,SELL,1,0.02h,Stop Loss,$20.25,$119.25,$241807.75,419,$119.25
2025-08-14,15:49:00,23919.0,BUY,1,0.02h,Stop Loss,$19.00,$138.25,$241826.75,419,$138.25
2025-08-14,16:07:00,23900.0,SELL,1,0.02h,Break Even,$0.25,$138.50,$241827.00,419,$138.50
2025-08-14,16:26:00,23903.75,BUY,1,0.02h,Stop Loss,$-6.00,$132.50,$241821.00,419,$132.50
2025-08-14,16:28:00,23887.25,SELL,1,0.02h,Stop Loss,$25.25,$157.75,$241846.25,419,$157.75
2025-08-14,16:34:00,23898.5,BUY,1,0.02h,Stop Loss,$62.75,$220.50,$241909.00,419,$220.50
2025-08-14,17:40:00,23958.0,SELL,1,0.02h,Stop Loss,$77.75,$298.25,$241986.75,419,$298.25
2025-08-14,18:00:00,23962.5,BUY,1,0.02h,Stop Loss,$-6.00,$292.25,$241980.75,419,$292.25
2025-08-14,18:02:00,23951.0,SELL,1,0.02h,Stop Loss,$32.75,$325.00,$242013.50,419,$325.00
2025-08-14,18:45:00,23917.5,BUY,1,0.02h,Stop Loss,$-6.00,$319.00,$242007.50,419,$319.00
2025-08-14,19:31:00,23922.75,SELL,1,0.02h,Stop Loss,$-6.00,$313.00,$242001.50,419,$313.00
2025-08-14,19:38:00,23936.75,BUY,1,0.02h,Stop Loss,$15.25,$328.25,$242016.75,419,$328.25
2025-08-14,20:00:00,23921.25,SELL,1,0.02h,Stop Loss,$61.50,$389.75,$242078.25,419,$389.75
2025-08-14,20:38:00,23892.5,BUY,1,0.02h,Break Even,$0.25,$390.00,$242078.50,419,$390.00
2025-08-14,20:43:00,23884.25,SELL,1,0.02h,Break Even,$0.25,$390.25,$242078.75,419,$390.25
2025-08-14,20:48:00,23889.75,BUY,1,0.02h,Stop Loss,$-6.00,$384.25,$242072.75,419,$384.25
2025-08-14,20:50:00,23885.0,SELL,1,0.02h,Stop Loss,$-6.00,$378.25,$242066.75,419,$378.25
2025-08-14,20:51:00,23887.5,BUY,1,0.02h,Break Even,$0.25,$378.50,$242067.00,419,$378.50
2025-08-14,20:53:00,23885.25,SELL,1,0.02h,Stop Loss,$-6.00,$372.50,$242061.00,419,$372.50
2025-08-14,21:00:00,23891.0,BUY,1,1.02h,Stop Loss,$-6.00,$366.50,$242055.00,419,$366.50
2025-08-14,22:01:00,23882.5,SELL,1,0.02h,Stop Loss,$30.25,$396.75,$242085.25,419,$396.75
2025-08-14,22:07:00,23891.25,BUY,1,0.02h,Break Even,$0.25,$397.00,$242085.50,419,$397.00
2025-08-14,22:20:00,23883.25,SELL,1,0.02h,Stop Loss,$-6.00,$391.00,$242079.50,419,$391.00
2025-08-14,22:46:00,23891.5,BUY,1,0.02h,Stop Loss,$-6.00,$385.00,$242073.50,419,$385.00
Final P&L Day: 385.00,,,,,,,,,,,
2025-08-15,12:25:00,23893.25,SELL,1,0.02h,Stop Loss,$6.50,$6.50,$242080.00,420,$6.50
2025-08-15,12:33:00,23908.25,BUY,1,0.02h,Stop Loss,$-6.00,$0.50,$242074.00,420,$0.50
2025-08-15,12:34:00,23902.0,SELL,1,0.02h,Stop Loss,$-6.00,$-5.50,$242068.00,420,$-5.50
2025-08-15,12:35:00,23906.5,BUY,1,0.02h,Stop Loss,$-6.00,$-11.50,$242062.00,420,$-11.50
2025-08-15,12:39:00,23894.5,SELL,1,0.02h,Break Even,$0.25,$-11.25,$242062.25,420,$-11.25
2025-08-15,12:47:00,23907.25,BUY,1,0.02h,Stop Loss,$6.50,$-4.75,$242068.75,420,$-4.75
2025-08-15,13:01:00,23901.75,SELL,1,0.02h,Stop Loss,$-6.00,$-10.75,$242062.75,420,$-10.75
2025-08-15,13:20:00,23907.75,BUY,1,0.02h,Break Even,$0.25,$-10.50,$242063.00,420,$-10.50
2025-08-15,13:26:00,23888.5,SELL,1,0.02h,Stop Loss,$-6.00,$-16.50,$242057.00,420,$-16.50
2025-08-15,13:29:00,23912.25,BUY,1,0.02h,Stop Loss,$34.00,$17.50,$242091.00,420,$17.50
2025-08-15,13:31:00,23861.25,SELL,1,0.02h,Stop Loss,$40.25,$57.75,$242131.25,420,$57.75
2025-08-15,14:05:00,23853.75,BUY,1,0.02h,Stop Loss,$29.00,$86.75,$242160.25,420,$86.75
2025-08-15,14:34:00,23837.75,SELL,1,0.02h,Break Even,$0.25,$87.00,$242160.50,420,$87.00
2025-08-15,15:17:00,23815.75,BUY,1,0.02h,Stop Loss,$10.25,$97.25,$242170.75,420,$97.25
2025-08-15,15:27:00,23806.25,SELL,1,0.02h,Break Even,$0.25,$97.50,$242171.00,420,$97.50
2025-08-15,15:54:00,23812.25,BUY,1,0.02h,Stop Loss,$6.50,$104.00,$242177.50,420,$104.00
2025-08-15,16:03:00,23773.0,SELL,1,0.02h,Stop Loss,$12.75,$116.75,$242190.25,420,$116.75
2025-08-15,16:09:00,23792.75,BUY,1,0.02h,Stop Loss,$5.25,$122.00,$242195.50,420,$122.00
2025-08-15,16:19:00,23778.5,SELL,1,0.02h,Stop Loss,$-6.00,$116.00,$242189.50,420,$116.00
2025-08-15,16:41:00,23790.75,BUY,1,0.02h,Break Even,$0.25,$116.25,$242189.75,420,$116.25
2025-08-15,17:13:00,23802.75,SELL,1,0.02h,Break Even,$0.25,$116.50,$242190.00,420,$116.50
2025-08-15,17:31:00,23815.5,BUY,1,0.02h,Stop Loss,$32.75,$149.25,$242222.75,420,$149.25
2025-08-15,17:48:00,23805.0,SELL,1,0.02h,Stop Loss,$-6.00,$143.25,$242216.75,420,$143.25
2025-08-15,17:56:00,23827.25,BUY,1,0.02h,Stop Loss,$22.75,$166.00,$242239.50,420,$166.00
2025-08-15,18:16:00,23811.25,SELL,1,0.02h,Break Even,$0.25,$166.25,$242239.75,420,$166.25
2025-08-15,18:31:00,23823.75,BUY,1,0.02h,Stop Loss,$4.00,$170.25,$242243.75,420,$170.25
2025-08-15,18:37:00,23810.5,SELL,1,0.02h,Stop Loss,$-6.00,$164.25,$242237.75,420,$164.25
2025-08-15,18:56:00,23819.25,BUY,1,0.02h,Break Even,$0.25,$164.50,$242238.00,420,$164.50
2025-08-15,18:59:00,23810.5,SELL,1,0.02h,Stop Loss,$7.75,$172.25,$242245.75,420,$172.25
2025-08-15,19:15:00,23807.75,BUY,1,0.02h,Stop Loss,$9.00,$181.25,$242254.75,420,$181.25
2025-08-15,19:19:00,23793.5,SELL,1,0.02h,Stop Loss,$-6.00,$175.25,$242248.75,420,$175.25
2025-08-15,19:23:00,23809.25,BUY,1,0.02h,Stop Loss,$9.00,$184.25,$242257.75,420,$184.25
2025-08-15,19:53:00,23805.25,SELL,1,0.02h,Break Even,$0.25,$184.50,$242258.00,420,$184.50
2025-08-15,20:15:00,23809.0,BUY,1,0.02h,Break Even,$0.25,$184.75,$242258.25,420,$184.75
2025-08-15,20:25:00,23796.5,SELL,1,0.02h,Stop Loss,$6.50,$191.25,$242264.75,420,$191.25
2025-08-15,20:55:00,23795.25,BUY,1,0.02h,Break Even,$0.25,$191.50,$242265.00,420,$191.50
Final P&L Day: 191.50,,,,,,,,,,,
2025-08-18,12:00:00,23770.75,SELL,1,0.02h,Stop Loss,$7.75,$7.75,$242272.75,421,$7.75
2025-08-18,12:30:00,23770.75,BUY,1,0.02h,Stop Loss,$-6.00,$1.75,$242266.75,421,$1.75
2025-08-18,12:32:00,23758.75,SELL,1,0.02h,Stop Loss,$-6.00,$-4.25,$242260.75,421,$-4.25
2025-08-18,12:45:00,23765.75,BUY,1,0.02h,Stop Loss,$7.75,$3.50,$242268.50,421,$3.50
2025-08-18,13:13:00,23758.0,SELL,1,0.02h,Stop Loss,$-6.00,$-2.50,$242262.50,421,$-2.50
2025-08-18,13:31:00,23801.75,BUY,1,0.02h,Stop Loss,$12.75,$10.25,$242275.25,421,$10.25
2025-08-18,13:45:00,23776.75,SELL,1,0.02h,Stop Loss,$7.75,$18.00,$242283.00,421,$18.00
2025-08-18,13:46:00,23790.75,BUY,1,0.02h,Break Even,$0.25,$18.25,$242283.25,421,$18.25
2025-08-18,13:52:00,23752.0,SELL,1,0.02h,Stop Loss,$17.75,$36.00,$242301.00,421,$36.00
2025-08-18,14:06:00,23780.0,BUY,1,0.02h,Stop Loss,$15.25,$51.25,$242316.25,421,$51.25
2025-08-18,14:16:00,23766.5,SELL,1,0.02h,Break Even,$0.25,$51.50,$242316.50,421,$51.50
2025-08-18,14:17:00,23778.25,BUY,1,0.02h,Stop Loss,$5.25,$56.75,$242321.75,421,$56.75
2025-08-18,14:35:00,23778.75,SELL,1,0.02h,Stop Loss,$9.00,$65.75,$242330.75,421,$65.75
2025-08-18,14:56:00,23775.5,BUY,1,0.02h,Stop Loss,$-6.00,$59.75,$242324.75,421,$59.75
2025-08-18,15:14:00,23764.25,SELL,1,0.02h,Stop Loss,$15.25,$75.00,$242340.00,421,$75.00
2025-08-18,15:48:00,23753.5,BUY,1,0.02h,Stop Loss,$14.00,$89.00,$242354.00,421,$89.00
2025-08-18,15:56:00,23741.25,SELL,1,0.02h,Break Even,$0.25,$89.25,$242354.25,421,$89.25
2025-08-18,16:02:00,23754.5,BUY,1,0.02h,Break Even,$0.25,$89.50,$242354.50,421,$89.50
2025-08-18,16:37:00,23748.25,SELL,1,0.02h,Stop Loss,$49.00,$138.50,$242403.50,421,$138.50
2025-08-18,17:05:00,23752.0,BUY,1,0.02h,Stop Loss,$-6.00,$132.50,$242397.50,421,$132.50
2025-08-18,17:42:00,23755.25,SELL,1,0.02h,Stop Loss,$7.75,$140.25,$242405.25,421,$140.25
2025-08-18,18:08:00,23767.0,BUY,1,0.02h,Stop Loss,$-6.00,$134.25,$242399.25,421,$134.25
2025-08-18,18:19:00,23756.25,SELL,1,0.02h,Stop Loss,$-6.00,$128.25,$242393.25,421,$128.25
2025-08-18,18:24:00,23767.5,BUY,1,0.02h,Break Even,$0.25,$128.50,$242393.50,421,$128.50
2025-08-18,19:25:00,23792.5,SELL,1,0.02h,Break Even,$0.25,$128.75,$242393.75,421,$128.75
2025-08-18,19:38:00,23803.0,BUY,1,0.02h,Stop Loss,$-6.00,$122.75,$242387.75,421,$122.75
2025-08-18,20:03:00,23793.0,SELL,1,0.02h,Stop Loss,$-6.00,$116.75,$242381.75,421,$116.75
2025-08-18,20:50:00,23792.25,BUY,1,0.07h,Break Even,$0.25,$117.00,$242382.00,421,$117.00
2025-08-18,22:27:00,23814.0,SELL,1,0.02h,Break Even,$0.25,$117.25,$242382.25,421,$117.25
2025-08-18,22:49:00,23816.5,BUY,1,0.02h,Stop Loss,$-6.00,$111.25,$242376.25,421,$111.25
Final P&L Day: 111.25,,,,,,,,,,,
2025-08-19,12:00:00,23774.75,SELL,1,0.02h,Stop Loss,$15.25,$15.25,$242391.50,422,$15.25
2025-08-19,12:28:00,23780.75,BUY,1,0.02h,Stop Loss,$-6.00,$9.25,$242385.50,422,$9.25
2025-08-19,12:43:00,23771.5,SELL,1,0.02h,Break Even,$0.25,$9.50,$242385.75,422,$9.50
2025-08-19,13:24:00,23752.0,BUY,1,0.02h,Break Even,$0.25,$9.75,$242386.00,422,$9.75
2025-08-19,13:33:00,23692.75,SELL,1,0.02h,Stop Loss,$75.25,$85.00,$242461.25,422,$85.00
2025-08-19,14:05:00,23721.5,BUY,1,0.02h,Break Even,$0.25,$85.25,$242461.50,422,$85.25
2025-08-19,14:24:00,23688.0,SELL,1,0.02h,Stop Loss,$-6.00,$79.25,$242455.50,422,$79.25
2025-08-19,15:19:00,23567.5,BUY,1,0.02h,Stop Loss,$15.25,$94.50,$242470.75,422,$94.50
2025-08-19,15:26:00,23557.25,SELL,1,0.02h,Stop Loss,$-6.00,$88.50,$242464.75,422,$88.50
2025-08-19,15:27:00,23573.0,BUY,1,0.02h,Stop Loss,$40.25,$128.75,$242505.00,422,$128.75
2025-08-19,15:51:00,23560.5,SELL,1,0.02h,Stop Loss,$20.25,$149.00,$242525.25,422,$149.00
2025-08-19,17:26:00,23475.5,BUY,1,0.02h,Break Even,$0.25,$149.25,$242525.50,422,$149.25
2025-08-19,18:03:00,23483.25,SELL,1,0.02h,Stop Loss,$42.75,$192.00,$242568.25,422,$192.00
2025-08-19,18:58:00,23466.5,BUY,1,0.02h,Stop Loss,$6.50,$198.50,$242574.75,422,$198.50
2025-08-19,19:01:00,23447.0,SELL,1,0.02h,Stop Loss,$75.25,$273.75,$242650.00,422,$273.75
2025-08-19,19:24:00,23454.0,BUY,1,0.02h,Stop Loss,$29.00,$302.75,$242679.00,422,$302.75
2025-08-19,19:52:00,23452.75,SELL,1,0.02h,Stop Loss,$-6.00,$296.75,$242673.00,422,$296.75
2025-08-19,20:01:00,23481.5,BUY,1,0.02h,Stop Loss,$14.00,$310.75,$242687.00,422,$310.75
2025-08-19,20:21:00,23470.5,SELL,1,0.02h,Stop Loss,$-6.00,$304.75,$242681.00,422,$304.75
2025-08-19,20:23:00,23472.75,BUY,1,0.02h,Stop Loss,$-6.00,$298.75,$242675.00,422,$298.75
2025-08-19,20:24:00,23471.25,SELL,1,0.02h,Stop Loss,$14.00,$312.75,$242689.00,422,$312.75
2025-08-19,20:30:00,23473.25,BUY,1,0.02h,Break Even,$0.25,$313.00,$242689.25,422,$313.00
2025-08-19,20:37:00,23468.0,SELL,1,0.02h,Break Even,$0.25,$313.25,$242689.50,422,$313.25
2025-08-19,20:51:00,23472.5,BUY,1,0.02h,Stop Loss,$-6.00,$307.25,$242683.50,422,$307.25
2025-08-19,22:14:00,23469.25,SELL,1,0.02h,Stop Loss,$17.75,$325.00,$242701.25,422,$325.00
2025-08-19,22:39:00,23466.5,BUY,1,0.02h,Stop Loss,$-6.00,$319.00,$242695.25,422,$319.00
2025-08-19,22:40:00,23465.25,SELL,1,0.02h,Break Even,$0.25,$319.25,$242695.50,422,$319.25
2025-08-19,22:52:00,23468.25,BUY,1,0.02h,Stop Loss,$-6.00,$313.25,$242689.50,422,$313.25
2025-08-19,22:59:00,23461.25,SELL,1,0.02h,Stop Loss,$9.00,$322.25,$242698.50,422,$322.25
Final P&L Day: 322.25,,,,,,,,,,,
