Date,Time,MNQ Price,Operation type,Contracts,Trade duration,Close Reason,Net P&L,Daily P&L,Balance,Day,Daily P&L Total
2024-01-02,12:01:00,16874.25,SELL,3,0.02h,Stop Loss,$34.50,$34.50,$50034.50,1,$34.50
2024-01-02,13:30:00,16828.25,BUY,3,0.02h,Stop Loss,$-18.00,$16.50,$50016.50,1,$16.50
2024-01-02,14:07:00,16841.5,SELL,3,0.02h,Stop Loss,$-18.00,$-1.50,$49998.50,1,$-1.50
2024-01-02,14:08:00,16851.75,BUY,3,0.02h,Break Even,$0.75,$-0.75,$49999.25,1,$-0.75
2024-01-02,14:35:00,16832.0,SELL,3,0.02h,Stop Loss,$38.25,$37.50,$50037.50,1,$37.50
2024-01-02,16:02:00,16715.5,BUY,3,0.02h,Stop Loss,$64.50,$102.00,$50102.00,1,$102.00
2024-01-02,17:17:00,16772.5,SELL,3,0.02h,Stop Loss,$244.50,$346.50,$50346.50,1,$346.50
2024-01-02,17:37:00,16772.25,BUY,3,0.02h,Stop Loss,$-18.00,$328.50,$50328.50,1,$328.50
2024-01-02,17:48:00,16758.25,SELL,3,0.02h,Stop Loss,$162.00,$490.50,$50490.50,1,$490.50
2024-01-02,18:22:00,16730.5,BUY,3,0.02h,Stop Loss,$-18.00,$472.50,$50472.50,1,$472.50
2024-01-02,18:49:00,16729.75,SELL,3,0.02h,Stop Loss,$42.00,$514.50,$50514.50,1,$514.50
2024-01-02,19:29:00,16695.5,BUY,3,0.02h,Stop Loss,$42.00,$556.50,$50556.50,1,$556.50
2024-01-02,19:40:00,16684.75,SELL,3,0.02h,Stop Loss,$19.50,$576.00,$50576.00,1,$576.00
2024-01-02,20:31:00,16651.25,BUY,3,0.02h,Stop Loss,$60.75,$636.75,$50636.75,1,$636.75
2024-01-02,20:40:00,16640.25,SELL,3,0.02h,Break Even,$0.75,$637.50,$50637.50,1,$637.50
2024-01-02,20:44:00,16649.0,BUY,3,0.02h,Stop Loss,$42.00,$679.50,$50679.50,1,$679.50
,,,,,,,,,,,
2024-01-03,12:00:00,16648.5,SELL,3,0.02h,Break Even,$0.75,$0.75,$50680.25,2,$0.75
2024-01-03,13:12:00,16614.25,BUY,3,0.02h,Stop Loss,$-18.00,$-17.25,$50662.25,2,$-17.25
2024-01-03,13:50:00,16631.5,SELL,3,0.02h,Stop Loss,$-18.00,$-35.25,$50644.25,2,$-35.25
2024-01-03,13:52:00,16640.25,BUY,3,0.02h,Stop Loss,$-18.00,$-53.25,$50626.25,2,$-53.25
2024-01-03,13:54:00,16631.5,SELL,3,0.02h,Stop Loss,$-18.00,$-71.25,$50608.25,2,$-71.25
2024-01-03,14:32:00,16617.25,BUY,3,0.02h,Break Even,$0.75,$-70.50,$50609.00,2,$-70.50
2024-01-03,14:33:00,16593.0,SELL,3,0.02h,Stop Loss,$124.50,$54.00,$50733.50,2,$54.00
2024-01-03,14:36:00,16630.5,BUY,3,0.02h,Break Even,$0.75,$54.75,$50734.25,2,$54.75
2024-01-03,14:57:00,16607.0,SELL,3,0.02h,Stop Loss,$154.50,$209.25,$50888.75,2,$209.25
2024-01-03,15:04:00,16640.0,BUY,3,0.02h,Stop Loss,$53.25,$262.50,$50942.00,2,$262.50
2024-01-03,15:10:00,16608.0,SELL,3,0.02h,Stop Loss,$233.25,$495.75,$51175.25,2,$495.75
2024-01-03,15:53:00,16577.75,BUY,3,0.02h,Break Even,$0.75,$496.50,$51176.00,2,$496.50
2024-01-03,16:23:00,16585.5,SELL,3,0.02h,Stop Loss,$-18.00,$478.50,$51158.00,2,$478.50
2024-01-03,16:34:00,16600.25,BUY,3,0.02h,Stop Loss,$-18.00,$460.50,$51140.00,2,$460.50
2024-01-03,16:36:00,16589.25,SELL,3,0.02h,Stop Loss,$57.00,$517.50,$51197.00,2,$517.50
2024-01-03,17:28:00,16571.0,BUY,3,0.02h,Stop Loss,$42.00,$559.50,$51239.00,2,$559.50
2024-01-03,18:21:00,16590.5,SELL,3,0.02h,Break Even,$0.75,$560.25,$51239.75,2,$560.25
2024-01-03,19:26:00,16590.75,BUY,3,0.02h,Stop Loss,$244.50,$804.75,$51484.25,2,$804.75
2024-01-03,19:53:00,16596.25,SELL,3,0.02h,Stop Loss,$-18.00,$786.75,$51466.25,2,$786.75
2024-01-03,20:34:00,16572.5,BUY,3,0.02h,Stop Loss,$64.50,$851.25,$51530.75,2,$851.25
2024-01-03,20:44:00,16555.25,SELL,3,0.02h,Stop Loss,$109.50,$960.75,$51640.25,2,$960.75
2024-01-03,21:32:00,16536.25,BUY,3,0.02h,Stop Loss,$-18.00,$942.75,$51622.25,2,$942.75
2024-01-03,21:33:00,16535.0,SELL,3,0.03h,Stop Loss,$-18.00,$924.75,$51604.25,2,$924.75
2024-01-03,21:36:00,16536.75,BUY,3,0.02h,Stop Loss,$-18.00,$906.75,$51586.25,2,$906.75
2024-01-03,21:37:00,16535.0,SELL,3,0.03h,Stop Loss,$-18.00,$888.75,$51568.25,2,$888.75
2024-01-03,21:39:00,16536.5,BUY,3,0.03h,Stop Loss,$-18.00,$870.75,$51550.25,2,$870.75
,,,,,,,,,,,
2024-01-04,12:00:00,16529.25,SELL,3,0.02h,Stop Loss,$-18.00,$-18.00,$51532.25,3,$-18.00
2024-01-04,12:29:00,16525.25,BUY,3,0.02h,Break Even,$0.75,$-17.25,$51533.00,3,$-17.25
2024-01-04,12:42:00,16521.75,SELL,3,0.02h,Break Even,$0.75,$-16.50,$51533.75,3,$-16.50
2024-01-04,12:43:00,16527.75,BUY,3,0.02h,Stop Loss,$-18.00,$-34.50,$51515.75,3,$-34.50
2024-01-04,12:54:00,16523.75,SELL,3,0.02h,Break Even,$0.75,$-33.75,$51516.50,3,$-33.75
2024-01-04,14:14:00,16466.75,BUY,3,0.02h,Stop Loss,$15.75,$-18.00,$51532.25,3,$-18.00
2024-01-04,14:23:00,16461.25,SELL,3,0.02h,Break Even,$0.75,$-17.25,$51533.00,3,$-17.25
2024-01-04,14:33:00,16488.25,BUY,3,0.02h,Stop Loss,$-18.00,$-35.25,$51515.00,3,$-35.25
2024-01-04,14:49:00,16460.25,SELL,3,0.02h,Stop Loss,$75.75,$40.50,$51590.75,3,$40.50
2024-01-04,14:53:00,16485.75,BUY,3,0.02h,Stop Loss,$15.75,$56.25,$51606.50,3,$56.25
2024-01-04,14:59:00,16458.5,SELL,3,0.02h,Stop Loss,$53.25,$109.50,$51659.75,3,$109.50
2024-01-04,15:02:00,16491.25,BUY,3,0.02h,Stop Loss,$-18.00,$91.50,$51641.75,3,$91.50
2024-01-04,16:33:00,16551.75,SELL,3,0.02h,Stop Loss,$-18.00,$73.50,$51623.75,3,$73.50
2024-01-04,16:38:00,16571.25,BUY,3,0.02h,Stop Loss,$-18.00,$55.50,$51605.75,3,$55.50
2024-01-04,16:40:00,16558.5,SELL,3,0.02h,Stop Loss,$12.00,$67.50,$51617.75,3,$67.50
2024-01-04,17:30:00,16523.75,BUY,3,0.02h,Break Even,$0.75,$68.25,$51618.50,3,$68.25
2024-01-04,17:32:00,16516.5,SELL,3,0.02h,Stop Loss,$60.75,$129.00,$51679.25,3,$129.00
2024-01-04,17:42:00,16520.5,BUY,3,0.02h,Stop Loss,$-18.00,$111.00,$51661.25,3,$111.00
2024-01-04,17:44:00,16510.25,SELL,3,0.02h,Stop Loss,$158.25,$269.25,$51819.50,3,$269.25
2024-01-04,18:05:00,16509.5,BUY,3,0.02h,Break Even,$0.75,$270.00,$51820.25,3,$270.00
2024-01-04,18:13:00,16495.75,SELL,3,0.02h,Break Even,$0.75,$270.75,$51821.00,3,$270.75
2024-01-04,18:15:00,16506.75,BUY,3,0.02h,Stop Loss,$-18.00,$252.75,$51803.00,3,$252.75
2024-01-04,18:16:00,16501.0,SELL,3,0.02h,Stop Loss,$42.00,$294.75,$51845.00,3,$294.75
2024-01-04,18:18:00,16509.5,BUY,3,0.02h,Break Even,$0.75,$295.50,$51845.75,3,$295.50
2024-01-04,18:54:00,16514.75,SELL,3,0.02h,Stop Loss,$57.00,$352.50,$51902.75,3,$352.50
2024-01-04,19:52:00,16492.25,BUY,3,0.02h,Stop Loss,$27.00,$379.50,$51929.75,3,$379.50
2024-01-04,20:17:00,16478.5,SELL,3,0.02h,Break Even,$0.75,$380.25,$51930.50,3,$380.25
2024-01-04,20:33:00,16494.0,BUY,3,0.02h,Stop Loss,$34.50,$414.75,$51965.00,3,$414.75
2024-01-04,20:44:00,16482.25,SELL,3,0.02h,Stop Loss,$-18.00,$396.75,$51947.00,3,$396.75
2024-01-04,21:28:00,16450.5,BUY,3,0.02h,Break Even,$0.75,$397.50,$51947.75,3,$397.50
2024-01-04,21:54:00,16449.25,SELL,3,0.02h,Break Even,$0.75,$398.25,$51948.50,3,$398.25
,,,,,,,,,,,
2024-01-05,12:37:00,16399.0,BUY,3,0.02h,Break Even,$0.75,$0.75,$51949.25,4,$0.75
2024-01-05,12:49:00,16395.5,SELL,3,0.02h,Break Even,$0.75,$1.50,$51950.00,4,$1.50
2024-01-05,13:15:00,16399.25,BUY,3,0.02h,Break Even,$0.75,$2.25,$51950.75,4,$2.25
2024-01-05,13:31:00,16362.75,SELL,3,0.02h,Stop Loss,$379.50,$381.75,$52330.25,4,$381.75
2024-01-05,13:52:00,16388.75,BUY,3,0.02h,Break Even,$0.75,$382.50,$52331.00,4,$382.50
2024-01-05,16:19:00,16541.25,SELL,3,0.02h,Stop Loss,$30.75,$413.25,$52361.75,4,$413.25
2024-01-05,17:42:00,16476.5,BUY,3,0.02h,Break Even,$0.75,$414.00,$52362.50,4,$414.00
2024-01-05,18:01:00,16468.0,SELL,3,0.02h,Stop Loss,$90.75,$504.75,$52453.25,4,$504.75
2024-01-05,18:28:00,16457.25,BUY,3,0.02h,Stop Loss,$102.00,$606.75,$52555.25,4,$606.75
2024-01-05,19:17:00,16486.5,SELL,3,0.02h,Stop Loss,$15.75,$622.50,$52571.00,4,$622.50
2024-01-05,20:39:00,16430.25,BUY,3,0.02h,Stop Loss,$-18.00,$604.50,$52553.00,4,$604.50
2024-01-05,21:31:00,16461.25,SELL,3,0.02h,Stop Loss,$-18.00,$586.50,$52535.00,4,$586.50
2024-01-05,21:51:00,16463.5,BUY,3,0.03h,Stop Loss,$-18.00,$568.50,$52517.00,4,$568.50
,,,,,,,,,,,
2024-01-08,12:01:00,16453.75,SELL,3,0.02h,Stop Loss,$-18.00,$-18.00,$52499.00,5,$-18.00
2024-01-08,12:08:00,16468.25,BUY,3,0.02h,Break Even,$0.75,$-17.25,$52499.75,5,$-17.25
2024-01-08,12:32:00,16463.75,SELL,3,0.02h,Break Even,$0.75,$-16.50,$52500.50,5,$-16.50
2024-01-08,12:57:00,16462.0,BUY,3,0.02h,Stop Loss,$162.00,$145.50,$52662.50,5,$145.50
2024-01-08,13:48:00,16486.25,SELL,3,0.02h,Break Even,$0.75,$146.25,$52663.25,5,$146.25
2024-01-08,14:12:00,16490.25,BUY,3,0.02h,Stop Loss,$19.50,$165.75,$52682.75,5,$165.75
2024-01-08,16:12:00,16645.5,SELL,3,0.02h,Stop Loss,$27.00,$192.75,$52709.75,5,$192.75
2024-01-08,16:22:00,16661.75,BUY,3,0.02h,Break Even,$0.75,$193.50,$52710.50,5,$193.50
2024-01-08,16:24:00,16650.0,SELL,3,0.02h,Break Even,$0.75,$194.25,$52711.25,5,$194.25
2024-01-08,16:34:00,16658.5,BUY,3,0.02h,Stop Loss,$34.50,$228.75,$52745.75,5,$228.75
2024-01-08,16:49:00,16655.5,SELL,3,0.02h,Break Even,$0.75,$229.50,$52746.50,5,$229.50
2024-01-08,16:53:00,16658.75,BUY,3,0.02h,Break Even,$0.75,$230.25,$52747.25,5,$230.25
2024-01-08,17:26:00,16682.25,SELL,3,0.02h,Break Even,$0.75,$231.00,$52748.00,5,$231.00
2024-01-08,17:32:00,16685.75,BUY,3,0.02h,Break Even,$0.75,$231.75,$52748.75,5,$231.75
2024-01-08,18:33:00,16714.25,SELL,3,0.02h,Break Even,$0.75,$232.50,$52749.50,5,$232.50
2024-01-08,18:34:00,16715.75,BUY,3,0.02h,Break Even,$0.75,$233.25,$52750.25,5,$233.25
2024-01-08,20:15:00,16776.25,SELL,3,0.02h,Break Even,$0.75,$234.00,$52751.00,5,$234.00
2024-01-08,20:16:00,16779.75,BUY,3,0.02h,Break Even,$0.75,$234.75,$52751.75,5,$234.75
2024-01-08,20:17:00,16777.0,SELL,3,0.02h,Stop Loss,$-18.00,$216.75,$52733.75,5,$216.75
2024-01-08,20:18:00,16784.25,BUY,3,0.02h,Stop Loss,$45.75,$262.50,$52779.50,5,$262.50
2024-01-08,20:30:00,16778.0,SELL,3,0.02h,Stop Loss,$19.50,$282.00,$52799.00,5,$282.00
2024-01-08,20:35:00,16786.0,BUY,3,0.02h,Stop Loss,$-18.00,$264.00,$52781.00,5,$264.00
2024-01-08,20:48:00,16777.0,SELL,3,0.02h,Break Even,$0.75,$264.75,$52781.75,5,$264.75
2024-01-08,20:52:00,16801.0,BUY,3,0.02h,Stop Loss,$34.50,$299.25,$52816.25,5,$299.25
2024-01-08,21:11:00,16792.5,SELL,3,0.02h,Break Even,$0.75,$300.00,$52817.00,5,$300.00
,,,,,,,,,,,
2024-01-09,12:38:00,16716.0,BUY,3,0.02h,Break Even,$0.75,$0.75,$52817.75,6,$0.75
2024-01-09,13:04:00,16711.0,SELL,3,0.02h,Stop Loss,$27.00,$27.75,$52844.75,6,$27.75
2024-01-09,14:11:00,16677.5,BUY,3,0.02h,Break Even,$0.75,$28.50,$52845.50,6,$28.50
2024-01-09,14:22:00,16670.0,SELL,3,0.02h,Stop Loss,$-18.00,$10.50,$52827.50,6,$10.50
2024-01-09,14:24:00,16674.25,BUY,3,0.02h,Stop Loss,$-18.00,$-7.50,$52809.50,6,$-7.50
2024-01-09,14:25:00,16667.75,SELL,3,0.02h,Stop Loss,$-18.00,$-25.50,$52791.50,6,$-25.50
2024-01-09,14:27:00,16676.0,BUY,3,0.02h,Stop Loss,$15.75,$-9.75,$52807.25,6,$-9.75
2024-01-09,14:46:00,16676.0,SELL,3,0.02h,Stop Loss,$15.75,$6.00,$52823.00,6,$6.00
2024-01-09,14:57:00,16687.5,BUY,3,0.02h,Stop Loss,$87.00,$93.00,$52910.00,6,$93.00
2024-01-09,15:33:00,16713.0,SELL,3,0.02h,Stop Loss,$-18.00,$75.00,$52892.00,6,$75.00
2024-01-09,15:36:00,16731.25,BUY,3,0.02h,Stop Loss,$42.00,$117.00,$52934.00,6,$117.00
2024-01-09,15:59:00,16729.5,SELL,3,0.02h,Stop Loss,$-18.00,$99.00,$52916.00,6,$99.00
2024-01-09,16:02:00,16750.0,BUY,3,0.02h,Stop Loss,$72.00,$171.00,$52988.00,6,$171.00
2024-01-09,17:34:00,16816.25,SELL,3,0.02h,Break Even,$0.75,$171.75,$52988.75,6,$171.75
2024-01-09,17:41:00,16828.75,BUY,3,0.02h,Break Even,$0.75,$172.50,$52989.50,6,$172.50
2024-01-09,18:25:00,16837.0,SELL,3,0.02h,Stop Loss,$90.75,$263.25,$53080.25,6,$263.25
2024-01-09,18:50:00,16830.5,BUY,3,0.02h,Stop Loss,$120.75,$384.00,$53201.00,6,$384.00
2024-01-09,19:15:00,16832.25,SELL,3,0.02h,Stop Loss,$135.75,$519.75,$53336.75,6,$519.75
2024-01-09,19:55:00,16826.75,BUY,3,0.02h,Stop Loss,$-18.00,$501.75,$53318.75,6,$501.75
2024-01-09,19:56:00,16819.75,SELL,3,0.02h,Break Even,$0.75,$502.50,$53319.50,6,$502.50
2024-01-09,19:57:00,16822.0,BUY,3,0.02h,Break Even,$0.75,$503.25,$53320.25,6,$503.25
2024-01-09,20:08:00,16814.0,SELL,3,0.02h,Stop Loss,$150.75,$654.00,$53471.00,6,$654.00
2024-01-09,20:18:00,16829.5,BUY,3,0.02h,Stop Loss,$-18.00,$636.00,$53453.00,6,$636.00
2024-01-09,20:19:00,16821.25,SELL,3,0.02h,Break Even,$0.75,$636.75,$53453.75,6,$636.75
2024-01-09,20:20:00,16825.5,BUY,3,0.02h,Stop Loss,$38.25,$675.00,$53492.00,6,$675.00
2024-01-09,20:32:00,16820.75,SELL,3,0.02h,Stop Loss,$12.00,$687.00,$53504.00,6,$687.00
2024-01-09,20:55:00,16829.5,BUY,3,0.02h,Stop Loss,$132.00,$819.00,$53636.00,6,$819.00
2024-01-09,21:29:00,16828.75,SELL,3,0.07h,Break Even,$0.75,$819.75,$53636.75,6,$819.75
2024-01-09,21:42:00,16831.25,BUY,3,0.02h,Stop Loss,$-18.00,$801.75,$53618.75,6,$801.75
2024-01-09,21:57:00,16828.75,SELL,3,0.02h,Break Even,$0.75,$802.50,$53619.50,6,$802.50
,,,,,,,,,,,
2024-01-10,12:00:00,16847.5,BUY,3,0.02h,Stop Loss,$64.50,$64.50,$53684.00,7,$64.50
2024-01-10,12:38:00,16856.5,SELL,3,0.02h,Break Even,$0.75,$65.25,$53684.75,7,$65.25
2024-01-10,13:16:00,16845.25,BUY,3,0.02h,Stop Loss,$-18.00,$47.25,$53666.75,7,$47.25
2024-01-10,13:19:00,16840.25,SELL,3,0.02h,Break Even,$0.75,$48.00,$53667.50,7,$48.00
2024-01-10,13:29:00,16847.5,BUY,3,0.02h,Break Even,$0.75,$48.75,$53668.25,7,$48.75
2024-01-10,13:30:00,16839.0,SELL,3,0.02h,Stop Loss,$57.00,$105.75,$53725.25,7,$105.75
2024-01-10,14:13:00,16825.5,BUY,3,0.02h,Break Even,$0.75,$106.50,$53726.00,7,$106.50
2024-01-10,14:51:00,16831.75,SELL,3,0.02h,Stop Loss,$192.00,$298.50,$53918.00,7,$298.50
2024-01-10,15:13:00,16843.0,BUY,3,0.02h,Stop Loss,$117.00,$415.50,$54035.00,7,$415.50
2024-01-10,16:12:00,16876.5,SELL,3,0.02h,Stop Loss,$94.50,$510.00,$54129.50,7,$510.00
2024-01-10,16:42:00,16878.75,BUY,3,0.02h,Break Even,$0.75,$510.75,$54130.25,7,$510.75
2024-01-10,16:53:00,16863.75,SELL,3,0.02h,Break Even,$0.75,$511.50,$54131.00,7,$511.50
2024-01-10,16:57:00,16878.75,BUY,3,0.02h,Stop Loss,$12.00,$523.50,$54143.00,7,$523.50
2024-01-10,18:12:00,16893.0,SELL,3,0.02h,Stop Loss,$38.25,$561.75,$54181.25,7,$561.75
2024-01-10,18:19:00,16909.5,BUY,3,0.02h,Stop Loss,$-18.00,$543.75,$54163.25,7,$543.75
2024-01-10,18:22:00,16899.0,SELL,3,0.02h,Stop Loss,$27.00,$570.75,$54190.25,7,$570.75
2024-01-10,18:26:00,16910.25,BUY,3,0.02h,Break Even,$0.75,$571.50,$54191.00,7,$571.50
2024-01-10,19:39:00,16944.25,SELL,3,0.02h,Stop Loss,$-18.00,$553.50,$54173.00,7,$553.50
2024-01-10,19:42:00,16952.0,BUY,3,0.02h,Break Even,$0.75,$554.25,$54173.75,7,$554.25
2024-01-10,20:16:00,16962.5,SELL,3,0.02h,Break Even,$0.75,$555.00,$54174.50,7,$555.00
2024-01-10,20:59:00,16946.0,BUY,3,0.02h,Stop Loss,$38.25,$593.25,$54212.75,7,$593.25
2024-01-10,21:42:00,16951.75,SELL,3,0.02h,Stop Loss,$-18.00,$575.25,$54194.75,7,$575.25
2024-01-10,21:43:00,16952.75,BUY,3,0.03h,Break Even,$0.75,$576.00,$54195.50,7,$576.00
,,,,,,,,,,,
2024-01-11,12:56:00,17007.25,SELL,3,0.02h,Stop Loss,$-18.00,$-18.00,$54177.50,8,$-18.00
2024-01-11,13:17:00,17008.25,BUY,3,0.02h,Break Even,$0.75,$-17.25,$54178.25,8,$-17.25
2024-01-11,13:31:00,16956.25,SELL,3,0.02h,Stop Loss,$754.50,$737.25,$54932.75,8,$737.25
2024-01-11,14:10:00,16943.0,BUY,3,0.02h,Stop Loss,$30.75,$768.00,$54963.50,8,$768.00
2024-01-11,14:47:00,16972.5,SELL,3,0.02h,Stop Loss,$139.50,$907.50,$55103.00,8,$907.50
2024-01-11,15:29:00,16890.0,BUY,3,0.02h,Break Even,$0.75,$908.25,$55103.75,8,$908.25
2024-01-11,15:50:00,16874.75,SELL,3,0.02h,Stop Loss,$184.50,$1092.75,$55288.25,8,$1092.75
2024-01-11,17:05:00,16794.25,BUY,3,0.02h,Stop Loss,$72.00,$1164.75,$55360.25,8,$1164.75
2024-01-11,17:29:00,16793.0,SELL,3,0.02h,Stop Loss,$139.50,$1304.25,$55499.75,8,$1304.25
2024-01-11,17:41:00,16811.0,BUY,3,0.02h,Stop Loss,$162.00,$1466.25,$55661.75,8,$1466.25
2024-01-11,19:25:00,16924.0,SELL,3,0.02h,Stop Loss,$-18.00,$1448.25,$55643.75,8,$1448.25
2024-01-11,19:26:00,16931.25,BUY,3,0.02h,Stop Loss,$30.75,$1479.00,$55674.50,8,$1479.00
2024-01-11,20:06:00,16949.75,SELL,3,0.02h,Stop Loss,$-18.00,$1461.00,$55656.50,8,$1461.00
2024-01-11,20:26:00,16957.25,BUY,3,0.02h,Stop Loss,$12.00,$1473.00,$55668.50,8,$1473.00
2024-01-11,20:38:00,16944.5,SELL,3,0.02h,Break Even,$0.75,$1473.75,$55669.25,8,$1473.75
2024-01-11,20:50:00,16953.5,BUY,3,0.02h,Stop Loss,$12.00,$1485.75,$55681.25,8,$1485.75
2024-01-11,20:52:00,16941.75,SELL,3,0.02h,Stop Loss,$135.75,$1621.50,$55817.00,8,$1621.50
2024-01-11,20:55:00,16955.25,BUY,3,0.02h,Stop Loss,$53.25,$1674.75,$55870.25,8,$1674.75
2024-01-11,21:28:00,16961.5,SELL,3,0.02h,Stop Loss,$-18.00,$1656.75,$55852.25,8,$1656.75
,,,,,,,,,,,
2024-01-12,12:31:00,16912.0,BUY,3,0.02h,Break Even,$0.75,$0.75,$55853.00,9,$0.75
2024-01-12,12:53:00,16909.25,SELL,3,0.02h,Break Even,$0.75,$1.50,$55853.75,9,$1.50
2024-01-12,12:55:00,16917.5,BUY,3,0.02h,Break Even,$0.75,$2.25,$55854.50,9,$2.25
2024-01-12,12:57:00,16911.0,SELL,3,0.02h,Stop Loss,$12.00,$14.25,$55866.50,9,$14.25
2024-01-12,13:04:00,16925.0,BUY,3,0.02h,Break Even,$0.75,$15.00,$55867.25,9,$15.00
2024-01-12,13:10:00,16909.0,SELL,3,0.02h,Break Even,$0.75,$15.75,$55868.00,9,$15.75
2024-01-12,13:31:00,16952.5,BUY,3,0.02h,Stop Loss,$240.75,$256.50,$56108.75,9,$256.50
2024-01-12,15:00:00,16986.25,SELL,3,0.02h,Stop Loss,$488.25,$744.75,$56597.00,9,$744.75
2024-01-12,15:32:00,16984.0,BUY,3,0.02h,Stop Loss,$38.25,$783.00,$56635.25,9,$783.00
2024-01-12,15:40:00,16956.25,SELL,3,0.02h,Break Even,$0.75,$783.75,$56636.00,9,$783.75
2024-01-12,16:07:00,16958.0,BUY,3,0.02h,Stop Loss,$105.75,$889.50,$56741.75,9,$889.50
2024-01-12,16:37:00,16963.5,SELL,3,0.02h,Stop Loss,$379.50,$1269.00,$57121.25,9,$1269.00
2024-01-12,17:15:00,16940.0,BUY,3,0.02h,Stop Loss,$23.25,$1292.25,$57144.50,9,$1292.25
2024-01-12,17:28:00,16936.0,SELL,3,0.02h,Stop Loss,$49.50,$1341.75,$57194.00,9,$1341.75
2024-01-12,17:31:00,16949.75,BUY,3,0.02h,Stop Loss,$27.00,$1368.75,$57221.00,9,$1368.75
2024-01-12,17:38:00,16935.25,SELL,3,0.02h,Stop Loss,$-18.00,$1350.75,$57203.00,9,$1350.75
2024-01-12,17:54:00,16957.5,BUY,3,0.02h,Stop Loss,$27.00,$1377.75,$57230.00,9,$1377.75
2024-01-12,19:23:00,16969.25,SELL,3,0.02h,Stop Loss,$-18.00,$1359.75,$57212.00,9,$1359.75
2024-01-12,20:30:00,16953.75,BUY,3,0.02h,Stop Loss,$27.00,$1386.75,$57239.00,9,$1386.75
2024-01-12,21:05:00,16959.75,SELL,3,0.02h,Stop Loss,$-18.00,$1368.75,$57221.00,9,$1368.75
2024-01-12,21:58:00,16955.25,BUY,3,0.02h,Break Even,$0.75,$1369.50,$57221.75,9,$1369.50
,,,,,,,,,,,
2024-01-15,12:36:00,16971.5,SELL,3,0.02h,Break Even,$0.75,$0.75,$57222.50,10,$0.75
2024-01-15,13:22:00,16964.25,BUY,3,0.02h,Stop Loss,$-18.00,$-17.25,$57204.50,10,$-17.25
2024-01-15,13:41:00,16959.0,SELL,3,0.02h,Break Even,$0.75,$-16.50,$57205.25,10,$-16.50
2024-01-15,14:27:00,16954.75,BUY,3,0.03h,Stop Loss,$30.75,$14.25,$57236.00,10,$14.25
2024-01-15,14:47:00,16951.25,SELL,3,0.02h,Break Even,$0.75,$15.00,$57236.75,10,$15.00
2024-01-15,15:03:00,16956.25,BUY,3,0.02h,Stop Loss,$-18.00,$-3.00,$57218.75,10,$-3.00
2024-01-15,15:05:00,16949.0,SELL,3,0.02h,Stop Loss,$-18.00,$-21.00,$57200.75,10,$-21.00
2024-01-15,15:26:00,16954.25,BUY,3,0.02h,Stop Loss,$-18.00,$-39.00,$57182.75,10,$-39.00
2024-01-15,16:11:00,16968.5,SELL,3,0.02h,Stop Loss,$-18.00,$-57.00,$57164.75,10,$-57.00
2024-01-15,16:28:00,16972.25,BUY,3,0.03h,Break Even,$0.75,$-56.25,$57165.50,10,$-56.25
2024-01-15,16:47:00,16970.5,SELL,3,0.03h,Stop Loss,$-18.00,$-74.25,$57147.50,10,$-74.25
2024-01-15,17:09:00,16970.25,BUY,3,0.02h,Break Even,$0.75,$-73.50,$57148.25,10,$-73.50
2024-01-15,17:22:00,16965.25,SELL,3,0.02h,Stop Loss,$-18.00,$-91.50,$57130.25,10,$-91.50
2024-01-15,17:27:00,16971.0,BUY,3,0.02h,Break Even,$0.75,$-90.75,$57131.00,10,$-90.75
2024-01-15,17:39:00,16965.5,SELL,3,0.03h,Break Even,$0.75,$-90.00,$57131.75,10,$-90.00
2024-01-15,17:50:00,16969.5,BUY,3,0.02h,Stop Loss,$-18.00,$-108.00,$57113.75,10,$-108.00
2024-01-15,17:52:00,16966.5,SELL,3,0.02h,Stop Loss,$-18.00,$-126.00,$57095.75,10,$-126.00
2024-01-15,17:56:00,16969.0,BUY,3,0.03h,Stop Loss,$-18.00,$-144.00,$57077.75,10,$-144.00
,,,,,,,,,,,
2024-01-16,12:00:00,16881.25,SELL,3,0.02h,Stop Loss,$-18.00,$-18.00,$57059.75,11,$-18.00
2024-01-16,12:34:00,16894.5,BUY,3,0.02h,Stop Loss,$-18.00,$-36.00,$57041.75,11,$-36.00
2024-01-16,12:36:00,16889.0,SELL,3,0.02h,Stop Loss,$-18.00,$-54.00,$57023.75,11,$-54.00
2024-01-16,12:37:00,16894.75,BUY,3,0.02h,Stop Loss,$12.00,$-42.00,$57035.75,11,$-42.00
2024-01-16,13:07:00,16905.5,SELL,3,0.02h,Stop Loss,$15.75,$-26.25,$57051.50,11,$-26.25
2024-01-16,13:34:00,16909.0,BUY,3,0.02h,Stop Loss,$158.25,$132.00,$57209.75,11,$132.00
2024-01-16,13:52:00,16901.25,SELL,3,0.02h,Stop Loss,$38.25,$170.25,$57248.00,11,$170.25
2024-01-16,14:27:00,16905.75,BUY,3,0.02h,Break Even,$0.75,$171.00,$57248.75,11,$171.00
2024-01-16,14:42:00,16884.0,SELL,3,0.02h,Stop Loss,$158.25,$329.25,$57407.00,11,$329.25
2024-01-16,14:59:00,16903.75,BUY,3,0.02h,Stop Loss,$192.00,$521.25,$57599.00,11,$521.25
2024-01-16,16:01:00,16977.75,SELL,3,0.02h,Stop Loss,$604.50,$1125.75,$58203.50,11,$1125.75
2024-01-16,16:20:00,16989.75,BUY,3,0.02h,Stop Loss,$72.00,$1197.75,$58275.50,11,$1197.75
2024-01-16,16:43:00,16997.0,SELL,3,0.02h,Stop Loss,$199.50,$1397.25,$58475.00,11,$1397.25
2024-01-16,18:12:00,16911.5,BUY,3,0.02h,Stop Loss,$-18.00,$1379.25,$58457.00,11,$1379.25
2024-01-16,18:43:00,16921.0,SELL,3,0.02h,Stop Loss,$42.00,$1421.25,$58499.00,11,$1421.25
2024-01-16,19:29:00,16894.75,BUY,3,0.02h,Break Even,$0.75,$1422.00,$58499.75,11,$1422.00
2024-01-16,19:32:00,16882.0,SELL,3,0.02h,Break Even,$0.75,$1422.75,$58500.50,11,$1422.75
2024-01-16,19:35:00,16898.0,BUY,3,0.02h,Break Even,$0.75,$1423.50,$58501.25,11,$1423.50
2024-01-16,20:32:00,16929.0,SELL,3,0.02h,Break Even,$0.75,$1424.25,$58502.00,11,$1424.25
2024-01-16,20:41:00,16936.0,BUY,3,0.02h,Break Even,$0.75,$1425.00,$58502.75,11,$1425.00
,,,,,,,,,,,
2024-01-17,12:00:00,16891.75,SELL,3,0.02h,Stop Loss,$-18.00,$-18.00,$58484.75,12,$-18.00
2024-01-17,12:56:00,16899.25,BUY,3,0.02h,Break Even,$0.75,$-17.25,$58485.50,12,$-17.25
2024-01-17,13:01:00,16882.5,SELL,3,0.02h,Break Even,$0.75,$-16.50,$58486.25,12,$-16.50
2024-01-17,14:11:00,16834.0,BUY,3,0.02h,Break Even,$0.75,$-15.75,$58487.00,12,$-15.75
2024-01-17,14:25:00,16821.5,SELL,3,0.02h,Stop Loss,$12.00,$-3.75,$58499.00,12,$-3.75
2024-01-17,15:10:00,16735.5,BUY,3,0.02h,Stop Loss,$-18.00,$-21.75,$58481.00,12,$-21.75
2024-01-17,15:22:00,16722.75,SELL,3,0.02h,Stop Loss,$45.75,$24.00,$58526.75,12,$24.00
2024-01-17,15:26:00,16745.75,BUY,3,0.02h,Stop Loss,$98.25,$122.25,$58625.00,12,$122.25
2024-01-17,15:58:00,16757.25,SELL,3,0.02h,Stop Loss,$27.00,$149.25,$58652.00,12,$149.25
2024-01-17,16:00:00,16769.25,BUY,3,0.02h,Stop Loss,$109.50,$258.75,$58761.50,12,$258.75
2024-01-17,16:52:00,16803.0,SELL,3,0.02h,Stop Loss,$-18.00,$240.75,$58743.50,12,$240.75
2024-01-17,17:15:00,16817.0,BUY,3,0.02h,Stop Loss,$38.25,$279.00,$58781.75,12,$279.00
2024-01-17,17:22:00,16806.5,SELL,3,0.02h,Stop Loss,$75.75,$354.75,$58857.50,12,$354.75
2024-01-17,17:52:00,16800.0,BUY,3,0.02h,Stop Loss,$38.25,$393.00,$58895.75,12,$393.00
2024-01-17,18:12:00,16792.75,SELL,3,0.02h,Break Even,$0.75,$393.75,$58896.50,12,$393.75
2024-01-17,18:59:00,16763.25,BUY,3,0.02h,Stop Loss,$-18.00,$375.75,$58878.50,12,$375.75
2024-01-17,20:04:00,16811.25,SELL,3,0.02h,Break Even,$0.75,$376.50,$58879.25,12,$376.50
2024-01-17,20:34:00,16818.75,BUY,3,0.02h,Stop Loss,$75.75,$452.25,$58955.00,12,$452.25
2024-01-17,21:13:00,16857.75,SELL,3,0.02h,Stop Loss,$-18.00,$434.25,$58937.00,12,$434.25
2024-01-17,21:16:00,16861.75,BUY,3,0.02h,Stop Loss,$-18.00,$416.25,$58919.00,12,$416.25
2024-01-17,21:58:00,16860.25,SELL,3,0.02h,Stop Loss,$-18.00,$398.25,$58901.00,12,$398.25
,,,,,,,,,,,
2024-01-18,12:00:00,16992.75,BUY,3,0.02h,Break Even,$0.75,$0.75,$58901.75,13,$0.75
2024-01-18,13:00:00,17006.5,SELL,3,0.02h,Stop Loss,$-18.00,$-17.25,$58883.75,13,$-17.25
2024-01-18,13:07:00,17014.5,BUY,3,0.02h,Stop Loss,$12.00,$-5.25,$58895.75,13,$-5.25
2024-01-18,13:31:00,17000.75,SELL,3,0.02h,Stop Loss,$-18.00,$-23.25,$58877.75,13,$-23.25
2024-01-18,13:36:00,17038.25,BUY,3,0.02h,Stop Loss,$49.50,$26.25,$58927.25,13,$26.25
2024-01-18,13:41:00,17006.5,SELL,3,0.02h,Stop Loss,$158.25,$184.50,$59085.50,13,$184.50
2024-01-18,14:07:00,17001.75,BUY,3,0.02h,Stop Loss,$-18.00,$166.50,$59067.50,13,$166.50
2024-01-18,14:24:00,16997.0,SELL,3,0.02h,Stop Loss,$-18.00,$148.50,$59049.50,13,$148.50
2024-01-18,14:31:00,17029.75,BUY,3,0.02h,Stop Loss,$218.25,$366.75,$59267.75,13,$366.75
2024-01-18,14:53:00,17016.0,SELL,3,0.02h,Stop Loss,$94.50,$461.25,$59362.25,13,$461.25
2024-01-18,14:59:00,17029.25,BUY,3,0.02h,Stop Loss,$34.50,$495.75,$59396.75,13,$495.75
2024-01-18,15:03:00,17000.25,SELL,3,0.02h,Stop Loss,$147.00,$642.75,$59543.75,13,$642.75
2024-01-18,15:17:00,17020.75,BUY,3,0.02h,Stop Loss,$184.50,$827.25,$59728.25,13,$827.25
2024-01-18,15:22:00,17007.75,SELL,3,0.02h,Stop Loss,$-18.00,$809.25,$59710.25,13,$809.25
2024-01-18,15:23:00,17027.5,BUY,3,0.02h,Stop Loss,$12.00,$821.25,$59722.25,13,$821.25
2024-01-18,16:01:00,17041.5,SELL,3,0.02h,Stop Loss,$60.75,$882.00,$59783.00,13,$882.00
2024-01-18,16:14:00,17063.0,BUY,3,0.02h,Break Even,$0.75,$882.75,$59783.75,13,$882.75
2024-01-18,16:46:00,17076.75,SELL,3,0.02h,Stop Loss,$49.50,$932.25,$59833.25,13,$932.25
2024-01-18,16:54:00,17088.25,BUY,3,0.02h,Stop Loss,$-18.00,$914.25,$59815.25,13,$914.25
2024-01-18,16:58:00,17079.25,SELL,3,0.02h,Stop Loss,$-18.00,$896.25,$59797.25,13,$896.25
2024-01-18,17:45:00,17020.25,BUY,3,0.02h,Stop Loss,$60.75,$957.00,$59858.00,13,$957.00
2024-01-18,17:53:00,17005.75,SELL,3,0.02h,Stop Loss,$117.00,$1074.00,$59975.00,13,$1074.00
2024-01-18,18:34:00,16982.75,BUY,3,0.02h,Break Even,$0.75,$1074.75,$59975.75,13,$1074.75
2024-01-18,19:48:00,17071.0,SELL,3,0.02h,Stop Loss,$-18.00,$1056.75,$59957.75,13,$1056.75
2024-01-18,19:50:00,17094.5,BUY,3,0.02h,Stop Loss,$38.25,$1095.00,$59996.00,13,$1095.00
2024-01-18,20:40:00,17093.0,SELL,3,0.02h,Stop Loss,$60.75,$1155.75,$60056.75,13,$1155.75
2024-01-18,20:47:00,17107.5,BUY,3,0.02h,Stop Loss,$23.25,$1179.00,$60080.00,13,$1179.00
2024-01-18,21:01:00,17095.5,SELL,3,0.02h,Break Even,$0.75,$1179.75,$60080.75,13,$1179.75
2024-01-18,21:16:00,17107.25,BUY,3,0.02h,Stop Loss,$45.75,$1225.50,$60126.50,13,$1225.50
2024-01-18,21:47:00,17114.75,SELL,3,0.02h,Stop Loss,$-18.00,$1207.50,$60108.50,13,$1207.50
2024-01-18,21:53:00,17119.5,BUY,3,0.02h,Stop Loss,$-18.00,$1189.50,$60090.50,13,$1189.50
2024-01-18,21:57:00,17115.5,SELL,3,0.02h,Stop Loss,$-18.00,$1171.50,$60072.50,13,$1171.50
,,,,,,,,,,,
2024-01-19,12:00:00,17247.0,BUY,3,0.02h,Stop Loss,$-18.00,$-18.00,$60054.50,14,$-18.00
2024-01-19,12:41:00,17218.75,SELL,3,0.02h,Break Even,$0.75,$-17.25,$60055.25,14,$-17.25
2024-01-19,12:52:00,17226.0,BUY,3,0.02h,Stop Loss,$30.75,$13.50,$60086.00,14,$13.50
2024-01-19,13:27:00,17234.75,SELL,3,0.02h,Break Even,$0.75,$14.25,$60086.75,14,$14.25
2024-01-19,14:25:00,17221.5,BUY,3,0.02h,Stop Loss,$-18.00,$-3.75,$60068.75,14,$-3.75
2024-01-19,14:26:00,17207.0,SELL,3,0.02h,Stop Loss,$-18.00,$-21.75,$60050.75,14,$-21.75
2024-01-19,14:54:00,17207.0,BUY,3,0.02h,Stop Loss,$42.00,$20.25,$60092.75,14,$20.25
2024-01-19,15:08:00,17182.0,SELL,3,0.02h,Stop Loss,$150.75,$171.00,$60243.50,14,$171.00
2024-01-19,15:19:00,17209.5,BUY,3,0.02h,Stop Loss,$60.75,$231.75,$60304.25,14,$231.75
2024-01-19,16:36:00,17245.25,SELL,3,0.02h,Stop Loss,$83.25,$315.00,$60387.50,14,$315.00
2024-01-19,16:53:00,17250.0,BUY,3,0.02h,Stop Loss,$30.75,$345.75,$60418.25,14,$345.75
2024-01-19,17:12:00,17241.25,SELL,3,0.02h,Stop Loss,$-18.00,$327.75,$60400.25,14,$327.75
2024-01-19,17:15:00,17258.75,BUY,3,0.02h,Stop Loss,$34.50,$362.25,$60434.75,14,$362.25
2024-01-19,19:34:00,17406.25,SELL,3,0.02h,Stop Loss,$147.00,$509.25,$60581.75,14,$509.25
2024-01-19,19:42:00,17420.75,BUY,3,0.02h,Stop Loss,$-18.00,$491.25,$60563.75,14,$491.25
2024-01-19,20:22:00,17423.0,SELL,3,0.02h,Break Even,$0.75,$492.00,$60564.50,14,$492.00
2024-01-19,20:35:00,17435.5,BUY,3,0.02h,Stop Loss,$23.25,$515.25,$60587.75,14,$515.25
2024-01-19,20:41:00,17427.5,SELL,3,0.02h,Stop Loss,$-18.00,$497.25,$60569.75,14,$497.25
2024-01-19,20:42:00,17433.0,BUY,3,0.02h,Stop Loss,$12.00,$509.25,$60581.75,14,$509.25
2024-01-19,20:45:00,17426.0,SELL,3,0.02h,Break Even,$0.75,$510.00,$60582.50,14,$510.00
2024-01-19,20:46:00,17435.25,BUY,3,0.02h,Stop Loss,$19.50,$529.50,$60602.00,14,$529.50
2024-01-19,22:00:00,17463.25,SELL,3,62.00h,Stop Loss,$-18.00,$511.50,$60584.00,14,$511.50
,,,,,,,,,,,
2024-01-22,12:00:00,17535.75,BUY,3,0.02h,Break Even,$0.75,$0.75,$60584.75,15,$0.75
2024-01-22,13:02:00,17567.0,SELL,3,0.02h,Stop Loss,$64.50,$65.25,$60649.25,15,$65.25
2024-01-22,13:30:00,17560.0,BUY,3,0.02h,Stop Loss,$-18.00,$47.25,$60631.25,15,$47.25
2024-01-22,13:31:00,17551.75,SELL,3,0.02h,Stop Loss,$45.75,$93.00,$60677.00,15,$93.00
2024-01-22,14:24:00,17530.75,BUY,3,0.02h,Stop Loss,$-18.00,$75.00,$60659.00,15,$75.00
2024-01-22,14:43:00,17514.0,SELL,3,0.02h,Stop Loss,$267.00,$342.00,$60926.00,15,$342.00
2024-01-22,14:54:00,17541.0,BUY,3,0.02h,Stop Loss,$23.25,$365.25,$60949.25,15,$365.25
2024-01-22,15:04:00,17522.0,SELL,3,0.02h,Stop Loss,$270.75,$636.00,$61220.00,15,$636.00
2024-01-22,15:15:00,17538.25,BUY,3,0.02h,Stop Loss,$30.75,$666.75,$61250.75,15,$666.75
2024-01-22,15:20:00,17514.5,SELL,3,0.02h,Stop Loss,$57.00,$723.75,$61307.75,15,$723.75
2024-01-22,16:11:00,17472.5,BUY,3,0.02h,Break Even,$0.75,$724.50,$61308.50,15,$724.50
2024-01-22,17:07:00,17479.75,SELL,3,0.02h,Stop Loss,$199.50,$924.00,$61508.00,15,$924.00
2024-01-22,17:23:00,17493.75,BUY,3,0.02h,Stop Loss,$23.25,$947.25,$61531.25,15,$947.25
2024-01-22,17:35:00,17477.0,SELL,3,0.02h,Stop Loss,$64.50,$1011.75,$61595.75,15,$1011.75
2024-01-22,17:54:00,17490.75,BUY,3,0.02h,Break Even,$0.75,$1012.50,$61596.50,15,$1012.50
2024-01-22,18:01:00,17470.75,SELL,3,0.02h,Stop Loss,$34.50,$1047.00,$61631.00,15,$1047.00
2024-01-22,18:39:00,17466.0,BUY,3,0.02h,Break Even,$0.75,$1047.75,$61631.75,15,$1047.75
2024-01-22,19:14:00,17473.0,SELL,3,0.02h,Stop Loss,$38.25,$1086.00,$61670.00,15,$1086.00
2024-01-22,19:38:00,17466.0,BUY,3,0.02h,Stop Loss,$34.50,$1120.50,$61704.50,15,$1120.50
2024-01-22,19:49:00,17458.5,SELL,3,0.02h,Stop Loss,$-18.00,$1102.50,$61686.50,15,$1102.50
2024-01-22,19:57:00,17466.0,BUY,3,0.02h,Stop Loss,$-18.00,$1084.50,$61668.50,15,$1084.50
2024-01-22,20:03:00,17459.25,SELL,3,0.02h,Break Even,$0.75,$1085.25,$61669.25,15,$1085.25
2024-01-22,20:11:00,17473.25,BUY,3,0.02h,Stop Loss,$15.75,$1101.00,$61685.00,15,$1101.00
2024-01-22,20:43:00,17470.75,SELL,3,0.02h,Break Even,$0.75,$1101.75,$61685.75,15,$1101.75
2024-01-22,21:30:00,17454.5,BUY,3,0.02h,Stop Loss,$-18.00,$1083.75,$61667.75,15,$1083.75
2024-01-22,21:57:00,17456.25,SELL,3,0.03h,Stop Loss,$-18.00,$1065.75,$61649.75,15,$1065.75
,,,,,,,,,,,
2024-01-23,12:00:00,17474.25,BUY,3,0.02h,Break Even,$0.75,$0.75,$61650.50,16,$0.75
2024-01-23,12:28:00,17469.0,SELL,3,0.03h,Break Even,$0.75,$1.50,$61651.25,16,$1.50
2024-01-23,12:37:00,17473.75,BUY,3,0.02h,Break Even,$0.75,$2.25,$61652.00,16,$2.25
2024-01-23,12:49:00,17470.25,SELL,3,0.02h,Break Even,$0.75,$3.00,$61652.75,16,$3.00
2024-01-23,12:57:00,17479.5,BUY,3,0.02h,Break Even,$0.75,$3.75,$61653.50,16,$3.75
2024-01-23,13:52:00,17503.25,SELL,3,0.02h,Stop Loss,$-18.00,$-14.25,$61635.50,16,$-14.25
2024-01-23,14:51:00,17476.0,BUY,3,0.02h,Stop Loss,$23.25,$9.00,$61658.75,16,$9.00
2024-01-23,15:07:00,17467.5,SELL,3,0.02h,Break Even,$0.75,$9.75,$61659.50,16,$9.75
2024-01-23,15:08:00,17473.25,BUY,3,0.02h,Stop Loss,$45.75,$55.50,$61705.25,16,$55.50
2024-01-23,15:10:00,17466.75,SELL,3,0.02h,Stop Loss,$38.25,$93.75,$61743.50,16,$93.75
2024-01-23,15:12:00,17479.5,BUY,3,0.02h,Stop Loss,$30.75,$124.50,$61774.25,16,$124.50
2024-01-23,15:19:00,17455.75,SELL,3,0.02h,Stop Loss,$27.00,$151.50,$61801.25,16,$151.50
2024-01-23,15:39:00,17466.75,BUY,3,0.02h,Stop Loss,$60.75,$212.25,$61862.00,16,$212.25
2024-01-23,15:51:00,17457.75,SELL,3,0.02h,Stop Loss,$53.25,$265.50,$61915.25,16,$265.50
2024-01-23,16:04:00,17466.0,BUY,3,0.02h,Stop Loss,$45.75,$311.25,$61961.00,16,$311.25
2024-01-23,16:17:00,17448.75,SELL,3,0.02h,Stop Loss,$79.50,$390.75,$62040.50,16,$390.75
2024-01-23,16:46:00,17450.75,BUY,3,0.02h,Stop Loss,$57.00,$447.75,$62097.50,16,$447.75
2024-01-23,17:17:00,17453.25,SELL,3,0.02h,Break Even,$0.75,$448.50,$62098.25,16,$448.50
2024-01-23,17:43:00,17454.75,BUY,3,0.02h,Stop Loss,$-18.00,$430.50,$62080.25,16,$430.50
2024-01-23,18:30:00,17476.5,SELL,3,0.02h,Stop Loss,$-18.00,$412.50,$62062.25,16,$412.50
2024-01-23,18:49:00,17480.25,BUY,3,0.02h,Break Even,$0.75,$413.25,$62063.00,16,$413.25
2024-01-23,19:07:00,17473.75,SELL,3,0.02h,Stop Loss,$34.50,$447.75,$62097.50,16,$447.75
2024-01-23,19:39:00,17478.0,BUY,3,0.02h,Stop Loss,$-18.00,$429.75,$62079.50,16,$429.75
2024-01-23,20:36:00,17503.25,SELL,3,0.02h,Break Even,$0.75,$430.50,$62080.25,16,$430.50
2024-01-23,20:47:00,17513.0,BUY,3,0.02h,Stop Loss,$-18.00,$412.50,$62062.25,16,$412.50
2024-01-23,20:50:00,17503.5,SELL,3,0.02h,Break Even,$0.75,$413.25,$62063.00,16,$413.25
2024-01-23,20:51:00,17519.0,BUY,3,0.02h,Stop Loss,$30.75,$444.00,$62093.75,16,$444.00
2024-01-23,21:11:00,17520.25,SELL,3,0.02h,Break Even,$0.75,$444.75,$62094.50,16,$444.75
2024-01-23,21:15:00,17531.5,BUY,3,0.02h,Break Even,$0.75,$445.50,$62095.25,16,$445.50
,,,,,,,,,,,
2024-01-24,13:40:00,17678.75,SELL,3,0.02h,Break Even,$0.75,$0.75,$62096.00,17,$0.75
2024-01-24,14:15:00,17670.5,BUY,3,0.02h,Break Even,$0.75,$1.50,$62096.75,17,$1.50
2024-01-24,14:33:00,17667.75,SELL,3,0.02h,Stop Loss,$-18.00,$-16.50,$62078.75,17,$-16.50
2024-01-24,14:54:00,17668.25,BUY,3,0.02h,Break Even,$0.75,$-15.75,$62079.50,17,$-15.75
2024-01-24,15:02:00,17648.25,SELL,3,0.02h,Break Even,$0.75,$-15.00,$62080.25,17,$-15.00
2024-01-24,15:09:00,17681.25,BUY,3,0.02h,Stop Loss,$-18.00,$-33.00,$62062.25,17,$-33.00
2024-01-24,15:57:00,17732.25,SELL,3,0.02h,Break Even,$0.75,$-32.25,$62063.00,17,$-32.25
2024-01-24,16:01:00,17740.5,BUY,3,0.02h,Stop Loss,$-18.00,$-50.25,$62045.00,17,$-50.25
2024-01-24,16:07:00,17717.75,SELL,3,0.02h,Stop Loss,$237.00,$186.75,$62282.00,17,$186.75
2024-01-24,16:38:00,17718.0,BUY,3,0.02h,Stop Loss,$-18.00,$168.75,$62264.00,17,$168.75
2024-01-24,16:46:00,17708.75,SELL,3,0.02h,Break Even,$0.75,$169.50,$62264.75,17,$169.50
2024-01-24,16:49:00,17722.25,BUY,3,0.02h,Stop Loss,$45.75,$215.25,$62310.50,17,$215.25
2024-01-24,17:20:00,17740.75,SELL,3,0.02h,Stop Loss,$38.25,$253.50,$62348.75,17,$253.50
2024-01-24,17:23:00,17748.75,BUY,3,0.02h,Stop Loss,$19.50,$273.00,$62368.25,17,$273.00
2024-01-24,18:02:00,17758.5,SELL,3,0.02h,Stop Loss,$117.00,$390.00,$62485.25,17,$390.00
2024-01-24,18:29:00,17763.75,BUY,3,0.02h,Stop Loss,$-18.00,$372.00,$62467.25,17,$372.00
2024-01-24,18:34:00,17739.75,SELL,3,0.02h,Stop Loss,$-18.00,$354.00,$62449.25,17,$354.00
2024-01-24,19:44:00,17675.25,BUY,3,0.02h,Stop Loss,$53.25,$407.25,$62502.50,17,$407.25
2024-01-24,19:58:00,17662.0,SELL,3,0.02h,Break Even,$0.75,$408.00,$62503.25,17,$408.00
2024-01-24,20:07:00,17679.25,BUY,3,0.02h,Stop Loss,$12.00,$420.00,$62515.25,17,$420.00
2024-01-24,20:12:00,17660.0,SELL,3,0.02h,Break Even,$0.75,$420.75,$62516.00,17,$420.75
2024-01-24,20:39:00,17649.5,BUY,3,0.02h,Break Even,$0.75,$421.50,$62516.75,17,$421.50
2024-01-24,20:51:00,17621.0,SELL,3,0.02h,Break Even,$0.75,$422.25,$62517.50,17,$422.25
2024-01-24,21:33:00,17604.75,BUY,3,0.02h,Stop Loss,$-18.00,$404.25,$62499.50,17,$404.25
,,,,,,,,,,,
2024-01-25,12:24:00,17640.5,SELL,3,0.02h,Break Even,$0.75,$0.75,$62500.25,18,$0.75
2024-01-25,12:34:00,17648.5,BUY,3,0.02h,Stop Loss,$-18.00,$-17.25,$62482.25,18,$-17.25
2024-01-25,12:36:00,17642.5,SELL,3,0.02h,Stop Loss,$-18.00,$-35.25,$62464.25,18,$-35.25
2024-01-25,12:37:00,17646.75,BUY,3,0.02h,Break Even,$0.75,$-34.50,$62465.00,18,$-34.50
2024-01-25,12:56:00,17643.75,SELL,3,0.02h,Stop Loss,$19.50,$-15.00,$62484.50,18,$-15.00
2024-01-25,13:17:00,17649.0,BUY,3,0.02h,Stop Loss,$19.50,$4.50,$62504.00,18,$4.50
2024-01-25,14:31:00,17687.75,SELL,3,0.02h,Stop Loss,$60.75,$65.25,$62564.75,18,$65.25
2024-01-25,15:10:00,17698.25,BUY,3,0.02h,Stop Loss,$94.50,$159.75,$62659.25,18,$159.75
2024-01-25,15:37:00,17694.5,SELL,3,0.02h,Stop Loss,$19.50,$179.25,$62678.75,18,$179.25
2024-01-25,15:45:00,17720.75,BUY,3,0.02h,Break Even,$0.75,$180.00,$62679.50,18,$180.00
2024-01-25,15:50:00,17697.75,SELL,3,0.02h,Stop Loss,$64.50,$244.50,$62744.00,18,$244.50
2024-01-25,16:13:00,17709.75,BUY,3,0.02h,Stop Loss,$105.75,$350.25,$62849.75,18,$350.25
2024-01-25,16:43:00,17705.0,SELL,3,0.02h,Stop Loss,$-18.00,$332.25,$62831.75,18,$332.25
2024-01-25,16:48:00,17722.5,BUY,3,0.02h,Stop Loss,$150.75,$483.00,$62982.50,18,$483.00
2024-01-25,17:02:00,17720.0,SELL,3,0.02h,Stop Loss,$72.00,$555.00,$63054.50,18,$555.00
2024-01-25,18:03:00,17670.75,BUY,3,0.02h,Stop Loss,$53.25,$608.25,$63107.75,18,$608.25
2024-01-25,18:16:00,17646.5,SELL,3,0.02h,Stop Loss,$147.00,$755.25,$63254.75,18,$755.25
2024-01-25,18:45:00,17634.75,BUY,3,0.02h,Stop Loss,$19.50,$774.75,$63274.25,18,$774.75
2024-01-25,18:54:00,17620.75,SELL,3,0.02h,Stop Loss,$109.50,$884.25,$63383.75,18,$884.25
2024-01-25,19:31:00,17576.0,BUY,3,0.02h,Stop Loss,$45.75,$930.00,$63429.50,18,$930.00
2024-01-25,19:39:00,17565.5,SELL,3,0.02h,Stop Loss,$-18.00,$912.00,$63411.50,18,$912.00
2024-01-25,19:43:00,17574.5,BUY,3,0.02h,Stop Loss,$12.00,$924.00,$63423.50,18,$924.00
2024-01-25,20:25:00,17590.5,SELL,3,0.02h,Stop Loss,$-18.00,$906.00,$63405.50,18,$906.00
2024-01-25,20:33:00,17614.25,BUY,3,0.02h,Stop Loss,$143.25,$1049.25,$63548.75,18,$1049.25
2024-01-25,20:45:00,17604.25,SELL,3,0.02h,Break Even,$0.75,$1050.00,$63549.50,18,$1050.00
2024-01-25,20:48:00,17610.0,BUY,3,0.02h,Break Even,$0.75,$1050.75,$63550.25,18,$1050.75
2024-01-25,21:08:00,17606.5,SELL,3,0.02h,Break Even,$0.75,$1051.50,$63551.00,18,$1051.50
2024-01-25,21:33:00,17606.25,BUY,3,0.02h,Stop Loss,$-18.00,$1033.50,$63533.00,18,$1033.50
2024-01-25,21:39:00,17598.25,SELL,3,0.02h,Break Even,$0.75,$1034.25,$63533.75,18,$1034.25
2024-01-25,21:41:00,17605.0,BUY,3,0.02h,Stop Loss,$34.50,$1068.75,$63568.25,18,$1068.75
2024-01-25,21:47:00,17596.25,SELL,3,0.02h,Break Even,$0.75,$1069.50,$63569.00,18,$1069.50
,,,,,,,,,,,
2024-01-26,12:19:00,17577.25,BUY,3,0.02h,Break Even,$0.75,$0.75,$63569.75,19,$0.75
2024-01-26,12:52:00,17573.0,SELL,3,0.02h,Stop Loss,$-18.00,$-17.25,$63551.75,19,$-17.25
2024-01-26,13:08:00,17580.75,BUY,3,0.02h,Stop Loss,$12.00,$-5.25,$63563.75,19,$-5.25
2024-01-26,13:20:00,17573.25,SELL,3,0.02h,Stop Loss,$-18.00,$-23.25,$63545.75,19,$-23.25
2024-01-26,13:21:00,17580.75,BUY,3,0.02h,Break Even,$0.75,$-22.50,$63546.50,19,$-22.50
2024-01-26,13:24:00,17575.5,SELL,3,0.02h,Break Even,$0.75,$-21.75,$63547.25,19,$-21.75
2024-01-26,13:43:00,17586.25,BUY,3,0.02h,Stop Loss,$-18.00,$-39.75,$63529.25,19,$-39.75
2024-01-26,14:04:00,17578.0,SELL,3,0.02h,Stop Loss,$135.75,$96.00,$63665.00,19,$96.00
2024-01-26,14:34:00,17567.25,BUY,3,0.02h,Stop Loss,$15.75,$111.75,$63680.75,19,$111.75
2024-01-26,14:36:00,17549.25,SELL,3,0.02h,Stop Loss,$218.25,$330.00,$63899.00,19,$330.00
2024-01-26,15:15:00,17541.5,BUY,3,0.02h,Stop Loss,$-18.00,$312.00,$63881.00,19,$312.00
2024-01-26,15:17:00,17528.5,SELL,3,0.02h,Stop Loss,$128.25,$440.25,$64009.25,19,$440.25
2024-01-26,15:22:00,17553.25,BUY,3,0.02h,Stop Loss,$83.25,$523.50,$64092.50,19,$523.50
2024-01-26,16:15:00,17595.0,SELL,3,0.02h,Stop Loss,$-18.00,$505.50,$64074.50,19,$505.50
2024-01-26,16:24:00,17612.75,BUY,3,0.02h,Stop Loss,$-18.00,$487.50,$64056.50,19,$487.50
2024-01-26,16:38:00,17595.75,SELL,3,0.02h,Stop Loss,$143.25,$630.75,$64199.75,19,$630.75
2024-01-26,16:53:00,17602.25,BUY,3,0.02h,Break Even,$0.75,$631.50,$64200.50,19,$631.50
2024-01-26,17:26:00,17604.5,SELL,3,0.02h,Stop Loss,$98.25,$729.75,$64298.75,19,$729.75
2024-01-26,18:13:00,17540.25,BUY,3,0.02h,Stop Loss,$-18.00,$711.75,$64280.75,19,$711.75
2024-01-26,18:16:00,17528.0,SELL,3,0.02h,Stop Loss,$30.75,$742.50,$64311.50,19,$742.50
2024-01-26,18:24:00,17541.0,BUY,3,0.02h,Stop Loss,$-18.00,$724.50,$64293.50,19,$724.50
2024-01-26,18:42:00,17521.25,SELL,3,0.02h,Stop Loss,$94.50,$819.00,$64388.00,19,$819.00
2024-01-26,19:03:00,17530.75,BUY,3,0.02h,Stop Loss,$45.75,$864.75,$64433.75,19,$864.75
2024-01-26,19:24:00,17527.75,SELL,3,0.02h,Stop Loss,$27.00,$891.75,$64460.75,19,$891.75
2024-01-26,19:38:00,17539.75,BUY,3,0.02h,Break Even,$0.75,$892.50,$64461.50,19,$892.50
2024-01-26,20:10:00,17551.5,SELL,3,0.02h,Stop Loss,$-18.00,$874.50,$64443.50,19,$874.50
2024-01-26,20:11:00,17557.25,BUY,3,0.02h,Stop Loss,$-18.00,$856.50,$64425.50,19,$856.50
2024-01-26,20:12:00,17552.0,SELL,3,0.02h,Break Even,$0.75,$857.25,$64426.25,19,$857.25
2024-01-26,20:14:00,17558.25,BUY,3,0.02h,Stop Loss,$27.00,$884.25,$64453.25,19,$884.25
2024-01-26,20:22:00,17547.75,SELL,3,0.02h,Stop Loss,$64.50,$948.75,$64517.75,19,$948.75
2024-01-26,22:00:00,17504.75,BUY,3,62.00h,Stop Loss,$927.00,$1875.75,$65444.75,19,$1875.75
,,,,,,,,,,,
2024-01-29,12:37:00,17561.25,SELL,3,0.02h,Stop Loss,$53.25,$53.25,$65498.00,20,$53.25
2024-01-29,13:09:00,17564.0,BUY,3,0.02h,Stop Loss,$-18.00,$35.25,$65480.00,20,$35.25
2024-01-29,13:20:00,17552.0,SELL,3,0.02h,Break Even,$0.75,$36.00,$65480.75,20,$36.00
2024-01-29,13:55:00,17548.75,BUY,3,0.02h,Stop Loss,$-18.00,$18.00,$65462.75,20,$18.00
2024-01-29,14:02:00,17541.25,SELL,3,0.02h,Break Even,$0.75,$18.75,$65463.50,20,$18.75
2024-01-29,14:07:00,17548.25,BUY,3,0.02h,Break Even,$0.75,$19.50,$65464.25,20,$19.50
2024-01-29,14:16:00,17543.25,SELL,3,0.02h,Stop Loss,$19.50,$39.00,$65483.75,20,$39.00
2024-01-29,14:23:00,17551.25,BUY,3,0.02h,Break Even,$0.75,$39.75,$65484.50,20,$39.75
2024-01-29,14:31:00,17537.5,SELL,3,0.02h,Stop Loss,$68.25,$108.00,$65552.75,20,$108.00
2024-01-29,14:35:00,17553.25,BUY,3,0.02h,Stop Loss,$83.25,$191.25,$65636.00,20,$191.25
2024-01-29,14:58:00,17557.25,SELL,3,0.02h,Stop Loss,$38.25,$229.50,$65674.25,20,$229.50
2024-01-29,15:15:00,17560.25,BUY,3,0.02h,Stop Loss,$75.75,$305.25,$65750.00,20,$305.25
2024-01-29,15:23:00,17538.75,SELL,3,0.02h,Stop Loss,$23.25,$328.50,$65773.25,20,$328.50
2024-01-29,15:32:00,17560.5,BUY,3,0.02h,Break Even,$0.75,$329.25,$65774.00,20,$329.25
2024-01-29,15:33:00,17550.25,SELL,3,0.02h,Stop Loss,$248.25,$577.50,$66022.25,20,$577.50
2024-01-29,16:12:00,17543.0,BUY,3,0.02h,Break Even,$0.75,$578.25,$66023.00,20,$578.25
2024-01-29,17:47:00,17583.75,SELL,3,0.02h,Stop Loss,$-18.00,$560.25,$66005.00,20,$560.25
2024-01-29,17:57:00,17603.5,BUY,3,0.02h,Break Even,$0.75,$561.00,$66005.75,20,$561.00
2024-01-29,18:02:00,17585.25,SELL,3,0.02h,Break Even,$0.75,$561.75,$66006.50,20,$561.75
2024-01-29,18:22:00,17592.75,BUY,3,0.02h,Stop Loss,$-18.00,$543.75,$65988.50,20,$543.75
2024-01-29,18:23:00,17587.75,SELL,3,0.02h,Stop Loss,$-18.00,$525.75,$65970.50,20,$525.75
2024-01-29,18:26:00,17597.25,BUY,3,0.02h,Break Even,$0.75,$526.50,$65971.25,20,$526.50
2024-01-29,18:53:00,17592.5,SELL,3,0.02h,Break Even,$0.75,$527.25,$65972.00,20,$527.25
2024-01-29,19:08:00,17596.75,BUY,3,0.02h,Break Even,$0.75,$528.00,$65972.75,20,$528.00
2024-01-29,19:54:00,17621.25,SELL,3,0.02h,Break Even,$0.75,$528.75,$65973.50,20,$528.75
2024-01-29,19:56:00,17626.75,BUY,3,0.02h,Break Even,$0.75,$529.50,$65974.25,20,$529.50
2024-01-29,20:45:00,17692.75,SELL,3,0.02h,Stop Loss,$113.25,$642.75,$66087.50,20,$642.75
2024-01-29,20:58:00,17698.5,BUY,3,0.02h,Stop Loss,$60.75,$703.50,$66148.25,20,$703.50
2024-01-29,21:07:00,17689.75,SELL,3,0.02h,Stop Loss,$-18.00,$685.50,$66130.25,20,$685.50
2024-01-29,21:16:00,17703.25,BUY,3,0.02h,Stop Loss,$23.25,$708.75,$66153.50,20,$708.75
2024-01-29,21:46:00,17701.5,SELL,3,0.02h,Stop Loss,$-18.00,$690.75,$66135.50,20,$690.75
,,,,,,,,,,,
2024-01-30,12:23:00,17698.75,BUY,3,0.02h,Stop Loss,$-18.00,$-18.00,$66117.50,21,$-18.00
2024-01-30,12:27:00,17693.0,SELL,3,0.02h,Stop Loss,$12.00,$-6.00,$66129.50,21,$-6.00
2024-01-30,13:31:00,17668.5,BUY,3,0.02h,Break Even,$0.75,$-5.25,$66130.25,21,$-5.25
2024-01-30,13:37:00,17660.0,SELL,3,0.02h,Stop Loss,$-18.00,$-23.25,$66112.25,21,$-23.25
2024-01-30,14:02:00,17664.0,BUY,3,0.02h,Break Even,$0.75,$-22.50,$66113.00,21,$-22.50
2024-01-30,14:15:00,17657.75,SELL,3,0.02h,Break Even,$0.75,$-21.75,$66113.75,21,$-21.75
2024-01-30,14:27:00,17664.75,BUY,3,0.02h,Stop Loss,$15.75,$-6.00,$66129.50,21,$-6.00
2024-01-30,14:56:00,17668.25,SELL,3,0.02h,Stop Loss,$60.75,$54.75,$66190.25,21,$54.75
2024-01-30,15:21:00,17657.0,BUY,3,0.02h,Break Even,$0.75,$55.50,$66191.00,21,$55.50
2024-01-30,15:22:00,17651.25,SELL,3,0.02h,Stop Loss,$42.00,$97.50,$66233.00,21,$97.50
2024-01-30,15:24:00,17657.0,BUY,3,0.02h,Stop Loss,$-18.00,$79.50,$66215.00,21,$79.50
2024-01-30,15:26:00,17644.75,SELL,3,0.02h,Stop Loss,$158.25,$237.75,$66373.25,21,$237.75
2024-01-30,15:32:00,17658.25,BUY,3,0.02h,Stop Loss,$68.25,$306.00,$66441.50,21,$306.00
2024-01-30,15:43:00,17650.0,SELL,3,0.02h,Stop Loss,$128.25,$434.25,$66569.75,21,$434.25
2024-01-30,16:24:00,17639.0,BUY,3,0.02h,Stop Loss,$30.75,$465.00,$66600.50,21,$465.00
2024-01-30,16:55:00,17636.5,SELL,3,0.02h,Stop Loss,$30.75,$495.75,$66631.25,21,$495.75
2024-01-30,18:14:00,17575.5,BUY,3,0.02h,Stop Loss,$19.50,$515.25,$66650.75,21,$515.25
2024-01-30,18:45:00,17583.5,SELL,3,0.02h,Stop Loss,$68.25,$583.50,$66719.00,21,$583.50
2024-01-30,19:24:00,17577.5,BUY,3,0.02h,Break Even,$0.75,$584.25,$66719.75,21,$584.25
2024-01-30,20:06:00,17579.75,SELL,3,0.02h,Break Even,$0.75,$585.00,$66720.50,21,$585.00
2024-01-30,20:21:00,17590.5,BUY,3,0.02h,Stop Loss,$12.00,$597.00,$66732.50,21,$597.00
2024-01-30,20:35:00,17580.5,SELL,3,0.02h,Break Even,$0.75,$597.75,$66733.25,21,$597.75
2024-01-30,20:48:00,17593.5,BUY,3,0.02h,Stop Loss,$12.00,$609.75,$66745.25,21,$609.75
2024-01-30,20:55:00,17582.0,SELL,3,0.02h,Stop Loss,$-18.00,$591.75,$66727.25,21,$591.75
2024-01-30,21:01:00,17594.75,BUY,3,0.02h,Stop Loss,$135.75,$727.50,$66863.00,21,$727.50
2024-01-30,21:02:00,17578.75,SELL,3,0.02h,Stop Loss,$683.25,$1410.75,$67546.25,21,$1410.75
,,,,,,,,,,,
2024-01-31,12:47:00,17404.0,BUY,3,0.02h,Stop Loss,$15.75,$15.75,$67562.00,22,$15.75
2024-01-31,13:28:00,17425.25,SELL,3,0.02h,Stop Loss,$-18.00,$-2.25,$67544.00,22,$-2.25
2024-01-31,13:31:00,17435.75,BUY,3,0.02h,Stop Loss,$-18.00,$-20.25,$67526.00,22,$-20.25
2024-01-31,13:36:00,17422.0,SELL,3,0.02h,Stop Loss,$135.75,$115.50,$67661.75,22,$115.50
2024-01-31,14:34:00,17408.0,BUY,3,0.02h,Stop Loss,$225.75,$341.25,$67887.50,22,$341.25
2024-01-31,14:40:00,17389.5,SELL,3,0.02h,Stop Loss,$278.25,$619.50,$68165.75,22,$619.50
2024-01-31,16:02:00,17319.75,BUY,3,0.02h,Stop Loss,$45.75,$665.25,$68211.50,22,$665.25
2024-01-31,16:34:00,17327.0,SELL,3,0.02h,Stop Loss,$19.50,$684.75,$68231.00,22,$684.75
2024-01-31,16:38:00,17337.0,BUY,3,0.02h,Break Even,$0.75,$685.50,$68231.75,22,$685.50
2024-01-31,16:42:00,17329.75,SELL,3,0.02h,Break Even,$0.75,$686.25,$68232.50,22,$686.25
2024-01-31,16:45:00,17336.0,BUY,3,0.02h,Stop Loss,$79.50,$765.75,$68312.00,22,$765.75
2024-01-31,16:54:00,17321.25,SELL,3,0.02h,Stop Loss,$-18.00,$747.75,$68294.00,22,$747.75
2024-01-31,16:57:00,17340.75,BUY,3,0.02h,Stop Loss,$12.00,$759.75,$68306.00,22,$759.75
2024-01-31,17:24:00,17347.5,SELL,3,0.02h,Stop Loss,$-18.00,$741.75,$68288.00,22,$741.75
2024-01-31,17:27:00,17359.0,BUY,3,0.02h,Break Even,$0.75,$742.50,$68288.75,22,$742.50
2024-01-31,17:36:00,17349.0,SELL,3,0.02h,Stop Loss,$72.00,$814.50,$68360.75,22,$814.50
2024-01-31,17:52:00,17360.75,BUY,3,0.02h,Stop Loss,$-18.00,$796.50,$68342.75,22,$796.50
2024-01-31,18:29:00,17375.5,SELL,3,0.02h,Stop Loss,$12.00,$808.50,$68354.75,22,$808.50
2024-01-31,18:47:00,17391.25,BUY,3,0.02h,Break Even,$0.75,$809.25,$68355.50,22,$809.25
2024-01-31,19:00:00,17381.0,SELL,3,0.02h,Stop Loss,$709.50,$1518.75,$69065.00,22,$1518.75
2024-01-31,19:33:00,17363.5,BUY,3,0.02h,Stop Loss,$72.00,$1590.75,$69137.00,22,$1590.75
2024-01-31,20:00:00,17379.0,SELL,3,0.02h,Stop Loss,$278.25,$1869.00,$69415.25,22,$1869.00
2024-01-31,21:11:00,17263.0,BUY,3,0.02h,Stop Loss,$34.50,$1903.50,$69449.75,22,$1903.50
2024-01-31,21:25:00,17255.25,SELL,3,0.02h,Break Even,$0.75,$1904.25,$69450.50,22,$1904.25
2024-01-31,21:38:00,17262.75,BUY,3,0.02h,Break Even,$0.75,$1905.00,$69451.25,22,$1905.00
2024-01-31,21:41:00,17249.75,SELL,3,0.02h,Break Even,$0.75,$1905.75,$69452.00,22,$1905.75
2024-01-31,21:51:00,17259.0,BUY,3,0.02h,Stop Loss,$30.75,$1936.50,$69482.75,22,$1936.50
,,,,,,,,,,,
2024-02-01,12:59:00,17344.25,SELL,3,0.02h,Stop Loss,$-18.00,$-18.00,$69464.75,23,$-18.00
2024-02-01,13:31:00,17343.75,BUY,3,0.02h,Break Even,$0.75,$-17.25,$69465.50,23,$-17.25
2024-02-01,14:01:00,17339.25,SELL,3,0.02h,Stop Loss,$-18.00,$-35.25,$69447.50,23,$-35.25
2024-02-01,14:02:00,17347.25,BUY,3,0.02h,Break Even,$0.75,$-34.50,$69448.25,23,$-34.50
2024-02-01,14:05:00,17326.25,SELL,3,0.02h,Stop Loss,$15.75,$-18.75,$69464.00,23,$-18.75
2024-02-01,14:43:00,17332.25,BUY,3,0.02h,Break Even,$0.75,$-18.00,$69464.75,23,$-18.00
2024-02-01,14:49:00,17310.25,SELL,3,0.02h,Stop Loss,$57.00,$39.00,$69521.75,23,$39.00
2024-02-01,15:08:00,17327.25,BUY,3,0.02h,Stop Loss,$233.25,$272.25,$69755.00,23,$272.25
2024-02-01,15:45:00,17343.25,SELL,3,0.02h,Break Even,$0.75,$273.00,$69755.75,23,$273.00
2024-02-01,16:24:00,17295.0,BUY,3,0.02h,Stop Loss,$15.75,$288.75,$69771.50,23,$288.75
2024-02-01,16:26:00,17283.25,SELL,3,0.02h,Break Even,$0.75,$289.50,$69772.25,23,$289.50
2024-02-01,16:33:00,17296.25,BUY,3,0.02h,Stop Loss,$154.50,$444.00,$69926.75,23,$444.00
2024-02-01,17:28:00,17353.0,SELL,3,0.02h,Stop Loss,$53.25,$497.25,$69980.00,23,$497.25
2024-02-01,17:47:00,17367.5,BUY,3,0.02h,Break Even,$0.75,$498.00,$69980.75,23,$498.00
2024-02-01,18:04:00,17354.75,SELL,3,0.02h,Stop Loss,$195.75,$693.75,$70176.50,23,$693.75
2024-02-01,18:17:00,17369.5,BUY,3,0.02h,Stop Loss,$12.00,$705.75,$70188.50,23,$705.75
2024-02-01,18:39:00,17355.75,SELL,3,0.02h,Stop Loss,$75.75,$781.50,$70264.25,23,$781.50
2024-02-01,18:50:00,17374.75,BUY,3,0.02h,Stop Loss,$83.25,$864.75,$70347.50,23,$864.75
2024-02-01,19:35:00,17383.25,SELL,3,0.02h,Stop Loss,$-18.00,$846.75,$70329.50,23,$846.75
2024-02-01,19:40:00,17397.25,BUY,3,0.02h,Stop Loss,$102.00,$948.75,$70431.50,23,$948.75
2024-02-01,20:48:00,17434.0,SELL,3,0.02h,Stop Loss,$109.50,$1058.25,$70541.00,23,$1058.25
2024-02-01,21:02:00,17462.0,BUY,3,0.02h,Stop Loss,$117.00,$1175.25,$70658.00,23,$1175.25
,,,,,,,,,,,
2024-02-02,12:09:00,17607.75,SELL,3,0.02h,Stop Loss,$-18.00,$-18.00,$70640.00,24,$-18.00
2024-02-02,12:17:00,17617.75,BUY,3,0.02h,Break Even,$0.75,$-17.25,$70640.75,24,$-17.25
2024-02-02,12:51:00,17626.0,SELL,3,0.02h,Break Even,$0.75,$-16.50,$70641.50,24,$-16.50
2024-02-02,13:05:00,17631.25,BUY,3,0.02h,Break Even,$0.75,$-15.75,$70642.25,24,$-15.75
2024-02-02,13:10:00,17623.75,SELL,3,0.02h,Break Even,$0.75,$-15.00,$70643.00,24,$-15.00
2024-02-02,14:36:00,17524.75,BUY,3,0.02h,Stop Loss,$75.75,$60.75,$70718.75,24,$60.75
2024-02-02,15:13:00,17571.0,SELL,3,0.02h,Stop Loss,$12.00,$72.75,$70730.75,24,$72.75
2024-02-02,15:15:00,17592.0,BUY,3,0.02h,Stop Loss,$83.25,$156.00,$70814.00,24,$156.00
2024-02-02,15:30:00,17584.75,SELL,3,0.02h,Stop Loss,$42.00,$198.00,$70856.00,24,$198.00
2024-02-02,15:40:00,17616.5,BUY,3,0.02h,Stop Loss,$188.25,$386.25,$71044.25,24,$386.25
2024-02-02,16:04:00,17613.75,SELL,3,0.02h,Stop Loss,$68.25,$454.50,$71112.50,24,$454.50
2024-02-02,16:11:00,17643.25,BUY,3,0.02h,Break Even,$0.75,$455.25,$71113.25,24,$455.25
2024-02-02,17:45:00,17682.5,SELL,3,0.02h,Stop Loss,$109.50,$564.75,$71222.75,24,$564.75
2024-02-02,18:02:00,17721.5,BUY,3,0.02h,Break Even,$0.75,$565.50,$71223.50,24,$565.50
2024-02-02,18:27:00,17696.5,SELL,3,0.02h,Stop Loss,$12.00,$577.50,$71235.50,24,$577.50
2024-02-02,18:45:00,17719.0,BUY,3,0.02h,Stop Loss,$109.50,$687.00,$71345.00,24,$687.00
2024-02-02,19:54:00,17752.75,SELL,3,0.02h,Stop Loss,$-18.00,$669.00,$71327.00,24,$669.00
2024-02-02,20:08:00,17762.75,BUY,3,0.02h,Break Even,$0.75,$669.75,$71327.75,24,$669.75
2024-02-02,20:19:00,17756.25,SELL,3,0.02h,Stop Loss,$-18.00,$651.75,$71309.75,24,$651.75
2024-02-02,20:20:00,17762.75,BUY,3,0.02h,Break Even,$0.75,$652.50,$71310.50,24,$652.50
2024-02-02,20:23:00,17754.25,SELL,3,0.02h,Stop Loss,$240.75,$893.25,$71551.25,24,$893.25
2024-02-02,20:30:00,17766.25,BUY,3,0.02h,Stop Loss,$-18.00,$875.25,$71533.25,24,$875.25
2024-02-02,20:33:00,17751.75,SELL,3,0.02h,Stop Loss,$30.75,$906.00,$71564.00,24,$906.00
2024-02-02,20:51:00,17760.75,BUY,3,0.02h,Stop Loss,$68.25,$974.25,$71632.25,24,$974.25
2024-02-02,20:58:00,17746.75,SELL,3,0.02h,Stop Loss,$68.25,$1042.50,$71700.50,24,$1042.50
,,,,,,,,,,,
2024-02-05,12:04:00,17706.5,BUY,3,0.02h,Stop Loss,$15.75,$15.75,$71716.25,25,$15.75
2024-02-05,12:49:00,17721.25,SELL,3,0.02h,Stop Loss,$-18.00,$-2.25,$71698.25,25,$-2.25
2024-02-05,12:52:00,17728.0,BUY,3,0.02h,Break Even,$0.75,$-1.50,$71699.00,25,$-1.50
2024-02-05,13:11:00,17727.5,SELL,3,0.02h,Stop Loss,$-18.00,$-19.50,$71681.00,25,$-19.50
2024-02-05,13:15:00,17732.5,BUY,3,0.02h,Stop Loss,$-18.00,$-37.50,$71663.00,25,$-37.50
2024-02-05,13:17:00,17726.75,SELL,3,0.02h,Break Even,$0.75,$-36.75,$71663.75,25,$-36.75
2024-02-05,14:12:00,17707.5,BUY,3,0.02h,Break Even,$0.75,$-36.00,$71664.50,25,$-36.00
2024-02-05,14:41:00,17699.25,SELL,3,0.02h,Break Even,$0.75,$-35.25,$71665.25,25,$-35.25
2024-02-05,16:02:00,17595.75,BUY,3,0.02h,Stop Loss,$12.00,$-23.25,$71677.25,25,$-23.25
2024-02-05,17:54:00,17693.25,SELL,3,0.02h,Stop Loss,$-18.00,$-41.25,$71659.25,25,$-41.25
2024-02-05,18:08:00,17702.0,BUY,3,0.02h,Stop Loss,$60.75,$19.50,$71720.00,25,$19.50
2024-02-05,18:23:00,17696.5,SELL,3,0.02h,Break Even,$0.75,$20.25,$71720.75,25,$20.25
2024-02-05,18:48:00,17695.75,BUY,3,0.02h,Break Even,$0.75,$21.00,$71721.50,25,$21.00
2024-02-05,18:54:00,17688.75,SELL,3,0.02h,Break Even,$0.75,$21.75,$71722.25,25,$21.75
2024-02-05,18:59:00,17695.75,BUY,3,0.02h,Stop Loss,$53.25,$75.00,$71775.50,25,$75.00
2024-02-05,19:02:00,17688.0,SELL,3,0.02h,Break Even,$0.75,$75.75,$71776.25,25,$75.75
2024-02-05,19:08:00,17700.75,BUY,3,0.02h,Stop Loss,$60.75,$136.50,$71837.00,25,$136.50
2024-02-05,20:03:00,17720.25,SELL,3,0.02h,Stop Loss,$68.25,$204.75,$71905.25,25,$204.75
2024-02-05,20:29:00,17715.5,BUY,3,0.02h,Break Even,$0.75,$205.50,$71906.00,25,$205.50
2024-02-05,20:41:00,17703.0,SELL,3,0.02h,Break Even,$0.75,$206.25,$71906.75,25,$206.25
2024-02-05,20:48:00,17709.25,BUY,3,0.02h,Stop Loss,$12.00,$218.25,$71918.75,25,$218.25
2024-02-05,20:50:00,17702.25,SELL,3,0.02h,Break Even,$0.75,$219.00,$71919.50,25,$219.00
2024-02-05,20:51:00,17722.75,BUY,3,0.02h,Break Even,$0.75,$219.75,$71920.25,25,$219.75
2024-02-05,21:01:00,17685.0,SELL,3,0.02h,Break Even,$0.75,$220.50,$71921.00,25,$220.50
2024-02-05,21:52:00,17698.0,BUY,3,0.02h,Break Even,$0.75,$221.25,$71921.75,25,$221.25
,,,,,,,,,,,
2024-02-06,12:01:00,17693.5,SELL,3,0.02h,Stop Loss,$-18.00,$-18.00,$71903.75,26,$-18.00
2024-02-06,12:40:00,17690.5,BUY,3,0.02h,Stop Loss,$27.00,$9.00,$71930.75,26,$9.00
2024-02-06,14:30:00,17741.25,SELL,3,0.02h,Break Even,$0.75,$9.75,$71931.50,26,$9.75
2024-02-06,14:31:00,17764.25,BUY,3,0.02h,Break Even,$0.75,$10.50,$71932.25,26,$10.50
2024-02-06,14:35:00,17729.25,SELL,3,0.02h,Stop Loss,$259.50,$270.00,$72191.75,26,$270.00
2024-02-06,15:36:00,17655.25,BUY,3,0.02h,Stop Loss,$-18.00,$252.00,$72173.75,26,$252.00
2024-02-06,15:43:00,17627.5,SELL,3,0.02h,Stop Loss,$60.75,$312.75,$72234.50,26,$312.75
2024-02-06,15:48:00,17643.5,BUY,3,0.02h,Break Even,$0.75,$313.50,$72235.25,26,$313.50
2024-02-06,15:50:00,17626.0,SELL,3,0.02h,Stop Loss,$64.50,$378.00,$72299.75,26,$378.00
2024-02-06,15:58:00,17637.75,BUY,3,0.02h,Stop Loss,$42.00,$420.00,$72341.75,26,$420.00
2024-02-06,16:15:00,17627.5,SELL,3,0.02h,Break Even,$0.75,$420.75,$72342.50,26,$420.75
2024-02-06,16:21:00,17647.75,BUY,3,0.02h,Stop Loss,$-18.00,$402.75,$72324.50,26,$402.75
2024-02-06,16:40:00,17644.0,SELL,3,0.02h,Stop Loss,$184.50,$587.25,$72509.00,26,$587.25
2024-02-06,17:29:00,17599.0,BUY,3,0.02h,Stop Loss,$42.00,$629.25,$72551.00,26,$629.25
2024-02-06,17:54:00,17594.25,SELL,3,0.02h,Stop Loss,$49.50,$678.75,$72600.50,26,$678.75
2024-02-06,18:03:00,17604.25,BUY,3,0.02h,Stop Loss,$-18.00,$660.75,$72582.50,26,$660.75
2024-02-06,18:15:00,17595.75,SELL,3,0.02h,Break Even,$0.75,$661.50,$72583.25,26,$661.50
2024-02-06,18:17:00,17607.25,BUY,3,0.02h,Stop Loss,$49.50,$711.00,$72632.75,26,$711.00
2024-02-06,18:20:00,17595.0,SELL,3,0.02h,Stop Loss,$19.50,$730.50,$72652.25,26,$730.50
2024-02-06,18:30:00,17608.75,BUY,3,0.02h,Stop Loss,$42.00,$772.50,$72694.25,26,$772.50
2024-02-06,19:06:00,17610.0,SELL,3,0.02h,Stop Loss,$147.00,$919.50,$72841.25,26,$919.50
2024-02-06,19:30:00,17594.25,BUY,3,0.02h,Stop Loss,$53.25,$972.75,$72894.50,26,$972.75
2024-02-06,20:30:00,17635.5,SELL,3,0.02h,Stop Loss,$45.75,$1018.50,$72940.25,26,$1018.50
2024-02-06,20:51:00,17626.5,BUY,3,0.02h,Stop Loss,$79.50,$1098.00,$73019.75,26,$1098.00
2024-02-06,21:20:00,17642.25,SELL,3,0.02h,Stop Loss,$-18.00,$1080.00,$73001.75,26,$1080.00
2024-02-06,21:23:00,17646.75,BUY,3,0.02h,Stop Loss,$15.75,$1095.75,$73017.50,26,$1095.75
2024-02-06,21:44:00,17647.0,SELL,3,0.03h,Break Even,$0.75,$1096.50,$73018.25,26,$1096.50
2024-02-06,22:00:00,17649.5,BUY,3,14.00h,Stop Loss,$435.75,$1532.25,$73454.00,26,$1532.25
,,,,,,,,,,,
2024-02-07,12:23:00,17658.75,SELL,3,0.02h,Stop Loss,$12.00,$12.00,$73466.00,27,$12.00
2024-02-07,12:29:00,17674.25,BUY,3,0.02h,Break Even,$0.75,$12.75,$73466.75,27,$12.75
2024-02-07,13:56:00,17733.25,SELL,3,0.02h,Stop Loss,$-18.00,$-5.25,$73448.75,27,$-5.25
2024-02-07,13:59:00,17738.5,BUY,3,0.02h,Stop Loss,$-18.00,$-23.25,$73430.75,27,$-23.25
2024-02-07,14:35:00,17750.5,SELL,3,0.02h,Break Even,$0.75,$-22.50,$73431.50,27,$-22.50
2024-02-07,14:52:00,17760.75,BUY,3,0.02h,Stop Loss,$60.75,$38.25,$73492.25,27,$38.25
2024-02-07,14:56:00,17724.75,SELL,3,0.02h,Stop Loss,$49.50,$87.75,$73541.75,27,$87.75
2024-02-07,15:10:00,17757.75,BUY,3,0.02h,Stop Loss,$87.00,$174.75,$73628.75,27,$174.75
2024-02-07,15:59:00,17839.75,SELL,3,0.02h,Stop Loss,$87.00,$261.75,$73715.75,27,$261.75
2024-02-07,16:12:00,17850.5,BUY,3,0.02h,Break Even,$0.75,$262.50,$73716.50,27,$262.50
2024-02-07,16:18:00,17834.75,SELL,3,0.02h,Stop Loss,$60.75,$323.25,$73777.25,27,$323.25
2024-02-07,16:46:00,17828.5,BUY,3,0.02h,Stop Loss,$27.00,$350.25,$73804.25,27,$350.25
2024-02-07,17:13:00,17827.5,SELL,3,0.02h,Stop Loss,$-18.00,$332.25,$73786.25,27,$332.25
2024-02-07,17:18:00,17849.75,BUY,3,0.02h,Stop Loss,$-18.00,$314.25,$73768.25,27,$314.25
2024-02-07,17:23:00,17833.5,SELL,3,0.02h,Stop Loss,$19.50,$333.75,$73787.75,27,$333.75
2024-02-07,17:55:00,17813.75,BUY,3,0.02h,Stop Loss,$12.00,$345.75,$73799.75,27,$345.75
2024-02-07,18:06:00,17801.75,SELL,3,0.02h,Stop Loss,$-18.00,$327.75,$73781.75,27,$327.75
2024-02-07,18:11:00,17822.0,BUY,3,0.02h,Stop Loss,$42.00,$369.75,$73823.75,27,$369.75
2024-02-07,19:11:00,17846.0,SELL,3,0.02h,Break Even,$0.75,$370.50,$73824.50,27,$370.50
2024-02-07,19:12:00,17849.0,BUY,3,0.02h,Break Even,$0.75,$371.25,$73825.25,27,$371.25
2024-02-07,19:14:00,17843.75,SELL,3,0.02h,Break Even,$0.75,$372.00,$73826.00,27,$372.00
2024-02-07,19:16:00,17854.25,BUY,3,0.02h,Stop Loss,$-18.00,$354.00,$73808.00,27,$354.00
2024-02-07,19:18:00,17846.0,SELL,3,0.02h,Break Even,$0.75,$354.75,$73808.75,27,$354.75
2024-02-07,19:25:00,17851.75,BUY,3,0.02h,Stop Loss,$-18.00,$336.75,$73790.75,27,$336.75
2024-02-07,19:27:00,17845.25,SELL,3,0.02h,Break Even,$0.75,$337.50,$73791.50,27,$337.50
2024-02-07,19:43:00,17844.5,BUY,3,0.02h,Stop Loss,$-18.00,$319.50,$73773.50,27,$319.50
2024-02-07,19:44:00,17839.0,SELL,3,0.02h,Break Even,$0.75,$320.25,$73774.25,27,$320.25
2024-02-07,19:48:00,17852.75,BUY,3,0.02h,Break Even,$0.75,$321.00,$73775.00,27,$321.00
2024-02-07,20:24:00,17852.0,SELL,3,0.02h,Break Even,$0.75,$321.75,$73775.75,27,$321.75
2024-02-07,20:26:00,17857.75,BUY,3,0.02h,Break Even,$0.75,$322.50,$73776.50,27,$322.50
2024-02-07,20:28:00,17854.0,SELL,3,0.02h,Break Even,$0.75,$323.25,$73777.25,27,$323.25
2024-02-07,21:13:00,17851.0,BUY,3,0.02h,Break Even,$0.75,$324.00,$73778.00,27,$324.00
,,,,,,,,,,,
2024-02-08,12:00:00,17811.5,SELL,3,0.02h,Break Even,$0.75,$0.75,$73778.75,28,$0.75
2024-02-08,12:46:00,17820.0,BUY,3,0.02h,Stop Loss,$-18.00,$-17.25,$73760.75,28,$-17.25
2024-02-08,12:47:00,17814.25,SELL,3,0.02h,Stop Loss,$-18.00,$-35.25,$73742.75,28,$-35.25
2024-02-08,12:48:00,17819.75,BUY,3,0.02h,Break Even,$0.75,$-34.50,$73743.50,28,$-34.50
2024-02-08,12:56:00,17809.0,SELL,3,0.02h,Stop Loss,$12.00,$-22.50,$73755.50,28,$-22.50
2024-02-08,13:07:00,17815.25,BUY,3,0.02h,Stop Loss,$-18.00,$-40.50,$73737.50,28,$-40.50
2024-02-08,13:09:00,17809.5,SELL,3,0.02h,Stop Loss,$-18.00,$-58.50,$73719.50,28,$-58.50
2024-02-08,13:34:00,17812.5,BUY,3,0.02h,Stop Loss,$-18.00,$-76.50,$73701.50,28,$-76.50
2024-02-08,14:43:00,17812.25,SELL,3,0.02h,Stop Loss,$23.25,$-53.25,$73724.75,28,$-53.25
2024-02-08,14:51:00,17835.5,BUY,3,0.02h,Stop Loss,$38.25,$-15.00,$73763.00,28,$-15.00
2024-02-08,15:26:00,17837.5,SELL,3,0.02h,Break Even,$0.75,$-14.25,$73763.75,28,$-14.25
2024-02-08,15:36:00,17857.5,BUY,3,0.02h,Break Even,$0.75,$-13.50,$73764.50,28,$-13.50
2024-02-08,16:27:00,17867.5,SELL,3,0.02h,Break Even,$0.75,$-12.75,$73765.25,28,$-12.75
2024-02-08,16:38:00,17881.5,BUY,3,0.02h,Break Even,$0.75,$-12.00,$73766.00,28,$-12.00
2024-02-08,16:45:00,17867.5,SELL,3,0.02h,Break Even,$0.75,$-11.25,$73766.75,28,$-11.25
2024-02-08,16:54:00,17880.0,BUY,3,0.02h,Break Even,$0.75,$-10.50,$73767.50,28,$-10.50
2024-02-08,17:07:00,17872.25,SELL,3,0.02h,Stop Loss,$49.50,$39.00,$73817.00,28,$39.00
2024-02-08,17:15:00,17884.0,BUY,3,0.02h,Break Even,$0.75,$39.75,$73817.75,28,$39.75
2024-02-08,17:40:00,17882.5,SELL,3,0.02h,Stop Loss,$19.50,$59.25,$73837.25,28,$59.25
2024-02-08,18:03:00,17877.75,BUY,3,0.02h,Stop Loss,$23.25,$82.50,$73860.50,28,$82.50
2024-02-08,18:17:00,17862.5,SELL,3,0.02h,Break Even,$0.75,$83.25,$73861.25,28,$83.25
2024-02-08,18:26:00,17877.75,BUY,3,0.02h,Break Even,$0.75,$84.00,$73862.00,28,$84.00
2024-02-08,18:47:00,17878.0,SELL,3,0.02h,Break Even,$0.75,$84.75,$73862.75,28,$84.75
2024-02-08,19:46:00,17851.25,BUY,3,0.02h,Stop Loss,$-18.00,$66.75,$73844.75,28,$66.75
2024-02-08,20:37:00,17866.25,SELL,3,0.02h,Stop Loss,$-18.00,$48.75,$73826.75,28,$48.75
2024-02-08,21:18:00,17861.5,BUY,3,0.02h,Break Even,$0.75,$49.50,$73827.50,28,$49.50
2024-02-08,22:00:00,17861.0,SELL,3,14.00h,Stop Loss,$-18.00,$31.50,$73809.50,28,$31.50
,,,,,,,,,,,
2024-02-09,12:00:00,17918.5,BUY,3,0.02h,Break Even,$0.75,$0.75,$73810.25,29,$0.75
2024-02-09,12:42:00,17925.5,SELL,3,0.02h,Stop Loss,$-18.00,$-17.25,$73792.25,29,$-17.25
2024-02-09,12:46:00,17929.25,BUY,3,0.02h,Stop Loss,$-18.00,$-35.25,$73774.25,29,$-35.25
2024-02-09,12:47:00,17927.5,SELL,3,0.02h,Break Even,$0.75,$-34.50,$73775.00,29,$-34.50
2024-02-09,12:48:00,17928.25,BUY,3,0.02h,Stop Loss,$-18.00,$-52.50,$73757.00,29,$-52.50
2024-02-09,12:49:00,17926.25,SELL,3,0.02h,Stop Loss,$-18.00,$-70.50,$73739.00,29,$-70.50
2024-02-09,13:27:00,17916.25,BUY,3,0.02h,Stop Loss,$-18.00,$-88.50,$73721.00,29,$-88.50
2024-02-09,13:30:00,17912.5,SELL,3,0.02h,Stop Loss,$105.75,$17.25,$73826.75,29,$17.25
2024-02-09,13:31:00,17918.25,BUY,3,0.02h,Stop Loss,$469.50,$486.75,$74296.25,29,$486.75
2024-02-09,14:01:00,17925.5,SELL,3,0.02h,Break Even,$0.75,$487.50,$74297.00,29,$487.50
2024-02-09,14:14:00,17931.0,BUY,3,0.02h,Break Even,$0.75,$488.25,$74297.75,29,$488.25
2024-02-09,14:21:00,17923.5,SELL,3,0.02h,Break Even,$0.75,$489.00,$74298.50,29,$489.00
2024-02-09,14:49:00,17908.75,BUY,3,0.02h,Break Even,$0.75,$489.75,$74299.25,29,$489.75
2024-02-09,16:19:00,17989.75,SELL,3,0.02h,Stop Loss,$-18.00,$471.75,$74281.25,29,$471.75
2024-02-09,16:22:00,17999.5,BUY,3,0.02h,Break Even,$0.75,$472.50,$74282.00,29,$472.50
2024-02-09,16:25:00,17990.5,SELL,3,0.02h,Break Even,$0.75,$473.25,$74282.75,29,$473.25
2024-02-09,16:43:00,17993.25,BUY,3,0.02h,Break Even,$0.75,$474.00,$74283.50,29,$474.00
2024-02-09,17:02:00,17987.25,SELL,3,0.02h,Stop Loss,$-18.00,$456.00,$74265.50,29,$456.00
2024-02-09,17:26:00,17993.25,BUY,3,0.02h,Break Even,$0.75,$456.75,$74266.25,29,$456.75
2024-02-09,18:49:00,18032.25,SELL,3,0.02h,Stop Loss,$-18.00,$438.75,$74248.25,29,$438.75
2024-02-09,18:57:00,18038.25,BUY,3,0.02h,Stop Loss,$12.00,$450.75,$74260.25,29,$450.75
2024-02-09,19:10:00,18032.0,SELL,3,0.02h,Stop Loss,$-18.00,$432.75,$74242.25,29,$432.75
2024-02-09,19:15:00,18037.5,BUY,3,0.02h,Stop Loss,$-18.00,$414.75,$74224.25,29,$414.75
2024-02-09,19:16:00,18035.5,SELL,3,0.02h,Stop Loss,$-18.00,$396.75,$74206.25,29,$396.75
2024-02-09,19:17:00,18036.75,BUY,3,0.02h,Break Even,$0.75,$397.50,$74207.00,29,$397.50
2024-02-09,19:18:00,18035.25,SELL,3,0.02h,Stop Loss,$-18.00,$379.50,$74189.00,29,$379.50
2024-02-09,19:19:00,18038.25,BUY,3,0.02h,Break Even,$0.75,$380.25,$74189.75,29,$380.25
2024-02-09,20:01:00,18051.75,SELL,3,0.02h,Stop Loss,$113.25,$493.50,$74303.00,29,$493.50
2024-02-09,20:19:00,18052.75,BUY,3,0.02h,Stop Loss,$-18.00,$475.50,$74285.00,29,$475.50
2024-02-09,20:24:00,18043.25,SELL,3,0.02h,Break Even,$0.75,$476.25,$74285.75,29,$476.25
2024-02-09,20:56:00,18046.25,BUY,3,0.02h,Stop Loss,$-18.00,$458.25,$74267.75,29,$458.25
2024-02-09,20:58:00,18037.0,SELL,3,0.02h,Break Even,$0.75,$459.00,$74268.50,29,$459.00
2024-02-09,21:36:00,18034.25,BUY,3,0.07h,Stop Loss,$-18.00,$441.00,$74250.50,29,$441.00
2024-02-09,21:44:00,18032.75,SELL,3,0.02h,Stop Loss,$-18.00,$423.00,$74232.50,29,$423.00
2024-02-09,21:46:00,18033.5,BUY,3,0.02h,Break Even,$0.75,$423.75,$74233.25,29,$423.75
,,,,,,,,,,,
2024-02-12,12:27:00,18041.5,SELL,3,0.02h,Stop Loss,$-18.00,$-18.00,$74215.25,30,$-18.00
2024-02-12,12:48:00,18039.5,BUY,3,0.02h,Stop Loss,$-18.00,$-36.00,$74197.25,30,$-36.00
2024-02-12,12:51:00,18036.0,SELL,3,0.02h,Stop Loss,$-18.00,$-54.00,$74179.25,30,$-54.00
2024-02-12,13:01:00,18038.25,BUY,3,0.02h,Stop Loss,$-18.00,$-72.00,$74161.25,30,$-72.00
2024-02-12,13:02:00,18035.75,SELL,3,0.02h,Break Even,$0.75,$-71.25,$74162.00,30,$-71.25
2024-02-12,13:05:00,18039.25,BUY,3,0.02h,Stop Loss,$-18.00,$-89.25,$74144.00,30,$-89.25
2024-02-12,13:32:00,18037.0,SELL,3,0.02h,Stop Loss,$23.25,$-66.00,$74167.25,30,$-66.00
2024-02-12,14:07:00,18034.25,BUY,3,0.02h,Stop Loss,$-18.00,$-84.00,$74149.25,30,$-84.00
2024-02-12,14:15:00,18023.25,SELL,3,0.02h,Stop Loss,$-18.00,$-102.00,$74131.25,30,$-102.00
2024-02-12,14:35:00,18045.25,BUY,3,0.02h,Stop Loss,$34.50,$-67.50,$74165.75,30,$-67.50
2024-02-12,14:48:00,18028.75,SELL,3,0.02h,Stop Loss,$120.75,$53.25,$74286.50,30,$53.25
2024-02-12,14:57:00,18035.5,BUY,3,0.02h,Break Even,$0.75,$54.00,$74287.25,30,$54.00
2024-02-12,15:04:00,18027.5,SELL,3,0.02h,Stop Loss,$-18.00,$36.00,$74269.25,30,$36.00
2024-02-12,15:27:00,18032.25,BUY,3,0.02h,Stop Loss,$34.50,$70.50,$74303.75,30,$70.50
2024-02-12,16:50:00,18084.25,SELL,3,0.02h,Stop Loss,$-18.00,$52.50,$74285.75,30,$52.50
2024-02-12,16:56:00,18105.5,BUY,3,0.02h,Break Even,$0.75,$53.25,$74286.50,30,$53.25
2024-02-12,17:02:00,18092.75,SELL,3,0.02h,Stop Loss,$23.25,$76.50,$74309.75,30,$76.50
2024-02-12,17:06:00,18104.25,BUY,3,0.02h,Break Even,$0.75,$77.25,$74310.50,30,$77.25
2024-02-12,17:17:00,18095.75,SELL,3,0.02h,Break Even,$0.75,$78.00,$74311.25,30,$78.00
2024-02-12,17:50:00,18093.0,BUY,3,0.02h,Stop Loss,$-18.00,$60.00,$74293.25,30,$60.00
2024-02-12,18:23:00,18084.5,SELL,3,0.02h,Stop Loss,$128.25,$188.25,$74421.50,30,$188.25
2024-02-12,19:43:00,17984.0,BUY,3,0.02h,Stop Loss,$-18.00,$170.25,$74403.50,30,$170.25
2024-02-12,19:46:00,17976.25,SELL,3,0.02h,Stop Loss,$57.00,$227.25,$74460.50,30,$227.25
2024-02-12,20:08:00,17973.25,BUY,3,0.02h,Break Even,$0.75,$228.00,$74461.25,30,$228.00
2024-02-12,20:34:00,17972.5,SELL,3,0.02h,Stop Loss,$15.75,$243.75,$74477.00,30,$243.75
2024-02-12,20:53:00,17978.75,BUY,3,0.02h,Break Even,$0.75,$244.50,$74477.75,30,$244.50
2024-02-12,20:56:00,17953.0,SELL,3,0.02h,Stop Loss,$-18.00,$226.50,$74459.75,30,$226.50
2024-02-12,21:56:00,17923.5,BUY,3,0.03h,Stop Loss,$42.00,$268.50,$74501.75,30,$268.50
,,,,,,,,,,,
2024-02-13,12:00:00,17841.25,SELL,3,0.02h,Stop Loss,$27.00,$27.00,$74528.75,31,$27.00
2024-02-13,12:58:00,17835.5,BUY,3,0.02h,Break Even,$0.75,$27.75,$74529.50,31,$27.75
2024-02-13,13:31:00,17731.5,SELL,3,0.02h,Stop Loss,$199.50,$227.25,$74729.00,31,$227.25
2024-02-13,14:37:00,17654.25,BUY,3,0.02h,Break Even,$0.75,$228.00,$74729.75,31,$228.00
2024-02-13,14:53:00,17634.5,SELL,3,0.02h,Stop Loss,$23.25,$251.25,$74753.00,31,$251.25
2024-02-13,14:54:00,17659.75,BUY,3,0.02h,Stop Loss,$308.25,$559.50,$75061.25,31,$559.50
2024-02-13,15:15:00,17649.75,SELL,3,0.02h,Stop Loss,$158.25,$717.75,$75219.50,31,$717.75
2024-02-13,15:21:00,17689.0,BUY,3,0.02h,Stop Loss,$60.75,$778.50,$75280.25,31,$778.50
2024-02-13,15:58:00,17735.75,SELL,3,0.02h,Stop Loss,$49.50,$828.00,$75329.75,31,$828.00
2024-02-13,16:07:00,17761.0,BUY,3,0.02h,Stop Loss,$42.00,$870.00,$75371.75,31,$870.00
2024-02-13,16:18:00,17744.25,SELL,3,0.02h,Stop Loss,$75.75,$945.75,$75447.50,31,$945.75
2024-02-13,16:38:00,17757.0,BUY,3,0.02h,Break Even,$0.75,$946.50,$75448.25,31,$946.50
2024-02-13,16:54:00,17725.25,SELL,3,0.02h,Break Even,$0.75,$947.25,$75449.00,31,$947.25
2024-02-13,17:34:00,17721.25,BUY,3,0.02h,Stop Loss,$-18.00,$929.25,$75431.00,31,$929.25
2024-02-13,17:50:00,17700.5,SELL,3,0.02h,Break Even,$0.75,$930.00,$75431.75,31,$930.00
2024-02-13,18:16:00,17696.5,BUY,3,0.02h,Stop Loss,$-18.00,$912.00,$75413.75,31,$912.00
2024-02-13,18:21:00,17673.0,SELL,3,0.02h,Break Even,$0.75,$912.75,$75414.50,31,$912.75
2024-02-13,18:26:00,17685.0,BUY,3,0.02h,Stop Loss,$45.75,$958.50,$75460.25,31,$958.50
2024-02-13,18:33:00,17680.25,SELL,3,0.02h,Break Even,$0.75,$959.25,$75461.00,31,$959.25
2024-02-13,19:33:00,17626.25,BUY,3,0.02h,Stop Loss,$-18.00,$941.25,$75443.00,31,$941.25
2024-02-13,19:49:00,17608.25,SELL,3,0.02h,Break Even,$0.75,$942.00,$75443.75,31,$942.00
2024-02-13,20:33:00,17571.0,BUY,3,0.02h,Stop Loss,$124.50,$1066.50,$75568.25,31,$1066.50
,,,,,,,,,,,
2024-02-14,12:39:00,17784.25,SELL,3,0.02h,Stop Loss,$-18.00,$-18.00,$75550.25,32,$-18.00
2024-02-14,12:47:00,17793.0,BUY,3,0.02h,Stop Loss,$-18.00,$-36.00,$75532.25,32,$-36.00
2024-02-14,12:58:00,17787.25,SELL,3,0.02h,Stop Loss,$-18.00,$-54.00,$75514.25,32,$-54.00
2024-02-14,13:02:00,17796.75,BUY,3,0.02h,Stop Loss,$23.25,$-30.75,$75537.50,32,$-30.75
2024-02-14,13:19:00,17793.75,SELL,3,0.02h,Break Even,$0.75,$-30.00,$75538.25,32,$-30.00
2024-02-14,13:43:00,17794.5,BUY,3,0.02h,Break Even,$0.75,$-29.25,$75539.00,32,$-29.25
2024-02-14,13:50:00,17783.5,SELL,3,0.02h,Stop Loss,$23.25,$-6.00,$75562.25,32,$-6.00
2024-02-14,14:26:00,17785.75,BUY,3,0.02h,Break Even,$0.75,$-5.25,$75563.00,32,$-5.25
2024-02-14,14:39:00,17767.0,SELL,3,0.02h,Stop Loss,$192.00,$186.75,$75755.00,32,$186.75
2024-02-14,14:48:00,17790.0,BUY,3,0.02h,Break Even,$0.75,$187.50,$75755.75,32,$187.50
2024-02-14,14:51:00,17761.5,SELL,3,0.02h,Stop Loss,$113.25,$300.75,$75869.00,32,$300.75
2024-02-14,15:00:00,17789.25,BUY,3,0.02h,Stop Loss,$124.50,$425.25,$75993.50,32,$425.25
2024-02-14,15:40:00,17810.0,SELL,3,0.02h,Stop Loss,$143.25,$568.50,$76136.75,32,$568.50
2024-02-14,16:26:00,17755.0,BUY,3,0.02h,Break Even,$0.75,$569.25,$76137.50,32,$569.25
2024-02-14,16:45:00,17728.75,SELL,3,0.02h,Stop Loss,$19.50,$588.75,$76157.00,32,$588.75
2024-02-14,17:15:00,17732.0,BUY,3,0.02h,Break Even,$0.75,$589.50,$76157.75,32,$589.50
2024-02-14,18:11:00,17755.75,SELL,3,0.02h,Break Even,$0.75,$590.25,$76158.50,32,$590.25
2024-02-14,18:33:00,17774.25,BUY,3,0.02h,Break Even,$0.75,$591.00,$76159.25,32,$591.00
2024-02-14,18:58:00,17781.25,SELL,3,0.02h,Break Even,$0.75,$591.75,$76160.00,32,$591.75
2024-02-14,19:26:00,17772.25,BUY,3,0.02h,Break Even,$0.75,$592.50,$76160.75,32,$592.50
2024-02-14,21:46:00,17872.25,SELL,3,0.03h,Stop Loss,$-18.00,$574.50,$76142.75,32,$574.50
,,,,,,,,,,,
2024-02-15,12:00:00,17901.0,BUY,3,0.02h,Stop Loss,$-18.00,$-18.00,$76124.75,33,$-18.00
2024-02-15,12:54:00,17908.5,SELL,3,0.02h,Stop Loss,$12.00,$-6.00,$76136.75,33,$-6.00
2024-02-15,13:32:00,17904.5,BUY,3,0.02h,Stop Loss,$214.50,$208.50,$76351.25,33,$208.50
2024-02-15,13:49:00,17894.75,SELL,3,0.02h,Stop Loss,$143.25,$351.75,$76494.50,33,$351.75
2024-02-15,14:23:00,17897.25,BUY,3,0.02h,Break Even,$0.75,$352.50,$76495.25,33,$352.50
2024-02-15,14:29:00,17883.0,SELL,3,0.02h,Break Even,$0.75,$353.25,$76496.00,33,$353.25
2024-02-15,15:13:00,17850.25,BUY,3,0.02h,Stop Loss,$57.00,$410.25,$76553.00,33,$410.25
2024-02-15,15:29:00,17813.0,SELL,3,0.02h,Stop Loss,$-18.00,$392.25,$76535.00,33,$392.25
2024-02-15,15:46:00,17840.5,BUY,3,0.02h,Break Even,$0.75,$393.00,$76535.75,33,$393.00
2024-02-15,16:03:00,17826.75,SELL,3,0.02h,Break Even,$0.75,$393.75,$76536.50,33,$393.75
2024-02-15,16:25:00,17816.5,BUY,3,0.02h,Stop Loss,$27.00,$420.75,$76563.50,33,$420.75
2024-02-15,16:53:00,17822.5,SELL,3,0.02h,Break Even,$0.75,$421.50,$76564.25,33,$421.50
2024-02-15,17:02:00,17837.25,BUY,3,0.02h,Stop Loss,$-18.00,$403.50,$76546.25,33,$403.50
2024-02-15,17:03:00,17825.0,SELL,3,0.02h,Break Even,$0.75,$404.25,$76547.00,33,$404.25
2024-02-15,17:11:00,17840.75,BUY,3,0.02h,Stop Loss,$15.75,$420.00,$76562.75,33,$420.00
2024-02-15,17:55:00,17866.5,SELL,3,0.02h,Stop Loss,$23.25,$443.25,$76586.00,33,$443.25
2024-02-15,18:08:00,17874.75,BUY,3,0.02h,Stop Loss,$165.75,$609.00,$76751.75,33,$609.00
2024-02-15,18:45:00,17905.25,SELL,3,0.02h,Stop Loss,$15.75,$624.75,$76767.50,33,$624.75
2024-02-15,19:05:00,17913.0,BUY,3,0.02h,Stop Loss,$-18.00,$606.75,$76749.50,33,$606.75
2024-02-15,19:06:00,17906.0,SELL,3,0.02h,Break Even,$0.75,$607.50,$76750.25,33,$607.50
2024-02-15,19:07:00,17914.75,BUY,3,0.02h,Stop Loss,$42.00,$649.50,$76792.25,33,$649.50
2024-02-15,19:12:00,17896.75,SELL,3,0.02h,Stop Loss,$180.75,$830.25,$76973.00,33,$830.25
2024-02-15,19:23:00,17906.5,BUY,3,0.02h,Stop Loss,$42.00,$872.25,$77015.00,33,$872.25
2024-02-15,20:00:00,17906.75,SELL,3,0.02h,Stop Loss,$105.75,$978.00,$77120.75,33,$978.00
2024-02-15,20:52:00,17908.5,BUY,3,0.02h,Break Even,$0.75,$978.75,$77121.50,33,$978.75
2024-02-15,21:44:00,17950.0,SELL,3,0.02h,Break Even,$0.75,$979.50,$77122.25,33,$979.50
2024-02-15,21:53:00,17958.5,BUY,3,0.02h,Stop Loss,$-18.00,$961.50,$77104.25,33,$961.50
,,,,,,,,,,,
2024-02-16,12:55:00,17997.5,SELL,3,0.02h,Break Even,$0.75,$0.75,$77105.00,34,$0.75
2024-02-16,13:03:00,18006.25,BUY,3,0.02h,Break Even,$0.75,$1.50,$77105.75,34,$1.50
2024-02-16,13:06:00,17996.25,SELL,3,0.02h,Break Even,$0.75,$2.25,$77106.50,34,$2.25
2024-02-16,13:11:00,18003.5,BUY,3,0.02h,Break Even,$0.75,$3.00,$77107.25,34,$3.00
2024-02-16,13:22:00,17997.5,SELL,3,0.02h,Break Even,$0.75,$3.75,$77108.00,34,$3.75
2024-02-16,14:01:00,17944.75,BUY,3,0.02h,Stop Loss,$-18.00,$-14.25,$77090.00,34,$-14.25
2024-02-16,14:19:00,17933.25,SELL,3,0.02h,Break Even,$0.75,$-13.50,$77090.75,34,$-13.50
2024-02-16,15:39:00,17789.5,BUY,3,0.02h,Stop Loss,$222.00,$208.50,$77312.75,34,$208.50
2024-02-16,16:50:00,17852.25,SELL,3,0.02h,Stop Loss,$79.50,$288.00,$77392.25,34,$288.00
2024-02-16,16:55:00,17866.25,BUY,3,0.02h,Stop Loss,$23.25,$311.25,$77415.50,34,$311.25
2024-02-16,17:11:00,17856.0,SELL,3,0.02h,Break Even,$0.75,$312.00,$77416.25,34,$312.00
2024-02-16,17:26:00,17872.0,BUY,3,0.02h,Break Even,$0.75,$312.75,$77417.00,34,$312.75
2024-02-16,17:39:00,17861.5,SELL,3,0.02h,Stop Loss,$-18.00,$294.75,$77399.00,34,$294.75
2024-02-16,18:26:00,17839.5,BUY,3,0.02h,Break Even,$0.75,$295.50,$77399.75,34,$295.50
2024-02-16,19:29:00,17885.25,SELL,3,0.02h,Stop Loss,$-18.00,$277.50,$77381.75,34,$277.50
2024-02-16,20:25:00,17791.25,BUY,3,0.02h,Break Even,$0.75,$278.25,$77382.50,34,$278.25
2024-02-16,20:34:00,17783.5,SELL,3,0.02h,Break Even,$0.75,$279.00,$77383.25,34,$279.00
2024-02-16,20:35:00,17786.5,BUY,3,0.02h,Break Even,$0.75,$279.75,$77384.00,34,$279.75
2024-02-16,20:36:00,17784.0,SELL,3,0.02h,Stop Loss,$27.00,$306.75,$77411.00,34,$306.75
,,,,,,,,,,,
2024-02-19,12:00:00,17763.5,BUY,3,0.02h,Stop Loss,$12.00,$12.00,$77423.00,35,$12.00
2024-02-19,13:04:00,17759.5,SELL,3,0.02h,Stop Loss,$-18.00,$-6.00,$77405.00,35,$-6.00
2024-02-19,13:12:00,17766.25,BUY,3,0.02h,Break Even,$0.75,$-5.25,$77405.75,35,$-5.25
2024-02-19,13:45:00,17775.75,SELL,3,0.02h,Break Even,$0.75,$-4.50,$77406.50,35,$-4.50
2024-02-19,14:00:00,17778.25,BUY,3,0.02h,Break Even,$0.75,$-3.75,$77407.25,35,$-3.75
2024-02-19,14:07:00,17776.25,SELL,3,0.03h,Break Even,$0.75,$-3.00,$77408.00,35,$-3.00
2024-02-19,14:12:00,17780.25,BUY,3,0.02h,Stop Loss,$-18.00,$-21.00,$77390.00,35,$-21.00
2024-02-19,14:58:00,17793.25,SELL,3,0.02h,Break Even,$0.75,$-20.25,$77390.75,35,$-20.25
2024-02-19,15:07:00,17798.25,BUY,3,0.02h,Stop Loss,$-18.00,$-38.25,$77372.75,35,$-38.25
2024-02-19,15:08:00,17792.25,SELL,3,0.02h,Break Even,$0.75,$-37.50,$77373.50,35,$-37.50
2024-02-19,15:40:00,17785.5,BUY,3,0.02h,Stop Loss,$-18.00,$-55.50,$77355.50,35,$-55.50
2024-02-19,15:41:00,17783.25,SELL,3,0.02h,Break Even,$0.75,$-54.75,$77356.25,35,$-54.75
2024-02-19,16:04:00,17783.5,BUY,3,0.02h,Stop Loss,$-18.00,$-72.75,$77338.25,35,$-72.75
2024-02-19,16:10:00,17775.25,SELL,3,0.02h,Break Even,$0.75,$-72.00,$77339.00,35,$-72.00
2024-02-19,16:19:00,17783.75,BUY,3,0.03h,Break Even,$0.75,$-71.25,$77339.75,35,$-71.25
2024-02-19,16:43:00,17780.25,SELL,3,0.02h,Break Even,$0.75,$-70.50,$77340.50,35,$-70.50
2024-02-19,16:58:00,17784.25,BUY,3,0.02h,Break Even,$0.75,$-69.75,$77341.25,35,$-69.75
2024-02-19,17:27:00,17783.25,SELL,3,0.03h,Stop Loss,$-18.00,$-87.75,$77323.25,35,$-87.75
2024-02-19,17:29:00,17784.0,BUY,3,0.02h,Break Even,$0.75,$-87.00,$77324.00,35,$-87.00
,,,,,,,,,,,
2024-02-20,12:00:00,17654.25,SELL,3,0.02h,Stop Loss,$-18.00,$-18.00,$77306.00,36,$-18.00
2024-02-20,12:39:00,17683.5,BUY,3,0.02h,Stop Loss,$-18.00,$-36.00,$77288.00,36,$-36.00
2024-02-20,12:44:00,17677.25,SELL,3,0.02h,Stop Loss,$30.75,$-5.25,$77318.75,36,$-5.25
2024-02-20,13:01:00,17676.25,BUY,3,0.02h,Break Even,$0.75,$-4.50,$77319.50,36,$-4.50
2024-02-20,13:06:00,17665.5,SELL,3,0.02h,Stop Loss,$-18.00,$-22.50,$77301.50,36,$-22.50
2024-02-20,13:08:00,17675.5,BUY,3,0.02h,Stop Loss,$-18.00,$-40.50,$77283.50,36,$-40.50
2024-02-20,13:09:00,17669.5,SELL,3,0.02h,Break Even,$0.75,$-39.75,$77284.25,36,$-39.75
2024-02-20,13:12:00,17677.75,BUY,3,0.02h,Break Even,$0.75,$-39.00,$77285.00,36,$-39.00
2024-02-20,13:21:00,17667.75,SELL,3,0.02h,Break Even,$0.75,$-38.25,$77285.75,36,$-38.25
2024-02-20,13:41:00,17688.5,BUY,3,0.02h,Stop Loss,$49.50,$11.25,$77335.25,36,$11.25
2024-02-20,13:54:00,17676.0,SELL,3,0.02h,Stop Loss,$-18.00,$-6.75,$77317.25,36,$-6.75
2024-02-20,13:55:00,17682.5,BUY,3,0.02h,Stop Loss,$-18.00,$-24.75,$77299.25,36,$-24.75
2024-02-20,13:57:00,17676.25,SELL,3,0.02h,Stop Loss,$23.25,$-1.50,$77322.50,36,$-1.50
2024-02-20,14:16:00,17677.25,BUY,3,0.02h,Break Even,$0.75,$-0.75,$77323.25,36,$-0.75
2024-02-20,14:23:00,17666.0,SELL,3,0.02h,Stop Loss,$-18.00,$-18.75,$77305.25,36,$-18.75
2024-02-20,14:32:00,17711.75,BUY,3,0.02h,Stop Loss,$135.75,$117.00,$77441.00,36,$117.00
2024-02-20,14:38:00,17641.0,SELL,3,0.02h,Stop Loss,$285.75,$402.75,$77726.75,36,$402.75
2024-02-20,15:45:00,17525.5,BUY,3,0.02h,Stop Loss,$143.25,$546.00,$77870.00,36,$546.00
2024-02-20,16:23:00,17562.5,SELL,3,0.02h,Stop Loss,$15.75,$561.75,$77885.75,36,$561.75
2024-02-20,16:26:00,17570.75,BUY,3,0.02h,Break Even,$0.75,$562.50,$77886.50,36,$562.50
2024-02-20,16:27:00,17565.5,SELL,3,0.02h,Break Even,$0.75,$563.25,$77887.25,36,$563.25
2024-02-20,16:29:00,17574.75,BUY,3,0.02h,Break Even,$0.75,$564.00,$77888.00,36,$564.00
2024-02-20,16:32:00,17549.0,SELL,3,0.02h,Stop Loss,$45.75,$609.75,$77933.75,36,$609.75
2024-02-20,17:34:00,17489.75,BUY,3,0.02h,Stop Loss,$15.75,$625.50,$77949.50,36,$625.50
2024-02-20,17:39:00,17467.25,SELL,3,0.02h,Stop Loss,$173.25,$798.75,$78122.75,36,$798.75
2024-02-20,17:44:00,17491.25,BUY,3,0.02h,Stop Loss,$105.75,$904.50,$78228.50,36,$904.50
2024-02-20,18:08:00,17492.5,SELL,3,0.02h,Stop Loss,$-18.00,$886.50,$78210.50,36,$886.50
2024-02-20,18:09:00,17498.0,BUY,3,0.02h,Stop Loss,$38.25,$924.75,$78248.75,36,$924.75
2024-02-20,18:12:00,17492.5,SELL,3,0.02h,Break Even,$0.75,$925.50,$78249.50,36,$925.50
2024-02-20,18:14:00,17502.5,BUY,3,0.02h,Break Even,$0.75,$926.25,$78250.25,36,$926.25
2024-02-20,18:16:00,17490.5,SELL,3,0.02h,Stop Loss,$105.75,$1032.00,$78356.00,36,$1032.00
2024-02-20,18:20:00,17510.5,BUY,3,0.02h,Stop Loss,$75.75,$1107.75,$78431.75,36,$1107.75
2024-02-20,18:30:00,17492.75,SELL,3,0.02h,Stop Loss,$30.75,$1138.50,$78462.50,36,$1138.50
2024-02-20,18:43:00,17513.25,BUY,3,0.02h,Break Even,$0.75,$1139.25,$78463.25,36,$1139.25
2024-02-20,19:18:00,17509.0,SELL,3,0.02h,Break Even,$0.75,$1140.00,$78464.00,36,$1140.00
2024-02-20,19:20:00,17543.25,BUY,3,0.02h,Stop Loss,$-18.00,$1122.00,$78446.00,36,$1122.00
2024-02-20,19:25:00,17519.5,SELL,3,0.02h,Stop Loss,$102.00,$1224.00,$78548.00,36,$1224.00
2024-02-20,19:28:00,17533.75,BUY,3,0.02h,Stop Loss,$30.75,$1254.75,$78578.75,36,$1254.75
2024-02-20,20:33:00,17557.0,SELL,3,0.02h,Stop Loss,$330.75,$1585.50,$78909.50,36,$1585.50
2024-02-20,20:46:00,17584.0,BUY,3,0.02h,Stop Loss,$12.00,$1597.50,$78921.50,36,$1597.50
2024-02-20,21:12:00,17586.25,SELL,3,0.02h,Break Even,$0.75,$1598.25,$78922.25,36,$1598.25
2024-02-20,21:27:00,17587.25,BUY,3,0.02h,Stop Loss,$-18.00,$1580.25,$78904.25,36,$1580.25
2024-02-20,21:55:00,17588.5,SELL,3,0.02h,Break Even,$0.75,$1581.00,$78905.00,36,$1581.00
,,,,,,,,,,,
2024-02-21,13:06:00,17507.5,BUY,3,0.02h,Stop Loss,$-18.00,$-18.00,$78887.00,37,$-18.00
2024-02-21,13:14:00,17496.0,SELL,3,0.02h,Break Even,$0.75,$-17.25,$78887.75,37,$-17.25
2024-02-21,13:40:00,17500.0,BUY,3,0.02h,Break Even,$0.75,$-16.50,$78888.50,37,$-16.50
2024-02-21,14:18:00,17498.75,SELL,3,0.02h,Stop Loss,$-18.00,$-34.50,$78870.50,37,$-34.50
2024-02-21,14:40:00,17500.0,BUY,3,0.02h,Stop Loss,$23.25,$-11.25,$78893.75,37,$-11.25
2024-02-21,14:41:00,17494.5,SELL,3,0.02h,Stop Loss,$229.50,$218.25,$79123.25,37,$218.25
2024-02-21,15:04:00,17501.0,BUY,3,0.02h,Stop Loss,$323.25,$541.50,$79446.50,37,$541.50
2024-02-21,15:27:00,17476.75,SELL,3,0.02h,Break Even,$0.75,$542.25,$79447.25,37,$542.25
2024-02-21,15:59:00,17478.5,BUY,3,0.02h,Break Even,$0.75,$543.00,$79448.00,37,$543.00
2024-02-21,16:00:00,17469.25,SELL,3,0.02h,Break Even,$0.75,$543.75,$79448.75,37,$543.75
2024-02-21,16:02:00,17485.5,BUY,3,0.02h,Break Even,$0.75,$544.50,$79449.50,37,$544.50
2024-02-21,16:30:00,17490.0,SELL,3,0.02h,Stop Loss,$12.00,$556.50,$79461.50,37,$556.50
2024-02-21,16:52:00,17497.0,BUY,3,0.02h,Stop Loss,$19.50,$576.00,$79481.00,37,$576.00
2024-02-21,17:05:00,17483.25,SELL,3,0.02h,Stop Loss,$315.75,$891.75,$79796.75,37,$891.75
2024-02-21,17:41:00,17455.25,BUY,3,0.02h,Stop Loss,$30.75,$922.50,$79827.50,37,$922.50
2024-02-21,17:44:00,17448.0,SELL,3,0.02h,Stop Loss,$143.25,$1065.75,$79970.75,37,$1065.75
2024-02-21,17:47:00,17459.25,BUY,3,0.02h,Break Even,$0.75,$1066.50,$79971.50,37,$1066.50
2024-02-21,18:03:00,17431.0,SELL,3,0.02h,Stop Loss,$-18.00,$1048.50,$79953.50,37,$1048.50
2024-02-21,18:12:00,17469.0,BUY,3,0.02h,Stop Loss,$64.50,$1113.00,$80018.00,37,$1113.00
2024-02-21,18:28:00,17460.5,SELL,3,0.02h,Stop Loss,$68.25,$1181.25,$80086.25,37,$1181.25
2024-02-21,18:46:00,17468.0,BUY,3,0.02h,Stop Loss,$-18.00,$1163.25,$80068.25,37,$1163.25
2024-02-21,18:48:00,17459.75,SELL,3,0.02h,Stop Loss,$38.25,$1201.50,$80106.50,37,$1201.50
2024-02-21,18:51:00,17463.5,BUY,3,0.02h,Stop Loss,$-18.00,$1183.50,$80088.50,37,$1183.50
2024-02-21,18:52:00,17458.5,SELL,3,0.02h,Stop Loss,$12.00,$1195.50,$80100.50,37,$1195.50
2024-02-21,19:07:00,17462.5,BUY,3,0.02h,Stop Loss,$75.75,$1271.25,$80176.25,37,$1271.25
2024-02-21,19:17:00,17455.75,SELL,3,0.02h,Stop Loss,$60.75,$1332.00,$80237.00,37,$1332.00
2024-02-21,19:18:00,17466.75,BUY,3,0.02h,Stop Loss,$12.00,$1344.00,$80249.00,37,$1344.00
2024-02-21,19:19:00,17455.75,SELL,3,0.02h,Stop Loss,$154.50,$1498.50,$80403.50,37,$1498.50
2024-02-21,19:57:00,17409.0,BUY,3,0.02h,Stop Loss,$-18.00,$1480.50,$80385.50,37,$1480.50
2024-02-21,20:08:00,17394.75,SELL,3,0.02h,Break Even,$0.75,$1481.25,$80386.25,37,$1481.25
2024-02-21,20:19:00,17408.75,BUY,3,0.02h,Stop Loss,$-18.00,$1463.25,$80368.25,37,$1463.25
2024-02-21,20:22:00,17388.75,SELL,3,0.02h,Break Even,$0.75,$1464.00,$80369.00,37,$1464.00
2024-02-21,20:25:00,17401.5,BUY,3,0.02h,Stop Loss,$124.50,$1588.50,$80493.50,37,$1588.50
2024-02-21,21:22:00,17426.0,SELL,3,0.02h,Stop Loss,$27.00,$1615.50,$80520.50,37,$1615.50
2024-02-21,21:27:00,17544.0,BUY,3,0.02h,Stop Loss,$263.25,$1878.75,$80783.75,37,$1878.75
,,,,,,,,,,,
2024-02-22,12:59:00,17890.0,SELL,3,0.02h,Break Even,$0.75,$0.75,$80784.50,38,$0.75
2024-02-22,13:13:00,17895.0,BUY,3,0.02h,Stop Loss,$68.25,$69.00,$80852.75,38,$69.00
2024-02-22,13:28:00,17891.25,SELL,3,0.02h,Break Even,$0.75,$69.75,$80853.50,38,$69.75
2024-02-22,13:37:00,17900.25,BUY,3,0.02h,Stop Loss,$-18.00,$51.75,$80835.50,38,$51.75
2024-02-22,13:43:00,17889.25,SELL,3,0.02h,Stop Loss,$-18.00,$33.75,$80817.50,38,$33.75
2024-02-22,13:46:00,17898.75,BUY,3,0.02h,Stop Loss,$-18.00,$15.75,$80799.50,38,$15.75
2024-02-22,13:47:00,17893.0,SELL,3,0.02h,Break Even,$0.75,$16.50,$80800.25,38,$16.50
2024-02-22,13:50:00,17897.75,BUY,3,0.02h,Stop Loss,$15.75,$32.25,$80816.00,38,$32.25
2024-02-22,14:04:00,17891.25,SELL,3,0.02h,Break Even,$0.75,$33.00,$80816.75,38,$33.00
2024-02-22,14:30:00,17896.0,BUY,3,0.02h,Stop Loss,$304.50,$337.50,$81121.25,38,$337.50
2024-02-22,14:32:00,17870.75,SELL,3,0.02h,Stop Loss,$42.00,$379.50,$81163.25,38,$379.50
2024-02-22,14:33:00,17883.5,BUY,3,0.02h,Stop Loss,$68.25,$447.75,$81231.50,38,$447.75
2024-02-22,14:34:00,17868.5,SELL,3,0.02h,Stop Loss,$19.50,$467.25,$81251.00,38,$467.25
2024-02-22,14:40:00,17892.75,BUY,3,0.02h,Stop Loss,$169.50,$636.75,$81420.50,38,$636.75
2024-02-22,15:44:00,17936.0,SELL,3,0.02h,Stop Loss,$23.25,$660.00,$81443.75,38,$660.00
2024-02-22,16:07:00,17941.0,BUY,3,0.02h,Break Even,$0.75,$660.75,$81444.50,38,$660.75
2024-02-22,16:49:00,17952.0,SELL,3,0.02h,Break Even,$0.75,$661.50,$81445.25,38,$661.50
2024-02-22,17:07:00,17968.5,BUY,3,0.02h,Stop Loss,$-18.00,$643.50,$81427.25,38,$643.50
2024-02-22,19:36:00,18068.25,SELL,3,0.02h,Break Even,$0.75,$644.25,$81428.00,38,$644.25
2024-02-22,20:06:00,18071.5,BUY,3,0.02h,Stop Loss,$53.25,$697.50,$81481.25,38,$697.50
2024-02-22,20:31:00,18058.25,SELL,3,0.02h,Stop Loss,$109.50,$807.00,$81590.75,38,$807.00
2024-02-22,20:40:00,18075.25,BUY,3,0.02h,Break Even,$0.75,$807.75,$81591.50,38,$807.75
2024-02-22,20:48:00,18061.75,SELL,3,0.02h,Stop Loss,$15.75,$823.50,$81607.25,38,$823.50
2024-02-22,21:41:00,18020.25,BUY,3,0.03h,Break Even,$0.75,$824.25,$81608.00,38,$824.25
2024-02-22,21:45:00,18018.25,SELL,3,0.02h,Break Even,$0.75,$825.00,$81608.75,38,$825.00
2024-02-22,21:47:00,18020.75,BUY,3,0.02h,Stop Loss,$-18.00,$807.00,$81590.75,38,$807.00
,,,,,,,,,,,
2024-02-23,12:18:00,18024.5,SELL,3,0.02h,Break Even,$0.75,$0.75,$81591.50,39,$0.75
2024-02-23,12:27:00,18033.5,BUY,3,0.02h,Stop Loss,$30.75,$31.50,$81622.25,39,$31.50
2024-02-23,12:47:00,18035.0,SELL,3,0.02h,Break Even,$0.75,$32.25,$81623.00,39,$32.25
2024-02-23,12:50:00,18042.5,BUY,3,0.02h,Stop Loss,$-18.00,$14.25,$81605.00,39,$14.25
2024-02-23,13:03:00,18036.0,SELL,3,0.02h,Stop Loss,$-18.00,$-3.75,$81587.00,39,$-3.75
2024-02-23,13:06:00,18042.0,BUY,3,0.02h,Stop Loss,$12.00,$8.25,$81599.00,39,$8.25
2024-02-23,14:51:00,18110.5,SELL,3,0.02h,Stop Loss,$72.00,$80.25,$81671.00,39,$80.25
2024-02-23,16:26:00,17996.75,BUY,3,0.02h,Stop Loss,$68.25,$148.50,$81739.25,39,$148.50
2024-02-23,17:20:00,18035.75,SELL,3,0.02h,Stop Loss,$-18.00,$130.50,$81721.25,39,$130.50
2024-02-23,17:48:00,18033.0,BUY,3,0.02h,Break Even,$0.75,$131.25,$81722.00,39,$131.25
2024-02-23,18:39:00,18043.25,SELL,3,0.02h,Stop Loss,$-18.00,$113.25,$81704.00,39,$113.25
2024-02-23,19:37:00,18016.25,BUY,3,0.02h,Stop Loss,$12.00,$125.25,$81716.00,39,$125.25
2024-02-23,19:51:00,18007.0,SELL,3,0.02h,Stop Loss,$19.50,$144.75,$81735.50,39,$144.75
2024-02-23,19:53:00,18018.5,BUY,3,0.02h,Break Even,$0.75,$145.50,$81736.25,39,$145.50
2024-02-23,20:08:00,18001.0,SELL,3,0.02h,Stop Loss,$102.00,$247.50,$81838.25,39,$247.50
2024-02-23,20:39:00,18001.5,BUY,3,0.02h,Stop Loss,$-18.00,$229.50,$81820.25,39,$229.50
2024-02-23,21:01:00,17977.25,SELL,3,0.02h,Break Even,$0.75,$230.25,$81821.00,39,$230.25
2024-02-23,21:34:00,17969.75,BUY,3,0.02h,Stop Loss,$-18.00,$212.25,$81803.00,39,$212.25
2024-02-23,21:52:00,17968.25,SELL,3,0.03h,Break Even,$0.75,$213.00,$81803.75,39,$213.00
,,,,,,,,,,,
2024-02-26,12:00:00,17989.0,BUY,3,0.02h,Break Even,$0.75,$0.75,$81804.50,40,$0.75
2024-02-26,12:43:00,17980.75,SELL,3,0.02h,Break Even,$0.75,$1.50,$81805.25,40,$1.50
2024-02-26,13:08:00,17987.25,BUY,3,0.02h,Break Even,$0.75,$2.25,$81806.00,40,$2.25
2024-02-26,13:56:00,18013.25,SELL,3,0.02h,Break Even,$0.75,$3.00,$81806.75,40,$3.00
2024-02-26,13:59:00,18016.75,BUY,3,0.02h,Stop Loss,$-18.00,$-15.00,$81788.75,40,$-15.00
2024-02-26,14:01:00,18012.75,SELL,3,0.02h,Stop Loss,$-18.00,$-33.00,$81770.75,40,$-33.00
2024-02-26,14:30:00,18017.0,BUY,3,0.02h,Stop Loss,$274.50,$241.50,$82045.25,40,$241.50
2024-02-26,14:45:00,17992.25,SELL,3,0.02h,Stop Loss,$49.50,$291.00,$82094.75,40,$291.00
2024-02-26,15:08:00,18006.75,BUY,3,0.02h,Stop Loss,$79.50,$370.50,$82174.25,40,$370.50
2024-02-26,15:58:00,18019.75,SELL,3,0.02h,Stop Loss,$-18.00,$352.50,$82156.25,40,$352.50
2024-02-26,16:32:00,18025.5,BUY,3,0.02h,Stop Loss,$27.00,$379.50,$82183.25,40,$379.50
2024-02-26,17:03:00,18020.0,SELL,3,0.02h,Stop Loss,$-18.00,$361.50,$82165.25,40,$361.50
2024-02-26,17:16:00,18037.0,BUY,3,0.02h,Break Even,$0.75,$362.25,$82166.00,40,$362.25
2024-02-26,17:39:00,18037.25,SELL,3,0.02h,Break Even,$0.75,$363.00,$82166.75,40,$363.00
2024-02-26,18:09:00,18035.5,BUY,3,0.02h,Break Even,$0.75,$363.75,$82167.50,40,$363.75
2024-02-26,18:20:00,18015.5,SELL,3,0.02h,Stop Loss,$53.25,$417.00,$82220.75,40,$417.00
2024-02-26,18:58:00,18006.25,BUY,3,0.02h,Stop Loss,$42.00,$459.00,$82262.75,40,$459.00
2024-02-26,19:16:00,18009.75,SELL,3,0.02h,Stop Loss,$-18.00,$441.00,$82244.75,40,$441.00
2024-02-26,19:23:00,18025.75,BUY,3,0.02h,Stop Loss,$64.50,$505.50,$82309.25,40,$505.50
2024-02-26,19:43:00,18020.75,SELL,3,0.02h,Stop Loss,$53.25,$558.75,$82362.50,40,$558.75
2024-02-26,20:12:00,18024.75,BUY,3,0.02h,Stop Loss,$12.00,$570.75,$82374.50,40,$570.75
2024-02-26,20:21:00,18010.75,SELL,3,0.02h,Stop Loss,$-18.00,$552.75,$82356.50,40,$552.75
,,,,,,,,,,,
2024-02-27,12:00:00,18004.75,BUY,3,0.02h,Stop Loss,$15.75,$15.75,$82372.25,41,$15.75
2024-02-27,12:55:00,18029.75,SELL,3,0.02h,Break Even,$0.75,$16.50,$82373.00,41,$16.50
2024-02-27,13:37:00,18014.25,BUY,3,0.02h,Stop Loss,$-18.00,$-1.50,$82355.00,41,$-1.50
2024-02-27,14:10:00,18017.25,SELL,3,0.02h,Break Even,$0.75,$-0.75,$82355.75,41,$-0.75
2024-02-27,15:00:00,17990.25,BUY,3,0.02h,Stop Loss,$368.25,$367.50,$82724.00,41,$367.50
2024-02-27,15:40:00,17998.25,SELL,3,0.02h,Stop Loss,$53.25,$420.75,$82777.25,41,$420.75
2024-02-27,15:49:00,18023.25,BUY,3,0.02h,Break Even,$0.75,$421.50,$82778.00,41,$421.50
2024-02-27,16:05:00,18006.25,SELL,3,0.02h,Stop Loss,$147.00,$568.50,$82925.00,41,$568.50
2024-02-27,16:51:00,17992.0,BUY,3,0.02h,Stop Loss,$60.75,$629.25,$82985.75,41,$629.25
2024-02-27,17:18:00,17988.5,SELL,3,0.02h,Break Even,$0.75,$630.00,$82986.50,41,$630.00
2024-02-27,18:13:00,17951.75,BUY,3,0.02h,Break Even,$0.75,$630.75,$82987.25,41,$630.75
2024-02-27,18:30:00,17941.25,SELL,3,0.02h,Stop Loss,$23.25,$654.00,$83010.50,41,$654.00
2024-02-27,18:40:00,17952.5,BUY,3,0.02h,Break Even,$0.75,$654.75,$83011.25,41,$654.75
2024-02-27,20:18:00,18017.5,SELL,3,0.02h,Stop Loss,$38.25,$693.00,$83049.50,41,$693.00
2024-02-27,20:25:00,18023.75,BUY,3,0.02h,Stop Loss,$-18.00,$675.00,$83031.50,41,$675.00
2024-02-27,20:33:00,18010.0,SELL,3,0.02h,Break Even,$0.75,$675.75,$83032.25,41,$675.75
2024-02-27,20:49:00,18015.5,BUY,3,0.02h,Stop Loss,$15.75,$691.50,$83048.00,41,$691.50
2024-02-27,21:03:00,18010.5,SELL,3,0.02h,Break Even,$0.75,$692.25,$83048.75,41,$692.25
2024-02-27,21:12:00,18016.25,BUY,3,0.02h,Break Even,$0.75,$693.00,$83049.50,41,$693.00
2024-02-27,21:50:00,18020.5,SELL,3,0.02h,Stop Loss,$-18.00,$675.00,$83031.50,41,$675.00
,,,,,,,,,,,
2024-02-28,13:10:00,17935.25,BUY,3,0.02h,Stop Loss,$-18.00,$-18.00,$83013.50,42,$-18.00
2024-02-28,13:11:00,17934.0,SELL,3,0.02h,Stop Loss,$12.00,$-6.00,$83025.50,42,$-6.00
2024-02-28,13:20:00,17937.0,BUY,3,0.02h,Stop Loss,$27.00,$21.00,$83052.50,42,$21.00
2024-02-28,13:42:00,17926.25,SELL,3,0.02h,Stop Loss,$68.25,$89.25,$83120.75,42,$89.25
2024-02-28,13:48:00,17944.5,BUY,3,0.02h,Stop Loss,$23.25,$112.50,$83144.00,42,$112.50
2024-02-28,13:54:00,17931.5,SELL,3,0.02h,Break Even,$0.75,$113.25,$83144.75,42,$113.25
2024-02-28,14:00:00,17944.75,BUY,3,0.02h,Stop Loss,$-18.00,$95.25,$83126.75,42,$95.25
2024-02-28,14:05:00,17933.75,SELL,3,0.02h,Stop Loss,$42.00,$137.25,$83168.75,42,$137.25
2024-02-28,14:31:00,17937.0,BUY,3,0.02h,Stop Loss,$-18.00,$119.25,$83150.75,42,$119.25
2024-02-28,14:32:00,17924.5,SELL,3,0.02h,Stop Loss,$180.75,$300.00,$83331.50,42,$300.00
2024-02-28,14:37:00,17940.25,BUY,3,0.02h,Break Even,$0.75,$300.75,$83332.25,42,$300.75
2024-02-28,14:46:00,17913.5,SELL,3,0.02h,Stop Loss,$34.50,$335.25,$83366.75,42,$335.25
2024-02-28,15:11:00,17914.75,BUY,3,0.02h,Stop Loss,$79.50,$414.75,$83446.25,42,$414.75
2024-02-28,15:27:00,17904.5,SELL,3,0.02h,Stop Loss,$192.00,$606.75,$83638.25,42,$606.75
2024-02-28,15:33:00,17918.25,BUY,3,0.02h,Break Even,$0.75,$607.50,$83639.00,42,$607.50
2024-02-28,15:57:00,17916.0,SELL,3,0.02h,Break Even,$0.75,$608.25,$83639.75,42,$608.25
2024-02-28,15:58:00,17923.0,BUY,3,0.02h,Stop Loss,$72.00,$680.25,$83711.75,42,$680.25
2024-02-28,17:01:00,17955.75,SELL,3,0.02h,Break Even,$0.75,$681.00,$83712.50,42,$681.00
2024-02-28,17:55:00,17922.0,BUY,3,0.02h,Break Even,$0.75,$681.75,$83713.25,42,$681.75
2024-02-28,18:01:00,17911.0,SELL,3,0.02h,Stop Loss,$-18.00,$663.75,$83695.25,42,$663.75
2024-02-28,18:17:00,17919.75,BUY,3,0.02h,Stop Loss,$53.25,$717.00,$83748.50,42,$717.00
2024-02-28,18:52:00,17934.5,SELL,3,0.02h,Stop Loss,$-18.00,$699.00,$83730.50,42,$699.00
2024-02-28,18:59:00,17945.75,BUY,3,0.02h,Stop Loss,$12.00,$711.00,$83742.50,42,$711.00
2024-02-28,19:07:00,17935.25,SELL,3,0.02h,Stop Loss,$42.00,$753.00,$83784.50,42,$753.00
2024-02-28,19:57:00,17915.5,BUY,3,0.02h,Stop Loss,$-18.00,$735.00,$83766.50,42,$735.00
2024-02-28,20:11:00,17899.5,SELL,3,0.02h,Break Even,$0.75,$735.75,$83767.25,42,$735.75
2024-02-28,20:21:00,17909.5,BUY,3,0.02h,Stop Loss,$-18.00,$717.75,$83749.25,42,$717.75
2024-02-28,20:46:00,17906.0,SELL,3,0.02h,Stop Loss,$38.25,$756.00,$83787.50,42,$756.00
2024-02-28,21:01:00,17912.0,BUY,3,0.02h,Break Even,$0.75,$756.75,$83788.25,42,$756.75
2024-02-28,21:02:00,17909.25,SELL,3,0.02h,Stop Loss,$233.25,$990.00,$84021.50,42,$990.00
2024-02-28,21:58:00,17864.5,BUY,3,0.02h,Stop Loss,$-18.00,$972.00,$84003.50,42,$972.00
,,,,,,,,,,,
2024-02-29,12:21:00,17868.25,SELL,3,0.02h,Stop Loss,$23.25,$23.25,$84026.75,43,$23.25
2024-02-29,12:28:00,17874.5,BUY,3,0.02h,Stop Loss,$-18.00,$5.25,$84008.75,43,$5.25
2024-02-29,12:29:00,17869.0,SELL,3,0.02h,Stop Loss,$-18.00,$-12.75,$83990.75,43,$-12.75
2024-02-29,12:33:00,17874.0,BUY,3,0.02h,Break Even,$0.75,$-12.00,$83991.50,43,$-12.00
2024-02-29,12:40:00,17869.5,SELL,3,0.02h,Break Even,$0.75,$-11.25,$83992.25,43,$-11.25
2024-02-29,12:57:00,17874.75,BUY,3,0.02h,Stop Loss,$-18.00,$-29.25,$83974.25,43,$-29.25
2024-02-29,13:03:00,17865.25,SELL,3,0.02h,Stop Loss,$-18.00,$-47.25,$83956.25,43,$-47.25
2024-02-29,13:06:00,17874.25,BUY,3,0.02h,Stop Loss,$23.25,$-24.00,$83979.50,43,$-24.00
2024-02-29,13:24:00,17866.0,SELL,3,0.02h,Stop Loss,$-18.00,$-42.00,$83961.50,43,$-42.00
2024-02-29,13:31:00,17936.5,BUY,3,0.02h,Stop Loss,$334.50,$292.50,$84296.00,43,$292.50
2024-02-29,15:11:00,18011.5,SELL,3,0.02h,Stop Loss,$139.50,$432.00,$84435.50,43,$432.00
2024-02-29,15:37:00,18022.5,BUY,3,0.02h,Stop Loss,$-18.00,$414.00,$84417.50,43,$414.00
2024-02-29,15:44:00,18005.25,SELL,3,0.02h,Break Even,$0.75,$414.75,$84418.25,43,$414.75
2024-02-29,15:51:00,18025.25,BUY,3,0.02h,Stop Loss,$-18.00,$396.75,$84400.25,43,$396.75
2024-02-29,15:53:00,18016.0,SELL,3,0.02h,Stop Loss,$113.25,$510.00,$84513.50,43,$510.00
2024-02-29,16:16:00,18011.25,BUY,3,0.02h,Break Even,$0.75,$510.75,$84514.25,43,$510.75
2024-02-29,16:23:00,17996.0,SELL,3,0.02h,Stop Loss,$15.75,$526.50,$84530.00,43,$526.50
2024-02-29,16:54:00,17970.25,BUY,3,0.02h,Stop Loss,$38.25,$564.75,$84568.25,43,$564.75
2024-02-29,17:29:00,17983.75,SELL,3,0.02h,Stop Loss,$173.25,$738.00,$84741.50,43,$738.00
2024-02-29,17:43:00,17987.25,BUY,3,0.02h,Break Even,$0.75,$738.75,$84742.25,43,$738.75
2024-02-29,18:41:00,18031.25,SELL,3,0.02h,Stop Loss,$60.75,$799.50,$84803.00,43,$799.50
2024-02-29,18:53:00,18041.0,BUY,3,0.02h,Stop Loss,$-18.00,$781.50,$84785.00,43,$781.50
2024-02-29,19:06:00,18028.25,SELL,3,0.02h,Break Even,$0.75,$782.25,$84785.75,43,$782.25
2024-02-29,19:12:00,18041.5,BUY,3,0.02h,Break Even,$0.75,$783.00,$84786.50,43,$783.00
2024-02-29,19:27:00,18027.75,SELL,3,0.02h,Stop Loss,$30.75,$813.75,$84817.25,43,$813.75
2024-02-29,20:00:00,18037.0,BUY,3,0.02h,Stop Loss,$27.00,$840.75,$84844.25,43,$840.75
2024-02-29,21:05:00,18055.0,SELL,3,0.02h,Stop Loss,$240.75,$1081.50,$85085.00,43,$1081.50
2024-02-29,21:19:00,18066.25,BUY,3,0.02h,Break Even,$0.75,$1082.25,$85085.75,43,$1082.25
2024-02-29,21:46:00,18067.0,SELL,3,0.02h,Stop Loss,$-18.00,$1064.25,$85067.75,43,$1064.25
,,,,,,,,,,,
2024-03-01,12:00:00,18092.5,BUY,3,0.02h,Break Even,$0.75,$0.75,$85068.50,44,$0.75
2024-03-01,12:25:00,18076.75,SELL,3,0.02h,Stop Loss,$-18.00,$-17.25,$85050.50,44,$-17.25
2024-03-01,12:38:00,18086.5,BUY,3,0.02h,Break Even,$0.75,$-16.50,$85051.25,44,$-16.50
2024-03-01,13:24:00,18093.25,SELL,3,0.02h,Stop Loss,$42.00,$25.50,$85093.25,44,$25.50
2024-03-01,13:32:00,18102.0,BUY,3,0.02h,Stop Loss,$-18.00,$7.50,$85075.25,44,$7.50
2024-03-01,13:33:00,18096.25,SELL,3,0.02h,Stop Loss,$-18.00,$-10.50,$85057.25,44,$-10.50
2024-03-01,13:50:00,18098.75,BUY,3,0.02h,Stop Loss,$-18.00,$-28.50,$85039.25,44,$-28.50
2024-03-01,13:55:00,18084.25,SELL,3,0.02h,Break Even,$0.75,$-27.75,$85040.00,44,$-27.75
2024-03-01,14:17:00,18091.0,BUY,3,0.02h,Stop Loss,$-18.00,$-45.75,$85022.00,44,$-45.75
2024-03-01,15:33:00,18158.0,SELL,3,0.02h,Stop Loss,$27.00,$-18.75,$85049.00,44,$-18.75
2024-03-01,15:46:00,18182.25,BUY,3,0.02h,Stop Loss,$45.75,$27.00,$85094.75,44,$27.00
2024-03-01,16:36:00,18215.0,SELL,3,0.02h,Stop Loss,$-18.00,$9.00,$85076.75,44,$9.00
2024-03-01,16:38:00,18230.5,BUY,3,0.02h,Stop Loss,$-18.00,$-9.00,$85058.75,44,$-9.00
2024-03-01,17:04:00,18229.0,SELL,3,0.02h,Break Even,$0.75,$-8.25,$85059.50,44,$-8.25
2024-03-01,17:13:00,18244.0,BUY,3,0.02h,Break Even,$0.75,$-7.50,$85060.25,44,$-7.50
2024-03-01,19:35:00,18352.75,SELL,3,0.02h,Stop Loss,$98.25,$90.75,$85158.50,44,$90.75
2024-03-01,19:51:00,18360.75,BUY,3,0.02h,Break Even,$0.75,$91.50,$85159.25,44,$91.50
2024-03-01,20:04:00,18346.25,SELL,3,0.02h,Break Even,$0.75,$92.25,$85160.00,44,$92.25
2024-03-01,20:29:00,18346.0,BUY,3,0.02h,Stop Loss,$-18.00,$74.25,$85142.00,44,$74.25
2024-03-01,20:33:00,18333.5,SELL,3,0.02h,Stop Loss,$-18.00,$56.25,$85124.00,44,$56.25
2024-03-01,20:46:00,18344.5,BUY,3,0.02h,Break Even,$0.75,$57.00,$85124.75,44,$57.00
2024-03-01,21:00:00,18335.0,SELL,3,0.02h,Stop Loss,$143.25,$200.25,$85268.00,44,$200.25
,,,,,,,,,,,
2024-03-04,12:00:00,18334.5,BUY,3,0.03h,Break Even,$0.75,$0.75,$85268.75,45,$0.75
2024-03-04,12:40:00,18339.25,SELL,3,0.02h,Stop Loss,$-18.00,$-17.25,$85250.75,45,$-17.25
2024-03-04,12:43:00,18345.0,BUY,3,0.02h,Break Even,$0.75,$-16.50,$85251.50,45,$-16.50
2024-03-04,12:53:00,18342.5,SELL,3,0.02h,Break Even,$0.75,$-15.75,$85252.25,45,$-15.75
2024-03-04,13:13:00,18346.75,BUY,3,0.02h,Stop Loss,$-18.00,$-33.75,$85234.25,45,$-33.75
2024-03-04,13:27:00,18340.0,SELL,3,0.02h,Stop Loss,$57.00,$23.25,$85291.25,45,$23.25
2024-03-04,13:43:00,18344.75,BUY,3,0.02h,Stop Loss,$-18.00,$5.25,$85273.25,45,$5.25
2024-03-04,13:50:00,18335.0,SELL,3,0.02h,Break Even,$0.75,$6.00,$85274.00,45,$6.00
2024-03-04,15:19:00,18300.25,BUY,3,0.02h,Stop Loss,$-18.00,$-12.00,$85256.00,45,$-12.00
2024-03-04,15:20:00,18298.25,SELL,3,0.02h,Stop Loss,$132.00,$120.00,$85388.00,45,$120.00
2024-03-04,15:34:00,18301.75,BUY,3,0.02h,Stop Loss,$79.50,$199.50,$85467.50,45,$199.50
2024-03-04,16:06:00,18312.0,SELL,3,0.02h,Stop Loss,$105.75,$305.25,$85573.25,45,$305.25
2024-03-04,16:49:00,18307.75,BUY,3,0.02h,Stop Loss,$-18.00,$287.25,$85555.25,45,$287.25
2024-03-04,17:07:00,18306.25,SELL,3,0.02h,Stop Loss,$64.50,$351.75,$85619.75,45,$351.75
2024-03-04,17:14:00,18310.0,BUY,3,0.02h,Stop Loss,$-18.00,$333.75,$85601.75,45,$333.75
2024-03-04,17:36:00,18309.75,SELL,3,0.02h,Stop Loss,$42.00,$375.75,$85643.75,45,$375.75
2024-03-04,18:03:00,18309.25,BUY,3,0.02h,Stop Loss,$-18.00,$357.75,$85625.75,45,$357.75
2024-03-04,18:07:00,18300.75,SELL,3,0.02h,Break Even,$0.75,$358.50,$85626.50,45,$358.50
2024-03-04,18:39:00,18294.25,BUY,3,0.02h,Stop Loss,$-18.00,$340.50,$85608.50,45,$340.50
2024-03-04,19:08:00,18292.75,SELL,3,0.02h,Stop Loss,$12.00,$352.50,$85620.50,45,$352.50
2024-03-04,19:16:00,18302.0,BUY,3,0.02h,Stop Loss,$-18.00,$334.50,$85602.50,45,$334.50
2024-03-04,19:17:00,18298.0,SELL,3,0.02h,Break Even,$0.75,$335.25,$85603.25,45,$335.25
2024-03-04,19:18:00,18301.0,BUY,3,0.02h,Stop Loss,$83.25,$418.50,$85686.50,45,$418.50
2024-03-04,19:29:00,18297.75,SELL,3,0.02h,Break Even,$0.75,$419.25,$85687.25,45,$419.25
2024-03-04,19:34:00,18307.25,BUY,3,0.02h,Stop Loss,$38.25,$457.50,$85725.50,45,$457.50
2024-03-04,20:08:00,18327.75,SELL,3,0.02h,Stop Loss,$-18.00,$439.50,$85707.50,45,$439.50
2024-03-04,20:09:00,18335.25,BUY,3,0.02h,Stop Loss,$15.75,$455.25,$85723.25,45,$455.25
2024-03-04,20:29:00,18334.75,SELL,3,0.02h,Stop Loss,$229.50,$684.75,$85952.75,45,$684.75
2024-03-04,21:59:00,18242.0,BUY,3,0.02h,Stop Loss,$15.75,$700.50,$85968.50,45,$700.50
,,,,,,,,,,,
2024-03-05,12:00:00,18157.75,SELL,3,0.02h,Stop Loss,$-18.00,$-18.00,$85950.50,46,$-18.00
2024-03-05,13:04:00,18161.75,BUY,3,0.02h,Stop Loss,$-18.00,$-36.00,$85932.50,46,$-36.00
2024-03-05,13:23:00,18160.0,SELL,3,0.02h,Stop Loss,$-18.00,$-54.00,$85914.50,46,$-54.00
2024-03-05,15:04:00,18078.75,BUY,3,0.02h,Stop Loss,$30.75,$-23.25,$85945.25,46,$-23.25
2024-03-05,15:07:00,18050.75,SELL,3,0.02h,Stop Loss,$304.50,$281.25,$86249.75,46,$281.25
2024-03-05,16:07:00,17942.75,BUY,3,0.02h,Stop Loss,$19.50,$300.75,$86269.25,46,$300.75
2024-03-05,16:11:00,17931.0,SELL,3,0.02h,Stop Loss,$173.25,$474.00,$86442.50,46,$474.00
2024-03-05,16:19:00,17949.25,BUY,3,0.02h,Break Even,$0.75,$474.75,$86443.25,46,$474.75
2024-03-05,16:37:00,17937.75,SELL,3,0.02h,Break Even,$0.75,$475.50,$86444.00,46,$475.50
2024-03-05,17:01:00,17943.25,BUY,3,0.02h,Break Even,$0.75,$476.25,$86444.75,46,$476.25
2024-03-05,17:40:00,17951.25,SELL,3,0.02h,Stop Loss,$102.00,$578.25,$86546.75,46,$578.25
2024-03-05,17:47:00,17966.25,BUY,3,0.02h,Break Even,$0.75,$579.00,$86547.50,46,$579.00
2024-03-05,17:52:00,17948.5,SELL,3,0.02h,Break Even,$0.75,$579.75,$86548.25,46,$579.75
2024-03-05,17:56:00,17965.25,BUY,3,0.02h,Break Even,$0.75,$580.50,$86549.00,46,$580.50
2024-03-05,18:01:00,17946.25,SELL,3,0.02h,Break Even,$0.75,$581.25,$86549.75,46,$581.25
2024-03-05,19:11:00,17899.5,BUY,3,0.02h,Break Even,$0.75,$582.00,$86550.50,46,$582.00
2024-03-05,19:21:00,17881.75,SELL,3,0.02h,Stop Loss,$-18.00,$564.00,$86532.50,46,$564.00
2024-03-05,19:24:00,17898.25,BUY,3,0.02h,Break Even,$0.75,$564.75,$86533.25,46,$564.75
2024-03-05,19:31:00,17888.75,SELL,3,0.02h,Stop Loss,$128.25,$693.00,$86661.50,46,$693.00
2024-03-05,20:05:00,17872.75,BUY,3,0.02h,Stop Loss,$109.50,$802.50,$86771.00,46,$802.50
2024-03-05,20:09:00,17861.25,SELL,3,0.02h,Stop Loss,$15.75,$818.25,$86786.75,46,$818.25
2024-03-05,20:36:00,17858.25,BUY,3,0.02h,Break Even,$0.75,$819.00,$86787.50,46,$819.00
,,,,,,,,,,,
2024-03-06,13:32:00,18076.0,SELL,3,0.02h,Stop Loss,$143.25,$143.25,$86930.75,47,$143.25
2024-03-06,13:49:00,18083.0,BUY,3,0.02h,Stop Loss,$53.25,$196.50,$86984.00,47,$196.50
2024-03-06,14:37:00,18074.25,SELL,3,0.02h,Break Even,$0.75,$197.25,$86984.75,47,$197.25
2024-03-06,14:46:00,18108.75,BUY,3,0.02h,Break Even,$0.75,$198.00,$86985.50,47,$198.00
2024-03-06,14:47:00,18086.0,SELL,3,0.02h,Stop Loss,$147.00,$345.00,$87132.50,47,$345.00
2024-03-06,15:23:00,18030.0,BUY,3,0.02h,Stop Loss,$27.00,$372.00,$87159.50,47,$372.00
2024-03-06,15:25:00,18013.0,SELL,3,0.02h,Break Even,$0.75,$372.75,$87160.25,47,$372.75
2024-03-06,15:34:00,18034.75,BUY,3,0.02h,Stop Loss,$165.75,$538.50,$87326.00,47,$538.50
2024-03-06,16:33:00,18078.0,SELL,3,0.02h,Stop Loss,$169.50,$708.00,$87495.50,47,$708.00
2024-03-06,16:41:00,18093.75,BUY,3,0.02h,Break Even,$0.75,$708.75,$87496.25,47,$708.75
2024-03-06,17:42:00,18146.75,SELL,3,0.02h,Stop Loss,$45.75,$754.50,$87542.00,47,$754.50
2024-03-06,18:16:00,18142.25,BUY,3,0.02h,Stop Loss,$-18.00,$736.50,$87524.00,47,$736.50
2024-03-06,18:34:00,18082.0,SELL,3,0.02h,Stop Loss,$30.75,$767.25,$87554.75,47,$767.25
2024-03-06,19:25:00,18066.25,BUY,3,0.02h,Break Even,$0.75,$768.00,$87555.50,47,$768.00
2024-03-06,19:35:00,18053.0,SELL,3,0.02h,Stop Loss,$240.75,$1008.75,$87796.25,47,$1008.75
2024-03-06,20:11:00,18044.75,BUY,3,0.02h,Stop Loss,$19.50,$1028.25,$87815.75,47,$1028.25
2024-03-06,20:14:00,18021.5,SELL,3,0.02h,Stop Loss,$323.25,$1351.50,$88139.00,47,$1351.50
2024-03-06,20:41:00,18034.5,BUY,3,0.02h,Stop Loss,$15.75,$1367.25,$88154.75,47,$1367.25
2024-03-06,21:09:00,18034.0,SELL,3,0.02h,Break Even,$0.75,$1368.00,$88155.50,47,$1368.00
2024-03-06,21:14:00,18039.5,BUY,3,0.02h,Stop Loss,$-18.00,$1350.00,$88137.50,47,$1350.00
2024-03-06,21:51:00,18041.75,SELL,3,0.02h,Stop Loss,$-18.00,$1332.00,$88119.50,47,$1332.00
,,,,,,,,,,,
2024-03-07,12:00:00,18352.75,BUY,3,0.02h,Stop Loss,$-18.00,$-18.00,$88101.50,48,$-18.00
2024-03-07,12:27:00,18121.5,SELL,3,0.02h,Stop Loss,$-18.00,$-36.00,$88083.50,48,$-36.00
2024-03-07,12:28:00,18370.75,BUY,3,0.02h,Stop Loss,$-18.00,$-54.00,$88065.50,48,$-54.00
2024-03-07,12:32:00,18124.75,SELL,3,0.02h,Break Even,$0.75,$-53.25,$88066.25,48,$-53.25
2024-03-07,12:50:00,18371.25,BUY,3,0.02h,Stop Loss,$-18.00,$-71.25,$88048.25,48,$-71.25
2024-03-07,12:52:00,18125.25,SELL,3,0.02h,Stop Loss,$-18.00,$-89.25,$88030.25,48,$-89.25
2024-03-07,12:53:00,18362.0,BUY,3,0.03h,Stop Loss,$-18.00,$-107.25,$88012.25,48,$-107.25
2024-03-07,12:58:00,18120.5,SELL,3,0.02h,Break Even,$0.75,$-106.50,$88013.00,48,$-106.50
2024-03-07,13:03:00,18361.5,BUY,3,0.03h,Stop Loss,$-18.00,$-124.50,$87995.00,48,$-124.50
2024-03-07,13:23:00,18139.25,SELL,3,0.02h,Break Even,$0.75,$-123.75,$87995.75,48,$-123.75
2024-03-07,13:27:00,18384.5,BUY,3,0.02h,Break Even,$0.75,$-123.00,$87996.50,48,$-123.00
2024-03-07,13:30:00,18138.75,SELL,3,0.02h,Stop Loss,$23.25,$-99.75,$88019.75,48,$-99.75
2024-03-07,13:36:00,18396.75,BUY,3,0.02h,Break Even,$0.75,$-99.00,$88020.50,48,$-99.00
2024-03-07,13:39:00,18146.75,SELL,3,0.02h,Stop Loss,$-18.00,$-117.00,$88002.50,48,$-117.00
2024-03-07,13:42:00,18392.75,BUY,3,0.02h,Break Even,$0.75,$-116.25,$88003.25,48,$-116.25
2024-03-07,13:48:00,18158.0,SELL,3,0.02h,Stop Loss,$15.75,$-100.50,$88019.00,48,$-100.50
2024-03-07,13:59:00,18398.0,BUY,3,0.02h,Stop Loss,$-18.00,$-118.50,$88001.00,48,$-118.50
2024-03-07,14:14:00,18150.5,SELL,3,0.02h,Break Even,$0.75,$-117.75,$88001.75,48,$-117.75
2024-03-07,14:16:00,18400.0,BUY,3,0.02h,Stop Loss,$-18.00,$-135.75,$87983.75,48,$-135.75
2024-03-07,14:17:00,18153.75,SELL,3,0.02h,Break Even,$0.75,$-135.00,$87984.50,48,$-135.00
2024-03-07,14:20:00,18420.75,BUY,3,0.02h,Stop Loss,$30.75,$-104.25,$88015.25,48,$-104.25
2024-03-07,14:26:00,18172.25,SELL,3,0.02h,Stop Loss,$-18.00,$-122.25,$87997.25,48,$-122.25
2024-03-07,14:27:00,18417.75,BUY,3,0.02h,Stop Loss,$-18.00,$-140.25,$87979.25,48,$-140.25
2024-03-07,14:28:00,18172.5,SELL,3,0.02h,Stop Loss,$-18.00,$-158.25,$87961.25,48,$-158.25
2024-03-07,14:29:00,18419.25,BUY,3,0.02h,Stop Loss,$158.25,$0.00,$88119.50,48,$0.00
2024-03-07,14:43:00,18180.5,SELL,3,0.02h,Stop Loss,$-18.00,$-18.00,$88101.50,48,$-18.00
2024-03-07,14:44:00,18425.0,BUY,3,0.02h,Stop Loss,$-18.00,$-36.00,$88083.50,48,$-36.00
2024-03-07,14:45:00,18163.25,SELL,3,0.02h,Stop Loss,$282.00,$246.00,$88365.50,48,$246.00
2024-03-07,14:54:00,18438.75,BUY,3,0.02h,Stop Loss,$-18.00,$228.00,$88347.50,48,$228.00
2024-03-07,14:55:00,18194.0,SELL,3,0.02h,Break Even,$0.75,$228.75,$88348.25,48,$228.75
2024-03-07,14:57:00,18453.5,BUY,3,0.02h,Stop Loss,$-18.00,$210.75,$88330.25,48,$210.75
2024-03-07,14:58:00,18184.5,SELL,3,0.02h,Break Even,$0.75,$211.50,$88331.00,48,$211.50
2024-03-07,15:10:00,18435.5,BUY,3,0.02h,Stop Loss,$188.25,$399.75,$88519.25,48,$399.75
2024-03-07,15:20:00,18216.75,SELL,3,0.02h,Stop Loss,$-18.00,$381.75,$88501.25,48,$381.75
2024-03-07,15:24:00,18460.75,BUY,3,0.02h,Stop Loss,$-18.00,$363.75,$88483.25,48,$363.75
2024-03-07,15:26:00,18229.5,SELL,3,0.02h,Stop Loss,$15.75,$379.50,$88499.00,48,$379.50
2024-03-07,15:36:00,18478.5,BUY,3,0.02h,Stop Loss,$-18.00,$361.50,$88481.00,48,$361.50
2024-03-07,15:55:00,18242.5,SELL,3,0.02h,Stop Loss,$64.50,$426.00,$88545.50,48,$426.00
2024-03-07,16:00:00,18498.5,BUY,3,0.02h,Stop Loss,$-18.00,$408.00,$88527.50,48,$408.00
2024-03-07,16:01:00,18246.25,SELL,3,0.02h,Stop Loss,$23.25,$431.25,$88550.75,48,$431.25
2024-03-07,16:04:00,18496.75,BUY,3,0.02h,Stop Loss,$124.50,$555.75,$88675.25,48,$555.75
2024-03-07,16:08:00,18261.75,SELL,3,0.02h,Stop Loss,$-18.00,$537.75,$88657.25,48,$537.75
2024-03-07,16:09:00,18514.75,BUY,3,0.02h,Stop Loss,$-18.00,$519.75,$88639.25,48,$519.75
2024-03-07,16:22:00,18271.0,SELL,3,0.02h,Stop Loss,$-18.00,$501.75,$88621.25,48,$501.75
2024-03-07,16:30:00,18536.0,BUY,3,0.02h,Stop Loss,$-18.00,$483.75,$88603.25,48,$483.75
2024-03-07,16:32:00,18274.25,SELL,3,0.02h,Stop Loss,$-18.00,$465.75,$88585.25,48,$465.75
2024-03-07,16:33:00,18523.5,BUY,3,0.02h,Stop Loss,$-18.00,$447.75,$88567.25,48,$447.75
2024-03-07,16:34:00,18269.75,SELL,3,0.02h,Stop Loss,$-18.00,$429.75,$88549.25,48,$429.75
2024-03-07,16:35:00,18522.75,BUY,3,0.02h,Stop Loss,$-18.00,$411.75,$88531.25,48,$411.75
2024-03-07,16:37:00,18268.5,SELL,3,0.02h,Stop Loss,$-18.00,$393.75,$88513.25,48,$393.75
2024-03-07,16:38:00,18527.75,BUY,3,0.02h,Stop Loss,$-18.00,$375.75,$88495.25,48,$375.75
2024-03-07,16:40:00,18284.0,SELL,3,0.02h,Break Even,$0.75,$376.50,$88496.00,48,$376.50
2024-03-07,16:43:00,18540.25,BUY,3,0.02h,Stop Loss,$-18.00,$358.50,$88478.00,48,$358.50
2024-03-07,16:50:00,18282.75,SELL,3,0.02h,Stop Loss,$-18.00,$340.50,$88460.00,48,$340.50
2024-03-07,16:51:00,18536.25,BUY,3,0.02h,Stop Loss,$-18.00,$322.50,$88442.00,48,$322.50
2024-03-07,16:52:00,18283.75,SELL,3,0.02h,Stop Loss,$-18.00,$304.50,$88424.00,48,$304.50
2024-03-07,16:53:00,18534.5,BUY,3,0.02h,Break Even,$0.75,$305.25,$88424.75,48,$305.25
2024-03-07,17:01:00,18302.0,SELL,3,0.02h,Stop Loss,$19.50,$324.75,$88444.25,48,$324.75
2024-03-07,17:03:00,18546.0,BUY,3,0.02h,Stop Loss,$-18.00,$306.75,$88426.25,48,$306.75
2024-03-07,17:04:00,18298.25,SELL,3,0.02h,Stop Loss,$-18.00,$288.75,$88408.25,48,$288.75
2024-03-07,17:09:00,18551.5,BUY,3,0.02h,Stop Loss,$109.50,$398.25,$88517.75,48,$398.25
2024-03-07,17:18:00,18322.25,SELL,3,0.02h,Stop Loss,$-18.00,$380.25,$88499.75,48,$380.25
2024-03-07,17:19:00,18570.0,BUY,3,0.02h,Stop Loss,$-18.00,$362.25,$88481.75,48,$362.25
2024-03-07,17:20:00,18320.75,SELL,3,0.02h,Stop Loss,$-18.00,$344.25,$88463.75,48,$344.25
2024-03-07,17:21:00,18573.25,BUY,3,0.02h,Stop Loss,$-18.00,$326.25,$88445.75,48,$326.25
2024-03-07,17:24:00,18306.75,SELL,3,0.02h,Stop Loss,$-18.00,$308.25,$88427.75,48,$308.25
2024-03-07,17:28:00,18566.0,BUY,3,0.02h,Stop Loss,$-18.00,$290.25,$88409.75,48,$290.25
2024-03-07,17:29:00,18317.75,SELL,3,0.02h,Stop Loss,$113.25,$403.50,$88523.00,48,$403.50
2024-03-07,17:36:00,18559.5,BUY,3,0.02h,Stop Loss,$60.75,$464.25,$88583.75,48,$464.25
2024-03-07,17:52:00,18305.75,SELL,3,0.02h,Stop Loss,$-18.00,$446.25,$88565.75,48,$446.25
2024-03-07,17:53:00,18562.25,BUY,3,0.02h,Stop Loss,$-18.00,$428.25,$88547.75,48,$428.25
2024-03-07,17:59:00,18306.25,SELL,3,0.02h,Stop Loss,$-18.00,$410.25,$88529.75,48,$410.25
2024-03-07,18:04:00,18562.5,BUY,3,0.02h,Stop Loss,$-18.00,$392.25,$88511.75,48,$392.25
2024-03-07,18:05:00,18306.5,SELL,3,0.02h,Stop Loss,$113.25,$505.50,$88625.00,48,$505.50
2024-03-07,18:19:00,18564.0,BUY,3,0.02h,Stop Loss,$23.25,$528.75,$88648.25,48,$528.75
2024-03-07,18:23:00,18312.25,SELL,3,0.02h,Stop Loss,$-18.00,$510.75,$88630.25,48,$510.75
2024-03-07,18:28:00,18570.5,BUY,3,0.02h,Break Even,$0.75,$511.50,$88631.00,48,$511.50
2024-03-07,18:33:00,18329.75,SELL,3,0.02h,Stop Loss,$15.75,$527.25,$88646.75,48,$527.25
2024-03-07,18:35:00,18585.0,BUY,3,0.02h,Stop Loss,$-18.00,$509.25,$88628.75,48,$509.25
2024-03-07,18:36:00,18336.25,SELL,3,0.02h,Stop Loss,$-18.00,$491.25,$88610.75,48,$491.25
2024-03-07,18:37:00,18589.5,BUY,3,0.02h,Stop Loss,$27.00,$518.25,$88637.75,48,$518.25
2024-03-07,18:44:00,18340.5,SELL,3,0.02h,Stop Loss,$-18.00,$500.25,$88619.75,48,$500.25
2024-03-07,18:45:00,18593.5,BUY,3,0.02h,Stop Loss,$-18.00,$482.25,$88601.75,48,$482.25
2024-03-07,18:52:00,18351.75,SELL,3,0.02h,Stop Loss,$-18.00,$464.25,$88583.75,48,$464.25
2024-03-07,19:07:00,18597.5,BUY,3,0.02h,Stop Loss,$-18.00,$446.25,$88565.75,48,$446.25
2024-03-07,19:08:00,18350.5,SELL,3,0.02h,Stop Loss,$-18.00,$428.25,$88547.75,48,$428.25
2024-03-07,19:09:00,18591.5,BUY,3,0.02h,Stop Loss,$-18.00,$410.25,$88529.75,48,$410.25
2024-03-07,19:10:00,18340.0,SELL,3,0.02h,Stop Loss,$-18.00,$392.25,$88511.75,48,$392.25
2024-03-07,19:11:00,18600.0,BUY,3,0.02h,Break Even,$0.75,$393.00,$88512.50,48,$393.00
2024-03-07,19:22:00,18341.25,SELL,3,0.02h,Stop Loss,$-18.00,$375.00,$88494.50,48,$375.00
2024-03-07,19:23:00,18593.5,BUY,3,0.02h,Stop Loss,$-18.00,$357.00,$88476.50,48,$357.00
2024-03-07,19:24:00,18336.0,SELL,3,0.02h,Stop Loss,$-18.00,$339.00,$88458.50,48,$339.00
2024-03-07,19:26:00,18588.5,BUY,3,0.02h,Break Even,$0.75,$339.75,$88459.25,48,$339.75
2024-03-07,19:28:00,18341.75,SELL,3,0.02h,Stop Loss,$45.75,$385.50,$88505.00,48,$385.50
2024-03-07,19:49:00,18597.5,BUY,3,0.02h,Stop Loss,$60.75,$446.25,$88565.75,48,$446.25
2024-03-07,19:58:00,18335.75,SELL,3,0.02h,Stop Loss,$-18.00,$428.25,$88547.75,48,$428.25
2024-03-07,19:59:00,18578.0,BUY,3,0.02h,Break Even,$0.75,$429.00,$88548.50,48,$429.00
2024-03-07,20:05:00,18313.25,SELL,3,0.02h,Stop Loss,$87.00,$516.00,$88635.50,48,$516.00
2024-03-07,20:07:00,18571.25,BUY,3,0.02h,Stop Loss,$-18.00,$498.00,$88617.50,48,$498.00
2024-03-07,20:16:00,18314.0,SELL,3,0.02h,Break Even,$0.75,$498.75,$88618.25,48,$498.75
2024-03-07,20:21:00,18554.25,BUY,3,0.02h,Break Even,$0.75,$499.50,$88619.00,48,$499.50
2024-03-07,20:29:00,18303.25,SELL,3,0.02h,Stop Loss,$-18.00,$481.50,$88601.00,48,$481.50
2024-03-07,20:30:00,18554.0,BUY,3,0.02h,Stop Loss,$-18.00,$463.50,$88583.00,48,$463.50
2024-03-07,20:31:00,18307.5,SELL,3,0.02h,Break Even,$0.75,$464.25,$88583.75,48,$464.25
2024-03-07,20:36:00,18563.75,BUY,3,0.02h,Stop Loss,$-18.00,$446.25,$88565.75,48,$446.25
2024-03-07,20:37:00,18314.75,SELL,3,0.02h,Stop Loss,$15.75,$462.00,$88581.50,48,$462.00
2024-03-07,20:41:00,18573.75,BUY,3,0.02h,Stop Loss,$19.50,$481.50,$88601.00,48,$481.50
2024-03-07,20:53:00,18321.0,SELL,3,0.02h,Stop Loss,$38.25,$519.75,$88639.25,48,$519.75
2024-03-07,21:04:00,18536.75,BUY,3,0.02h,Stop Loss,$-18.00,$501.75,$88621.25,48,$501.75
2024-03-07,21:05:00,18292.75,SELL,3,0.02h,Stop Loss,$-18.00,$483.75,$88603.25,48,$483.75
2024-03-07,21:07:00,18518.0,BUY,3,0.02h,Stop Loss,$-18.00,$465.75,$88585.25,48,$465.75
2024-03-07,21:08:00,18268.75,SELL,3,0.02h,Stop Loss,$-18.00,$447.75,$88567.25,48,$447.75
2024-03-07,21:20:00,18466.75,BUY,3,0.02h,Stop Loss,$-18.00,$429.75,$88549.25,48,$429.75
2024-03-07,21:21:00,18224.0,SELL,3,0.02h,Stop Loss,$30.75,$460.50,$88580.00,48,$460.50
2024-03-07,21:28:00,18467.5,BUY,3,0.02h,Stop Loss,$173.25,$633.75,$88753.25,48,$633.75
2024-03-07,21:35:00,18217.25,SELL,3,0.02h,Stop Loss,$120.75,$754.50,$88874.00,48,$754.50
2024-03-07,21:38:00,18491.0,BUY,3,0.02h,Stop Loss,$-18.00,$736.50,$88856.00,48,$736.50
2024-03-07,21:39:00,18240.5,SELL,3,0.02h,Stop Loss,$-18.00,$718.50,$88838.00,48,$718.50
2024-03-07,21:40:00,18496.5,BUY,3,0.02h,Stop Loss,$-18.00,$700.50,$88820.00,48,$700.50
2024-03-07,21:43:00,18244.0,SELL,3,0.02h,Stop Loss,$105.75,$806.25,$88925.75,48,$806.25
2024-03-07,21:54:00,18507.0,BUY,3,0.02h,Break Even,$0.75,$807.00,$88926.50,48,$807.00
,,,,,,,,,,,
2024-03-08,12:11:00,18293.0,SELL,3,0.02h,Break Even,$0.75,$0.75,$88927.25,49,$0.75
2024-03-08,12:25:00,18530.0,BUY,3,0.02h,Stop Loss,$-18.00,$-17.25,$88909.25,49,$-17.25
2024-03-08,12:27:00,18278.0,SELL,3,0.02h,Break Even,$0.75,$-16.50,$88910.00,49,$-16.50
2024-03-08,12:36:00,18529.25,BUY,3,0.02h,Stop Loss,$-18.00,$-34.50,$88892.00,49,$-34.50
2024-03-08,12:37:00,18274.5,SELL,3,0.02h,Stop Loss,$-18.00,$-52.50,$88874.00,49,$-52.50
2024-03-08,12:38:00,18522.0,BUY,3,0.02h,Stop Loss,$-18.00,$-70.50,$88856.00,49,$-70.50
2024-03-08,12:47:00,18261.5,SELL,3,0.02h,Stop Loss,$-18.00,$-88.50,$88838.00,49,$-88.50
2024-03-08,12:48:00,18520.25,BUY,3,0.02h,Break Even,$0.75,$-87.75,$88838.75,49,$-87.75
2024-03-08,12:51:00,18260.75,SELL,3,0.02h,Stop Loss,$-18.00,$-105.75,$88820.75,49,$-105.75
2024-03-08,12:52:00,18510.5,BUY,3,0.02h,Stop Loss,$-18.00,$-123.75,$88802.75,49,$-123.75
2024-03-08,12:53:00,18254.75,SELL,3,0.02h,Stop Loss,$-18.00,$-141.75,$88784.75,49,$-141.75
2024-03-08,12:55:00,18516.25,BUY,3,0.02h,Stop Loss,$-18.00,$-159.75,$88766.75,49,$-159.75
2024-03-08,12:56:00,18262.75,SELL,3,0.02h,Stop Loss,$-18.00,$-177.75,$88748.75,49,$-177.75
2024-03-08,12:57:00,18516.25,BUY,3,0.02h,Stop Loss,$-18.00,$-195.75,$88730.75,49,$-195.75
2024-03-08,12:58:00,18267.75,SELL,3,0.02h,Break Even,$0.75,$-195.00,$88731.50,49,$-195.00
2024-03-08,13:01:00,18523.25,BUY,3,0.02h,Stop Loss,$64.50,$-130.50,$88796.00,49,$-130.50
2024-03-08,13:18:00,18291.0,SELL,3,0.02h,Stop Loss,$-18.00,$-148.50,$88778.00,49,$-148.50
2024-03-08,13:19:00,18542.5,BUY,3,0.02h,Stop Loss,$-18.00,$-166.50,$88760.00,49,$-166.50
2024-03-08,13:20:00,18287.25,SELL,3,0.02h,Stop Loss,$57.00,$-109.50,$88817.00,49,$-109.50
2024-03-08,13:23:00,18544.5,BUY,3,0.02h,Stop Loss,$53.25,$-56.25,$88870.25,49,$-56.25
2024-03-08,13:29:00,18283.75,SELL,3,0.02h,Stop Loss,$383.25,$327.00,$89253.50,49,$327.00
2024-03-08,13:32:00,18621.0,BUY,3,0.02h,Stop Loss,$-18.00,$309.00,$89235.50,49,$309.00
2024-03-08,13:33:00,18342.25,SELL,3,0.02h,Stop Loss,$-18.00,$291.00,$89217.50,49,$291.00
2024-03-08,13:34:00,18587.5,BUY,3,0.02h,Stop Loss,$-18.00,$273.00,$89199.50,49,$273.00
2024-03-08,13:35:00,18317.75,SELL,3,0.02h,Stop Loss,$-18.00,$255.00,$89181.50,49,$255.00
2024-03-08,13:36:00,18581.25,BUY,3,0.02h,Stop Loss,$30.75,$285.75,$89212.25,49,$285.75
2024-03-08,13:43:00,18348.5,SELL,3,0.02h,Stop Loss,$-18.00,$267.75,$89194.25,49,$267.75
2024-03-08,13:44:00,18599.25,BUY,3,0.02h,Stop Loss,$53.25,$321.00,$89247.50,49,$321.00
2024-03-08,13:47:00,18364.25,SELL,3,0.02h,Stop Loss,$27.00,$348.00,$89274.50,49,$348.00
2024-03-08,13:50:00,18597.75,BUY,3,0.02h,Stop Loss,$-18.00,$330.00,$89256.50,49,$330.00
2024-03-08,13:56:00,18364.5,SELL,3,0.02h,Stop Loss,$45.75,$375.75,$89302.25,49,$375.75
2024-03-08,14:00:00,18604.75,BUY,3,0.02h,Stop Loss,$83.25,$459.00,$89385.50,49,$459.00
2024-03-08,14:09:00,18340.75,SELL,3,0.02h,Stop Loss,$60.75,$519.75,$89446.25,49,$519.75
2024-03-08,14:16:00,18577.25,BUY,3,0.02h,Break Even,$0.75,$520.50,$89447.00,49,$520.50
2024-03-08,14:18:00,18330.5,SELL,3,0.02h,Stop Loss,$-18.00,$502.50,$89429.00,49,$502.50
2024-03-08,14:19:00,18576.0,BUY,3,0.02h,Stop Loss,$30.75,$533.25,$89459.75,49,$533.25
2024-03-08,14:21:00,18331.5,SELL,3,0.02h,Stop Loss,$-18.00,$515.25,$89441.75,49,$515.25
2024-03-08,14:22:00,18585.25,BUY,3,0.02h,Break Even,$0.75,$516.00,$89442.50,49,$516.00
2024-03-08,14:31:00,18311.5,SELL,3,0.02h,Stop Loss,$-18.00,$498.00,$89424.50,49,$498.00
2024-03-08,14:32:00,18572.5,BUY,3,0.02h,Stop Loss,$-18.00,$480.00,$89406.50,49,$480.00
2024-03-08,14:33:00,18323.75,SELL,3,0.02h,Stop Loss,$79.50,$559.50,$89486.00,49,$559.50
2024-03-08,14:39:00,18561.25,BUY,3,0.02h,Stop Loss,$-18.00,$541.50,$89468.00,49,$541.50
2024-03-08,14:40:00,18300.0,SELL,3,0.02h,Stop Loss,$-18.00,$523.50,$89450.00,49,$523.50
2024-03-08,14:42:00,18572.25,BUY,3,0.02h,Stop Loss,$-18.00,$505.50,$89432.00,49,$505.50
2024-03-08,14:43:00,18318.75,SELL,3,0.02h,Stop Loss,$-18.00,$487.50,$89414.00,49,$487.50
2024-03-08,14:54:00,18619.0,BUY,3,0.02h,Stop Loss,$79.50,$567.00,$89493.50,49,$567.00
2024-03-08,15:03:00,18386.0,SELL,3,0.02h,Stop Loss,$15.75,$582.75,$89509.25,49,$582.75
2024-03-08,15:08:00,18664.5,BUY,3,0.02h,Stop Loss,$-18.00,$564.75,$89491.25,49,$564.75
2024-03-08,15:09:00,18411.25,SELL,3,0.02h,Stop Loss,$23.25,$588.00,$89514.50,49,$588.00
2024-03-08,15:12:00,18665.0,BUY,3,0.02h,Stop Loss,$-18.00,$570.00,$89496.50,49,$570.00
2024-03-08,15:17:00,18416.5,SELL,3,0.02h,Stop Loss,$-18.00,$552.00,$89478.50,49,$552.00
2024-03-08,15:18:00,18675.25,BUY,3,0.02h,Stop Loss,$-18.00,$534.00,$89460.50,49,$534.00
2024-03-08,15:25:00,18408.25,SELL,3,0.02h,Stop Loss,$-18.00,$516.00,$89442.50,49,$516.00
2024-03-08,15:29:00,18676.5,BUY,3,0.02h,Stop Loss,$139.50,$655.50,$89582.00,49,$655.50
2024-03-08,15:39:00,18383.25,SELL,3,0.02h,Stop Loss,$-18.00,$637.50,$89564.00,49,$637.50
2024-03-08,15:40:00,18633.5,BUY,3,0.02h,Stop Loss,$-18.00,$619.50,$89546.00,49,$619.50
2024-03-08,15:41:00,18380.0,SELL,3,0.02h,Stop Loss,$-18.00,$601.50,$89528.00,49,$601.50
2024-03-08,15:59:00,18649.75,BUY,3,0.02h,Stop Loss,$-18.00,$583.50,$89510.00,49,$583.50
2024-03-08,16:00:00,18380.5,SELL,3,0.02h,Stop Loss,$323.25,$906.75,$89833.25,49,$906.75
2024-03-08,16:02:00,18611.0,BUY,3,0.02h,Stop Loss,$-18.00,$888.75,$89815.25,49,$888.75
2024-03-08,16:03:00,18334.0,SELL,3,0.02h,Stop Loss,$338.25,$1227.00,$90153.50,49,$1227.00
2024-03-08,16:16:00,18519.5,BUY,3,0.02h,Stop Loss,$120.75,$1347.75,$90274.25,49,$1347.75
2024-03-08,16:18:00,18244.0,SELL,3,0.02h,Stop Loss,$113.25,$1461.00,$90387.50,49,$1461.00
2024-03-08,16:30:00,18451.0,BUY,3,0.02h,Stop Loss,$105.75,$1566.75,$90493.25,49,$1566.75
2024-03-08,16:35:00,18206.25,SELL,3,0.02h,Stop Loss,$19.50,$1586.25,$90512.75,49,$1586.25
2024-03-08,16:42:00,18461.5,BUY,3,0.02h,Stop Loss,$188.25,$1774.50,$90701.00,49,$1774.50
2024-03-08,16:48:00,18170.25,SELL,3,0.02h,Stop Loss,$-18.00,$1756.50,$90683.00,49,$1756.50
2024-03-08,16:49:00,18431.0,BUY,3,0.02h,Stop Loss,$90.75,$1847.25,$90773.75,49,$1847.25
2024-03-08,16:51:00,18198.75,SELL,3,0.02h,Stop Loss,$42.00,$1889.25,$90815.75,49,$1889.25
2024-03-08,17:07:00,18443.25,BUY,3,0.02h,Stop Loss,$-18.00,$1871.25,$90797.75,49,$1871.25
2024-03-08,17:08:00,18193.25,SELL,3,0.02h,Stop Loss,$-18.00,$1853.25,$90779.75,49,$1853.25
2024-03-08,17:09:00,18420.5,BUY,3,0.02h,Stop Loss,$-18.00,$1835.25,$90761.75,49,$1835.25
2024-03-08,17:10:00,18151.25,SELL,3,0.02h,Stop Loss,$300.75,$2136.00,$91062.50,49,$2136.00
2024-03-08,17:13:00,18414.5,BUY,3,0.02h,Stop Loss,$-18.00,$2118.00,$91044.50,49,$2118.00
2024-03-08,17:14:00,18183.0,SELL,3,0.02h,Stop Loss,$-18.00,$2100.00,$91026.50,49,$2100.00
2024-03-08,17:15:00,18424.5,BUY,3,0.02h,Stop Loss,$-18.00,$2082.00,$91008.50,49,$2082.00
2024-03-08,17:16:00,18165.75,SELL,3,0.02h,Stop Loss,$53.25,$2135.25,$91061.75,49,$2135.25
2024-03-08,17:19:00,18403.75,BUY,3,0.02h,Stop Loss,$-18.00,$2117.25,$91043.75,49,$2117.25
2024-03-08,17:20:00,18141.5,SELL,3,0.02h,Stop Loss,$-18.00,$2099.25,$91025.75,49,$2099.25
2024-03-08,17:21:00,18411.75,BUY,3,0.02h,Stop Loss,$12.00,$2111.25,$91037.75,49,$2111.25
2024-03-08,17:28:00,18180.75,SELL,3,0.02h,Stop Loss,$-18.00,$2093.25,$91019.75,49,$2093.25
2024-03-08,17:31:00,18437.75,BUY,3,0.02h,Stop Loss,$117.00,$2210.25,$91136.75,49,$2210.25
2024-03-08,17:40:00,18176.5,SELL,3,0.02h,Stop Loss,$87.00,$2297.25,$91223.75,49,$2297.25
2024-03-08,18:00:00,18314.5,BUY,3,0.02h,Break Even,$0.75,$2298.00,$91224.50,49,$2298.00
2024-03-08,18:03:00,18070.0,SELL,3,0.02h,Stop Loss,$-18.00,$2280.00,$91206.50,49,$2280.00
2024-03-08,18:20:00,18327.25,BUY,3,0.02h,Stop Loss,$-18.00,$2262.00,$91188.50,49,$2262.00
2024-03-08,18:21:00,18078.5,SELL,3,0.02h,Stop Loss,$143.25,$2405.25,$91331.75,49,$2405.25
2024-03-08,18:29:00,18310.5,BUY,3,0.02h,Break Even,$0.75,$2406.00,$91332.50,49,$2406.00
2024-03-08,18:35:00,18034.25,SELL,3,0.02h,Break Even,$0.75,$2406.75,$91333.25,49,$2406.75
2024-03-08,18:47:00,18285.5,BUY,3,0.02h,Stop Loss,$-18.00,$2388.75,$91315.25,49,$2388.75
2024-03-08,18:48:00,18036.5,SELL,3,0.02h,Stop Loss,$30.75,$2419.50,$91346.00,49,$2419.50
2024-03-08,18:52:00,18282.0,BUY,3,0.02h,Stop Loss,$60.75,$2480.25,$91406.75,49,$2480.25
2024-03-08,19:00:00,18046.0,SELL,3,0.02h,Stop Loss,$49.50,$2529.75,$91456.25,49,$2529.75
2024-03-08,19:02:00,18311.25,BUY,3,0.02h,Stop Loss,$-18.00,$2511.75,$91438.25,49,$2511.75
2024-03-08,19:03:00,18074.5,SELL,3,0.02h,Stop Loss,$-18.00,$2493.75,$91420.25,49,$2493.75
2024-03-08,19:04:00,18337.0,BUY,3,0.02h,Stop Loss,$-18.00,$2475.75,$91402.25,49,$2475.75
2024-03-08,19:06:00,18077.25,SELL,3,0.02h,Break Even,$0.75,$2476.50,$91403.00,49,$2476.50
2024-03-08,19:09:00,18339.25,BUY,3,0.02h,Stop Loss,$64.50,$2541.00,$91467.50,49,$2541.00
2024-03-08,19:16:00,18085.75,SELL,3,0.02h,Stop Loss,$53.25,$2594.25,$91520.75,49,$2594.25
2024-03-08,19:19:00,18344.25,BUY,3,0.02h,Stop Loss,$-18.00,$2576.25,$91502.75,49,$2576.25
2024-03-08,19:20:00,18091.25,SELL,3,0.02h,Stop Loss,$-18.00,$2558.25,$91484.75,49,$2558.25
2024-03-08,19:21:00,18354.0,BUY,3,0.02h,Stop Loss,$-18.00,$2540.25,$91466.75,49,$2540.25
2024-03-08,19:23:00,18119.25,SELL,3,0.02h,Stop Loss,$53.25,$2593.50,$91520.00,49,$2593.50
2024-03-08,19:29:00,18372.0,BUY,3,0.02h,Stop Loss,$19.50,$2613.00,$91539.50,49,$2613.00
2024-03-08,19:43:00,18161.0,SELL,3,0.02h,Break Even,$0.75,$2613.75,$91540.25,49,$2613.75
2024-03-08,19:45:00,18420.75,BUY,3,0.02h,Stop Loss,$15.75,$2629.50,$91556.00,49,$2629.50
2024-03-08,19:57:00,18140.75,SELL,3,0.02h,Stop Loss,$-18.00,$2611.50,$91538.00,49,$2611.50
2024-03-08,19:58:00,18387.75,BUY,3,0.02h,Stop Loss,$-18.00,$2593.50,$91520.00,49,$2593.50
2024-03-08,19:59:00,18146.25,SELL,3,0.02h,Stop Loss,$-18.00,$2575.50,$91502.00,49,$2575.50
2024-03-08,20:00:00,18393.25,BUY,3,0.02h,Stop Loss,$229.50,$2805.00,$91731.50,49,$2805.00
2024-03-08,20:04:00,18164.5,SELL,3,0.02h,Stop Loss,$72.00,$2877.00,$91803.50,49,$2877.00
2024-03-08,20:07:00,18378.25,BUY,3,0.02h,Stop Loss,$-18.00,$2859.00,$91785.50,49,$2859.00
2024-03-08,20:08:00,18131.75,SELL,3,0.02h,Stop Loss,$-18.00,$2841.00,$91767.50,49,$2841.00
2024-03-08,20:09:00,18384.0,BUY,3,0.02h,Stop Loss,$-18.00,$2823.00,$91749.50,49,$2823.00
2024-03-08,20:12:00,18106.75,SELL,3,0.02h,Stop Loss,$-18.00,$2805.00,$91731.50,49,$2805.00
2024-03-08,20:13:00,18363.5,BUY,3,0.02h,Stop Loss,$-18.00,$2787.00,$91713.50,49,$2787.00
2024-03-08,20:14:00,18107.25,SELL,3,0.02h,Stop Loss,$19.50,$2806.50,$91733.00,49,$2806.50
2024-03-08,20:19:00,18345.5,BUY,3,0.02h,Stop Loss,$-18.00,$2788.50,$91715.00,49,$2788.50
2024-03-08,20:20:00,18094.25,SELL,3,0.02h,Stop Loss,$124.50,$2913.00,$91839.50,49,$2913.00
2024-03-08,20:25:00,18353.25,BUY,3,0.02h,Stop Loss,$124.50,$3037.50,$91964.00,49,$3037.50
2024-03-08,20:28:00,18089.5,SELL,3,0.02h,Stop Loss,$428.25,$3465.75,$92392.25,49,$3465.75
2024-03-08,20:34:00,18331.0,BUY,3,0.02h,Stop Loss,$-18.00,$3447.75,$92374.25,49,$3447.75
2024-03-08,20:35:00,18079.25,SELL,3,0.02h,Stop Loss,$105.75,$3553.50,$92480.00,49,$3553.50
2024-03-08,20:42:00,18304.5,BUY,3,0.02h,Stop Loss,$27.00,$3580.50,$92507.00,49,$3580.50
2024-03-08,20:44:00,18064.25,SELL,3,0.02h,Stop Loss,$-18.00,$3562.50,$92489.00,49,$3562.50
2024-03-08,20:45:00,18304.5,BUY,3,0.02h,Stop Loss,$-18.00,$3544.50,$92471.00,49,$3544.50
2024-03-08,20:46:00,18066.5,SELL,3,0.02h,Stop Loss,$38.25,$3582.75,$92509.25,49,$3582.75
2024-03-08,20:50:00,18318.25,BUY,3,0.02h,Stop Loss,$120.75,$3703.50,$92630.00,49,$3703.50
2024-03-08,20:52:00,18060.75,SELL,3,0.02h,Stop Loss,$-18.00,$3685.50,$92612.00,49,$3685.50
2024-03-08,20:53:00,18304.75,BUY,3,0.02h,Stop Loss,$-18.00,$3667.50,$92594.00,49,$3667.50
2024-03-08,20:54:00,18054.25,SELL,3,0.02h,Stop Loss,$-18.00,$3649.50,$92576.00,49,$3649.50
2024-03-08,20:55:00,18316.75,BUY,3,0.02h,Stop Loss,$-18.00,$3631.50,$92558.00,49,$3631.50
2024-03-08,20:56:00,18049.5,SELL,3,0.02h,Stop Loss,$-18.00,$3613.50,$92540.00,49,$3613.50
2024-03-08,21:06:00,18320.25,BUY,3,0.02h,Stop Loss,$-18.00,$3595.50,$92522.00,49,$3595.50
2024-03-08,21:12:00,18065.5,SELL,3,0.02h,Stop Loss,$-18.00,$3577.50,$92504.00,49,$3577.50
2024-03-08,21:13:00,18315.25,BUY,3,0.02h,Stop Loss,$-18.00,$3559.50,$92486.00,49,$3559.50
2024-03-08,21:14:00,18066.5,SELL,3,0.02h,Stop Loss,$162.00,$3721.50,$92648.00,49,$3721.50
2024-03-08,21:37:00,18305.5,BUY,3,0.02h,Stop Loss,$-18.00,$3703.50,$92630.00,49,$3703.50
2024-03-08,21:38:00,18054.0,SELL,3,0.02h,Stop Loss,$-18.00,$3685.50,$92612.00,49,$3685.50
2024-03-08,21:41:00,18304.0,BUY,3,0.02h,Stop Loss,$-18.00,$3667.50,$92594.00,49,$3667.50
2024-03-08,21:43:00,18053.25,SELL,3,0.03h,Stop Loss,$-18.00,$3649.50,$92576.00,49,$3649.50
2024-03-08,21:45:00,18303.0,BUY,3,0.02h,Break Even,$0.75,$3650.25,$92576.75,49,$3650.25
2024-03-08,21:56:00,18055.5,SELL,3,0.02h,Stop Loss,$-18.00,$3632.25,$92558.75,49,$3632.25
2024-03-08,21:57:00,18304.0,BUY,3,0.02h,Stop Loss,$-18.00,$3614.25,$92540.75,49,$3614.25
2024-03-08,21:58:00,18053.5,SELL,3,0.02h,Stop Loss,$-18.00,$3596.25,$92522.75,49,$3596.25
2024-03-08,21:59:00,18303.75,BUY,3,0.02h,Stop Loss,$-18.00,$3578.25,$92504.75,49,$3578.25
2024-03-08,22:00:00,18055.25,SELL,3,62.00h,Stop Loss,$-18.00,$3560.25,$92486.75,49,$3560.25
,,,,,,,,,,,
2024-03-11,12:00:00,18235.25,BUY,3,0.02h,Stop Loss,$-18.00,$-18.00,$92468.75,50,$-18.00
2024-03-11,12:17:00,18186.5,SELL,3,0.02h,Stop Loss,$38.25,$20.25,$92507.00,50,$20.25
2024-03-11,12:20:00,18201.0,BUY,3,0.02h,Stop Loss,$143.25,$163.50,$92650.25,50,$163.50
2024-03-11,12:44:00,18190.25,SELL,3,0.02h,Stop Loss,$105.75,$269.25,$92756.00,50,$269.25
2024-03-11,12:55:00,18201.0,BUY,3,0.02h,Break Even,$0.75,$270.00,$92756.75,50,$270.00
2024-03-11,13:32:00,18185.25,SELL,3,0.02h,Stop Loss,$300.75,$570.75,$93057.50,50,$570.75
2024-03-11,13:41:00,18229.0,BUY,3,0.02h,Stop Loss,$229.50,$800.25,$93287.00,50,$800.25
2024-03-11,13:53:00,18202.5,SELL,3,0.02h,Stop Loss,$214.50,$1014.75,$93501.50,50,$1014.75
2024-03-11,14:21:00,18169.25,BUY,3,0.02h,Break Even,$0.75,$1015.50,$93502.25,50,$1015.50
2024-03-11,14:22:00,18162.25,SELL,3,0.02h,Stop Loss,$72.00,$1087.50,$93574.25,50,$1087.50
2024-03-11,14:30:00,18175.25,BUY,3,0.02h,Stop Loss,$390.75,$1478.25,$93965.00,50,$1478.25
2024-03-11,15:11:00,18214.0,SELL,3,0.02h,Stop Loss,$364.50,$1842.75,$94329.50,50,$1842.75
2024-03-11,15:46:00,18200.25,BUY,3,0.02h,Stop Loss,$214.50,$2057.25,$94544.00,50,$2057.25
2024-03-11,16:10:00,18213.25,SELL,3,0.02h,Stop Loss,$132.00,$2189.25,$94676.00,50,$2189.25
2024-03-11,16:19:00,18231.5,BUY,3,0.02h,Break Even,$0.75,$2190.00,$94676.75,50,$2190.00
2024-03-11,16:47:00,18220.25,SELL,3,0.02h,Stop Loss,$34.50,$2224.50,$94711.25,50,$2224.50
2024-03-11,16:55:00,18234.0,BUY,3,0.02h,Break Even,$0.75,$2225.25,$94712.00,50,$2225.25
2024-03-11,17:05:00,18225.5,SELL,3,0.02h,Stop Loss,$-18.00,$2207.25,$94694.00,50,$2207.25
2024-03-11,17:24:00,18231.0,BUY,3,0.02h,Break Even,$0.75,$2208.00,$94694.75,50,$2208.00
2024-03-11,17:41:00,18223.75,SELL,3,0.02h,Stop Loss,$278.25,$2486.25,$94973.00,50,$2486.25
2024-03-11,17:59:00,18218.75,BUY,3,0.02h,Stop Loss,$42.00,$2528.25,$95015.00,50,$2528.25
2024-03-11,18:37:00,18223.75,SELL,3,0.02h,Stop Loss,$-18.00,$2510.25,$94997.00,50,$2510.25
2024-03-11,18:43:00,18239.5,BUY,3,0.02h,Break Even,$0.75,$2511.00,$94997.75,50,$2511.00
2024-03-11,19:02:00,18231.0,SELL,3,0.02h,Break Even,$0.75,$2511.75,$94998.50,50,$2511.75
2024-03-11,19:43:00,18223.75,BUY,3,0.02h,Stop Loss,$53.25,$2565.00,$95051.75,50,$2565.00
2024-03-11,19:51:00,18209.5,SELL,3,0.02h,Stop Loss,$102.00,$2667.00,$95153.75,50,$2667.00
2024-03-11,20:01:00,18225.25,BUY,3,0.02h,Stop Loss,$27.00,$2694.00,$95180.75,50,$2694.00
2024-03-11,22:39:00,18275.0,SELL,3,0.02h,Stop Loss,$-18.00,$2676.00,$95162.75,50,$2676.00
2024-03-11,22:41:00,18281.0,BUY,3,0.02h,Stop Loss,$12.00,$2688.00,$95174.75,50,$2688.00
2024-03-11,22:54:00,18278.25,SELL,3,0.02h,Break Even,$0.75,$2688.75,$95175.50,50,$2688.75
,,,,,,,,,,,
2024-03-12,12:20:00,18295.5,BUY,3,0.02h,Stop Loss,$79.50,$79.50,$95255.00,51,$79.50
2024-03-12,12:26:00,18051.75,SELL,3,0.02h,Stop Loss,$-18.00,$61.50,$95237.00,51,$61.50
2024-03-12,12:28:00,18300.5,BUY,3,0.02h,Stop Loss,$-18.00,$43.50,$95219.00,51,$43.50
2024-03-12,12:45:00,18109.0,SELL,3,0.02h,Stop Loss,$-18.00,$25.50,$95201.00,51,$25.50
2024-03-12,12:46:00,18375.0,BUY,3,0.02h,Break Even,$0.75,$26.25,$95201.75,51,$26.25
2024-03-12,12:59:00,18075.75,SELL,3,0.02h,Stop Loss,$128.25,$154.50,$95330.00,51,$154.50
2024-03-12,13:16:00,18280.25,BUY,3,0.02h,Stop Loss,$-18.00,$136.50,$95312.00,51,$136.50
2024-03-12,13:17:00,18045.5,SELL,3,0.02h,Stop Loss,$-18.00,$118.50,$95294.00,51,$118.50
2024-03-12,13:18:00,18292.75,BUY,3,0.02h,Break Even,$0.75,$119.25,$95294.75,51,$119.25
2024-03-12,13:25:00,18047.0,SELL,3,0.02h,Stop Loss,$-18.00,$101.25,$95276.75,51,$101.25
2024-03-12,13:28:00,18300.5,BUY,3,0.02h,Stop Loss,$-18.00,$83.25,$95258.75,51,$83.25
2024-03-12,13:29:00,18062.5,SELL,3,0.02h,Stop Loss,$-18.00,$65.25,$95240.75,51,$65.25
2024-03-12,13:30:00,18311.5,BUY,3,0.02h,Stop Loss,$364.50,$429.75,$95605.25,51,$429.75
2024-03-12,13:37:00,17997.25,SELL,3,0.02h,Stop Loss,$248.25,$678.00,$95853.50,51,$678.00
2024-03-12,13:57:00,18269.75,BUY,3,0.02h,Break Even,$0.75,$678.75,$95854.25,51,$678.75
2024-03-12,14:12:00,18069.75,SELL,3,0.02h,Stop Loss,$-18.00,$660.75,$95836.25,51,$660.75
2024-03-12,14:13:00,18314.5,BUY,3,0.02h,Stop Loss,$-18.00,$642.75,$95818.25,51,$642.75
2024-03-12,14:16:00,18075.75,SELL,3,0.02h,Stop Loss,$120.75,$763.50,$95939.00,51,$763.50
2024-03-12,14:24:00,18344.75,BUY,3,0.02h,Stop Loss,$150.75,$914.25,$96089.75,51,$914.25
2024-03-12,14:43:00,18152.5,SELL,3,0.02h,Stop Loss,$30.75,$945.00,$96120.50,51,$945.00
2024-03-12,14:45:00,18407.5,BUY,3,0.02h,Stop Loss,$-18.00,$927.00,$96102.50,51,$927.00
2024-03-12,14:46:00,18159.5,SELL,3,0.02h,Stop Loss,$42.00,$969.00,$96144.50,51,$969.00
2024-03-12,14:51:00,18425.0,BUY,3,0.02h,Stop Loss,$229.50,$1198.50,$96374.00,51,$1198.50
2024-03-12,15:02:00,18168.5,SELL,3,0.02h,Stop Loss,$45.75,$1244.25,$96419.75,51,$1244.25
2024-03-12,15:04:00,18422.5,BUY,3,0.02h,Stop Loss,$-18.00,$1226.25,$96401.75,51,$1226.25
2024-03-12,15:05:00,18157.25,SELL,3,0.02h,Stop Loss,$-18.00,$1208.25,$96383.75,51,$1208.25
2024-03-12,15:06:00,18405.5,BUY,3,0.02h,Stop Loss,$79.50,$1287.75,$96463.25,51,$1287.75
2024-03-12,15:08:00,18172.5,SELL,3,0.02h,Stop Loss,$-18.00,$1269.75,$96445.25,51,$1269.75
2024-03-12,15:09:00,18431.0,BUY,3,0.02h,Stop Loss,$-18.00,$1251.75,$96427.25,51,$1251.75
2024-03-12,15:10:00,18177.0,SELL,3,0.02h,Stop Loss,$-18.00,$1233.75,$96409.25,51,$1233.75
2024-03-12,15:12:00,18435.0,BUY,3,0.02h,Break Even,$0.75,$1234.50,$96410.00,51,$1234.50
2024-03-12,15:16:00,18190.5,SELL,3,0.02h,Break Even,$0.75,$1235.25,$96410.75,51,$1235.25
2024-03-12,15:20:00,18436.75,BUY,3,0.02h,Stop Loss,$-18.00,$1217.25,$96392.75,51,$1217.25
2024-03-12,15:21:00,18189.0,SELL,3,0.02h,Stop Loss,$79.50,$1296.75,$96472.25,51,$1296.75
2024-03-12,15:23:00,18437.75,BUY,3,0.02h,Stop Loss,$184.50,$1481.25,$96656.75,51,$1481.25
2024-03-12,15:26:00,18202.0,SELL,3,0.02h,Break Even,$0.75,$1482.00,$96657.50,51,$1482.00
2024-03-12,15:35:00,18447.5,BUY,3,0.02h,Stop Loss,$-18.00,$1464.00,$96639.50,51,$1464.00
2024-03-12,15:42:00,18159.25,SELL,3,0.02h,Stop Loss,$-18.00,$1446.00,$96621.50,51,$1446.00
2024-03-12,15:43:00,18405.5,BUY,3,0.02h,Stop Loss,$-18.00,$1428.00,$96603.50,51,$1428.00
2024-03-12,15:44:00,18161.5,SELL,3,0.02h,Break Even,$0.75,$1428.75,$96604.25,51,$1428.75
2024-03-12,15:47:00,18390.0,BUY,3,0.02h,Stop Loss,$267.00,$1695.75,$96871.25,51,$1695.75
2024-03-12,15:53:00,18175.25,SELL,3,0.02h,Break Even,$0.75,$1696.50,$96872.00,51,$1696.50
2024-03-12,16:03:00,18391.75,BUY,3,0.02h,Stop Loss,$-18.00,$1678.50,$96854.00,51,$1678.50
2024-03-12,16:04:00,18147.25,SELL,3,0.02h,Stop Loss,$75.75,$1754.25,$96929.75,51,$1754.25
2024-03-12,16:12:00,18396.0,BUY,3,0.02h,Stop Loss,$-18.00,$1736.25,$96911.75,51,$1736.25
2024-03-12,16:13:00,18157.0,SELL,3,0.02h,Stop Loss,$-18.00,$1718.25,$96893.75,51,$1718.25
2024-03-12,16:22:00,18392.5,BUY,3,0.02h,Stop Loss,$-18.00,$1700.25,$96875.75,51,$1700.25
2024-03-12,16:23:00,18140.25,SELL,3,0.02h,Stop Loss,$-18.00,$1682.25,$96857.75,51,$1682.25
2024-03-12,16:24:00,18382.0,BUY,3,0.02h,Break Even,$0.75,$1683.00,$96858.50,51,$1683.00
2024-03-12,16:28:00,18131.75,SELL,3,0.02h,Stop Loss,$-18.00,$1665.00,$96840.50,51,$1665.00
2024-03-12,16:29:00,18385.5,BUY,3,0.02h,Stop Loss,$-18.00,$1647.00,$96822.50,51,$1647.00
2024-03-12,16:32:00,18133.0,SELL,3,0.02h,Break Even,$0.75,$1647.75,$96823.25,51,$1647.75
2024-03-12,16:45:00,18354.25,BUY,3,0.02h,Stop Loss,$-18.00,$1629.75,$96805.25,51,$1629.75
2024-03-12,16:49:00,18093.5,SELL,3,0.02h,Break Even,$0.75,$1630.50,$96806.00,51,$1630.50
2024-03-12,16:51:00,18347.5,BUY,3,0.02h,Stop Loss,$139.50,$1770.00,$96945.50,51,$1770.00
2024-03-12,16:54:00,18104.75,SELL,3,0.02h,Stop Loss,$-18.00,$1752.00,$96927.50,51,$1752.00
2024-03-12,16:55:00,18358.75,BUY,3,0.02h,Stop Loss,$-18.00,$1734.00,$96909.50,51,$1734.00
2024-03-12,16:56:00,18114.5,SELL,3,0.02h,Stop Loss,$-18.00,$1716.00,$96891.50,51,$1716.00
2024-03-12,16:57:00,18342.25,BUY,3,0.02h,Stop Loss,$-18.00,$1698.00,$96873.50,51,$1698.00
2024-03-12,16:58:00,18099.0,SELL,3,0.02h,Stop Loss,$-18.00,$1680.00,$96855.50,51,$1680.00
2024-03-12,16:59:00,18350.0,BUY,3,0.02h,Stop Loss,$79.50,$1759.50,$96935.00,51,$1759.50
2024-03-12,17:03:00,18085.0,SELL,3,0.02h,Stop Loss,$-18.00,$1741.50,$96917.00,51,$1741.50
2024-03-12,17:11:00,18328.75,BUY,3,0.02h,Stop Loss,$79.50,$1821.00,$96996.50,51,$1821.00
2024-03-12,17:21:00,18142.5,SELL,3,0.02h,Stop Loss,$-18.00,$1803.00,$96978.50,51,$1803.00
2024-03-12,17:24:00,18396.0,BUY,3,0.02h,Stop Loss,$45.75,$1848.75,$97024.25,51,$1848.75
2024-03-12,17:29:00,18140.25,SELL,3,0.02h,Stop Loss,$113.25,$1962.00,$97137.50,51,$1962.00
2024-03-12,17:31:00,18391.25,BUY,3,0.02h,Stop Loss,$-18.00,$1944.00,$97119.50,51,$1944.00
2024-03-12,17:32:00,18146.75,SELL,3,0.02h,Stop Loss,$-18.00,$1926.00,$97101.50,51,$1926.00
2024-03-12,17:33:00,18393.0,BUY,3,0.02h,Stop Loss,$-18.00,$1908.00,$97083.50,51,$1908.00
2024-03-12,17:34:00,18145.5,SELL,3,0.02h,Break Even,$0.75,$1908.75,$97084.25,51,$1908.75
2024-03-12,17:38:00,18391.5,BUY,3,0.02h,Stop Loss,$-18.00,$1890.75,$97066.25,51,$1890.75
2024-03-12,17:39:00,18152.25,SELL,3,0.02h,Stop Loss,$30.75,$1921.50,$97097.00,51,$1921.50
2024-03-12,17:42:00,18400.5,BUY,3,0.02h,Stop Loss,$-18.00,$1903.50,$97079.00,51,$1903.50
2024-03-12,17:43:00,18153.25,SELL,3,0.02h,Break Even,$0.75,$1904.25,$97079.75,51,$1904.25
2024-03-12,17:49:00,18404.0,BUY,3,0.02h,Break Even,$0.75,$1905.00,$97080.50,51,$1905.00
2024-03-12,18:06:00,18175.5,SELL,3,0.02h,Stop Loss,$83.25,$1988.25,$97163.75,51,$1988.25
2024-03-12,18:08:00,18412.5,BUY,3,0.02h,Stop Loss,$-18.00,$1970.25,$97145.75,51,$1970.25
2024-03-12,18:09:00,18167.0,SELL,3,0.02h,Stop Loss,$-18.00,$1952.25,$97127.75,51,$1952.25
2024-03-12,18:18:00,18424.75,BUY,3,0.02h,Stop Loss,$-18.00,$1934.25,$97109.75,51,$1934.25
2024-03-12,18:19:00,18173.25,SELL,3,0.02h,Break Even,$0.75,$1935.00,$97110.50,51,$1935.00
2024-03-12,18:26:00,18432.5,BUY,3,0.02h,Stop Loss,$-18.00,$1917.00,$97092.50,51,$1917.00
2024-03-12,18:34:00,18201.5,SELL,3,0.02h,Stop Loss,$-18.00,$1899.00,$97074.50,51,$1899.00
2024-03-12,18:35:00,18452.0,BUY,3,0.02h,Stop Loss,$-18.00,$1881.00,$97056.50,51,$1881.00
2024-03-12,18:37:00,18206.25,SELL,3,0.02h,Stop Loss,$128.25,$2009.25,$97184.75,51,$2009.25
2024-03-12,18:40:00,18446.0,BUY,3,0.02h,Break Even,$0.75,$2010.00,$97185.50,51,$2010.00
2024-03-12,18:43:00,18178.75,SELL,3,0.02h,Stop Loss,$-18.00,$1992.00,$97167.50,51,$1992.00
2024-03-12,18:44:00,18411.25,BUY,3,0.02h,Stop Loss,$94.50,$2086.50,$97262.00,51,$2086.50
2024-03-12,18:53:00,18209.5,SELL,3,0.02h,Stop Loss,$-18.00,$2068.50,$97244.00,51,$2068.50
2024-03-12,18:54:00,18460.25,BUY,3,0.02h,Break Even,$0.75,$2069.25,$97244.75,51,$2069.25
2024-03-12,18:59:00,18213.5,SELL,3,0.02h,Stop Loss,$-18.00,$2051.25,$97226.75,51,$2051.25
2024-03-12,19:00:00,18454.75,BUY,3,0.02h,Break Even,$0.75,$2052.00,$97227.50,51,$2052.00
2024-03-12,19:05:00,18205.75,SELL,3,0.02h,Stop Loss,$15.75,$2067.75,$97243.25,51,$2067.75
2024-03-12,19:07:00,18450.25,BUY,3,0.02h,Stop Loss,$-18.00,$2049.75,$97225.25,51,$2049.75
2024-03-12,19:08:00,18204.0,SELL,3,0.02h,Break Even,$0.75,$2050.50,$97226.00,51,$2050.50
2024-03-12,19:11:00,18460.25,BUY,3,0.02h,Stop Loss,$-18.00,$2032.50,$97208.00,51,$2032.50
2024-03-12,19:12:00,18207.0,SELL,3,0.02h,Stop Loss,$-18.00,$2014.50,$97190.00,51,$2014.50
2024-03-12,19:15:00,18459.25,BUY,3,0.02h,Break Even,$0.75,$2015.25,$97190.75,51,$2015.25
2024-03-12,19:29:00,18213.25,SELL,3,0.02h,Break Even,$0.75,$2016.00,$97191.50,51,$2016.00
2024-03-12,19:38:00,18469.75,BUY,3,0.02h,Stop Loss,$23.25,$2039.25,$97214.75,51,$2039.25
2024-03-12,19:43:00,18230.25,SELL,3,0.02h,Stop Loss,$42.00,$2081.25,$97256.75,51,$2081.25
2024-03-12,19:45:00,18467.0,BUY,3,0.02h,Stop Loss,$-18.00,$2063.25,$97238.75,51,$2063.25
2024-03-12,19:46:00,18224.25,SELL,3,0.02h,Stop Loss,$12.00,$2075.25,$97250.75,51,$2075.25
2024-03-12,19:59:00,18480.0,BUY,3,0.02h,Break Even,$0.75,$2076.00,$97251.50,51,$2076.00
2024-03-12,20:16:00,18220.0,SELL,3,0.02h,Break Even,$0.75,$2076.75,$97252.25,51,$2076.75
2024-03-12,20:24:00,18467.5,BUY,3,0.02h,Stop Loss,$-18.00,$2058.75,$97234.25,51,$2058.75
2024-03-12,20:25:00,18218.5,SELL,3,0.02h,Stop Loss,$-18.00,$2040.75,$97216.25,51,$2040.75
2024-03-12,20:26:00,18469.25,BUY,3,0.02h,Break Even,$0.75,$2041.50,$97217.00,51,$2041.50
2024-03-12,20:31:00,18226.0,SELL,3,0.02h,Stop Loss,$-18.00,$2023.50,$97199.00,51,$2023.50
2024-03-12,20:33:00,18475.0,BUY,3,0.02h,Stop Loss,$-18.00,$2005.50,$97181.00,51,$2005.50
2024-03-12,20:37:00,18226.75,SELL,3,0.02h,Stop Loss,$-18.00,$1987.50,$97163.00,51,$1987.50
2024-03-12,20:38:00,18474.75,BUY,3,0.02h,Stop Loss,$-18.00,$1969.50,$97145.00,51,$1969.50
2024-03-12,20:39:00,18226.5,SELL,3,0.02h,Break Even,$0.75,$1970.25,$97145.75,51,$1970.25
2024-03-12,20:52:00,18475.75,BUY,3,0.02h,Stop Loss,$-18.00,$1952.25,$97127.75,51,$1952.25
2024-03-12,20:57:00,18229.25,SELL,3,0.02h,Stop Loss,$-18.00,$1934.25,$97109.75,51,$1934.25
2024-03-12,20:58:00,18474.5,BUY,3,0.02h,Stop Loss,$-18.00,$1916.25,$97091.75,51,$1916.25
2024-03-12,22:01:00,18219.75,SELL,3,0.02h,Stop Loss,$-18.00,$1898.25,$97073.75,51,$1898.25
2024-03-12,22:02:00,18468.75,BUY,3,0.02h,Stop Loss,$-18.00,$1880.25,$97055.75,51,$1880.25
2024-03-12,22:09:00,18220.25,SELL,3,0.02h,Stop Loss,$-18.00,$1862.25,$97037.75,51,$1862.25
2024-03-12,22:10:00,18467.5,BUY,3,0.02h,Break Even,$0.75,$1863.00,$97038.50,51,$1863.00
2024-03-12,22:12:00,18219.0,SELL,3,0.02h,Stop Loss,$-18.00,$1845.00,$97020.50,51,$1845.00
2024-03-12,22:14:00,18469.75,BUY,3,0.03h,Break Even,$0.75,$1845.75,$97021.25,51,$1845.75
2024-03-12,22:29:00,18223.25,SELL,3,0.03h,Stop Loss,$-18.00,$1827.75,$97003.25,51,$1827.75
2024-03-12,22:41:00,18474.0,BUY,3,0.02h,Stop Loss,$-18.00,$1809.75,$96985.25,51,$1809.75
2024-03-12,22:42:00,18223.5,SELL,3,0.03h,Stop Loss,$-18.00,$1791.75,$96967.25,51,$1791.75
2024-03-12,22:46:00,18474.0,BUY,3,0.02h,Stop Loss,$-18.00,$1773.75,$96949.25,51,$1773.75
2024-03-12,22:47:00,18225.5,SELL,3,0.02h,Stop Loss,$-18.00,$1755.75,$96931.25,51,$1755.75
2024-03-12,22:48:00,18475.25,BUY,3,0.03h,Stop Loss,$-18.00,$1737.75,$96913.25,51,$1737.75
2024-03-12,22:51:00,18227.0,SELL,3,0.02h,Stop Loss,$-18.00,$1719.75,$96895.25,51,$1719.75
2024-03-12,22:53:00,18479.75,BUY,3,0.02h,Stop Loss,$-18.00,$1701.75,$96877.25,51,$1701.75
2024-03-12,22:54:00,18229.75,SELL,3,0.02h,Break Even,$0.75,$1702.50,$96878.00,51,$1702.50
,,,,,,,,,,,
2024-03-13,12:04:00,18458.0,BUY,3,0.02h,Stop Loss,$-18.00,$-18.00,$96860.00,52,$-18.00
2024-03-13,12:05:00,18201.25,SELL,3,0.02h,Stop Loss,$-18.00,$-36.00,$96842.00,52,$-36.00
2024-03-13,12:07:00,18453.25,BUY,3,0.02h,Stop Loss,$-18.00,$-54.00,$96824.00,52,$-54.00
2024-03-13,12:10:00,18202.5,SELL,3,0.02h,Break Even,$0.75,$-53.25,$96824.75,52,$-53.25
2024-03-13,12:12:00,18447.0,BUY,3,0.02h,Stop Loss,$60.75,$7.50,$96885.50,52,$7.50
2024-03-13,12:18:00,18199.0,SELL,3,0.02h,Stop Loss,$12.00,$19.50,$96897.50,52,$19.50
2024-03-13,12:22:00,18443.0,BUY,3,0.02h,Stop Loss,$-18.00,$1.50,$96879.50,52,$1.50
2024-03-13,12:26:00,18187.25,SELL,3,0.02h,Break Even,$0.75,$2.25,$96880.25,52,$2.25
2024-03-13,12:30:00,18430.5,BUY,3,0.02h,Stop Loss,$-18.00,$-15.75,$96862.25,52,$-15.75
2024-03-13,12:32:00,18177.75,SELL,3,0.02h,Stop Loss,$-18.00,$-33.75,$96844.25,52,$-33.75
2024-03-13,12:33:00,18426.75,BUY,3,0.02h,Stop Loss,$-18.00,$-51.75,$96826.25,52,$-51.75
2024-03-13,12:34:00,18172.25,SELL,3,0.02h,Stop Loss,$-18.00,$-69.75,$96808.25,52,$-69.75
2024-03-13,12:35:00,18415.0,BUY,3,0.02h,Stop Loss,$75.75,$6.00,$96884.00,52,$6.00
2024-03-13,12:37:00,18167.75,SELL,3,0.02h,Stop Loss,$-18.00,$-12.00,$96866.00,52,$-12.00
2024-03-13,12:48:00,18423.0,BUY,3,0.02h,Break Even,$0.75,$-11.25,$96866.75,52,$-11.25
2024-03-13,12:53:00,18170.25,SELL,3,0.02h,Stop Loss,$-18.00,$-29.25,$96848.75,52,$-29.25
2024-03-13,12:54:00,18414.5,BUY,3,0.02h,Stop Loss,$12.00,$-17.25,$96860.75,52,$-17.25
2024-03-13,13:02:00,18177.0,SELL,3,0.02h,Stop Loss,$-18.00,$-35.25,$96842.75,52,$-35.25
2024-03-13,13:03:00,18427.75,BUY,3,0.02h,Stop Loss,$-18.00,$-53.25,$96824.75,52,$-53.25
2024-03-13,13:04:00,18182.0,SELL,3,0.02h,Stop Loss,$-18.00,$-71.25,$96806.75,52,$-71.25
2024-03-13,13:05:00,18434.0,BUY,3,0.02h,Stop Loss,$-18.00,$-89.25,$96788.75,52,$-89.25
2024-03-13,13:06:00,18184.25,SELL,3,0.02h,Stop Loss,$12.00,$-77.25,$96800.75,52,$-77.25
2024-03-13,13:10:00,18434.0,BUY,3,0.02h,Stop Loss,$-18.00,$-95.25,$96782.75,52,$-95.25
2024-03-13,13:16:00,18189.5,SELL,3,0.02h,Stop Loss,$38.25,$-57.00,$96821.00,52,$-57.00
2024-03-13,13:23:00,18434.5,BUY,3,0.02h,Stop Loss,$-18.00,$-75.00,$96803.00,52,$-75.00
2024-03-13,13:24:00,18184.75,SELL,3,0.02h,Stop Loss,$-18.00,$-93.00,$96785.00,52,$-93.00
2024-03-13,13:25:00,18432.0,BUY,3,0.02h,Stop Loss,$38.25,$-54.75,$96823.25,52,$-54.75
2024-03-13,13:28:00,18184.25,SELL,3,0.02h,Stop Loss,$-18.00,$-72.75,$96805.25,52,$-72.75
2024-03-13,13:29:00,18429.0,BUY,3,0.02h,Stop Loss,$42.00,$-30.75,$96847.25,52,$-30.75
2024-03-13,13:36:00,18155.0,SELL,3,0.02h,Stop Loss,$113.25,$82.50,$96960.50,52,$82.50
2024-03-13,13:43:00,18389.75,BUY,3,0.02h,Stop Loss,$-18.00,$64.50,$96942.50,52,$64.50
2024-03-13,13:47:00,18107.75,SELL,3,0.02h,Break Even,$0.75,$65.25,$96943.25,52,$65.25
2024-03-13,14:07:00,18335.5,BUY,3,0.02h,Stop Loss,$-18.00,$47.25,$96925.25,52,$47.25
2024-03-13,14:11:00,18075.0,SELL,3,0.02h,Stop Loss,$-18.00,$29.25,$96907.25,52,$29.25
2024-03-13,14:16:00,18335.0,BUY,3,0.02h,Stop Loss,$-18.00,$11.25,$96889.25,52,$11.25
2024-03-13,14:17:00,18081.0,SELL,3,0.02h,Break Even,$0.75,$12.00,$96890.00,52,$12.00
2024-03-13,14:24:00,18343.25,BUY,3,0.02h,Stop Loss,$-18.00,$-6.00,$96872.00,52,$-6.00
2024-03-13,14:25:00,18098.25,SELL,3,0.02h,Stop Loss,$64.50,$58.50,$96936.50,52,$58.50
2024-03-13,14:29:00,18341.25,BUY,3,0.02h,Stop Loss,$-18.00,$40.50,$96918.50,52,$40.50
2024-03-13,14:30:00,18095.75,SELL,3,0.02h,Stop Loss,$15.75,$56.25,$96934.25,52,$56.25
2024-03-13,14:32:00,18344.0,BUY,3,0.02h,Stop Loss,$-18.00,$38.25,$96916.25,52,$38.25
2024-03-13,14:33:00,18099.25,SELL,3,0.02h,Stop Loss,$-18.00,$20.25,$96898.25,52,$20.25
2024-03-13,14:34:00,18361.5,BUY,3,0.02h,Break Even,$0.75,$21.00,$96899.00,52,$21.00
2024-03-13,14:38:00,18096.5,SELL,3,0.02h,Stop Loss,$-18.00,$3.00,$96881.00,52,$3.00
2024-03-13,14:39:00,18354.5,BUY,3,0.02h,Stop Loss,$-18.00,$-15.00,$96863.00,52,$-15.00
2024-03-13,14:50:00,18112.75,SELL,3,0.02h,Stop Loss,$49.50,$34.50,$96912.50,52,$34.50
2024-03-13,15:06:00,18356.5,BUY,3,0.02h,Stop Loss,$-18.00,$16.50,$96894.50,52,$16.50
2024-03-13,15:08:00,18094.25,SELL,3,0.02h,Break Even,$0.75,$17.25,$96895.25,52,$17.25
2024-03-13,15:13:00,18362.75,BUY,3,0.02h,Stop Loss,$-18.00,$-0.75,$96877.25,52,$-0.75
2024-03-13,15:14:00,18105.5,SELL,3,0.02h,Stop Loss,$109.50,$108.75,$96986.75,52,$108.75
2024-03-13,15:17:00,18347.5,BUY,3,0.02h,Stop Loss,$45.75,$154.50,$97032.50,52,$154.50
2024-03-13,15:30:00,18073.5,SELL,3,0.02h,Stop Loss,$64.50,$219.00,$97097.00,52,$219.00
2024-03-13,15:42:00,18304.25,BUY,3,0.02h,Stop Loss,$-18.00,$201.00,$97079.00,52,$201.00
2024-03-13,15:43:00,18044.75,SELL,3,0.02h,Stop Loss,$117.00,$318.00,$97196.00,52,$318.00
2024-03-13,15:48:00,18296.0,BUY,3,0.02h,Stop Loss,$38.25,$356.25,$97234.25,52,$356.25
2024-03-13,15:55:00,18075.75,SELL,3,0.02h,Stop Loss,$-18.00,$338.25,$97216.25,52,$338.25
2024-03-13,15:57:00,18332.5,BUY,3,0.02h,Stop Loss,$-18.00,$320.25,$97198.25,52,$320.25
2024-03-13,15:58:00,18083.75,SELL,3,0.02h,Stop Loss,$-18.00,$302.25,$97180.25,52,$302.25
2024-03-13,15:59:00,18330.25,BUY,3,0.02h,Stop Loss,$60.75,$363.00,$97241.00,52,$363.00
2024-03-13,16:02:00,18078.5,SELL,3,0.02h,Stop Loss,$27.00,$390.00,$97268.00,52,$390.00
2024-03-13,16:06:00,18336.0,BUY,3,0.02h,Stop Loss,$-18.00,$372.00,$97250.00,52,$372.00
2024-03-13,16:10:00,18078.0,SELL,3,0.02h,Stop Loss,$23.25,$395.25,$97273.25,52,$395.25
2024-03-13,16:18:00,18335.5,BUY,3,0.02h,Stop Loss,$27.00,$422.25,$97300.25,52,$422.25
2024-03-13,16:22:00,18089.75,SELL,3,0.02h,Stop Loss,$-18.00,$404.25,$97282.25,52,$404.25
2024-03-13,16:24:00,18338.75,BUY,3,0.02h,Stop Loss,$-18.00,$386.25,$97264.25,52,$386.25
2024-03-13,16:25:00,18092.5,SELL,3,0.02h,Stop Loss,$-18.00,$368.25,$97246.25,52,$368.25
2024-03-13,16:26:00,18344.0,BUY,3,0.02h,Stop Loss,$-18.00,$350.25,$97228.25,52,$350.25
2024-03-13,16:27:00,18091.5,SELL,3,0.02h,Stop Loss,$-18.00,$332.25,$97210.25,52,$332.25
2024-03-13,16:28:00,18342.5,BUY,3,0.02h,Stop Loss,$-18.00,$314.25,$97192.25,52,$314.25
2024-03-13,16:29:00,18083.25,SELL,3,0.02h,Stop Loss,$-18.00,$296.25,$97174.25,52,$296.25
2024-03-13,16:31:00,18339.0,BUY,3,0.02h,Stop Loss,$-18.00,$278.25,$97156.25,52,$278.25
2024-03-13,16:32:00,18075.75,SELL,3,0.02h,Stop Loss,$34.50,$312.75,$97190.75,52,$312.75
2024-03-13,16:35:00,18328.5,BUY,3,0.02h,Stop Loss,$-18.00,$294.75,$97172.75,52,$294.75
2024-03-13,16:36:00,18080.75,SELL,3,0.02h,Stop Loss,$-18.00,$276.75,$97154.75,52,$276.75
2024-03-13,16:37:00,18327.0,BUY,3,0.02h,Stop Loss,$-18.00,$258.75,$97136.75,52,$258.75
2024-03-13,16:38:00,18078.0,SELL,3,0.02h,Stop Loss,$-18.00,$240.75,$97118.75,52,$240.75
2024-03-13,16:44:00,18351.5,BUY,3,0.02h,Stop Loss,$-18.00,$222.75,$97100.75,52,$222.75
2024-03-13,16:45:00,18100.25,SELL,3,0.02h,Break Even,$0.75,$223.50,$97101.50,52,$223.50
2024-03-13,16:47:00,18350.75,BUY,3,0.02h,Break Even,$0.75,$224.25,$97102.25,52,$224.25
2024-03-13,16:57:00,18102.75,SELL,3,0.02h,Stop Loss,$42.00,$266.25,$97144.25,52,$266.25
2024-03-13,17:05:00,18362.75,BUY,3,0.02h,Stop Loss,$68.25,$334.50,$97212.50,52,$334.50
2024-03-13,17:17:00,18104.25,SELL,3,0.02h,Stop Loss,$-18.00,$316.50,$97194.50,52,$316.50
2024-03-13,17:20:00,18359.0,BUY,3,0.02h,Stop Loss,$-18.00,$298.50,$97176.50,52,$298.50
2024-03-13,17:21:00,18111.25,SELL,3,0.02h,Stop Loss,$-18.00,$280.50,$97158.50,52,$280.50
2024-03-13,17:22:00,18363.75,BUY,3,0.02h,Stop Loss,$-18.00,$262.50,$97140.50,52,$262.50
2024-03-13,17:23:00,18116.0,SELL,3,0.02h,Stop Loss,$-18.00,$244.50,$97122.50,52,$244.50
2024-03-13,17:24:00,18365.0,BUY,3,0.02h,Stop Loss,$-18.00,$226.50,$97104.50,52,$226.50
2024-03-13,17:25:00,18117.75,SELL,3,0.02h,Stop Loss,$-18.00,$208.50,$97086.50,52,$208.50
2024-03-13,17:28:00,18378.5,BUY,3,0.02h,Break Even,$0.75,$209.25,$97087.25,52,$209.25
2024-03-13,17:31:00,18142.5,SELL,3,0.02h,Stop Loss,$143.25,$352.50,$97230.50,52,$352.50
2024-03-13,17:35:00,18369.75,BUY,3,0.02h,Stop Loss,$-18.00,$334.50,$97212.50,52,$334.50
2024-03-13,17:36:00,18121.75,SELL,3,0.02h,Stop Loss,$-18.00,$316.50,$97194.50,52,$316.50
2024-03-13,17:37:00,18383.25,BUY,3,0.02h,Stop Loss,$-18.00,$298.50,$97176.50,52,$298.50
2024-03-13,17:38:00,18135.5,SELL,3,0.02h,Stop Loss,$72.00,$370.50,$97248.50,52,$370.50
2024-03-13,17:43:00,18372.25,BUY,3,0.02h,Stop Loss,$-18.00,$352.50,$97230.50,52,$352.50
2024-03-13,17:44:00,18120.25,SELL,3,0.02h,Stop Loss,$-18.00,$334.50,$97212.50,52,$334.50
2024-03-13,17:45:00,18367.25,BUY,3,0.02h,Stop Loss,$120.75,$455.25,$97333.25,52,$455.25
2024-03-13,17:57:00,18135.25,SELL,3,0.02h,Stop Loss,$-18.00,$437.25,$97315.25,52,$437.25
2024-03-13,17:58:00,18390.5,BUY,3,0.02h,Stop Loss,$-18.00,$419.25,$97297.25,52,$419.25
2024-03-13,17:59:00,18141.0,SELL,3,0.02h,Stop Loss,$-18.00,$401.25,$97279.25,52,$401.25
2024-03-13,18:00:00,18388.25,BUY,3,0.02h,Stop Loss,$-18.00,$383.25,$97261.25,52,$383.25
2024-03-13,18:01:00,18136.75,SELL,3,0.02h,Stop Loss,$-18.00,$365.25,$97243.25,52,$365.25
2024-03-13,18:04:00,18384.25,BUY,3,0.02h,Break Even,$0.75,$366.00,$97244.00,52,$366.00
2024-03-13,18:20:00,18123.25,SELL,3,0.02h,Stop Loss,$-18.00,$348.00,$97226.00,52,$348.00
2024-03-13,18:21:00,18380.0,BUY,3,0.02h,Stop Loss,$42.00,$390.00,$97268.00,52,$390.00
2024-03-13,18:24:00,18131.75,SELL,3,0.02h,Break Even,$0.75,$390.75,$97268.75,52,$390.75
2024-03-13,18:36:00,18387.75,BUY,3,0.02h,Break Even,$0.75,$391.50,$97269.50,52,$391.50
2024-03-13,18:49:00,18135.5,SELL,3,0.02h,Stop Loss,$-18.00,$373.50,$97251.50,52,$373.50
2024-03-13,18:54:00,18397.25,BUY,3,0.02h,Stop Loss,$-18.00,$355.50,$97233.50,52,$355.50
2024-03-13,18:57:00,18141.5,SELL,3,0.02h,Stop Loss,$-18.00,$337.50,$97215.50,52,$337.50
2024-03-13,18:58:00,18387.0,BUY,3,0.02h,Stop Loss,$-18.00,$319.50,$97197.50,52,$319.50
2024-03-13,18:59:00,18131.75,SELL,3,0.02h,Stop Loss,$-18.00,$301.50,$97179.50,52,$301.50
2024-03-13,19:01:00,18385.75,BUY,3,0.02h,Stop Loss,$-18.00,$283.50,$97161.50,52,$283.50
2024-03-13,19:02:00,18132.75,SELL,3,0.02h,Stop Loss,$34.50,$318.00,$97196.00,52,$318.00
2024-03-13,19:05:00,18384.0,BUY,3,0.02h,Stop Loss,$-18.00,$300.00,$97178.00,52,$300.00
2024-03-13,19:07:00,18123.5,SELL,3,0.02h,Break Even,$0.75,$300.75,$97178.75,52,$300.75
2024-03-13,19:16:00,18373.5,BUY,3,0.02h,Stop Loss,$-18.00,$282.75,$97160.75,52,$282.75
2024-03-13,19:17:00,18123.25,SELL,3,0.02h,Stop Loss,$-18.00,$264.75,$97142.75,52,$264.75
2024-03-13,19:21:00,18382.5,BUY,3,0.02h,Stop Loss,$-18.00,$246.75,$97124.75,52,$246.75
2024-03-13,19:22:00,18127.75,SELL,3,0.02h,Stop Loss,$-18.00,$228.75,$97106.75,52,$228.75
2024-03-13,19:23:00,18372.5,BUY,3,0.02h,Stop Loss,$-18.00,$210.75,$97088.75,52,$210.75
2024-03-13,19:31:00,18086.25,SELL,3,0.02h,Stop Loss,$147.00,$357.75,$97235.75,52,$357.75
2024-03-13,19:36:00,18321.75,BUY,3,0.02h,Stop Loss,$-18.00,$339.75,$97217.75,52,$339.75
2024-03-13,19:37:00,18072.5,SELL,3,0.02h,Stop Loss,$-18.00,$321.75,$97199.75,52,$321.75
2024-03-13,19:48:00,18344.0,BUY,3,0.02h,Stop Loss,$23.25,$345.00,$97223.00,52,$345.00
2024-03-13,19:51:00,18087.75,SELL,3,0.02h,Stop Loss,$244.50,$589.50,$97467.50,52,$589.50
2024-03-13,20:03:00,18331.5,BUY,3,0.02h,Stop Loss,$-18.00,$571.50,$97449.50,52,$571.50
2024-03-13,20:04:00,18080.25,SELL,3,0.02h,Stop Loss,$-18.00,$553.50,$97431.50,52,$553.50
2024-03-13,20:05:00,18333.25,BUY,3,0.02h,Stop Loss,$23.25,$576.75,$97454.75,52,$576.75
2024-03-13,20:11:00,18091.0,SELL,3,0.02h,Stop Loss,$-18.00,$558.75,$97436.75,52,$558.75
2024-03-13,20:12:00,18341.0,BUY,3,0.02h,Stop Loss,$-18.00,$540.75,$97418.75,52,$540.75
2024-03-13,20:13:00,18092.75,SELL,3,0.02h,Stop Loss,$-18.00,$522.75,$97400.75,52,$522.75
2024-03-13,20:14:00,18346.0,BUY,3,0.02h,Stop Loss,$-18.00,$504.75,$97382.75,52,$504.75
2024-03-13,20:15:00,18094.5,SELL,3,0.02h,Stop Loss,$19.50,$524.25,$97402.25,52,$524.25
2024-03-13,20:22:00,18344.0,BUY,3,0.02h,Stop Loss,$-18.00,$506.25,$97384.25,52,$506.25
2024-03-13,20:23:00,18093.75,SELL,3,0.02h,Stop Loss,$-18.00,$488.25,$97366.25,52,$488.25
2024-03-13,20:24:00,18343.5,BUY,3,0.02h,Break Even,$0.75,$489.00,$97367.00,52,$489.00
2024-03-13,20:34:00,18097.75,SELL,3,0.02h,Break Even,$0.75,$489.75,$97367.75,52,$489.75
2024-03-13,20:36:00,18348.75,BUY,3,0.03h,Stop Loss,$-18.00,$471.75,$97349.75,52,$471.75
2024-03-13,20:39:00,18096.75,SELL,3,0.02h,Break Even,$0.75,$472.50,$97350.50,52,$472.50
2024-03-13,20:41:00,18347.5,BUY,3,0.03h,Stop Loss,$-18.00,$454.50,$97332.50,52,$454.50
2024-03-13,20:43:00,18096.75,SELL,3,0.02h,Stop Loss,$-18.00,$436.50,$97314.50,52,$436.50
2024-03-13,20:53:00,18352.75,BUY,3,0.02h,Break Even,$0.75,$437.25,$97315.25,52,$437.25
2024-03-13,20:58:00,18106.5,SELL,3,0.03h,Break Even,$0.75,$438.00,$97316.00,52,$438.00
2024-03-13,21:00:00,18355.5,BUY,3,1.02h,Stop Loss,$-18.00,$420.00,$97298.00,52,$420.00
2024-03-13,22:01:00,18097.5,SELL,3,0.02h,Stop Loss,$-18.00,$402.00,$97280.00,52,$402.00
2024-03-13,22:11:00,18355.75,BUY,3,0.02h,Stop Loss,$-18.00,$384.00,$97262.00,52,$384.00
2024-03-13,22:13:00,18101.0,SELL,3,0.02h,Stop Loss,$-18.00,$366.00,$97244.00,52,$366.00
2024-03-13,22:16:00,18353.0,BUY,3,0.02h,Stop Loss,$-18.00,$348.00,$97226.00,52,$348.00
2024-03-13,22:20:00,18104.5,SELL,3,0.03h,Break Even,$0.75,$348.75,$97226.75,52,$348.75
2024-03-13,22:22:00,18351.75,BUY,3,0.02h,Stop Loss,$-18.00,$330.75,$97208.75,52,$330.75
2024-03-13,22:31:00,18103.25,SELL,3,0.02h,Break Even,$0.75,$331.50,$97209.50,52,$331.50
2024-03-13,22:40:00,18350.0,BUY,3,0.07h,Break Even,$0.75,$332.25,$97210.25,52,$332.25
2024-03-13,22:46:00,18103.75,SELL,3,0.02h,Stop Loss,$-18.00,$314.25,$97192.25,52,$314.25
2024-03-13,22:50:00,18360.25,BUY,3,0.02h,Stop Loss,$-18.00,$296.25,$97174.25,52,$296.25
2024-03-13,23:00:00,18108.0,SELL,3,13.00h,Stop Loss,$-18.00,$278.25,$97156.25,52,$278.25
,,,,,,,,,,,
2024-03-14,12:00:00,18395.25,BUY,3,0.02h,Stop Loss,$-18.00,$-18.00,$97138.25,53,$-18.00
2024-03-14,12:02:00,18150.75,SELL,3,0.02h,Stop Loss,$-18.00,$-36.00,$97120.25,53,$-36.00
2024-03-14,12:03:00,18405.75,BUY,3,0.02h,Break Even,$0.75,$-35.25,$97121.00,53,$-35.25
2024-03-14,12:17:00,18156.5,SELL,3,0.02h,Stop Loss,$-18.00,$-53.25,$97103.00,53,$-53.25
2024-03-14,12:18:00,18410.25,BUY,3,0.02h,Break Even,$0.75,$-52.50,$97103.75,53,$-52.50
2024-03-14,12:22:00,18155.25,SELL,3,0.02h,Stop Loss,$-18.00,$-70.50,$97085.75,53,$-70.50
2024-03-14,12:24:00,18403.75,BUY,3,0.02h,Stop Loss,$-18.00,$-88.50,$97067.75,53,$-88.50
2024-03-14,12:27:00,18155.25,SELL,3,0.02h,Stop Loss,$-18.00,$-106.50,$97049.75,53,$-106.50
2024-03-14,12:28:00,18404.25,BUY,3,0.02h,Stop Loss,$-18.00,$-124.50,$97031.75,53,$-124.50
2024-03-14,12:29:00,18163.0,SELL,3,0.02h,Stop Loss,$-18.00,$-142.50,$97013.75,53,$-142.50
2024-03-14,12:30:00,18407.25,BUY,3,0.02h,Stop Loss,$-18.00,$-160.50,$96995.75,53,$-160.50
2024-03-14,12:31:00,18128.75,SELL,3,0.02h,Stop Loss,$-18.00,$-178.50,$96977.75,53,$-178.50
2024-03-14,12:33:00,18367.0,BUY,3,0.02h,Stop Loss,$113.25,$-65.25,$97091.00,53,$-65.25
2024-03-14,12:38:00,18115.0,SELL,3,0.02h,Stop Loss,$-18.00,$-83.25,$97073.00,53,$-83.25
2024-03-14,12:49:00,18384.0,BUY,3,0.02h,Break Even,$0.75,$-82.50,$97073.75,53,$-82.50
2024-03-14,12:51:00,18117.5,SELL,3,0.02h,Stop Loss,$83.25,$0.75,$97157.00,53,$0.75
2024-03-14,12:56:00,18369.25,BUY,3,0.02h,Stop Loss,$-18.00,$-17.25,$97139.00,53,$-17.25
2024-03-14,12:57:00,18125.5,SELL,3,0.02h,Stop Loss,$-18.00,$-35.25,$97121.00,53,$-35.25
2024-03-14,12:58:00,18374.0,BUY,3,0.02h,Stop Loss,$-18.00,$-53.25,$97103.00,53,$-53.25
2024-03-14,12:59:00,18119.5,SELL,3,0.02h,Stop Loss,$-18.00,$-71.25,$97085.00,53,$-71.25
2024-03-14,13:00:00,18370.5,BUY,3,0.02h,Stop Loss,$64.50,$-6.75,$97149.50,53,$-6.75
2024-03-14,13:09:00,18107.25,SELL,3,0.02h,Stop Loss,$-18.00,$-24.75,$97131.50,53,$-24.75
2024-03-14,13:10:00,18357.75,BUY,3,0.02h,Break Even,$0.75,$-24.00,$97132.25,53,$-24.00
2024-03-14,13:12:00,18112.25,SELL,3,0.02h,Stop Loss,$60.75,$36.75,$97193.00,53,$36.75
2024-03-14,13:16:00,18361.0,BUY,3,0.02h,Stop Loss,$-18.00,$18.75,$97175.00,53,$18.75
2024-03-14,13:17:00,18113.5,SELL,3,0.02h,Stop Loss,$-18.00,$0.75,$97157.00,53,$0.75
2024-03-14,13:35:00,18374.5,BUY,3,0.02h,Break Even,$0.75,$1.50,$97157.75,53,$1.50
2024-03-14,13:39:00,18142.0,SELL,3,0.02h,Stop Loss,$-18.00,$-16.50,$97139.75,53,$-16.50
2024-03-14,13:40:00,18384.75,BUY,3,0.02h,Stop Loss,$57.00,$40.50,$97196.75,53,$40.50
2024-03-14,13:51:00,18247.75,SELL,3,0.02h,Stop Loss,$57.00,$97.50,$97253.75,53,$97.50
2024-03-14,14:07:00,18257.5,BUY,3,0.02h,Stop Loss,$45.75,$143.25,$97299.50,53,$143.25
2024-03-14,14:13:00,18051.75,SELL,3,0.02h,Stop Loss,$-18.00,$125.25,$97281.50,53,$125.25
2024-03-14,14:14:00,18306.0,BUY,3,0.02h,Stop Loss,$23.25,$148.50,$97304.75,53,$148.50
2024-03-14,14:17:00,18050.25,SELL,3,0.02h,Stop Loss,$-18.00,$130.50,$97286.75,53,$130.50
2024-03-14,14:18:00,18294.75,BUY,3,0.02h,Break Even,$0.75,$131.25,$97287.50,53,$131.25
2024-03-14,14:20:00,18037.25,SELL,3,0.02h,Stop Loss,$53.25,$184.50,$97340.75,53,$184.50
2024-03-14,14:29:00,18293.25,BUY,3,0.02h,Stop Loss,$293.25,$477.75,$97634.00,53,$477.75
2024-03-14,14:31:00,18089.25,SELL,3,0.02h,Stop Loss,$-18.00,$459.75,$97616.00,53,$459.75
2024-03-14,14:32:00,18333.75,BUY,3,0.02h,Stop Loss,$30.75,$490.50,$97646.75,53,$490.50
2024-03-14,14:35:00,18088.75,SELL,3,0.02h,Stop Loss,$-18.00,$472.50,$97628.75,53,$472.50
2024-03-14,14:36:00,18337.75,BUY,3,0.02h,Break Even,$0.75,$473.25,$97629.50,53,$473.25
2024-03-14,14:44:00,18049.75,SELL,3,0.02h,Stop Loss,$72.00,$545.25,$97701.50,53,$545.25
2024-03-14,14:51:00,18295.75,BUY,3,0.02h,Stop Loss,$203.25,$748.50,$97904.75,53,$748.50
2024-03-14,14:53:00,18045.0,SELL,3,0.02h,Stop Loss,$-18.00,$730.50,$97886.75,53,$730.50
2024-03-14,14:54:00,18295.0,BUY,3,0.02h,Stop Loss,$117.00,$847.50,$98003.75,53,$847.50
2024-03-14,14:56:00,18044.5,SELL,3,0.02h,Break Even,$0.75,$848.25,$98004.50,53,$848.25
2024-03-14,15:04:00,18324.0,BUY,3,0.02h,Break Even,$0.75,$849.00,$98005.25,53,$849.00
2024-03-14,15:09:00,18060.25,SELL,3,0.02h,Stop Loss,$-18.00,$831.00,$97987.25,53,$831.00
2024-03-14,15:10:00,18307.25,BUY,3,0.02h,Stop Loss,$285.75,$1116.75,$98273.00,53,$1116.75
2024-03-14,15:13:00,18082.25,SELL,3,0.02h,Break Even,$0.75,$1117.50,$98273.75,53,$1117.50
2024-03-14,15:26:00,18277.75,BUY,3,0.02h,Stop Loss,$53.25,$1170.75,$98327.00,53,$1170.75
2024-03-14,15:30:00,18031.75,SELL,3,0.02h,Stop Loss,$-18.00,$1152.75,$98309.00,53,$1152.75
2024-03-14,15:31:00,18275.5,BUY,3,0.02h,Break Even,$0.75,$1153.50,$98309.75,53,$1153.50
2024-03-14,15:33:00,18025.75,SELL,3,0.02h,Break Even,$0.75,$1154.25,$98310.50,53,$1154.25
2024-03-14,15:41:00,18287.5,BUY,3,0.02h,Stop Loss,$-18.00,$1136.25,$98292.50,53,$1136.25
2024-03-14,15:42:00,18043.0,SELL,3,0.02h,Stop Loss,$27.00,$1163.25,$98319.50,53,$1163.25
2024-03-14,15:49:00,18280.25,BUY,3,0.02h,Stop Loss,$19.50,$1182.75,$98339.00,53,$1182.75
2024-03-14,16:06:00,18022.0,SELL,3,0.02h,Stop Loss,$-18.00,$1164.75,$98321.00,53,$1164.75
2024-03-14,16:08:00,18251.5,BUY,3,0.02h,Stop Loss,$-18.00,$1146.75,$98303.00,53,$1146.75
2024-03-14,16:09:00,18003.0,SELL,3,0.02h,Stop Loss,$-18.00,$1128.75,$98285.00,53,$1128.75
2024-03-14,16:16:00,18252.25,BUY,3,0.02h,Stop Loss,$-18.00,$1110.75,$98267.00,53,$1110.75
2024-03-14,16:17:00,18006.5,SELL,3,0.02h,Stop Loss,$-18.00,$1092.75,$98249.00,53,$1092.75
2024-03-14,16:21:00,18254.5,BUY,3,0.02h,Stop Loss,$165.75,$1258.50,$98414.75,53,$1258.50
2024-03-14,16:32:00,18042.75,SELL,3,0.02h,Stop Loss,$128.25,$1386.75,$98543.00,53,$1386.75
2024-03-14,16:35:00,18283.5,BUY,3,0.02h,Stop Loss,$-18.00,$1368.75,$98525.00,53,$1368.75
2024-03-14,16:36:00,18050.75,SELL,3,0.02h,Stop Loss,$-18.00,$1350.75,$98507.00,53,$1350.75
2024-03-14,16:38:00,18291.25,BUY,3,0.02h,Stop Loss,$-18.00,$1332.75,$98489.00,53,$1332.75
2024-03-14,16:39:00,18036.75,SELL,3,0.02h,Stop Loss,$-18.00,$1314.75,$98471.00,53,$1314.75
2024-03-14,16:49:00,18268.75,BUY,3,0.02h,Stop Loss,$-18.00,$1296.75,$98453.00,53,$1296.75
2024-03-14,16:51:00,18022.0,SELL,3,0.02h,Stop Loss,$-18.00,$1278.75,$98435.00,53,$1278.75
2024-03-14,16:52:00,18275.25,BUY,3,0.02h,Stop Loss,$-18.00,$1260.75,$98417.00,53,$1260.75
2024-03-14,16:53:00,18027.5,SELL,3,0.02h,Stop Loss,$-18.00,$1242.75,$98399.00,53,$1242.75
2024-03-14,16:54:00,18271.5,BUY,3,0.02h,Stop Loss,$-18.00,$1224.75,$98381.00,53,$1224.75
2024-03-14,16:55:00,18020.75,SELL,3,0.02h,Stop Loss,$75.75,$1300.50,$98456.75,53,$1300.50
2024-03-14,17:04:00,18250.25,BUY,3,0.02h,Break Even,$0.75,$1301.25,$98457.50,53,$1301.25
2024-03-14,17:08:00,17998.25,SELL,3,0.02h,Stop Loss,$-18.00,$1283.25,$98439.50,53,$1283.25
2024-03-14,17:09:00,18241.75,BUY,3,0.02h,Stop Loss,$68.25,$1351.50,$98507.75,53,$1351.50
2024-03-14,17:12:00,17988.25,SELL,3,0.02h,Stop Loss,$-18.00,$1333.50,$98489.75,53,$1333.50
2024-03-14,17:13:00,18233.5,BUY,3,0.02h,Stop Loss,$-18.00,$1315.50,$98471.75,53,$1315.50
2024-03-14,17:14:00,17992.5,SELL,3,0.02h,Stop Loss,$23.25,$1338.75,$98495.00,53,$1338.75
2024-03-14,17:23:00,18229.5,BUY,3,0.02h,Stop Loss,$-18.00,$1320.75,$98477.00,53,$1320.75
2024-03-14,17:24:00,17993.25,SELL,3,0.02h,Break Even,$0.75,$1321.50,$98477.75,53,$1321.50
2024-03-14,17:33:00,18229.25,BUY,3,0.02h,Stop Loss,$-18.00,$1303.50,$98459.75,53,$1303.50
2024-03-14,17:34:00,17982.5,SELL,3,0.02h,Stop Loss,$-18.00,$1285.50,$98441.75,53,$1285.50
2024-03-14,17:37:00,18238.75,BUY,3,0.02h,Stop Loss,$-18.00,$1267.50,$98423.75,53,$1267.50
2024-03-14,17:38:00,18004.25,SELL,3,0.02h,Stop Loss,$-18.00,$1249.50,$98405.75,53,$1249.50
2024-03-14,17:39:00,18253.5,BUY,3,0.02h,Stop Loss,$-18.00,$1231.50,$98387.75,53,$1231.50
2024-03-14,17:50:00,18012.25,SELL,3,0.02h,Stop Loss,$12.00,$1243.50,$98399.75,53,$1243.50
2024-03-14,17:52:00,18267.0,BUY,3,0.02h,Break Even,$0.75,$1244.25,$98400.50,53,$1244.25
2024-03-14,18:02:00,18064.75,SELL,3,0.02h,Stop Loss,$-18.00,$1226.25,$98382.50,53,$1226.25
2024-03-14,18:07:00,18314.5,BUY,3,0.02h,Stop Loss,$-18.00,$1208.25,$98364.50,53,$1208.25
2024-03-14,18:08:00,18063.5,SELL,3,0.02h,Stop Loss,$-18.00,$1190.25,$98346.50,53,$1190.25
2024-03-14,18:10:00,18322.25,BUY,3,0.02h,Stop Loss,$-18.00,$1172.25,$98328.50,53,$1172.25
2024-03-14,18:12:00,18074.75,SELL,3,0.02h,Stop Loss,$-18.00,$1154.25,$98310.50,53,$1154.25
2024-03-14,18:14:00,18321.0,BUY,3,0.02h,Stop Loss,$23.25,$1177.50,$98333.75,53,$1177.50
2024-03-14,18:29:00,18055.0,SELL,3,0.02h,Stop Loss,$-18.00,$1159.50,$98315.75,53,$1159.50
2024-03-14,18:30:00,18299.75,BUY,3,0.02h,Stop Loss,$75.75,$1235.25,$98391.50,53,$1235.25
2024-03-14,18:32:00,18040.5,SELL,3,0.02h,Stop Loss,$-18.00,$1217.25,$98373.50,53,$1217.25
2024-03-14,18:33:00,18289.0,BUY,3,0.02h,Stop Loss,$-18.00,$1199.25,$98355.50,53,$1199.25
2024-03-14,18:34:00,18042.0,SELL,3,0.02h,Stop Loss,$-18.00,$1181.25,$98337.50,53,$1181.25
2024-03-14,18:37:00,18286.5,BUY,3,0.02h,Stop Loss,$-18.00,$1163.25,$98319.50,53,$1163.25
2024-03-14,18:39:00,18036.75,SELL,3,0.02h,Stop Loss,$57.00,$1220.25,$98376.50,53,$1220.25
2024-03-14,18:49:00,18306.5,BUY,3,0.02h,Break Even,$0.75,$1221.00,$98377.25,53,$1221.00
2024-03-14,18:54:00,18022.0,SELL,3,0.02h,Stop Loss,$113.25,$1334.25,$98490.50,53,$1334.25
2024-03-14,19:08:00,18224.5,BUY,3,0.02h,Stop Loss,$-18.00,$1316.25,$98472.50,53,$1316.25
2024-03-14,19:09:00,17961.75,SELL,3,0.02h,Stop Loss,$-18.00,$1298.25,$98454.50,53,$1298.25
2024-03-14,19:10:00,18198.5,BUY,3,0.02h,Stop Loss,$87.00,$1385.25,$98541.50,53,$1385.25
2024-03-14,19:14:00,17939.0,SELL,3,0.02h,Stop Loss,$-18.00,$1367.25,$98523.50,53,$1367.25
2024-03-14,19:18:00,18199.0,BUY,3,0.02h,Stop Loss,$-18.00,$1349.25,$98505.50,53,$1349.25
2024-03-14,19:20:00,17943.5,SELL,3,0.02h,Stop Loss,$-18.00,$1331.25,$98487.50,53,$1331.25
2024-03-14,19:23:00,18195.5,BUY,3,0.02h,Stop Loss,$-18.00,$1313.25,$98469.50,53,$1313.25
2024-03-14,19:24:00,17941.25,SELL,3,0.02h,Stop Loss,$27.00,$1340.25,$98496.50,53,$1340.25
2024-03-14,19:30:00,18192.0,BUY,3,0.02h,Break Even,$0.75,$1341.00,$98497.25,53,$1341.00
2024-03-14,19:32:00,17935.5,SELL,3,0.02h,Stop Loss,$143.25,$1484.25,$98640.50,53,$1484.25
2024-03-14,19:41:00,18201.0,BUY,3,0.02h,Stop Loss,$135.75,$1620.00,$98776.25,53,$1620.00
2024-03-14,19:48:00,17964.0,SELL,3,0.02h,Stop Loss,$-18.00,$1602.00,$98758.25,53,$1602.00
2024-03-14,19:50:00,18221.0,BUY,3,0.02h,Stop Loss,$173.25,$1775.25,$98931.50,53,$1775.25
2024-03-14,19:53:00,17998.5,SELL,3,0.02h,Stop Loss,$-18.00,$1757.25,$98913.50,53,$1757.25
2024-03-14,19:54:00,18246.75,BUY,3,0.02h,Stop Loss,$-18.00,$1739.25,$98895.50,53,$1739.25
2024-03-14,19:56:00,18009.5,SELL,3,0.02h,Stop Loss,$154.50,$1893.75,$99050.00,53,$1893.75
2024-03-14,19:58:00,18253.75,BUY,3,0.02h,Stop Loss,$-18.00,$1875.75,$99032.00,53,$1875.75
2024-03-14,20:00:00,18030.75,SELL,3,0.02h,Stop Loss,$-18.00,$1857.75,$99014.00,53,$1857.75
2024-03-14,20:01:00,18279.25,BUY,3,0.02h,Stop Loss,$139.50,$1997.25,$99153.50,53,$1997.25
2024-03-14,20:14:00,18016.75,SELL,3,0.02h,Stop Loss,$53.25,$2050.50,$99206.75,53,$2050.50
2024-03-14,20:18:00,18260.5,BUY,3,0.02h,Stop Loss,$23.25,$2073.75,$99230.00,53,$2073.75
2024-03-14,20:26:00,18017.0,SELL,3,0.02h,Stop Loss,$12.00,$2085.75,$99242.00,53,$2085.75
2024-03-14,20:33:00,18261.5,BUY,3,0.02h,Stop Loss,$-18.00,$2067.75,$99224.00,53,$2067.75
2024-03-14,20:34:00,18011.75,SELL,3,0.02h,Stop Loss,$-18.00,$2049.75,$99206.00,53,$2049.75
2024-03-14,20:41:00,18265.0,BUY,3,0.02h,Stop Loss,$-18.00,$2031.75,$99188.00,53,$2031.75
2024-03-14,20:42:00,18020.25,SELL,3,0.02h,Stop Loss,$-18.00,$2013.75,$99170.00,53,$2013.75
2024-03-14,20:46:00,18273.25,BUY,3,0.02h,Stop Loss,$-18.00,$1995.75,$99152.00,53,$1995.75
2024-03-14,20:53:00,18014.25,SELL,3,0.02h,Stop Loss,$-18.00,$1977.75,$99134.00,53,$1977.75
2024-03-14,21:00:00,18267.0,BUY,3,1.02h,Stop Loss,$-18.00,$1959.75,$99116.00,53,$1959.75
2024-03-14,22:01:00,18002.25,SELL,3,0.02h,Stop Loss,$-18.00,$1941.75,$99098.00,53,$1941.75
2024-03-14,22:05:00,18253.0,BUY,3,0.02h,Stop Loss,$-18.00,$1923.75,$99080.00,53,$1923.75
2024-03-14,22:09:00,18009.25,SELL,3,0.02h,Stop Loss,$-18.00,$1905.75,$99062.00,53,$1905.75
2024-03-14,22:17:00,18254.0,BUY,3,0.02h,Stop Loss,$-18.00,$1887.75,$99044.00,53,$1887.75
2024-03-14,22:18:00,18006.25,SELL,3,0.02h,Stop Loss,$12.00,$1899.75,$99056.00,53,$1899.75
2024-03-14,22:22:00,18251.75,BUY,3,0.02h,Stop Loss,$-18.00,$1881.75,$99038.00,53,$1881.75
2024-03-14,22:28:00,18006.75,SELL,3,0.02h,Stop Loss,$-18.00,$1863.75,$99020.00,53,$1863.75
2024-03-14,22:29:00,18259.0,BUY,3,0.02h,Break Even,$0.75,$1864.50,$99020.75,53,$1864.50
2024-03-14,22:32:00,18007.25,SELL,3,0.02h,Stop Loss,$-18.00,$1846.50,$99002.75,53,$1846.50
2024-03-14,22:38:00,18257.25,BUY,3,0.02h,Break Even,$0.75,$1847.25,$99003.50,53,$1847.25
2024-03-14,22:41:00,18005.25,SELL,3,0.02h,Stop Loss,$-18.00,$1829.25,$98985.50,53,$1829.25
2024-03-14,22:42:00,18254.75,BUY,3,0.02h,Stop Loss,$-18.00,$1811.25,$98967.50,53,$1811.25
2024-03-14,22:43:00,18004.25,SELL,3,0.02h,Break Even,$0.75,$1812.00,$98968.25,53,$1812.00
2024-03-14,22:52:00,18250.0,BUY,3,0.02h,Break Even,$0.75,$1812.75,$98969.00,53,$1812.75
2024-03-14,23:00:00,18001.75,SELL,3,13.00h,Stop Loss,$-18.00,$1794.75,$98951.00,53,$1794.75
,,,,,,,,,,,
2024-03-15,12:02:00,18272.5,BUY,3,0.02h,Stop Loss,$-18.00,$-18.00,$98933.00,54,$-18.00
2024-03-15,12:03:00,18029.75,SELL,3,0.02h,Stop Loss,$-18.00,$-36.00,$98915.00,54,$-36.00
2024-03-15,12:04:00,18276.75,BUY,3,0.02h,Stop Loss,$-18.00,$-54.00,$98897.00,54,$-54.00
2024-03-15,12:17:00,18006.5,SELL,3,0.02h,Stop Loss,$-18.00,$-72.00,$98879.00,54,$-72.00
2024-03-15,12:22:00,18256.25,BUY,3,0.02h,Stop Loss,$-18.00,$-90.00,$98861.00,54,$-90.00
2024-03-15,12:23:00,18008.0,SELL,3,0.02h,Stop Loss,$-18.00,$-108.00,$98843.00,54,$-108.00
2024-03-15,12:24:00,18250.75,BUY,3,0.02h,Stop Loss,$15.75,$-92.25,$98858.75,54,$-92.25
2024-03-15,12:26:00,18009.0,SELL,3,0.02h,Stop Loss,$-18.00,$-110.25,$98840.75,54,$-110.25
2024-03-15,12:39:00,18259.0,BUY,3,0.02h,Break Even,$0.75,$-109.50,$98841.50,54,$-109.50
2024-03-15,12:45:00,18000.25,SELL,3,0.02h,Stop Loss,$154.50,$45.00,$98996.00,54,$45.00
2024-03-15,12:51:00,18251.25,BUY,3,0.02h,Stop Loss,$-18.00,$27.00,$98978.00,54,$27.00
2024-03-15,12:53:00,18004.75,SELL,3,0.02h,Stop Loss,$-18.00,$9.00,$98960.00,54,$9.00
2024-03-15,12:56:00,18258.25,BUY,3,0.02h,Stop Loss,$15.75,$24.75,$98975.75,54,$24.75
2024-03-15,13:02:00,17998.0,SELL,3,0.02h,Stop Loss,$34.50,$59.25,$99010.25,54,$59.25
2024-03-15,13:04:00,18240.75,BUY,3,0.02h,Stop Loss,$-18.00,$41.25,$98992.25,54,$41.25
2024-03-15,13:05:00,18000.0,SELL,3,0.02h,Stop Loss,$42.00,$83.25,$99034.25,54,$83.25
2024-03-15,13:07:00,18236.25,BUY,3,0.02h,Stop Loss,$-18.00,$65.25,$99016.25,54,$65.25
2024-03-15,13:08:00,17988.75,SELL,3,0.02h,Stop Loss,$-18.00,$47.25,$98998.25,54,$47.25
2024-03-15,13:09:00,18228.5,BUY,3,0.02h,Stop Loss,$64.50,$111.75,$99062.75,54,$111.75
2024-03-15,13:24:00,17952.0,SELL,3,0.02h,Stop Loss,$49.50,$161.25,$99112.25,54,$161.25
2024-03-15,13:34:00,18141.25,BUY,3,0.02h,Stop Loss,$293.25,$454.50,$99405.50,54,$454.50
2024-03-15,13:43:00,18099.25,SELL,3,0.02h,Stop Loss,$90.75,$545.25,$99496.25,54,$545.25
2024-03-15,13:56:00,18127.25,BUY,3,0.02h,Stop Loss,$-18.00,$527.25,$99478.25,54,$527.25
2024-03-15,13:57:00,18098.75,SELL,3,0.02h,Stop Loss,$79.50,$606.75,$99557.75,54,$606.75
2024-03-15,14:16:00,18110.75,BUY,3,0.02h,Break Even,$0.75,$607.50,$99558.50,54,$607.50
2024-03-15,14:59:00,18128.5,SELL,3,0.02h,Stop Loss,$79.50,$687.00,$99638.00,54,$687.00
2024-03-15,16:33:00,18067.75,BUY,3,0.02h,Stop Loss,$-18.00,$669.00,$99620.00,54,$669.00
2024-03-15,16:49:00,18045.0,SELL,3,0.02h,Stop Loss,$72.00,$741.00,$99692.00,54,$741.00
2024-03-15,17:11:00,18035.5,BUY,3,0.02h,Stop Loss,$165.75,$906.75,$99857.75,54,$906.75
2024-03-15,17:49:00,18044.0,SELL,3,0.02h,Stop Loss,$60.75,$967.50,$99918.50,54,$967.50
2024-03-15,17:55:00,18068.5,BUY,3,0.02h,Stop Loss,$132.00,$1099.50,$100050.50,54,$1099.50
2024-03-15,18:14:00,18059.75,SELL,3,0.02h,Stop Loss,$45.75,$1145.25,$100096.25,54,$1145.25
2024-03-15,18:34:00,18071.25,BUY,3,0.02h,Break Even,$0.75,$1146.00,$100097.00,54,$1146.00
2024-03-15,19:10:00,18071.75,SELL,3,0.02h,Stop Loss,$27.00,$1173.00,$100124.00,54,$1173.00
2024-03-15,19:27:00,18087.5,BUY,3,0.02h,Stop Loss,$109.50,$1282.50,$100233.50,54,$1282.50
2024-03-15,19:39:00,18068.75,SELL,3,0.02h,Break Even,$0.75,$1283.25,$100234.25,54,$1283.25
2024-03-15,20:05:00,18069.5,BUY,3,0.02h,Break Even,$0.75,$1284.00,$100235.00,54,$1284.00
2024-03-15,20:22:00,18066.25,SELL,3,0.02h,Stop Loss,$-18.00,$1266.00,$100217.00,54,$1266.00
2024-03-15,20:25:00,18073.75,BUY,3,0.03h,Stop Loss,$60.75,$1326.75,$100277.75,54,$1326.75
2024-03-15,20:38:00,18068.75,SELL,3,0.02h,Break Even,$0.75,$1327.50,$100278.50,54,$1327.50
,,,,,,,,,,,
2024-03-18,12:00:00,18262.75,BUY,3,0.02h,Stop Loss,$12.00,$12.00,$100290.50,55,$12.00
2024-03-18,12:54:00,18264.0,SELL,3,0.02h,Stop Loss,$-18.00,$-6.00,$100272.50,55,$-6.00
2024-03-18,12:58:00,18275.0,BUY,3,0.02h,Stop Loss,$-18.00,$-24.00,$100254.50,55,$-24.00
2024-03-18,13:24:00,18277.0,SELL,3,0.02h,Stop Loss,$-18.00,$-42.00,$100236.50,55,$-42.00
2024-03-18,13:31:00,18294.75,BUY,3,0.02h,Stop Loss,$263.25,$221.25,$100499.75,55,$221.25
2024-03-18,13:57:00,18314.25,SELL,3,0.02h,Stop Loss,$319.50,$540.75,$100819.25,55,$540.75
2024-03-18,14:09:00,18333.25,BUY,3,0.02h,Break Even,$0.75,$541.50,$100820.00,55,$541.50
2024-03-18,14:52:00,18353.75,SELL,3,0.02h,Break Even,$0.75,$542.25,$100820.75,55,$542.25
2024-03-18,16:11:00,18301.75,BUY,3,0.02h,Break Even,$0.75,$543.00,$100821.50,55,$543.00
2024-03-18,16:27:00,18291.5,SELL,3,0.02h,Break Even,$0.75,$543.75,$100822.25,55,$543.75
2024-03-18,16:45:00,18298.5,BUY,3,0.02h,Stop Loss,$-18.00,$525.75,$100804.25,55,$525.75
2024-03-18,16:50:00,18282.5,SELL,3,0.02h,Stop Loss,$312.00,$837.75,$101116.25,55,$837.75
2024-03-18,17:22:00,18274.0,BUY,3,0.02h,Break Even,$0.75,$838.50,$101117.00,55,$838.50
2024-03-18,17:39:00,18254.25,SELL,3,0.02h,Stop Loss,$34.50,$873.00,$101151.50,55,$873.00
2024-03-18,17:59:00,18274.0,BUY,3,0.02h,Break Even,$0.75,$873.75,$101152.25,55,$873.75
2024-03-18,18:42:00,18278.5,SELL,3,0.02h,Stop Loss,$312.00,$1185.75,$101464.25,55,$1185.75
2024-03-18,19:08:00,18289.5,BUY,3,0.02h,Stop Loss,$64.50,$1250.25,$101528.75,55,$1250.25
2024-03-18,19:26:00,18280.0,SELL,3,0.02h,Break Even,$0.75,$1251.00,$101529.50,55,$1251.00
2024-03-18,19:35:00,18286.75,BUY,3,0.02h,Stop Loss,$-18.00,$1233.00,$101511.50,55,$1233.00
2024-03-18,19:37:00,18277.75,SELL,3,0.02h,Stop Loss,$23.25,$1256.25,$101534.75,55,$1256.25
2024-03-18,20:29:00,18232.5,BUY,3,0.02h,Stop Loss,$113.25,$1369.50,$101648.00,55,$1369.50
2024-03-18,20:40:00,18226.0,SELL,3,0.02h,Break Even,$0.75,$1370.25,$101648.75,55,$1370.25
,,,,,,,,,,,
2024-03-19,12:38:00,18114.0,BUY,3,0.02h,Stop Loss,$-18.00,$-18.00,$101630.75,56,$-18.00
2024-03-19,13:32:00,18116.5,SELL,3,0.02h,Break Even,$0.75,$-17.25,$101631.50,56,$-17.25
2024-03-19,14:01:00,18099.0,BUY,3,0.02h,Stop Loss,$102.00,$84.75,$101733.50,56,$84.75
2024-03-19,14:18:00,18093.0,SELL,3,0.02h,Stop Loss,$98.25,$183.00,$101831.75,56,$183.00
2024-03-19,14:36:00,18105.75,BUY,3,0.02h,Break Even,$0.75,$183.75,$101832.50,56,$183.75
2024-03-19,15:04:00,18117.0,SELL,3,0.02h,Stop Loss,$-18.00,$165.75,$101814.50,56,$165.75
2024-03-19,15:05:00,18129.0,BUY,3,0.02h,Stop Loss,$143.25,$309.00,$101957.75,56,$309.00
2024-03-19,15:21:00,18118.0,SELL,3,0.02h,Break Even,$0.75,$309.75,$101958.50,56,$309.75
2024-03-19,15:30:00,18131.25,BUY,3,0.02h,Stop Loss,$105.75,$415.50,$102064.25,56,$415.50
2024-03-19,15:55:00,18135.75,SELL,3,0.02h,Break Even,$0.75,$416.25,$102065.00,56,$416.25
2024-03-19,16:00:00,18158.75,BUY,3,0.02h,Break Even,$0.75,$417.00,$102065.75,56,$417.00
2024-03-19,17:16:00,18235.5,SELL,3,0.02h,Break Even,$0.75,$417.75,$102066.50,56,$417.75
2024-03-19,17:28:00,18254.75,BUY,3,0.02h,Break Even,$0.75,$418.50,$102067.25,56,$418.50
2024-03-19,17:55:00,18253.25,SELL,3,0.02h,Stop Loss,$19.50,$438.00,$102086.75,56,$438.00
2024-03-19,18:16:00,18271.0,BUY,3,0.02h,Stop Loss,$53.25,$491.25,$102140.00,56,$491.25
2024-03-19,18:56:00,18255.5,SELL,3,0.02h,Stop Loss,$-18.00,$473.25,$102122.00,56,$473.25
2024-03-19,19:38:00,18241.0,BUY,3,0.02h,Stop Loss,$42.00,$515.25,$102164.00,56,$515.25
2024-03-19,20:21:00,18269.25,SELL,3,0.02h,Break Even,$0.75,$516.00,$102164.75,56,$516.00
2024-03-19,20:35:00,18272.25,BUY,3,0.02h,Break Even,$0.75,$516.75,$102165.50,56,$516.75
2024-03-19,20:56:00,18274.0,SELL,3,0.02h,Break Even,$0.75,$517.50,$102166.25,56,$517.50
2024-03-19,22:22:00,18275.25,BUY,3,0.02h,Stop Loss,$-18.00,$499.50,$102148.25,56,$499.50
2024-03-19,22:32:00,18269.25,SELL,3,0.02h,Stop Loss,$-18.00,$481.50,$102130.25,56,$481.50
2024-03-19,22:47:00,18275.5,BUY,3,0.02h,Stop Loss,$-18.00,$463.50,$102112.25,56,$463.50
,,,,,,,,,,,
2024-03-20,12:19:00,18297.5,SELL,3,0.02h,Break Even,$0.75,$0.75,$102113.00,57,$0.75
2024-03-20,12:29:00,18310.75,BUY,3,0.02h,Stop Loss,$-18.00,$-17.25,$102095.00,57,$-17.25
2024-03-20,12:41:00,18295.5,SELL,3,0.02h,Stop Loss,$139.50,$122.25,$102234.50,57,$122.25
2024-03-20,13:10:00,18302.5,BUY,3,0.02h,Stop Loss,$-18.00,$104.25,$102216.50,57,$104.25
2024-03-20,13:12:00,18293.75,SELL,3,0.02h,Break Even,$0.75,$105.00,$102217.25,57,$105.00
2024-03-20,13:19:00,18302.25,BUY,3,0.02h,Stop Loss,$19.50,$124.50,$102236.75,57,$124.50
2024-03-20,13:38:00,18280.5,SELL,3,0.02h,Break Even,$0.75,$125.25,$102237.50,57,$125.25
2024-03-20,14:24:00,18278.5,BUY,3,0.02h,Stop Loss,$75.75,$201.00,$102313.25,57,$201.00
2024-03-20,14:38:00,18265.0,SELL,3,0.02h,Break Even,$0.75,$201.75,$102314.00,57,$201.75
2024-03-20,15:03:00,18270.75,BUY,3,0.02h,Stop Loss,$19.50,$221.25,$102333.50,57,$221.25
2024-03-20,15:35:00,18278.5,SELL,3,0.02h,Stop Loss,$-18.00,$203.25,$102315.50,57,$203.25
2024-03-20,15:56:00,18279.75,BUY,3,0.02h,Stop Loss,$27.00,$230.25,$102342.50,57,$230.25
2024-03-20,16:09:00,18268.0,SELL,3,0.02h,Break Even,$0.75,$231.00,$102343.25,57,$231.00
2024-03-20,16:26:00,18275.25,BUY,3,0.02h,Stop Loss,$57.00,$288.00,$102400.25,57,$288.00
2024-03-20,16:34:00,18262.75,SELL,3,0.02h,Stop Loss,$-18.00,$270.00,$102382.25,57,$270.00
2024-03-20,16:38:00,18273.75,BUY,3,0.02h,Stop Loss,$49.50,$319.50,$102431.75,57,$319.50
2024-03-20,17:10:00,18277.25,SELL,3,0.02h,Break Even,$0.75,$320.25,$102432.50,57,$320.25
2024-03-20,17:52:00,18269.25,BUY,3,0.02h,Stop Loss,$-18.00,$302.25,$102414.50,57,$302.25
2024-03-20,18:35:00,18297.75,SELL,3,0.02h,Stop Loss,$120.75,$423.00,$102535.25,57,$423.00
2024-03-20,18:40:00,18366.5,BUY,3,0.02h,Stop Loss,$120.75,$543.75,$102656.00,57,$543.75
2024-03-20,19:44:00,18458.75,SELL,3,0.02h,Stop Loss,$102.00,$645.75,$102758.00,57,$645.75
2024-03-20,19:58:00,18474.25,BUY,3,0.02h,Stop Loss,$45.75,$691.50,$102803.75,57,$691.50
2024-03-20,22:01:00,18532.0,SELL,3,0.02h,Stop Loss,$30.75,$722.25,$102834.50,57,$722.25
2024-03-20,22:08:00,18543.25,BUY,3,0.02h,Break Even,$0.75,$723.00,$102835.25,57,$723.00
2024-03-20,22:25:00,18536.75,SELL,3,0.02h,Stop Loss,$-18.00,$705.00,$102817.25,57,$705.00
2024-03-20,22:38:00,18545.75,BUY,3,0.02h,Stop Loss,$-18.00,$687.00,$102799.25,57,$687.00
,,,,,,,,,,,
2024-03-21,12:39:00,18647.25,SELL,3,0.02h,Stop Loss,$-18.00,$-18.00,$102781.25,58,$-18.00
2024-03-21,12:41:00,18657.0,BUY,3,0.02h,Break Even,$0.75,$-17.25,$102782.00,58,$-17.25
2024-03-21,12:45:00,18651.25,SELL,3,0.02h,Stop Loss,$-18.00,$-35.25,$102764.00,58,$-35.25
2024-03-21,12:49:00,18654.75,BUY,3,0.02h,Stop Loss,$27.00,$-8.25,$102791.00,58,$-8.25
2024-03-21,13:05:00,18653.25,SELL,3,0.02h,Stop Loss,$-18.00,$-26.25,$102773.00,58,$-26.25
2024-03-21,13:20:00,18657.0,BUY,3,0.02h,Break Even,$0.75,$-25.50,$102773.75,58,$-25.50
2024-03-21,13:49:00,18644.75,SELL,3,0.02h,Stop Loss,$57.00,$31.50,$102830.75,58,$31.50
2024-03-21,14:11:00,18653.75,BUY,3,0.02h,Stop Loss,$12.00,$43.50,$102842.75,58,$43.50
2024-03-21,14:18:00,18643.75,SELL,3,0.02h,Break Even,$0.75,$44.25,$102843.50,58,$44.25
2024-03-21,14:20:00,18661.75,BUY,3,0.02h,Stop Loss,$38.25,$82.50,$102881.75,58,$82.50
2024-03-21,14:32:00,18637.5,SELL,3,0.02h,Stop Loss,$79.50,$162.00,$102961.25,58,$162.00
2024-03-21,14:49:00,18664.5,BUY,3,0.02h,Stop Loss,$23.25,$185.25,$102984.50,58,$185.25
2024-03-21,15:00:00,18643.5,SELL,3,0.02h,Stop Loss,$-18.00,$167.25,$102966.50,58,$167.25
2024-03-21,15:02:00,18661.75,BUY,3,0.02h,Break Even,$0.75,$168.00,$102967.25,58,$168.00
2024-03-21,15:04:00,18641.0,SELL,3,0.02h,Stop Loss,$23.25,$191.25,$102990.50,58,$191.25
2024-03-21,15:22:00,18648.75,BUY,3,0.02h,Stop Loss,$83.25,$274.50,$103073.75,58,$274.50
2024-03-21,16:38:00,18688.5,SELL,3,0.02h,Break Even,$0.75,$275.25,$103074.50,58,$275.25
2024-03-21,16:57:00,18695.0,BUY,3,0.02h,Stop Loss,$-18.00,$257.25,$103056.50,58,$257.25
2024-03-21,17:00:00,18689.0,SELL,3,0.02h,Stop Loss,$12.00,$269.25,$103068.50,58,$269.25
2024-03-21,18:27:00,18616.0,BUY,3,0.02h,Break Even,$0.75,$270.00,$103069.25,58,$270.00
2024-03-21,18:35:00,18594.5,SELL,3,0.02h,Stop Loss,$285.75,$555.75,$103355.00,58,$555.75
2024-03-21,19:11:00,18585.0,BUY,3,0.02h,Stop Loss,$30.75,$586.50,$103385.75,58,$586.50
2024-03-21,19:27:00,18579.25,SELL,3,0.02h,Stop Loss,$19.50,$606.00,$103405.25,58,$606.00
2024-03-21,19:30:00,18586.5,BUY,3,0.02h,Stop Loss,$83.25,$689.25,$103488.50,58,$689.25
2024-03-21,19:35:00,18578.5,SELL,3,0.02h,Stop Loss,$60.75,$750.00,$103549.25,58,$750.00
2024-03-21,19:45:00,18590.5,BUY,3,0.02h,Break Even,$0.75,$750.75,$103550.00,58,$750.75
2024-03-21,19:48:00,18578.75,SELL,3,0.02h,Stop Loss,$113.25,$864.00,$103663.25,58,$864.00
2024-03-21,20:14:00,18576.5,BUY,3,0.02h,Stop Loss,$-18.00,$846.00,$103645.25,58,$846.00
2024-03-21,20:37:00,18575.25,SELL,3,0.02h,Break Even,$0.75,$846.75,$103646.00,58,$846.75
2024-03-21,20:58:00,18580.25,BUY,3,0.02h,Stop Loss,$-18.00,$828.75,$103628.00,58,$828.75
2024-03-21,22:10:00,18570.0,SELL,3,0.02h,Stop Loss,$-18.00,$810.75,$103610.00,58,$810.75
2024-03-21,22:34:00,18579.25,BUY,3,0.03h,Break Even,$0.75,$811.50,$103610.75,58,$811.50
,,,,,,,,,,,
2024-03-22,12:00:00,18510.5,SELL,3,0.02h,Break Even,$0.75,$0.75,$103611.50,59,$0.75
2024-03-22,12:44:00,18519.5,BUY,3,0.02h,Stop Loss,$23.25,$24.00,$103634.75,59,$24.00
2024-03-22,13:23:00,18525.0,SELL,3,0.02h,Stop Loss,$-18.00,$6.00,$103616.75,59,$6.00
2024-03-22,13:32:00,18544.0,BUY,3,0.02h,Stop Loss,$-18.00,$-12.00,$103598.75,59,$-12.00
2024-03-22,13:33:00,18528.0,SELL,3,0.02h,Stop Loss,$117.00,$105.00,$103715.75,59,$105.00
2024-03-22,13:55:00,18538.0,BUY,3,0.02h,Stop Loss,$30.75,$135.75,$103746.50,59,$135.75
2024-03-22,14:16:00,18529.25,SELL,3,0.02h,Stop Loss,$-18.00,$117.75,$103728.50,59,$117.75
2024-03-22,14:21:00,18544.5,BUY,3,0.02h,Stop Loss,$-18.00,$99.75,$103710.50,59,$99.75
2024-03-22,14:23:00,18525.75,SELL,3,0.02h,Stop Loss,$30.75,$130.50,$103741.25,59,$130.50
2024-03-22,15:03:00,18532.0,BUY,3,0.02h,Stop Loss,$57.00,$187.50,$103798.25,59,$187.50
2024-03-22,15:43:00,18543.25,SELL,3,0.02h,Stop Loss,$-18.00,$169.50,$103780.25,59,$169.50
2024-03-22,15:51:00,18553.5,BUY,3,0.02h,Break Even,$0.75,$170.25,$103781.00,59,$170.25
2024-03-22,16:09:00,18546.0,SELL,3,0.02h,Stop Loss,$-18.00,$152.25,$103763.00,59,$152.25
2024-03-22,16:12:00,18555.5,BUY,3,0.02h,Stop Loss,$-18.00,$134.25,$103745.00,59,$134.25
2024-03-22,16:13:00,18549.75,SELL,3,0.02h,Stop Loss,$30.75,$165.00,$103775.75,59,$165.00
2024-03-22,16:27:00,18553.0,BUY,3,0.02h,Stop Loss,$-18.00,$147.00,$103757.75,59,$147.00
2024-03-22,16:35:00,18536.0,SELL,3,0.02h,Break Even,$0.75,$147.75,$103758.50,59,$147.75
2024-03-22,16:44:00,18553.0,BUY,3,0.02h,Break Even,$0.75,$148.50,$103759.25,59,$148.50
2024-03-22,17:42:00,18591.5,SELL,3,0.02h,Stop Loss,$-18.00,$130.50,$103741.25,59,$130.50
2024-03-22,17:45:00,18602.75,BUY,3,0.02h,Break Even,$0.75,$131.25,$103742.00,59,$131.25
2024-03-22,18:12:00,18612.0,SELL,3,0.02h,Stop Loss,$-18.00,$113.25,$103724.00,59,$113.25
2024-03-22,18:30:00,18609.5,BUY,3,0.02h,Break Even,$0.75,$114.00,$103724.75,59,$114.00
2024-03-22,18:34:00,18599.0,SELL,3,0.02h,Stop Loss,$-18.00,$96.00,$103706.75,59,$96.00
2024-03-22,18:35:00,18606.75,BUY,3,0.02h,Break Even,$0.75,$96.75,$103707.50,59,$96.75
2024-03-22,18:42:00,18597.75,SELL,3,0.02h,Stop Loss,$-18.00,$78.75,$103689.50,59,$78.75
2024-03-22,19:37:00,18580.5,BUY,3,0.02h,Break Even,$0.75,$79.50,$103690.25,59,$79.50
2024-03-22,20:01:00,18569.25,SELL,3,0.02h,Stop Loss,$27.00,$106.50,$103717.25,59,$106.50
2024-03-22,20:48:00,18562.75,BUY,3,0.03h,Break Even,$0.75,$107.25,$103718.00,59,$107.25
,,,,,,,,,,,
2024-03-25,12:00:00,18470.25,SELL,3,0.02h,Stop Loss,$68.25,$68.25,$103786.25,60,$68.25
2024-03-25,12:48:00,18482.5,BUY,3,0.02h,Break Even,$0.75,$69.00,$103787.00,60,$69.00
2024-03-25,12:55:00,18479.0,SELL,3,0.02h,Break Even,$0.75,$69.75,$103787.75,60,$69.75
2024-03-25,13:18:00,18477.75,BUY,3,0.02h,Break Even,$0.75,$70.50,$103788.50,60,$70.50
2024-03-25,13:22:00,18474.0,SELL,3,0.02h,Stop Loss,$53.25,$123.75,$103841.75,60,$123.75
2024-03-25,13:52:00,18480.25,BUY,3,0.02h,Stop Loss,$19.50,$143.25,$103861.25,60,$143.25
2024-03-25,14:47:00,18511.25,SELL,3,0.02h,Stop Loss,$64.50,$207.75,$103925.75,60,$207.75
2024-03-25,14:59:00,18519.75,BUY,3,0.02h,Break Even,$0.75,$208.50,$103926.50,60,$208.50
2024-03-25,15:26:00,18520.0,SELL,3,0.02h,Stop Loss,$34.50,$243.00,$103961.00,60,$243.00
2024-03-25,15:38:00,18531.0,BUY,3,0.02h,Stop Loss,$30.75,$273.75,$103991.75,60,$273.75
2024-03-25,16:03:00,18530.75,SELL,3,0.02h,Stop Loss,$72.00,$345.75,$104063.75,60,$345.75
2024-03-25,16:22:00,18533.5,BUY,3,0.02h,Stop Loss,$-18.00,$327.75,$104045.75,60,$327.75
2024-03-25,16:23:00,18527.25,SELL,3,0.02h,Break Even,$0.75,$328.50,$104046.50,60,$328.50
2024-03-25,16:47:00,18528.25,BUY,3,0.02h,Break Even,$0.75,$329.25,$104047.25,60,$329.25
2024-03-25,16:51:00,18519.5,SELL,3,0.02h,Break Even,$0.75,$330.00,$104048.00,60,$330.00
2024-03-25,16:52:00,18526.0,BUY,3,0.02h,Stop Loss,$34.50,$364.50,$104082.50,60,$364.50
2024-03-25,17:09:00,18524.75,SELL,3,0.02h,Stop Loss,$-18.00,$346.50,$104064.50,60,$346.50
2024-03-25,17:15:00,18534.0,BUY,3,0.02h,Break Even,$0.75,$347.25,$104065.25,60,$347.25
2024-03-25,18:30:00,18558.75,SELL,3,0.02h,Break Even,$0.75,$348.00,$104066.00,60,$348.00
2024-03-25,18:41:00,18560.25,BUY,3,0.02h,Break Even,$0.75,$348.75,$104066.75,60,$348.75
2024-03-25,19:04:00,18558.0,SELL,3,0.02h,Stop Loss,$12.00,$360.75,$104078.75,60,$360.75
2024-03-25,19:41:00,18544.25,BUY,3,0.02h,Stop Loss,$42.00,$402.75,$104120.75,60,$402.75
2024-03-25,19:52:00,18531.25,SELL,3,0.02h,Stop Loss,$49.50,$452.25,$104170.25,60,$452.25
2024-03-25,20:25:00,18520.25,BUY,3,0.05h,Stop Loss,$-18.00,$434.25,$104152.25,60,$434.25
2024-03-25,22:33:00,18535.0,SELL,3,0.02h,Break Even,$0.75,$435.00,$104153.00,60,$435.00
,,,,,,,,,,,
2024-03-26,12:00:00,18614.0,BUY,3,0.02h,Break Even,$0.75,$0.75,$104153.75,61,$0.75
2024-03-26,12:35:00,18588.25,SELL,3,0.02h,Stop Loss,$102.00,$102.75,$104255.75,61,$102.75
2024-03-26,13:29:00,18569.25,BUY,3,0.02h,Break Even,$0.75,$103.50,$104256.50,61,$103.50
2024-03-26,14:25:00,18587.75,SELL,3,0.02h,Stop Loss,$94.50,$198.00,$104351.00,61,$198.00
2024-03-26,14:59:00,18558.5,BUY,3,0.02h,Stop Loss,$49.50,$247.50,$104400.50,61,$247.50
2024-03-26,15:41:00,18560.5,SELL,3,0.02h,Stop Loss,$-18.00,$229.50,$104382.50,61,$229.50
2024-03-26,15:53:00,18576.5,BUY,3,0.02h,Stop Loss,$-18.00,$211.50,$104364.50,61,$211.50
2024-03-26,16:14:00,18572.5,SELL,3,0.02h,Break Even,$0.75,$212.25,$104365.25,61,$212.25
2024-03-26,17:09:00,18549.75,BUY,3,0.02h,Break Even,$0.75,$213.00,$104366.00,61,$213.00
2024-03-26,17:21:00,18545.25,SELL,3,0.02h,Break Even,$0.75,$213.75,$104366.75,61,$213.75
2024-03-26,17:31:00,18552.25,BUY,3,0.02h,Break Even,$0.75,$214.50,$104367.50,61,$214.50
2024-03-26,17:45:00,18541.25,SELL,3,0.02h,Stop Loss,$105.75,$320.25,$104473.25,61,$320.25
2024-03-26,18:03:00,18548.0,BUY,3,0.02h,Stop Loss,$-18.00,$302.25,$104455.25,61,$302.25
2024-03-26,18:42:00,18548.25,SELL,3,0.02h,Stop Loss,$38.25,$340.50,$104493.50,61,$340.50
2024-03-26,18:57:00,18556.25,BUY,3,0.02h,Break Even,$0.75,$341.25,$104494.25,61,$341.25
2024-03-26,19:04:00,18546.25,SELL,3,0.02h,Break Even,$0.75,$342.00,$104495.00,61,$342.00
2024-03-26,20:14:00,18470.5,BUY,3,0.02h,Break Even,$0.75,$342.75,$104495.75,61,$342.75
2024-03-26,20:53:00,18477.25,SELL,3,0.02h,Break Even,$0.75,$343.50,$104496.50,61,$343.50
2024-03-26,20:57:00,18481.75,BUY,3,0.02h,Stop Loss,$-18.00,$325.50,$104478.50,61,$325.50
2024-03-26,22:01:00,18474.75,SELL,3,0.02h,Break Even,$0.75,$326.25,$104479.25,61,$326.25
2024-03-26,22:19:00,18477.5,BUY,3,0.02h,Stop Loss,$-18.00,$308.25,$104461.25,61,$308.25
2024-03-26,22:21:00,18476.5,SELL,3,0.02h,Break Even,$0.75,$309.00,$104462.00,61,$309.00
2024-03-26,22:53:00,18476.5,BUY,3,0.02h,Break Even,$0.75,$309.75,$104462.75,61,$309.75
,,,,,,,,,,,
2024-03-27,13:33:00,18536.25,SELL,3,0.02h,Stop Loss,$192.00,$192.00,$104654.75,62,$192.00
2024-03-27,14:35:00,18432.25,BUY,3,0.02h,Stop Loss,$-18.00,$174.00,$104636.75,62,$174.00
2024-03-27,14:49:00,18422.0,SELL,3,0.02h,Stop Loss,$225.75,$399.75,$104862.50,62,$399.75
2024-03-27,15:18:00,18428.0,BUY,3,0.02h,Break Even,$0.75,$400.50,$104863.25,62,$400.50
2024-03-27,15:25:00,18411.5,SELL,3,0.02h,Stop Loss,$12.00,$412.50,$104875.25,62,$412.50
2024-03-27,15:42:00,18421.0,BUY,3,0.02h,Stop Loss,$15.75,$428.25,$104891.00,62,$428.25
2024-03-27,15:54:00,18410.0,SELL,3,0.02h,Stop Loss,$12.00,$440.25,$104903.00,62,$440.25
2024-03-27,16:07:00,18418.75,BUY,3,0.02h,Break Even,$0.75,$441.00,$104903.75,62,$441.00
2024-03-27,16:13:00,18404.75,SELL,3,0.02h,Stop Loss,$-18.00,$423.00,$104885.75,62,$423.00
2024-03-27,16:18:00,18417.0,BUY,3,0.02h,Stop Loss,$49.50,$472.50,$104935.25,62,$472.50
2024-03-27,17:05:00,18433.25,SELL,3,0.02h,Stop Loss,$45.75,$518.25,$104981.00,62,$518.25
2024-03-27,17:22:00,18432.0,BUY,3,0.02h,Stop Loss,$60.75,$579.00,$105041.75,62,$579.00
2024-03-27,17:29:00,18422.5,SELL,3,0.02h,Stop Loss,$-18.00,$561.00,$105023.75,62,$561.00
2024-03-27,17:32:00,18433.25,BUY,3,0.02h,Break Even,$0.75,$561.75,$105024.50,62,$561.75
2024-03-27,17:36:00,18423.75,SELL,3,0.02h,Stop Loss,$-18.00,$543.75,$105006.50,62,$543.75
2024-03-27,17:38:00,18430.75,BUY,3,0.02h,Break Even,$0.75,$544.50,$105007.25,62,$544.50
2024-03-27,17:40:00,18424.75,SELL,3,0.02h,Break Even,$0.75,$545.25,$105008.00,62,$545.25
2024-03-27,17:46:00,18431.25,BUY,3,0.02h,Break Even,$0.75,$546.00,$105008.75,62,$546.00
2024-03-27,18:01:00,18428.0,SELL,3,0.02h,Stop Loss,$-18.00,$528.00,$104990.75,62,$528.00
2024-03-27,18:02:00,18434.25,BUY,3,0.02h,Stop Loss,$-18.00,$510.00,$104972.75,62,$510.00
2024-03-27,18:03:00,18427.25,SELL,3,0.02h,Break Even,$0.75,$510.75,$104973.50,62,$510.75
2024-03-27,18:17:00,18435.5,BUY,3,0.02h,Stop Loss,$94.50,$605.25,$105068.00,62,$605.25
2024-03-27,18:38:00,18434.75,SELL,3,0.02h,Break Even,$0.75,$606.00,$105068.75,62,$606.00
2024-03-27,19:08:00,18431.5,BUY,3,0.02h,Break Even,$0.75,$606.75,$105069.50,62,$606.75
2024-03-27,19:10:00,18420.75,SELL,3,0.02h,Stop Loss,$184.50,$791.25,$105254.00,62,$791.25
2024-03-27,19:28:00,18424.75,BUY,3,0.02h,Stop Loss,$244.50,$1035.75,$105498.50,62,$1035.75
2024-03-27,20:37:00,18513.0,SELL,3,0.07h,Break Even,$0.75,$1036.50,$105499.25,62,$1036.50
2024-03-27,22:34:00,18491.0,BUY,3,0.02h,Stop Loss,$-18.00,$1018.50,$105481.25,62,$1018.50
2024-03-27,22:39:00,18485.75,SELL,3,0.02h,Break Even,$0.75,$1019.25,$105482.00,62,$1019.25
,,,,,,,,,,,
2024-03-28,12:01:00,18493.75,BUY,3,0.02h,Stop Loss,$27.00,$27.00,$105509.00,63,$27.00
2024-03-28,12:37:00,18485.0,SELL,3,0.02h,Stop Loss,$-18.00,$9.00,$105491.00,63,$9.00
2024-03-28,12:58:00,18499.25,BUY,3,0.02h,Break Even,$0.75,$9.75,$105491.75,63,$9.75
2024-03-28,13:30:00,18500.0,SELL,3,0.02h,Stop Loss,$244.50,$254.25,$105736.25,63,$254.25
2024-03-28,13:42:00,18501.75,BUY,3,0.02h,Stop Loss,$60.75,$315.00,$105797.00,63,$315.00
2024-03-28,14:09:00,18505.0,SELL,3,0.02h,Stop Loss,$49.50,$364.50,$105846.50,63,$364.50
2024-03-28,14:36:00,18506.25,BUY,3,0.02h,Stop Loss,$83.25,$447.75,$105929.75,63,$447.75
2024-03-28,15:04:00,18498.75,SELL,3,0.02h,Stop Loss,$-18.00,$429.75,$105911.75,63,$429.75
2024-03-28,15:06:00,18514.0,BUY,3,0.02h,Break Even,$0.75,$430.50,$105912.50,63,$430.50
2024-03-28,15:08:00,18494.25,SELL,3,0.02h,Stop Loss,$12.00,$442.50,$105924.50,63,$442.50
2024-03-28,15:19:00,18503.25,BUY,3,0.02h,Stop Loss,$45.75,$488.25,$105970.25,63,$488.25
2024-03-28,15:37:00,18500.25,SELL,3,0.02h,Stop Loss,$-18.00,$470.25,$105952.25,63,$470.25
2024-03-28,15:51:00,18508.0,BUY,3,0.02h,Stop Loss,$12.00,$482.25,$105964.25,63,$482.25
2024-03-28,16:06:00,18496.75,SELL,3,0.02h,Stop Loss,$203.25,$685.50,$106167.50,63,$685.50
2024-03-28,17:39:00,18470.75,BUY,3,0.02h,Stop Loss,$12.00,$697.50,$106179.50,63,$697.50
2024-03-28,18:01:00,18467.0,SELL,3,0.02h,Stop Loss,$240.75,$938.25,$106420.25,63,$938.25
2024-03-28,18:09:00,18474.0,BUY,3,0.02h,Stop Loss,$-18.00,$920.25,$106402.25,63,$920.25
2024-03-28,18:24:00,18467.5,SELL,3,0.02h,Break Even,$0.75,$921.00,$106403.00,63,$921.00
2024-03-28,18:29:00,18472.75,BUY,3,0.02h,Break Even,$0.75,$921.75,$106403.75,63,$921.75
2024-03-28,18:38:00,18468.0,SELL,3,0.02h,Break Even,$0.75,$922.50,$106404.50,63,$922.50
2024-03-28,18:51:00,18471.25,BUY,3,0.02h,Break Even,$0.75,$923.25,$106405.25,63,$923.25
2024-03-28,19:37:00,18494.5,SELL,3,0.02h,Stop Loss,$42.00,$965.25,$106447.25,63,$965.25
2024-03-28,20:58:00,18461.25,BUY,3,0.02h,Break Even,$0.75,$966.00,$106448.00,63,$966.00
,,,,,,,,,,,
2024-04-01,12:34:00,18503.25,SELL,3,0.02h,Stop Loss,$109.50,$109.50,$106557.50,64,$109.50
2024-04-01,12:38:00,18509.0,BUY,3,0.02h,Stop Loss,$-18.00,$91.50,$106539.50,64,$91.50
2024-04-01,13:02:00,18506.25,SELL,3,0.02h,Stop Loss,$-18.00,$73.50,$106521.50,64,$73.50
2024-04-01,13:33:00,18515.5,BUY,3,0.02h,Stop Loss,$312.00,$385.50,$106833.50,64,$385.50
2024-04-01,14:05:00,18550.75,SELL,3,0.02h,Stop Loss,$15.75,$401.25,$106849.25,64,$401.25
2024-04-01,14:14:00,18584.75,BUY,3,0.02h,Break Even,$0.75,$402.00,$106850.00,64,$402.00
2024-04-01,14:17:00,18574.5,SELL,3,0.02h,Stop Loss,$102.00,$504.00,$106952.00,64,$504.00
2024-04-01,15:30:00,18470.75,BUY,3,0.02h,Stop Loss,$-18.00,$486.00,$106934.00,64,$486.00
2024-04-01,15:40:00,18453.5,SELL,3,0.02h,Break Even,$0.75,$486.75,$106934.75,64,$486.75
2024-04-01,15:50:00,18468.5,BUY,3,0.02h,Stop Loss,$-18.00,$468.75,$106916.75,64,$468.75
2024-04-01,15:52:00,18448.5,SELL,3,0.02h,Stop Loss,$75.75,$544.50,$106992.50,64,$544.50
2024-04-01,16:07:00,18455.25,BUY,3,0.02h,Stop Loss,$57.00,$601.50,$107049.50,64,$601.50
2024-04-01,16:58:00,18478.0,SELL,3,0.02h,Stop Loss,$42.00,$643.50,$107091.50,64,$643.50
2024-04-01,17:39:00,18452.5,BUY,3,0.02h,Stop Loss,$-18.00,$625.50,$107073.50,64,$625.50
2024-04-01,18:13:00,18454.0,SELL,3,0.02h,Break Even,$0.75,$626.25,$107074.25,64,$626.25
2024-04-01,18:19:00,18463.0,BUY,3,0.02h,Break Even,$0.75,$627.00,$107075.00,64,$627.00
2024-04-01,18:58:00,18468.5,SELL,3,0.02h,Stop Loss,$38.25,$665.25,$107113.25,64,$665.25
2024-04-01,19:07:00,18482.5,BUY,3,0.02h,Break Even,$0.75,$666.00,$107114.00,64,$666.00
2024-04-01,19:27:00,18468.25,SELL,3,0.02h,Break Even,$0.75,$666.75,$107114.75,64,$666.75
2024-04-01,19:34:00,18479.0,BUY,3,0.02h,Break Even,$0.75,$667.50,$107115.50,64,$667.50
2024-04-01,19:36:00,18464.75,SELL,3,0.02h,Stop Loss,$57.00,$724.50,$107172.50,64,$724.50
2024-04-01,19:44:00,18478.5,BUY,3,0.02h,Break Even,$0.75,$725.25,$107173.25,64,$725.25
2024-04-01,20:28:00,18494.75,SELL,3,0.02h,Stop Loss,$-18.00,$707.25,$107155.25,64,$707.25
2024-04-01,20:39:00,18496.75,BUY,3,0.02h,Stop Loss,$-18.00,$689.25,$107137.25,64,$689.25
2024-04-01,22:01:00,18491.5,SELL,3,0.02h,Stop Loss,$64.50,$753.75,$107201.75,64,$753.75
2024-04-01,22:44:00,18483.0,BUY,3,0.02h,Stop Loss,$-18.00,$735.75,$107183.75,64,$735.75
2024-04-01,22:53:00,18478.5,SELL,3,0.02h,Stop Loss,$-18.00,$717.75,$107165.75,64,$717.75
,,,,,,,,,,,
2024-04-02,12:33:00,18410.0,BUY,3,0.02h,Stop Loss,$-18.00,$-18.00,$107147.75,65,$-18.00
2024-04-02,12:34:00,18400.75,SELL,3,0.02h,Stop Loss,$27.00,$9.00,$107174.75,65,$9.00
2024-04-02,14:04:00,18266.0,BUY,3,0.02h,Stop Loss,$98.25,$107.25,$107273.00,65,$107.25
2024-04-02,14:09:00,18243.75,SELL,3,0.02h,Stop Loss,$19.50,$126.75,$107292.50,65,$126.75
2024-04-02,14:26:00,18245.5,BUY,3,0.02h,Break Even,$0.75,$127.50,$107293.25,65,$127.50
2024-04-02,14:49:00,18225.5,SELL,3,0.02h,Stop Loss,$60.75,$188.25,$107354.00,65,$188.25
2024-04-02,15:09:00,18233.75,BUY,3,0.02h,Stop Loss,$12.00,$200.25,$107366.00,65,$200.25
2024-04-02,15:46:00,18258.75,SELL,3,0.02h,Stop Loss,$34.50,$234.75,$107400.50,65,$234.75
2024-04-02,16:25:00,18241.75,BUY,3,0.02h,Break Even,$0.75,$235.50,$107401.25,65,$235.50
2024-04-02,17:18:00,18277.25,SELL,3,0.02h,Stop Loss,$-18.00,$217.50,$107383.25,65,$217.50
2024-04-02,17:47:00,18283.5,BUY,3,0.02h,Break Even,$0.75,$218.25,$107384.00,65,$218.25
2024-04-02,18:00:00,18277.5,SELL,3,0.02h,Stop Loss,$-18.00,$200.25,$107366.00,65,$200.25
2024-04-02,18:09:00,18288.75,BUY,3,0.02h,Break Even,$0.75,$201.00,$107366.75,65,$201.00
2024-04-02,18:32:00,18285.5,SELL,3,0.02h,Break Even,$0.75,$201.75,$107367.50,65,$201.75
2024-04-02,18:34:00,18287.5,BUY,3,0.02h,Break Even,$0.75,$202.50,$107368.25,65,$202.50
2024-04-02,18:36:00,18283.0,SELL,3,0.02h,Stop Loss,$64.50,$267.00,$107432.75,65,$267.00
2024-04-02,18:44:00,18289.25,BUY,3,0.02h,Stop Loss,$-18.00,$249.00,$107414.75,65,$249.00
2024-04-02,18:46:00,18275.5,SELL,3,0.02h,Stop Loss,$68.25,$317.25,$107483.00,65,$317.25
2024-04-02,18:56:00,18285.75,BUY,3,0.02h,Stop Loss,$-18.00,$299.25,$107465.00,65,$299.25
2024-04-02,18:57:00,18280.0,SELL,3,0.02h,Stop Loss,$-18.00,$281.25,$107447.00,65,$281.25
2024-04-02,19:03:00,18286.25,BUY,3,0.02h,Stop Loss,$64.50,$345.75,$107511.50,65,$345.75
2024-04-02,19:18:00,18281.0,SELL,3,0.02h,Break Even,$0.75,$346.50,$107512.25,65,$346.50
2024-04-02,19:25:00,18301.75,BUY,3,0.02h,Stop Loss,$30.75,$377.25,$107543.00,65,$377.25
2024-04-02,20:56:00,18341.75,SELL,3,0.02h,Stop Loss,$-18.00,$359.25,$107525.00,65,$359.25
2024-04-02,22:37:00,18333.5,BUY,3,0.03h,Stop Loss,$-18.00,$341.25,$107507.00,65,$341.25
2024-04-02,22:45:00,18330.0,SELL,3,0.02h,Stop Loss,$-18.00,$323.25,$107489.00,65,$323.25
,,,,,,,,,,,
2024-04-03,13:04:00,18273.75,BUY,3,0.02h,Stop Loss,$15.75,$15.75,$107504.75,66,$15.75
2024-04-03,13:12:00,18260.25,SELL,3,0.02h,Stop Loss,$38.25,$54.00,$107543.00,66,$54.00
2024-04-03,13:34:00,18264.75,BUY,3,0.02h,Stop Loss,$79.50,$133.50,$107622.50,66,$133.50
2024-04-03,15:41:00,18437.0,SELL,3,0.02h,Stop Loss,$-18.00,$115.50,$107604.50,66,$115.50
2024-04-03,15:43:00,18446.0,BUY,3,0.02h,Break Even,$0.75,$116.25,$107605.25,66,$116.25
2024-04-03,15:46:00,18433.25,SELL,3,0.02h,Stop Loss,$-18.00,$98.25,$107587.25,66,$98.25
2024-04-03,16:20:00,18415.25,BUY,3,0.02h,Stop Loss,$38.25,$136.50,$107625.50,66,$136.50
2024-04-03,16:39:00,18374.75,SELL,3,0.02h,Break Even,$0.75,$137.25,$107626.25,66,$137.25
2024-04-03,16:46:00,18419.25,BUY,3,0.02h,Break Even,$0.75,$138.00,$107627.00,66,$138.00
2024-04-03,17:03:00,18410.0,SELL,3,0.02h,Break Even,$0.75,$138.75,$107627.75,66,$138.75
2024-04-03,17:23:00,18419.25,BUY,3,0.02h,Stop Loss,$30.75,$169.50,$107658.50,66,$169.50
2024-04-03,17:39:00,18414.5,SELL,3,0.02h,Stop Loss,$53.25,$222.75,$107711.75,66,$222.75
2024-04-03,17:48:00,18421.0,BUY,3,0.02h,Stop Loss,$12.00,$234.75,$107723.75,66,$234.75
2024-04-03,17:59:00,18415.25,SELL,3,0.02h,Stop Loss,$-18.00,$216.75,$107705.75,66,$216.75
2024-04-03,18:08:00,18427.5,BUY,3,0.02h,Break Even,$0.75,$217.50,$107706.50,66,$217.50
2024-04-03,18:17:00,18415.75,SELL,3,0.02h,Stop Loss,$38.25,$255.75,$107744.75,66,$255.75
2024-04-03,18:39:00,18422.0,BUY,3,0.02h,Stop Loss,$-18.00,$237.75,$107726.75,66,$237.75
2024-04-03,18:47:00,18408.5,SELL,3,0.02h,Stop Loss,$-18.00,$219.75,$107708.75,66,$219.75
2024-04-03,19:39:00,18362.25,BUY,3,0.02h,Break Even,$0.75,$220.50,$107709.50,66,$220.50
2024-04-03,20:59:00,18390.25,SELL,3,0.02h,Break Even,$0.75,$221.25,$107710.25,66,$221.25
2024-04-03,22:28:00,18384.75,BUY,3,0.03h,Break Even,$0.75,$222.00,$107711.00,66,$222.00
2024-04-03,22:32:00,18382.5,SELL,3,0.02h,Stop Loss,$-18.00,$204.00,$107693.00,66,$204.00
2024-04-03,22:33:00,18384.0,BUY,3,0.02h,Stop Loss,$-18.00,$186.00,$107675.00,66,$186.00
2024-04-03,22:34:00,18382.5,SELL,3,0.02h,Stop Loss,$-18.00,$168.00,$107657.00,66,$168.00
2024-04-03,22:35:00,18385.5,BUY,3,0.02h,Stop Loss,$-18.00,$150.00,$107639.00,66,$150.00
,,,,,,,,,,,
2024-04-04,13:44:00,18541.25,SELL,3,0.02h,Stop Loss,$90.75,$90.75,$107729.75,67,$90.75
2024-04-04,15:02:00,18503.75,BUY,3,0.02h,Break Even,$0.75,$91.50,$107730.50,67,$91.50
2024-04-04,15:13:00,18486.0,SELL,3,0.02h,Break Even,$0.75,$92.25,$107731.25,67,$92.25
2024-04-04,15:30:00,18501.75,BUY,3,0.02h,Stop Loss,$53.25,$145.50,$107784.50,67,$145.50
2024-04-04,17:02:00,18550.5,SELL,3,0.02h,Stop Loss,$38.25,$183.75,$107822.75,67,$183.75
2024-04-04,20:42:00,18072.0,BUY,3,0.02h,Break Even,$0.75,$184.50,$107823.50,67,$184.50
2024-04-04,22:24:00,18079.25,SELL,3,0.02h,Stop Loss,$19.50,$204.00,$107843.00,67,$204.00
2024-04-04,22:33:00,18110.25,BUY,3,0.02h,Break Even,$0.75,$204.75,$107843.75,67,$204.75
2024-04-04,22:51:00,18099.75,SELL,3,0.02h,Break Even,$0.75,$205.50,$107844.50,67,$205.50
,,,,,,,,,,,
2024-04-05,12:00:00,18144.25,BUY,3,0.02h,Stop Loss,$57.00,$57.00,$107901.50,68,$57.00
2024-04-05,12:31:00,18109.75,SELL,3,0.02h,Stop Loss,$323.25,$380.25,$108224.75,68,$380.25
2024-04-05,12:39:00,18152.5,BUY,3,0.02h,Stop Loss,$79.50,$459.75,$108304.25,68,$459.75
2024-04-05,12:59:00,18144.75,SELL,3,0.02h,Stop Loss,$83.25,$543.00,$108387.50,68,$543.00
2024-04-05,13:01:00,18161.75,BUY,3,0.02h,Stop Loss,$75.75,$618.75,$108463.25,68,$618.75
2024-04-05,13:05:00,18143.25,SELL,3,0.02h,Stop Loss,$79.50,$698.25,$108542.75,68,$698.25
2024-04-05,13:28:00,18143.0,BUY,3,0.02h,Stop Loss,$64.50,$762.75,$108607.25,68,$762.75
2024-04-05,13:37:00,18127.75,SELL,3,0.02h,Stop Loss,$248.25,$1011.00,$108855.50,68,$1011.00
2024-04-05,13:43:00,18170.5,BUY,3,0.02h,Stop Loss,$128.25,$1139.25,$108983.75,68,$1139.25
2024-04-05,14:28:00,18187.75,SELL,3,0.02h,Stop Loss,$-18.00,$1121.25,$108965.75,68,$1121.25
2024-04-05,14:35:00,18218.75,BUY,3,0.02h,Break Even,$0.75,$1122.00,$108966.50,68,$1122.00
2024-04-05,14:36:00,18211.75,SELL,3,0.02h,Break Even,$0.75,$1122.75,$108967.25,68,$1122.75
2024-04-05,14:37:00,18218.25,BUY,3,0.02h,Stop Loss,$90.75,$1213.50,$109058.00,68,$1213.50
2024-04-05,15:15:00,18272.0,SELL,3,0.02h,Stop Loss,$267.00,$1480.50,$109325.00,68,$1480.50
2024-04-05,15:30:00,18282.75,BUY,3,0.02h,Break Even,$0.75,$1481.25,$109325.75,68,$1481.25
2024-04-05,16:30:00,18355.75,SELL,3,0.02h,Stop Loss,$12.00,$1493.25,$109337.75,68,$1493.25
2024-04-05,16:40:00,18371.75,BUY,3,0.02h,Stop Loss,$-18.00,$1475.25,$109319.75,68,$1475.25
2024-04-05,16:50:00,18356.25,SELL,3,0.02h,Stop Loss,$-18.00,$1457.25,$109301.75,68,$1457.25
2024-04-05,16:51:00,18364.5,BUY,3,0.02h,Stop Loss,$30.75,$1488.00,$109332.50,68,$1488.00
2024-04-05,17:09:00,18357.5,SELL,3,0.02h,Break Even,$0.75,$1488.75,$109333.25,68,$1488.75
2024-04-05,17:25:00,18369.25,BUY,3,0.02h,Break Even,$0.75,$1489.50,$109334.00,68,$1489.50
2024-04-05,17:26:00,18363.0,SELL,3,0.02h,Break Even,$0.75,$1490.25,$109334.75,68,$1490.25
2024-04-05,17:30:00,18369.0,BUY,3,0.02h,Stop Loss,$57.00,$1547.25,$109391.75,68,$1547.25
2024-04-05,17:41:00,18362.0,SELL,3,0.02h,Stop Loss,$154.50,$1701.75,$109546.25,68,$1701.75
2024-04-05,18:14:00,18318.75,BUY,3,0.02h,Break Even,$0.75,$1702.50,$109547.00,68,$1702.50
2024-04-05,18:26:00,18303.25,SELL,3,0.02h,Stop Loss,$-18.00,$1684.50,$109529.00,68,$1684.50
2024-04-05,18:41:00,18310.5,BUY,3,0.02h,Stop Loss,$-18.00,$1666.50,$109511.00,68,$1666.50
2024-04-05,18:42:00,18296.25,SELL,3,0.02h,Stop Loss,$38.25,$1704.75,$109549.25,68,$1704.75
2024-04-05,19:06:00,18293.5,BUY,3,0.02h,Stop Loss,$19.50,$1724.25,$109568.75,68,$1724.25
2024-04-05,19:28:00,18281.25,SELL,3,0.02h,Stop Loss,$-18.00,$1706.25,$109550.75,68,$1706.25
2024-04-05,19:29:00,18291.75,BUY,3,0.02h,Stop Loss,$-18.00,$1688.25,$109532.75,68,$1688.25
2024-04-05,20:01:00,18286.25,SELL,3,0.02h,Break Even,$0.75,$1689.00,$109533.50,68,$1689.00
2024-04-05,20:27:00,18296.5,BUY,3,0.02h,Break Even,$0.75,$1689.75,$109534.25,68,$1689.75
,,,,,,,,,,,
2024-04-08,12:03:00,18294.5,SELL,3,0.02h,Stop Loss,$-18.00,$-18.00,$109516.25,69,$-18.00
2024-04-08,12:14:00,18306.75,BUY,3,0.02h,Stop Loss,$19.50,$1.50,$109535.75,69,$1.50
2024-04-08,13:27:00,18346.0,SELL,3,0.02h,Stop Loss,$23.25,$24.75,$109559.00,69,$24.75
2024-04-08,13:59:00,18300.5,BUY,3,0.02h,Stop Loss,$45.75,$70.50,$109604.75,69,$70.50
2024-04-08,14:08:00,18283.25,SELL,3,0.02h,Stop Loss,$-18.00,$52.50,$109586.75,69,$52.50
2024-04-08,14:09:00,18307.25,BUY,3,0.02h,Stop Loss,$34.50,$87.00,$109621.25,69,$87.00
2024-04-08,15:03:00,18331.5,SELL,3,0.02h,Break Even,$0.75,$87.75,$109622.00,69,$87.75
2024-04-08,16:32:00,18291.25,BUY,3,0.02h,Stop Loss,$19.50,$107.25,$109641.50,69,$107.25
2024-04-08,17:15:00,18302.0,SELL,3,0.02h,Break Even,$0.75,$108.00,$109642.25,69,$108.00
2024-04-08,17:30:00,18311.5,BUY,3,0.02h,Stop Loss,$-18.00,$90.00,$109624.25,69,$90.00
2024-04-08,17:37:00,18291.0,SELL,3,0.02h,Stop Loss,$-18.00,$72.00,$109606.25,69,$72.00
2024-04-08,17:58:00,18303.5,BUY,3,0.02h,Stop Loss,$38.25,$110.25,$109644.50,69,$110.25
2024-04-08,18:32:00,18308.0,SELL,3,0.02h,Stop Loss,$-18.00,$92.25,$109626.50,69,$92.25
2024-04-08,18:56:00,18306.5,BUY,3,0.02h,Stop Loss,$34.50,$126.75,$109661.00,69,$126.75
2024-04-08,19:08:00,18292.5,SELL,3,0.02h,Break Even,$0.75,$127.50,$109661.75,69,$127.50
2024-04-08,19:13:00,18308.25,BUY,3,0.02h,Stop Loss,$15.75,$143.25,$109677.50,69,$143.25
2024-04-08,19:23:00,18301.75,SELL,3,0.02h,Break Even,$0.75,$144.00,$109678.25,69,$144.00
2024-04-08,19:30:00,18315.5,BUY,3,0.02h,Stop Loss,$12.00,$156.00,$109690.25,69,$156.00
2024-04-08,19:43:00,18302.75,SELL,3,0.02h,Stop Loss,$120.75,$276.75,$109811.00,69,$276.75
2024-04-08,20:04:00,18311.25,BUY,3,0.02h,Stop Loss,$-18.00,$258.75,$109793.00,69,$258.75
2024-04-08,20:30:00,18308.25,SELL,3,0.03h,Stop Loss,$15.75,$274.50,$109808.75,69,$274.50
2024-04-08,20:42:00,18310.25,BUY,3,0.05h,Stop Loss,$-18.00,$256.50,$109790.75,69,$256.50
2024-04-08,22:39:00,18314.5,SELL,3,0.02h,Stop Loss,$-18.00,$238.50,$109772.75,69,$238.50
,,,,,,,,,,,
2024-04-09,12:00:00,18340.75,BUY,3,0.02h,Stop Loss,$57.00,$57.00,$109829.75,70,$57.00
2024-04-09,13:07:00,18356.25,SELL,3,0.02h,Break Even,$0.75,$57.75,$109830.50,70,$57.75
2024-04-09,13:15:00,18369.75,BUY,3,0.02h,Stop Loss,$15.75,$73.50,$109846.25,70,$73.50
2024-04-09,13:36:00,18368.5,SELL,3,0.02h,Stop Loss,$72.00,$145.50,$109918.25,70,$145.50
2024-04-09,13:40:00,18390.25,BUY,3,0.02h,Stop Loss,$120.75,$266.25,$110039.00,70,$266.25
2024-04-09,13:49:00,18365.5,SELL,3,0.02h,Stop Loss,$240.75,$507.00,$110279.75,70,$507.00
2024-04-09,14:17:00,18362.5,BUY,3,0.02h,Stop Loss,$64.50,$571.50,$110344.25,70,$571.50
2024-04-09,14:21:00,18349.25,SELL,3,0.02h,Stop Loss,$-18.00,$553.50,$110326.25,70,$553.50
2024-04-09,14:23:00,18358.0,BUY,3,0.02h,Stop Loss,$23.25,$576.75,$110349.50,70,$576.75
2024-04-09,14:26:00,18346.5,SELL,3,0.02h,Stop Loss,$169.50,$746.25,$110519.00,70,$746.25
2024-04-09,15:05:00,18215.75,BUY,3,0.02h,Stop Loss,$90.75,$837.00,$110609.75,70,$837.00
2024-04-09,15:33:00,18221.75,SELL,3,0.02h,Stop Loss,$27.00,$864.00,$110636.75,70,$864.00
2024-04-09,15:43:00,18235.25,BUY,3,0.02h,Stop Loss,$240.75,$1104.75,$110877.50,70,$1104.75
2024-04-09,16:51:00,18288.5,SELL,3,0.02h,Stop Loss,$53.25,$1158.00,$110930.75,70,$1158.00
2024-04-09,17:08:00,18285.25,BUY,3,0.02h,Break Even,$0.75,$1158.75,$110931.50,70,$1158.75
2024-04-09,17:17:00,18270.25,SELL,3,0.02h,Stop Loss,$-18.00,$1140.75,$110913.50,70,$1140.75
2024-04-09,17:22:00,18289.25,BUY,3,0.02h,Stop Loss,$57.00,$1197.75,$110970.50,70,$1197.75
2024-04-09,17:29:00,18272.25,SELL,3,0.02h,Stop Loss,$-18.00,$1179.75,$110952.50,70,$1179.75
2024-04-09,17:40:00,18288.25,BUY,3,0.02h,Stop Loss,$49.50,$1229.25,$111002.00,70,$1229.25
2024-04-09,17:43:00,18264.5,SELL,3,0.02h,Stop Loss,$-18.00,$1211.25,$110984.00,70,$1211.25
2024-04-09,18:13:00,18271.75,BUY,3,0.02h,Stop Loss,$-18.00,$1193.25,$110966.00,70,$1193.25
2024-04-09,18:30:00,18260.5,SELL,3,0.02h,Stop Loss,$150.75,$1344.00,$111116.75,70,$1344.00
2024-04-09,18:57:00,18259.75,BUY,3,0.02h,Stop Loss,$-18.00,$1326.00,$111098.75,70,$1326.00
2024-04-09,19:00:00,18252.25,SELL,3,0.02h,Stop Loss,$154.50,$1480.50,$111253.25,70,$1480.50
2024-04-09,19:20:00,18255.25,BUY,3,0.02h,Stop Loss,$34.50,$1515.00,$111287.75,70,$1515.00
2024-04-09,20:46:00,18383.25,SELL,3,0.02h,Break Even,$0.75,$1515.75,$111288.50,70,$1515.75
2024-04-09,22:40:00,18378.0,BUY,3,0.02h,Stop Loss,$-18.00,$1497.75,$111270.50,70,$1497.75
2024-04-09,22:41:00,18376.5,SELL,3,0.02h,Break Even,$0.75,$1498.50,$111271.25,70,$1498.50
,,,,,,,,,,,
2024-04-10,12:00:00,18381.75,BUY,3,0.02h,Break Even,$0.75,$0.75,$111272.00,71,$0.75
2024-04-10,12:21:00,18381.0,SELL,3,0.02h,Stop Loss,$-18.00,$-17.25,$111254.00,71,$-17.25
2024-04-10,12:30:00,18424.0,BUY,3,0.02h,Stop Loss,$173.25,$156.00,$111427.25,71,$156.00
2024-04-10,12:31:00,18167.25,SELL,3,0.02h,Stop Loss,$717.00,$873.00,$112144.25,71,$873.00
2024-04-10,13:19:00,18129.25,BUY,3,0.02h,Stop Loss,$-18.00,$855.00,$112126.25,71,$855.00
2024-04-10,13:49:00,18139.5,SELL,3,0.02h,Stop Loss,$278.25,$1133.25,$112404.50,71,$1133.25
2024-04-10,13:52:00,18176.0,BUY,3,0.02h,Break Even,$0.75,$1134.00,$112405.25,71,$1134.00
2024-04-10,14:07:00,18152.25,SELL,3,0.02h,Stop Loss,$-18.00,$1116.00,$112387.25,71,$1116.00
2024-04-10,14:08:00,18167.25,BUY,3,0.02h,Stop Loss,$218.25,$1334.25,$112605.50,71,$1334.25
2024-04-10,14:16:00,18151.75,SELL,3,0.02h,Break Even,$0.75,$1335.00,$112606.25,71,$1335.00
2024-04-10,14:19:00,18184.0,BUY,3,0.02h,Stop Loss,$304.50,$1639.50,$112910.75,71,$1639.50
2024-04-10,14:50:00,18186.25,SELL,3,0.02h,Break Even,$0.75,$1640.25,$112911.50,71,$1640.25
2024-04-10,15:27:00,18158.75,BUY,3,0.02h,Stop Loss,$188.25,$1828.50,$113099.75,71,$1828.50
2024-04-10,15:38:00,18144.0,SELL,3,0.02h,Stop Loss,$27.00,$1855.50,$113126.75,71,$1855.50
2024-04-10,16:04:00,18157.5,BUY,3,0.02h,Stop Loss,$49.50,$1905.00,$113176.25,71,$1905.00
2024-04-10,16:13:00,18136.0,SELL,3,0.02h,Stop Loss,$42.00,$1947.00,$113218.25,71,$1947.00
2024-04-10,16:27:00,18149.5,BUY,3,0.02h,Stop Loss,$57.00,$2004.00,$113275.25,71,$2004.00
2024-04-10,17:05:00,18143.75,SELL,3,0.02h,Stop Loss,$135.75,$2139.75,$113411.00,71,$2139.75
2024-04-10,17:21:00,18179.25,BUY,3,0.02h,Stop Loss,$255.75,$2395.50,$113666.75,71,$2395.50
2024-04-10,17:34:00,18139.75,SELL,3,0.02h,Stop Loss,$105.75,$2501.25,$113772.50,71,$2501.25
2024-04-10,17:57:00,18186.75,BUY,3,0.02h,Stop Loss,$252.00,$2753.25,$114024.50,71,$2753.25
2024-04-10,18:20:00,18159.75,SELL,3,0.02h,Stop Loss,$-18.00,$2735.25,$114006.50,71,$2735.25
2024-04-10,18:21:00,18173.75,BUY,3,0.02h,Stop Loss,$42.00,$2777.25,$114048.50,71,$2777.25
2024-04-10,18:23:00,18153.25,SELL,3,0.02h,Stop Loss,$177.00,$2954.25,$114225.50,71,$2954.25
2024-04-10,18:40:00,18171.0,BUY,3,0.02h,Break Even,$0.75,$2955.00,$114226.25,71,$2955.00
2024-04-10,18:56:00,18142.25,SELL,3,0.02h,Stop Loss,$98.25,$3053.25,$114324.50,71,$3053.25
2024-04-10,19:13:00,18152.0,BUY,3,0.02h,Stop Loss,$240.75,$3294.00,$114565.25,71,$3294.00
2024-04-10,19:34:00,18153.0,SELL,3,0.02h,Stop Loss,$-18.00,$3276.00,$114547.25,71,$3276.00
2024-04-10,19:43:00,18195.0,BUY,3,0.02h,Stop Loss,$79.50,$3355.50,$114626.75,71,$3355.50
2024-04-10,20:02:00,18171.5,SELL,3,0.02h,Stop Loss,$34.50,$3390.00,$114661.25,71,$3390.00
2024-04-10,20:39:00,18173.5,BUY,3,0.03h,Break Even,$0.75,$3390.75,$114662.00,71,$3390.75
2024-04-10,22:04:00,18169.75,SELL,3,0.02h,Break Even,$0.75,$3391.50,$114662.75,71,$3391.50
2024-04-10,22:24:00,18173.25,BUY,3,0.02h,Break Even,$0.75,$3392.25,$114663.50,71,$3392.25
2024-04-10,22:36:00,18170.75,SELL,3,0.02h,Stop Loss,$-18.00,$3374.25,$114645.50,71,$3374.25
2024-04-10,22:44:00,18174.5,BUY,3,0.03h,Break Even,$0.75,$3375.00,$114646.25,71,$3375.00
2024-04-10,22:55:00,18170.5,SELL,3,0.02h,Break Even,$0.75,$3375.75,$114647.00,71,$3375.75
,,,,,,,,,,,
2024-04-11,12:31:00,18205.75,BUY,3,0.02h,Stop Loss,$90.75,$90.75,$114737.75,72,$90.75
2024-04-11,13:32:00,18231.75,SELL,3,0.02h,Stop Loss,$53.25,$144.00,$114791.00,72,$144.00
2024-04-11,13:53:00,18270.75,BUY,3,0.02h,Break Even,$0.75,$144.75,$114791.75,72,$144.75
2024-04-11,14:02:00,18230.0,SELL,3,0.02h,Stop Loss,$23.25,$168.00,$114815.00,72,$168.00
2024-04-11,14:32:00,18238.75,BUY,3,0.02h,Break Even,$0.75,$168.75,$114815.75,72,$168.75
2024-04-11,15:29:00,18246.75,SELL,3,0.02h,Break Even,$0.75,$169.50,$114816.50,72,$169.50
2024-04-11,15:36:00,18259.5,BUY,3,0.02h,Break Even,$0.75,$170.25,$114817.25,72,$170.25
2024-04-11,16:31:00,18295.75,SELL,3,0.02h,Stop Loss,$-18.00,$152.25,$114799.25,72,$152.25
2024-04-11,16:36:00,18307.75,BUY,3,0.02h,Break Even,$0.75,$153.00,$114800.00,72,$153.00
2024-04-11,16:38:00,18302.5,SELL,3,0.02h,Stop Loss,$-18.00,$135.00,$114782.00,72,$135.00
2024-04-11,16:43:00,18310.0,BUY,3,0.02h,Stop Loss,$23.25,$158.25,$114805.25,72,$158.25
2024-04-11,18:52:00,18493.75,SELL,3,0.02h,Stop Loss,$75.75,$234.00,$114881.00,72,$234.00
2024-04-11,19:06:00,18501.5,BUY,3,0.02h,Break Even,$0.75,$234.75,$114881.75,72,$234.75
2024-04-11,19:20:00,18488.0,SELL,3,0.02h,Break Even,$0.75,$235.50,$114882.50,72,$235.50
2024-04-11,19:23:00,18502.25,BUY,3,0.02h,Stop Loss,$-18.00,$217.50,$114864.50,72,$217.50
2024-04-11,19:52:00,18499.0,SELL,3,0.02h,Stop Loss,$27.00,$244.50,$114891.50,72,$244.50
2024-04-11,20:27:00,18493.25,BUY,3,0.02h,Stop Loss,$-18.00,$226.50,$114873.50,72,$226.50
2024-04-11,20:41:00,18489.0,SELL,3,0.02h,Stop Loss,$-18.00,$208.50,$114855.50,72,$208.50
2024-04-11,22:11:00,18492.5,BUY,3,0.02h,Break Even,$0.75,$209.25,$114856.25,72,$209.25
2024-04-11,22:34:00,18490.0,SELL,3,0.05h,Break Even,$0.75,$210.00,$114857.00,72,$210.00
2024-04-11,22:45:00,18494.25,BUY,3,0.02h,Stop Loss,$-18.00,$192.00,$114839.00,72,$192.00
,,,,,,,,,,,
2024-04-12,12:00:00,18412.5,SELL,3,0.02h,Stop Loss,$27.00,$27.00,$114866.00,73,$27.00
2024-04-12,13:33:00,18320.5,BUY,3,0.02h,Stop Loss,$49.50,$76.50,$114915.50,73,$76.50
2024-04-12,13:39:00,18296.25,SELL,3,0.02h,Stop Loss,$-18.00,$58.50,$114897.50,73,$58.50
2024-04-12,13:40:00,18306.0,BUY,3,0.02h,Stop Loss,$15.75,$74.25,$114913.25,73,$74.25
2024-04-12,14:04:00,18292.0,SELL,3,0.02h,Break Even,$0.75,$75.00,$114914.00,73,$75.00
2024-04-12,14:24:00,18303.25,BUY,3,0.02h,Break Even,$0.75,$75.75,$114914.75,73,$75.75
2024-04-12,14:26:00,18291.0,SELL,3,0.02h,Stop Loss,$79.50,$155.25,$114994.25,73,$155.25
2024-04-12,15:18:00,18230.5,BUY,3,0.02h,Stop Loss,$184.50,$339.75,$115178.75,73,$339.75
2024-04-12,15:57:00,18254.25,SELL,3,0.02h,Stop Loss,$-18.00,$321.75,$115160.75,73,$321.75
2024-04-12,17:14:00,18169.25,BUY,3,0.02h,Stop Loss,$19.50,$341.25,$115180.25,73,$341.25
2024-04-12,17:22:00,18145.5,SELL,3,0.02h,Stop Loss,$79.50,$420.75,$115259.75,73,$420.75
2024-04-12,17:43:00,18160.5,BUY,3,0.02h,Stop Loss,$72.00,$492.75,$115331.75,73,$492.75
2024-04-12,18:02:00,18148.0,SELL,3,0.02h,Stop Loss,$27.00,$519.75,$115358.75,73,$519.75
2024-04-12,18:07:00,18168.5,BUY,3,0.02h,Stop Loss,$117.00,$636.75,$115475.75,73,$636.75
2024-04-12,18:26:00,18162.5,SELL,3,0.02h,Break Even,$0.75,$637.50,$115476.50,73,$637.50
2024-04-12,19:25:00,18147.75,BUY,3,0.02h,Stop Loss,$75.75,$713.25,$115552.25,73,$713.25
2024-04-12,20:48:00,18185.25,SELL,3,0.02h,Break Even,$0.75,$714.00,$115553.00,73,$714.00
,,,,,,,,,,,
2024-04-15,12:00:00,18292.25,BUY,3,0.02h,Stop Loss,$-18.00,$-18.00,$115535.00,74,$-18.00
2024-04-15,13:30:00,18335.5,SELL,3,0.02h,Stop Loss,$499.50,$481.50,$116034.50,74,$481.50
2024-04-15,13:54:00,18322.0,BUY,3,0.02h,Break Even,$0.75,$482.25,$116035.25,74,$482.25
2024-04-15,14:06:00,18297.25,SELL,3,0.02h,Stop Loss,$102.00,$584.25,$116137.25,74,$584.25
2024-04-15,15:29:00,18193.0,BUY,3,0.02h,Break Even,$0.75,$585.00,$116138.00,74,$585.00
2024-04-15,15:48:00,18185.25,SELL,3,0.02h,Break Even,$0.75,$585.75,$116138.75,74,$585.75
2024-04-15,15:52:00,18206.0,BUY,3,0.02h,Stop Loss,$90.75,$676.50,$116229.50,74,$676.50
2024-04-15,16:17:00,18204.0,SELL,3,0.02h,Stop Loss,$98.25,$774.75,$116327.75,74,$774.75
2024-04-15,17:05:00,18110.75,BUY,3,0.02h,Stop Loss,$135.75,$910.50,$116463.50,74,$910.50
2024-04-15,17:15:00,18099.25,SELL,3,0.02h,Stop Loss,$42.00,$952.50,$116505.50,74,$952.50
2024-04-15,18:28:00,17905.0,BUY,3,0.02h,Break Even,$0.75,$953.25,$116506.25,74,$953.25
2024-04-15,18:30:00,17891.75,SELL,3,0.02h,Stop Loss,$49.50,$1002.75,$116555.75,74,$1002.75
2024-04-15,18:31:00,17902.5,BUY,3,0.02h,Stop Loss,$57.00,$1059.75,$116612.75,74,$1059.75
2024-04-15,18:46:00,17893.75,SELL,3,0.02h,Stop Loss,$-18.00,$1041.75,$116594.75,74,$1041.75
2024-04-15,19:25:00,17878.75,BUY,3,0.02h,Stop Loss,$42.00,$1083.75,$116636.75,74,$1083.75
2024-04-15,19:29:00,17864.25,SELL,3,0.02h,Stop Loss,$60.75,$1144.50,$116697.50,74,$1144.50
2024-04-15,19:32:00,17883.75,BUY,3,0.02h,Stop Loss,$68.25,$1212.75,$116765.75,74,$1212.75
2024-04-15,20:01:00,17864.25,SELL,3,0.02h,Stop Loss,$23.25,$1236.00,$116789.00,74,$1236.00
2024-04-15,20:54:00,17862.5,BUY,3,0.02h,Break Even,$0.75,$1236.75,$116789.75,74,$1236.75
2024-04-15,22:41:00,17880.0,SELL,3,0.02h,Break Even,$0.75,$1237.50,$116790.50,74,$1237.50
2024-04-15,22:48:00,17884.0,BUY,3,0.02h,Stop Loss,$-18.00,$1219.50,$116772.50,74,$1219.50
2024-04-15,22:49:00,17881.5,SELL,3,0.02h,Break Even,$0.75,$1220.25,$116773.25,74,$1220.25
,,,,,,,,,,,
2024-04-16,12:00:00,17907.75,BUY,3,0.02h,Stop Loss,$-18.00,$-18.00,$116755.25,75,$-18.00
2024-04-16,12:10:00,17885.75,SELL,3,0.02h,Stop Loss,$-18.00,$-36.00,$116737.25,75,$-36.00
2024-04-16,12:11:00,17890.25,BUY,3,0.02h,Stop Loss,$128.25,$92.25,$116865.50,75,$92.25
2024-04-16,12:18:00,17884.0,SELL,3,0.02h,Stop Loss,$12.00,$104.25,$116877.50,75,$104.25
2024-04-16,12:33:00,17896.0,BUY,3,0.02h,Stop Loss,$-18.00,$86.25,$116859.50,75,$86.25
2024-04-16,12:58:00,17894.75,SELL,3,0.02h,Break Even,$0.75,$87.00,$116860.25,75,$87.00
2024-04-16,13:55:00,17867.25,BUY,3,0.02h,Stop Loss,$102.00,$189.00,$116962.25,75,$189.00
2024-04-16,14:25:00,17887.0,SELL,3,0.02h,Stop Loss,$64.50,$253.50,$117026.75,75,$253.50
2024-04-16,14:51:00,17868.75,BUY,3,0.02h,Break Even,$0.75,$254.25,$117027.50,75,$254.25
2024-04-16,14:52:00,17864.0,SELL,3,0.02h,Stop Loss,$-18.00,$236.25,$117009.50,75,$236.25
2024-04-16,14:53:00,17872.25,BUY,3,0.02h,Stop Loss,$113.25,$349.50,$117122.75,75,$349.50
2024-04-16,15:01:00,17861.25,SELL,3,0.02h,Stop Loss,$102.00,$451.50,$117224.75,75,$451.50
2024-04-16,15:04:00,17878.25,BUY,3,0.02h,Stop Loss,$23.25,$474.75,$117248.00,75,$474.75
2024-04-16,15:40:00,17884.75,SELL,3,0.02h,Stop Loss,$-18.00,$456.75,$117230.00,75,$456.75
2024-04-16,15:43:00,17904.25,BUY,3,0.02h,Break Even,$0.75,$457.50,$117230.75,75,$457.50
2024-04-16,16:01:00,17877.0,SELL,3,0.02h,Stop Loss,$154.50,$612.00,$117385.25,75,$612.00
2024-04-16,16:12:00,17906.5,BUY,3,0.02h,Break Even,$0.75,$612.75,$117386.00,75,$612.75
2024-04-16,16:34:00,17904.75,SELL,3,0.02h,Stop Loss,$53.25,$666.00,$117439.25,75,$666.00
2024-04-16,16:42:00,17917.25,BUY,3,0.02h,Break Even,$0.75,$666.75,$117440.00,75,$666.75
2024-04-16,16:45:00,17897.5,SELL,3,0.02h,Stop Loss,$-18.00,$648.75,$117422.00,75,$648.75
2024-04-16,16:48:00,17913.75,BUY,3,0.02h,Stop Loss,$87.00,$735.75,$117509.00,75,$735.75
2024-04-16,17:02:00,17902.25,SELL,3,0.02h,Stop Loss,$60.75,$796.50,$117569.75,75,$796.50
2024-04-16,17:10:00,17916.5,BUY,3,0.02h,Stop Loss,$12.00,$808.50,$117581.75,75,$808.50
2024-04-16,17:31:00,17847.25,SELL,3,0.02h,Stop Loss,$188.25,$996.75,$117770.00,75,$996.75
2024-04-16,17:44:00,17905.75,BUY,3,0.02h,Break Even,$0.75,$997.50,$117770.75,75,$997.50
2024-04-16,17:48:00,17881.25,SELL,3,0.02h,Stop Loss,$109.50,$1107.00,$117880.25,75,$1107.00
2024-04-16,18:05:00,17904.75,BUY,3,0.02h,Stop Loss,$60.75,$1167.75,$117941.00,75,$1167.75
2024-04-16,18:19:00,17884.75,SELL,3,0.02h,Break Even,$0.75,$1168.50,$117941.75,75,$1168.50
2024-04-16,18:39:00,17891.75,BUY,3,0.02h,Stop Loss,$68.25,$1236.75,$118010.00,75,$1236.75
2024-04-16,19:17:00,17912.75,SELL,3,0.02h,Break Even,$0.75,$1237.50,$118010.75,75,$1237.50
2024-04-16,19:23:00,17933.5,BUY,3,0.02h,Stop Loss,$102.00,$1339.50,$118112.75,75,$1339.50
2024-04-16,19:34:00,17915.25,SELL,3,0.02h,Stop Loss,$334.50,$1674.00,$118447.25,75,$1674.00
2024-04-16,20:33:00,17887.25,BUY,3,0.02h,Stop Loss,$-18.00,$1656.00,$118429.25,75,$1656.00
2024-04-16,22:21:00,17899.5,SELL,3,0.02h,Break Even,$0.75,$1656.75,$118430.00,75,$1656.75
2024-04-16,22:31:00,17901.75,BUY,3,0.02h,Stop Loss,$23.25,$1680.00,$118453.25,75,$1680.00
,,,,,,,,,,,
2024-04-17,12:02:00,17903.5,SELL,3,0.02h,Stop Loss,$45.75,$45.75,$118499.00,76,$45.75
2024-04-17,12:07:00,17912.5,BUY,3,0.02h,Break Even,$0.75,$46.50,$118499.75,76,$46.50
2024-04-17,12:10:00,17904.5,SELL,3,0.02h,Stop Loss,$72.00,$118.50,$118571.75,76,$118.50
2024-04-17,12:15:00,17913.0,BUY,3,0.02h,Break Even,$0.75,$119.25,$118572.50,76,$119.25
2024-04-17,12:26:00,17899.25,SELL,3,0.02h,Stop Loss,$-18.00,$101.25,$118554.50,76,$101.25
2024-04-17,12:34:00,17916.5,BUY,3,0.02h,Stop Loss,$-18.00,$83.25,$118536.50,76,$83.25
2024-04-17,13:33:00,17945.75,SELL,3,0.02h,Stop Loss,$102.00,$185.25,$118638.50,76,$185.25
2024-04-17,14:49:00,17858.25,BUY,3,0.02h,Stop Loss,$-18.00,$167.25,$118620.50,76,$167.25
2024-04-17,14:52:00,17811.0,SELL,3,0.02h,Stop Loss,$338.25,$505.50,$118958.75,76,$505.50
2024-04-17,15:04:00,17839.25,BUY,3,0.02h,Stop Loss,$124.50,$630.00,$119083.25,76,$630.00
2024-04-17,15:11:00,17815.75,SELL,3,0.02h,Break Even,$0.75,$630.75,$119084.00,76,$630.75
2024-04-17,17:04:00,17668.75,BUY,3,0.02h,Break Even,$0.75,$631.50,$119084.75,76,$631.50
2024-04-17,17:48:00,17704.5,SELL,3,0.02h,Stop Loss,$27.00,$658.50,$119111.75,76,$658.50
2024-04-17,17:49:00,17712.25,BUY,3,0.02h,Stop Loss,$135.75,$794.25,$119247.50,76,$794.25
2024-04-17,18:12:00,17712.75,SELL,3,0.02h,Stop Loss,$-18.00,$776.25,$119229.50,76,$776.25
2024-04-17,18:42:00,17741.25,BUY,3,0.02h,Stop Loss,$450.75,$1227.00,$119680.25,76,$1227.00
2024-04-17,18:55:00,17706.5,SELL,3,0.02h,Stop Loss,$192.00,$1419.00,$119872.25,76,$1419.00
2024-04-17,19:45:00,17686.25,BUY,3,0.02h,Stop Loss,$-18.00,$1401.00,$119854.25,76,$1401.00
2024-04-17,19:59:00,17678.0,SELL,3,0.02h,Stop Loss,$372.00,$1773.00,$120226.25,76,$1773.00
2024-04-17,20:30:00,17664.25,BUY,3,0.02h,Stop Loss,$-18.00,$1755.00,$120208.25,76,$1755.00
2024-04-17,20:44:00,17661.0,SELL,3,0.02h,Stop Loss,$-18.00,$1737.00,$120190.25,76,$1737.00
2024-04-17,20:59:00,17665.0,BUY,3,0.02h,Stop Loss,$-18.00,$1719.00,$120172.25,76,$1719.00
2024-04-17,22:39:00,17678.5,SELL,3,0.02h,Stop Loss,$-18.00,$1701.00,$120154.25,76,$1701.00
2024-04-17,22:42:00,17682.75,BUY,3,0.02h,Stop Loss,$-18.00,$1683.00,$120136.25,76,$1683.00
2024-04-17,22:51:00,17678.25,SELL,3,0.02h,Break Even,$0.75,$1683.75,$120137.00,76,$1683.75
,,,,,,,,,,,
2024-04-18,12:00:00,17709.5,BUY,3,0.02h,Break Even,$0.75,$0.75,$120137.75,77,$0.75
2024-04-18,12:18:00,17692.0,SELL,3,0.02h,Break Even,$0.75,$1.50,$120138.50,77,$1.50
2024-04-18,12:38:00,17703.75,BUY,3,0.02h,Break Even,$0.75,$2.25,$120139.25,77,$2.25
2024-04-18,12:44:00,17687.0,SELL,3,0.02h,Stop Loss,$27.00,$29.25,$120166.25,77,$29.25
2024-04-18,13:06:00,17694.5,BUY,3,0.02h,Stop Loss,$-18.00,$11.25,$120148.25,77,$11.25
2024-04-18,13:09:00,17685.5,SELL,3,0.02h,Stop Loss,$27.00,$38.25,$120175.25,77,$38.25
2024-04-18,13:12:00,17689.5,BUY,3,0.02h,Break Even,$0.75,$39.00,$120176.00,77,$39.00
2024-04-18,13:17:00,17679.25,SELL,3,0.02h,Stop Loss,$57.00,$96.00,$120233.00,77,$96.00
2024-04-18,14:10:00,17642.0,BUY,3,0.02h,Stop Loss,$98.25,$194.25,$120331.25,77,$194.25
2024-04-18,15:31:00,17697.5,SELL,3,0.02h,Stop Loss,$-18.00,$176.25,$120313.25,77,$176.25
2024-04-18,16:03:00,17700.0,BUY,3,0.02h,Break Even,$0.75,$177.00,$120314.00,77,$177.00
2024-04-18,16:04:00,17695.5,SELL,3,0.02h,Stop Loss,$64.50,$241.50,$120378.50,77,$241.50
2024-04-18,17:50:00,17571.25,BUY,3,0.02h,Stop Loss,$-18.00,$223.50,$120360.50,77,$223.50
2024-04-18,17:51:00,17563.75,SELL,3,0.02h,Stop Loss,$60.75,$284.25,$120421.25,77,$284.25
2024-04-18,18:17:00,17565.0,BUY,3,0.02h,Stop Loss,$113.25,$397.50,$120534.50,77,$397.50
2024-04-18,18:32:00,17550.0,SELL,3,0.02h,Stop Loss,$120.75,$518.25,$120655.25,77,$518.25
2024-04-18,18:50:00,17558.25,BUY,3,0.02h,Stop Loss,$-18.00,$500.25,$120637.25,77,$500.25
2024-04-18,18:51:00,17547.0,SELL,3,0.02h,Stop Loss,$180.75,$681.00,$120818.00,77,$681.00
2024-04-18,19:03:00,17571.25,BUY,3,0.02h,Stop Loss,$-18.00,$663.00,$120800.00,77,$663.00
2024-04-18,19:21:00,17556.5,SELL,3,0.02h,Stop Loss,$68.25,$731.25,$120868.25,77,$731.25
2024-04-18,19:30:00,17562.25,BUY,3,0.02h,Stop Loss,$38.25,$769.50,$120906.50,77,$769.50
2024-04-18,19:55:00,17537.5,SELL,3,0.02h,Stop Loss,$75.75,$845.25,$120982.25,77,$845.25
2024-04-18,20:59:00,17531.25,BUY,3,0.02h,Stop Loss,$-18.00,$827.25,$120964.25,77,$827.25
2024-04-18,22:23:00,17534.25,SELL,3,0.02h,Break Even,$0.75,$828.00,$120965.00,77,$828.00
,,,,,,,,,,,
2024-04-19,12:17:00,17513.5,BUY,3,0.02h,Break Even,$0.75,$0.75,$120965.75,78,$0.75
2024-04-19,12:45:00,17527.0,SELL,3,0.02h,Stop Loss,$132.00,$132.75,$121097.75,78,$132.75
2024-04-19,13:46:00,17492.25,BUY,3,0.02h,Stop Loss,$312.00,$444.75,$121409.75,78,$444.75
2024-04-19,13:51:00,17449.0,SELL,3,0.02h,Stop Loss,$102.00,$546.75,$121511.75,78,$546.75
2024-04-19,14:47:00,17396.25,BUY,3,0.02h,Stop Loss,$102.00,$648.75,$121613.75,78,$648.75
2024-04-19,15:01:00,17378.0,SELL,3,0.02h,Stop Loss,$34.50,$683.25,$121648.25,78,$683.25
2024-04-19,15:48:00,17346.25,BUY,3,0.02h,Stop Loss,$30.75,$714.00,$121679.00,78,$714.00
2024-04-19,15:52:00,17325.25,SELL,3,0.02h,Break Even,$0.75,$714.75,$121679.75,78,$714.75
2024-04-19,16:46:00,17246.75,BUY,3,0.02h,Stop Loss,$120.75,$835.50,$121800.50,78,$835.50
2024-04-19,17:29:00,17274.25,SELL,3,0.02h,Stop Loss,$218.25,$1053.75,$122018.75,78,$1053.75
2024-04-19,17:48:00,17284.75,BUY,3,0.02h,Stop Loss,$38.25,$1092.00,$122057.00,78,$1092.00
2024-04-19,18:01:00,17268.5,SELL,3,0.02h,Stop Loss,$274.50,$1366.50,$122331.50,78,$1366.50
2024-04-19,19:12:00,17174.5,BUY,3,0.02h,Stop Loss,$124.50,$1491.00,$122456.00,78,$1491.00
2024-04-19,19:36:00,17154.75,SELL,3,0.02h,Stop Loss,$270.75,$1761.75,$122726.75,78,$1761.75
2024-04-19,19:55:00,17183.25,BUY,3,0.02h,Break Even,$0.75,$1762.50,$122727.50,78,$1762.50
2024-04-19,20:40:00,17174.5,SELL,3,0.02h,Stop Loss,$-18.00,$1744.50,$122709.50,78,$1744.50
2024-04-19,20:58:00,17180.75,BUY,3,0.02h,Stop Loss,$-18.00,$1726.50,$122691.50,78,$1726.50
,,,,,,,,,,,
2024-04-22,13:25:00,17295.0,SELL,3,0.02h,Stop Loss,$83.25,$83.25,$122774.75,79,$83.25
2024-04-22,13:47:00,17298.5,BUY,3,0.02h,Stop Loss,$19.50,$102.75,$122794.25,79,$102.75
2024-04-22,14:01:00,17296.75,SELL,3,0.02h,Stop Loss,$-18.00,$84.75,$122776.25,79,$84.75
2024-04-22,14:02:00,17307.75,BUY,3,0.02h,Stop Loss,$45.75,$130.50,$122822.00,79,$130.50
2024-04-22,14:03:00,17295.25,SELL,3,0.02h,Stop Loss,$87.00,$217.50,$122909.00,79,$217.50
2024-04-22,15:27:00,17193.25,BUY,3,0.02h,Break Even,$0.75,$218.25,$122909.75,79,$218.25
2024-04-22,16:31:00,17247.25,SELL,3,0.02h,Stop Loss,$90.75,$309.00,$123000.50,79,$309.00
2024-04-22,16:48:00,17268.0,BUY,3,0.02h,Break Even,$0.75,$309.75,$123001.25,79,$309.75
2024-04-22,18:42:00,17413.25,SELL,3,0.02h,Stop Loss,$105.75,$415.50,$123107.00,79,$415.50
2024-04-22,19:10:00,17407.5,BUY,3,0.02h,Break Even,$0.75,$416.25,$123107.75,79,$416.25
2024-04-22,19:12:00,17399.25,SELL,3,0.02h,Stop Loss,$-18.00,$398.25,$123089.75,79,$398.25
2024-04-22,19:13:00,17409.25,BUY,3,0.02h,Break Even,$0.75,$399.00,$123090.50,79,$399.00
2024-04-22,19:21:00,17384.25,SELL,3,0.02h,Stop Loss,$57.00,$456.00,$123147.50,79,$456.00
2024-04-22,20:31:00,17338.5,BUY,3,0.02h,Stop Loss,$12.00,$468.00,$123159.50,79,$468.00
2024-04-22,20:49:00,17335.0,SELL,3,0.02h,Stop Loss,$-18.00,$450.00,$123141.50,79,$450.00
2024-04-22,20:53:00,17341.75,BUY,3,0.02h,Stop Loss,$-18.00,$432.00,$123123.50,79,$432.00
2024-04-22,22:15:00,17345.0,SELL,3,0.02h,Stop Loss,$12.00,$444.00,$123135.50,79,$444.00
2024-04-22,22:37:00,17342.5,BUY,3,0.03h,Stop Loss,$-18.00,$426.00,$123117.50,79,$426.00
2024-04-22,22:43:00,17339.0,SELL,3,0.02h,Stop Loss,$-18.00,$408.00,$123099.50,79,$408.00
2024-04-22,22:44:00,17341.0,BUY,3,0.02h,Stop Loss,$-18.00,$390.00,$123081.50,79,$390.00
2024-04-22,22:45:00,17339.75,SELL,3,0.02h,Stop Loss,$-18.00,$372.00,$123063.50,79,$372.00
2024-04-22,22:46:00,17342.5,BUY,3,0.03h,Break Even,$0.75,$372.75,$123064.25,79,$372.75
2024-04-22,22:57:00,17340.0,SELL,3,0.02h,Break Even,$0.75,$373.50,$123065.00,79,$373.50
,,,,,,,,,,,
2024-04-23,12:00:00,17391.0,BUY,3,0.02h,Break Even,$0.75,$0.75,$123065.75,80,$0.75
2024-04-23,12:19:00,17363.25,SELL,3,0.02h,Break Even,$0.75,$1.50,$123066.50,80,$1.50
2024-04-23,12:21:00,17374.5,BUY,3,0.02h,Stop Loss,$27.00,$28.50,$123093.50,80,$28.50
2024-04-23,14:52:00,17562.0,SELL,3,0.02h,Stop Loss,$-18.00,$10.50,$123075.50,80,$10.50
2024-04-23,14:55:00,17576.75,BUY,3,0.02h,Stop Loss,$94.50,$105.00,$123170.00,80,$105.00
2024-04-23,15:03:00,17544.0,SELL,3,0.02h,Break Even,$0.75,$105.75,$123170.75,80,$105.75
2024-04-23,15:14:00,17579.0,BUY,3,0.02h,Stop Loss,$30.75,$136.50,$123201.50,80,$136.50
2024-04-23,15:45:00,17583.5,SELL,3,0.02h,Stop Loss,$105.75,$242.25,$123307.25,80,$242.25
2024-04-23,16:06:00,17584.25,BUY,3,0.02h,Break Even,$0.75,$243.00,$123308.00,80,$243.00
2024-04-23,16:54:00,17598.5,SELL,3,0.02h,Stop Loss,$15.75,$258.75,$123323.75,80,$258.75
2024-04-23,17:08:00,17611.75,BUY,3,0.02h,Stop Loss,$-18.00,$240.75,$123305.75,80,$240.75
2024-04-23,17:12:00,17595.0,SELL,3,0.02h,Stop Loss,$158.25,$399.00,$123464.00,80,$399.00
2024-04-23,17:24:00,17596.25,BUY,3,0.02h,Break Even,$0.75,$399.75,$123464.75,80,$399.75
2024-04-23,17:26:00,17587.75,SELL,3,0.02h,Stop Loss,$-18.00,$381.75,$123446.75,80,$381.75
2024-04-23,17:29:00,17596.75,BUY,3,0.02h,Stop Loss,$12.00,$393.75,$123458.75,80,$393.75
2024-04-23,18:52:00,17634.5,SELL,3,0.02h,Break Even,$0.75,$394.50,$123459.50,80,$394.50
2024-04-23,19:38:00,17630.25,BUY,3,0.02h,Break Even,$0.75,$395.25,$123460.25,80,$395.25
2024-04-23,19:42:00,17626.75,SELL,3,0.02h,Stop Loss,$98.25,$493.50,$123558.50,80,$493.50
2024-04-23,20:05:00,17641.0,BUY,3,0.02h,Stop Loss,$30.75,$524.25,$123589.25,80,$524.25
2024-04-23,22:30:00,17669.5,SELL,3,0.02h,Break Even,$0.75,$525.00,$123590.00,80,$525.00
2024-04-23,22:46:00,17670.75,BUY,3,0.02h,Stop Loss,$-18.00,$507.00,$123572.00,80,$507.00
,,,,,,,,,,,
2024-04-24,12:43:00,17722.25,SELL,3,0.02h,Break Even,$0.75,$0.75,$123572.75,81,$0.75
2024-04-24,13:25:00,17705.25,BUY,3,0.02h,Stop Loss,$124.50,$125.25,$123697.25,81,$125.25
2024-04-24,13:57:00,17716.75,SELL,3,0.02h,Break Even,$0.75,$126.00,$123698.00,81,$126.00
2024-04-24,14:08:00,17768.75,BUY,3,0.02h,Stop Loss,$60.75,$186.75,$123758.75,81,$186.75
2024-04-24,14:14:00,17740.75,SELL,3,0.02h,Stop Loss,$297.00,$483.75,$124055.75,81,$483.75
2024-04-24,15:33:00,17669.5,BUY,3,0.02h,Stop Loss,$23.25,$507.00,$124079.00,81,$507.00
2024-04-24,15:44:00,17639.25,SELL,3,0.02h,Stop Loss,$192.00,$699.00,$124271.00,81,$699.00
2024-04-24,16:53:00,17603.5,BUY,3,0.02h,Stop Loss,$27.00,$726.00,$124298.00,81,$726.00
2024-04-24,18:06:00,17668.25,SELL,3,0.02h,Break Even,$0.75,$726.75,$124298.75,81,$726.75
2024-04-24,19:11:00,17637.5,BUY,3,0.02h,Stop Loss,$90.75,$817.50,$124389.50,81,$817.50
2024-04-24,20:01:00,17665.25,SELL,3,0.02h,Stop Loss,$45.75,$863.25,$124435.25,81,$863.25
2024-04-24,20:02:00,17672.5,BUY,3,0.02h,Break Even,$0.75,$864.00,$124436.00,81,$864.00
2024-04-24,20:03:00,17666.75,SELL,3,0.02h,Stop Loss,$79.50,$943.50,$124515.50,81,$943.50
2024-04-24,20:55:00,17517.0,BUY,3,0.02h,Break Even,$0.75,$944.25,$124516.25,81,$944.25
2024-04-24,20:59:00,17502.5,SELL,3,0.02h,Break Even,$0.75,$945.00,$124517.00,81,$945.00
2024-04-24,22:30:00,17483.75,BUY,3,0.02h,Break Even,$0.75,$945.75,$124517.75,81,$945.75
2024-04-24,22:37:00,17466.25,SELL,3,0.02h,Stop Loss,$87.00,$1032.75,$124604.75,81,$1032.75
,,,,,,,,,,,
2024-04-25,12:00:00,17501.0,BUY,3,0.02h,Stop Loss,$-18.00,$-18.00,$124586.75,82,$-18.00
2024-04-25,12:13:00,17465.75,SELL,3,0.02h,Stop Loss,$-18.00,$-36.00,$124568.75,82,$-36.00
2024-04-25,13:44:00,17368.5,BUY,3,0.02h,Stop Loss,$60.75,$24.75,$124629.50,82,$24.75
2024-04-25,14:01:00,17342.0,SELL,3,0.02h,Stop Loss,$120.75,$145.50,$124750.25,82,$145.50
2024-04-25,14:06:00,17370.0,BUY,3,0.02h,Stop Loss,$188.25,$333.75,$124938.50,82,$333.75
2024-04-25,14:35:00,17382.5,SELL,3,0.02h,Break Even,$0.75,$334.50,$124939.25,82,$334.50
2024-04-25,15:06:00,17378.0,BUY,3,0.02h,Stop Loss,$45.75,$380.25,$124985.00,82,$380.25
2024-04-25,15:18:00,17362.0,SELL,3,0.02h,Stop Loss,$49.50,$429.75,$125034.50,82,$429.75
2024-04-25,15:27:00,17380.75,BUY,3,0.02h,Stop Loss,$38.25,$468.00,$125072.75,82,$468.00
2024-04-25,15:49:00,17371.75,SELL,3,0.02h,Stop Loss,$34.50,$502.50,$125107.25,82,$502.50
2024-04-25,15:55:00,17394.0,BUY,3,0.02h,Stop Loss,$72.00,$574.50,$125179.25,82,$574.50
2024-04-25,17:21:00,17484.25,SELL,3,0.02h,Stop Loss,$98.25,$672.75,$125277.50,82,$672.75
2024-04-25,17:31:00,17502.0,BUY,3,0.02h,Break Even,$0.75,$673.50,$125278.25,82,$673.50
2024-04-25,18:26:00,17557.75,SELL,3,0.02h,Break Even,$0.75,$674.25,$125279.00,82,$674.25
2024-04-25,19:01:00,17534.0,BUY,3,0.02h,Stop Loss,$49.50,$723.75,$125328.50,82,$723.75
2024-04-25,19:38:00,17570.0,SELL,3,0.02h,Stop Loss,$105.75,$829.50,$125434.25,82,$829.50
2024-04-25,20:00:00,17569.25,BUY,3,0.02h,Stop Loss,$788.25,$1617.75,$126222.50,82,$1617.75
2024-04-25,22:02:00,17787.25,SELL,3,0.02h,Stop Loss,$15.75,$1633.50,$126238.25,82,$1633.50
2024-04-25,22:35:00,17774.25,BUY,3,0.02h,Stop Loss,$-18.00,$1615.50,$126220.25,82,$1615.50
2024-04-25,22:53:00,17773.5,SELL,3,0.02h,Stop Loss,$-18.00,$1597.50,$126202.25,82,$1597.50
,,,,,,,,,,,
2024-04-26,12:31:00,17795.5,BUY,3,0.02h,Stop Loss,$203.25,$203.25,$126405.50,83,$203.25
2024-04-26,12:42:00,17736.0,SELL,3,0.02h,Stop Loss,$79.50,$282.75,$126485.00,83,$282.75
2024-04-26,12:45:00,17754.0,BUY,3,0.02h,Break Even,$0.75,$283.50,$126485.75,83,$283.50
2024-04-26,12:47:00,17735.75,SELL,3,0.02h,Break Even,$0.75,$284.25,$126486.50,83,$284.25
2024-04-26,13:02:00,17742.5,BUY,3,0.02h,Stop Loss,$49.50,$333.75,$126536.00,83,$333.75
2024-04-26,13:07:00,17717.0,SELL,3,0.02h,Stop Loss,$-18.00,$315.75,$126518.00,83,$315.75
2024-04-26,13:36:00,17734.5,BUY,3,0.02h,Stop Loss,$23.25,$339.00,$126541.25,83,$339.00
2024-04-26,14:31:00,17788.25,SELL,3,0.02h,Break Even,$0.75,$339.75,$126542.00,83,$339.75
2024-04-26,14:36:00,17828.75,BUY,3,0.02h,Break Even,$0.75,$340.50,$126542.75,83,$340.50
2024-04-26,15:13:00,17825.25,SELL,3,0.02h,Stop Loss,$27.00,$367.50,$126569.75,83,$367.50
2024-04-26,15:44:00,17849.75,BUY,3,0.02h,Stop Loss,$143.25,$510.75,$126713.00,83,$510.75
2024-04-26,16:01:00,17831.75,SELL,3,0.02h,Break Even,$0.75,$511.50,$126713.75,83,$511.50
2024-04-26,16:26:00,17851.0,BUY,3,0.02h,Stop Loss,$-18.00,$493.50,$126695.75,83,$493.50
2024-04-26,16:32:00,17835.75,SELL,3,0.02h,Stop Loss,$-18.00,$475.50,$126677.75,83,$475.50
2024-04-26,16:35:00,17854.5,BUY,3,0.02h,Break Even,$0.75,$476.25,$126678.50,83,$476.25
2024-04-26,17:41:00,17876.75,SELL,3,0.02h,Stop Loss,$177.00,$653.25,$126855.50,83,$653.25
2024-04-26,17:49:00,17892.0,BUY,3,0.02h,Stop Loss,$42.00,$695.25,$126897.50,83,$695.25
2024-04-26,17:57:00,17884.25,SELL,3,0.02h,Stop Loss,$38.25,$733.50,$126935.75,83,$733.50
2024-04-26,18:59:00,17861.25,BUY,3,0.02h,Stop Loss,$57.00,$790.50,$126992.75,83,$790.50
2024-04-26,19:42:00,17872.75,SELL,3,0.02h,Stop Loss,$-18.00,$772.50,$126974.75,83,$772.50
2024-04-26,20:42:00,17838.25,BUY,3,0.02h,Stop Loss,$-18.00,$754.50,$126956.75,83,$754.50
2024-04-26,20:44:00,17836.5,SELL,3,0.03h,Break Even,$0.75,$755.25,$126957.50,83,$755.25
2024-04-26,20:49:00,17839.0,BUY,3,0.02h,Break Even,$0.75,$756.00,$126958.25,83,$756.00
,,,,,,,,,,,
2024-04-29,12:37:00,17906.75,SELL,3,0.02h,Break Even,$0.75,$0.75,$126959.00,84,$0.75
2024-04-29,12:41:00,17912.0,BUY,3,0.02h,Stop Loss,$23.25,$24.00,$126982.25,84,$24.00
2024-04-29,13:09:00,17915.0,SELL,3,0.02h,Break Even,$0.75,$24.75,$126983.00,84,$24.75
2024-04-29,13:31:00,17915.0,BUY,3,0.02h,Stop Loss,$338.25,$363.00,$127321.25,84,$363.00
2024-04-29,13:40:00,17896.5,SELL,3,0.02h,Stop Loss,$319.50,$682.50,$127640.75,84,$682.50
2024-04-29,14:05:00,17872.25,BUY,3,0.02h,Break Even,$0.75,$683.25,$127641.50,84,$683.25
2024-04-29,14:40:00,17877.0,SELL,3,0.02h,Stop Loss,$-18.00,$665.25,$127623.50,84,$665.25
2024-04-29,15:20:00,17888.0,BUY,3,0.02h,Stop Loss,$-18.00,$647.25,$127605.50,84,$647.25
2024-04-29,15:23:00,17876.75,SELL,3,0.02h,Stop Loss,$60.75,$708.00,$127666.25,84,$708.00
2024-04-29,15:45:00,17883.25,BUY,3,0.02h,Stop Loss,$-18.00,$690.00,$127648.25,84,$690.00
2024-04-29,16:42:00,17888.25,SELL,3,0.02h,Stop Loss,$-18.00,$672.00,$127630.25,84,$672.00
2024-04-29,16:44:00,17904.5,BUY,3,0.02h,Stop Loss,$34.50,$706.50,$127664.75,84,$706.50
2024-04-29,16:49:00,17898.75,SELL,3,0.02h,Break Even,$0.75,$707.25,$127665.50,84,$707.25
2024-04-29,17:18:00,17895.75,BUY,3,0.02h,Break Even,$0.75,$708.00,$127666.25,84,$708.00
2024-04-29,17:54:00,17916.0,SELL,3,0.02h,Break Even,$0.75,$708.75,$127667.00,84,$708.75
2024-04-29,18:47:00,17881.5,BUY,3,0.02h,Stop Loss,$15.75,$724.50,$127682.75,84,$724.50
2024-04-29,19:01:00,17852.5,SELL,3,0.02h,Stop Loss,$154.50,$879.00,$127837.25,84,$879.00
2024-04-29,19:23:00,17850.75,BUY,3,0.02h,Stop Loss,$-18.00,$861.00,$127819.25,84,$861.00
2024-04-29,20:46:00,17913.75,SELL,3,0.02h,Break Even,$0.75,$861.75,$127820.00,84,$861.75
2024-04-29,22:29:00,17912.75,BUY,3,0.02h,Stop Loss,$-18.00,$843.75,$127802.00,84,$843.75
2024-04-29,22:39:00,17909.0,SELL,3,0.02h,Stop Loss,$-18.00,$825.75,$127784.00,84,$825.75
,,,,,,,,,,,
2024-04-30,12:56:00,17834.5,BUY,3,0.02h,Stop Loss,$-18.00,$-18.00,$127766.00,85,$-18.00
2024-04-30,12:58:00,17822.0,SELL,3,0.02h,Stop Loss,$12.00,$-6.00,$127778.00,85,$-6.00
2024-04-30,13:09:00,17829.25,BUY,3,0.02h,Break Even,$0.75,$-5.25,$127778.75,85,$-5.25
2024-04-30,13:10:00,17820.75,SELL,3,0.02h,Stop Loss,$-18.00,$-23.25,$127760.75,85,$-23.25
2024-04-30,13:11:00,17832.5,BUY,3,0.02h,Break Even,$0.75,$-22.50,$127761.50,85,$-22.50
2024-04-30,14:13:00,17846.5,SELL,3,0.02h,Stop Loss,$-18.00,$-40.50,$127743.50,85,$-40.50
2024-04-30,14:16:00,17872.5,BUY,3,0.02h,Break Even,$0.75,$-39.75,$127744.25,85,$-39.75
2024-04-30,14:22:00,17858.5,SELL,3,0.02h,Stop Loss,$-18.00,$-57.75,$127726.25,85,$-57.75
2024-04-30,14:43:00,17862.75,BUY,3,0.02h,Stop Loss,$-18.00,$-75.75,$127708.25,85,$-75.75
2024-04-30,14:55:00,17841.0,SELL,3,0.02h,Stop Loss,$30.75,$-45.00,$127739.00,85,$-45.00
2024-04-30,15:58:00,17765.5,BUY,3,0.02h,Stop Loss,$-18.00,$-63.00,$127721.00,85,$-63.00
2024-04-30,16:06:00,17746.75,SELL,3,0.02h,Break Even,$0.75,$-62.25,$127721.75,85,$-62.25
2024-04-30,16:12:00,17760.5,BUY,3,0.02h,Stop Loss,$-18.00,$-80.25,$127703.75,85,$-80.25
2024-04-30,16:32:00,17743.75,SELL,3,0.02h,Stop Loss,$154.50,$74.25,$127858.25,85,$74.25
2024-04-30,17:04:00,17717.25,BUY,3,0.02h,Stop Loss,$-18.00,$56.25,$127840.25,85,$56.25
2024-04-30,17:12:00,17695.0,SELL,3,0.02h,Stop Loss,$248.25,$304.50,$128088.50,85,$304.50
2024-04-30,17:25:00,17702.5,BUY,3,0.02h,Stop Loss,$75.75,$380.25,$128164.25,85,$380.25
2024-04-30,18:14:00,17717.5,SELL,3,0.02h,Stop Loss,$-18.00,$362.25,$128146.25,85,$362.25
2024-04-30,18:39:00,17719.25,BUY,3,0.02h,Stop Loss,$-18.00,$344.25,$128128.25,85,$344.25
2024-04-30,18:46:00,17704.0,SELL,3,0.02h,Stop Loss,$45.75,$390.00,$128174.00,85,$390.00
2024-04-30,19:07:00,17695.5,BUY,3,0.02h,Stop Loss,$72.00,$462.00,$128246.00,85,$462.00
2024-04-30,19:17:00,17686.75,SELL,3,0.02h,Stop Loss,$102.00,$564.00,$128348.00,85,$564.00
2024-04-30,19:32:00,17692.75,BUY,3,0.02h,Stop Loss,$79.50,$643.50,$128427.50,85,$643.50
2024-04-30,19:45:00,17683.75,SELL,3,0.02h,Stop Loss,$-18.00,$625.50,$128409.50,85,$625.50
2024-04-30,19:49:00,17695.0,BUY,3,0.02h,Stop Loss,$154.50,$780.00,$128564.00,85,$780.00
2024-04-30,19:52:00,17664.0,SELL,3,0.02h,Stop Loss,$158.25,$938.25,$128722.25,85,$938.25
2024-04-30,22:34:00,17494.25,BUY,3,0.02h,Stop Loss,$-18.00,$920.25,$128704.25,85,$920.25
2024-04-30,22:51:00,17493.25,SELL,3,0.02h,Stop Loss,$-18.00,$902.25,$128686.25,85,$902.25
2024-04-30,22:54:00,17498.5,BUY,3,0.02h,Break Even,$0.75,$903.00,$128687.00,85,$903.00
,,,,,,,,,,,
2024-05-01,12:00:00,17446.75,SELL,3,0.02h,Stop Loss,$45.75,$45.75,$128732.75,86,$45.75
2024-05-01,12:20:00,17477.0,BUY,3,0.02h,Break Even,$0.75,$46.50,$128733.50,86,$46.50
2024-05-01,13:05:00,17496.75,SELL,3,0.02h,Break Even,$0.75,$47.25,$128734.25,86,$47.25
2024-05-01,13:07:00,17499.5,BUY,3,0.02h,Break Even,$0.75,$48.00,$128735.00,86,$48.00
2024-05-01,13:30:00,17500.25,SELL,3,0.02h,Stop Loss,$173.25,$221.25,$128908.25,86,$221.25
2024-05-01,13:31:00,17512.5,BUY,3,0.02h,Stop Loss,$-18.00,$203.25,$128890.25,86,$203.25
2024-05-01,13:32:00,17487.5,SELL,3,0.02h,Stop Loss,$102.00,$305.25,$128992.25,86,$305.25
2024-05-01,14:28:00,17477.0,BUY,3,0.02h,Stop Loss,$45.75,$351.00,$129038.00,86,$351.00
2024-05-01,15:04:00,17476.25,SELL,3,0.02h,Stop Loss,$38.25,$389.25,$129076.25,86,$389.25
2024-05-01,15:34:00,17455.0,BUY,3,0.02h,Stop Loss,$90.75,$480.00,$129167.00,86,$480.00
2024-05-01,15:52:00,17438.5,SELL,3,0.02h,Stop Loss,$30.75,$510.75,$129197.75,86,$510.75
2024-05-01,16:13:00,17455.25,BUY,3,0.02h,Stop Loss,$27.00,$537.75,$129224.75,86,$537.75
2024-05-01,16:40:00,17445.5,SELL,3,0.02h,Stop Loss,$90.75,$628.50,$129315.50,86,$628.50
2024-05-01,17:24:00,17449.0,BUY,3,0.02h,Stop Loss,$-18.00,$610.50,$129297.50,86,$610.50
2024-05-01,19:22:00,17702.0,SELL,3,0.02h,Stop Loss,$360.75,$971.25,$129658.25,86,$971.25
2024-05-01,19:27:00,17748.5,BUY,3,0.02h,Stop Loss,$184.50,$1155.75,$129842.75,86,$1155.75
2024-05-01,19:30:00,17717.75,SELL,3,0.02h,Stop Loss,$499.50,$1655.25,$130342.25,86,$1655.25
2024-05-01,20:47:00,17470.5,BUY,3,0.02h,Stop Loss,$-18.00,$1637.25,$130324.25,86,$1637.25
2024-05-01,22:52:00,17498.5,SELL,3,0.02h,Stop Loss,$-18.00,$1619.25,$130306.25,86,$1619.25
2024-05-01,22:55:00,17502.0,BUY,3,0.02h,Break Even,$0.75,$1620.00,$130307.00,86,$1620.00
,,,,,,,,,,,
2024-05-02,12:56:00,17585.0,SELL,3,0.02h,Break Even,$0.75,$0.75,$130307.75,87,$0.75
2024-05-02,13:26:00,17582.5,BUY,3,0.02h,Stop Loss,$27.00,$27.75,$130334.75,87,$27.75
2024-05-02,13:32:00,17557.75,SELL,3,0.02h,Break Even,$0.75,$28.50,$130335.50,87,$28.50
2024-05-02,14:25:00,17497.25,BUY,3,0.02h,Stop Loss,$158.25,$186.75,$130493.75,87,$186.75
2024-05-02,14:43:00,17460.75,SELL,3,0.02h,Stop Loss,$143.25,$330.00,$130637.00,87,$330.00
2024-05-02,14:51:00,17491.0,BUY,3,0.02h,Stop Loss,$68.25,$398.25,$130705.25,87,$398.25
2024-05-02,15:28:00,17519.0,SELL,3,0.02h,Stop Loss,$34.50,$432.75,$130739.75,87,$432.75
2024-05-02,15:48:00,17527.75,BUY,3,0.02h,Stop Loss,$-18.00,$414.75,$130721.75,87,$414.75
2024-05-02,16:12:00,17531.5,SELL,3,0.02h,Stop Loss,$42.00,$456.75,$130763.75,87,$456.75
2024-05-02,16:29:00,17538.75,BUY,3,0.02h,Break Even,$0.75,$457.50,$130764.50,87,$457.50
2024-05-02,16:31:00,17515.5,SELL,3,0.02h,Stop Loss,$102.00,$559.50,$130866.50,87,$559.50
2024-05-02,16:45:00,17529.25,BUY,3,0.02h,Break Even,$0.75,$560.25,$130867.25,87,$560.25
2024-05-02,16:58:00,17517.25,SELL,3,0.02h,Stop Loss,$-18.00,$542.25,$130849.25,87,$542.25
2024-05-02,17:01:00,17536.25,BUY,3,0.02h,Stop Loss,$23.25,$565.50,$130872.50,87,$565.50
2024-05-02,19:34:00,17651.5,SELL,3,0.02h,Stop Loss,$42.00,$607.50,$130914.50,87,$607.50
2024-05-02,20:01:00,17675.25,BUY,3,0.02h,Stop Loss,$45.75,$653.25,$130960.25,87,$653.25
2024-05-02,20:18:00,17650.25,SELL,3,0.02h,Break Even,$0.75,$654.00,$130961.00,87,$654.00
2024-05-02,20:29:00,17662.25,BUY,3,0.02h,Break Even,$0.75,$654.75,$130961.75,87,$654.75
2024-05-02,22:07:00,17729.0,SELL,3,0.02h,Stop Loss,$57.00,$711.75,$131018.75,87,$711.75
2024-05-02,22:14:00,17743.25,BUY,3,0.02h,Break Even,$0.75,$712.50,$131019.50,87,$712.50
2024-05-02,22:34:00,17742.5,SELL,3,0.02h,Stop Loss,$-18.00,$694.50,$131001.50,87,$694.50
,,,,,,,,,,,
2024-05-03,12:01:00,17751.0,BUY,3,0.02h,Break Even,$0.75,$0.75,$131002.25,88,$0.75
2024-05-03,12:30:00,17745.0,SELL,3,0.02h,Break Even,$0.75,$1.50,$131003.00,88,$1.50
2024-05-03,12:31:00,17898.75,BUY,3,0.02h,Stop Loss,$229.50,$231.00,$131232.50,88,$231.00
2024-05-03,14:04:00,17949.0,SELL,3,0.02h,Stop Loss,$218.25,$449.25,$131450.75,88,$449.25
2024-05-03,14:32:00,17941.5,BUY,3,0.02h,Stop Loss,$109.50,$558.75,$131560.25,88,$558.75
2024-05-03,14:33:00,17931.0,SELL,3,0.02h,Stop Loss,$45.75,$604.50,$131606.00,88,$604.50
2024-05-03,14:37:00,17950.0,BUY,3,0.02h,Stop Loss,$19.50,$624.00,$131625.50,88,$624.00
2024-05-03,14:55:00,17938.75,SELL,3,0.02h,Stop Loss,$-18.00,$606.00,$131607.50,88,$606.00
2024-05-03,15:23:00,17943.25,BUY,3,0.02h,Stop Loss,$-18.00,$588.00,$131589.50,88,$588.00
2024-05-03,16:19:00,17987.25,SELL,3,0.02h,Stop Loss,$27.00,$615.00,$131616.50,88,$615.00
2024-05-03,16:25:00,17990.75,BUY,3,0.02h,Stop Loss,$30.75,$645.75,$131647.25,88,$645.75
2024-05-03,16:33:00,17985.5,SELL,3,0.02h,Stop Loss,$-18.00,$627.75,$131629.25,88,$627.75
2024-05-03,16:37:00,17993.0,BUY,3,0.02h,Break Even,$0.75,$628.50,$131630.00,88,$628.50
2024-05-03,16:51:00,17987.0,SELL,3,0.02h,Stop Loss,$27.00,$655.50,$131657.00,88,$655.50
2024-05-03,17:09:00,17989.25,BUY,3,0.02h,Stop Loss,$-18.00,$637.50,$131639.00,88,$637.50
2024-05-03,17:32:00,17983.25,SELL,3,0.02h,Stop Loss,$195.75,$833.25,$131834.75,88,$833.25
2024-05-03,17:42:00,17997.75,BUY,3,0.02h,Stop Loss,$-18.00,$815.25,$131816.75,88,$815.25
2024-05-03,17:44:00,17980.0,SELL,3,0.02h,Break Even,$0.75,$816.00,$131817.50,88,$816.00
2024-05-03,17:50:00,17989.0,BUY,3,0.02h,Break Even,$0.75,$816.75,$131818.25,88,$816.75
2024-05-03,18:42:00,18017.0,SELL,3,0.02h,Stop Loss,$-18.00,$798.75,$131800.25,88,$798.75
2024-05-03,18:43:00,18020.75,BUY,3,0.02h,Stop Loss,$-18.00,$780.75,$131782.25,88,$780.75
2024-05-03,18:45:00,18012.5,SELL,3,0.02h,Stop Loss,$-18.00,$762.75,$131764.25,88,$762.75
2024-05-03,18:54:00,18020.25,BUY,3,0.02h,Stop Loss,$-18.00,$744.75,$131746.25,88,$744.75
2024-05-03,18:55:00,18014.0,SELL,3,0.02h,Stop Loss,$222.00,$966.75,$131968.25,88,$966.75
2024-05-03,19:07:00,18022.5,BUY,3,0.02h,Stop Loss,$-18.00,$948.75,$131950.25,88,$948.75
2024-05-03,19:19:00,18010.25,SELL,3,0.02h,Break Even,$0.75,$949.50,$131951.00,88,$949.50
2024-05-03,19:30:00,18016.25,BUY,3,0.02h,Stop Loss,$-18.00,$931.50,$131933.00,88,$931.50
2024-05-03,19:31:00,18008.75,SELL,3,0.02h,Break Even,$0.75,$932.25,$131933.75,88,$932.25
2024-05-03,20:02:00,18017.75,BUY,3,0.02h,Stop Loss,$-18.00,$914.25,$131915.75,88,$914.25
2024-05-03,20:49:00,18021.0,SELL,3,0.02h,Break Even,$0.75,$915.00,$131916.50,88,$915.00
2024-05-03,20:58:00,18023.25,BUY,3,0.02h,Stop Loss,$-18.00,$897.00,$131898.50,88,$897.00
,,,,,,,,,,,
2024-05-06,12:48:00,18059.5,SELL,3,0.02h,Stop Loss,$-18.00,$-18.00,$131880.50,89,$-18.00
2024-05-06,12:50:00,18061.75,BUY,3,0.02h,Stop Loss,$-18.00,$-36.00,$131862.50,89,$-36.00
2024-05-06,12:55:00,18059.75,SELL,3,0.02h,Break Even,$0.75,$-35.25,$131863.25,89,$-35.25
2024-05-06,13:04:00,18063.75,BUY,3,0.02h,Stop Loss,$-18.00,$-53.25,$131845.25,89,$-53.25
2024-05-06,13:07:00,18057.25,SELL,3,0.02h,Stop Loss,$-18.00,$-71.25,$131827.25,89,$-71.25
2024-05-06,13:12:00,18062.75,BUY,3,0.02h,Stop Loss,$-18.00,$-89.25,$131809.25,89,$-89.25
2024-05-06,13:14:00,18055.0,SELL,3,0.02h,Stop Loss,$-18.00,$-107.25,$131791.25,89,$-107.25
2024-05-06,13:19:00,18064.75,BUY,3,0.02h,Stop Loss,$-18.00,$-125.25,$131773.25,89,$-125.25
2024-05-06,13:32:00,18056.0,SELL,3,0.02h,Stop Loss,$154.50,$29.25,$131927.75,89,$29.25
2024-05-06,13:36:00,18076.75,BUY,3,0.02h,Stop Loss,$49.50,$78.75,$131977.25,89,$78.75
2024-05-06,14:14:00,18091.75,SELL,3,0.02h,Break Even,$0.75,$79.50,$131978.00,89,$79.50
2024-05-06,14:16:00,18099.5,BUY,3,0.02h,Break Even,$0.75,$80.25,$131978.75,89,$80.25
2024-05-06,14:17:00,18097.25,SELL,3,0.02h,Stop Loss,$135.75,$216.00,$132114.50,89,$216.00
2024-05-06,14:25:00,18100.5,BUY,3,0.02h,Stop Loss,$49.50,$265.50,$132164.00,89,$265.50
2024-05-06,14:30:00,18094.25,SELL,3,0.02h,Stop Loss,$-18.00,$247.50,$132146.00,89,$247.50
2024-05-06,14:39:00,18102.25,BUY,3,0.02h,Stop Loss,$-18.00,$229.50,$132128.00,89,$229.50
2024-05-06,14:48:00,18091.0,SELL,3,0.02h,Stop Loss,$-18.00,$211.50,$132110.00,89,$211.50
2024-05-06,14:52:00,18100.5,BUY,3,0.02h,Stop Loss,$60.75,$272.25,$132170.75,89,$272.25
2024-05-06,14:59:00,18095.0,SELL,3,0.02h,Break Even,$0.75,$273.00,$132171.50,89,$273.00
2024-05-06,15:12:00,18096.5,BUY,3,0.02h,Break Even,$0.75,$273.75,$132172.25,89,$273.75
2024-05-06,15:14:00,18087.0,SELL,3,0.02h,Stop Loss,$15.75,$289.50,$132188.00,89,$289.50
2024-05-06,15:24:00,18101.25,BUY,3,0.02h,Stop Loss,$-18.00,$271.50,$132170.00,89,$271.50
2024-05-06,16:02:00,18103.25,SELL,3,0.02h,Stop Loss,$12.00,$283.50,$132182.00,89,$283.50
2024-05-06,16:34:00,18096.5,BUY,3,0.02h,Break Even,$0.75,$284.25,$132182.75,89,$284.25
2024-05-06,16:55:00,18099.0,SELL,3,0.02h,Break Even,$0.75,$285.00,$132183.50,89,$285.00
2024-05-06,16:57:00,18104.5,BUY,3,0.02h,Stop Loss,$49.50,$334.50,$132233.00,89,$334.50
2024-05-06,17:12:00,18096.0,SELL,3,0.02h,Stop Loss,$-18.00,$316.50,$132215.00,89,$316.50
2024-05-06,17:25:00,18111.75,BUY,3,0.02h,Stop Loss,$-18.00,$298.50,$132197.00,89,$298.50
2024-05-06,18:23:00,18131.0,SELL,3,0.02h,Stop Loss,$-18.00,$280.50,$132179.00,89,$280.50
2024-05-06,18:24:00,18135.25,BUY,3,0.02h,Stop Loss,$53.25,$333.75,$132232.25,89,$333.75
2024-05-06,18:42:00,18133.75,SELL,3,0.02h,Break Even,$0.75,$334.50,$132233.00,89,$334.50
2024-05-06,18:48:00,18142.75,BUY,3,0.02h,Stop Loss,$12.00,$346.50,$132245.00,89,$346.50
2024-05-06,19:14:00,18137.5,SELL,3,0.02h,Stop Loss,$-18.00,$328.50,$132227.00,89,$328.50
2024-05-06,19:23:00,18145.25,BUY,3,0.02h,Stop Loss,$-18.00,$310.50,$132209.00,89,$310.50
2024-05-06,19:31:00,18136.5,SELL,3,0.02h,Stop Loss,$30.75,$341.25,$132239.75,89,$341.25
2024-05-06,19:38:00,18149.75,BUY,3,0.02h,Stop Loss,$-18.00,$323.25,$132221.75,89,$323.25
2024-05-06,20:56:00,18183.5,SELL,3,0.02h,Stop Loss,$-18.00,$305.25,$132203.75,89,$305.25
2024-05-06,22:17:00,18184.75,BUY,3,0.02h,Stop Loss,$-18.00,$287.25,$132185.75,89,$287.25
,,,,,,,,,,,
2024-05-07,12:00:00,18164.75,SELL,3,0.02h,Stop Loss,$-18.00,$-18.00,$132167.75,90,$-18.00
2024-05-07,12:42:00,18171.5,BUY,3,0.02h,Stop Loss,$23.25,$5.25,$132191.00,90,$5.25
2024-05-07,13:52:00,18200.75,SELL,3,0.02h,Stop Loss,$23.25,$28.50,$132214.25,90,$28.50
2024-05-07,14:14:00,18208.75,BUY,3,0.02h,Stop Loss,$105.75,$134.25,$132320.00,90,$134.25
2024-05-07,14:24:00,18191.5,SELL,3,0.02h,Stop Loss,$34.50,$168.75,$132354.50,90,$168.75
2024-05-07,14:39:00,18205.0,BUY,3,0.02h,Break Even,$0.75,$169.50,$132355.25,90,$169.50
2024-05-07,15:34:00,18236.75,SELL,3,0.02h,Break Even,$0.75,$170.25,$132356.00,90,$170.25
2024-05-07,15:45:00,18252.5,BUY,3,0.02h,Stop Loss,$-18.00,$152.25,$132338.00,90,$152.25
2024-05-07,16:23:00,18251.0,SELL,3,0.02h,Break Even,$0.75,$153.00,$132338.75,90,$153.00
2024-05-07,16:25:00,18257.5,BUY,3,0.02h,Break Even,$0.75,$153.75,$132339.50,90,$153.75
2024-05-07,16:32:00,18250.5,SELL,3,0.02h,Break Even,$0.75,$154.50,$132340.25,90,$154.50
2024-05-07,16:44:00,18258.25,BUY,3,0.02h,Stop Loss,$-18.00,$136.50,$132322.25,90,$136.50
2024-05-07,16:46:00,18245.75,SELL,3,0.02h,Break Even,$0.75,$137.25,$132323.00,90,$137.25
2024-05-07,17:09:00,18244.75,BUY,3,0.02h,Break Even,$0.75,$138.00,$132323.75,90,$138.00
2024-05-07,17:18:00,18240.0,SELL,3,0.02h,Stop Loss,$27.00,$165.00,$132350.75,90,$165.00
2024-05-07,17:21:00,18247.75,BUY,3,0.02h,Stop Loss,$12.00,$177.00,$132362.75,90,$177.00
2024-05-07,17:41:00,18240.75,SELL,3,0.02h,Stop Loss,$-18.00,$159.00,$132344.75,90,$159.00
2024-05-07,18:45:00,18191.5,BUY,3,0.02h,Stop Loss,$-18.00,$141.00,$132326.75,90,$141.00
2024-05-07,19:19:00,18186.5,SELL,3,0.02h,Stop Loss,$-18.00,$123.00,$132308.75,90,$123.00
2024-05-07,19:22:00,18201.25,BUY,3,0.02h,Stop Loss,$-18.00,$105.00,$132290.75,90,$105.00
2024-05-07,19:33:00,18192.0,SELL,3,0.02h,Break Even,$0.75,$105.75,$132291.50,90,$105.75
2024-05-07,19:37:00,18201.5,BUY,3,0.02h,Break Even,$0.75,$106.50,$132292.25,90,$106.50
2024-05-07,19:39:00,18195.0,SELL,3,0.02h,Break Even,$0.75,$107.25,$132293.00,90,$107.25
2024-05-07,19:40:00,18202.25,BUY,3,0.02h,Break Even,$0.75,$108.00,$132293.75,90,$108.00
2024-05-07,19:43:00,18193.25,SELL,3,0.02h,Break Even,$0.75,$108.75,$132294.50,90,$108.75
2024-05-07,19:49:00,18201.5,BUY,3,0.02h,Stop Loss,$23.25,$132.00,$132317.75,90,$132.00
2024-05-07,20:03:00,18199.5,SELL,3,0.02h,Stop Loss,$-18.00,$114.00,$132299.75,90,$114.00
2024-05-07,20:06:00,18208.5,BUY,3,0.02h,Break Even,$0.75,$114.75,$132300.50,90,$114.75
2024-05-07,20:31:00,18207.0,SELL,3,0.02h,Break Even,$0.75,$115.50,$132301.25,90,$115.50
2024-05-07,22:23:00,18193.75,BUY,3,0.02h,Break Even,$0.75,$116.25,$132302.00,90,$116.25
,,,,,,,,,,,
2024-05-08,12:00:00,18152.5,SELL,3,0.02h,Stop Loss,$79.50,$79.50,$132381.50,91,$79.50
2024-05-08,13:18:00,18091.0,BUY,3,0.02h,Stop Loss,$-18.00,$61.50,$132363.50,91,$61.50
2024-05-08,13:19:00,18088.25,SELL,3,0.02h,Break Even,$0.75,$62.25,$132364.25,91,$62.25
2024-05-08,13:28:00,18092.25,BUY,3,0.02h,Break Even,$0.75,$63.00,$132365.00,91,$63.00
2024-05-08,13:30:00,18083.25,SELL,3,0.02h,Stop Loss,$15.75,$78.75,$132380.75,91,$78.75
2024-05-08,13:31:00,18097.25,BUY,3,0.02h,Stop Loss,$124.50,$203.25,$132505.25,91,$203.25
2024-05-08,15:06:00,18208.0,SELL,3,0.02h,Break Even,$0.75,$204.00,$132506.00,91,$204.00
2024-05-08,16:19:00,18182.75,BUY,3,0.02h,Stop Loss,$57.00,$261.00,$132563.00,91,$261.00
2024-05-08,16:36:00,18160.25,SELL,3,0.02h,Stop Loss,$30.75,$291.75,$132593.75,91,$291.75
2024-05-08,16:50:00,18176.0,BUY,3,0.02h,Stop Loss,$-18.00,$273.75,$132575.75,91,$273.75
2024-05-08,16:51:00,18169.75,SELL,3,0.02h,Break Even,$0.75,$274.50,$132576.50,91,$274.50
2024-05-08,17:44:00,18159.75,BUY,3,0.02h,Stop Loss,$68.25,$342.75,$132644.75,91,$342.75
2024-05-08,18:27:00,18176.5,SELL,3,0.02h,Stop Loss,$-18.00,$324.75,$132626.75,91,$324.75
2024-05-08,18:29:00,18186.0,BUY,3,0.02h,Stop Loss,$-18.00,$306.75,$132608.75,91,$306.75
2024-05-08,18:42:00,18176.5,SELL,3,0.02h,Break Even,$0.75,$307.50,$132609.50,91,$307.50
2024-05-08,19:18:00,18180.25,BUY,3,0.02h,Break Even,$0.75,$308.25,$132610.25,91,$308.25
2024-05-08,20:01:00,18178.0,SELL,3,0.02h,Stop Loss,$-18.00,$290.25,$132592.25,91,$290.25
2024-05-08,20:55:00,18161.0,BUY,3,0.02h,Break Even,$0.75,$291.00,$132593.00,91,$291.00
2024-05-08,22:03:00,18158.75,SELL,3,0.02h,Break Even,$0.75,$291.75,$132593.75,91,$291.75
2024-05-08,22:06:00,18163.5,BUY,3,0.02h,Break Even,$0.75,$292.50,$132594.50,91,$292.50
2024-05-08,22:43:00,18168.25,SELL,3,0.03h,Break Even,$0.75,$293.25,$132595.25,91,$293.25
,,,,,,,,,,,
2024-05-09,12:25:00,18159.25,BUY,3,0.02h,Break Even,$0.75,$0.75,$132596.00,92,$0.75
2024-05-09,13:23:00,18196.75,SELL,3,0.02h,Break Even,$0.75,$1.50,$132596.75,92,$1.50
2024-05-09,14:01:00,18160.5,BUY,3,0.02h,Stop Loss,$42.00,$43.50,$132638.75,92,$43.50
2024-05-09,14:17:00,18148.5,SELL,3,0.02h,Stop Loss,$23.25,$66.75,$132662.00,92,$66.75
2024-05-09,14:26:00,18160.5,BUY,3,0.02h,Stop Loss,$64.50,$131.25,$132726.50,92,$131.25
2024-05-09,14:30:00,18151.25,SELL,3,0.02h,Stop Loss,$-18.00,$113.25,$132708.50,92,$113.25
2024-05-09,14:31:00,18166.25,BUY,3,0.02h,Stop Loss,$64.50,$177.75,$132773.00,92,$177.75
2024-05-09,15:42:00,18212.0,SELL,3,0.02h,Stop Loss,$-18.00,$159.75,$132755.00,92,$159.75
2024-05-09,16:15:00,18199.25,BUY,3,0.02h,Break Even,$0.75,$160.50,$132755.75,92,$160.50
2024-05-09,16:34:00,18185.5,SELL,3,0.02h,Stop Loss,$30.75,$191.25,$132786.50,92,$191.25
2024-05-09,16:38:00,18205.5,BUY,3,0.02h,Break Even,$0.75,$192.00,$132787.25,92,$192.00
2024-05-09,17:20:00,18215.25,SELL,3,0.02h,Stop Loss,$357.00,$549.00,$133144.25,92,$549.00
2024-05-09,17:31:00,18215.75,BUY,3,0.02h,Break Even,$0.75,$549.75,$133145.00,92,$549.75
2024-05-09,17:38:00,18212.5,SELL,3,0.02h,Stop Loss,$-18.00,$531.75,$133127.00,92,$531.75
2024-05-09,17:39:00,18215.0,BUY,3,0.02h,Stop Loss,$-18.00,$513.75,$133109.00,92,$513.75
2024-05-09,17:42:00,18213.0,SELL,3,0.02h,Break Even,$0.75,$514.50,$133109.75,92,$514.50
2024-05-09,17:45:00,18218.25,BUY,3,0.02h,Stop Loss,$34.50,$549.00,$133144.25,92,$549.00
2024-05-09,17:49:00,18209.25,SELL,3,0.02h,Stop Loss,$-18.00,$531.00,$133126.25,92,$531.00
2024-05-09,18:28:00,18213.75,BUY,3,0.02h,Stop Loss,$12.00,$543.00,$133138.25,92,$543.00
2024-05-09,19:11:00,18222.5,SELL,3,0.02h,Stop Loss,$38.25,$581.25,$133176.50,92,$581.25
2024-05-09,19:54:00,18211.5,BUY,3,0.02h,Break Even,$0.75,$582.00,$133177.25,92,$582.00
2024-05-09,19:56:00,18201.5,SELL,3,0.02h,Stop Loss,$23.25,$605.25,$133200.50,92,$605.25
2024-05-09,20:00:00,18215.75,BUY,3,0.02h,Stop Loss,$-18.00,$587.25,$133182.50,92,$587.25
2024-05-09,20:37:00,18228.0,SELL,3,0.03h,Break Even,$0.75,$588.00,$133183.25,92,$588.00
2024-05-09,20:40:00,18230.0,BUY,3,0.05h,Break Even,$0.75,$588.75,$133184.00,92,$588.75
2024-05-09,20:52:00,18228.25,SELL,3,0.02h,Break Even,$0.75,$589.50,$133184.75,92,$589.50
2024-05-09,22:13:00,18227.5,BUY,3,0.02h,Break Even,$0.75,$590.25,$133185.50,92,$590.25
,,,,,,,,,,,
2024-05-10,12:38:00,18277.75,SELL,3,0.02h,Stop Loss,$23.25,$23.25,$133208.75,93,$23.25
2024-05-10,13:11:00,18269.75,BUY,3,0.02h,Stop Loss,$-18.00,$5.25,$133190.75,93,$5.25
2024-05-10,14:02:00,18293.75,SELL,3,0.02h,Break Even,$0.75,$6.00,$133191.50,93,$6.00
2024-05-10,15:16:00,18232.0,BUY,3,0.02h,Break Even,$0.75,$6.75,$133192.25,93,$6.75
2024-05-10,15:38:00,18215.0,SELL,3,0.02h,Stop Loss,$-18.00,$-11.25,$133174.25,93,$-11.25
2024-05-10,15:53:00,18227.5,BUY,3,0.02h,Stop Loss,$72.00,$60.75,$133246.25,93,$60.75
2024-05-10,16:05:00,18214.0,SELL,3,0.02h,Stop Loss,$-18.00,$42.75,$133228.25,93,$42.75
2024-05-10,16:11:00,18227.75,BUY,3,0.02h,Break Even,$0.75,$43.50,$133229.00,93,$43.50
2024-05-10,16:37:00,18226.25,SELL,3,0.02h,Stop Loss,$15.75,$59.25,$133244.75,93,$59.25
2024-05-10,16:49:00,18246.5,BUY,3,0.02h,Stop Loss,$30.75,$90.00,$133275.50,93,$90.00
2024-05-10,17:06:00,18235.75,SELL,3,0.02h,Break Even,$0.75,$90.75,$133276.25,93,$90.75
2024-05-10,17:38:00,18231.75,BUY,3,0.02h,Break Even,$0.75,$91.50,$133277.00,93,$91.50
2024-05-10,17:39:00,18225.0,SELL,3,0.02h,Stop Loss,$-18.00,$73.50,$133259.00,93,$73.50
2024-05-10,17:53:00,18235.25,BUY,3,0.02h,Break Even,$0.75,$74.25,$133259.75,93,$74.25
2024-05-10,18:28:00,18247.25,SELL,3,0.02h,Stop Loss,$-18.00,$56.25,$133241.75,93,$56.25
2024-05-10,18:49:00,18248.25,BUY,3,0.02h,Stop Loss,$-18.00,$38.25,$133223.75,93,$38.25
2024-05-10,19:45:00,18250.75,SELL,3,0.02h,Break Even,$0.75,$39.00,$133224.50,93,$39.00
2024-05-10,19:55:00,18265.0,BUY,3,0.02h,Break Even,$0.75,$39.75,$133225.25,93,$39.75
2024-05-10,20:02:00,18248.5,SELL,3,0.02h,Break Even,$0.75,$40.50,$133226.00,93,$40.50
,,,,,,,,,,,
2024-05-13,12:00:00,18318.0,BUY,3,0.02h,Break Even,$0.75,$0.75,$133226.75,94,$0.75
2024-05-13,13:03:00,18312.25,SELL,3,0.02h,Stop Loss,$60.75,$61.50,$133287.50,94,$61.50
2024-05-13,13:14:00,18321.5,BUY,3,0.02h,Break Even,$0.75,$62.25,$133288.25,94,$62.25
2024-05-13,13:34:00,18310.5,SELL,3,0.02h,Stop Loss,$233.25,$295.50,$133521.50,94,$295.50
2024-05-13,14:04:00,18293.25,BUY,3,0.02h,Stop Loss,$49.50,$345.00,$133571.00,94,$345.00
2024-05-13,14:33:00,18288.25,SELL,3,0.02h,Stop Loss,$-18.00,$327.00,$133553.00,94,$327.00
2024-05-13,14:50:00,18300.25,BUY,3,0.02h,Break Even,$0.75,$327.75,$133553.75,94,$327.75
2024-05-13,15:01:00,18289.5,SELL,3,0.02h,Stop Loss,$-18.00,$309.75,$133535.75,94,$309.75
2024-05-13,15:10:00,18296.5,BUY,3,0.02h,Stop Loss,$98.25,$408.00,$133634.00,94,$408.00
2024-05-13,15:22:00,18287.0,SELL,3,0.02h,Stop Loss,$27.00,$435.00,$133661.00,94,$435.00
2024-05-13,15:53:00,18289.0,BUY,3,0.02h,Break Even,$0.75,$435.75,$133661.75,94,$435.75
2024-05-13,16:43:00,18297.25,SELL,3,0.02h,Stop Loss,$-18.00,$417.75,$133643.75,94,$417.75
2024-05-13,17:21:00,18285.75,BUY,3,0.02h,Stop Loss,$79.50,$497.25,$133723.25,94,$497.25
2024-05-13,17:39:00,18279.25,SELL,3,0.02h,Break Even,$0.75,$498.00,$133724.00,94,$498.00
2024-05-13,17:59:00,18285.0,BUY,3,0.02h,Stop Loss,$-18.00,$480.00,$133706.00,94,$480.00
2024-05-13,18:02:00,18272.5,SELL,3,0.02h,Stop Loss,$12.00,$492.00,$133718.00,94,$492.00
2024-05-13,18:14:00,18279.0,BUY,3,0.02h,Stop Loss,$-18.00,$474.00,$133700.00,94,$474.00
2024-05-13,18:17:00,18274.0,SELL,3,0.02h,Break Even,$0.75,$474.75,$133700.75,94,$474.75
2024-05-13,18:18:00,18279.0,BUY,3,0.02h,Break Even,$0.75,$475.50,$133701.50,94,$475.50
2024-05-13,18:34:00,18278.0,SELL,3,0.02h,Stop Loss,$-18.00,$457.50,$133683.50,94,$457.50
2024-05-13,18:35:00,18284.5,BUY,3,0.02h,Break Even,$0.75,$458.25,$133684.25,94,$458.25
2024-05-13,18:50:00,18278.0,SELL,3,0.02h,Break Even,$0.75,$459.00,$133685.00,94,$459.00
2024-05-13,19:00:00,18288.0,BUY,3,0.02h,Stop Loss,$-18.00,$441.00,$133667.00,94,$441.00
2024-05-13,19:25:00,18282.0,SELL,3,0.02h,Break Even,$0.75,$441.75,$133667.75,94,$441.75
2024-05-13,19:34:00,18290.75,BUY,3,0.02h,Break Even,$0.75,$442.50,$133668.50,94,$442.50
2024-05-13,19:50:00,18287.5,SELL,3,0.02h,Stop Loss,$-18.00,$424.50,$133650.50,94,$424.50
2024-05-13,19:53:00,18298.5,BUY,3,0.02h,Break Even,$0.75,$425.25,$133651.25,94,$425.25
2024-05-13,19:57:00,18285.5,SELL,3,0.02h,Stop Loss,$-18.00,$407.25,$133633.25,94,$407.25
2024-05-13,20:01:00,18295.75,BUY,3,0.02h,Stop Loss,$19.50,$426.75,$133652.75,94,$426.75
2024-05-13,20:09:00,18288.0,SELL,3,0.02h,Break Even,$0.75,$427.50,$133653.50,94,$427.50
2024-05-13,20:27:00,18290.25,BUY,3,0.07h,Break Even,$0.75,$428.25,$133654.25,94,$428.25
2024-05-13,20:41:00,18289.5,SELL,3,0.02h,Break Even,$0.75,$429.00,$133655.00,94,$429.00
2024-05-13,22:15:00,18285.5,BUY,3,0.10h,Break Even,$0.75,$429.75,$133655.75,94,$429.75
2024-05-13,22:23:00,18281.25,SELL,3,0.02h,Break Even,$0.75,$430.50,$133656.50,94,$430.50
2024-05-13,22:48:00,18281.5,BUY,3,0.07h,Break Even,$0.75,$431.25,$133657.25,94,$431.25
,,,,,,,,,,,
2024-05-14,12:31:00,18221.0,SELL,3,0.02h,Stop Loss,$248.25,$248.25,$133905.50,95,$248.25
2024-05-14,12:54:00,18269.25,BUY,3,0.02h,Break Even,$0.75,$249.00,$133906.25,95,$249.00
2024-05-14,13:01:00,18252.5,SELL,3,0.02h,Break Even,$0.75,$249.75,$133907.00,95,$249.75
2024-05-14,13:10:00,18265.0,BUY,3,0.02h,Stop Loss,$45.75,$295.50,$133952.75,95,$295.50
2024-05-14,14:00:00,18290.0,SELL,3,0.02h,Stop Loss,$23.25,$318.75,$133976.00,95,$318.75
2024-05-14,14:12:00,18307.25,BUY,3,0.02h,Stop Loss,$68.25,$387.00,$134044.25,95,$387.00
2024-05-14,14:18:00,18286.0,SELL,3,0.02h,Stop Loss,$72.00,$459.00,$134116.25,95,$459.00
2024-05-14,14:23:00,18313.5,BUY,3,0.02h,Stop Loss,$274.50,$733.50,$134390.75,95,$733.50
2024-05-14,14:39:00,18302.5,SELL,3,0.02h,Stop Loss,$34.50,$768.00,$134425.25,95,$768.00
2024-05-14,14:58:00,18324.75,BUY,3,0.02h,Stop Loss,$154.50,$922.50,$134579.75,95,$922.50
2024-05-14,15:34:00,18337.5,SELL,3,0.02h,Stop Loss,$27.00,$949.50,$134606.75,95,$949.50
2024-05-14,16:10:00,18328.25,BUY,3,0.02h,Stop Loss,$-18.00,$931.50,$134588.75,95,$931.50
2024-05-14,16:18:00,18318.75,SELL,3,0.02h,Break Even,$0.75,$932.25,$134589.50,95,$932.25
2024-05-14,16:55:00,18311.75,BUY,3,0.02h,Break Even,$0.75,$933.00,$134590.25,95,$933.00
2024-05-14,17:07:00,18302.75,SELL,3,0.02h,Break Even,$0.75,$933.75,$134591.00,95,$933.75
2024-05-14,17:23:00,18313.5,BUY,3,0.02h,Stop Loss,$12.00,$945.75,$134603.00,95,$945.75
2024-05-14,19:50:00,18413.0,SELL,3,0.02h,Stop Loss,$-18.00,$927.75,$134585.00,95,$927.75
2024-05-14,19:52:00,18424.5,BUY,3,0.02h,Stop Loss,$27.00,$954.75,$134612.00,95,$954.75
2024-05-14,20:01:00,18412.25,SELL,3,0.02h,Break Even,$0.75,$955.50,$134612.75,95,$955.50
2024-05-14,20:51:00,18410.0,BUY,3,0.02h,Stop Loss,$-18.00,$937.50,$134594.75,95,$937.50
2024-05-14,22:04:00,18405.75,SELL,3,0.02h,Stop Loss,$-18.00,$919.50,$134576.75,95,$919.50
2024-05-14,22:06:00,18411.0,BUY,3,0.02h,Break Even,$0.75,$920.25,$134577.50,95,$920.25
,,,,,,,,,,,
2024-05-15,12:00:00,18410.75,SELL,3,0.02h,Break Even,$0.75,$0.75,$134578.25,96,$0.75
2024-05-15,12:31:00,18523.25,BUY,3,0.02h,Stop Loss,$308.25,$309.00,$134886.50,96,$309.00
2024-05-15,13:22:00,18501.25,SELL,3,0.02h,Stop Loss,$-18.00,$291.00,$134868.50,96,$291.00
2024-05-15,13:25:00,18510.25,BUY,3,0.02h,Stop Loss,$-18.00,$273.00,$134850.50,96,$273.00
2024-05-15,13:26:00,18500.0,SELL,3,0.02h,Break Even,$0.75,$273.75,$134851.25,96,$273.75
2024-05-15,13:29:00,18509.0,BUY,3,0.02h,Stop Loss,$-18.00,$255.75,$134833.25,96,$255.75
2024-05-15,13:46:00,18504.5,SELL,3,0.02h,Stop Loss,$222.00,$477.75,$135055.25,96,$477.75
2024-05-15,14:04:00,18505.75,BUY,3,0.02h,Stop Loss,$60.75,$538.50,$135116.00,96,$538.50
2024-05-15,16:01:00,18582.75,SELL,3,0.02h,Stop Loss,$-18.00,$520.50,$135098.00,96,$520.50
2024-05-15,16:12:00,18601.0,BUY,3,0.02h,Stop Loss,$-18.00,$502.50,$135080.00,96,$502.50
2024-05-15,18:29:00,18683.0,SELL,3,0.02h,Stop Loss,$-18.00,$484.50,$135062.00,96,$484.50
2024-05-15,18:41:00,18689.75,BUY,3,0.02h,Stop Loss,$-18.00,$466.50,$135044.00,96,$466.50
2024-05-15,18:45:00,18680.5,SELL,3,0.02h,Stop Loss,$12.00,$478.50,$135056.00,96,$478.50
2024-05-15,18:55:00,18687.75,BUY,3,0.02h,Stop Loss,$-18.00,$460.50,$135038.00,96,$460.50
2024-05-15,19:03:00,18681.5,SELL,3,0.02h,Break Even,$0.75,$461.25,$135038.75,96,$461.25
2024-05-15,19:06:00,18687.5,BUY,3,0.02h,Stop Loss,$-18.00,$443.25,$135020.75,96,$443.25
2024-05-15,19:34:00,18688.5,SELL,3,0.02h,Break Even,$0.75,$444.00,$135021.50,96,$444.00
2024-05-15,19:57:00,18695.5,BUY,3,0.02h,Stop Loss,$34.50,$478.50,$135056.00,96,$478.50
2024-05-15,20:01:00,18681.5,SELL,3,0.02h,Stop Loss,$45.75,$524.25,$135101.75,96,$524.25
2024-05-15,20:31:00,18686.0,BUY,3,0.02h,Break Even,$0.75,$525.00,$135102.50,96,$525.00
2024-05-15,20:51:00,18684.75,SELL,3,0.02h,Break Even,$0.75,$525.75,$135103.25,96,$525.75
2024-05-15,20:57:00,18692.25,BUY,3,1.07h,Stop Loss,$57.00,$582.75,$135160.25,96,$582.75
2024-05-15,22:58:00,18698.75,SELL,3,0.02h,Stop Loss,$-18.00,$564.75,$135142.25,96,$564.75
,,,,,,,,,,,
2024-05-16,12:00:00,18715.0,BUY,3,0.02h,Stop Loss,$-18.00,$-18.00,$135124.25,97,$-18.00
2024-05-16,12:33:00,18709.25,SELL,3,0.02h,Stop Loss,$57.00,$39.00,$135181.25,97,$39.00
2024-05-16,13:39:00,18692.75,BUY,3,0.02h,Break Even,$0.75,$39.75,$135182.00,97,$39.75
2024-05-16,14:07:00,18691.0,SELL,3,0.02h,Stop Loss,$214.50,$254.25,$135396.50,97,$254.25
2024-05-16,14:19:00,18702.75,BUY,3,0.02h,Stop Loss,$42.00,$296.25,$135438.50,97,$296.25
2024-05-16,15:17:00,18732.0,SELL,3,0.02h,Stop Loss,$19.50,$315.75,$135458.00,97,$315.75
2024-05-16,15:31:00,18744.25,BUY,3,0.02h,Break Even,$0.75,$316.50,$135458.75,97,$316.50
2024-05-16,15:41:00,18734.25,SELL,3,0.02h,Break Even,$0.75,$317.25,$135459.50,97,$317.25
2024-05-16,15:53:00,18742.0,BUY,3,0.02h,Stop Loss,$12.00,$329.25,$135471.50,97,$329.25
2024-05-16,16:01:00,18731.75,SELL,3,0.02h,Stop Loss,$274.50,$603.75,$135746.00,97,$603.75
2024-05-16,16:46:00,18727.0,BUY,3,0.02h,Break Even,$0.75,$604.50,$135746.75,97,$604.50
2024-05-16,17:05:00,18724.0,SELL,3,0.02h,Break Even,$0.75,$605.25,$135747.50,97,$605.25
2024-05-16,17:09:00,18732.0,BUY,3,0.02h,Break Even,$0.75,$606.00,$135748.25,97,$606.00
2024-05-16,17:21:00,18719.5,SELL,3,0.02h,Stop Loss,$334.50,$940.50,$136082.75,97,$940.50
2024-05-16,17:55:00,18706.25,BUY,3,0.02h,Break Even,$0.75,$941.25,$136083.50,97,$941.25
2024-05-16,18:07:00,18688.5,SELL,3,0.02h,Stop Loss,$49.50,$990.75,$136133.00,97,$990.75
2024-05-16,18:35:00,18685.0,BUY,3,0.02h,Stop Loss,$23.25,$1014.00,$136156.25,97,$1014.00
2024-05-16,18:58:00,18687.0,SELL,3,0.02h,Stop Loss,$-18.00,$996.00,$136138.25,97,$996.00
2024-05-16,19:00:00,18695.25,BUY,3,0.02h,Break Even,$0.75,$996.75,$136139.00,97,$996.75
2024-05-16,19:19:00,18690.0,SELL,3,0.02h,Stop Loss,$-18.00,$978.75,$136121.00,97,$978.75
2024-05-16,19:55:00,18687.5,BUY,3,0.02h,Stop Loss,$-18.00,$960.75,$136103.00,97,$960.75
2024-05-16,19:57:00,18665.0,SELL,3,0.02h,Break Even,$0.75,$961.50,$136103.75,97,$961.50
2024-05-16,20:45:00,18642.0,BUY,3,0.02h,Stop Loss,$-18.00,$943.50,$136085.75,97,$943.50
2024-05-16,20:53:00,18639.0,SELL,3,0.03h,Break Even,$0.75,$944.25,$136086.50,97,$944.25
2024-05-16,22:01:00,18646.0,BUY,3,0.02h,Stop Loss,$-18.00,$926.25,$136068.50,97,$926.25
2024-05-16,22:35:00,18643.75,SELL,3,0.02h,Stop Loss,$-18.00,$908.25,$136050.50,97,$908.25
2024-05-16,22:42:00,18648.75,BUY,3,0.02h,Break Even,$0.75,$909.00,$136051.25,97,$909.00
,,,,,,,,,,,
2024-05-17,13:05:00,18677.75,SELL,3,0.02h,Break Even,$0.75,$0.75,$136052.00,98,$0.75
2024-05-17,14:06:00,18645.5,BUY,3,0.02h,Stop Loss,$-18.00,$-17.25,$136034.00,98,$-17.25
2024-05-17,14:07:00,18635.0,SELL,3,0.02h,Stop Loss,$38.25,$21.00,$136072.25,98,$21.00
2024-05-17,14:22:00,18646.75,BUY,3,0.02h,Stop Loss,$15.75,$36.75,$136088.00,98,$36.75
2024-05-17,15:01:00,18658.5,SELL,3,0.02h,Stop Loss,$30.75,$67.50,$136118.75,98,$67.50
2024-05-17,15:30:00,18654.75,BUY,3,0.02h,Stop Loss,$-18.00,$49.50,$136100.75,98,$49.50
2024-05-17,15:32:00,18647.0,SELL,3,0.02h,Stop Loss,$23.25,$72.75,$136124.00,98,$72.75
2024-05-17,15:56:00,18646.0,BUY,3,0.02h,Break Even,$0.75,$73.50,$136124.75,98,$73.50
2024-05-17,16:13:00,18643.25,SELL,3,0.02h,Break Even,$0.75,$74.25,$136125.50,98,$74.25
2024-05-17,16:55:00,18637.75,BUY,3,0.02h,Break Even,$0.75,$75.00,$136126.25,98,$75.00
2024-05-17,17:07:00,18630.0,SELL,3,0.02h,Stop Loss,$-18.00,$57.00,$136108.25,98,$57.00
2024-05-17,17:43:00,18626.0,BUY,3,0.02h,Break Even,$0.75,$57.75,$136109.00,98,$57.75
2024-05-17,17:48:00,18620.0,SELL,3,0.02h,Stop Loss,$-18.00,$39.75,$136091.00,98,$39.75
2024-05-17,18:39:00,18581.25,BUY,3,0.02h,Stop Loss,$19.50,$59.25,$136110.50,98,$59.25
2024-05-17,18:45:00,18577.0,SELL,3,0.02h,Stop Loss,$-18.00,$41.25,$136092.50,98,$41.25
2024-05-17,18:49:00,18585.75,BUY,3,0.02h,Stop Loss,$57.00,$98.25,$136149.50,98,$98.25
2024-05-17,19:47:00,18626.5,SELL,3,0.02h,Break Even,$0.75,$99.00,$136150.25,98,$99.00
2024-05-17,19:53:00,18631.0,BUY,3,0.02h,Break Even,$0.75,$99.75,$136151.00,98,$99.75
2024-05-17,19:57:00,18625.0,SELL,3,0.02h,Stop Loss,$45.75,$145.50,$136196.75,98,$145.50
2024-05-17,20:00:00,18638.5,BUY,3,0.02h,Break Even,$0.75,$146.25,$136197.50,98,$146.25
2024-05-17,20:01:00,18623.25,SELL,3,0.02h,Break Even,$0.75,$147.00,$136198.25,98,$147.00
2024-05-17,20:19:00,18628.75,BUY,3,0.02h,Break Even,$0.75,$147.75,$136199.00,98,$147.75
,,,,,,,,,,,
2024-05-20,12:29:00,18673.25,SELL,3,0.02h,Break Even,$0.75,$0.75,$136199.75,99,$0.75
2024-05-20,13:16:00,18652.5,BUY,3,0.02h,Break Even,$0.75,$1.50,$136200.50,99,$1.50
2024-05-20,13:26:00,18645.25,SELL,3,0.02h,Stop Loss,$38.25,$39.75,$136238.75,99,$39.75
2024-05-20,13:33:00,18665.5,BUY,3,0.02h,Stop Loss,$188.25,$228.00,$136427.00,99,$228.00
2024-05-20,14:58:00,18742.5,SELL,3,0.02h,Stop Loss,$30.75,$258.75,$136457.75,99,$258.75
2024-05-20,15:26:00,18752.5,BUY,3,0.02h,Stop Loss,$-18.00,$240.75,$136439.75,99,$240.75
2024-05-20,15:44:00,18740.5,SELL,3,0.02h,Break Even,$0.75,$241.50,$136440.50,99,$241.50
2024-05-20,16:03:00,18748.5,BUY,3,0.02h,Stop Loss,$-18.00,$223.50,$136422.50,99,$223.50
2024-05-20,16:16:00,18745.5,SELL,3,0.02h,Stop Loss,$15.75,$239.25,$136438.25,99,$239.25
2024-05-20,16:19:00,18752.0,BUY,3,0.02h,Stop Loss,$-18.00,$221.25,$136420.25,99,$221.25
2024-05-20,16:25:00,18746.25,SELL,3,0.02h,Break Even,$0.75,$222.00,$136421.00,99,$222.00
2024-05-20,16:33:00,18752.5,BUY,3,0.02h,Stop Loss,$-18.00,$204.00,$136403.00,99,$204.00
2024-05-20,17:21:00,18776.25,SELL,3,0.02h,Stop Loss,$42.00,$246.00,$136445.00,99,$246.00
2024-05-20,18:28:00,18745.25,BUY,3,0.02h,Break Even,$0.75,$246.75,$136445.75,99,$246.75
2024-05-20,18:59:00,18752.75,SELL,3,0.02h,Stop Loss,$30.75,$277.50,$136476.50,99,$277.50
2024-05-20,19:06:00,18760.0,BUY,3,0.02h,Stop Loss,$-18.00,$259.50,$136458.50,99,$259.50
2024-05-20,19:37:00,18765.25,SELL,3,0.02h,Break Even,$0.75,$260.25,$136459.25,99,$260.25
2024-05-20,20:02:00,18773.0,BUY,3,0.02h,Stop Loss,$-18.00,$242.25,$136441.25,99,$242.25
2024-05-20,20:07:00,18748.5,SELL,3,0.02h,Break Even,$0.75,$243.00,$136442.00,99,$243.00
2024-05-20,20:35:00,18748.75,BUY,3,0.02h,Break Even,$0.75,$243.75,$136442.75,99,$243.75
2024-05-20,20:46:00,18744.25,SELL,3,0.02h,Break Even,$0.75,$244.50,$136443.50,99,$244.50
2024-05-20,20:55:00,18748.0,BUY,3,0.02h,Stop Loss,$-18.00,$226.50,$136425.50,99,$226.50
2024-05-20,21:00:00,18745.5,SELL,3,1.02h,Break Even,$0.75,$227.25,$136426.25,99,$227.25
2024-05-20,22:01:00,18752.25,BUY,3,0.02h,Break Even,$0.75,$228.00,$136427.00,99,$228.00
2024-05-20,22:21:00,18748.75,SELL,3,0.02h,Stop Loss,$-18.00,$210.00,$136409.00,99,$210.00
,,,,,,,,,,,
2024-05-21,12:00:00,18750.5,BUY,3,0.02h,Stop Loss,$-18.00,$-18.00,$136391.00,100,$-18.00
2024-05-21,12:16:00,18742.5,SELL,3,0.02h,Break Even,$0.75,$-17.25,$136391.75,100,$-17.25
2024-05-21,13:37:00,18712.5,BUY,3,0.02h,Stop Loss,$-18.00,$-35.25,$136373.75,100,$-35.25
2024-05-21,13:47:00,18685.0,SELL,3,0.02h,Stop Loss,$-18.00,$-53.25,$136355.75,100,$-53.25
2024-05-21,13:53:00,18712.5,BUY,3,0.02h,Stop Loss,$27.00,$-26.25,$136382.75,100,$-26.25
2024-05-21,15:33:00,18748.0,SELL,3,0.02h,Stop Loss,$-18.00,$-44.25,$136364.75,100,$-44.25
2024-05-21,16:07:00,18748.25,BUY,3,0.02h,Break Even,$0.75,$-43.50,$136365.50,100,$-43.50
2024-05-21,16:36:00,18757.75,SELL,3,0.02h,Break Even,$0.75,$-42.75,$136366.25,100,$-42.75
2024-05-21,17:28:00,18751.5,BUY,3,0.02h,Stop Loss,$30.75,$-12.00,$136397.00,100,$-12.00
2024-05-21,18:18:00,18767.5,SELL,3,0.02h,Stop Loss,$-18.00,$-30.00,$136379.00,100,$-30.00
2024-05-21,18:53:00,18768.25,BUY,3,0.02h,Stop Loss,$-18.00,$-48.00,$136361.00,100,$-48.00
2024-05-21,19:28:00,18769.75,SELL,3,0.02h,Stop Loss,$-18.00,$-66.00,$136343.00,100,$-66.00
2024-05-21,19:32:00,18781.25,BUY,3,0.02h,Break Even,$0.75,$-65.25,$136343.75,100,$-65.25
2024-05-21,19:51:00,18781.0,SELL,3,0.02h,Break Even,$0.75,$-64.50,$136344.50,100,$-64.50
2024-05-21,19:53:00,18791.25,BUY,3,0.02h,Break Even,$0.75,$-63.75,$136345.25,100,$-63.75
2024-05-21,20:57:00,18803.5,SELL,3,0.02h,Break Even,$0.75,$-63.00,$136346.00,100,$-63.00
2024-05-21,22:21:00,18803.25,BUY,3,0.02h,Break Even,$0.75,$-62.25,$136346.75,100,$-62.25
,,,,,,,,,,,
2024-05-22,12:00:00,18792.5,SELL,3,0.02h,Stop Loss,$-18.00,$-18.00,$136328.75,101,$-18.00
2024-05-22,12:41:00,18796.75,BUY,3,0.02h,Stop Loss,$-18.00,$-36.00,$136310.75,101,$-36.00
2024-05-22,13:10:00,18795.5,SELL,3,0.02h,Break Even,$0.75,$-35.25,$136311.50,101,$-35.25
2024-05-22,13:19:00,18807.0,BUY,3,0.02h,Break Even,$0.75,$-34.50,$136312.25,101,$-34.50
2024-05-22,13:42:00,18799.0,SELL,3,0.02h,Stop Loss,$23.25,$-11.25,$136335.50,101,$-11.25
2024-05-22,13:47:00,18816.5,BUY,3,0.02h,Break Even,$0.75,$-10.50,$136336.25,101,$-10.50
2024-05-22,14:09:00,18811.25,SELL,3,0.02h,Stop Loss,$-18.00,$-28.50,$136318.25,101,$-28.50
2024-05-22,14:15:00,18825.0,BUY,3,0.02h,Stop Loss,$12.00,$-16.50,$136330.25,101,$-16.50
2024-05-22,14:23:00,18806.25,SELL,3,0.02h,Stop Loss,$-18.00,$-34.50,$136312.25,101,$-34.50
2024-05-22,14:42:00,18816.5,BUY,3,0.02h,Stop Loss,$30.75,$-3.75,$136343.00,101,$-3.75
2024-05-22,14:44:00,18808.75,SELL,3,0.02h,Stop Loss,$60.75,$57.00,$136403.75,101,$57.00
2024-05-22,14:58:00,18818.75,BUY,3,0.02h,Stop Loss,$19.50,$76.50,$136423.25,101,$76.50
2024-05-22,15:42:00,18831.5,SELL,3,0.03h,Break Even,$0.75,$77.25,$136424.00,101,$77.25
2024-05-22,16:09:00,18828.0,BUY,3,0.02h,Stop Loss,$-18.00,$59.25,$136406.00,101,$59.25
2024-05-22,16:27:00,18823.0,SELL,3,0.02h,Break Even,$0.75,$60.00,$136406.75,101,$60.00
2024-05-22,17:07:00,18809.25,BUY,3,0.02h,Break Even,$0.75,$60.75,$136407.50,101,$60.75
2024-05-22,17:33:00,18810.75,SELL,3,0.02h,Stop Loss,$30.75,$91.50,$136438.25,101,$91.50
2024-05-22,18:49:00,18721.75,BUY,3,0.02h,Stop Loss,$132.00,$223.50,$136570.25,101,$223.50
2024-05-22,19:20:00,18702.25,SELL,3,0.02h,Stop Loss,$-18.00,$205.50,$136552.25,101,$205.50
2024-05-22,19:25:00,18737.5,BUY,3,0.02h,Break Even,$0.75,$206.25,$136553.00,101,$206.25
2024-05-22,19:47:00,18745.0,SELL,3,0.02h,Break Even,$0.75,$207.00,$136553.75,101,$207.00
2024-05-22,19:57:00,18762.25,BUY,3,0.02h,Stop Loss,$94.50,$301.50,$136648.25,101,$301.50
2024-05-22,20:34:00,18800.25,SELL,3,0.02h,Stop Loss,$469.50,$771.00,$137117.75,101,$771.00
2024-05-22,20:45:00,18821.0,BUY,3,0.02h,Stop Loss,$42.00,$813.00,$137159.75,101,$813.00
,,,,,,,,,,,
2024-05-23,12:59:00,19005.5,SELL,3,0.02h,Break Even,$0.75,$0.75,$137160.50,102,$0.75
2024-05-23,14:13:00,18898.0,BUY,3,0.02h,Stop Loss,$38.25,$39.00,$137198.75,102,$39.00
2024-05-23,14:23:00,18864.0,SELL,3,0.02h,Stop Loss,$-18.00,$21.00,$137180.75,102,$21.00
2024-05-23,14:32:00,18888.0,BUY,3,0.02h,Stop Loss,$263.25,$284.25,$137444.00,102,$284.25
2024-05-23,14:47:00,18885.75,SELL,3,0.02h,Stop Loss,$169.50,$453.75,$137613.50,102,$453.75
2024-05-23,15:09:00,18870.5,BUY,3,0.02h,Stop Loss,$255.75,$709.50,$137869.25,102,$709.50
2024-05-23,16:09:00,18910.0,SELL,3,0.02h,Stop Loss,$57.00,$766.50,$137926.25,102,$766.50
2024-05-23,16:24:00,18913.5,BUY,3,0.02h,Stop Loss,$30.75,$797.25,$137957.00,102,$797.25
2024-05-23,16:43:00,18909.0,SELL,3,0.02h,Stop Loss,$94.50,$891.75,$138051.50,102,$891.75
2024-05-23,19:18:00,18654.5,BUY,3,0.02h,Stop Loss,$30.75,$922.50,$138082.25,102,$922.50
2024-05-23,20:26:00,18689.25,SELL,3,0.07h,Stop Loss,$-18.00,$904.50,$138064.25,102,$904.50
2024-05-23,22:01:00,18687.75,BUY,3,0.02h,Stop Loss,$-18.00,$886.50,$138046.25,102,$886.50
2024-05-23,22:15:00,18683.75,SELL,3,0.02h,Break Even,$0.75,$887.25,$138047.00,102,$887.25
2024-05-23,22:21:00,18689.75,BUY,3,0.02h,Stop Loss,$-18.00,$869.25,$138029.00,102,$869.25
,,,,,,,,,,,
2024-05-24,12:26:00,18728.75,SELL,3,0.02h,Break Even,$0.75,$0.75,$138029.75,103,$0.75
2024-05-24,12:32:00,18745.25,BUY,3,0.02h,Stop Loss,$90.75,$91.50,$138120.50,103,$91.50
2024-05-24,12:55:00,18745.75,SELL,3,0.02h,Break Even,$0.75,$92.25,$138121.25,103,$92.25
2024-05-24,13:02:00,18766.0,BUY,3,0.02h,Break Even,$0.75,$93.00,$138122.00,103,$93.00
2024-05-24,13:07:00,18751.0,SELL,3,0.02h,Break Even,$0.75,$93.75,$138122.75,103,$93.75
2024-05-24,13:29:00,18761.0,BUY,3,0.02h,Stop Loss,$87.00,$180.75,$138209.75,103,$180.75
2024-05-24,13:41:00,18745.0,SELL,3,0.02h,Stop Loss,$19.50,$200.25,$138229.25,103,$200.25
2024-05-24,13:43:00,18759.5,BUY,3,0.02h,Stop Loss,$132.00,$332.25,$138361.25,103,$332.25
2024-05-24,13:53:00,18748.5,SELL,3,0.02h,Stop Loss,$120.75,$453.00,$138482.00,103,$453.00
2024-05-24,14:01:00,18792.25,BUY,3,0.02h,Stop Loss,$38.25,$491.25,$138520.25,103,$491.25
2024-05-24,15:39:00,18893.0,SELL,3,0.02h,Stop Loss,$83.25,$574.50,$138603.50,103,$574.50
2024-05-24,15:45:00,18906.5,BUY,3,0.02h,Stop Loss,$-18.00,$556.50,$138585.50,103,$556.50
2024-05-24,15:46:00,18900.0,SELL,3,0.02h,Stop Loss,$27.00,$583.50,$138612.50,103,$583.50
2024-05-24,16:08:00,18900.75,BUY,3,0.02h,Break Even,$0.75,$584.25,$138613.25,103,$584.25
2024-05-24,16:09:00,18893.5,SELL,3,0.02h,Stop Loss,$-18.00,$566.25,$138595.25,103,$566.25
2024-05-24,16:11:00,18900.5,BUY,3,0.02h,Stop Loss,$19.50,$585.75,$138614.75,103,$585.75
2024-05-24,16:37:00,18894.75,SELL,3,0.02h,Stop Loss,$-18.00,$567.75,$138596.75,103,$567.75
2024-05-24,16:55:00,18909.0,BUY,3,0.02h,Stop Loss,$-18.00,$549.75,$138578.75,103,$549.75
2024-05-24,16:57:00,18889.75,SELL,3,0.02h,Stop Loss,$12.00,$561.75,$138590.75,103,$561.75
2024-05-24,17:21:00,18889.25,BUY,3,0.02h,Stop Loss,$-18.00,$543.75,$138572.75,103,$543.75
2024-05-24,17:22:00,18885.75,SELL,3,0.02h,Stop Loss,$-18.00,$525.75,$138554.75,103,$525.75
2024-05-24,17:23:00,18891.25,BUY,3,0.02h,Stop Loss,$-18.00,$507.75,$138536.75,103,$507.75
2024-05-24,17:34:00,18882.5,SELL,3,0.02h,Break Even,$0.75,$508.50,$138537.50,103,$508.50
2024-05-24,17:52:00,18895.75,BUY,3,0.02h,Stop Loss,$-18.00,$490.50,$138519.50,103,$490.50
2024-05-24,18:24:00,18903.25,SELL,3,0.02h,Stop Loss,$87.00,$577.50,$138606.50,103,$577.50
2024-05-24,19:28:00,18869.5,BUY,3,0.02h,Stop Loss,$-18.00,$559.50,$138588.50,103,$559.50
2024-05-24,19:30:00,18862.25,SELL,3,0.02h,Stop Loss,$38.25,$597.75,$138626.75,103,$597.75
2024-05-24,19:32:00,18872.5,BUY,3,0.02h,Stop Loss,$-18.00,$579.75,$138608.75,103,$579.75
2024-05-24,19:46:00,18866.5,SELL,3,0.02h,Break Even,$0.75,$580.50,$138609.50,103,$580.50
2024-05-24,20:00:00,18874.0,BUY,3,0.02h,Stop Loss,$49.50,$630.00,$138659.00,103,$630.00
2024-05-24,20:21:00,18867.25,SELL,3,0.02h,Stop Loss,$-18.00,$612.00,$138641.00,103,$612.00
2024-05-24,20:26:00,18870.25,BUY,3,0.02h,Stop Loss,$-18.00,$594.00,$138623.00,103,$594.00
2024-05-24,20:29:00,18868.0,SELL,3,0.03h,Break Even,$0.75,$594.75,$138623.75,103,$594.75
2024-05-24,20:35:00,18871.0,BUY,3,0.02h,Stop Loss,$-18.00,$576.75,$138605.75,103,$576.75
,,,,,,,,,,,
2024-05-27,12:38:00,18874.25,SELL,3,0.02h,Stop Loss,$-18.00,$-18.00,$138587.75,104,$-18.00
2024-05-27,13:10:00,18875.25,BUY,3,0.02h,Break Even,$0.75,$-17.25,$138588.50,104,$-17.25
2024-05-27,13:53:00,18890.0,SELL,3,0.02h,Stop Loss,$38.25,$21.00,$138626.75,104,$21.00
2024-05-27,14:35:00,18884.0,BUY,3,0.02h,Stop Loss,$15.75,$36.75,$138642.50,104,$36.75
2024-05-27,16:12:00,18934.75,SELL,3,0.02h,Stop Loss,$-18.00,$18.75,$138624.50,104,$18.75
2024-05-27,16:14:00,18939.75,BUY,3,0.02h,Stop Loss,$-18.00,$0.75,$138606.50,104,$0.75
2024-05-27,16:41:00,18943.25,SELL,3,0.02h,Stop Loss,$-18.00,$-17.25,$138588.50,104,$-17.25
2024-05-27,16:42:00,18945.5,BUY,3,0.02h,Stop Loss,$-18.00,$-35.25,$138570.50,104,$-35.25
2024-05-27,16:43:00,18942.0,SELL,3,0.02h,Stop Loss,$-18.00,$-53.25,$138552.50,104,$-53.25
2024-05-27,16:47:00,18951.0,BUY,3,0.02h,Stop Loss,$-18.00,$-71.25,$138534.50,104,$-71.25
2024-05-27,22:01:00,18938.0,SELL,3,0.02h,Stop Loss,$27.00,$-44.25,$138561.50,104,$-44.25
2024-05-27,22:52:00,18917.5,BUY,3,0.02h,Break Even,$0.75,$-43.50,$138562.25,104,$-43.50
,,,,,,,,,,,
2024-05-28,12:20:00,18919.25,SELL,3,0.02h,Stop Loss,$-18.00,$-18.00,$138544.25,105,$-18.00
2024-05-28,12:26:00,18927.75,BUY,3,0.02h,Break Even,$0.75,$-17.25,$138545.00,105,$-17.25
2024-05-28,12:32:00,18916.75,SELL,3,0.02h,Stop Loss,$-18.00,$-35.25,$138527.00,105,$-35.25
2024-05-28,12:40:00,18925.75,BUY,3,0.02h,Break Even,$0.75,$-34.50,$138527.75,105,$-34.50
2024-05-28,12:43:00,18918.5,SELL,3,0.02h,Break Even,$0.75,$-33.75,$138528.50,105,$-33.75
2024-05-28,13:01:00,18919.25,BUY,3,0.02h,Stop Loss,$-18.00,$-51.75,$138510.50,105,$-51.75
2024-05-28,13:02:00,18913.75,SELL,3,0.02h,Stop Loss,$23.25,$-28.50,$138533.75,105,$-28.50
2024-05-28,13:13:00,18916.0,BUY,3,0.02h,Stop Loss,$34.50,$6.00,$138568.25,105,$6.00
2024-05-28,13:35:00,18911.0,SELL,3,0.02h,Stop Loss,$15.75,$21.75,$138584.00,105,$21.75
2024-05-28,14:06:00,18880.5,BUY,3,0.02h,Stop Loss,$147.00,$168.75,$138731.00,105,$168.75
2024-05-28,14:39:00,18885.75,SELL,3,0.02h,Stop Loss,$45.75,$214.50,$138776.75,105,$214.50
2024-05-28,14:43:00,18901.0,BUY,3,0.02h,Stop Loss,$27.00,$241.50,$138803.75,105,$241.50
2024-05-28,15:07:00,18904.5,SELL,3,0.02h,Stop Loss,$-18.00,$223.50,$138785.75,105,$223.50
2024-05-28,15:13:00,18917.25,BUY,3,0.02h,Break Even,$0.75,$224.25,$138786.50,105,$224.25
2024-05-28,15:17:00,18904.75,SELL,3,0.02h,Stop Loss,$-18.00,$206.25,$138768.50,105,$206.25
2024-05-28,15:20:00,18917.0,BUY,3,0.02h,Break Even,$0.75,$207.00,$138769.25,105,$207.00
2024-05-28,15:57:00,18921.25,SELL,3,0.02h,Stop Loss,$-18.00,$189.00,$138751.25,105,$189.00
2024-05-28,16:02:00,18929.5,BUY,3,0.02h,Stop Loss,$-18.00,$171.00,$138733.25,105,$171.00
2024-05-28,16:06:00,18920.25,SELL,3,0.02h,Stop Loss,$12.00,$183.00,$138745.25,105,$183.00
2024-05-28,16:14:00,18931.0,BUY,3,0.02h,Stop Loss,$27.00,$210.00,$138772.25,105,$210.00
2024-05-28,16:18:00,18915.75,SELL,3,0.02h,Break Even,$0.75,$210.75,$138773.00,105,$210.75
2024-05-28,16:37:00,18926.75,BUY,3,0.02h,Stop Loss,$-18.00,$192.75,$138755.00,105,$192.75
2024-05-28,16:59:00,18922.5,SELL,3,0.02h,Break Even,$0.75,$193.50,$138755.75,105,$193.50
2024-05-28,17:15:00,18926.5,BUY,3,0.02h,Stop Loss,$-18.00,$175.50,$138737.75,105,$175.50
2024-05-28,17:16:00,18921.5,SELL,3,0.02h,Stop Loss,$12.00,$187.50,$138749.75,105,$187.50
2024-05-28,17:19:00,18927.25,BUY,3,0.02h,Stop Loss,$23.25,$210.75,$138773.00,105,$210.75
2024-05-28,17:23:00,18919.25,SELL,3,0.02h,Break Even,$0.75,$211.50,$138773.75,105,$211.50
2024-05-28,17:26:00,18925.0,BUY,3,0.02h,Stop Loss,$-18.00,$193.50,$138755.75,105,$193.50
2024-05-28,17:27:00,18921.5,SELL,3,0.02h,Stop Loss,$-18.00,$175.50,$138737.75,105,$175.50
2024-05-28,17:28:00,18927.25,BUY,3,0.02h,Stop Loss,$-18.00,$157.50,$138719.75,105,$157.50
2024-05-28,17:48:00,18926.5,SELL,3,0.02h,Stop Loss,$42.00,$199.50,$138761.75,105,$199.50
2024-05-28,18:09:00,18916.5,BUY,3,0.02h,Break Even,$0.75,$200.25,$138762.50,105,$200.25
2024-05-28,18:18:00,18903.0,SELL,3,0.02h,Stop Loss,$79.50,$279.75,$138842.00,105,$279.75
2024-05-28,18:58:00,18861.0,BUY,3,0.02h,Stop Loss,$90.75,$370.50,$138932.75,105,$370.50
2024-05-28,19:48:00,18883.75,SELL,3,0.02h,Stop Loss,$105.75,$476.25,$139038.50,105,$476.25
2024-05-28,19:54:00,18900.5,BUY,3,0.02h,Stop Loss,$12.00,$488.25,$139050.50,105,$488.25
2024-05-28,22:02:00,18939.25,SELL,3,0.02h,Break Even,$0.75,$489.00,$139051.25,105,$489.00
2024-05-28,22:48:00,18940.75,BUY,3,0.15h,Break Even,$0.75,$489.75,$139052.00,105,$489.75
,,,,,,,,,,,
2024-05-29,12:00:00,18817.75,SELL,3,0.02h,Stop Loss,$-18.00,$-18.00,$139034.00,106,$-18.00
2024-05-29,13:31:00,18797.75,BUY,3,0.02h,Stop Loss,$64.50,$46.50,$139098.50,106,$46.50
2024-05-29,15:04:00,18858.75,SELL,3,0.02h,Break Even,$0.75,$47.25,$139099.25,106,$47.25
2024-05-29,15:27:00,18854.25,BUY,3,0.02h,Stop Loss,$27.00,$74.25,$139126.25,106,$74.25
2024-05-29,15:33:00,18840.0,SELL,3,0.02h,Stop Loss,$79.50,$153.75,$139205.75,106,$153.75
2024-05-29,15:55:00,18849.0,BUY,3,0.02h,Stop Loss,$38.25,$192.00,$139244.00,106,$192.00
2024-05-29,16:10:00,18841.25,SELL,3,0.02h,Stop Loss,$203.25,$395.25,$139447.25,106,$395.25
2024-05-29,16:22:00,18845.0,BUY,3,0.02h,Stop Loss,$42.00,$437.25,$139489.25,106,$437.25
2024-05-29,17:03:00,18852.25,SELL,3,0.02h,Stop Loss,$34.50,$471.75,$139523.75,106,$471.75
2024-05-29,17:31:00,18851.0,BUY,3,0.02h,Break Even,$0.75,$472.50,$139524.50,106,$472.50
2024-05-29,17:34:00,18842.25,SELL,3,0.02h,Stop Loss,$72.00,$544.50,$139596.50,106,$544.50
2024-05-29,17:52:00,18849.5,BUY,3,0.02h,Stop Loss,$147.00,$691.50,$139743.50,106,$691.50
2024-05-29,18:21:00,18850.75,SELL,3,0.02h,Stop Loss,$-18.00,$673.50,$139725.50,106,$673.50
2024-05-29,19:16:00,18836.0,BUY,3,0.02h,Break Even,$0.75,$674.25,$139726.25,106,$674.25
2024-05-29,19:45:00,18836.75,SELL,3,0.02h,Stop Loss,$30.75,$705.00,$139757.00,106,$705.00
,,,,,,,,,,,
2024-05-30,12:00:00,18745.5,BUY,3,0.02h,Stop Loss,$-18.00,$-18.00,$139739.00,107,$-18.00
2024-05-30,12:56:00,18768.75,SELL,3,0.02h,Stop Loss,$72.00,$54.00,$139811.00,107,$54.00
2024-05-30,13:25:00,18766.0,BUY,3,0.02h,Break Even,$0.75,$54.75,$139811.75,107,$54.75
2024-05-30,13:33:00,18758.0,SELL,3,0.02h,Stop Loss,$195.75,$250.50,$140007.50,107,$250.50
2024-05-30,14:07:00,18746.5,BUY,3,0.02h,Break Even,$0.75,$251.25,$140008.25,107,$251.25
2024-05-30,14:11:00,18725.5,SELL,3,0.02h,Stop Loss,$334.50,$585.75,$140342.75,107,$585.75
2024-05-30,15:23:00,18657.0,BUY,3,0.02h,Stop Loss,$15.75,$601.50,$140358.50,107,$601.50
2024-05-30,15:59:00,18675.0,SELL,3,0.02h,Stop Loss,$72.00,$673.50,$140430.50,107,$673.50
2024-05-30,16:05:00,18692.75,BUY,3,0.02h,Stop Loss,$57.00,$730.50,$140487.50,107,$730.50
2024-05-30,16:30:00,18686.0,SELL,3,0.02h,Stop Loss,$15.75,$746.25,$140503.25,107,$746.25
2024-05-30,16:34:00,18696.0,BUY,3,0.02h,Stop Loss,$34.50,$780.75,$140537.75,107,$780.75
2024-05-30,16:44:00,18689.0,SELL,3,0.02h,Stop Loss,$-18.00,$762.75,$140519.75,107,$762.75
2024-05-30,16:54:00,18698.5,BUY,3,0.02h,Stop Loss,$27.00,$789.75,$140546.75,107,$789.75
2024-05-30,16:58:00,18688.5,SELL,3,0.02h,Stop Loss,$-18.00,$771.75,$140528.75,107,$771.75
2024-05-30,17:00:00,18696.5,BUY,3,0.02h,Stop Loss,$-18.00,$753.75,$140510.75,107,$753.75
2024-05-30,17:49:00,18706.75,SELL,3,0.02h,Stop Loss,$12.00,$765.75,$140522.75,107,$765.75
2024-05-30,19:16:00,18670.0,BUY,3,0.02h,Break Even,$0.75,$766.50,$140523.50,107,$766.50
2024-05-30,19:19:00,18664.5,SELL,3,0.02h,Stop Loss,$98.25,$864.75,$140621.75,107,$864.75
2024-05-30,20:28:00,18581.0,BUY,3,0.02h,Stop Loss,$124.50,$989.25,$140746.25,107,$989.25
2024-05-30,20:54:00,18584.25,SELL,3,0.02h,Stop Loss,$-18.00,$971.25,$140728.25,107,$971.25
2024-05-30,20:59:00,18591.5,BUY,3,0.02h,Stop Loss,$45.75,$1017.00,$140774.00,107,$1017.00
2024-05-30,22:01:00,18570.0,SELL,3,0.02h,Break Even,$0.75,$1017.75,$140774.75,107,$1017.75
2024-05-30,22:34:00,18570.25,BUY,3,0.02h,Stop Loss,$-18.00,$999.75,$140756.75,107,$999.75
2024-05-30,22:54:00,18570.75,SELL,3,0.03h,Break Even,$0.75,$1000.50,$140757.50,107,$1000.50
,,,,,,,,,,,
2024-05-31,12:24:00,18569.0,BUY,3,0.02h,Break Even,$0.75,$0.75,$140758.25,108,$0.75
2024-05-31,13:07:00,18638.25,SELL,3,0.02h,Stop Loss,$30.75,$31.50,$140789.00,108,$31.50
2024-05-31,13:44:00,18627.25,BUY,3,0.02h,Break Even,$0.75,$32.25,$140789.75,108,$32.25
2024-05-31,13:46:00,18589.25,SELL,3,0.02h,Stop Loss,$188.25,$220.50,$140978.00,108,$220.50
2024-05-31,16:41:00,18279.5,BUY,3,0.02h,Stop Loss,$64.50,$285.00,$141042.50,108,$285.00
2024-05-31,17:43:00,18334.5,SELL,3,0.02h,Break Even,$0.75,$285.75,$141043.25,108,$285.75
2024-05-31,17:46:00,18354.25,BUY,3,0.02h,Break Even,$0.75,$286.50,$141044.00,108,$286.50
2024-05-31,17:55:00,18340.0,SELL,3,0.02h,Stop Loss,$-18.00,$268.50,$141026.00,108,$268.50
2024-05-31,18:19:00,18339.75,BUY,3,0.02h,Break Even,$0.75,$269.25,$141026.75,108,$269.25
2024-05-31,18:24:00,18335.75,SELL,3,0.02h,Stop Loss,$23.25,$292.50,$141050.00,108,$292.50
2024-05-31,18:42:00,18335.5,BUY,3,0.02h,Stop Loss,$19.50,$312.00,$141069.50,108,$312.00
2024-05-31,20:50:00,18576.5,SELL,3,0.02h,Break Even,$0.75,$312.75,$141070.25,108,$312.75
,,,,,,,,,,,
2024-06-03,12:00:00,18688.5,BUY,3,0.02h,Break Even,$0.75,$0.75,$141071.00,109,$0.75
2024-06-03,12:37:00,18679.5,SELL,3,0.02h,Stop Loss,$-18.00,$-17.25,$141053.00,109,$-17.25
2024-06-03,12:44:00,18689.5,BUY,3,0.02h,Break Even,$0.75,$-16.50,$141053.75,109,$-16.50
2024-06-03,12:47:00,18684.75,SELL,3,0.02h,Break Even,$0.75,$-15.75,$141054.50,109,$-15.75
2024-06-03,13:02:00,18691.5,BUY,3,0.02h,Break Even,$0.75,$-15.00,$141055.25,109,$-15.00
2024-06-03,13:53:00,18679.5,SELL,3,0.02h,Break Even,$0.75,$-14.25,$141056.00,109,$-14.25
2024-06-03,14:19:00,18690.0,BUY,3,0.02h,Stop Loss,$162.00,$147.75,$141218.00,109,$147.75
2024-06-03,14:23:00,18682.5,SELL,3,0.02h,Break Even,$0.75,$148.50,$141218.75,109,$148.50
2024-06-03,14:24:00,18702.25,BUY,3,0.02h,Stop Loss,$60.75,$209.25,$141279.50,109,$209.25
2024-06-03,14:33:00,18678.0,SELL,3,0.02h,Break Even,$0.75,$210.00,$141280.25,109,$210.00
2024-06-03,15:20:00,18604.75,BUY,3,0.02h,Stop Loss,$109.50,$319.50,$141389.75,109,$319.50
2024-06-03,15:47:00,18594.5,SELL,3,0.02h,Break Even,$0.75,$320.25,$141390.50,109,$320.25
2024-06-03,15:55:00,18615.75,BUY,3,0.02h,Stop Loss,$-18.00,$302.25,$141372.50,109,$302.25
2024-06-03,15:56:00,18608.25,SELL,3,0.02h,Stop Loss,$128.25,$430.50,$141500.75,109,$430.50
2024-06-03,17:21:00,18498.5,BUY,3,0.02h,Stop Loss,$49.50,$480.00,$141550.25,109,$480.00
2024-06-03,18:14:00,18541.25,SELL,3,0.02h,Stop Loss,$173.25,$653.25,$141723.50,109,$653.25
2024-06-03,18:24:00,18568.0,BUY,3,0.02h,Stop Loss,$-18.00,$635.25,$141705.50,109,$635.25
2024-06-03,18:30:00,18538.0,SELL,3,0.02h,Break Even,$0.75,$636.00,$141706.25,109,$636.00
2024-06-03,18:37:00,18562.75,BUY,3,0.02h,Stop Loss,$-18.00,$618.00,$141688.25,109,$618.00
2024-06-03,18:54:00,18550.25,SELL,3,0.02h,Stop Loss,$38.25,$656.25,$141726.50,109,$656.25
2024-06-03,19:03:00,18568.75,BUY,3,0.02h,Break Even,$0.75,$657.00,$141727.25,109,$657.00
2024-06-03,19:40:00,18571.5,SELL,3,0.02h,Stop Loss,$49.50,$706.50,$141776.75,109,$706.50
2024-06-03,19:47:00,18598.5,BUY,3,0.02h,Stop Loss,$-18.00,$688.50,$141758.75,109,$688.50
2024-06-03,20:46:00,18662.0,SELL,3,0.02h,Stop Loss,$-18.00,$670.50,$141740.75,109,$670.50
2024-06-03,22:25:00,18660.5,BUY,3,0.03h,Stop Loss,$-18.00,$652.50,$141722.75,109,$652.50
2024-06-03,22:45:00,18660.0,SELL,3,0.02h,Stop Loss,$-18.00,$634.50,$141704.75,109,$634.50
,,,,,,,,,,,
2024-06-04,12:32:00,18589.5,BUY,3,0.02h,Stop Loss,$27.00,$27.00,$141731.75,110,$27.00
2024-06-04,13:35:00,18594.25,SELL,3,0.02h,Stop Loss,$143.25,$170.25,$141875.00,110,$170.25
2024-06-04,14:02:00,18659.5,BUY,3,0.02h,Stop Loss,$-18.00,$152.25,$141857.00,110,$152.25
2024-06-04,14:07:00,18596.5,SELL,3,0.02h,Break Even,$0.75,$153.00,$141857.75,110,$153.00
2024-06-04,14:29:00,18619.25,BUY,3,0.02h,Stop Loss,$15.75,$168.75,$141873.50,110,$168.75
2024-06-04,14:56:00,18621.0,SELL,3,0.02h,Stop Loss,$147.00,$315.75,$142020.50,110,$315.75
2024-06-04,15:21:00,18626.5,BUY,3,0.02h,Stop Loss,$90.75,$406.50,$142111.25,110,$406.50
2024-06-04,15:30:00,18601.5,SELL,3,0.02h,Stop Loss,$94.50,$501.00,$142205.75,110,$501.00
2024-06-04,15:55:00,18600.5,BUY,3,0.02h,Stop Loss,$19.50,$520.50,$142225.25,110,$520.50
2024-06-04,15:59:00,18592.0,SELL,3,0.02h,Stop Loss,$75.75,$596.25,$142301.00,110,$596.25
2024-06-04,16:26:00,18590.25,BUY,3,0.02h,Stop Loss,$34.50,$630.75,$142335.50,110,$630.75
2024-06-04,17:04:00,18616.5,SELL,3,0.02h,Break Even,$0.75,$631.50,$142336.25,110,$631.50
2024-06-04,17:17:00,18628.75,BUY,3,0.02h,Stop Loss,$49.50,$681.00,$142385.75,110,$681.00
2024-06-04,17:27:00,18614.75,SELL,3,0.02h,Break Even,$0.75,$681.75,$142386.50,110,$681.75
2024-06-04,17:29:00,18634.25,BUY,3,0.02h,Stop Loss,$75.75,$757.50,$142462.25,110,$757.50
2024-06-04,17:38:00,18622.25,SELL,3,0.02h,Break Even,$0.75,$758.25,$142463.00,110,$758.25
2024-06-04,17:42:00,18631.5,BUY,3,0.02h,Stop Loss,$34.50,$792.75,$142497.50,110,$792.75
2024-06-04,17:44:00,18621.5,SELL,3,0.02h,Stop Loss,$23.25,$816.00,$142520.75,110,$816.00
2024-06-04,17:49:00,18628.5,BUY,3,0.02h,Break Even,$0.75,$816.75,$142521.50,110,$816.75
2024-06-04,17:50:00,18625.25,SELL,3,0.02h,Stop Loss,$-18.00,$798.75,$142503.50,110,$798.75
2024-06-04,17:51:00,18630.25,BUY,3,0.02h,Stop Loss,$-18.00,$780.75,$142485.50,110,$780.75
2024-06-04,18:59:00,18712.25,SELL,3,0.02h,Break Even,$0.75,$781.50,$142486.25,110,$781.50
2024-06-04,19:44:00,18682.75,BUY,3,0.02h,Stop Loss,$128.25,$909.75,$142614.50,110,$909.75
2024-06-04,22:06:00,18707.5,SELL,3,0.02h,Break Even,$0.75,$910.50,$142615.25,110,$910.50
2024-06-04,22:27:00,18703.75,BUY,3,0.03h,Stop Loss,$-18.00,$892.50,$142597.25,110,$892.50
,,,,,,,,,,,
2024-06-05,12:32:00,18782.75,SELL,3,0.02h,Stop Loss,$19.50,$19.50,$142616.75,111,$19.50
2024-06-05,12:37:00,18800.75,BUY,3,0.02h,Break Even,$0.75,$20.25,$142617.50,111,$20.25
2024-06-05,13:35:00,18833.75,SELL,3,0.02h,Stop Loss,$255.75,$276.00,$142873.25,111,$276.00
2024-06-05,13:46:00,18841.75,BUY,3,0.02h,Stop Loss,$15.75,$291.75,$142889.00,111,$291.75
2024-06-05,14:08:00,18831.75,SELL,3,0.02h,Stop Loss,$23.25,$315.00,$142912.25,111,$315.00
2024-06-05,14:22:00,18849.75,BUY,3,0.02h,Stop Loss,$38.25,$353.25,$142950.50,111,$353.25
2024-06-05,15:55:00,18969.0,SELL,3,0.02h,Stop Loss,$53.25,$406.50,$143003.75,111,$406.50
2024-06-05,16:12:00,18973.75,BUY,3,0.02h,Break Even,$0.75,$407.25,$143004.50,111,$407.25
2024-06-05,16:16:00,18961.75,SELL,3,0.02h,Stop Loss,$-18.00,$389.25,$142986.50,111,$389.25
2024-06-05,16:21:00,18974.25,BUY,3,0.02h,Stop Loss,$-18.00,$371.25,$142968.50,111,$371.25
2024-06-05,17:21:00,18982.0,SELL,3,0.02h,Stop Loss,$19.50,$390.75,$142988.00,111,$390.75
2024-06-05,17:34:00,19009.25,BUY,3,0.02h,Stop Loss,$-18.00,$372.75,$142970.00,111,$372.75
2024-06-05,18:09:00,19013.25,SELL,3,0.02h,Stop Loss,$-18.00,$354.75,$142952.00,111,$354.75
2024-06-05,18:11:00,19019.5,BUY,3,0.02h,Break Even,$0.75,$355.50,$142952.75,111,$355.50
2024-06-05,18:14:00,19009.75,SELL,3,0.02h,Break Even,$0.75,$356.25,$142953.50,111,$356.25
2024-06-05,18:23:00,19019.25,BUY,3,0.02h,Break Even,$0.75,$357.00,$142954.25,111,$357.00
2024-06-05,19:27:00,19035.75,SELL,3,0.02h,Stop Loss,$57.00,$414.00,$143011.25,111,$414.00
2024-06-05,19:38:00,19046.75,BUY,3,0.02h,Stop Loss,$27.00,$441.00,$143038.25,111,$441.00
2024-06-05,19:47:00,19036.25,SELL,3,0.02h,Stop Loss,$30.75,$471.75,$143069.00,111,$471.75
2024-06-05,19:53:00,19053.5,BUY,3,0.02h,Stop Loss,$83.25,$555.00,$143152.25,111,$555.00
2024-06-05,22:02:00,19076.5,SELL,3,0.02h,Stop Loss,$-18.00,$537.00,$143134.25,111,$537.00
2024-06-05,22:37:00,19083.0,BUY,3,0.02h,Break Even,$0.75,$537.75,$143135.00,111,$537.75
,,,,,,,,,,,
2024-06-06,12:25:00,19097.5,SELL,3,0.02h,Stop Loss,$27.00,$27.00,$143162.00,112,$27.00
2024-06-06,12:53:00,19095.5,BUY,3,0.02h,Stop Loss,$-18.00,$9.00,$143144.00,112,$9.00
2024-06-06,13:46:00,19086.25,SELL,3,0.02h,Stop Loss,$237.00,$246.00,$143381.00,112,$246.00
2024-06-06,14:24:00,19082.25,BUY,3,0.02h,Stop Loss,$27.00,$273.00,$143408.00,112,$273.00
2024-06-06,14:53:00,19079.75,SELL,3,0.02h,Stop Loss,$-18.00,$255.00,$143390.00,112,$255.00
2024-06-06,14:56:00,19097.25,BUY,3,0.02h,Stop Loss,$-18.00,$237.00,$143372.00,112,$237.00
2024-06-06,15:00:00,19083.0,SELL,3,0.02h,Stop Loss,$79.50,$316.50,$143451.50,112,$316.50
2024-06-06,15:10:00,19090.75,BUY,3,0.02h,Break Even,$0.75,$317.25,$143452.25,112,$317.25
2024-06-06,15:11:00,19087.75,SELL,3,0.02h,Stop Loss,$23.25,$340.50,$143475.50,112,$340.50
2024-06-06,15:54:00,19067.75,BUY,3,0.02h,Stop Loss,$23.25,$363.75,$143498.75,112,$363.75
2024-06-06,16:01:00,19062.0,SELL,3,0.02h,Stop Loss,$19.50,$383.25,$143518.25,112,$383.25
2024-06-06,16:05:00,19070.75,BUY,3,0.02h,Stop Loss,$38.25,$421.50,$143556.50,112,$421.50
2024-06-06,16:16:00,19056.25,SELL,3,0.02h,Stop Loss,$203.25,$624.75,$143759.75,112,$624.75
2024-06-06,16:55:00,19052.75,BUY,3,0.02h,Break Even,$0.75,$625.50,$143760.50,112,$625.50
2024-06-06,17:49:00,19070.5,SELL,3,0.02h,Break Even,$0.75,$626.25,$143761.25,112,$626.25
2024-06-06,17:56:00,19082.25,BUY,3,0.02h,Stop Loss,$-18.00,$608.25,$143743.25,112,$608.25
2024-06-06,17:57:00,19072.25,SELL,3,0.02h,Break Even,$0.75,$609.00,$143744.00,112,$609.00
2024-06-06,18:35:00,19052.0,BUY,3,0.02h,Stop Loss,$30.75,$639.75,$143774.75,112,$639.75
2024-06-06,18:37:00,19045.75,SELL,3,0.02h,Stop Loss,$19.50,$659.25,$143794.25,112,$659.25
2024-06-06,18:41:00,19052.5,BUY,3,0.02h,Break Even,$0.75,$660.00,$143795.00,112,$660.00
2024-06-06,19:14:00,19056.0,SELL,3,0.02h,Stop Loss,$72.00,$732.00,$143867.00,112,$732.00
2024-06-06,19:32:00,19061.25,BUY,3,0.02h,Stop Loss,$-18.00,$714.00,$143849.00,112,$714.00
2024-06-06,19:36:00,19051.5,SELL,3,0.02h,Break Even,$0.75,$714.75,$143849.75,112,$714.75
2024-06-06,19:39:00,19060.0,BUY,3,0.02h,Stop Loss,$-18.00,$696.75,$143831.75,112,$696.75
2024-06-06,19:40:00,19055.0,SELL,3,0.02h,Stop Loss,$79.50,$776.25,$143911.25,112,$776.25
2024-06-06,19:49:00,19065.5,BUY,3,0.02h,Stop Loss,$75.75,$852.00,$143987.00,112,$852.00
2024-06-06,20:03:00,19047.75,SELL,3,0.02h,Break Even,$0.75,$852.75,$143987.75,112,$852.75
2024-06-06,20:08:00,19064.25,BUY,3,0.02h,Break Even,$0.75,$853.50,$143988.50,112,$853.50
2024-06-06,20:42:00,19063.5,SELL,3,0.02h,Stop Loss,$-18.00,$835.50,$143970.50,112,$835.50
2024-06-06,20:57:00,19066.75,BUY,3,0.02h,Stop Loss,$-18.00,$817.50,$143952.50,112,$817.50
2024-06-06,22:02:00,19062.25,SELL,3,0.02h,Stop Loss,$-18.00,$799.50,$143934.50,112,$799.50
2024-06-06,22:08:00,19066.75,BUY,3,0.02h,Stop Loss,$-18.00,$781.50,$143916.50,112,$781.50
2024-06-06,22:09:00,19063.0,SELL,3,0.02h,Stop Loss,$-18.00,$763.50,$143898.50,112,$763.50
2024-06-06,22:13:00,19068.75,BUY,3,0.02h,Stop Loss,$-18.00,$745.50,$143880.50,112,$745.50
,,,,,,,,,,,
2024-06-07,12:31:00,19009.0,SELL,3,0.02h,Stop Loss,$308.25,$308.25,$144188.75,113,$308.25
2024-06-07,13:06:00,19025.25,BUY,3,0.02h,Stop Loss,$83.25,$391.50,$144272.00,113,$391.50
2024-06-07,13:35:00,18996.25,SELL,3,0.02h,Break Even,$0.75,$392.25,$144272.75,113,$392.25
2024-06-07,13:46:00,19025.5,BUY,3,0.02h,Stop Loss,$64.50,$456.75,$144337.25,113,$456.75
2024-06-07,14:12:00,19028.5,SELL,3,0.02h,Break Even,$0.75,$457.50,$144338.00,113,$457.50
2024-06-07,14:14:00,19041.5,BUY,3,0.02h,Stop Loss,$-18.00,$439.50,$144320.00,113,$439.50
2024-06-07,14:30:00,19038.5,SELL,3,0.02h,Stop Loss,$42.00,$481.50,$144362.00,113,$481.50
2024-06-07,14:33:00,19042.25,BUY,3,0.02h,Stop Loss,$15.75,$497.25,$144377.75,113,$497.25
2024-06-07,14:34:00,19036.0,SELL,3,0.02h,Stop Loss,$-18.00,$479.25,$144359.75,113,$479.25
2024-06-07,14:35:00,19046.75,BUY,3,0.02h,Stop Loss,$83.25,$562.50,$144443.00,113,$562.50
2024-06-07,15:01:00,19055.25,SELL,3,0.02h,Stop Loss,$57.00,$619.50,$144500.00,113,$619.50
2024-06-07,15:25:00,19061.75,BUY,3,0.02h,Stop Loss,$12.00,$631.50,$144512.00,113,$631.50
2024-06-07,16:43:00,19094.25,SELL,3,0.02h,Stop Loss,$-18.00,$613.50,$144494.00,113,$613.50
2024-06-07,16:53:00,19111.25,BUY,3,0.02h,Stop Loss,$49.50,$663.00,$144543.50,113,$663.00
2024-06-07,17:38:00,19122.25,SELL,3,0.02h,Stop Loss,$68.25,$731.25,$144611.75,113,$731.25
2024-06-07,17:52:00,19132.25,BUY,3,0.02h,Stop Loss,$19.50,$750.75,$144631.25,113,$750.75
2024-06-07,18:00:00,19115.0,SELL,3,0.02h,Stop Loss,$432.00,$1182.75,$145063.25,113,$1182.75
2024-06-07,18:32:00,19052.25,BUY,3,0.02h,Break Even,$0.75,$1183.50,$145064.00,113,$1183.50
2024-06-07,19:01:00,19039.0,SELL,3,0.02h,Stop Loss,$12.00,$1195.50,$145076.00,113,$1195.50
2024-06-07,19:30:00,19047.5,BUY,3,0.02h,Stop Loss,$-18.00,$1177.50,$145058.00,113,$1177.50
2024-06-07,19:52:00,19037.5,SELL,3,0.02h,Stop Loss,$188.25,$1365.75,$145246.25,113,$1365.75
2024-06-07,19:59:00,19044.25,BUY,3,0.02h,Stop Loss,$53.25,$1419.00,$145299.50,113,$1419.00
2024-06-07,20:01:00,19039.5,SELL,3,0.02h,Stop Loss,$23.25,$1442.25,$145322.75,113,$1442.25
2024-06-07,20:50:00,19024.5,BUY,3,0.02h,Stop Loss,$27.00,$1469.25,$145349.75,113,$1469.25
,,,,,,,,,,,
2024-06-10,12:24:00,19023.5,SELL,3,0.02h,Stop Loss,$-18.00,$-18.00,$145331.75,114,$-18.00
2024-06-10,13:33:00,19005.75,BUY,3,0.02h,Stop Loss,$-18.00,$-36.00,$145313.75,114,$-36.00
2024-06-10,13:48:00,18992.5,SELL,3,0.02h,Break Even,$0.75,$-35.25,$145314.50,114,$-35.25
2024-06-10,14:09:00,19010.0,BUY,3,0.02h,Stop Loss,$49.50,$14.25,$145364.00,114,$14.25
2024-06-10,14:18:00,19001.25,SELL,3,0.02h,Break Even,$0.75,$15.00,$145364.75,114,$15.00
2024-06-10,14:20:00,19009.0,BUY,3,0.02h,Stop Loss,$87.00,$102.00,$145451.75,114,$102.00
2024-06-10,16:02:00,19091.75,SELL,3,0.02h,Stop Loss,$-18.00,$84.00,$145433.75,114,$84.00
2024-06-10,16:12:00,19105.0,BUY,3,0.02h,Break Even,$0.75,$84.75,$145434.50,114,$84.75
2024-06-10,16:32:00,19104.25,SELL,3,0.02h,Stop Loss,$79.50,$164.25,$145514.00,114,$164.25
2024-06-10,16:35:00,19109.5,BUY,3,0.02h,Stop Loss,$-18.00,$146.25,$145496.00,114,$146.25
2024-06-10,16:41:00,19104.5,SELL,3,0.02h,Stop Loss,$-18.00,$128.25,$145478.00,114,$128.25
2024-06-10,16:42:00,19109.5,BUY,3,0.02h,Break Even,$0.75,$129.00,$145478.75,114,$129.00
2024-06-10,16:48:00,19100.25,SELL,3,0.02h,Stop Loss,$-18.00,$111.00,$145460.75,114,$111.00
2024-06-10,16:53:00,19109.5,BUY,3,0.02h,Stop Loss,$12.00,$123.00,$145472.75,114,$123.00
2024-06-10,17:01:00,19092.25,SELL,3,0.02h,Break Even,$0.75,$123.75,$145473.50,114,$123.75
2024-06-10,17:47:00,19090.75,BUY,3,0.02h,Stop Loss,$-18.00,$105.75,$145455.50,114,$105.75
2024-06-10,18:11:00,19083.0,SELL,3,0.02h,Stop Loss,$15.75,$121.50,$145471.25,114,$121.50
2024-06-10,18:41:00,19071.5,BUY,3,0.02h,Stop Loss,$147.00,$268.50,$145618.25,114,$268.50
2024-06-10,19:34:00,19097.75,SELL,3,0.02h,Break Even,$0.75,$269.25,$145619.00,114,$269.25
2024-06-10,19:42:00,19115.0,BUY,3,0.02h,Stop Loss,$-18.00,$251.25,$145601.00,114,$251.25
2024-06-10,19:46:00,19096.0,SELL,3,0.02h,Break Even,$0.75,$252.00,$145601.75,114,$252.00
2024-06-10,20:00:00,19112.75,BUY,3,0.02h,Break Even,$0.75,$252.75,$145602.50,114,$252.75
2024-06-10,20:02:00,19094.0,SELL,3,0.02h,Stop Loss,$-18.00,$234.75,$145584.50,114,$234.75
2024-06-10,20:27:00,19094.25,BUY,3,0.07h,Stop Loss,$-18.00,$216.75,$145566.50,114,$216.75
2024-06-10,22:06:00,19099.0,SELL,3,0.02h,Stop Loss,$-18.00,$198.75,$145548.50,114,$198.75
2024-06-10,22:37:00,19099.5,BUY,3,0.02h,Break Even,$0.75,$199.50,$145549.25,114,$199.50
2024-06-10,22:46:00,19096.5,SELL,3,0.02h,Stop Loss,$-18.00,$181.50,$145531.25,114,$181.50
,,,,,,,,,,,
2024-06-11,12:45:00,19066.0,BUY,3,0.02h,Stop Loss,$-18.00,$-18.00,$145513.25,115,$-18.00
2024-06-11,12:53:00,19057.5,SELL,3,0.02h,Break Even,$0.75,$-17.25,$145514.00,115,$-17.25
2024-06-11,13:14:00,19058.5,BUY,3,0.02h,Break Even,$0.75,$-16.50,$145514.75,115,$-16.50
2024-06-11,13:26:00,19050.0,SELL,3,0.02h,Stop Loss,$-18.00,$-34.50,$145496.75,115,$-34.50
2024-06-11,13:30:00,19057.5,BUY,3,0.02h,Stop Loss,$83.25,$48.75,$145580.00,115,$48.75
2024-06-11,13:32:00,19048.5,SELL,3,0.02h,Stop Loss,$-18.00,$30.75,$145562.00,115,$30.75
2024-06-11,13:33:00,19060.5,BUY,3,0.02h,Stop Loss,$192.00,$222.75,$145754.00,115,$222.75
2024-06-11,13:47:00,19048.25,SELL,3,0.02h,Stop Loss,$555.75,$778.50,$146309.75,115,$778.50
2024-06-11,14:05:00,19053.5,BUY,3,0.02h,Stop Loss,$150.75,$929.25,$146460.50,115,$929.25
2024-06-11,15:10:00,19107.0,SELL,3,0.02h,Stop Loss,$-18.00,$911.25,$146442.50,115,$911.25
2024-06-11,15:24:00,19115.25,BUY,3,0.02h,Break Even,$0.75,$912.00,$146443.25,115,$912.00
2024-06-11,15:40:00,19111.25,SELL,3,0.02h,Stop Loss,$53.25,$965.25,$146496.50,115,$965.25
2024-06-11,16:13:00,19092.0,BUY,3,0.02h,Break Even,$0.75,$966.00,$146497.25,115,$966.00
2024-06-11,16:24:00,19083.5,SELL,3,0.02h,Break Even,$0.75,$966.75,$146498.00,115,$966.75
2024-06-11,16:26:00,19093.5,BUY,3,0.02h,Break Even,$0.75,$967.50,$146498.75,115,$967.50
2024-06-11,16:59:00,19097.0,SELL,3,0.02h,Stop Loss,$45.75,$1013.25,$146544.50,115,$1013.25
2024-06-11,17:03:00,19113.25,BUY,3,0.02h,Stop Loss,$154.50,$1167.75,$146699.00,115,$1167.75
2024-06-11,17:25:00,19110.5,SELL,3,0.02h,Stop Loss,$-18.00,$1149.75,$146681.00,115,$1149.75
2024-06-11,17:33:00,19124.75,BUY,3,0.02h,Break Even,$0.75,$1150.50,$146681.75,115,$1150.50
2024-06-11,18:54:00,19199.25,SELL,3,0.02h,Stop Loss,$-18.00,$1132.50,$146663.75,115,$1132.50
2024-06-11,19:03:00,19216.5,BUY,3,0.02h,Stop Loss,$42.00,$1174.50,$146705.75,115,$1174.50
2024-06-11,19:12:00,19201.75,SELL,3,0.02h,Stop Loss,$42.00,$1216.50,$146747.75,115,$1216.50
2024-06-11,19:42:00,19203.75,BUY,3,0.02h,Stop Loss,$-18.00,$1198.50,$146729.75,115,$1198.50
2024-06-11,20:39:00,19243.75,SELL,3,0.02h,Break Even,$0.75,$1199.25,$146730.50,115,$1199.25
2024-06-11,20:58:00,19247.25,BUY,3,0.02h,Stop Loss,$-18.00,$1181.25,$146712.50,115,$1181.25
2024-06-11,22:02:00,19240.25,SELL,3,0.02h,Stop Loss,$42.00,$1223.25,$146754.50,115,$1223.25
2024-06-11,22:22:00,19240.25,BUY,3,0.02h,Break Even,$0.75,$1224.00,$146755.25,115,$1224.00
,,,,,,,,,,,
2024-06-12,12:28:00,19266.25,SELL,3,0.02h,Stop Loss,$-18.00,$-18.00,$146737.25,116,$-18.00
2024-06-12,12:30:00,19286.5,BUY,3,0.02h,Stop Loss,$2532.00,$2514.00,$149269.25,116,$2514.00
2024-06-12,13:24:00,19414.0,SELL,3,0.02h,Stop Loss,$-18.00,$2496.00,$149251.25,116,$2496.00
2024-06-12,13:35:00,19435.5,BUY,3,0.02h,Break Even,$0.75,$2496.75,$149252.00,116,$2496.75
2024-06-12,14:44:00,19510.25,SELL,3,0.02h,Stop Loss,$158.25,$2655.00,$149410.25,116,$2655.00
2024-06-12,15:07:00,19522.5,BUY,3,0.02h,Break Even,$0.75,$2655.75,$149411.00,116,$2655.75
2024-06-12,15:16:00,19503.5,SELL,3,0.02h,Stop Loss,$-18.00,$2637.75,$149393.00,116,$2637.75
2024-06-12,15:20:00,19523.5,BUY,3,0.02h,Stop Loss,$30.75,$2668.50,$149423.75,116,$2668.50
2024-06-12,15:45:00,19518.25,SELL,3,0.02h,Stop Loss,$42.00,$2710.50,$149465.75,116,$2710.50
2024-06-12,16:10:00,19519.75,BUY,3,0.02h,Break Even,$0.75,$2711.25,$149466.50,116,$2711.25
2024-06-12,16:13:00,19509.75,SELL,3,0.02h,Stop Loss,$-18.00,$2693.25,$149448.50,116,$2693.25
2024-06-12,16:45:00,19511.0,BUY,3,0.02h,Stop Loss,$30.75,$2724.00,$149479.25,116,$2724.00
2024-06-12,16:57:00,19504.5,SELL,3,0.02h,Stop Loss,$-18.00,$2706.00,$149461.25,116,$2706.00
2024-06-12,17:00:00,19509.5,BUY,3,0.02h,Stop Loss,$38.25,$2744.25,$149499.50,116,$2744.25
2024-06-12,17:32:00,19505.25,SELL,3,0.02h,Stop Loss,$143.25,$2887.50,$149642.75,116,$2887.50
2024-06-12,17:56:00,19516.25,BUY,3,0.02h,Break Even,$0.75,$2888.25,$149643.50,116,$2888.25
2024-06-12,18:01:00,19488.5,SELL,3,0.02h,Stop Loss,$214.50,$3102.75,$149858.00,116,$3102.75
2024-06-12,18:19:00,19516.0,BUY,3,0.02h,Stop Loss,$38.25,$3141.00,$149896.25,116,$3141.00
2024-06-12,18:36:00,19488.5,SELL,3,0.02h,Stop Loss,$105.75,$3246.75,$150002.00,116,$3246.75
2024-06-12,18:40:00,19540.0,BUY,3,0.02h,Break Even,$0.75,$3247.50,$150002.75,116,$3247.50
2024-06-12,18:46:00,19495.0,SELL,3,0.02h,Stop Loss,$53.25,$3300.75,$150056.00,116,$3300.75
2024-06-12,18:59:00,19518.5,BUY,3,0.02h,Stop Loss,$83.25,$3384.00,$150139.25,116,$3384.00
2024-06-12,19:26:00,19494.25,SELL,3,0.02h,Stop Loss,$135.75,$3519.75,$150275.00,116,$3519.75
2024-06-12,19:52:00,19498.25,BUY,3,0.02h,Stop Loss,$165.75,$3685.50,$150440.75,116,$3685.50
2024-06-12,20:04:00,19468.25,SELL,3,0.02h,Stop Loss,$23.25,$3708.75,$150464.00,116,$3708.75
2024-06-12,20:16:00,19540.75,BUY,3,0.02h,Stop Loss,$184.50,$3893.25,$150648.50,116,$3893.25
2024-06-12,22:17:00,19589.75,SELL,3,0.02h,Break Even,$0.75,$3894.00,$150649.25,116,$3894.00
2024-06-12,22:21:00,19597.5,BUY,3,0.02h,Break Even,$0.75,$3894.75,$150650.00,116,$3894.75
2024-06-12,22:41:00,19593.75,SELL,3,0.02h,Stop Loss,$-18.00,$3876.75,$150632.00,116,$3876.75
,,,,,,,,,,,
2024-06-13,12:00:00,19873.25,BUY,3,0.02h,Stop Loss,$-18.00,$-18.00,$150614.00,117,$-18.00
2024-06-13,12:23:00,19637.0,SELL,3,0.02h,Stop Loss,$-18.00,$-36.00,$150596.00,117,$-36.00
2024-06-13,12:24:00,19895.75,BUY,3,0.02h,Stop Loss,$-18.00,$-54.00,$150578.00,117,$-54.00
2024-06-13,12:25:00,19634.75,SELL,3,0.02h,Break Even,$0.75,$-53.25,$150578.75,117,$-53.25
2024-06-13,12:27:00,19900.25,BUY,3,0.02h,Stop Loss,$-18.00,$-71.25,$150560.75,117,$-71.25
2024-06-13,12:28:00,19637.75,SELL,3,0.02h,Break Even,$0.75,$-70.50,$150561.50,117,$-70.50
2024-06-13,12:31:00,19931.75,BUY,3,0.02h,Stop Loss,$-18.00,$-88.50,$150543.50,117,$-88.50
2024-06-13,12:32:00,19669.5,SELL,3,0.02h,Stop Loss,$30.75,$-57.75,$150574.25,117,$-57.75
2024-06-13,12:38:00,19913.75,BUY,3,0.02h,Stop Loss,$-18.00,$-75.75,$150556.25,117,$-75.75
2024-06-13,12:39:00,19652.75,SELL,3,0.02h,Stop Loss,$225.75,$150.00,$150782.00,117,$150.00
2024-06-13,12:43:00,19904.75,BUY,3,0.02h,Stop Loss,$-18.00,$132.00,$150764.00,117,$132.00
2024-06-13,12:44:00,19633.0,SELL,3,0.02h,Stop Loss,$-18.00,$114.00,$150746.00,117,$114.00
2024-06-13,12:45:00,19899.5,BUY,3,0.02h,Break Even,$0.75,$114.75,$150746.75,117,$114.75
2024-06-13,12:53:00,19631.5,SELL,3,0.02h,Break Even,$0.75,$115.50,$150747.50,117,$115.50
2024-06-13,12:55:00,19901.0,BUY,3,0.02h,Stop Loss,$-18.00,$97.50,$150729.50,117,$97.50
2024-06-13,12:56:00,19633.0,SELL,3,0.02h,Stop Loss,$23.25,$120.75,$150752.75,117,$120.75
2024-06-13,12:58:00,19898.0,BUY,3,0.02h,Stop Loss,$-18.00,$102.75,$150734.75,117,$102.75
2024-06-13,13:00:00,19629.25,SELL,3,0.02h,Stop Loss,$23.25,$126.00,$150758.00,117,$126.00
2024-06-13,13:07:00,19882.0,BUY,3,0.02h,Stop Loss,$-18.00,$108.00,$150740.00,117,$108.00
2024-06-13,13:08:00,19623.75,SELL,3,0.02h,Stop Loss,$-18.00,$90.00,$150722.00,117,$90.00
2024-06-13,13:09:00,19884.25,BUY,3,0.02h,Stop Loss,$-18.00,$72.00,$150704.00,117,$72.00
2024-06-13,13:10:00,19619.5,SELL,3,0.02h,Break Even,$0.75,$72.75,$150704.75,117,$72.75
2024-06-13,13:16:00,19893.75,BUY,3,0.02h,Break Even,$0.75,$73.50,$150705.50,117,$73.50
2024-06-13,13:26:00,19640.25,SELL,3,0.02h,Stop Loss,$-18.00,$55.50,$150687.50,117,$55.50
2024-06-13,13:27:00,19900.5,BUY,3,0.02h,Stop Loss,$30.75,$86.25,$150718.25,117,$86.25
2024-06-13,13:31:00,19635.0,SELL,3,0.02h,Stop Loss,$57.00,$143.25,$150775.25,117,$143.25
2024-06-13,13:41:00,19917.0,BUY,3,0.02h,Stop Loss,$15.75,$159.00,$150791.00,117,$159.00
2024-06-13,13:50:00,19653.25,SELL,3,0.02h,Stop Loss,$-18.00,$141.00,$150773.00,117,$141.00
2024-06-13,13:51:00,19912.5,BUY,3,0.02h,Stop Loss,$-18.00,$123.00,$150755.00,117,$123.00
2024-06-13,13:52:00,19637.5,SELL,3,0.02h,Stop Loss,$38.25,$161.25,$150793.25,117,$161.25
2024-06-13,13:54:00,19894.5,BUY,3,0.02h,Stop Loss,$117.00,$278.25,$150910.25,117,$278.25
2024-06-13,13:56:00,19637.5,SELL,3,0.02h,Stop Loss,$49.50,$327.75,$150959.75,117,$327.75
2024-06-13,14:03:00,19905.5,BUY,3,0.02h,Stop Loss,$-18.00,$309.75,$150941.75,117,$309.75
2024-06-13,14:04:00,19641.75,SELL,3,0.02h,Stop Loss,$154.50,$464.25,$151096.25,117,$464.25
2024-06-13,14:08:00,19898.0,BUY,3,0.02h,Break Even,$0.75,$465.00,$151097.00,117,$465.00
2024-06-13,14:12:00,19606.25,SELL,3,0.02h,Stop Loss,$139.50,$604.50,$151236.50,117,$604.50
2024-06-13,14:22:00,19827.25,BUY,3,0.02h,Stop Loss,$-18.00,$586.50,$151218.50,117,$586.50
2024-06-13,14:23:00,19559.75,SELL,3,0.02h,Stop Loss,$300.75,$887.25,$151519.25,117,$887.25
2024-06-13,14:26:00,19815.0,BUY,3,0.02h,Stop Loss,$-18.00,$869.25,$151501.25,117,$869.25
2024-06-13,14:36:00,19559.0,SELL,3,0.02h,Break Even,$0.75,$870.00,$151502.00,117,$870.00
2024-06-13,14:43:00,19843.0,BUY,3,0.02h,Stop Loss,$-18.00,$852.00,$151484.00,117,$852.00
2024-06-13,14:49:00,19567.0,SELL,3,0.02h,Stop Loss,$-18.00,$834.00,$151466.00,117,$834.00
2024-06-13,14:50:00,19844.75,BUY,3,0.02h,Break Even,$0.75,$834.75,$151466.75,117,$834.75
2024-06-13,14:54:00,19572.75,SELL,3,0.02h,Break Even,$0.75,$835.50,$151467.50,117,$835.50
2024-06-13,14:57:00,19826.25,BUY,3,0.02h,Stop Loss,$-18.00,$817.50,$151449.50,117,$817.50
2024-06-13,14:58:00,19560.75,SELL,3,0.02h,Stop Loss,$30.75,$848.25,$151480.25,117,$848.25
2024-06-13,15:07:00,19839.0,BUY,3,0.02h,Stop Loss,$-18.00,$830.25,$151462.25,117,$830.25
2024-06-13,15:08:00,19582.25,SELL,3,0.02h,Break Even,$0.75,$831.00,$151463.00,117,$831.00
2024-06-13,15:11:00,19850.0,BUY,3,0.02h,Break Even,$0.75,$831.75,$151463.75,117,$831.75
2024-06-13,15:16:00,19559.0,SELL,3,0.02h,Break Even,$0.75,$832.50,$151464.50,117,$832.50
2024-06-13,15:30:00,19840.0,BUY,3,0.02h,Stop Loss,$-18.00,$814.50,$151446.50,117,$814.50
2024-06-13,15:31:00,19585.75,SELL,3,0.02h,Stop Loss,$-18.00,$796.50,$151428.50,117,$796.50
2024-06-13,15:33:00,19855.25,BUY,3,0.02h,Break Even,$0.75,$797.25,$151429.25,117,$797.25
2024-06-13,15:51:00,19601.25,SELL,3,0.02h,Stop Loss,$79.50,$876.75,$151508.75,117,$876.75
2024-06-13,15:53:00,19861.25,BUY,3,0.02h,Stop Loss,$-18.00,$858.75,$151490.75,117,$858.75
2024-06-13,15:54:00,19594.75,SELL,3,0.02h,Stop Loss,$-18.00,$840.75,$151472.75,117,$840.75
2024-06-13,15:55:00,19856.0,BUY,3,0.02h,Stop Loss,$34.50,$875.25,$151507.25,117,$875.25
2024-06-13,15:57:00,19594.75,SELL,3,0.02h,Stop Loss,$15.75,$891.00,$151523.00,117,$891.00
2024-06-13,16:04:00,19816.75,BUY,3,0.02h,Stop Loss,$-18.00,$873.00,$151505.00,117,$873.00
2024-06-13,16:05:00,19561.5,SELL,3,0.02h,Stop Loss,$-18.00,$855.00,$151487.00,117,$855.00
2024-06-13,16:06:00,19831.0,BUY,3,0.02h,Stop Loss,$-18.00,$837.00,$151469.00,117,$837.00
2024-06-13,16:07:00,19572.5,SELL,3,0.02h,Stop Loss,$-18.00,$819.00,$151451.00,117,$819.00
2024-06-13,16:08:00,19829.25,BUY,3,0.02h,Stop Loss,$-18.00,$801.00,$151433.00,117,$801.00
2024-06-13,16:09:00,19563.75,SELL,3,0.02h,Stop Loss,$68.25,$869.25,$151501.25,117,$869.25
2024-06-13,16:16:00,19814.0,BUY,3,0.02h,Break Even,$0.75,$870.00,$151502.00,117,$870.00
2024-06-13,16:26:00,19519.5,SELL,3,0.02h,Stop Loss,$158.25,$1028.25,$151660.25,117,$1028.25
2024-06-13,16:36:00,19798.25,BUY,3,0.02h,Break Even,$0.75,$1029.00,$151661.00,117,$1029.00
2024-06-13,16:43:00,19536.5,SELL,3,0.02h,Break Even,$0.75,$1029.75,$151661.75,117,$1029.75
2024-06-13,16:49:00,19774.0,BUY,3,0.02h,Stop Loss,$-18.00,$1011.75,$151643.75,117,$1011.75
2024-06-13,16:50:00,19521.5,SELL,3,0.02h,Stop Loss,$-18.00,$993.75,$151625.75,117,$993.75
2024-06-13,16:51:00,19789.75,BUY,3,0.02h,Stop Loss,$-18.00,$975.75,$151607.75,117,$975.75
2024-06-13,16:52:00,19538.0,SELL,3,0.02h,Stop Loss,$-18.00,$957.75,$151589.75,117,$957.75
2024-06-13,16:53:00,19804.25,BUY,3,0.02h,Stop Loss,$-18.00,$939.75,$151571.75,117,$939.75
2024-06-13,16:54:00,19545.0,SELL,3,0.02h,Break Even,$0.75,$940.50,$151572.50,117,$940.50
2024-06-13,17:00:00,19804.5,BUY,3,0.02h,Stop Loss,$105.75,$1046.25,$151678.25,117,$1046.25
2024-06-13,17:08:00,19558.75,SELL,3,0.02h,Break Even,$0.75,$1047.00,$151679.00,117,$1047.00
2024-06-13,17:10:00,19817.25,BUY,3,0.02h,Stop Loss,$64.50,$1111.50,$151743.50,117,$1111.50
2024-06-13,17:15:00,19572.25,SELL,3,0.02h,Stop Loss,$147.00,$1258.50,$151890.50,117,$1258.50
2024-06-13,17:21:00,19823.0,BUY,3,0.02h,Break Even,$0.75,$1259.25,$151891.25,117,$1259.25
2024-06-13,17:24:00,19565.25,SELL,3,0.02h,Break Even,$0.75,$1260.00,$151892.00,117,$1260.00
2024-06-13,17:45:00,19839.5,BUY,3,0.02h,Stop Loss,$-18.00,$1242.00,$151874.00,117,$1242.00
2024-06-13,17:55:00,19579.75,SELL,3,0.02h,Stop Loss,$-18.00,$1224.00,$151856.00,117,$1224.00
2024-06-13,17:56:00,19839.0,BUY,3,0.02h,Stop Loss,$-18.00,$1206.00,$151838.00,117,$1206.00
2024-06-13,18:14:00,19583.5,SELL,3,0.02h,Stop Loss,$-18.00,$1188.00,$151820.00,117,$1188.00
2024-06-13,18:15:00,19845.5,BUY,3,0.02h,Stop Loss,$-18.00,$1170.00,$151802.00,117,$1170.00
2024-06-13,18:21:00,19586.25,SELL,3,0.02h,Stop Loss,$-18.00,$1152.00,$151784.00,117,$1152.00
2024-06-13,18:22:00,19848.0,BUY,3,0.02h,Stop Loss,$-18.00,$1134.00,$151766.00,117,$1134.00
2024-06-13,18:23:00,19588.0,SELL,3,0.02h,Stop Loss,$-18.00,$1116.00,$151748.00,117,$1116.00
2024-06-13,18:34:00,19853.5,BUY,3,0.02h,Stop Loss,$-18.00,$1098.00,$151730.00,117,$1098.00
2024-06-13,18:38:00,19589.0,SELL,3,0.02h,Stop Loss,$45.75,$1143.75,$151775.75,117,$1143.75
2024-06-13,18:40:00,19846.25,BUY,3,0.02h,Stop Loss,$-18.00,$1125.75,$151757.75,117,$1125.75
2024-06-13,18:41:00,19589.25,SELL,3,0.02h,Stop Loss,$-18.00,$1107.75,$151739.75,117,$1107.75
2024-06-13,18:49:00,19851.5,BUY,3,0.02h,Stop Loss,$19.50,$1127.25,$151759.25,117,$1127.25
2024-06-13,19:00:00,19599.0,SELL,3,0.02h,Stop Loss,$60.75,$1188.00,$151820.00,117,$1188.00
2024-06-13,19:04:00,19865.25,BUY,3,0.02h,Stop Loss,$-18.00,$1170.00,$151802.00,117,$1170.00
2024-06-13,19:05:00,19610.5,SELL,3,0.02h,Stop Loss,$-18.00,$1152.00,$151784.00,117,$1152.00
2024-06-13,19:06:00,19871.5,BUY,3,0.02h,Stop Loss,$-18.00,$1134.00,$151766.00,117,$1134.00
2024-06-13,19:07:00,19606.5,SELL,3,0.02h,Stop Loss,$-18.00,$1116.00,$151748.00,117,$1116.00
2024-06-13,19:14:00,19864.25,BUY,3,0.02h,Stop Loss,$-18.00,$1098.00,$151730.00,117,$1098.00
2024-06-13,19:17:00,19590.5,SELL,3,0.02h,Stop Loss,$-18.00,$1080.00,$151712.00,117,$1080.00
2024-06-13,19:18:00,19860.75,BUY,3,0.02h,Stop Loss,$-18.00,$1062.00,$151694.00,117,$1062.00
2024-06-13,19:19:00,19601.0,SELL,3,0.02h,Stop Loss,$-18.00,$1044.00,$151676.00,117,$1044.00
2024-06-13,19:28:00,19865.75,BUY,3,0.02h,Stop Loss,$-18.00,$1026.00,$151658.00,117,$1026.00
2024-06-13,19:29:00,19608.5,SELL,3,0.02h,Stop Loss,$57.00,$1083.00,$151715.00,117,$1083.00
2024-06-13,19:34:00,19858.5,BUY,3,0.02h,Stop Loss,$-18.00,$1065.00,$151697.00,117,$1065.00
2024-06-13,19:35:00,19600.0,SELL,3,0.02h,Stop Loss,$42.00,$1107.00,$151739.00,117,$1107.00
2024-06-13,19:44:00,19863.75,BUY,3,0.02h,Break Even,$0.75,$1107.75,$151739.75,117,$1107.75
2024-06-13,19:56:00,19617.25,SELL,3,0.02h,Stop Loss,$-18.00,$1089.75,$151721.75,117,$1089.75
2024-06-13,19:57:00,19882.5,BUY,3,0.02h,Stop Loss,$23.25,$1113.00,$151745.00,117,$1113.00
2024-06-13,20:07:00,19622.75,SELL,3,0.02h,Stop Loss,$113.25,$1226.25,$151858.25,117,$1226.25
2024-06-13,20:10:00,19872.0,BUY,3,0.02h,Stop Loss,$-18.00,$1208.25,$151840.25,117,$1208.25
2024-06-13,20:11:00,19613.25,SELL,3,0.02h,Stop Loss,$19.50,$1227.75,$151859.75,117,$1227.75
2024-06-13,20:15:00,19877.75,BUY,3,0.02h,Stop Loss,$-18.00,$1209.75,$151841.75,117,$1209.75
2024-06-13,20:19:00,19611.75,SELL,3,0.02h,Stop Loss,$-18.00,$1191.75,$151823.75,117,$1191.75
2024-06-13,20:23:00,19873.75,BUY,3,0.02h,Stop Loss,$-18.00,$1173.75,$151805.75,117,$1173.75
2024-06-13,20:24:00,19613.0,SELL,3,0.02h,Break Even,$0.75,$1174.50,$151806.50,117,$1174.50
2024-06-13,20:29:00,19875.25,BUY,3,0.02h,Stop Loss,$-18.00,$1156.50,$151788.50,117,$1156.50
2024-06-13,20:30:00,19613.5,SELL,3,0.02h,Stop Loss,$19.50,$1176.00,$151808.00,117,$1176.00
2024-06-13,20:33:00,19874.5,BUY,3,0.02h,Stop Loss,$-18.00,$1158.00,$151790.00,117,$1158.00
2024-06-13,20:39:00,19605.25,SELL,3,0.02h,Break Even,$0.75,$1158.75,$151790.75,117,$1158.75
2024-06-13,20:49:00,19857.25,BUY,3,0.02h,Stop Loss,$-18.00,$1140.75,$151772.75,117,$1140.75
2024-06-13,20:53:00,19600.25,SELL,3,0.02h,Stop Loss,$-18.00,$1122.75,$151754.75,117,$1122.75
2024-06-13,20:54:00,19859.25,BUY,3,0.02h,Break Even,$0.75,$1123.50,$151755.50,117,$1123.50
2024-06-13,20:58:00,19606.5,SELL,3,0.02h,Stop Loss,$-18.00,$1105.50,$151737.50,117,$1105.50
2024-06-13,20:59:00,19868.0,BUY,3,0.02h,Stop Loss,$-18.00,$1087.50,$151719.50,117,$1087.50
2024-06-13,21:00:00,19608.25,SELL,3,1.02h,Stop Loss,$188.25,$1275.75,$151907.75,117,$1275.75
2024-06-13,22:03:00,19857.0,BUY,3,0.02h,Stop Loss,$-18.00,$1257.75,$151889.75,117,$1257.75
2024-06-13,22:07:00,19595.75,SELL,3,0.02h,Stop Loss,$-18.00,$1239.75,$151871.75,117,$1239.75
2024-06-13,22:10:00,19860.5,BUY,3,0.02h,Stop Loss,$-18.00,$1221.75,$151853.75,117,$1221.75
2024-06-13,22:19:00,19607.5,SELL,3,0.02h,Break Even,$0.75,$1222.50,$151854.50,117,$1222.50
2024-06-13,22:30:00,19871.0,BUY,3,0.02h,Stop Loss,$-18.00,$1204.50,$151836.50,117,$1204.50
2024-06-13,22:31:00,19607.25,SELL,3,0.02h,Stop Loss,$-18.00,$1186.50,$151818.50,117,$1186.50
2024-06-13,22:32:00,19870.75,BUY,3,0.02h,Stop Loss,$-18.00,$1168.50,$151800.50,117,$1168.50
2024-06-13,22:33:00,19609.25,SELL,3,0.02h,Stop Loss,$-18.00,$1150.50,$151782.50,117,$1150.50
2024-06-13,22:34:00,19874.0,BUY,3,0.02h,Stop Loss,$-18.00,$1132.50,$151764.50,117,$1132.50
2024-06-13,22:40:00,19612.5,SELL,3,0.07h,Stop Loss,$-18.00,$1114.50,$151746.50,117,$1114.50
2024-06-13,22:45:00,19875.0,BUY,3,0.02h,Stop Loss,$-18.00,$1096.50,$151728.50,117,$1096.50
2024-06-13,22:46:00,19612.25,SELL,3,0.02h,Stop Loss,$-18.00,$1078.50,$151710.50,117,$1078.50
2024-06-13,22:47:00,19876.0,BUY,3,0.03h,Stop Loss,$-18.00,$1060.50,$151692.50,117,$1060.50
2024-06-13,22:50:00,19612.25,SELL,3,0.02h,Stop Loss,$-18.00,$1042.50,$151674.50,117,$1042.50
2024-06-13,22:51:00,19872.5,BUY,3,0.02h,Stop Loss,$-18.00,$1024.50,$151656.50,117,$1024.50
2024-06-13,22:58:00,19610.25,SELL,3,0.03h,Break Even,$0.75,$1025.25,$151657.25,117,$1025.25
,,,,,,,,,,,
2024-06-14,12:05:00,19805.25,BUY,3,0.02h,Stop Loss,$-18.00,$-18.00,$151639.25,118,$-18.00
2024-06-14,12:07:00,19552.0,SELL,3,0.02h,Stop Loss,$-18.00,$-36.00,$151621.25,118,$-36.00
2024-06-14,12:08:00,19809.0,BUY,3,0.02h,Break Even,$0.75,$-35.25,$151622.00,118,$-35.25
2024-06-14,12:10:00,19544.0,SELL,3,0.02h,Stop Loss,$-18.00,$-53.25,$151604.00,118,$-53.25
2024-06-14,12:12:00,19809.5,BUY,3,0.02h,Stop Loss,$-18.00,$-71.25,$151586.00,118,$-71.25
2024-06-14,12:14:00,19534.75,SELL,3,0.02h,Stop Loss,$-18.00,$-89.25,$151568.00,118,$-89.25
2024-06-14,12:16:00,19800.75,BUY,3,0.02h,Stop Loss,$-18.00,$-107.25,$151550.00,118,$-107.25
2024-06-14,12:17:00,19543.25,SELL,3,0.02h,Stop Loss,$-18.00,$-125.25,$151532.00,118,$-125.25
2024-06-14,12:21:00,19816.5,BUY,3,0.02h,Stop Loss,$-18.00,$-143.25,$151514.00,118,$-143.25
2024-06-14,12:22:00,19556.5,SELL,3,0.02h,Stop Loss,$-18.00,$-161.25,$151496.00,118,$-161.25
2024-06-14,12:23:00,19825.0,BUY,3,0.02h,Stop Loss,$-18.00,$-179.25,$151478.00,118,$-179.25
2024-06-14,12:26:00,19564.5,SELL,3,0.02h,Stop Loss,$-18.00,$-197.25,$151460.00,118,$-197.25
2024-06-14,12:27:00,19823.5,BUY,3,0.02h,Break Even,$0.75,$-196.50,$151460.75,118,$-196.50
2024-06-14,12:42:00,19559.25,SELL,3,0.02h,Stop Loss,$-18.00,$-214.50,$151442.75,118,$-214.50
2024-06-14,12:56:00,19822.25,BUY,3,0.02h,Stop Loss,$-18.00,$-232.50,$151424.75,118,$-232.50
2024-06-14,12:57:00,19558.75,SELL,3,0.02h,Stop Loss,$-18.00,$-250.50,$151406.75,118,$-250.50
2024-06-14,12:58:00,19819.75,BUY,3,0.02h,Break Even,$0.75,$-249.75,$151407.50,118,$-249.75
2024-06-14,13:03:00,19558.5,SELL,3,0.02h,Stop Loss,$30.75,$-219.00,$151438.25,118,$-219.00
2024-06-14,13:06:00,19818.25,BUY,3,0.02h,Stop Loss,$-18.00,$-237.00,$151420.25,118,$-237.00
2024-06-14,13:08:00,19559.25,SELL,3,0.02h,Stop Loss,$-18.00,$-255.00,$151402.25,118,$-255.00
2024-06-14,13:09:00,19818.75,BUY,3,0.02h,Break Even,$0.75,$-254.25,$151403.00,118,$-254.25
2024-06-14,13:11:00,19557.5,SELL,3,0.02h,Stop Loss,$-18.00,$-272.25,$151385.00,118,$-272.25
2024-06-14,13:12:00,19822.0,BUY,3,0.02h,Break Even,$0.75,$-271.50,$151385.75,118,$-271.50
2024-06-14,13:18:00,19559.0,SELL,3,0.02h,Break Even,$0.75,$-270.75,$151386.50,118,$-270.75
2024-06-14,13:24:00,19827.25,BUY,3,0.02h,Break Even,$0.75,$-270.00,$151387.25,118,$-270.00
2024-06-14,13:28:00,19565.0,SELL,3,0.02h,Stop Loss,$-18.00,$-288.00,$151369.25,118,$-288.00
2024-06-14,13:29:00,19830.5,BUY,3,0.02h,Stop Loss,$94.50,$-193.50,$151463.75,118,$-193.50
2024-06-14,13:31:00,19577.75,SELL,3,0.02h,Stop Loss,$-18.00,$-211.50,$151445.75,118,$-211.50
2024-06-14,13:32:00,19842.75,BUY,3,0.02h,Stop Loss,$-18.00,$-229.50,$151427.75,118,$-229.50
2024-06-14,13:33:00,19561.0,SELL,3,0.02h,Stop Loss,$12.00,$-217.50,$151439.75,118,$-217.50
2024-06-14,13:37:00,19847.25,BUY,3,0.02h,Stop Loss,$-18.00,$-235.50,$151421.75,118,$-235.50
2024-06-14,13:38:00,19590.5,SELL,3,0.02h,Stop Loss,$-18.00,$-253.50,$151403.75,118,$-253.50
2024-06-14,13:39:00,19856.25,BUY,3,0.02h,Stop Loss,$-18.00,$-271.50,$151385.75,118,$-271.50
2024-06-14,13:40:00,19599.25,SELL,3,0.02h,Stop Loss,$57.00,$-214.50,$151442.75,118,$-214.50
2024-06-14,13:44:00,19852.0,BUY,3,0.02h,Stop Loss,$57.00,$-157.50,$151499.75,118,$-157.50
2024-06-14,13:52:00,19626.25,SELL,3,0.02h,Stop Loss,$-18.00,$-175.50,$151481.75,118,$-175.50
2024-06-14,13:53:00,19893.5,BUY,3,0.02h,Stop Loss,$-18.00,$-193.50,$151463.75,118,$-193.50
2024-06-14,13:54:00,19632.0,SELL,3,0.02h,Stop Loss,$45.75,$-147.75,$151509.50,118,$-147.75
2024-06-14,14:01:00,19875.0,BUY,3,0.02h,Stop Loss,$-18.00,$-165.75,$151491.50,118,$-165.75
2024-06-14,14:02:00,19620.25,SELL,3,0.02h,Stop Loss,$23.25,$-142.50,$151514.75,118,$-142.50
2024-06-14,14:06:00,19869.5,BUY,3,0.02h,Stop Loss,$-18.00,$-160.50,$151496.75,118,$-160.50
2024-06-14,14:07:00,19610.75,SELL,3,0.02h,Stop Loss,$-18.00,$-178.50,$151478.75,118,$-178.50
2024-06-14,14:08:00,19890.5,BUY,3,0.02h,Stop Loss,$-18.00,$-196.50,$151460.75,118,$-196.50
2024-06-14,14:10:00,19605.25,SELL,3,0.02h,Stop Loss,$-18.00,$-214.50,$151442.75,118,$-214.50
2024-06-14,14:11:00,19868.5,BUY,3,0.02h,Stop Loss,$-18.00,$-232.50,$151424.75,118,$-232.50
2024-06-14,14:12:00,19605.5,SELL,3,0.02h,Stop Loss,$-18.00,$-250.50,$151406.75,118,$-250.50
2024-06-14,14:13:00,19857.25,BUY,3,0.02h,Stop Loss,$-18.00,$-268.50,$151388.75,118,$-268.50
2024-06-14,14:14:00,19598.75,SELL,3,0.02h,Stop Loss,$-18.00,$-286.50,$151370.75,118,$-286.50
2024-06-14,14:15:00,19856.25,BUY,3,0.02h,Stop Loss,$143.25,$-143.25,$151514.00,118,$-143.25
2024-06-14,14:22:00,19641.5,SELL,3,0.02h,Stop Loss,$132.00,$-11.25,$151646.00,118,$-11.25
2024-06-14,14:24:00,19900.25,BUY,3,0.02h,Stop Loss,$102.00,$90.75,$151748.00,118,$90.75
2024-06-14,14:30:00,19624.25,SELL,3,0.02h,Stop Loss,$34.50,$125.25,$151782.50,118,$125.25
2024-06-14,14:34:00,19866.5,BUY,3,0.02h,Stop Loss,$-18.00,$107.25,$151764.50,118,$107.25
2024-06-14,14:35:00,19610.0,SELL,3,0.02h,Stop Loss,$-18.00,$89.25,$151746.50,118,$89.25
2024-06-14,14:36:00,19862.0,BUY,3,0.02h,Stop Loss,$-18.00,$71.25,$151728.50,118,$71.25
2024-06-14,14:37:00,19592.5,SELL,3,0.02h,Stop Loss,$162.00,$233.25,$151890.50,118,$233.25
2024-06-14,14:40:00,19836.75,BUY,3,0.02h,Stop Loss,$-18.00,$215.25,$151872.50,118,$215.25
2024-06-14,14:41:00,19585.25,SELL,3,0.02h,Stop Loss,$49.50,$264.75,$151922.00,118,$264.75
2024-06-14,14:45:00,19864.75,BUY,3,0.02h,Break Even,$0.75,$265.50,$151922.75,118,$265.50
2024-06-14,14:53:00,19625.25,SELL,3,0.02h,Stop Loss,$15.75,$281.25,$151938.50,118,$281.25
2024-06-14,14:55:00,19891.75,BUY,3,0.02h,Stop Loss,$-18.00,$263.25,$151920.50,118,$263.25
2024-06-14,14:56:00,19629.25,SELL,3,0.02h,Stop Loss,$45.75,$309.00,$151966.25,118,$309.00
2024-06-14,15:00:00,19890.0,BUY,3,0.02h,Break Even,$0.75,$309.75,$151967.00,118,$309.75
2024-06-14,15:10:00,19600.75,SELL,3,0.02h,Stop Loss,$-18.00,$291.75,$151949.00,118,$291.75
2024-06-14,15:11:00,19866.25,BUY,3,0.02h,Stop Loss,$-18.00,$273.75,$151931.00,118,$273.75
2024-06-14,15:12:00,19612.25,SELL,3,0.02h,Stop Loss,$-18.00,$255.75,$151913.00,118,$255.75
2024-06-14,15:13:00,19882.5,BUY,3,0.02h,Break Even,$0.75,$256.50,$151913.75,118,$256.50
2024-06-14,15:15:00,19624.5,SELL,3,0.02h,Stop Loss,$-18.00,$238.50,$151895.75,118,$238.50
2024-06-14,15:16:00,19881.0,BUY,3,0.02h,Break Even,$0.75,$239.25,$151896.50,118,$239.25
2024-06-14,15:18:00,19609.75,SELL,3,0.02h,Stop Loss,$-18.00,$221.25,$151878.50,118,$221.25
2024-06-14,15:19:00,19878.75,BUY,3,0.02h,Stop Loss,$-18.00,$203.25,$151860.50,118,$203.25
2024-06-14,15:21:00,19625.25,SELL,3,0.02h,Stop Loss,$180.75,$384.00,$152041.25,118,$384.00
2024-06-14,15:36:00,19881.25,BUY,3,0.02h,Stop Loss,$-18.00,$366.00,$152023.25,118,$366.00
2024-06-14,15:37:00,19620.0,SELL,3,0.02h,Stop Loss,$94.50,$460.50,$152117.75,118,$460.50
2024-06-14,15:40:00,19871.0,BUY,3,0.02h,Stop Loss,$-18.00,$442.50,$152099.75,118,$442.50
2024-06-14,15:41:00,19602.25,SELL,3,0.02h,Stop Loss,$-18.00,$424.50,$152081.75,118,$424.50
2024-06-14,15:42:00,19860.0,BUY,3,0.02h,Stop Loss,$-18.00,$406.50,$152063.75,118,$406.50
2024-06-14,15:43:00,19601.0,SELL,3,0.02h,Stop Loss,$135.75,$542.25,$152199.50,118,$542.25
2024-06-14,15:48:00,19836.75,BUY,3,0.02h,Break Even,$0.75,$543.00,$152200.25,118,$543.00
2024-06-14,15:56:00,19603.25,SELL,3,0.02h,Stop Loss,$-18.00,$525.00,$152182.25,118,$525.00
2024-06-14,15:57:00,19868.0,BUY,3,0.02h,Stop Loss,$-18.00,$507.00,$152164.25,118,$507.00
2024-06-14,15:58:00,19602.25,SELL,3,0.02h,Stop Loss,$-18.00,$489.00,$152146.25,118,$489.00
2024-06-14,16:00:00,19877.25,BUY,3,0.02h,Stop Loss,$-18.00,$471.00,$152128.25,118,$471.00
2024-06-14,16:03:00,19617.25,SELL,3,0.02h,Break Even,$0.75,$471.75,$152129.00,118,$471.75
2024-06-14,16:06:00,19877.5,BUY,3,0.02h,Break Even,$0.75,$472.50,$152129.75,118,$472.50
2024-06-14,16:28:00,19620.25,SELL,3,0.02h,Stop Loss,$68.25,$540.75,$152198.00,118,$540.75
2024-06-14,16:36:00,19875.75,BUY,3,0.02h,Break Even,$0.75,$541.50,$152198.75,118,$541.50
2024-06-14,16:39:00,19627.0,SELL,3,0.02h,Stop Loss,$-18.00,$523.50,$152180.75,118,$523.50
2024-06-14,16:40:00,19893.0,BUY,3,0.02h,Stop Loss,$-18.00,$505.50,$152162.75,118,$505.50
2024-06-14,16:42:00,19623.75,SELL,3,0.02h,Stop Loss,$30.75,$536.25,$152193.50,118,$536.25
2024-06-14,16:46:00,19889.0,BUY,3,0.02h,Stop Loss,$-18.00,$518.25,$152175.50,118,$518.25
2024-06-14,16:47:00,19626.0,SELL,3,0.02h,Stop Loss,$-18.00,$500.25,$152157.50,118,$500.25
2024-06-14,16:48:00,19887.25,BUY,3,0.02h,Stop Loss,$-18.00,$482.25,$152139.50,118,$482.25
2024-06-14,16:50:00,19626.25,SELL,3,0.02h,Stop Loss,$-18.00,$464.25,$152121.50,118,$464.25
2024-06-14,16:51:00,19890.75,BUY,3,0.02h,Stop Loss,$-18.00,$446.25,$152103.50,118,$446.25
2024-06-14,16:52:00,19635.0,SELL,3,0.02h,Break Even,$0.75,$447.00,$152104.25,118,$447.00
2024-06-14,16:55:00,19883.0,BUY,3,0.02h,Stop Loss,$-18.00,$429.00,$152086.25,118,$429.00
2024-06-14,16:56:00,19623.75,SELL,3,0.02h,Stop Loss,$-18.00,$411.00,$152068.25,118,$411.00
2024-06-14,16:59:00,19888.25,BUY,3,0.02h,Stop Loss,$15.75,$426.75,$152084.00,118,$426.75
2024-06-14,17:14:00,19652.5,SELL,3,0.02h,Stop Loss,$-18.00,$408.75,$152066.00,118,$408.75
2024-06-14,17:15:00,19911.5,BUY,3,0.02h,Stop Loss,$139.50,$548.25,$152205.50,118,$548.25
2024-06-14,17:19:00,19647.5,SELL,3,0.02h,Stop Loss,$-18.00,$530.25,$152187.50,118,$530.25
2024-06-14,17:27:00,19916.5,BUY,3,0.02h,Stop Loss,$-18.00,$512.25,$152169.50,118,$512.25
2024-06-14,17:28:00,19662.0,SELL,3,0.02h,Stop Loss,$-18.00,$494.25,$152151.50,118,$494.25
2024-06-14,17:32:00,19923.25,BUY,3,0.02h,Stop Loss,$64.50,$558.75,$152216.00,118,$558.75
2024-06-14,17:34:00,19666.75,SELL,3,0.02h,Stop Loss,$-18.00,$540.75,$152198.00,118,$540.75
2024-06-14,17:35:00,19929.75,BUY,3,0.02h,Stop Loss,$-18.00,$522.75,$152180.00,118,$522.75
2024-06-14,17:38:00,19669.75,SELL,3,0.02h,Stop Loss,$-18.00,$504.75,$152162.00,118,$504.75
2024-06-14,17:46:00,19928.5,BUY,3,0.02h,Stop Loss,$-18.00,$486.75,$152144.00,118,$486.75
2024-06-14,17:47:00,19666.75,SELL,3,0.02h,Stop Loss,$23.25,$510.00,$152167.25,118,$510.00
2024-06-14,17:56:00,19924.25,BUY,3,0.02h,Stop Loss,$-18.00,$492.00,$152149.25,118,$492.00
2024-06-14,18:06:00,19662.5,SELL,3,0.02h,Break Even,$0.75,$492.75,$152150.00,118,$492.75
2024-06-14,18:12:00,19906.0,BUY,3,0.02h,Stop Loss,$45.75,$538.50,$152195.75,118,$538.50
2024-06-14,18:15:00,19644.25,SELL,3,0.02h,Stop Loss,$-18.00,$520.50,$152177.75,118,$520.50
2024-06-14,18:16:00,19901.25,BUY,3,0.02h,Stop Loss,$-18.00,$502.50,$152159.75,118,$502.50
2024-06-14,18:29:00,19660.0,SELL,3,0.02h,Stop Loss,$-18.00,$484.50,$152141.75,118,$484.50
2024-06-14,18:30:00,19917.0,BUY,3,0.02h,Stop Loss,$-18.00,$466.50,$152123.75,118,$466.50
2024-06-14,18:31:00,19652.5,SELL,3,0.02h,Break Even,$0.75,$467.25,$152124.50,118,$467.25
2024-06-14,18:43:00,19900.0,BUY,3,0.02h,Stop Loss,$-18.00,$449.25,$152106.50,118,$449.25
2024-06-14,18:44:00,19642.75,SELL,3,0.02h,Break Even,$0.75,$450.00,$152107.25,118,$450.00
2024-06-14,18:47:00,19909.25,BUY,3,0.02h,Stop Loss,$-18.00,$432.00,$152089.25,118,$432.00
2024-06-14,18:48:00,19650.75,SELL,3,0.02h,Stop Loss,$27.00,$459.00,$152116.25,118,$459.00
2024-06-14,18:51:00,19917.5,BUY,3,0.02h,Stop Loss,$42.00,$501.00,$152158.25,118,$501.00
2024-06-14,18:54:00,19667.0,SELL,3,0.02h,Stop Loss,$-18.00,$483.00,$152140.25,118,$483.00
2024-06-14,18:58:00,19923.25,BUY,3,0.02h,Stop Loss,$-18.00,$465.00,$152122.25,118,$465.00
2024-06-14,18:59:00,19668.5,SELL,3,0.02h,Break Even,$0.75,$465.75,$152123.00,118,$465.75
2024-06-14,19:05:00,19933.0,BUY,3,0.02h,Stop Loss,$-18.00,$447.75,$152105.00,118,$447.75
2024-06-14,19:20:00,19669.5,SELL,3,0.02h,Stop Loss,$-18.00,$429.75,$152087.00,118,$429.75
2024-06-14,19:21:00,19926.75,BUY,3,0.02h,Break Even,$0.75,$430.50,$152087.75,118,$430.50
2024-06-14,19:27:00,19668.5,SELL,3,0.02h,Stop Loss,$-18.00,$412.50,$152069.75,118,$412.50
2024-06-14,19:28:00,19930.0,BUY,3,0.02h,Stop Loss,$-18.00,$394.50,$152051.75,118,$394.50
2024-06-14,19:29:00,19668.25,SELL,3,0.02h,Stop Loss,$-18.00,$376.50,$152033.75,118,$376.50
2024-06-14,19:35:00,19927.0,BUY,3,0.02h,Stop Loss,$42.00,$418.50,$152075.75,118,$418.50
2024-06-14,19:37:00,19671.5,SELL,3,0.02h,Stop Loss,$-18.00,$400.50,$152057.75,118,$400.50
2024-06-14,19:38:00,19931.0,BUY,3,0.02h,Stop Loss,$-18.00,$382.50,$152039.75,118,$382.50
2024-06-14,19:40:00,19664.25,SELL,3,0.02h,Stop Loss,$-18.00,$364.50,$152021.75,118,$364.50
2024-06-14,19:41:00,19925.0,BUY,3,0.02h,Stop Loss,$-18.00,$346.50,$152003.75,118,$346.50
2024-06-14,19:46:00,19649.0,SELL,3,0.02h,Break Even,$0.75,$347.25,$152004.50,118,$347.25
2024-06-14,19:49:00,19916.5,BUY,3,0.02h,Stop Loss,$-18.00,$329.25,$151986.50,118,$329.25
2024-06-14,19:52:00,19654.5,SELL,3,0.02h,Break Even,$0.75,$330.00,$151987.25,118,$330.00
2024-06-14,19:55:00,19914.5,BUY,3,0.02h,Stop Loss,$57.00,$387.00,$152044.25,118,$387.00
2024-06-14,19:58:00,19668.25,SELL,3,0.02h,Stop Loss,$-18.00,$369.00,$152026.25,118,$369.00
2024-06-14,20:03:00,19945.75,BUY,3,0.02h,Stop Loss,$-18.00,$351.00,$152008.25,118,$351.00
2024-06-14,20:04:00,19686.0,SELL,3,0.02h,Stop Loss,$-18.00,$333.00,$151990.25,118,$333.00
2024-06-14,20:05:00,19946.0,BUY,3,0.02h,Stop Loss,$-18.00,$315.00,$151972.25,118,$315.00
2024-06-14,20:06:00,19688.5,SELL,3,0.02h,Break Even,$0.75,$315.75,$151973.00,118,$315.75
2024-06-14,20:12:00,19944.5,BUY,3,0.02h,Stop Loss,$-18.00,$297.75,$151955.00,118,$297.75
2024-06-14,20:13:00,19686.75,SELL,3,0.02h,Stop Loss,$-18.00,$279.75,$151937.00,118,$279.75
2024-06-14,20:14:00,19948.75,BUY,3,0.02h,Stop Loss,$-18.00,$261.75,$151919.00,118,$261.75
2024-06-14,20:24:00,19689.75,SELL,3,0.02h,Stop Loss,$-18.00,$243.75,$151901.00,118,$243.75
2024-06-14,20:25:00,19953.0,BUY,3,0.02h,Stop Loss,$-18.00,$225.75,$151883.00,118,$225.75
2024-06-14,20:26:00,19696.25,SELL,3,0.02h,Stop Loss,$-18.00,$207.75,$151865.00,118,$207.75
2024-06-14,20:27:00,19958.25,BUY,3,0.02h,Stop Loss,$-18.00,$189.75,$151847.00,118,$189.75
2024-06-14,20:34:00,19694.25,SELL,3,0.02h,Stop Loss,$-18.00,$171.75,$151829.00,118,$171.75
2024-06-14,20:35:00,19953.25,BUY,3,0.02h,Stop Loss,$-18.00,$153.75,$151811.00,118,$153.75
2024-06-14,20:36:00,19694.5,SELL,3,0.02h,Stop Loss,$-18.00,$135.75,$151793.00,118,$135.75
2024-06-14,20:38:00,19954.0,BUY,3,0.02h,Stop Loss,$-18.00,$117.75,$151775.00,118,$117.75
2024-06-14,20:40:00,19693.0,SELL,3,0.02h,Stop Loss,$-18.00,$99.75,$151757.00,118,$99.75
2024-06-14,20:45:00,19953.5,BUY,3,0.02h,Stop Loss,$-18.00,$81.75,$151739.00,118,$81.75
2024-06-14,20:53:00,19686.5,SELL,3,0.02h,Stop Loss,$-18.00,$63.75,$151721.00,118,$63.75
,,,,,,,,,,,
2024-06-17,12:01:00,19981.5,BUY,3,0.02h,Stop Loss,$-18.00,$-18.00,$151703.00,119,$-18.00
2024-06-17,12:36:00,19959.5,SELL,3,0.02h,Stop Loss,$15.75,$-2.25,$151718.75,119,$-2.25
2024-06-17,13:29:00,19954.0,BUY,3,0.02h,Stop Loss,$34.50,$32.25,$151753.25,119,$32.25
2024-06-17,13:35:00,19940.25,SELL,3,0.02h,Stop Loss,$132.00,$164.25,$151885.25,119,$164.25
2024-06-17,13:42:00,19953.0,BUY,3,0.02h,Break Even,$0.75,$165.00,$151886.00,119,$165.00
2024-06-17,13:43:00,19947.75,SELL,3,0.02h,Stop Loss,$105.75,$270.75,$151991.75,119,$270.75
2024-06-17,14:00:00,19954.5,BUY,3,0.02h,Break Even,$0.75,$271.50,$151992.50,119,$271.50
2024-06-17,14:27:00,19946.5,SELL,3,0.02h,Stop Loss,$79.50,$351.00,$152072.00,119,$351.00
2024-06-17,14:36:00,19968.5,BUY,3,0.02h,Break Even,$0.75,$351.75,$152072.75,119,$351.75
2024-06-17,14:51:00,19960.5,SELL,3,0.02h,Stop Loss,$53.25,$405.00,$152126.00,119,$405.00
2024-06-17,14:58:00,19973.0,BUY,3,0.02h,Break Even,$0.75,$405.75,$152126.75,119,$405.75
2024-06-17,15:56:00,20002.25,SELL,3,0.02h,Stop Loss,$-18.00,$387.75,$152108.75,119,$387.75
2024-06-17,15:57:00,20014.0,BUY,3,0.02h,Break Even,$0.75,$388.50,$152109.50,119,$388.50
2024-06-17,15:58:00,20009.5,SELL,3,0.02h,Stop Loss,$-18.00,$370.50,$152091.50,119,$370.50
2024-06-17,16:00:00,20015.0,BUY,3,0.02h,Stop Loss,$45.75,$416.25,$152137.25,119,$416.25
2024-06-17,18:19:00,20225.75,SELL,3,0.02h,Break Even,$0.75,$417.00,$152138.00,119,$417.00
2024-06-17,18:30:00,20240.25,BUY,3,0.02h,Stop Loss,$27.00,$444.00,$152165.00,119,$444.00
2024-06-17,18:41:00,20234.25,SELL,3,0.02h,Break Even,$0.75,$444.75,$152165.75,119,$444.75
2024-06-17,19:12:00,20236.75,BUY,3,0.02h,Break Even,$0.75,$445.50,$152166.50,119,$445.50
2024-06-17,19:37:00,20239.75,SELL,3,0.02h,Break Even,$0.75,$446.25,$152167.25,119,$446.25
2024-06-17,20:30:00,20181.75,BUY,3,0.02h,Stop Loss,$-18.00,$428.25,$152149.25,119,$428.25
2024-06-17,20:36:00,20179.75,SELL,3,0.02h,Stop Loss,$-18.00,$410.25,$152131.25,119,$410.25
2024-06-17,20:43:00,20183.25,BUY,3,0.03h,Break Even,$0.75,$411.00,$152132.00,119,$411.00
2024-06-17,20:50:00,20178.75,SELL,3,0.02h,Stop Loss,$-18.00,$393.00,$152114.00,119,$393.00
2024-06-17,20:56:00,20182.75,BUY,3,0.05h,Break Even,$0.75,$393.75,$152114.75,119,$393.75
2024-06-17,22:38:00,20206.5,SELL,3,0.02h,Break Even,$0.75,$394.50,$152115.50,119,$394.50
2024-06-17,22:44:00,20210.25,BUY,3,0.02h,Stop Loss,$-18.00,$376.50,$152097.50,119,$376.50
2024-06-17,22:50:00,20207.25,SELL,3,0.02h,Stop Loss,$-18.00,$358.50,$152079.50,119,$358.50
,,,,,,,,,,,
2024-06-18,12:20:00,20230.0,BUY,3,0.02h,Break Even,$0.75,$0.75,$152080.25,120,$0.75
2024-06-18,12:23:00,19958.25,SELL,3,0.02h,Stop Loss,$-18.00,$-17.25,$152062.25,120,$-17.25
2024-06-18,12:24:00,20233.5,BUY,3,0.02h,Stop Loss,$30.75,$13.50,$152093.00,120,$13.50
2024-06-18,12:34:00,19931.0,SELL,3,0.02h,Stop Loss,$-18.00,$-4.50,$152075.00,120,$-4.50
2024-06-18,12:35:00,20215.75,BUY,3,0.02h,Stop Loss,$42.00,$37.50,$152117.00,120,$37.50
2024-06-18,12:37:00,19936.5,SELL,3,0.02h,Stop Loss,$-18.00,$19.50,$152099.00,120,$19.50
2024-06-18,12:38:00,20207.25,BUY,3,0.02h,Stop Loss,$-18.00,$1.50,$152081.00,120,$1.50
2024-06-18,12:39:00,19932.0,SELL,3,0.02h,Stop Loss,$-18.00,$-16.50,$152063.00,120,$-16.50
2024-06-18,12:45:00,20198.75,BUY,3,0.02h,Stop Loss,$-18.00,$-34.50,$152045.00,120,$-34.50
2024-06-18,12:46:00,19933.25,SELL,3,0.02h,Stop Loss,$-18.00,$-52.50,$152027.00,120,$-52.50
2024-06-18,12:47:00,20210.25,BUY,3,0.02h,Stop Loss,$-18.00,$-70.50,$152009.00,120,$-70.50
2024-06-18,12:49:00,19934.25,SELL,3,0.02h,Break Even,$0.75,$-69.75,$152009.75,120,$-69.75
2024-06-18,12:56:00,20210.25,BUY,3,0.02h,Stop Loss,$-18.00,$-87.75,$151991.75,120,$-87.75
2024-06-18,13:00:00,19936.0,SELL,3,0.02h,Stop Loss,$-18.00,$-105.75,$151973.75,120,$-105.75
2024-06-18,13:01:00,20199.25,BUY,3,0.02h,Stop Loss,$-18.00,$-123.75,$151955.75,120,$-123.75
2024-06-18,13:02:00,19922.0,SELL,3,0.02h,Stop Loss,$-18.00,$-141.75,$151937.75,120,$-141.75
2024-06-18,13:03:00,20201.75,BUY,3,0.02h,Stop Loss,$-18.00,$-159.75,$151919.75,120,$-159.75
2024-06-18,13:09:00,19921.0,SELL,3,0.02h,Stop Loss,$-18.00,$-177.75,$151901.75,120,$-177.75
2024-06-18,13:10:00,20195.25,BUY,3,0.02h,Break Even,$0.75,$-177.00,$151902.50,120,$-177.00
2024-06-18,13:19:00,19933.25,SELL,3,0.02h,Stop Loss,$-18.00,$-195.00,$151884.50,120,$-195.00
2024-06-18,13:20:00,20204.5,BUY,3,0.02h,Break Even,$0.75,$-194.25,$151885.25,120,$-194.25
2024-06-18,13:23:00,19929.75,SELL,3,0.02h,Stop Loss,$27.00,$-167.25,$151912.25,120,$-167.25
2024-06-18,13:38:00,20211.5,BUY,3,0.02h,Break Even,$0.75,$-166.50,$151913.00,120,$-166.50
2024-06-18,13:44:00,19909.75,SELL,3,0.02h,Stop Loss,$-18.00,$-184.50,$151895.00,120,$-184.50
2024-06-18,13:45:00,20190.75,BUY,3,0.02h,Stop Loss,$-18.00,$-202.50,$151877.00,120,$-202.50
2024-06-18,13:46:00,19914.0,SELL,3,0.02h,Stop Loss,$124.50,$-78.00,$152001.50,120,$-78.00
2024-06-18,13:56:00,20182.0,BUY,3,0.02h,Stop Loss,$117.00,$39.00,$152118.50,120,$39.00
2024-06-18,14:03:00,19903.25,SELL,3,0.02h,Break Even,$0.75,$39.75,$152119.25,120,$39.75
2024-06-18,14:05:00,20189.75,BUY,3,0.02h,Stop Loss,$72.00,$111.75,$152191.25,120,$111.75
2024-06-18,14:24:00,19902.5,SELL,3,0.02h,Stop Loss,$-18.00,$93.75,$152173.25,120,$93.75
2024-06-18,14:31:00,20181.0,BUY,3,0.02h,Stop Loss,$-18.00,$75.75,$152155.25,120,$75.75
2024-06-18,14:32:00,19908.0,SELL,3,0.02h,Stop Loss,$-18.00,$57.75,$152137.25,120,$57.75
2024-06-18,14:39:00,20192.0,BUY,3,0.02h,Stop Loss,$-18.00,$39.75,$152119.25,120,$39.75
2024-06-18,14:40:00,19917.75,SELL,3,0.02h,Stop Loss,$42.00,$81.75,$152161.25,120,$81.75
2024-06-18,14:44:00,20170.75,BUY,3,0.02h,Stop Loss,$-18.00,$63.75,$152143.25,120,$63.75
2024-06-18,14:45:00,19892.25,SELL,3,0.02h,Stop Loss,$-18.00,$45.75,$152125.25,120,$45.75
2024-06-18,14:46:00,20159.0,BUY,3,0.02h,Stop Loss,$180.75,$226.50,$152306.00,120,$226.50
2024-06-18,14:57:00,19886.5,SELL,3,0.02h,Stop Loss,$-18.00,$208.50,$152288.00,120,$208.50
2024-06-18,14:58:00,20156.75,BUY,3,0.02h,Stop Loss,$45.75,$254.25,$152333.75,120,$254.25
2024-06-18,15:00:00,19886.5,SELL,3,0.02h,Stop Loss,$-18.00,$236.25,$152315.75,120,$236.25
2024-06-18,15:02:00,20176.0,BUY,3,0.02h,Break Even,$0.75,$237.00,$152316.50,120,$237.00
2024-06-18,15:05:00,19874.0,SELL,3,0.02h,Stop Loss,$75.75,$312.75,$152392.25,120,$312.75
2024-06-18,15:15:00,20135.5,BUY,3,0.02h,Stop Loss,$94.50,$407.25,$152486.75,120,$407.25
2024-06-18,15:17:00,19865.75,SELL,3,0.02h,Stop Loss,$-18.00,$389.25,$152468.75,120,$389.25
2024-06-18,15:22:00,20155.75,BUY,3,0.02h,Stop Loss,$-18.00,$371.25,$152450.75,120,$371.25
2024-06-18,15:23:00,19881.25,SELL,3,0.02h,Stop Loss,$-18.00,$353.25,$152432.75,120,$353.25
2024-06-18,15:29:00,20154.75,BUY,3,0.02h,Break Even,$0.75,$354.00,$152433.50,120,$354.00
2024-06-18,15:34:00,19877.5,SELL,3,0.02h,Break Even,$0.75,$354.75,$152434.25,120,$354.75
2024-06-18,15:37:00,20161.25,BUY,3,0.02h,Stop Loss,$34.50,$389.25,$152468.75,120,$389.25
2024-06-18,15:44:00,19895.75,SELL,3,0.02h,Break Even,$0.75,$390.00,$152469.50,120,$390.00
2024-06-18,15:49:00,20175.75,BUY,3,0.02h,Stop Loss,$-18.00,$372.00,$152451.50,120,$372.00
2024-06-18,15:50:00,19903.0,SELL,3,0.02h,Stop Loss,$27.00,$399.00,$152478.50,120,$399.00
2024-06-18,15:55:00,20173.25,BUY,3,0.02h,Stop Loss,$-18.00,$381.00,$152460.50,120,$381.00
2024-06-18,16:00:00,19911.25,SELL,3,0.02h,Stop Loss,$-18.00,$363.00,$152442.50,120,$363.00
2024-06-18,16:01:00,20189.25,BUY,3,0.02h,Stop Loss,$-18.00,$345.00,$152424.50,120,$345.00
2024-06-18,16:02:00,19912.5,SELL,3,0.02h,Stop Loss,$-18.00,$327.00,$152406.50,120,$327.00
2024-06-18,16:19:00,20174.0,BUY,3,0.02h,Break Even,$0.75,$327.75,$152407.25,120,$327.75
2024-06-18,16:34:00,19899.5,SELL,3,0.02h,Stop Loss,$-18.00,$309.75,$152389.25,120,$309.75
2024-06-18,16:35:00,20177.25,BUY,3,0.02h,Stop Loss,$-18.00,$291.75,$152371.25,120,$291.75
2024-06-18,16:36:00,19905.25,SELL,3,0.02h,Stop Loss,$23.25,$315.00,$152394.50,120,$315.00
2024-06-18,16:40:00,20178.5,BUY,3,0.02h,Break Even,$0.75,$315.75,$152395.25,120,$315.75
2024-06-18,16:42:00,19903.5,SELL,3,0.02h,Break Even,$0.75,$316.50,$152396.00,120,$316.50
2024-06-18,16:51:00,20180.5,BUY,3,0.02h,Stop Loss,$38.25,$354.75,$152434.25,120,$354.75
2024-06-18,17:09:00,19925.5,SELL,3,0.02h,Stop Loss,$-18.00,$336.75,$152416.25,120,$336.75
2024-06-18,17:10:00,20205.25,BUY,3,0.02h,Stop Loss,$-18.00,$318.75,$152398.25,120,$318.75
2024-06-18,17:11:00,19925.25,SELL,3,0.02h,Break Even,$0.75,$319.50,$152399.00,120,$319.50
2024-06-18,17:18:00,20200.0,BUY,3,0.02h,Stop Loss,$-18.00,$301.50,$152381.00,120,$301.50
2024-06-18,17:19:00,19927.0,SELL,3,0.02h,Stop Loss,$-18.00,$283.50,$152363.00,120,$283.50
2024-06-18,17:20:00,20203.25,BUY,3,0.02h,Break Even,$0.75,$284.25,$152363.75,120,$284.25
2024-06-18,17:22:00,19933.0,SELL,3,0.02h,Break Even,$0.75,$285.00,$152364.50,120,$285.00
2024-06-18,17:31:00,20206.0,BUY,3,0.02h,Break Even,$0.75,$285.75,$152365.25,120,$285.75
2024-06-18,17:40:00,19933.0,SELL,3,0.02h,Stop Loss,$-18.00,$267.75,$152347.25,120,$267.75
2024-06-18,17:41:00,20213.75,BUY,3,0.02h,Break Even,$0.75,$268.50,$152348.00,120,$268.50
2024-06-18,17:49:00,19948.25,SELL,3,0.02h,Stop Loss,$-18.00,$250.50,$152330.00,120,$250.50
2024-06-18,17:58:00,20209.75,BUY,3,0.02h,Break Even,$0.75,$251.25,$152330.75,120,$251.25
2024-06-18,18:04:00,19894.5,SELL,3,0.02h,Stop Loss,$23.25,$274.50,$152354.00,120,$274.50
2024-06-18,18:25:00,20180.25,BUY,3,0.02h,Break Even,$0.75,$275.25,$152354.75,120,$275.25
2024-06-18,18:32:00,19910.5,SELL,3,0.02h,Stop Loss,$-18.00,$257.25,$152336.75,120,$257.25
2024-06-18,18:43:00,20187.25,BUY,3,0.02h,Stop Loss,$-18.00,$239.25,$152318.75,120,$239.25
2024-06-18,18:50:00,19905.0,SELL,3,0.02h,Stop Loss,$-18.00,$221.25,$152300.75,120,$221.25
2024-06-18,18:51:00,20189.25,BUY,3,0.02h,Break Even,$0.75,$222.00,$152301.50,120,$222.00
2024-06-18,18:57:00,19913.25,SELL,3,0.02h,Stop Loss,$-18.00,$204.00,$152283.50,120,$204.00
2024-06-18,18:58:00,20193.5,BUY,3,0.02h,Stop Loss,$49.50,$253.50,$152333.00,120,$253.50
2024-06-18,19:02:00,19917.75,SELL,3,0.02h,Stop Loss,$79.50,$333.00,$152412.50,120,$333.00
2024-06-18,19:05:00,20184.25,BUY,3,0.02h,Stop Loss,$-18.00,$315.00,$152394.50,120,$315.00
2024-06-18,19:06:00,19916.25,SELL,3,0.02h,Stop Loss,$60.75,$375.75,$152455.25,120,$375.75
2024-06-18,19:09:00,20186.25,BUY,3,0.02h,Stop Loss,$-18.00,$357.75,$152437.25,120,$357.75
2024-06-18,19:10:00,19909.25,SELL,3,0.02h,Stop Loss,$-18.00,$339.75,$152419.25,120,$339.75
2024-06-18,19:11:00,20183.5,BUY,3,0.02h,Break Even,$0.75,$340.50,$152420.00,120,$340.50
2024-06-18,19:17:00,19921.25,SELL,3,0.02h,Stop Loss,$19.50,$360.00,$152439.50,120,$360.00
2024-06-18,19:21:00,20194.5,BUY,3,0.02h,Break Even,$0.75,$360.75,$152440.25,120,$360.75
2024-06-18,19:23:00,19921.5,SELL,3,0.02h,Stop Loss,$-18.00,$342.75,$152422.25,120,$342.75
2024-06-18,19:24:00,20196.5,BUY,3,0.02h,Break Even,$0.75,$343.50,$152423.00,120,$343.50
2024-06-18,19:26:00,19923.5,SELL,3,0.02h,Break Even,$0.75,$344.25,$152423.75,120,$344.25
2024-06-18,19:28:00,20199.25,BUY,3,0.02h,Stop Loss,$-18.00,$326.25,$152405.75,120,$326.25
2024-06-18,19:29:00,19920.75,SELL,3,0.02h,Stop Loss,$68.25,$394.50,$152474.00,120,$394.50
2024-06-18,19:48:00,20182.5,BUY,3,0.02h,Stop Loss,$12.00,$406.50,$152486.00,120,$406.50
2024-06-18,19:56:00,19925.25,SELL,3,0.02h,Break Even,$0.75,$407.25,$152486.75,120,$407.25
2024-06-18,19:59:00,20204.0,BUY,3,0.02h,Stop Loss,$-18.00,$389.25,$152468.75,120,$389.25
2024-06-18,20:00:00,19923.25,SELL,3,0.02h,Stop Loss,$68.25,$457.50,$152537.00,120,$457.50
2024-06-18,20:08:00,20201.0,BUY,3,0.02h,Stop Loss,$-18.00,$439.50,$152519.00,120,$439.50
2024-06-18,20:09:00,19923.25,SELL,3,0.02h,Stop Loss,$-18.00,$421.50,$152501.00,120,$421.50
2024-06-18,20:12:00,20205.0,BUY,3,0.02h,Break Even,$0.75,$422.25,$152501.75,120,$422.25
2024-06-18,20:19:00,19928.75,SELL,3,0.02h,Stop Loss,$-18.00,$404.25,$152483.75,120,$404.25
2024-06-18,20:20:00,20205.5,BUY,3,0.02h,Stop Loss,$-18.00,$386.25,$152465.75,120,$386.25
2024-06-18,20:22:00,19930.25,SELL,3,0.02h,Stop Loss,$-18.00,$368.25,$152447.75,120,$368.25
2024-06-18,20:23:00,20204.5,BUY,3,0.03h,Stop Loss,$-18.00,$350.25,$152429.75,120,$350.25
2024-06-18,20:26:00,19929.25,SELL,3,0.02h,Stop Loss,$-18.00,$332.25,$152411.75,120,$332.25
2024-06-18,20:27:00,20206.75,BUY,3,0.02h,Stop Loss,$-18.00,$314.25,$152393.75,120,$314.25
2024-06-18,20:32:00,19931.0,SELL,3,0.02h,Break Even,$0.75,$315.00,$152394.50,120,$315.00
2024-06-18,20:34:00,20206.0,BUY,3,0.02h,Stop Loss,$-18.00,$297.00,$152376.50,120,$297.00
2024-06-18,20:35:00,19929.5,SELL,3,0.02h,Stop Loss,$-18.00,$279.00,$152358.50,120,$279.00
2024-06-18,20:37:00,20205.0,BUY,3,0.02h,Stop Loss,$-18.00,$261.00,$152340.50,120,$261.00
2024-06-18,20:38:00,19928.5,SELL,3,0.02h,Stop Loss,$-18.00,$243.00,$152322.50,120,$243.00
2024-06-18,20:39:00,20205.5,BUY,3,0.03h,Stop Loss,$-18.00,$225.00,$152304.50,120,$225.00
2024-06-18,21:00:00,19933.5,SELL,3,1.02h,Stop Loss,$-18.00,$207.00,$152286.50,120,$207.00
2024-06-18,22:01:00,20208.0,BUY,3,0.02h,Break Even,$0.75,$207.75,$152287.25,120,$207.75
2024-06-18,22:03:00,19931.75,SELL,3,0.02h,Stop Loss,$-18.00,$189.75,$152269.25,120,$189.75
2024-06-18,22:13:00,20217.75,BUY,3,0.02h,Stop Loss,$-18.00,$171.75,$152251.25,120,$171.75
2024-06-18,22:20:00,19941.0,SELL,3,0.02h,Stop Loss,$-18.00,$153.75,$152233.25,120,$153.75
2024-06-18,22:21:00,20219.25,BUY,3,0.02h,Break Even,$0.75,$154.50,$152234.00,120,$154.50
2024-06-18,22:25:00,19942.75,SELL,3,0.02h,Stop Loss,$-18.00,$136.50,$152216.00,120,$136.50
2024-06-18,22:26:00,20219.25,BUY,3,0.02h,Stop Loss,$-18.00,$118.50,$152198.00,120,$118.50
2024-06-18,22:27:00,19942.75,SELL,3,0.07h,Break Even,$0.75,$119.25,$152198.75,120,$119.25
2024-06-18,22:47:00,20229.0,BUY,3,0.02h,Stop Loss,$-18.00,$101.25,$152180.75,120,$101.25
2024-06-18,22:48:00,19953.5,SELL,3,0.02h,Break Even,$0.75,$102.00,$152181.50,120,$102.00
2024-06-18,22:51:00,20229.25,BUY,3,0.02h,Stop Loss,$-18.00,$84.00,$152163.50,120,$84.00
2024-06-18,22:52:00,19951.75,SELL,3,0.02h,Stop Loss,$-18.00,$66.00,$152145.50,120,$66.00
2024-06-18,22:53:00,20229.75,BUY,3,0.02h,Stop Loss,$-18.00,$48.00,$152127.50,120,$48.00
2024-06-18,22:55:00,19952.0,SELL,3,0.03h,Stop Loss,$-18.00,$30.00,$152109.50,120,$30.00
2024-06-18,22:57:00,20230.25,BUY,3,0.02h,Stop Loss,$-18.00,$12.00,$152091.50,120,$12.00
,,,,,,,,,,,
2024-06-19,12:13:00,19958.5,SELL,3,0.02h,Stop Loss,$-18.00,$-18.00,$152073.50,121,$-18.00
2024-06-19,12:25:00,20232.25,BUY,3,0.02h,Stop Loss,$-18.00,$-36.00,$152055.50,121,$-36.00
2024-06-19,12:26:00,19956.75,SELL,3,0.02h,Stop Loss,$-18.00,$-54.00,$152037.50,121,$-54.00
2024-06-19,12:27:00,20233.0,BUY,3,0.02h,Stop Loss,$-18.00,$-72.00,$152019.50,121,$-72.00
2024-06-19,12:28:00,19958.75,SELL,3,0.02h,Stop Loss,$-18.00,$-90.00,$152001.50,121,$-90.00
2024-06-19,12:29:00,20235.25,BUY,3,0.03h,Stop Loss,$-18.00,$-108.00,$151983.50,121,$-108.00
2024-06-19,12:41:00,19960.75,SELL,3,0.02h,Stop Loss,$-18.00,$-126.00,$151965.50,121,$-126.00
2024-06-19,12:42:00,20238.5,BUY,3,0.02h,Break Even,$0.75,$-125.25,$151966.25,121,$-125.25
2024-06-19,12:48:00,19965.25,SELL,3,0.02h,Stop Loss,$-18.00,$-143.25,$151948.25,121,$-143.25
2024-06-19,12:50:00,20242.0,BUY,3,0.02h,Stop Loss,$-18.00,$-161.25,$151930.25,121,$-161.25
2024-06-19,12:51:00,19968.75,SELL,3,0.02h,Stop Loss,$-18.00,$-179.25,$151912.25,121,$-179.25
2024-06-19,12:52:00,20244.5,BUY,3,0.02h,Stop Loss,$-18.00,$-197.25,$151894.25,121,$-197.25
2024-06-19,12:54:00,19968.25,SELL,3,0.03h,Stop Loss,$-18.00,$-215.25,$151876.25,121,$-215.25
2024-06-19,13:00:00,20242.0,BUY,3,0.02h,Stop Loss,$-18.00,$-233.25,$151858.25,121,$-233.25
2024-06-19,13:05:00,19971.25,SELL,3,0.02h,Stop Loss,$-18.00,$-251.25,$151840.25,121,$-251.25
2024-06-19,13:06:00,20247.5,BUY,3,0.02h,Break Even,$0.75,$-250.50,$151841.00,121,$-250.50
2024-06-19,13:09:00,19972.0,SELL,3,0.02h,Stop Loss,$-18.00,$-268.50,$151823.00,121,$-268.50
2024-06-19,13:18:00,20244.75,BUY,3,0.02h,Break Even,$0.75,$-267.75,$151823.75,121,$-267.75
2024-06-19,13:20:00,19972.25,SELL,3,0.02h,Stop Loss,$-18.00,$-285.75,$151805.75,121,$-285.75
2024-06-19,13:21:00,20245.75,BUY,3,0.02h,Stop Loss,$-18.00,$-303.75,$151787.75,121,$-303.75
2024-06-19,13:22:00,19970.25,SELL,3,0.02h,Break Even,$0.75,$-303.00,$151788.50,121,$-303.00
2024-06-19,13:24:00,20244.5,BUY,3,0.03h,Stop Loss,$-18.00,$-321.00,$151770.50,121,$-321.00
2024-06-19,13:26:00,19970.0,SELL,3,0.02h,Stop Loss,$-18.00,$-339.00,$151752.50,121,$-339.00
2024-06-19,13:27:00,20243.75,BUY,3,0.02h,Stop Loss,$-18.00,$-357.00,$151734.50,121,$-357.00
2024-06-19,13:28:00,19967.75,SELL,3,0.02h,Break Even,$0.75,$-356.25,$151735.25,121,$-356.25
2024-06-19,13:30:00,20242.75,BUY,3,0.02h,Stop Loss,$79.50,$-276.75,$151814.75,121,$-276.75
2024-06-19,13:35:00,19971.0,SELL,3,0.02h,Stop Loss,$42.00,$-234.75,$151856.75,121,$-234.75
2024-06-19,13:48:00,20242.25,BUY,3,0.03h,Stop Loss,$-18.00,$-252.75,$151838.75,121,$-252.75
2024-06-19,13:53:00,19965.0,SELL,3,0.02h,Stop Loss,$-18.00,$-270.75,$151820.75,121,$-270.75
2024-06-19,13:54:00,20239.5,BUY,3,0.02h,Stop Loss,$-18.00,$-288.75,$151802.75,121,$-288.75
2024-06-19,13:55:00,19965.0,SELL,3,0.02h,Stop Loss,$-18.00,$-306.75,$151784.75,121,$-306.75
2024-06-19,13:56:00,20239.25,BUY,3,0.03h,Stop Loss,$-18.00,$-324.75,$151766.75,121,$-324.75
2024-06-19,14:08:00,19963.5,SELL,3,0.02h,Stop Loss,$-18.00,$-342.75,$151748.75,121,$-342.75
2024-06-19,14:15:00,20242.0,BUY,3,0.02h,Stop Loss,$-18.00,$-360.75,$151730.75,121,$-360.75
2024-06-19,14:16:00,19964.5,SELL,3,0.05h,Stop Loss,$-18.00,$-378.75,$151712.75,121,$-378.75
2024-06-19,14:23:00,20238.75,BUY,3,0.03h,Stop Loss,$-18.00,$-396.75,$151694.75,121,$-396.75
2024-06-19,14:36:00,19950.0,SELL,3,0.02h,Stop Loss,$-18.00,$-414.75,$151676.75,121,$-414.75
2024-06-19,14:41:00,20232.5,BUY,3,0.02h,Break Even,$0.75,$-414.00,$151677.50,121,$-414.00
2024-06-19,14:47:00,19962.75,SELL,3,0.02h,Stop Loss,$-18.00,$-432.00,$151659.50,121,$-432.00
2024-06-19,14:48:00,20240.75,BUY,3,0.02h,Stop Loss,$-18.00,$-450.00,$151641.50,121,$-450.00
2024-06-19,14:51:00,19960.75,SELL,3,0.02h,Break Even,$0.75,$-449.25,$151642.25,121,$-449.25
2024-06-19,14:58:00,20237.25,BUY,3,0.02h,Stop Loss,$-18.00,$-467.25,$151624.25,121,$-467.25
2024-06-19,15:02:00,19963.0,SELL,3,0.02h,Stop Loss,$-18.00,$-485.25,$151606.25,121,$-485.25
2024-06-19,15:03:00,20241.75,BUY,3,0.02h,Stop Loss,$-18.00,$-503.25,$151588.25,121,$-503.25
2024-06-19,15:08:00,19963.0,SELL,3,0.02h,Stop Loss,$-18.00,$-521.25,$151570.25,121,$-521.25
2024-06-19,15:13:00,20241.25,BUY,3,0.02h,Stop Loss,$-18.00,$-539.25,$151552.25,121,$-539.25
2024-06-19,15:23:00,19962.5,SELL,3,0.02h,Stop Loss,$-18.00,$-557.25,$151534.25,121,$-557.25
2024-06-19,15:37:00,20246.5,BUY,3,0.02h,Stop Loss,$-18.00,$-575.25,$151516.25,121,$-575.25
2024-06-19,15:39:00,19969.75,SELL,3,0.02h,Break Even,$0.75,$-574.50,$151517.00,121,$-574.50
2024-06-19,15:42:00,20245.0,BUY,3,0.02h,Stop Loss,$-18.00,$-592.50,$151499.00,121,$-592.50
2024-06-19,15:53:00,19967.0,SELL,3,0.03h,Stop Loss,$-18.00,$-610.50,$151481.00,121,$-610.50
2024-06-19,15:55:00,20241.75,BUY,3,0.02h,Break Even,$0.75,$-609.75,$151481.75,121,$-609.75
2024-06-19,16:11:00,19956.75,SELL,3,0.02h,Stop Loss,$-18.00,$-627.75,$151463.75,121,$-627.75
2024-06-19,16:19:00,20236.0,BUY,3,0.02h,Stop Loss,$-18.00,$-645.75,$151445.75,121,$-645.75
2024-06-19,16:27:00,19960.0,SELL,3,0.07h,Break Even,$0.75,$-645.00,$151446.50,121,$-645.00
2024-06-19,16:36:00,20237.25,BUY,3,0.02h,Stop Loss,$-18.00,$-663.00,$151428.50,121,$-663.00
2024-06-19,16:37:00,19962.5,SELL,3,0.10h,Stop Loss,$-18.00,$-681.00,$151410.50,121,$-681.00
2024-06-19,16:44:00,20238.25,BUY,3,0.02h,Stop Loss,$-18.00,$-699.00,$151392.50,121,$-699.00
2024-06-19,16:45:00,19962.0,SELL,3,0.02h,Stop Loss,$-18.00,$-717.00,$151374.50,121,$-717.00
2024-06-19,16:46:00,20237.0,BUY,3,0.02h,Stop Loss,$-18.00,$-735.00,$151356.50,121,$-735.00
2024-06-19,16:55:00,19957.25,SELL,3,0.02h,Stop Loss,$-18.00,$-753.00,$151338.50,121,$-753.00
2024-06-19,16:56:00,20231.5,BUY,3,0.02h,Stop Loss,$-18.00,$-771.00,$151320.50,121,$-771.00
2024-06-19,16:57:00,19955.5,SELL,3,0.02h,Stop Loss,$-18.00,$-789.00,$151302.50,121,$-789.00
2024-06-19,16:58:00,20231.25,BUY,3,0.02h,Stop Loss,$-18.00,$-807.00,$151284.50,121,$-807.00
2024-06-19,16:59:00,19954.75,SELL,3,0.02h,Stop Loss,$-18.00,$-825.00,$151266.50,121,$-825.00
2024-06-19,17:00:00,20230.75,BUY,3,5.02h,Stop Loss,$-18.00,$-843.00,$151248.50,121,$-843.00
2024-06-19,22:01:00,19961.75,SELL,3,0.03h,Break Even,$0.75,$-842.25,$151249.25,121,$-842.25
2024-06-19,22:04:00,20237.5,BUY,3,0.02h,Stop Loss,$-18.00,$-860.25,$151231.25,121,$-860.25
2024-06-19,22:12:00,19957.5,SELL,3,0.05h,Stop Loss,$-18.00,$-878.25,$151213.25,121,$-878.25
2024-06-19,22:16:00,20234.0,BUY,3,0.02h,Stop Loss,$-18.00,$-896.25,$151195.25,121,$-896.25
2024-06-19,22:19:00,19958.25,SELL,3,0.02h,Stop Loss,$-18.00,$-914.25,$151177.25,121,$-914.25
2024-06-19,22:20:00,20236.25,BUY,3,0.02h,Stop Loss,$-18.00,$-932.25,$151159.25,121,$-932.25
2024-06-19,22:27:00,19955.5,SELL,3,0.02h,Break Even,$0.75,$-931.50,$151160.00,121,$-931.50
2024-06-19,22:36:00,20230.5,BUY,3,0.02h,Stop Loss,$-18.00,$-949.50,$151142.00,121,$-949.50
2024-06-19,22:37:00,19955.5,SELL,3,0.02h,Stop Loss,$-18.00,$-967.50,$151124.00,121,$-967.50
2024-06-19,22:38:00,20229.5,BUY,3,0.02h,Stop Loss,$-18.00,$-985.50,$151106.00,121,$-985.50
2024-06-19,22:49:00,19956.0,SELL,3,0.03h,Stop Loss,$-18.00,$-1003.50,$151088.00,121,$-1003.50
,,,,,,,,,,,
2024-06-20,12:02:00,20297.5,BUY,3,0.02h,Stop Loss,$-18.00,$-18.00,$151070.00,122,$-18.00
2024-06-20,12:03:00,20025.0,SELL,3,0.02h,Stop Loss,$-18.00,$-36.00,$151052.00,122,$-36.00
2024-06-20,12:04:00,20301.75,BUY,3,0.02h,Stop Loss,$-18.00,$-54.00,$151034.00,122,$-54.00
2024-06-20,12:07:00,20025.0,SELL,3,0.02h,Stop Loss,$15.75,$-38.25,$151049.75,122,$-38.25
2024-06-20,12:09:00,20295.25,BUY,3,0.02h,Stop Loss,$-18.00,$-56.25,$151031.75,122,$-56.25
2024-06-20,12:11:00,20007.5,SELL,3,0.02h,Stop Loss,$-18.00,$-74.25,$151013.75,122,$-74.25
2024-06-20,12:14:00,20292.0,BUY,3,0.02h,Stop Loss,$-18.00,$-92.25,$150995.75,122,$-92.25
2024-06-20,12:25:00,20012.0,SELL,3,0.02h,Stop Loss,$-18.00,$-110.25,$150977.75,122,$-110.25
2024-06-20,12:28:00,20296.5,BUY,3,0.02h,Stop Loss,$-18.00,$-128.25,$150959.75,122,$-128.25
2024-06-20,12:29:00,20022.5,SELL,3,0.02h,Break Even,$0.75,$-127.50,$150960.50,122,$-127.50
2024-06-20,12:34:00,20283.75,BUY,3,0.02h,Stop Loss,$-18.00,$-145.50,$150942.50,122,$-145.50
2024-06-20,12:37:00,20005.25,SELL,3,0.02h,Break Even,$0.75,$-144.75,$150943.25,122,$-144.75
2024-06-20,12:40:00,20274.0,BUY,3,0.02h,Break Even,$0.75,$-144.00,$150944.00,122,$-144.00
2024-06-20,12:49:00,19999.0,SELL,3,0.02h,Break Even,$0.75,$-143.25,$150944.75,122,$-143.25
2024-06-20,12:57:00,20271.25,BUY,3,0.02h,Stop Loss,$-18.00,$-161.25,$150926.75,122,$-161.25
2024-06-20,12:58:00,19991.0,SELL,3,0.02h,Stop Loss,$15.75,$-145.50,$150942.50,122,$-145.50
2024-06-20,13:06:00,20265.5,BUY,3,0.02h,Stop Loss,$-18.00,$-163.50,$150924.50,122,$-163.50
2024-06-20,13:18:00,19974.0,SELL,3,0.02h,Stop Loss,$-18.00,$-181.50,$150906.50,122,$-181.50
2024-06-20,13:31:00,20252.5,BUY,3,0.02h,Stop Loss,$-18.00,$-199.50,$150888.50,122,$-199.50
2024-06-20,13:35:00,19928.75,SELL,3,0.02h,Break Even,$0.75,$-198.75,$150889.25,122,$-198.75
2024-06-20,13:39:00,20226.75,BUY,3,0.02h,Stop Loss,$60.75,$-138.00,$150950.00,122,$-138.00
2024-06-20,13:51:00,19974.25,SELL,3,0.02h,Stop Loss,$162.00,$24.00,$151112.00,122,$24.00
2024-06-20,13:55:00,20237.0,BUY,3,0.02h,Stop Loss,$-18.00,$6.00,$151094.00,122,$6.00
2024-06-20,13:56:00,19966.0,SELL,3,0.02h,Stop Loss,$-18.00,$-12.00,$151076.00,122,$-12.00
2024-06-20,14:00:00,20234.25,BUY,3,0.02h,Stop Loss,$49.50,$37.50,$151125.50,122,$37.50
2024-06-20,14:02:00,19946.5,SELL,3,0.02h,Stop Loss,$-18.00,$19.50,$151107.50,122,$19.50
2024-06-20,14:11:00,20178.75,BUY,3,0.02h,Break Even,$0.75,$20.25,$151108.25,122,$20.25
2024-06-20,14:13:00,19884.75,SELL,3,0.02h,Stop Loss,$23.25,$43.50,$151131.50,122,$43.50
2024-06-20,14:24:00,20157.25,BUY,3,0.02h,Break Even,$0.75,$44.25,$151132.25,122,$44.25
2024-06-20,14:29:00,19895.75,SELL,3,0.02h,Break Even,$0.75,$45.00,$151133.00,122,$45.00
2024-06-20,14:36:00,20170.0,BUY,3,0.02h,Stop Loss,$-18.00,$27.00,$151115.00,122,$27.00
2024-06-20,14:37:00,19908.0,SELL,3,0.02h,Stop Loss,$-18.00,$9.00,$151097.00,122,$9.00
2024-06-20,14:38:00,20189.25,BUY,3,0.02h,Stop Loss,$27.00,$36.00,$151124.00,122,$36.00
2024-06-20,14:47:00,19901.0,SELL,3,0.02h,Stop Loss,$-18.00,$18.00,$151106.00,122,$18.00
2024-06-20,14:48:00,20172.5,BUY,3,0.02h,Break Even,$0.75,$18.75,$151106.75,122,$18.75
2024-06-20,14:50:00,19903.75,SELL,3,0.02h,Break Even,$0.75,$19.50,$151107.50,122,$19.50
2024-06-20,14:52:00,20190.0,BUY,3,0.02h,Break Even,$0.75,$20.25,$151108.25,122,$20.25
2024-06-20,14:54:00,19916.5,SELL,3,0.02h,Break Even,$0.75,$21.00,$151109.00,122,$21.00
2024-06-20,14:56:00,20191.75,BUY,3,0.02h,Stop Loss,$-18.00,$3.00,$151091.00,122,$3.00
2024-06-20,14:57:00,19929.0,SELL,3,0.02h,Stop Loss,$-18.00,$-15.00,$151073.00,122,$-15.00
2024-06-20,14:58:00,20203.5,BUY,3,0.02h,Stop Loss,$64.50,$49.50,$151137.50,122,$49.50
2024-06-20,15:03:00,19937.75,SELL,3,0.02h,Break Even,$0.75,$50.25,$151138.25,122,$50.25
2024-06-20,15:11:00,20213.75,BUY,3,0.02h,Stop Loss,$-18.00,$32.25,$151120.25,122,$32.25
2024-06-20,15:12:00,19943.25,SELL,3,0.02h,Stop Loss,$-18.00,$14.25,$151102.25,122,$14.25
2024-06-20,15:15:00,20214.0,BUY,3,0.02h,Stop Loss,$-18.00,$-3.75,$151084.25,122,$-3.75
2024-06-20,15:16:00,19939.5,SELL,3,0.02h,Break Even,$0.75,$-3.00,$151085.00,122,$-3.00
2024-06-20,15:18:00,20206.75,BUY,3,0.02h,Stop Loss,$30.75,$27.75,$151115.75,122,$27.75
2024-06-20,15:27:00,19917.0,SELL,3,0.02h,Break Even,$0.75,$28.50,$151116.50,122,$28.50
2024-06-20,15:32:00,20198.0,BUY,3,0.02h,Stop Loss,$-18.00,$10.50,$151098.50,122,$10.50
2024-06-20,15:33:00,19924.5,SELL,3,0.02h,Stop Loss,$-18.00,$-7.50,$151080.50,122,$-7.50
2024-06-20,15:34:00,20195.5,BUY,3,0.02h,Stop Loss,$-18.00,$-25.50,$151062.50,122,$-25.50
2024-06-20,15:35:00,19929.25,SELL,3,0.02h,Stop Loss,$-18.00,$-43.50,$151044.50,122,$-43.50
2024-06-20,15:36:00,20200.5,BUY,3,0.02h,Stop Loss,$-18.00,$-61.50,$151026.50,122,$-61.50
2024-06-20,15:43:00,19935.75,SELL,3,0.02h,Stop Loss,$-18.00,$-79.50,$151008.50,122,$-79.50
2024-06-20,15:44:00,20204.25,BUY,3,0.02h,Stop Loss,$-18.00,$-97.50,$150990.50,122,$-97.50
2024-06-20,15:45:00,19931.75,SELL,3,0.02h,Stop Loss,$-18.00,$-115.50,$150972.50,122,$-115.50
2024-06-20,15:46:00,20197.75,BUY,3,0.02h,Stop Loss,$-18.00,$-133.50,$150954.50,122,$-133.50
2024-06-20,15:47:00,19917.75,SELL,3,0.02h,Stop Loss,$-18.00,$-151.50,$150936.50,122,$-151.50
2024-06-20,15:48:00,20182.0,BUY,3,0.02h,Stop Loss,$34.50,$-117.00,$150971.00,122,$-117.00
2024-06-20,15:50:00,19887.0,SELL,3,0.02h,Break Even,$0.75,$-116.25,$150971.75,122,$-116.25
2024-06-20,15:56:00,20179.25,BUY,3,0.02h,Stop Loss,$-18.00,$-134.25,$150953.75,122,$-134.25
2024-06-20,15:59:00,19904.0,SELL,3,0.02h,Stop Loss,$-18.00,$-152.25,$150935.75,122,$-152.25
2024-06-20,16:00:00,20163.25,BUY,3,0.02h,Stop Loss,$-18.00,$-170.25,$150917.75,122,$-170.25
2024-06-20,16:01:00,19889.75,SELL,3,0.02h,Stop Loss,$-18.00,$-188.25,$150899.75,122,$-188.25
2024-06-20,16:02:00,20157.75,BUY,3,0.02h,Stop Loss,$-18.00,$-206.25,$150881.75,122,$-206.25
2024-06-20,16:03:00,19888.25,SELL,3,0.02h,Stop Loss,$-18.00,$-224.25,$150863.75,122,$-224.25
2024-06-20,16:05:00,20159.5,BUY,3,0.02h,Stop Loss,$-18.00,$-242.25,$150845.75,122,$-242.25
2024-06-20,16:06:00,19903.75,SELL,3,0.02h,Break Even,$0.75,$-241.50,$150846.50,122,$-241.50
2024-06-20,16:09:00,20161.5,BUY,3,0.02h,Stop Loss,$-18.00,$-259.50,$150828.50,122,$-259.50
2024-06-20,16:10:00,19891.25,SELL,3,0.02h,Break Even,$0.75,$-258.75,$150829.25,122,$-258.75
2024-06-20,16:13:00,20158.5,BUY,3,0.02h,Stop Loss,$-18.00,$-276.75,$150811.25,122,$-276.75
2024-06-20,16:14:00,19892.0,SELL,3,0.02h,Break Even,$0.75,$-276.00,$150812.00,122,$-276.00
2024-06-20,16:27:00,20098.0,BUY,3,0.02h,Stop Loss,$-18.00,$-294.00,$150794.00,122,$-294.00
2024-06-20,16:29:00,19813.25,SELL,3,0.02h,Stop Loss,$244.50,$-49.50,$151038.50,122,$-49.50
2024-06-20,16:41:00,20048.75,BUY,3,0.02h,Stop Loss,$-18.00,$-67.50,$151020.50,122,$-67.50
2024-06-20,16:42:00,19793.0,SELL,3,0.02h,Stop Loss,$-18.00,$-85.50,$151002.50,122,$-85.50
2024-06-20,16:43:00,20056.75,BUY,3,0.02h,Stop Loss,$23.25,$-62.25,$151025.75,122,$-62.25
2024-06-20,16:47:00,19801.75,SELL,3,0.02h,Stop Loss,$-18.00,$-80.25,$151007.75,122,$-80.25
2024-06-20,16:48:00,20079.0,BUY,3,0.02h,Stop Loss,$-18.00,$-98.25,$150989.75,122,$-98.25
2024-06-20,16:49:00,19803.0,SELL,3,0.02h,Stop Loss,$49.50,$-48.75,$151039.25,122,$-48.75
2024-06-20,16:51:00,20094.0,BUY,3,0.02h,Break Even,$0.75,$-48.00,$151040.00,122,$-48.00
2024-06-20,17:08:00,19732.0,SELL,3,0.02h,Break Even,$0.75,$-47.25,$151040.75,122,$-47.25
2024-06-20,17:27:00,20012.5,BUY,3,0.02h,Stop Loss,$68.25,$21.00,$151109.00,122,$21.00
2024-06-20,17:29:00,19737.0,SELL,3,0.02h,Stop Loss,$-18.00,$3.00,$151091.00,122,$3.00
2024-06-20,17:30:00,20006.5,BUY,3,0.02h,Stop Loss,$293.25,$296.25,$151384.25,122,$296.25
2024-06-20,17:34:00,19725.5,SELL,3,0.02h,Stop Loss,$-18.00,$278.25,$151366.25,122,$278.25
2024-06-20,17:35:00,19980.0,BUY,3,0.02h,Stop Loss,$75.75,$354.00,$151442.00,122,$354.00
2024-06-20,17:37:00,19708.5,SELL,3,0.02h,Stop Loss,$-18.00,$336.00,$151424.00,122,$336.00
2024-06-20,17:38:00,19974.0,BUY,3,0.02h,Break Even,$0.75,$336.75,$151424.75,122,$336.75
2024-06-20,17:40:00,19708.5,SELL,3,0.02h,Break Even,$0.75,$337.50,$151425.50,122,$337.50
2024-06-20,17:45:00,20017.0,BUY,3,0.02h,Break Even,$0.75,$338.25,$151426.25,122,$338.25
2024-06-20,18:01:00,19781.5,SELL,3,0.02h,Stop Loss,$-18.00,$320.25,$151408.25,122,$320.25
2024-06-20,18:02:00,20051.75,BUY,3,0.02h,Break Even,$0.75,$321.00,$151409.00,122,$321.00
2024-06-20,18:08:00,19811.0,SELL,3,0.02h,Stop Loss,$30.75,$351.75,$151439.75,122,$351.75
2024-06-20,18:21:00,20050.5,BUY,3,0.02h,Stop Loss,$139.50,$491.25,$151579.25,122,$491.25
2024-06-20,18:41:00,19782.25,SELL,3,0.02h,Stop Loss,$-18.00,$473.25,$151561.25,122,$473.25
2024-06-20,18:42:00,20043.0,BUY,3,0.02h,Stop Loss,$-18.00,$455.25,$151543.25,122,$455.25
2024-06-20,18:43:00,19773.0,SELL,3,0.02h,Stop Loss,$-18.00,$437.25,$151525.25,122,$437.25
2024-06-20,18:48:00,20037.25,BUY,3,0.02h,Stop Loss,$-18.00,$419.25,$151507.25,122,$419.25
2024-06-20,18:49:00,19770.0,SELL,3,0.02h,Break Even,$0.75,$420.00,$151508.00,122,$420.00
2024-06-20,18:53:00,20025.0,BUY,3,0.02h,Stop Loss,$75.75,$495.75,$151583.75,122,$495.75
2024-06-20,18:56:00,19762.5,SELL,3,0.02h,Stop Loss,$-18.00,$477.75,$151565.75,122,$477.75
2024-06-20,19:02:00,20016.0,BUY,3,0.02h,Stop Loss,$-18.00,$459.75,$151547.75,122,$459.75
2024-06-20,19:03:00,19729.0,SELL,3,0.02h,Stop Loss,$188.25,$648.00,$151736.00,122,$648.00
2024-06-20,19:08:00,20004.5,BUY,3,0.02h,Stop Loss,$-18.00,$630.00,$151718.00,122,$630.00
2024-06-20,19:09:00,19740.5,SELL,3,0.02h,Stop Loss,$19.50,$649.50,$151737.50,122,$649.50
2024-06-20,19:21:00,20002.5,BUY,3,0.02h,Break Even,$0.75,$650.25,$151738.25,122,$650.25
2024-06-20,19:30:00,19760.75,SELL,3,0.02h,Stop Loss,$19.50,$669.75,$151757.75,122,$669.75
2024-06-20,19:32:00,20028.5,BUY,3,0.02h,Stop Loss,$-18.00,$651.75,$151739.75,122,$651.75
2024-06-20,19:33:00,19760.25,SELL,3,0.02h,Stop Loss,$-18.00,$633.75,$151721.75,122,$633.75
2024-06-20,19:34:00,20036.75,BUY,3,0.02h,Stop Loss,$-18.00,$615.75,$151703.75,122,$615.75
2024-06-20,19:35:00,19786.0,SELL,3,0.02h,Stop Loss,$132.00,$747.75,$151835.75,122,$747.75
2024-06-20,19:37:00,20027.5,BUY,3,0.02h,Stop Loss,$-18.00,$729.75,$151817.75,122,$729.75
2024-06-20,19:38:00,19753.5,SELL,3,0.02h,Stop Loss,$-18.00,$711.75,$151799.75,122,$711.75
2024-06-20,19:39:00,20027.25,BUY,3,0.02h,Stop Loss,$-18.00,$693.75,$151781.75,122,$693.75
2024-06-20,19:52:00,19793.25,SELL,3,0.02h,Stop Loss,$75.75,$769.50,$151857.50,122,$769.50
2024-06-20,19:57:00,20038.75,BUY,3,0.02h,Break Even,$0.75,$770.25,$151858.25,122,$770.25
2024-06-20,19:59:00,19763.25,SELL,3,0.02h,Stop Loss,$-18.00,$752.25,$151840.25,122,$752.25
2024-06-20,20:00:00,20035.75,BUY,3,0.02h,Stop Loss,$-18.00,$734.25,$151822.25,122,$734.25
2024-06-20,20:01:00,19766.25,SELL,3,0.02h,Stop Loss,$64.50,$798.75,$151886.75,122,$798.75
2024-06-20,20:15:00,20035.5,BUY,3,0.02h,Stop Loss,$-18.00,$780.75,$151868.75,122,$780.75
2024-06-20,20:17:00,19775.25,SELL,3,0.02h,Stop Loss,$19.50,$800.25,$151888.25,122,$800.25
2024-06-20,20:24:00,20046.0,BUY,3,0.02h,Stop Loss,$-18.00,$782.25,$151870.25,122,$782.25
2024-06-20,20:27:00,19772.25,SELL,3,0.02h,Stop Loss,$-18.00,$764.25,$151852.25,122,$764.25
2024-06-20,20:28:00,20042.5,BUY,3,0.02h,Break Even,$0.75,$765.00,$151853.00,122,$765.00
2024-06-20,20:32:00,19778.25,SELL,3,0.02h,Stop Loss,$-18.00,$747.00,$151835.00,122,$747.00
2024-06-20,20:35:00,20049.75,BUY,3,0.02h,Break Even,$0.75,$747.75,$151835.75,122,$747.75
2024-06-20,20:47:00,19782.0,SELL,3,0.02h,Break Even,$0.75,$748.50,$151836.50,122,$748.50
2024-06-20,20:49:00,20050.0,BUY,3,0.02h,Stop Loss,$-18.00,$730.50,$151818.50,122,$730.50
2024-06-20,20:59:00,19783.5,SELL,3,0.02h,Stop Loss,$-18.00,$712.50,$151800.50,122,$712.50
2024-06-20,21:00:00,20053.25,BUY,3,1.02h,Stop Loss,$-18.00,$694.50,$151782.50,122,$694.50
2024-06-20,22:08:00,19787.75,SELL,3,0.05h,Stop Loss,$-18.00,$676.50,$151764.50,122,$676.50
2024-06-20,22:17:00,20060.0,BUY,3,0.02h,Stop Loss,$-18.00,$658.50,$151746.50,122,$658.50
2024-06-20,22:18:00,19791.25,SELL,3,0.02h,Stop Loss,$-18.00,$640.50,$151728.50,122,$640.50
2024-06-20,22:19:00,20058.25,BUY,3,0.02h,Break Even,$0.75,$641.25,$151729.25,122,$641.25
2024-06-20,22:24:00,19791.5,SELL,3,0.05h,Break Even,$0.75,$642.00,$151730.00,122,$642.00
2024-06-20,22:32:00,20057.75,BUY,3,0.02h,Stop Loss,$-18.00,$624.00,$151712.00,122,$624.00
2024-06-20,22:35:00,19788.25,SELL,3,0.02h,Stop Loss,$-18.00,$606.00,$151694.00,122,$606.00
2024-06-20,22:36:00,20058.0,BUY,3,0.03h,Stop Loss,$-18.00,$588.00,$151676.00,122,$588.00
2024-06-20,22:41:00,19788.25,SELL,3,0.03h,Stop Loss,$-18.00,$570.00,$151658.00,122,$570.00
2024-06-20,22:43:00,20056.0,BUY,3,0.02h,Stop Loss,$-18.00,$552.00,$151640.00,122,$552.00
2024-06-20,22:44:00,19789.25,SELL,3,0.02h,Break Even,$0.75,$552.75,$151640.75,122,$552.75
2024-06-20,22:47:00,20056.0,BUY,3,0.02h,Stop Loss,$-18.00,$534.75,$151622.75,122,$534.75
2024-06-20,22:48:00,19788.0,SELL,3,0.07h,Stop Loss,$-18.00,$516.75,$151604.75,122,$516.75
2024-06-20,22:53:00,20058.25,BUY,3,0.02h,Break Even,$0.75,$517.50,$151605.50,122,$517.50
,,,,,,,,,,,
2024-06-21,12:04:00,19735.0,SELL,3,0.02h,Stop Loss,$-18.00,$-18.00,$151587.50,123,$-18.00
2024-06-21,12:20:00,19995.75,BUY,3,0.02h,Stop Loss,$-18.00,$-36.00,$151569.50,123,$-36.00
2024-06-21,12:21:00,19727.75,SELL,3,0.02h,Stop Loss,$49.50,$13.50,$151619.00,123,$13.50
2024-06-21,12:24:00,19991.0,BUY,3,0.02h,Stop Loss,$-18.00,$-4.50,$151601.00,123,$-4.50
2024-06-21,12:30:00,19727.75,SELL,3,0.02h,Stop Loss,$30.75,$26.25,$151631.75,123,$26.25
2024-06-21,12:40:00,20021.75,BUY,3,0.02h,Stop Loss,$-18.00,$8.25,$151613.75,123,$8.25
2024-06-21,12:41:00,19753.75,SELL,3,0.02h,Stop Loss,$-18.00,$-9.75,$151595.75,123,$-9.75
2024-06-21,12:42:00,20014.25,BUY,3,0.02h,Stop Loss,$150.75,$141.00,$151746.50,123,$141.00
2024-06-21,12:52:00,19764.75,SELL,3,0.02h,Stop Loss,$-18.00,$123.00,$151728.50,123,$123.00
2024-06-21,12:53:00,20029.0,BUY,3,0.02h,Stop Loss,$-18.00,$105.00,$151710.50,123,$105.00
2024-06-21,12:55:00,19760.75,SELL,3,0.02h,Stop Loss,$-18.00,$87.00,$151692.50,123,$87.00
2024-06-21,12:56:00,20032.5,BUY,3,0.02h,Stop Loss,$-18.00,$69.00,$151674.50,123,$69.00
2024-06-21,12:57:00,19766.5,SELL,3,0.02h,Stop Loss,$-18.00,$51.00,$151656.50,123,$51.00
2024-06-21,12:58:00,20032.25,BUY,3,0.02h,Break Even,$0.75,$51.75,$151657.25,123,$51.75
2024-06-21,13:03:00,19763.25,SELL,3,0.02h,Stop Loss,$147.00,$198.75,$151804.25,123,$198.75
2024-06-21,13:11:00,20023.75,BUY,3,0.02h,Stop Loss,$-18.00,$180.75,$151786.25,123,$180.75
2024-06-21,13:15:00,19768.25,SELL,3,0.02h,Stop Loss,$53.25,$234.00,$151839.50,123,$234.00
2024-06-21,13:20:00,20038.75,BUY,3,0.02h,Stop Loss,$-18.00,$216.00,$151821.50,123,$216.00
2024-06-21,13:50:00,19957.5,SELL,3,0.02h,Stop Loss,$263.25,$479.25,$152084.75,123,$479.25
2024-06-21,14:05:00,19961.5,BUY,3,0.02h,Stop Loss,$45.75,$525.00,$152130.50,123,$525.00
2024-06-21,14:27:00,19965.75,SELL,3,0.02h,Stop Loss,$45.75,$570.75,$152176.25,123,$570.75
2024-06-21,14:47:00,19977.75,BUY,3,0.02h,Stop Loss,$120.75,$691.50,$152297.00,123,$691.50
2024-06-21,15:29:00,19994.5,SELL,3,0.02h,Stop Loss,$15.75,$707.25,$152312.75,123,$707.25
2024-06-21,15:43:00,20013.0,BUY,3,0.02h,Stop Loss,$19.50,$726.75,$152332.25,123,$726.75
2024-06-21,16:16:00,20043.75,SELL,3,0.02h,Break Even,$0.75,$727.50,$152333.00,123,$727.50
2024-06-21,16:17:00,20053.75,BUY,3,0.02h,Stop Loss,$42.00,$769.50,$152375.00,123,$769.50
2024-06-21,16:25:00,20042.75,SELL,3,0.02h,Stop Loss,$34.50,$804.00,$152409.50,123,$804.00
2024-06-21,17:52:00,19977.75,BUY,3,0.02h,Stop Loss,$120.75,$924.75,$152530.25,123,$924.75
2024-06-21,18:00:00,19961.25,SELL,3,0.02h,Break Even,$0.75,$925.50,$152531.00,123,$925.50
2024-06-21,18:12:00,19974.5,BUY,3,0.02h,Stop Loss,$49.50,$975.00,$152580.50,123,$975.00
2024-06-21,18:40:00,19982.25,SELL,3,0.02h,Break Even,$0.75,$975.75,$152581.25,123,$975.75
2024-06-21,19:03:00,19989.75,BUY,3,0.02h,Stop Loss,$57.00,$1032.75,$152638.25,123,$1032.75
2024-06-21,19:31:00,19993.5,SELL,3,0.02h,Break Even,$0.75,$1033.50,$152639.00,123,$1033.50
2024-06-21,19:35:00,20002.75,BUY,3,0.02h,Stop Loss,$19.50,$1053.00,$152658.50,123,$1053.00
2024-06-21,19:47:00,19992.0,SELL,3,0.02h,Stop Loss,$23.25,$1076.25,$152681.75,123,$1076.25
2024-06-21,19:55:00,20001.5,BUY,3,0.02h,Break Even,$0.75,$1077.00,$152682.50,123,$1077.00
2024-06-21,19:56:00,19997.0,SELL,3,0.02h,Stop Loss,$87.00,$1164.00,$152769.50,123,$1164.00
2024-06-21,20:09:00,19998.5,BUY,3,0.02h,Stop Loss,$-18.00,$1146.00,$152751.50,123,$1146.00
2024-06-21,20:55:00,20006.5,SELL,3,0.05h,Stop Loss,$-18.00,$1128.00,$152733.50,123,$1128.00
2024-06-21,21:00:00,20009.0,BUY,3,63.00h,Stop Loss,$-18.00,$1110.00,$152715.50,123,$1110.00
,,,,,,,,,,,
2024-06-24,12:00:00,19954.0,SELL,3,0.02h,Stop Loss,$60.75,$60.75,$152776.25,124,$60.75
2024-06-24,12:25:00,19967.5,BUY,3,0.02h,Break Even,$0.75,$61.50,$152777.00,124,$61.50
2024-06-24,12:35:00,19953.75,SELL,3,0.02h,Stop Loss,$120.75,$182.25,$152897.75,124,$182.25
2024-06-24,13:25:00,19926.25,BUY,3,0.02h,Stop Loss,$-18.00,$164.25,$152879.75,124,$164.25
2024-06-24,13:42:00,19907.25,SELL,3,0.02h,Stop Loss,$109.50,$273.75,$152989.25,124,$273.75
2024-06-24,13:56:00,19931.75,BUY,3,0.02h,Break Even,$0.75,$274.50,$152990.00,124,$274.50
2024-06-24,14:22:00,19949.5,SELL,3,0.02h,Stop Loss,$12.00,$286.50,$153002.00,124,$286.50
2024-06-24,15:01:00,19897.75,BUY,3,0.02h,Break Even,$0.75,$287.25,$153002.75,124,$287.25
2024-06-24,15:27:00,19882.5,SELL,3,0.02h,Stop Loss,$94.50,$381.75,$153097.25,124,$381.75
2024-06-24,15:36:00,19911.25,BUY,3,0.02h,Stop Loss,$-18.00,$363.75,$153079.25,124,$363.75
2024-06-24,15:37:00,19902.0,SELL,3,0.02h,Stop Loss,$-18.00,$345.75,$153061.25,124,$345.75
2024-06-24,15:38:00,19908.0,BUY,3,0.02h,Stop Loss,$132.00,$477.75,$153193.25,124,$477.75
2024-06-24,15:51:00,19900.25,SELL,3,0.02h,Stop Loss,$87.00,$564.75,$153280.25,124,$564.75
2024-06-24,16:00:00,19918.0,BUY,3,0.02h,Break Even,$0.75,$565.50,$153281.00,124,$565.50
2024-06-24,16:08:00,19899.0,SELL,3,0.02h,Stop Loss,$64.50,$630.00,$153345.50,124,$630.00
2024-06-24,16:21:00,19902.75,BUY,3,0.02h,Stop Loss,$-18.00,$612.00,$153327.50,124,$612.00
2024-06-24,16:23:00,19896.75,SELL,3,0.02h,Break Even,$0.75,$612.75,$153328.25,124,$612.75
2024-06-24,16:24:00,19903.0,BUY,3,0.02h,Break Even,$0.75,$613.50,$153329.00,124,$613.50
2024-06-24,16:25:00,19898.0,SELL,3,0.02h,Break Even,$0.75,$614.25,$153329.75,124,$614.25
2024-06-24,16:31:00,19907.25,BUY,3,0.02h,Break Even,$0.75,$615.00,$153330.50,124,$615.00
2024-06-24,16:40:00,19896.75,SELL,3,0.02h,Stop Loss,$-18.00,$597.00,$153312.50,124,$597.00
2024-06-24,17:47:00,19821.75,BUY,3,0.02h,Stop Loss,$-18.00,$579.00,$153294.50,124,$579.00
2024-06-24,17:49:00,19815.0,SELL,3,0.02h,Stop Loss,$34.50,$613.50,$153329.00,124,$613.50
2024-06-24,17:57:00,19828.5,BUY,3,0.02h,Stop Loss,$-18.00,$595.50,$153311.00,124,$595.50
2024-06-24,17:59:00,19810.5,SELL,3,0.02h,Break Even,$0.75,$596.25,$153311.75,124,$596.25
2024-06-24,18:40:00,19800.25,BUY,3,0.02h,Break Even,$0.75,$597.00,$153312.50,124,$597.00
2024-06-24,19:22:00,19826.25,SELL,3,0.02h,Break Even,$0.75,$597.75,$153313.25,124,$597.75
2024-06-24,20:44:00,19751.25,BUY,3,0.02h,Stop Loss,$-18.00,$579.75,$153295.25,124,$579.75
2024-06-24,20:53:00,19746.75,SELL,3,0.02h,Stop Loss,$-18.00,$561.75,$153277.25,124,$561.75
2024-06-24,21:00:00,19753.25,BUY,3,1.02h,Stop Loss,$203.25,$765.00,$153480.50,124,$765.00
2024-06-24,22:47:00,19761.75,SELL,3,0.02h,Stop Loss,$-18.00,$747.00,$153462.50,124,$747.00
2024-06-24,22:48:00,19762.25,BUY,3,0.07h,Stop Loss,$-18.00,$729.00,$153444.50,124,$729.00
2024-06-24,22:52:00,19761.25,SELL,3,0.03h,Stop Loss,$-18.00,$711.00,$153426.50,124,$711.00
2024-06-24,22:54:00,19763.25,BUY,3,0.02h,Break Even,$0.75,$711.75,$153427.25,124,$711.75
2024-06-24,23:00:00,19759.75,SELL,3,13.00h,Stop Loss,$-18.00,$693.75,$153409.25,124,$693.75
,,,,,,,,,,,
2024-06-25,12:00:00,19819.75,BUY,3,0.02h,Stop Loss,$12.00,$12.00,$153421.25,125,$12.00
2024-06-25,12:33:00,19817.25,SELL,3,0.02h,Stop Loss,$-18.00,$-6.00,$153403.25,125,$-6.00
2024-06-25,12:38:00,19829.75,BUY,3,0.02h,Break Even,$0.75,$-5.25,$153404.00,125,$-5.25
2024-06-25,12:42:00,19820.0,SELL,3,0.02h,Stop Loss,$-18.00,$-23.25,$153386.00,125,$-23.25
2024-06-25,12:57:00,19827.75,BUY,3,0.02h,Stop Loss,$15.75,$-7.50,$153401.75,125,$-7.50
2024-06-25,13:28:00,19832.0,SELL,3,0.02h,Stop Loss,$72.00,$64.50,$153473.75,125,$64.50
2024-06-25,13:46:00,19836.75,BUY,3,0.02h,Stop Loss,$-18.00,$46.50,$153455.75,125,$46.50
2024-06-25,14:46:00,19871.75,SELL,3,0.02h,Stop Loss,$-18.00,$28.50,$153437.75,125,$28.50
2024-06-25,15:03:00,19889.75,BUY,3,0.02h,Stop Loss,$30.75,$59.25,$153468.50,125,$59.25
2024-06-25,16:12:00,19943.5,SELL,3,0.02h,Stop Loss,$68.25,$127.50,$153536.75,125,$127.50
2024-06-25,17:15:00,19887.25,BUY,3,0.02h,Stop Loss,$-18.00,$109.50,$153518.75,125,$109.50
2024-06-25,18:49:00,19920.5,SELL,3,0.02h,Break Even,$0.75,$110.25,$153519.50,125,$110.25
2024-06-25,19:00:00,19950.0,BUY,3,0.02h,Stop Loss,$-18.00,$92.25,$153501.50,125,$92.25
2024-06-25,19:01:00,19939.75,SELL,3,0.02h,Stop Loss,$-18.00,$74.25,$153483.50,125,$74.25
2024-06-25,19:03:00,19945.75,BUY,3,0.02h,Break Even,$0.75,$75.00,$153484.25,125,$75.00
2024-06-25,19:04:00,19941.25,SELL,3,0.02h,Stop Loss,$-18.00,$57.00,$153466.25,125,$57.00
2024-06-25,19:06:00,19947.25,BUY,3,0.02h,Break Even,$0.75,$57.75,$153467.00,125,$57.75
2024-06-25,19:11:00,19938.0,SELL,3,0.02h,Break Even,$0.75,$58.50,$153467.75,125,$58.50
2024-06-25,19:17:00,19950.75,BUY,3,0.02h,Stop Loss,$45.75,$104.25,$153513.50,125,$104.25
2024-06-25,19:46:00,19957.0,SELL,3,0.02h,Stop Loss,$27.00,$131.25,$153540.50,125,$131.25
2024-06-25,19:59:00,19973.0,BUY,3,0.02h,Stop Loss,$45.75,$177.00,$153586.25,125,$177.00
2024-06-25,22:33:00,19976.25,SELL,3,0.02h,Break Even,$0.75,$177.75,$153587.00,125,$177.75
2024-06-25,22:58:00,19976.5,BUY,3,0.02h,Break Even,$0.75,$178.50,$153587.75,125,$178.50
,,,,,,,,,,,
2024-06-26,12:15:00,19979.25,SELL,3,0.02h,Stop Loss,$12.00,$12.00,$153599.75,126,$12.00
2024-06-26,13:28:00,19929.25,BUY,3,0.02h,Break Even,$0.75,$12.75,$153600.50,126,$12.75
2024-06-26,14:29:00,19956.25,SELL,3,0.02h,Stop Loss,$135.75,$148.50,$153736.25,126,$148.50
2024-06-26,14:46:00,19997.0,BUY,3,0.02h,Stop Loss,$105.75,$254.25,$153842.00,126,$254.25
2024-06-26,15:00:00,19974.75,SELL,3,0.02h,Stop Loss,$53.25,$307.50,$153895.25,126,$307.50
2024-06-26,15:23:00,19966.25,BUY,3,0.02h,Stop Loss,$79.50,$387.00,$153974.75,126,$387.00
2024-06-26,15:32:00,19951.0,SELL,3,0.02h,Break Even,$0.75,$387.75,$153975.50,126,$387.75
2024-06-26,15:39:00,19966.75,BUY,3,0.02h,Break Even,$0.75,$388.50,$153976.25,126,$388.50
2024-06-26,16:18:00,19998.75,SELL,3,0.02h,Break Even,$0.75,$389.25,$153977.00,126,$389.25
2024-06-26,16:28:00,20013.25,BUY,3,0.02h,Stop Loss,$64.50,$453.75,$154041.50,126,$453.75
2024-06-26,16:38:00,19997.0,SELL,3,0.02h,Stop Loss,$109.50,$563.25,$154151.00,126,$563.25
2024-06-26,17:13:00,19978.75,BUY,3,0.02h,Stop Loss,$15.75,$579.00,$154166.75,126,$579.00
2024-06-26,17:20:00,19946.5,SELL,3,0.02h,Stop Loss,$120.75,$699.75,$154287.50,126,$699.75
2024-06-26,17:35:00,19969.25,BUY,3,0.02h,Stop Loss,$-18.00,$681.75,$154269.50,126,$681.75
2024-06-26,17:38:00,19958.0,SELL,3,0.02h,Stop Loss,$-18.00,$663.75,$154251.50,126,$663.75
2024-06-26,17:39:00,19966.5,BUY,3,0.02h,Stop Loss,$49.50,$713.25,$154301.00,126,$713.25
2024-06-26,18:05:00,19964.5,SELL,3,0.02h,Stop Loss,$60.75,$774.00,$154361.75,126,$774.00
2024-06-26,18:14:00,19972.0,BUY,3,0.02h,Break Even,$0.75,$774.75,$154362.50,126,$774.75
2024-06-26,18:23:00,19964.25,SELL,3,0.02h,Stop Loss,$-18.00,$756.75,$154344.50,126,$756.75
2024-06-26,18:25:00,19976.5,BUY,3,0.02h,Break Even,$0.75,$757.50,$154345.25,126,$757.50
2024-06-26,18:37:00,19963.75,SELL,3,0.02h,Break Even,$0.75,$758.25,$154346.00,126,$758.25
2024-06-26,18:48:00,19972.75,BUY,3,0.02h,Stop Loss,$38.25,$796.50,$154384.25,126,$796.50
2024-06-26,18:56:00,19960.0,SELL,3,0.02h,Stop Loss,$102.00,$898.50,$154486.25,126,$898.50
2024-06-26,19:24:00,19948.25,BUY,3,0.02h,Break Even,$0.75,$899.25,$154487.00,126,$899.25
2024-06-26,20:03:00,19926.75,SELL,3,0.02h,Stop Loss,$30.75,$930.00,$154517.75,126,$930.00
2024-06-26,20:44:00,19947.25,BUY,3,0.02h,Stop Loss,$-18.00,$912.00,$154499.75,126,$912.00
2024-06-26,20:51:00,19943.75,SELL,3,0.02h,Stop Loss,$-18.00,$894.00,$154481.75,126,$894.00
2024-06-26,20:55:00,19948.5,BUY,3,0.02h,Break Even,$0.75,$894.75,$154482.50,126,$894.75
2024-06-26,22:16:00,19948.75,SELL,3,0.02h,Stop Loss,$-18.00,$876.75,$154464.50,126,$876.75
,,,,,,,,,,,
2024-06-27,12:00:00,19974.5,BUY,3,0.02h,Stop Loss,$102.00,$102.00,$154566.50,127,$102.00
2024-06-27,12:30:00,19968.0,SELL,3,0.02h,Stop Loss,$173.25,$275.25,$154739.75,127,$275.25
2024-06-27,12:32:00,19989.0,BUY,3,0.02h,Stop Loss,$64.50,$339.75,$154804.25,127,$339.75
2024-06-27,13:13:00,19992.0,SELL,3,0.02h,Break Even,$0.75,$340.50,$154805.00,127,$340.50
2024-06-27,13:18:00,20000.0,BUY,3,0.02h,Stop Loss,$-18.00,$322.50,$154787.00,127,$322.50
2024-06-27,13:22:00,19993.5,SELL,3,0.02h,Break Even,$0.75,$323.25,$154787.75,127,$323.25
2024-06-27,13:31:00,20015.75,BUY,3,0.02h,Stop Loss,$117.00,$440.25,$154904.75,127,$440.25
2024-06-27,13:54:00,20044.0,SELL,3,0.02h,Stop Loss,$-18.00,$422.25,$154886.75,127,$422.25
2024-06-27,14:01:00,20069.75,BUY,3,0.02h,Stop Loss,$102.00,$524.25,$154988.75,127,$524.25
2024-06-27,14:33:00,20062.0,SELL,3,0.02h,Stop Loss,$-18.00,$506.25,$154970.75,127,$506.25
2024-06-27,15:19:00,20032.25,BUY,3,0.02h,Break Even,$0.75,$507.00,$154971.50,127,$507.00
2024-06-27,15:20:00,20023.25,SELL,3,0.02h,Stop Loss,$75.75,$582.75,$155047.25,127,$582.75
2024-06-27,15:57:00,19988.75,BUY,3,0.02h,Break Even,$0.75,$583.50,$155048.00,127,$583.50
2024-06-27,17:00:00,20028.75,SELL,3,0.02h,Stop Loss,$-18.00,$565.50,$155030.00,127,$565.50
2024-06-27,17:04:00,20047.0,BUY,3,0.02h,Break Even,$0.75,$566.25,$155030.75,127,$566.25
2024-06-27,17:14:00,20036.75,SELL,3,0.02h,Break Even,$0.75,$567.00,$155031.50,127,$567.00
2024-06-27,17:27:00,20042.5,BUY,3,0.02h,Stop Loss,$34.50,$601.50,$155066.00,127,$601.50
2024-06-27,17:55:00,20050.0,SELL,3,0.02h,Stop Loss,$-18.00,$583.50,$155048.00,127,$583.50
2024-06-27,18:49:00,20020.5,BUY,3,0.02h,Stop Loss,$34.50,$618.00,$155082.50,127,$618.00
2024-06-27,19:35:00,20040.5,SELL,3,0.02h,Break Even,$0.75,$618.75,$155083.25,127,$618.75
2024-06-27,19:42:00,20049.75,BUY,3,0.02h,Stop Loss,$-18.00,$600.75,$155065.25,127,$600.75
2024-06-27,19:43:00,20040.5,SELL,3,0.02h,Break Even,$0.75,$601.50,$155066.00,127,$601.50
2024-06-27,20:01:00,20059.75,BUY,3,0.02h,Stop Loss,$12.00,$613.50,$155078.00,127,$613.50
2024-06-27,20:42:00,20067.0,SELL,3,0.02h,Break Even,$0.75,$614.25,$155078.75,127,$614.25
2024-06-27,20:55:00,20069.0,BUY,3,0.02h,Stop Loss,$-18.00,$596.25,$155060.75,127,$596.25
2024-06-27,21:00:00,20067.25,SELL,3,1.02h,Stop Loss,$15.75,$612.00,$155076.50,127,$612.00
2024-06-27,22:11:00,20069.0,BUY,3,0.02h,Stop Loss,$-18.00,$594.00,$155058.50,127,$594.00
2024-06-27,23:00:00,20083.0,SELL,3,13.00h,Stop Loss,$-18.00,$576.00,$155040.50,127,$576.00
,,,,,,,,,,,
2024-06-28,12:00:00,20126.75,BUY,3,0.02h,Break Even,$0.75,$0.75,$155041.25,128,$0.75
2024-06-28,12:39:00,20130.25,SELL,3,0.02h,Stop Loss,$-18.00,$-17.25,$155023.25,128,$-17.25
2024-06-28,13:39:00,20087.5,BUY,3,0.02h,Stop Loss,$42.00,$24.75,$155065.25,128,$24.75
2024-06-28,14:37:00,20210.0,SELL,3,0.02h,Stop Loss,$94.50,$119.25,$155159.75,128,$119.25
2024-06-28,15:35:00,20120.5,BUY,3,0.02h,Stop Loss,$-18.00,$101.25,$155141.75,128,$101.25
2024-06-28,15:44:00,20101.0,SELL,3,0.02h,Stop Loss,$15.75,$117.00,$155157.50,128,$117.00
2024-06-28,15:51:00,20120.75,BUY,3,0.02h,Break Even,$0.75,$117.75,$155158.25,128,$117.75
2024-06-28,15:59:00,20103.5,SELL,3,0.02h,Stop Loss,$-18.00,$99.75,$155140.25,128,$99.75
2024-06-28,16:02:00,20113.75,BUY,3,0.02h,Break Even,$0.75,$100.50,$155141.00,128,$100.50
2024-06-28,16:03:00,20105.0,SELL,3,0.02h,Stop Loss,$72.00,$172.50,$155213.00,128,$172.50
2024-06-28,16:30:00,20070.75,BUY,3,0.02h,Stop Loss,$64.50,$237.00,$155277.50,128,$237.00
2024-06-28,16:34:00,20046.5,SELL,3,0.02h,Stop Loss,$169.50,$406.50,$155447.00,128,$406.50
2024-06-28,17:00:00,20036.5,BUY,3,0.02h,Stop Loss,$-18.00,$388.50,$155429.00,128,$388.50
2024-06-28,17:32:00,20046.25,SELL,3,0.02h,Break Even,$0.75,$389.25,$155429.75,128,$389.25
2024-06-28,18:05:00,20058.25,BUY,3,0.02h,Stop Loss,$-18.00,$371.25,$155411.75,128,$371.25
2024-06-28,18:23:00,20014.0,SELL,3,0.02h,Stop Loss,$87.00,$458.25,$155498.75,128,$458.25
2024-06-28,19:44:00,20013.0,BUY,3,0.02h,Stop Loss,$27.00,$485.25,$155525.75,128,$485.25
2024-06-28,19:56:00,19966.75,SELL,3,0.02h,Stop Loss,$207.00,$692.25,$155732.75,128,$692.25
2024-06-28,20:20:00,19968.75,BUY,3,0.02h,Stop Loss,$-18.00,$674.25,$155714.75,128,$674.25
2024-06-28,20:35:00,19961.5,SELL,3,0.02h,Stop Loss,$-18.00,$656.25,$155696.75,128,$656.25
2024-06-28,20:44:00,19970.75,BUY,3,0.02h,Break Even,$0.75,$657.00,$155697.50,128,$657.00
,,,,,,,,,,,
2024-07-01,12:34:00,19976.75,SELL,3,0.02h,Stop Loss,$-18.00,$-18.00,$155679.50,129,$-18.00
2024-07-01,12:35:00,19981.75,BUY,3,0.02h,Break Even,$0.75,$-17.25,$155680.25,129,$-17.25
2024-07-01,12:37:00,19978.0,SELL,3,0.02h,Break Even,$0.75,$-16.50,$155681.00,129,$-16.50
2024-07-01,12:53:00,19981.0,BUY,3,0.02h,Stop Loss,$30.75,$14.25,$155711.75,129,$14.25
2024-07-01,13:08:00,19965.75,SELL,3,0.02h,Break Even,$0.75,$15.00,$155712.50,129,$15.00
2024-07-01,13:32:00,19976.5,BUY,3,0.02h,Break Even,$0.75,$15.75,$155713.25,129,$15.75
2024-07-01,13:33:00,19946.25,SELL,3,0.02h,Stop Loss,$53.25,$69.00,$155766.50,129,$69.00
2024-07-01,14:04:00,19904.0,BUY,3,0.02h,Stop Loss,$169.50,$238.50,$155936.00,129,$238.50
2024-07-01,14:12:00,19853.25,SELL,3,0.02h,Stop Loss,$192.00,$430.50,$156128.00,129,$430.50
2024-07-01,14:22:00,19909.25,BUY,3,0.02h,Stop Loss,$405.75,$836.25,$156533.75,129,$836.25
2024-07-01,14:42:00,19877.0,SELL,3,0.02h,Stop Loss,$-18.00,$818.25,$156515.75,129,$818.25
2024-07-01,15:12:00,19926.5,BUY,3,0.02h,Break Even,$0.75,$819.00,$156516.50,129,$819.00
2024-07-01,16:59:00,20006.0,SELL,3,0.02h,Break Even,$0.75,$819.75,$156517.25,129,$819.75
2024-07-01,17:37:00,20008.5,BUY,3,0.02h,Break Even,$0.75,$820.50,$156518.00,129,$820.50
2024-07-01,17:50:00,19995.75,SELL,3,0.02h,Stop Loss,$12.00,$832.50,$156530.00,129,$832.50
2024-07-01,18:08:00,20004.75,BUY,3,0.02h,Stop Loss,$83.25,$915.75,$156613.25,129,$915.75
2024-07-01,18:29:00,20006.5,SELL,3,0.02h,Break Even,$0.75,$916.50,$156614.00,129,$916.50
2024-07-01,18:59:00,20017.0,BUY,3,0.02h,Stop Loss,$-18.00,$898.50,$156596.00,129,$898.50
2024-07-01,19:02:00,20008.25,SELL,3,0.02h,Stop Loss,$27.00,$925.50,$156623.00,129,$925.50
2024-07-01,19:06:00,20025.5,BUY,3,0.02h,Stop Loss,$45.75,$971.25,$156668.75,129,$971.25
2024-07-01,19:23:00,20018.5,SELL,3,0.02h,Break Even,$0.75,$972.00,$156669.50,129,$972.00
2024-07-01,19:36:00,20031.25,BUY,3,0.02h,Break Even,$0.75,$972.75,$156670.25,129,$972.75
2024-07-01,19:47:00,20012.5,SELL,3,0.02h,Stop Loss,$19.50,$992.25,$156689.75,129,$992.25
2024-07-01,19:51:00,20031.5,BUY,3,0.02h,Stop Loss,$98.25,$1090.50,$156788.00,129,$1090.50
2024-07-01,20:16:00,20041.0,SELL,3,0.02h,Stop Loss,$15.75,$1106.25,$156803.75,129,$1106.25
2024-07-01,20:26:00,20048.25,BUY,3,0.02h,Stop Loss,$-18.00,$1088.25,$156785.75,129,$1088.25
2024-07-01,20:27:00,20045.25,SELL,3,0.02h,Stop Loss,$-18.00,$1070.25,$156767.75,129,$1070.25
2024-07-01,20:28:00,20046.75,BUY,3,0.05h,Stop Loss,$-18.00,$1052.25,$156749.75,129,$1052.25
2024-07-01,20:44:00,20046.0,BUY,3,0.02h,Stop Loss,$-18.00,$1034.25,$156731.75,129,$1034.25
2024-07-01,20:46:00,20042.5,SELL,3,0.02h,Stop Loss,$-18.00,$1016.25,$156713.75,129,$1016.25
2024-07-01,22:02:00,20047.0,BUY,3,0.02h,Stop Loss,$27.00,$1043.25,$156740.75,129,$1043.25
2024-07-01,22:19:00,20042.75,SELL,3,0.02h,Stop Loss,$-18.00,$1025.25,$156722.75,129,$1025.25
,,,,,,,,,,,
2024-07-02,12:34:00,19958.75,BUY,3,0.02h,Break Even,$0.75,$0.75,$156723.50,130,$0.75
2024-07-02,12:35:00,19953.5,SELL,3,0.02h,Stop Loss,$-18.00,$-17.25,$156705.50,130,$-17.25
2024-07-02,13:01:00,19954.0,BUY,3,0.02h,Stop Loss,$83.25,$66.00,$156788.75,130,$66.00
2024-07-02,14:11:00,20027.5,SELL,3,0.02h,Stop Loss,$34.50,$100.50,$156823.25,130,$100.50
2024-07-02,14:30:00,20058.5,BUY,3,0.02h,Stop Loss,$255.75,$356.25,$157079.00,130,$356.25
2024-07-02,15:21:00,20102.75,SELL,3,0.02h,Stop Loss,$225.75,$582.00,$157304.75,130,$582.00
2024-07-02,15:26:00,20124.0,BUY,3,0.02h,Break Even,$0.75,$582.75,$157305.50,130,$582.75
2024-07-02,15:55:00,20126.5,SELL,3,0.02h,Stop Loss,$60.75,$643.50,$157366.25,130,$643.50
2024-07-02,16:29:00,20102.75,BUY,3,0.02h,Stop Loss,$53.25,$696.75,$157419.50,130,$696.75
2024-07-02,18:35:00,20211.25,SELL,3,0.02h,Stop Loss,$-18.00,$678.75,$157401.50,130,$678.75
2024-07-02,18:36:00,20217.5,BUY,3,0.02h,Stop Loss,$15.75,$694.50,$157417.25,130,$694.50
2024-07-02,18:37:00,20216.75,SELL,3,0.02h,Break Even,$0.75,$695.25,$157418.00,130,$695.25
2024-07-02,18:38:00,20218.25,BUY,3,0.02h,Stop Loss,$34.50,$729.75,$157452.50,130,$729.75
2024-07-02,19:05:00,20221.25,SELL,3,0.02h,Stop Loss,$-18.00,$711.75,$157434.50,130,$711.75
2024-07-02,19:26:00,20224.75,BUY,3,0.02h,Stop Loss,$-18.00,$693.75,$157416.50,130,$693.75
2024-07-02,19:42:00,20218.25,SELL,3,0.02h,Break Even,$0.75,$694.50,$157417.25,130,$694.50
2024-07-02,19:54:00,20231.5,BUY,3,0.02h,Stop Loss,$57.00,$751.50,$157474.25,130,$751.50
2024-07-02,20:38:00,20242.5,SELL,3,0.02h,Stop Loss,$23.25,$774.75,$157497.50,130,$774.75
2024-07-02,21:00:00,20240.25,BUY,3,1.02h,Break Even,$0.75,$775.50,$157498.25,130,$775.50
2024-07-02,22:02:00,20234.5,SELL,3,0.02h,Break Even,$0.75,$776.25,$157499.00,130,$776.25
2024-07-02,22:11:00,20238.5,BUY,3,0.03h,Stop Loss,$-18.00,$758.25,$157481.00,130,$758.25
2024-07-02,22:14:00,20235.5,SELL,3,0.02h,Stop Loss,$-18.00,$740.25,$157463.00,130,$740.25
2024-07-02,22:22:00,20239.5,BUY,3,0.02h,Break Even,$0.75,$741.00,$157463.75,130,$741.00
,,,,,,,,,,,
2024-07-03,12:10:00,20242.0,SELL,3,0.02h,Break Even,$0.75,$0.75,$157464.50,131,$0.75
2024-07-03,13:01:00,20221.75,BUY,3,0.02h,Break Even,$0.75,$1.50,$157465.25,131,$1.50
2024-07-03,13:06:00,20211.5,SELL,3,0.02h,Stop Loss,$-18.00,$-16.50,$157447.25,131,$-16.50
2024-07-03,13:09:00,20221.5,BUY,3,0.02h,Stop Loss,$-18.00,$-34.50,$157429.25,131,$-34.50
2024-07-03,13:24:00,20212.5,SELL,3,0.02h,Break Even,$0.75,$-33.75,$157430.00,131,$-33.75
2024-07-03,13:31:00,20242.5,BUY,3,0.02h,Stop Loss,$173.25,$139.50,$157603.25,131,$139.50
2024-07-03,14:26:00,20257.5,SELL,3,0.02h,Stop Loss,$154.50,$294.00,$157757.75,131,$294.00
2024-07-03,14:39:00,20281.0,BUY,3,0.02h,Stop Loss,$-18.00,$276.00,$157739.75,131,$276.00
2024-07-03,15:36:00,20334.5,SELL,3,0.02h,Break Even,$0.75,$276.75,$157740.50,131,$276.75
2024-07-03,15:44:00,20343.75,BUY,3,0.02h,Stop Loss,$57.00,$333.75,$157797.50,131,$333.75
2024-07-03,16:41:00,20396.5,SELL,3,0.02h,Stop Loss,$12.00,$345.75,$157809.50,131,$345.75
2024-07-03,16:57:00,20406.75,BUY,3,0.02h,Stop Loss,$75.75,$421.50,$157885.25,131,$421.50
2024-07-03,22:02:00,20405.5,SELL,3,0.02h,Break Even,$0.75,$422.25,$157886.00,131,$422.25
2024-07-03,22:23:00,20406.75,BUY,3,0.02h,Stop Loss,$-18.00,$404.25,$157868.00,131,$404.25
2024-07-03,22:49:00,20406.5,SELL,3,0.07h,Stop Loss,$53.25,$457.50,$157921.25,131,$457.50
,,,,,,,,,,,
2024-07-04,12:09:00,20404.25,BUY,3,0.07h,Stop Loss,$-18.00,$-18.00,$157903.25,132,$-18.00
2024-07-04,13:25:00,20406.5,SELL,3,0.02h,Stop Loss,$-18.00,$-36.00,$157885.25,132,$-36.00
2024-07-04,15:01:00,20378.5,BUY,3,0.02h,Break Even,$0.75,$-35.25,$157886.00,132,$-35.25
2024-07-04,15:50:00,20386.5,SELL,3,0.02h,Break Even,$0.75,$-34.50,$157886.75,132,$-34.50
2024-07-04,16:29:00,20383.0,BUY,3,0.02h,Stop Loss,$-18.00,$-52.50,$157868.75,132,$-52.50
2024-07-04,16:48:00,20380.5,SELL,3,0.02h,Stop Loss,$-18.00,$-70.50,$157850.75,132,$-70.50
2024-07-04,16:51:00,20384.0,BUY,3,0.02h,Stop Loss,$-18.00,$-88.50,$157832.75,132,$-88.50
2024-07-04,16:54:00,20379.75,SELL,3,0.02h,Stop Loss,$-18.00,$-106.50,$157814.75,132,$-106.50
2024-07-04,22:05:00,20384.0,BUY,3,0.02h,Stop Loss,$57.00,$-49.50,$157871.75,132,$-49.50
2024-07-04,22:31:00,20382.25,SELL,3,0.02h,Stop Loss,$-18.00,$-67.50,$157853.75,132,$-67.50
2024-07-04,22:33:00,20386.0,BUY,3,0.02h,Break Even,$0.75,$-66.75,$157854.50,132,$-66.75
2024-07-04,22:48:00,20383.5,SELL,3,0.02h,Stop Loss,$-18.00,$-84.75,$157836.50,132,$-84.75
2024-07-04,22:53:00,20386.25,BUY,3,0.05h,Stop Loss,$-18.00,$-102.75,$157818.50,132,$-102.75
2024-07-04,22:59:00,20382.25,SELL,3,0.02h,Stop Loss,$-18.00,$-120.75,$157800.50,132,$-120.75
,,,,,,,,,,,
2024-07-05,12:00:00,20433.5,BUY,3,0.02h,Break Even,$0.75,$0.75,$157801.25,133,$0.75
2024-07-05,12:48:00,20439.5,SELL,3,0.02h,Stop Loss,$139.50,$140.25,$157940.75,133,$140.25
2024-07-05,13:21:00,20426.5,BUY,3,0.02h,Stop Loss,$64.50,$204.75,$158005.25,133,$204.75
2024-07-05,14:12:00,20467.25,SELL,3,0.02h,Break Even,$0.75,$205.50,$158006.00,133,$205.50
2024-07-05,14:19:00,20507.75,BUY,3,0.02h,Stop Loss,$49.50,$255.00,$158055.50,133,$255.00
2024-07-05,15:02:00,20520.5,SELL,3,0.02h,Break Even,$0.75,$255.75,$158056.25,133,$255.75
2024-07-05,15:08:00,20537.25,BUY,3,0.02h,Stop Loss,$105.75,$361.50,$158162.00,133,$361.50
2024-07-05,16:09:00,20582.75,SELL,3,0.02h,Stop Loss,$-18.00,$343.50,$158144.00,133,$343.50
2024-07-05,16:12:00,20594.25,BUY,3,0.02h,Stop Loss,$53.25,$396.75,$158197.25,133,$396.75
2024-07-05,16:36:00,20595.0,SELL,3,0.02h,Stop Loss,$-18.00,$378.75,$158179.25,133,$378.75
2024-07-05,17:15:00,20595.0,BUY,3,0.02h,Stop Loss,$23.25,$402.00,$158202.50,133,$402.00
2024-07-05,18:01:00,20621.75,SELL,3,0.02h,Stop Loss,$98.25,$500.25,$158300.75,133,$500.25
2024-07-05,18:14:00,20627.25,BUY,3,0.02h,Stop Loss,$-18.00,$482.25,$158282.75,133,$482.25
2024-07-05,18:24:00,20615.5,SELL,3,0.02h,Stop Loss,$79.50,$561.75,$158362.25,133,$561.75
2024-07-05,18:50:00,20612.5,BUY,3,0.02h,Stop Loss,$12.00,$573.75,$158374.25,133,$573.75
2024-07-05,19:33:00,20616.75,SELL,3,0.02h,Stop Loss,$-18.00,$555.75,$158356.25,133,$555.75
2024-07-05,19:35:00,20626.75,BUY,3,0.02h,Stop Loss,$-18.00,$537.75,$158338.25,133,$537.75
2024-07-05,20:01:00,20613.0,SELL,3,0.02h,Break Even,$0.75,$538.50,$158339.00,133,$538.50
,,,,,,,,,,,
2024-07-08,12:00:00,20628.25,BUY,3,0.02h,Stop Loss,$-18.00,$-18.00,$158321.00,134,$-18.00
2024-07-08,12:45:00,20632.75,SELL,3,0.02h,Stop Loss,$-18.00,$-36.00,$158303.00,134,$-36.00
2024-07-08,12:47:00,20633.5,BUY,3,0.02h,Stop Loss,$-18.00,$-54.00,$158285.00,134,$-54.00
2024-07-08,12:48:00,20630.5,SELL,3,0.02h,Break Even,$0.75,$-53.25,$158285.75,134,$-53.25
2024-07-08,13:06:00,20632.5,BUY,3,0.02h,Stop Loss,$-18.00,$-71.25,$158267.75,134,$-71.25
2024-07-08,13:31:00,20628.25,SELL,3,0.02h,Stop Loss,$113.25,$42.00,$158381.00,134,$42.00
2024-07-08,13:51:00,20646.5,BUY,3,0.02h,Stop Loss,$64.50,$106.50,$158445.50,134,$106.50
2024-07-08,14:01:00,20607.75,SELL,3,0.02h,Stop Loss,$120.75,$227.25,$158566.25,134,$227.25
2024-07-08,14:08:00,20633.75,BUY,3,0.02h,Stop Loss,$12.00,$239.25,$158578.25,134,$239.25
2024-07-08,14:21:00,20611.25,SELL,3,0.02h,Stop Loss,$34.50,$273.75,$158612.75,134,$273.75
2024-07-08,14:31:00,20631.75,BUY,3,0.02h,Stop Loss,$-18.00,$255.75,$158594.75,134,$255.75
2024-07-08,14:34:00,20615.0,SELL,3,0.02h,Break Even,$0.75,$256.50,$158595.50,134,$256.50
2024-07-08,15:03:00,20618.5,BUY,3,0.02h,Stop Loss,$113.25,$369.75,$158708.75,134,$369.75
2024-07-08,16:04:00,20647.5,SELL,3,0.02h,Break Even,$0.75,$370.50,$158709.50,134,$370.50
2024-07-08,16:49:00,20626.25,BUY,3,0.02h,Break Even,$0.75,$371.25,$158710.25,134,$371.25
2024-07-08,17:52:00,20647.25,SELL,3,0.02h,Break Even,$0.75,$372.00,$158711.00,134,$372.00
2024-07-08,18:21:00,20646.5,BUY,3,0.02h,Stop Loss,$-18.00,$354.00,$158693.00,134,$354.00
2024-07-08,18:33:00,20635.0,SELL,3,0.02h,Break Even,$0.75,$354.75,$158693.75,134,$354.75
2024-07-08,18:55:00,20638.25,BUY,3,0.02h,Stop Loss,$57.00,$411.75,$158750.75,134,$411.75
2024-07-08,19:12:00,20633.25,SELL,3,0.02h,Break Even,$0.75,$412.50,$158751.50,134,$412.50
2024-07-08,19:44:00,20633.5,BUY,3,0.02h,Stop Loss,$45.75,$458.25,$158797.25,134,$458.25
2024-07-08,20:35:00,20675.5,SELL,3,0.02h,Stop Loss,$-18.00,$440.25,$158779.25,134,$440.25
2024-07-08,20:43:00,20678.0,BUY,3,0.02h,Stop Loss,$-18.00,$422.25,$158761.25,134,$422.25
2024-07-08,20:44:00,20677.0,SELL,3,0.02h,Stop Loss,$-18.00,$404.25,$158743.25,134,$404.25
2024-07-08,20:46:00,20677.25,BUY,3,0.03h,Break Even,$0.75,$405.00,$158744.00,134,$405.00
2024-07-08,22:39:00,20690.75,SELL,3,0.05h,Break Even,$0.75,$405.75,$158744.75,134,$405.75
2024-07-08,22:48:00,20694.75,BUY,3,0.02h,Stop Loss,$-18.00,$387.75,$158726.75,134,$387.75
2024-07-08,22:55:00,20691.0,SELL,3,0.02h,Break Even,$0.75,$388.50,$158727.50,134,$388.50
,,,,,,,,,,,
2024-07-09,12:00:00,20725.5,BUY,3,0.02h,Break Even,$0.75,$0.75,$158728.25,135,$0.75
2024-07-09,12:25:00,20715.25,SELL,3,0.02h,Break Even,$0.75,$1.50,$158729.00,135,$1.50
2024-07-09,12:51:00,20719.0,BUY,3,0.02h,Break Even,$0.75,$2.25,$158729.75,135,$2.25
2024-07-09,13:52:00,20726.5,SELL,3,0.02h,Break Even,$0.75,$3.00,$158730.50,135,$3.00
2024-07-09,13:55:00,20739.25,BUY,3,0.02h,Break Even,$0.75,$3.75,$158731.25,135,$3.75
2024-07-09,14:07:00,20720.0,SELL,3,0.02h,Break Even,$0.75,$4.50,$158732.00,135,$4.50
2024-07-09,14:12:00,20753.25,BUY,3,0.02h,Stop Loss,$229.50,$234.00,$158961.50,135,$234.00
2024-07-09,14:25:00,20718.75,SELL,3,0.02h,Stop Loss,$98.25,$332.25,$159059.75,135,$332.25
2024-07-09,14:45:00,20728.5,BUY,3,0.02h,Stop Loss,$117.00,$449.25,$159176.75,135,$449.25
2024-07-09,14:56:00,20712.25,SELL,3,0.02h,Stop Loss,$124.50,$573.75,$159301.25,135,$573.75
2024-07-09,15:47:00,20698.75,BUY,3,0.02h,Stop Loss,$15.75,$589.50,$159317.00,135,$589.50
2024-07-09,16:27:00,20696.0,SELL,3,0.02h,Stop Loss,$-18.00,$571.50,$159299.00,135,$571.50
2024-07-09,17:03:00,20682.0,BUY,3,0.02h,Stop Loss,$83.25,$654.75,$159382.25,135,$654.75
2024-07-09,17:17:00,20663.25,SELL,3,0.02h,Stop Loss,$225.75,$880.50,$159608.00,135,$880.50
2024-07-09,17:39:00,20652.0,BUY,3,0.02h,Break Even,$0.75,$881.25,$159608.75,135,$881.25
2024-07-09,17:48:00,20643.5,SELL,3,0.02h,Break Even,$0.75,$882.00,$159609.50,135,$882.00
2024-07-09,17:52:00,20652.25,BUY,3,0.02h,Stop Loss,$49.50,$931.50,$159659.00,135,$931.50
2024-07-09,18:07:00,20650.5,SELL,3,0.02h,Stop Loss,$-18.00,$913.50,$159641.00,135,$913.50
2024-07-09,18:09:00,20656.75,BUY,3,0.02h,Stop Loss,$53.25,$966.75,$159694.25,135,$966.75
2024-07-09,18:28:00,20654.75,SELL,3,0.02h,Stop Loss,$38.25,$1005.00,$159732.50,135,$1005.00
2024-07-09,18:37:00,20664.5,BUY,3,0.02h,Break Even,$0.75,$1005.75,$159733.25,135,$1005.75
2024-07-09,18:56:00,20660.25,SELL,3,0.02h,Stop Loss,$30.75,$1036.50,$159764.00,135,$1036.50
2024-07-09,19:00:00,20671.5,BUY,3,0.02h,Break Even,$0.75,$1037.25,$159764.75,135,$1037.25
2024-07-09,19:22:00,20659.5,SELL,3,0.02h,Stop Loss,$12.00,$1049.25,$159776.75,135,$1049.25
2024-07-09,19:39:00,20667.0,BUY,3,0.02h,Stop Loss,$-18.00,$1031.25,$159758.75,135,$1031.25
2024-07-09,20:12:00,20673.25,SELL,3,0.03h,Stop Loss,$-18.00,$1013.25,$159740.75,135,$1013.25
2024-07-09,20:15:00,20675.0,BUY,3,0.02h,Break Even,$0.75,$1014.00,$159741.50,135,$1014.00
2024-07-09,22:54:00,20692.25,SELL,3,0.02h,Stop Loss,$-18.00,$996.00,$159723.50,135,$996.00
,,,,,,,,,,,
2024-07-10,12:00:00,20749.75,BUY,3,0.02h,Break Even,$0.75,$0.75,$159724.25,136,$0.75
2024-07-10,12:47:00,20755.0,SELL,3,0.02h,Break Even,$0.75,$1.50,$159725.00,136,$1.50
2024-07-10,13:07:00,20758.5,BUY,3,0.02h,Break Even,$0.75,$2.25,$159725.75,136,$2.25
2024-07-10,13:20:00,20755.5,SELL,3,0.02h,Stop Loss,$-18.00,$-15.75,$159707.75,136,$-15.75
2024-07-10,13:26:00,20765.0,BUY,3,0.02h,Stop Loss,$-18.00,$-33.75,$159689.75,136,$-33.75
2024-07-10,13:32:00,20752.5,SELL,3,0.02h,Stop Loss,$132.00,$98.25,$159821.75,136,$98.25
2024-07-10,13:46:00,20761.25,BUY,3,0.02h,Stop Loss,$-18.00,$80.25,$159803.75,136,$80.25
2024-07-10,14:21:00,20761.0,SELL,3,0.02h,Stop Loss,$38.25,$118.50,$159842.00,136,$118.50
2024-07-10,15:23:00,20735.0,BUY,3,0.02h,Stop Loss,$-18.00,$100.50,$159824.00,136,$100.50
2024-07-10,17:27:00,20848.25,SELL,3,0.02h,Stop Loss,$-18.00,$82.50,$159806.00,136,$82.50
2024-07-10,17:28:00,20857.75,BUY,3,0.02h,Stop Loss,$-18.00,$64.50,$159788.00,136,$64.50
2024-07-10,18:20:00,20867.0,SELL,3,0.02h,Stop Loss,$45.75,$110.25,$159833.75,136,$110.25
2024-07-10,18:36:00,20872.75,BUY,3,0.02h,Stop Loss,$-18.00,$92.25,$159815.75,136,$92.25
2024-07-10,18:42:00,20867.0,SELL,3,0.02h,Break Even,$0.75,$93.00,$159816.50,136,$93.00
2024-07-10,18:44:00,20873.25,BUY,3,0.02h,Stop Loss,$-18.00,$75.00,$159798.50,136,$75.00
2024-07-10,19:02:00,20869.75,SELL,3,0.02h,Stop Loss,$42.00,$117.00,$159840.50,136,$117.00
2024-07-10,19:30:00,20870.0,BUY,3,0.02h,Stop Loss,$-18.00,$99.00,$159822.50,136,$99.00
2024-07-10,20:04:00,20884.0,SELL,3,0.02h,Stop Loss,$27.00,$126.00,$159849.50,136,$126.00
2024-07-10,20:20:00,20893.5,BUY,3,0.02h,Stop Loss,$-18.00,$108.00,$159831.50,136,$108.00
2024-07-10,20:47:00,20886.75,SELL,3,0.02h,Stop Loss,$-18.00,$90.00,$159813.50,136,$90.00
2024-07-10,20:55:00,20892.5,BUY,3,0.02h,Break Even,$0.75,$90.75,$159814.25,136,$90.75
2024-07-10,22:14:00,20893.25,SELL,3,0.03h,Stop Loss,$-18.00,$72.75,$159796.25,136,$72.75
2024-07-10,22:25:00,20896.5,BUY,3,0.02h,Stop Loss,$-18.00,$54.75,$159778.25,136,$54.75
2024-07-10,22:33:00,20892.5,SELL,3,0.07h,Stop Loss,$49.50,$104.25,$159827.75,136,$104.25
2024-07-10,22:58:00,20889.75,BUY,3,0.02h,Break Even,$0.75,$105.00,$159828.50,136,$105.00
,,,,,,,,,,,
2024-07-11,12:00:00,20882.25,SELL,3,0.02h,Break Even,$0.75,$0.75,$159829.25,137,$0.75
2024-07-11,12:30:00,20888.75,BUY,3,0.02h,Stop Loss,$1245.75,$1246.50,$161075.00,137,$1246.50
2024-07-11,12:52:00,20907.5,SELL,3,0.02h,Stop Loss,$267.00,$1513.50,$161342.00,137,$1513.50
2024-07-11,13:18:00,20914.0,BUY,3,0.02h,Break Even,$0.75,$1514.25,$161342.75,137,$1514.25
2024-07-11,13:29:00,20895.5,SELL,3,0.02h,Stop Loss,$75.75,$1590.00,$161418.50,137,$1590.00
2024-07-11,16:11:00,20519.0,BUY,3,0.02h,Stop Loss,$49.50,$1639.50,$161468.00,137,$1639.50
2024-07-11,16:19:00,20481.5,SELL,3,0.02h,Stop Loss,$-18.00,$1621.50,$161450.00,137,$1621.50
2024-07-11,16:31:00,20510.0,BUY,3,0.02h,Stop Loss,$60.75,$1682.25,$161510.75,137,$1682.25
2024-07-11,16:48:00,20470.5,SELL,3,0.02h,Stop Loss,$225.75,$1908.00,$161736.50,137,$1908.00
2024-07-11,17:17:00,20474.25,BUY,3,0.02h,Break Even,$0.75,$1908.75,$161737.25,137,$1908.75
2024-07-11,17:35:00,20459.5,SELL,3,0.02h,Stop Loss,$90.75,$1999.50,$161828.00,137,$1999.50
2024-07-11,18:17:00,20412.5,BUY,3,0.02h,Stop Loss,$-18.00,$1981.50,$161810.00,137,$1981.50
2024-07-11,19:22:00,20466.5,SELL,3,0.02h,Stop Loss,$34.50,$2016.00,$161844.50,137,$2016.00
2024-07-11,19:38:00,20481.25,BUY,3,0.02h,Stop Loss,$57.00,$2073.00,$161901.50,137,$2073.00
2024-07-11,19:45:00,20448.25,SELL,3,0.02h,Break Even,$0.75,$2073.75,$161902.25,137,$2073.75
2024-07-11,19:50:00,20466.0,BUY,3,0.02h,Stop Loss,$124.50,$2198.25,$162026.75,137,$2198.25
2024-07-11,19:55:00,20447.0,SELL,3,0.02h,Stop Loss,$98.25,$2296.50,$162125.00,137,$2296.50
2024-07-11,20:31:00,20452.0,BUY,3,0.02h,Stop Loss,$-18.00,$2278.50,$162107.00,137,$2278.50
2024-07-11,20:39:00,20442.75,SELL,3,0.02h,Stop Loss,$-18.00,$2260.50,$162089.00,137,$2260.50
2024-07-11,20:40:00,20445.5,BUY,3,0.02h,Break Even,$0.75,$2261.25,$162089.75,137,$2261.25
2024-07-11,20:43:00,20442.5,SELL,3,0.02h,Break Even,$0.75,$2262.00,$162090.50,137,$2262.00
2024-07-11,20:45:00,20445.5,BUY,3,0.02h,Break Even,$0.75,$2262.75,$162091.25,137,$2262.75
2024-07-11,20:46:00,20442.5,SELL,3,0.02h,Stop Loss,$12.00,$2274.75,$162103.25,137,$2274.75
2024-07-11,22:04:00,20444.25,BUY,3,0.02h,Stop Loss,$12.00,$2286.75,$162115.25,137,$2286.75
2024-07-11,22:07:00,20437.5,SELL,3,0.02h,Break Even,$0.75,$2287.50,$162116.00,137,$2287.50
2024-07-11,22:32:00,20440.0,BUY,3,0.02h,Stop Loss,$68.25,$2355.75,$162184.25,137,$2355.75
,,,,,,,,,,,
2024-07-12,12:03:00,20429.5,SELL,3,0.02h,Break Even,$0.75,$0.75,$162185.00,138,$0.75
2024-07-12,12:35:00,20429.0,BUY,3,0.02h,Stop Loss,$-18.00,$-17.25,$162167.00,138,$-17.25
2024-07-12,13:19:00,20436.0,SELL,3,0.02h,Break Even,$0.75,$-16.50,$162167.75,138,$-16.50
2024-07-12,13:31:00,20459.25,BUY,3,0.02h,Stop Loss,$128.25,$111.75,$162296.00,138,$111.75
2024-07-12,14:24:00,20536.75,SELL,3,0.02h,Break Even,$0.75,$112.50,$162296.75,138,$112.50
2024-07-12,14:26:00,20558.75,BUY,3,0.02h,Break Even,$0.75,$113.25,$162297.50,138,$113.25
2024-07-12,15:20:00,20634.75,SELL,3,0.02h,Stop Loss,$12.00,$125.25,$162309.50,138,$125.25
2024-07-12,15:30:00,20655.5,BUY,3,0.02h,Break Even,$0.75,$126.00,$162310.25,138,$126.00
2024-07-12,15:35:00,20638.0,SELL,3,0.02h,Break Even,$0.75,$126.75,$162311.00,138,$126.75
2024-07-12,15:40:00,20654.0,BUY,3,0.02h,Stop Loss,$57.00,$183.75,$162368.00,138,$183.75
2024-07-12,15:54:00,20647.75,SELL,3,0.02h,Stop Loss,$-18.00,$165.75,$162350.00,138,$165.75
2024-07-12,16:37:00,20606.5,BUY,3,0.02h,Break Even,$0.75,$166.50,$162350.75,138,$166.50
2024-07-12,16:50:00,20589.75,SELL,3,0.02h,Stop Loss,$-18.00,$148.50,$162332.75,138,$148.50
2024-07-12,16:51:00,20597.0,BUY,3,0.02h,Stop Loss,$53.25,$201.75,$162386.00,138,$201.75
2024-07-12,18:08:00,20703.5,SELL,3,0.02h,Break Even,$0.75,$202.50,$162386.75,138,$202.50
2024-07-12,18:41:00,20709.5,BUY,3,0.02h,Stop Loss,$-18.00,$184.50,$162368.75,138,$184.50
2024-07-12,18:53:00,20701.25,SELL,3,0.02h,Break Even,$0.75,$185.25,$162369.50,138,$185.25
2024-07-12,18:58:00,20708.5,BUY,3,0.02h,Break Even,$0.75,$186.00,$162370.25,138,$186.00
2024-07-12,19:05:00,20698.25,SELL,3,0.02h,Stop Loss,$-18.00,$168.00,$162352.25,138,$168.00
2024-07-12,20:42:00,20537.5,BUY,3,0.02h,Break Even,$0.75,$168.75,$162353.00,138,$168.75
,,,,,,,,,,,
2024-07-15,12:39:00,20612.5,SELL,3,0.02h,Stop Loss,$53.25,$53.25,$162406.25,139,$53.25
2024-07-15,13:06:00,20612.5,BUY,3,0.02h,Break Even,$0.75,$54.00,$162407.00,139,$54.00
2024-07-15,13:13:00,20602.0,SELL,3,0.02h,Break Even,$0.75,$54.75,$162407.75,139,$54.75
2024-07-15,13:21:00,20612.75,BUY,3,0.02h,Break Even,$0.75,$55.50,$162408.50,139,$55.50
2024-07-15,13:46:00,20599.25,SELL,3,0.02h,Stop Loss,$147.00,$202.50,$162555.50,139,$202.50
2024-07-15,13:55:00,20635.25,BUY,3,0.02h,Break Even,$0.75,$203.25,$162556.25,139,$203.25
2024-07-15,15:30:00,20734.5,SELL,3,0.02h,Stop Loss,$147.00,$350.25,$162703.25,139,$350.25
2024-07-15,16:30:00,20663.75,BUY,3,0.02h,Stop Loss,$-18.00,$332.25,$162685.25,139,$332.25
2024-07-15,16:46:00,20645.75,SELL,3,0.02h,Stop Loss,$94.50,$426.75,$162779.75,139,$426.75
2024-07-15,16:59:00,20654.0,BUY,3,0.02h,Break Even,$0.75,$427.50,$162780.50,139,$427.50
2024-07-15,17:01:00,20617.25,SELL,3,0.02h,Stop Loss,$327.00,$754.50,$163107.50,139,$754.50
2024-07-15,17:25:00,20647.5,BUY,3,0.02h,Break Even,$0.75,$755.25,$163108.25,139,$755.25
2024-07-15,17:28:00,20616.5,SELL,3,0.02h,Stop Loss,$184.50,$939.75,$163292.75,139,$939.75
2024-07-15,18:24:00,20589.25,BUY,3,0.02h,Stop Loss,$105.75,$1045.50,$163398.50,139,$1045.50
2024-07-15,18:46:00,20588.5,SELL,3,0.02h,Stop Loss,$-18.00,$1027.50,$163380.50,139,$1027.50
2024-07-15,18:48:00,20606.25,BUY,3,0.02h,Stop Loss,$75.75,$1103.25,$163456.25,139,$1103.25
2024-07-15,19:37:00,20611.5,SELL,3,0.02h,Stop Loss,$34.50,$1137.75,$163490.75,139,$1137.75
2024-07-15,20:01:00,20599.25,BUY,3,0.02h,Break Even,$0.75,$1138.50,$163491.50,139,$1138.50
2024-07-15,22:35:00,20639.25,SELL,3,0.02h,Stop Loss,$30.75,$1169.25,$163522.25,139,$1169.25
,,,,,,,,,,,
2024-07-16,12:27:00,20634.25,BUY,3,0.02h,Stop Loss,$-18.00,$-18.00,$163504.25,140,$-18.00
2024-07-16,12:51:00,20628.25,SELL,3,0.02h,Stop Loss,$72.00,$54.00,$163576.25,140,$54.00
2024-07-16,13:12:00,20636.0,BUY,3,0.02h,Break Even,$0.75,$54.75,$163577.00,140,$54.75
2024-07-16,13:46:00,20630.75,SELL,3,0.02h,Stop Loss,$98.25,$153.00,$163675.25,140,$153.00
2024-07-16,14:33:00,20548.75,BUY,3,0.02h,Stop Loss,$-18.00,$135.00,$163657.25,140,$135.00
2024-07-16,14:59:00,20543.75,SELL,3,0.02h,Stop Loss,$124.50,$259.50,$163781.75,140,$259.50
2024-07-16,15:05:00,20568.5,BUY,3,0.02h,Break Even,$0.75,$260.25,$163782.50,140,$260.25
2024-07-16,15:22:00,20561.5,SELL,3,0.02h,Stop Loss,$-18.00,$242.25,$163764.50,140,$242.25
2024-07-16,15:51:00,20554.0,BUY,3,0.02h,Stop Loss,$139.50,$381.75,$163904.00,140,$381.75
2024-07-16,16:08:00,20547.25,SELL,3,0.02h,Stop Loss,$-18.00,$363.75,$163886.00,140,$363.75
2024-07-16,16:49:00,20518.75,BUY,3,0.02h,Stop Loss,$30.75,$394.50,$163916.75,140,$394.50
2024-07-16,17:16:00,20515.0,SELL,3,0.02h,Stop Loss,$173.25,$567.75,$164090.00,140,$567.75
2024-07-16,17:49:00,20523.5,BUY,3,0.02h,Stop Loss,$-18.00,$549.75,$164072.00,140,$549.75
2024-07-16,18:04:00,20508.5,SELL,3,0.02h,Break Even,$0.75,$550.50,$164072.75,140,$550.50
2024-07-16,18:06:00,20522.75,BUY,3,0.02h,Break Even,$0.75,$551.25,$164073.50,140,$551.25
2024-07-16,18:14:00,20506.5,SELL,3,0.02h,Stop Loss,$-18.00,$533.25,$164055.50,140,$533.25
2024-07-16,18:24:00,20528.5,BUY,3,0.02h,Stop Loss,$218.25,$751.50,$164273.75,140,$751.50
2024-07-16,19:20:00,20566.75,SELL,3,0.02h,Stop Loss,$38.25,$789.75,$164312.00,140,$789.75
2024-07-16,19:34:00,20584.25,BUY,3,0.02h,Stop Loss,$124.50,$914.25,$164436.50,140,$914.25
2024-07-16,19:47:00,20568.5,SELL,3,0.02h,Break Even,$0.75,$915.00,$164437.25,140,$915.00
2024-07-16,19:52:00,20593.25,BUY,3,0.02h,Stop Loss,$12.00,$927.00,$164449.25,140,$927.00
2024-07-16,20:24:00,20594.25,SELL,3,0.03h,Break Even,$0.75,$927.75,$164450.00,140,$927.75
2024-07-16,20:29:00,20599.0,BUY,3,0.02h,Stop Loss,$-18.00,$909.75,$164432.00,140,$909.75
2024-07-16,20:47:00,20597.0,SELL,3,0.03h,Stop Loss,$-18.00,$891.75,$164414.00,140,$891.75
2024-07-16,22:19:00,20591.75,BUY,3,0.02h,Stop Loss,$-18.00,$873.75,$164396.00,140,$873.75
2024-07-16,22:21:00,20588.5,SELL,3,0.02h,Break Even,$0.75,$874.50,$164396.75,140,$874.50
2024-07-16,22:35:00,20592.0,BUY,3,0.02h,Stop Loss,$-18.00,$856.50,$164378.75,140,$856.50
2024-07-16,22:49:00,20587.25,SELL,3,0.02h,Stop Loss,$-18.00,$838.50,$164360.75,140,$838.50
,,,,,,,,,,,
2024-07-17,13:10:00,20293.5,BUY,3,0.02h,Break Even,$0.75,$0.75,$164361.50,141,$0.75
2024-07-17,13:13:00,20284.0,SELL,3,0.02h,Break Even,$0.75,$1.50,$164362.25,141,$1.50
2024-07-17,14:36:00,20169.5,BUY,3,0.02h,Break Even,$0.75,$2.25,$164363.00,141,$2.25
2024-07-17,14:50:00,20125.25,SELL,3,0.02h,Stop Loss,$113.25,$115.50,$164476.25,141,$115.50
2024-07-17,15:20:00,20127.75,BUY,3,0.02h,Stop Loss,$-18.00,$97.50,$164458.25,141,$97.50
2024-07-17,15:21:00,20113.5,SELL,3,0.02h,Break Even,$0.75,$98.25,$164459.00,141,$98.25
2024-07-17,15:22:00,20138.0,BUY,3,0.02h,Stop Loss,$72.00,$170.25,$164531.00,141,$170.25
2024-07-17,15:27:00,20097.5,SELL,3,0.02h,Break Even,$0.75,$171.00,$164531.75,141,$171.00
2024-07-17,15:31:00,20130.0,BUY,3,0.02h,Stop Loss,$15.75,$186.75,$164547.50,141,$186.75
2024-07-17,15:37:00,20108.0,SELL,3,0.02h,Stop Loss,$-18.00,$168.75,$164529.50,141,$168.75
2024-07-17,16:55:00,20047.75,BUY,3,0.02h,Stop Loss,$158.25,$327.00,$164687.75,141,$327.00
2024-07-17,17:10:00,20023.0,SELL,3,0.02h,Stop Loss,$-18.00,$309.00,$164669.75,141,$309.00
2024-07-17,17:22:00,20051.0,BUY,3,0.02h,Break Even,$0.75,$309.75,$164670.50,141,$309.75
2024-07-17,17:29:00,20033.0,SELL,3,0.02h,Stop Loss,$-18.00,$291.75,$164652.50,141,$291.75
2024-07-17,17:30:00,20046.5,BUY,3,0.02h,Stop Loss,$147.00,$438.75,$164799.50,141,$438.75
2024-07-17,17:44:00,20040.5,SELL,3,0.02h,Break Even,$0.75,$439.50,$164800.25,141,$439.50
2024-07-17,18:11:00,20048.0,BUY,3,0.02h,Stop Loss,$49.50,$489.00,$164849.75,141,$489.00
2024-07-17,18:40:00,20041.25,SELL,3,0.02h,Stop Loss,$-18.00,$471.00,$164831.75,141,$471.00
2024-07-17,19:13:00,20039.5,BUY,3,0.02h,Break Even,$0.75,$471.75,$164832.50,141,$471.75
2024-07-17,19:18:00,20013.0,SELL,3,0.02h,Break Even,$0.75,$472.50,$164833.25,141,$472.50
2024-07-17,19:22:00,20032.25,BUY,3,0.02h,Stop Loss,$222.00,$694.50,$165055.25,141,$694.50
2024-07-17,19:40:00,20027.25,SELL,3,0.02h,Stop Loss,$-18.00,$676.50,$165037.25,141,$676.50
2024-07-17,19:50:00,20055.0,BUY,3,0.02h,Stop Loss,$192.00,$868.50,$165229.25,141,$868.50
2024-07-17,19:57:00,20014.25,SELL,3,0.02h,Stop Loss,$102.00,$970.50,$165331.25,141,$970.50
2024-07-17,20:24:00,20009.25,BUY,3,0.02h,Stop Loss,$98.25,$1068.75,$165429.50,141,$1068.75
2024-07-17,20:47:00,20009.75,SELL,3,0.02h,Stop Loss,$-18.00,$1050.75,$165411.50,141,$1050.75
2024-07-17,21:26:00,20017.0,BUY,3,0.58h,Stop Loss,$405.75,$1456.50,$165817.25,141,$1456.50
2024-07-17,22:38:00,20042.5,SELL,3,0.02h,Stop Loss,$60.75,$1517.25,$165878.00,141,$1517.25
2024-07-17,22:51:00,20052.75,BUY,3,0.02h,Stop Loss,$-18.00,$1499.25,$165860.00,141,$1499.25
,,,,,,,,,,,
2024-07-18,13:23:00,20136.75,SELL,3,0.02h,Break Even,$0.75,$0.75,$165860.75,142,$0.75
2024-07-18,14:06:00,20092.25,BUY,3,0.02h,Stop Loss,$150.75,$151.50,$166011.50,142,$151.50
2024-07-18,14:21:00,20056.75,SELL,3,0.02h,Stop Loss,$68.25,$219.75,$166079.75,142,$219.75
2024-07-18,14:54:00,20011.5,BUY,3,0.02h,Stop Loss,$79.50,$299.25,$166159.25,142,$299.25
2024-07-18,15:07:00,19948.75,SELL,3,0.02h,Stop Loss,$147.00,$446.25,$166306.25,142,$446.25
2024-07-18,16:10:00,19837.75,BUY,3,0.02h,Stop Loss,$-18.00,$428.25,$166288.25,142,$428.25
2024-07-18,16:20:00,19810.25,SELL,3,0.02h,Break Even,$0.75,$429.00,$166289.00,142,$429.00
2024-07-18,16:21:00,19815.25,BUY,3,0.02h,Stop Loss,$267.00,$696.00,$166556.00,142,$696.00
2024-07-18,17:09:00,19874.25,SELL,3,0.02h,Stop Loss,$128.25,$824.25,$166684.25,142,$824.25
2024-07-18,17:13:00,19914.0,BUY,3,0.02h,Stop Loss,$-18.00,$806.25,$166666.25,142,$806.25
2024-07-18,17:38:00,19906.0,SELL,3,0.02h,Stop Loss,$188.25,$994.50,$166854.50,142,$994.50
2024-07-18,17:48:00,19916.0,BUY,3,0.02h,Stop Loss,$75.75,$1070.25,$166930.25,142,$1070.25
2024-07-18,17:52:00,19883.75,SELL,3,0.02h,Stop Loss,$90.75,$1161.00,$167021.00,142,$1161.00
2024-07-18,18:25:00,19886.0,BUY,3,0.02h,Stop Loss,$-18.00,$1143.00,$167003.00,142,$1143.00
2024-07-18,18:28:00,19856.75,SELL,3,0.02h,Stop Loss,$60.75,$1203.75,$167063.75,142,$1203.75
2024-07-18,18:57:00,19845.25,BUY,3,0.02h,Stop Loss,$19.50,$1223.25,$167083.25,142,$1223.25
2024-07-18,19:08:00,19830.0,SELL,3,0.02h,Stop Loss,$169.50,$1392.75,$167252.75,142,$1392.75
2024-07-18,19:30:00,19823.75,BUY,3,0.02h,Stop Loss,$102.00,$1494.75,$167354.75,142,$1494.75
2024-07-18,22:23:00,19947.5,SELL,3,0.02h,Break Even,$0.75,$1495.50,$167355.50,142,$1495.50
2024-07-18,22:48:00,19959.5,BUY,3,0.02h,Break Even,$0.75,$1496.25,$167356.25,142,$1496.25
,,,,,,,,,,,
2024-07-19,12:00:00,19923.5,SELL,3,0.02h,Stop Loss,$-18.00,$-18.00,$167338.25,143,$-18.00
2024-07-19,12:36:00,19925.5,BUY,3,0.02h,Stop Loss,$87.00,$69.00,$167425.25,143,$69.00
2024-07-19,13:04:00,19919.25,SELL,3,0.02h,Stop Loss,$60.75,$129.75,$167486.00,143,$129.75
2024-07-19,13:40:00,19927.5,BUY,3,0.02h,Stop Loss,$402.00,$531.75,$167888.00,143,$531.75
2024-07-19,13:48:00,19862.75,SELL,3,0.02h,Stop Loss,$12.00,$543.75,$167900.00,143,$543.75
2024-07-19,13:52:00,19922.25,BUY,3,0.02h,Stop Loss,$109.50,$653.25,$168009.50,143,$653.25
2024-07-19,14:13:00,19879.0,SELL,3,0.02h,Stop Loss,$424.50,$1077.75,$168434.00,143,$1077.75
2024-07-19,14:55:00,19821.5,BUY,3,0.02h,Stop Loss,$128.25,$1206.00,$168562.25,143,$1206.00
2024-07-19,15:11:00,19800.5,SELL,3,0.02h,Stop Loss,$214.50,$1420.50,$168776.75,143,$1420.50
2024-07-19,15:52:00,19767.25,BUY,3,0.02h,Stop Loss,$38.25,$1458.75,$168815.00,143,$1458.75
2024-07-19,16:20:00,19778.0,SELL,3,0.02h,Break Even,$0.75,$1459.50,$168815.75,143,$1459.50
2024-07-19,17:00:00,19728.75,BUY,3,0.02h,Break Even,$0.75,$1460.25,$168816.50,143,$1460.25
2024-07-19,17:03:00,19695.75,SELL,3,0.02h,Stop Loss,$30.75,$1491.00,$168847.25,143,$1491.00
2024-07-19,17:34:00,19690.5,BUY,3,0.02h,Stop Loss,$72.00,$1563.00,$168919.25,143,$1563.00
2024-07-19,17:44:00,19667.75,SELL,3,0.02h,Break Even,$0.75,$1563.75,$168920.00,143,$1563.75
2024-07-19,17:47:00,19700.25,BUY,3,0.02h,Stop Loss,$94.50,$1658.25,$169014.50,143,$1658.25
2024-07-19,18:23:00,19708.75,SELL,3,0.02h,Stop Loss,$60.75,$1719.00,$169075.25,143,$1719.00
2024-07-19,18:52:00,19711.75,BUY,3,0.02h,Break Even,$0.75,$1719.75,$169076.00,143,$1719.75
2024-07-19,19:33:00,19743.75,SELL,3,0.02h,Stop Loss,$64.50,$1784.25,$169140.50,143,$1784.25
2024-07-19,20:44:00,19703.5,BUY,3,0.02h,Stop Loss,$-18.00,$1766.25,$169122.50,143,$1766.25
2024-07-19,20:56:00,19700.5,SELL,3,0.02h,Break Even,$0.75,$1767.00,$169123.25,143,$1767.00
,,,,,,,,,,,
2024-07-22,12:00:00,19897.5,BUY,3,0.02h,Break Even,$0.75,$0.75,$169124.00,144,$0.75
2024-07-22,12:53:00,19913.5,SELL,3,0.02h,Break Even,$0.75,$1.50,$169124.75,144,$1.50
2024-07-22,13:04:00,19924.75,BUY,3,0.02h,Stop Loss,$-18.00,$-16.50,$169106.75,144,$-16.50
2024-07-22,13:32:00,19901.0,SELL,3,0.02h,Stop Loss,$42.00,$25.50,$169148.75,144,$25.50
2024-07-22,13:39:00,19974.25,BUY,3,0.02h,Stop Loss,$19.50,$45.00,$169168.25,144,$45.00
2024-07-22,14:02:00,19945.5,SELL,3,0.02h,Stop Loss,$120.75,$165.75,$169289.00,144,$165.75
2024-07-22,14:29:00,19962.25,BUY,3,0.02h,Stop Loss,$38.25,$204.00,$169327.25,144,$204.00
2024-07-22,14:55:00,19964.25,SELL,3,0.02h,Break Even,$0.75,$204.75,$169328.00,144,$204.75
2024-07-22,15:06:00,19987.75,BUY,3,0.02h,Stop Loss,$105.75,$310.50,$169433.75,144,$310.50
2024-07-22,15:10:00,19895.75,SELL,3,0.02h,Stop Loss,$23.25,$333.75,$169457.00,144,$333.75
2024-07-22,15:54:00,19859.5,BUY,3,0.02h,Stop Loss,$128.25,$462.00,$169585.25,144,$462.00
2024-07-22,17:58:00,19989.5,SELL,3,0.02h,Stop Loss,$60.75,$522.75,$169646.00,144,$522.75
2024-07-22,18:01:00,19998.75,BUY,3,0.02h,Stop Loss,$27.00,$549.75,$169673.00,144,$549.75
2024-07-22,18:44:00,20017.5,SELL,3,0.02h,Stop Loss,$-18.00,$531.75,$169655.00,144,$531.75
2024-07-22,18:54:00,20032.0,BUY,3,0.02h,Break Even,$0.75,$532.50,$169655.75,144,$532.50
2024-07-22,18:56:00,20022.0,SELL,3,0.02h,Stop Loss,$128.25,$660.75,$169784.00,144,$660.75
2024-07-22,19:39:00,20014.75,BUY,3,0.02h,Stop Loss,$53.25,$714.00,$169837.25,144,$714.00
2024-07-22,19:55:00,19992.25,SELL,3,0.02h,Break Even,$0.75,$714.75,$169838.00,144,$714.75
2024-07-22,20:58:00,19976.5,BUY,3,0.02h,Break Even,$0.75,$715.50,$169838.75,144,$715.50
2024-07-22,22:48:00,19986.5,SELL,3,0.02h,Break Even,$0.75,$716.25,$169839.50,144,$716.25
,,,,,,,,,,,
2024-07-23,12:01:00,19992.75,BUY,3,0.02h,Stop Loss,$-18.00,$-18.00,$169821.50,145,$-18.00
2024-07-23,12:06:00,19981.25,SELL,3,0.02h,Stop Loss,$-18.00,$-36.00,$169803.50,145,$-36.00
2024-07-23,12:48:00,19955.75,BUY,3,0.02h,Stop Loss,$102.00,$66.00,$169905.50,145,$66.00
2024-07-23,13:14:00,19958.75,SELL,3,0.02h,Stop Loss,$12.00,$78.00,$169917.50,145,$78.00
2024-07-23,13:19:00,19975.0,BUY,3,0.02h,Stop Loss,$-18.00,$60.00,$169899.50,145,$60.00
2024-07-23,13:29:00,19956.25,SELL,3,0.02h,Break Even,$0.75,$60.75,$169900.25,145,$60.75
2024-07-23,13:38:00,19988.5,BUY,3,0.02h,Stop Loss,$34.50,$95.25,$169934.75,145,$95.25
2024-07-23,14:03:00,19972.25,SELL,3,0.02h,Stop Loss,$132.00,$227.25,$170066.75,145,$227.25
2024-07-23,14:08:00,20014.5,BUY,3,0.02h,Stop Loss,$87.00,$314.25,$170153.75,145,$314.25
2024-07-23,14:33:00,20006.75,SELL,3,0.02h,Stop Loss,$132.00,$446.25,$170285.75,145,$446.25
2024-07-23,15:02:00,19988.75,BUY,3,0.02h,Stop Loss,$-18.00,$428.25,$170267.75,145,$428.25
2024-07-23,15:45:00,20049.5,SELL,3,0.02h,Break Even,$0.75,$429.00,$170268.50,145,$429.00
2024-07-23,17:23:00,19963.25,BUY,3,0.02h,Stop Loss,$27.00,$456.00,$170295.50,145,$456.00
2024-07-23,17:42:00,19953.25,SELL,3,0.02h,Stop Loss,$45.75,$501.75,$170341.25,145,$501.75
2024-07-23,17:47:00,19964.5,BUY,3,0.02h,Stop Loss,$57.00,$558.75,$170398.25,145,$558.75
2024-07-23,18:26:00,19968.75,SELL,3,0.02h,Stop Loss,$285.75,$844.50,$170684.00,145,$844.50
2024-07-23,18:39:00,19986.25,BUY,3,0.02h,Stop Loss,$15.75,$860.25,$170699.75,145,$860.25
2024-07-23,18:42:00,19967.75,SELL,3,0.02h,Stop Loss,$19.50,$879.75,$170719.25,145,$879.75
2024-07-23,19:00:00,19976.25,BUY,3,0.02h,Break Even,$0.75,$880.50,$170720.00,145,$880.50
2024-07-23,19:19:00,19973.25,SELL,3,0.02h,Break Even,$0.75,$881.25,$170720.75,145,$881.25
2024-07-23,19:22:00,19984.5,BUY,3,0.02h,Stop Loss,$90.75,$972.00,$170811.50,145,$972.00
2024-07-23,19:35:00,19974.25,SELL,3,0.02h,Break Even,$0.75,$972.75,$170812.25,145,$972.75
2024-07-23,20:05:00,19986.75,BUY,3,0.02h,Stop Loss,$87.00,$1059.75,$170899.25,145,$1059.75
2024-07-23,20:13:00,19932.75,SELL,3,0.02h,Stop Loss,$34.50,$1094.25,$170933.75,145,$1094.25
2024-07-23,20:24:00,19960.0,BUY,3,0.02h,Stop Loss,$-18.00,$1076.25,$170915.75,145,$1076.25
2024-07-23,21:00:00,19944.75,SELL,3,1.02h,Stop Loss,$1898.25,$2974.50,$172814.00,145,$2974.50
2024-07-23,22:40:00,19828.75,BUY,3,0.02h,Stop Loss,$75.75,$3050.25,$172889.75,145,$3050.25
2024-07-23,22:49:00,19823.5,SELL,3,0.02h,Break Even,$0.75,$3051.00,$172890.50,145,$3051.00
2024-07-23,22:50:00,19827.0,BUY,3,0.02h,Break Even,$0.75,$3051.75,$172891.25,145,$3051.75
2024-07-23,22:54:00,19823.25,SELL,3,0.02h,Break Even,$0.75,$3052.50,$172892.00,145,$3052.50
,,,,,,,,,,,
2024-07-24,13:01:00,19636.25,BUY,3,0.02h,Break Even,$0.75,$0.75,$172892.75,146,$0.75
2024-07-24,13:26:00,19629.25,SELL,3,0.02h,Stop Loss,$-18.00,$-17.25,$172874.75,146,$-17.25
2024-07-24,13:27:00,19641.25,BUY,3,0.02h,Stop Loss,$23.25,$6.00,$172898.00,146,$6.00
2024-07-24,13:31:00,19631.75,SELL,3,0.02h,Break Even,$0.75,$6.75,$172898.75,146,$6.75
2024-07-24,13:32:00,19645.5,BUY,3,0.02h,Stop Loss,$49.50,$56.25,$172948.25,146,$56.25
2024-07-24,13:33:00,19629.25,SELL,3,0.02h,Stop Loss,$327.00,$383.25,$173275.25,146,$383.25
2024-07-24,15:38:00,19404.5,BUY,3,0.02h,Stop Loss,$15.75,$399.00,$173291.00,146,$399.00
2024-07-24,15:41:00,19391.0,SELL,3,0.02h,Stop Loss,$83.25,$482.25,$173374.25,146,$482.25
2024-07-24,16:23:00,19358.25,BUY,3,0.02h,Stop Loss,$-18.00,$464.25,$173356.25,146,$464.25
2024-07-24,16:24:00,19347.75,SELL,3,0.02h,Break Even,$0.75,$465.00,$173357.00,146,$465.00
2024-07-24,17:07:00,19343.0,BUY,3,0.02h,Break Even,$0.75,$465.75,$173357.75,146,$465.75
2024-07-24,17:31:00,19340.25,SELL,3,0.02h,Break Even,$0.75,$466.50,$173358.50,146,$466.50
2024-07-24,17:36:00,19363.0,BUY,3,0.02h,Stop Loss,$-18.00,$448.50,$173340.50,146,$448.50
2024-07-24,17:49:00,19342.5,SELL,3,0.02h,Stop Loss,$30.75,$479.25,$173371.25,146,$479.25
2024-07-24,19:35:00,19267.75,BUY,3,0.02h,Stop Loss,$-18.00,$461.25,$173353.25,146,$461.25
2024-07-24,19:53:00,19243.5,SELL,3,0.02h,Stop Loss,$278.25,$739.50,$173631.50,146,$739.50
2024-07-24,20:10:00,19248.0,BUY,3,0.02h,Stop Loss,$105.75,$845.25,$173737.25,146,$845.25
2024-07-24,20:55:00,19259.25,SELL,3,0.02h,Break Even,$0.75,$846.00,$173738.00,146,$846.00
2024-07-24,22:01:00,19270.75,BUY,3,0.02h,Stop Loss,$23.25,$869.25,$173761.25,146,$869.25
2024-07-24,22:30:00,19278.25,SELL,3,0.02h,Break Even,$0.75,$870.00,$173762.00,146,$870.00
2024-07-24,22:35:00,19288.25,BUY,3,0.02h,Stop Loss,$-18.00,$852.00,$173744.00,146,$852.00
2024-07-24,22:48:00,19280.25,SELL,3,0.02h,Break Even,$0.75,$852.75,$173744.75,146,$852.75
,,,,,,,,,,,
2024-07-25,12:36:00,19161.25,BUY,3,0.02h,Stop Loss,$345.75,$345.75,$174090.50,147,$345.75
2024-07-25,13:06:00,19189.0,SELL,3,0.02h,Stop Loss,$-18.00,$327.75,$174072.50,147,$327.75
2024-07-25,13:07:00,19208.25,BUY,3,0.02h,Stop Loss,$120.75,$448.50,$174193.25,147,$448.50
2024-07-25,13:31:00,19198.75,SELL,3,0.02h,Stop Loss,$98.25,$546.75,$174291.50,147,$546.75
2024-07-25,14:24:00,19029.5,BUY,3,0.02h,Stop Loss,$308.25,$855.00,$174599.75,147,$855.00
2024-07-25,15:28:00,19187.75,SELL,3,0.02h,Stop Loss,$38.25,$893.25,$174638.00,147,$893.25
2024-07-25,15:40:00,19222.5,BUY,3,0.02h,Stop Loss,$-18.00,$875.25,$174620.00,147,$875.25
2024-07-25,15:41:00,19201.5,SELL,3,0.02h,Stop Loss,$450.75,$1326.00,$175070.75,147,$1326.00
2024-07-25,15:54:00,19203.0,BUY,3,0.02h,Stop Loss,$90.75,$1416.75,$175161.50,147,$1416.75
2024-07-25,16:52:00,19304.25,SELL,3,0.02h,Break Even,$0.75,$1417.50,$175162.25,147,$1417.50
2024-07-25,17:00:00,19333.5,BUY,3,0.02h,Stop Loss,$109.50,$1527.00,$175271.75,147,$1527.00
2024-07-25,17:16:00,19314.0,SELL,3,0.02h,Stop Loss,$60.75,$1587.75,$175332.50,147,$1587.75
2024-07-25,17:59:00,19300.0,BUY,3,0.02h,Stop Loss,$-18.00,$1569.75,$175314.50,147,$1569.75
2024-07-25,18:05:00,19256.25,SELL,3,0.02h,Stop Loss,$308.25,$1878.00,$175622.75,147,$1878.00
2024-07-25,18:35:00,19243.5,BUY,3,0.02h,Break Even,$0.75,$1878.75,$175623.50,147,$1878.75
2024-07-25,18:37:00,19204.75,SELL,3,0.02h,Stop Loss,$27.00,$1905.75,$175650.50,147,$1905.75
2024-07-25,19:21:00,19155.0,BUY,3,0.02h,Stop Loss,$372.00,$2277.75,$176022.50,147,$2277.75
2024-07-25,19:38:00,19158.0,SELL,3,0.02h,Stop Loss,$180.75,$2458.50,$176203.25,147,$2458.50
2024-07-25,20:48:00,18983.5,BUY,3,0.02h,Stop Loss,$-18.00,$2440.50,$176185.25,147,$2440.50
2024-07-25,22:28:00,19013.25,SELL,3,0.02h,Stop Loss,$-18.00,$2422.50,$176167.25,147,$2422.50
2024-07-25,22:34:00,19022.75,BUY,3,0.02h,Break Even,$0.75,$2423.25,$176168.00,147,$2423.25
2024-07-25,22:50:00,19015.75,SELL,3,0.02h,Break Even,$0.75,$2424.00,$176168.75,147,$2424.00
,,,,,,,,,,,
2024-07-26,12:00:00,19212.5,BUY,3,0.02h,Break Even,$0.75,$0.75,$176169.50,148,$0.75
2024-07-26,12:36:00,19177.5,SELL,3,0.02h,Break Even,$0.75,$1.50,$176170.25,148,$1.50
2024-07-26,13:26:00,19181.75,BUY,3,0.02h,Break Even,$0.75,$2.25,$176171.00,148,$2.25
2024-07-26,13:29:00,19160.0,SELL,3,0.02h,Stop Loss,$-18.00,$-15.75,$176153.00,148,$-15.75
2024-07-26,14:01:00,19164.5,BUY,3,0.02h,Stop Loss,$87.00,$71.25,$176240.00,148,$71.25
2024-07-26,14:07:00,19081.5,SELL,3,0.02h,Stop Loss,$42.00,$113.25,$176282.00,148,$113.25
2024-07-26,14:24:00,19126.25,BUY,3,0.02h,Stop Loss,$327.00,$440.25,$176609.00,148,$440.25
2024-07-26,14:33:00,19073.5,SELL,3,0.02h,Stop Loss,$139.50,$579.75,$176748.50,148,$579.75
2024-07-26,14:59:00,19119.0,BUY,3,0.02h,Stop Loss,$192.00,$771.75,$176940.50,148,$771.75
2024-07-26,15:19:00,19107.5,SELL,3,0.02h,Stop Loss,$64.50,$836.25,$177005.00,148,$836.25
2024-07-26,15:32:00,19133.25,BUY,3,0.02h,Stop Loss,$45.75,$882.00,$177050.75,148,$882.00
2024-07-26,15:37:00,19113.5,SELL,3,0.02h,Break Even,$0.75,$882.75,$177051.50,148,$882.75
2024-07-26,15:38:00,19134.25,BUY,3,0.02h,Stop Loss,$60.75,$943.50,$177112.25,148,$943.50
2024-07-26,17:11:00,19271.25,SELL,3,0.02h,Stop Loss,$53.25,$996.75,$177165.50,148,$996.75
2024-07-26,17:13:00,19279.0,BUY,3,0.02h,Stop Loss,$27.00,$1023.75,$177192.50,148,$1023.75
2024-07-26,17:15:00,19264.5,SELL,3,0.02h,Stop Loss,$-18.00,$1005.75,$177174.50,148,$1005.75
2024-07-26,17:17:00,19278.0,BUY,3,0.02h,Stop Loss,$15.75,$1021.50,$177190.25,148,$1021.50
2024-07-26,17:35:00,19231.5,SELL,3,0.02h,Stop Loss,$612.00,$1633.50,$177802.25,148,$1633.50
2024-07-26,18:04:00,19210.0,BUY,3,0.02h,Break Even,$0.75,$1634.25,$177803.00,148,$1634.25
2024-07-26,18:05:00,19192.0,SELL,3,0.02h,Stop Loss,$94.50,$1728.75,$177897.50,148,$1728.75
2024-07-26,18:08:00,19208.75,BUY,3,0.02h,Break Even,$0.75,$1729.50,$177898.25,148,$1729.50
2024-07-26,18:20:00,19170.25,SELL,3,0.02h,Break Even,$0.75,$1730.25,$177899.00,148,$1730.25
2024-07-26,19:23:00,19140.75,BUY,3,0.02h,Stop Loss,$64.50,$1794.75,$177963.50,148,$1794.75
2024-07-26,19:35:00,19116.75,SELL,3,0.02h,Stop Loss,$64.50,$1859.25,$178028.00,148,$1859.25
2024-07-26,19:42:00,19170.25,BUY,3,0.02h,Stop Loss,$-18.00,$1841.25,$178010.00,148,$1841.25
2024-07-26,19:54:00,19133.25,SELL,3,0.02h,Stop Loss,$180.75,$2022.00,$178190.75,148,$2022.00
2024-07-26,20:01:00,19174.25,BUY,3,0.02h,Break Even,$0.75,$2022.75,$178191.50,148,$2022.75
2024-07-26,20:39:00,19177.5,SELL,3,0.02h,Stop Loss,$-18.00,$2004.75,$178173.50,148,$2004.75
,,,,,,,,,,,
2024-07-29,12:00:00,19297.0,BUY,3,0.02h,Stop Loss,$169.50,$169.50,$178343.00,149,$169.50
2024-07-29,12:52:00,19316.5,SELL,3,0.02h,Break Even,$0.75,$170.25,$178343.75,149,$170.25
2024-07-29,13:40:00,19312.75,BUY,3,0.02h,Stop Loss,$94.50,$264.75,$178438.25,149,$264.75
2024-07-29,14:10:00,19307.75,SELL,3,0.02h,Stop Loss,$195.75,$460.50,$178634.00,149,$460.50
2024-07-29,14:42:00,19304.75,BUY,3,0.02h,Stop Loss,$113.25,$573.75,$178747.25,149,$573.75
2024-07-29,14:51:00,19252.25,SELL,3,0.02h,Stop Loss,$34.50,$608.25,$178781.75,149,$608.25
2024-07-29,15:45:00,19164.75,BUY,3,0.02h,Stop Loss,$180.75,$789.00,$178962.50,149,$789.00
2024-07-29,16:52:00,19297.25,SELL,3,0.02h,Break Even,$0.75,$789.75,$178963.25,149,$789.75
2024-07-29,16:56:00,19328.5,BUY,3,0.02h,Stop Loss,$15.75,$805.50,$178979.00,149,$805.50
2024-07-29,16:59:00,19313.5,SELL,3,0.02h,Stop Loss,$120.75,$926.25,$179099.75,149,$926.25
2024-07-29,17:04:00,19319.25,BUY,3,0.02h,Stop Loss,$-18.00,$908.25,$179081.75,149,$908.25
2024-07-29,17:06:00,19310.0,SELL,3,0.02h,Stop Loss,$-18.00,$890.25,$179063.75,149,$890.25
2024-07-29,17:11:00,19324.75,BUY,3,0.02h,Stop Loss,$38.25,$928.50,$179102.00,149,$928.50
2024-07-29,17:21:00,19308.75,SELL,3,0.02h,Stop Loss,$105.75,$1034.25,$179207.75,149,$1034.25
2024-07-29,18:58:00,19213.75,BUY,3,0.02h,Stop Loss,$135.75,$1170.00,$179343.50,149,$1170.00
2024-07-29,19:53:00,19238.75,SELL,3,0.02h,Stop Loss,$113.25,$1283.25,$179456.75,149,$1283.25
2024-07-29,20:27:00,19210.5,BUY,3,0.02h,Stop Loss,$19.50,$1302.75,$179476.25,149,$1302.75
2024-07-29,20:53:00,19210.0,SELL,3,0.02h,Break Even,$0.75,$1303.50,$179477.00,149,$1303.50
2024-07-29,21:00:00,19221.75,BUY,3,1.02h,Stop Loss,$143.25,$1446.75,$179620.25,149,$1446.75
2024-07-29,22:33:00,19217.5,SELL,3,0.02h,Stop Loss,$-18.00,$1428.75,$179602.25,149,$1428.75
,,,,,,,,,,,
2024-07-30,12:00:00,19261.75,BUY,3,0.02h,Break Even,$0.75,$0.75,$179603.00,150,$0.75
2024-07-30,12:29:00,19257.25,SELL,3,0.02h,Stop Loss,$27.00,$27.75,$179630.00,150,$27.75
2024-07-30,12:35:00,19261.0,BUY,3,0.02h,Stop Loss,$-18.00,$9.75,$179612.00,150,$9.75
2024-07-30,12:36:00,19257.0,SELL,3,0.02h,Stop Loss,$-18.00,$-8.25,$179594.00,150,$-8.25
2024-07-30,12:37:00,19265.5,BUY,3,0.02h,Break Even,$0.75,$-7.50,$179594.75,150,$-7.50
2024-07-30,13:10:00,19264.5,SELL,3,0.02h,Stop Loss,$-18.00,$-25.50,$179576.75,150,$-25.50
2024-07-30,13:11:00,19268.0,BUY,3,0.02h,Stop Loss,$-18.00,$-43.50,$179558.75,150,$-43.50
2024-07-30,13:46:00,19236.25,SELL,3,0.02h,Stop Loss,$42.00,$-1.50,$179600.75,150,$-1.50
2024-07-30,14:18:00,19229.0,BUY,3,0.02h,Break Even,$0.75,$-0.75,$179601.50,150,$-0.75
2024-07-30,14:19:00,19199.0,SELL,3,0.02h,Stop Loss,$87.00,$86.25,$179688.50,150,$86.25
2024-07-30,16:10:00,18968.5,BUY,3,0.02h,Break Even,$0.75,$87.00,$179689.25,150,$87.00
2024-07-30,16:22:00,18929.0,SELL,3,0.02h,Stop Loss,$173.25,$260.25,$179862.50,150,$260.25
2024-07-30,16:43:00,18945.25,BUY,3,0.02h,Break Even,$0.75,$261.00,$179863.25,150,$261.00
2024-07-30,16:46:00,18915.5,SELL,3,0.02h,Stop Loss,$248.25,$509.25,$180111.50,150,$509.25
2024-07-30,17:15:00,18878.75,BUY,3,0.02h,Stop Loss,$90.75,$600.00,$180202.25,150,$600.00
2024-07-30,18:48:00,18962.75,SELL,3,0.02h,Stop Loss,$49.50,$649.50,$180251.75,150,$649.50
2024-07-30,19:24:00,18947.5,BUY,3,0.02h,Break Even,$0.75,$650.25,$180252.50,150,$650.25
2024-07-30,19:32:00,18926.25,SELL,3,0.02h,Stop Loss,$105.75,$756.00,$180358.25,150,$756.00
2024-07-30,19:47:00,18936.5,BUY,3,0.02h,Stop Loss,$499.50,$1255.50,$180857.75,150,$1255.50
2024-07-30,20:01:00,18866.75,SELL,3,0.02h,Stop Loss,$1433.25,$2688.75,$182291.00,150,$2688.75
2024-07-30,20:30:00,18839.5,BUY,3,0.02h,Stop Loss,$72.00,$2760.75,$182363.00,150,$2760.75
2024-07-30,20:56:00,18847.5,SELL,3,0.02h,Break Even,$0.75,$2761.50,$182363.75,150,$2761.50
2024-07-30,22:01:00,18875.0,BUY,3,0.02h,Stop Loss,$225.75,$2987.25,$182589.50,150,$2987.25
2024-07-30,22:51:00,18969.0,SELL,3,0.02h,Break Even,$0.75,$2988.00,$182590.25,150,$2988.00
,,,,,,,,,,,
2024-07-31,12:00:00,19251.75,BUY,3,0.02h,Stop Loss,$42.00,$42.00,$182632.25,151,$42.00
2024-07-31,13:33:00,19335.5,SELL,3,0.02h,Stop Loss,$72.00,$114.00,$182704.25,151,$114.00
2024-07-31,13:41:00,19398.25,BUY,3,0.02h,Stop Loss,$102.00,$216.00,$182806.25,151,$216.00
2024-07-31,13:47:00,19334.5,SELL,3,0.02h,Stop Loss,$-18.00,$198.00,$182788.25,151,$198.00
2024-07-31,13:50:00,19364.0,BUY,3,0.02h,Break Even,$0.75,$198.75,$182789.00,151,$198.75
2024-07-31,14:49:00,19447.25,SELL,3,0.02h,Stop Loss,$109.50,$308.25,$182898.50,151,$308.25
2024-07-31,15:04:00,19456.5,BUY,3,0.02h,Stop Loss,$68.25,$376.50,$182966.75,151,$376.50
2024-07-31,15:48:00,19481.25,SELL,3,0.02h,Break Even,$0.75,$377.25,$182967.50,151,$377.25
2024-07-31,15:49:00,19487.0,BUY,3,0.02h,Break Even,$0.75,$378.00,$182968.25,151,$378.00
2024-07-31,15:51:00,19476.75,SELL,3,0.02h,Stop Loss,$158.25,$536.25,$183126.50,151,$536.25
2024-07-31,16:14:00,19475.25,BUY,3,0.02h,Stop Loss,$87.00,$623.25,$183213.50,151,$623.25
2024-07-31,16:25:00,19461.75,SELL,3,0.02h,Stop Loss,$248.25,$871.50,$183461.75,151,$871.50
2024-07-31,16:52:00,19452.75,BUY,3,0.02h,Break Even,$0.75,$872.25,$183462.50,151,$872.25
2024-07-31,16:54:00,19440.25,SELL,3,0.02h,Stop Loss,$87.00,$959.25,$183549.50,151,$959.25
2024-07-31,17:06:00,19447.75,BUY,3,0.02h,Stop Loss,$27.00,$986.25,$183576.50,151,$986.25
2024-07-31,17:26:00,19436.0,SELL,3,0.02h,Stop Loss,$12.00,$998.25,$183588.50,151,$998.25
2024-07-31,17:51:00,19432.5,BUY,3,0.02h,Stop Loss,$-18.00,$980.25,$183570.50,151,$980.25
2024-07-31,19:14:00,19535.75,SELL,3,0.02h,Stop Loss,$117.00,$1097.25,$183687.50,151,$1097.25
2024-07-31,19:17:00,19555.25,BUY,3,0.02h,Stop Loss,$139.50,$1236.75,$183827.00,151,$1236.75
2024-07-31,19:19:00,19502.5,SELL,3,0.02h,Stop Loss,$420.75,$1657.50,$184247.75,151,$1657.50
2024-07-31,19:41:00,19515.25,BUY,3,0.02h,Stop Loss,$162.00,$1819.50,$184409.75,151,$1819.50
2024-07-31,19:53:00,19463.75,SELL,3,0.02h,Stop Loss,$143.25,$1962.75,$184553.00,151,$1962.75
2024-07-31,20:01:00,19550.0,BUY,3,0.02h,Stop Loss,$383.25,$2346.00,$184936.25,151,$2346.00
2024-07-31,22:32:00,19621.25,SELL,3,0.02h,Stop Loss,$-18.00,$2328.00,$184918.25,151,$2328.00
2024-07-31,22:37:00,19637.0,BUY,3,0.02h,Break Even,$0.75,$2328.75,$184919.00,151,$2328.75
2024-07-31,22:40:00,19609.5,SELL,3,0.02h,Break Even,$0.75,$2329.50,$184919.75,151,$2329.50
2024-07-31,22:53:00,19638.0,BUY,3,0.02h,Break Even,$0.75,$2330.25,$184920.50,151,$2330.25
,,,,,,,,,,,
2024-08-01,12:00:00,19574.25,SELL,3,0.02h,Break Even,$0.75,$0.75,$184921.25,152,$0.75
2024-08-01,12:19:00,19613.0,BUY,3,0.02h,Stop Loss,$15.75,$16.50,$184937.00,152,$16.50
2024-08-01,12:40:00,19608.5,SELL,3,0.02h,Stop Loss,$139.50,$156.00,$185076.50,152,$156.00
2024-08-01,13:40:00,19563.25,BUY,3,0.02h,Stop Loss,$312.00,$468.00,$185388.50,152,$468.00
2024-08-01,14:06:00,19578.75,SELL,3,0.02h,Stop Loss,$214.50,$682.50,$185603.00,152,$682.50
2024-08-01,16:08:00,19227.75,BUY,3,0.02h,Stop Loss,$-18.00,$664.50,$185585.00,152,$664.50
2024-08-01,16:21:00,19175.5,SELL,3,0.02h,Stop Loss,$105.75,$770.25,$185690.75,152,$770.25
2024-08-01,17:58:00,18981.5,BUY,3,0.02h,Stop Loss,$207.00,$977.25,$185897.75,152,$977.25
2024-08-01,18:13:00,18950.0,SELL,3,0.02h,Break Even,$0.75,$978.00,$185898.50,152,$978.00
2024-08-01,19:02:00,18915.25,BUY,3,0.02h,Stop Loss,$113.25,$1091.25,$186011.75,152,$1091.25
2024-08-01,20:03:00,18953.0,SELL,3,0.02h,Stop Loss,$454.50,$1545.75,$186466.25,152,$1545.75
2024-08-01,20:39:00,18929.25,BUY,3,0.02h,Stop Loss,$12.00,$1557.75,$186478.25,152,$1557.75
2024-08-01,20:41:00,18908.5,SELL,3,0.02h,Stop Loss,$117.00,$1674.75,$186595.25,152,$1674.75
2024-08-01,20:48:00,18928.75,BUY,3,0.02h,Break Even,$0.75,$1675.50,$186596.00,152,$1675.50
2024-08-01,22:09:00,18925.25,SELL,3,0.02h,Stop Loss,$113.25,$1788.75,$186709.25,152,$1788.75
2024-08-01,22:29:00,18938.0,BUY,3,0.02h,Stop Loss,$12.00,$1800.75,$186721.25,152,$1800.75
2024-08-01,22:39:00,18901.5,SELL,3,0.02h,Stop Loss,$274.50,$2075.25,$186995.75,152,$2075.25
,,,,,,,,,,,
2024-08-02,12:54:00,18612.0,BUY,3,0.02h,Stop Loss,$330.75,$330.75,$187326.50,153,$330.75
2024-08-02,13:02:00,18573.0,SELL,3,0.02h,Stop Loss,$252.00,$582.75,$187578.50,153,$582.75
2024-08-02,13:09:00,18595.25,BUY,3,0.02h,Stop Loss,$64.50,$647.25,$187643.00,153,$647.25
2024-08-02,13:34:00,18562.75,SELL,3,0.02h,Stop Loss,$267.00,$914.25,$187910.00,153,$914.25
2024-08-02,13:40:00,18719.25,BUY,3,0.02h,Stop Loss,$529.50,$1443.75,$188439.50,153,$1443.75
2024-08-02,13:52:00,18605.25,SELL,3,0.02h,Stop Loss,$255.75,$1699.50,$188695.25,153,$1699.50
2024-08-02,14:30:00,18486.75,BUY,3,0.02h,Stop Loss,$507.00,$2206.50,$189202.25,153,$2206.50
2024-08-02,14:36:00,18457.25,SELL,3,0.02h,Stop Loss,$244.50,$2451.00,$189446.75,153,$2451.00
2024-08-02,14:47:00,18499.5,BUY,3,0.02h,Stop Loss,$368.25,$2819.25,$189815.00,153,$2819.25
2024-08-02,14:57:00,18453.0,SELL,3,0.02h,Stop Loss,$267.00,$3086.25,$190082.00,153,$3086.25
2024-08-02,15:13:00,18476.75,BUY,3,0.02h,Stop Loss,$23.25,$3109.50,$190105.25,153,$3109.50
2024-08-02,15:21:00,18432.5,SELL,3,0.02h,Break Even,$0.75,$3110.25,$190106.00,153,$3110.25
2024-08-02,15:24:00,18493.25,BUY,3,0.02h,Stop Loss,$162.00,$3272.25,$190268.00,153,$3272.25
2024-08-02,16:12:00,18535.5,SELL,3,0.02h,Stop Loss,$169.50,$3441.75,$190437.50,153,$3441.75
2024-08-02,16:22:00,18607.5,BUY,3,0.02h,Break Even,$0.75,$3442.50,$190438.25,153,$3442.50
2024-08-02,16:38:00,18563.25,SELL,3,0.02h,Break Even,$0.75,$3443.25,$190439.00,153,$3443.25
2024-08-02,16:41:00,18608.0,BUY,3,0.02h,Stop Loss,$330.75,$3774.00,$190769.75,153,$3774.00
2024-08-02,16:48:00,18558.75,SELL,3,0.02h,Stop Loss,$23.25,$3797.25,$190793.00,153,$3797.25
2024-08-02,17:15:00,18550.25,BUY,3,0.02h,Stop Loss,$75.75,$3873.00,$190868.75,153,$3873.00
2024-08-02,17:23:00,18509.75,SELL,3,0.02h,Stop Loss,$94.50,$3967.50,$190963.25,153,$3967.50
2024-08-02,17:59:00,18484.5,BUY,3,0.02h,Stop Loss,$102.00,$4069.50,$191065.25,153,$4069.50
2024-08-02,18:15:00,18474.25,SELL,3,0.02h,Stop Loss,$90.75,$4160.25,$191156.00,153,$4160.25
2024-08-02,18:23:00,18501.25,BUY,3,0.02h,Stop Loss,$147.00,$4307.25,$191303.00,153,$4307.25
2024-08-02,18:59:00,18514.75,SELL,3,0.02h,Stop Loss,$218.25,$4525.50,$191521.25,153,$4525.50
2024-08-02,19:04:00,18532.0,BUY,3,0.02h,Break Even,$0.75,$4526.25,$191522.00,153,$4526.25
2024-08-02,19:05:00,18520.75,SELL,3,0.02h,Stop Loss,$195.75,$4722.00,$191717.75,153,$4722.00
2024-08-02,19:15:00,18540.25,BUY,3,0.02h,Stop Loss,$12.00,$4734.00,$191729.75,153,$4734.00
2024-08-02,19:39:00,18504.5,SELL,3,0.02h,Stop Loss,$218.25,$4952.25,$191948.00,153,$4952.25
2024-08-02,19:56:00,18555.25,BUY,3,0.02h,Stop Loss,$327.00,$5279.25,$192275.00,153,$5279.25
2024-08-02,20:32:00,18543.25,SELL,3,0.02h,Stop Loss,$27.00,$5306.25,$192302.00,153,$5306.25
,,,,,,,,,,,
2024-08-05,12:57:00,17526.5,BUY,3,0.02h,Stop Loss,$450.75,$450.75,$192752.75,154,$450.75
2024-08-05,13:30:00,17564.25,SELL,3,0.02h,Stop Loss,$777.00,$1227.75,$193529.75,154,$1227.75
2024-08-05,13:34:00,17681.0,BUY,3,0.02h,Stop Loss,$375.75,$1603.50,$193905.50,154,$1603.50
2024-08-05,14:28:00,17906.75,SELL,3,0.02h,Stop Loss,$342.00,$1945.50,$194247.50,154,$1945.50
2024-08-05,14:37:00,17968.5,BUY,3,0.02h,Stop Loss,$199.50,$2145.00,$194447.00,154,$2145.00
2024-08-05,15:01:00,17918.0,SELL,3,0.02h,Stop Loss,$383.25,$2528.25,$194830.25,154,$2528.25
2024-08-05,15:08:00,18018.75,BUY,3,0.02h,Stop Loss,$1508.25,$4036.50,$196338.50,154,$4036.50
2024-08-05,15:44:00,18080.75,SELL,3,0.02h,Stop Loss,$135.75,$4172.25,$196474.25,154,$4172.25
2024-08-05,16:04:00,18151.75,BUY,3,0.02h,Break Even,$0.75,$4173.00,$196475.00,154,$4173.00
2024-08-05,16:38:00,18139.5,SELL,3,0.02h,Stop Loss,$124.50,$4297.50,$196599.50,154,$4297.50
2024-08-05,17:16:00,18104.25,BUY,3,0.02h,Stop Loss,$64.50,$4362.00,$196664.00,154,$4362.00
2024-08-05,17:50:00,18101.0,SELL,3,0.02h,Stop Loss,$83.25,$4445.25,$196747.25,154,$4445.25
2024-08-05,18:31:00,18052.5,BUY,3,0.02h,Stop Loss,$53.25,$4498.50,$196800.50,154,$4498.50
2024-08-05,18:39:00,17999.75,SELL,3,0.02h,Stop Loss,$53.25,$4551.75,$196853.75,154,$4551.75
2024-08-05,19:05:00,17996.0,BUY,3,0.02h,Stop Loss,$-18.00,$4533.75,$196835.75,154,$4533.75
2024-08-05,19:10:00,17926.75,SELL,3,0.02h,Break Even,$0.75,$4534.50,$196836.50,154,$4534.50
2024-08-05,19:23:00,17948.0,BUY,3,0.02h,Stop Loss,$105.75,$4640.25,$196942.25,154,$4640.25
2024-08-05,19:45:00,17932.75,SELL,3,0.02h,Stop Loss,$68.25,$4708.50,$197010.50,154,$4708.50
2024-08-05,19:54:00,17968.25,BUY,3,0.02h,Break Even,$0.75,$4709.25,$197011.25,154,$4709.25
2024-08-05,22:46:00,18215.0,SELL,3,0.02h,Stop Loss,$27.00,$4736.25,$197038.25,154,$4736.25
,,,,,,,,,,,
2024-08-06,13:20:00,18102.25,BUY,3,0.02h,Stop Loss,$23.25,$23.25,$197061.50,155,$23.25
2024-08-06,13:25:00,18082.25,SELL,3,0.02h,Stop Loss,$12.00,$35.25,$197073.50,155,$35.25
2024-08-06,13:26:00,18105.75,BUY,3,0.02h,Stop Loss,$282.00,$317.25,$197355.50,155,$317.25
2024-08-06,13:38:00,18047.25,SELL,3,0.02h,Stop Loss,$57.00,$374.25,$197412.50,155,$374.25
2024-08-06,13:54:00,18117.25,BUY,3,0.02h,Stop Loss,$323.25,$697.50,$197735.75,155,$697.50
2024-08-06,14:31:00,18133.5,SELL,3,0.02h,Stop Loss,$30.75,$728.25,$197766.50,155,$728.25
2024-08-06,14:37:00,18193.5,BUY,3,0.02h,Stop Loss,$402.00,$1130.25,$198168.50,155,$1130.25
2024-08-06,15:14:00,18280.0,SELL,3,0.02h,Stop Loss,$210.75,$1341.00,$198379.25,155,$1341.00
2024-08-06,15:44:00,18250.25,BUY,3,0.02h,Stop Loss,$162.00,$1503.00,$198541.25,155,$1503.00
2024-08-06,16:27:00,18330.25,SELL,3,0.02h,Stop Loss,$27.00,$1530.00,$198568.25,155,$1530.00
2024-08-06,16:42:00,18358.75,BUY,3,0.02h,Stop Loss,$79.50,$1609.50,$198647.75,155,$1609.50
2024-08-06,17:19:00,18408.0,SELL,3,0.02h,Stop Loss,$64.50,$1674.00,$198712.25,155,$1674.00
2024-08-06,17:30:00,18422.75,BUY,3,0.02h,Stop Loss,$158.25,$1832.25,$198870.50,155,$1832.25
2024-08-06,17:44:00,18402.75,SELL,3,0.02h,Stop Loss,$42.00,$1874.25,$198912.50,155,$1874.25
2024-08-06,17:54:00,18428.0,BUY,3,0.02h,Stop Loss,$87.00,$1961.25,$198999.50,155,$1961.25
2024-08-06,18:04:00,18408.0,SELL,3,0.02h,Break Even,$0.75,$1962.00,$199000.25,155,$1962.00
2024-08-06,18:18:00,18425.5,BUY,3,0.02h,Stop Loss,$177.00,$2139.00,$199177.25,155,$2139.00
2024-08-06,18:58:00,18442.75,SELL,3,0.02h,Stop Loss,$473.25,$2612.25,$199650.50,155,$2612.25
2024-08-06,19:26:00,18366.0,BUY,3,0.02h,Break Even,$0.75,$2613.00,$199651.25,155,$2613.00
2024-08-06,19:37:00,18330.5,SELL,3,0.02h,Stop Loss,$19.50,$2632.50,$199670.75,155,$2632.50
2024-08-06,20:21:00,18265.5,BUY,3,0.02h,Break Even,$0.75,$2633.25,$199671.50,155,$2633.25
2024-08-06,20:33:00,18181.25,SELL,3,0.02h,Stop Loss,$-18.00,$2615.25,$199653.50,155,$2615.25
2024-08-06,22:21:00,18126.0,BUY,3,0.02h,Stop Loss,$154.50,$2769.75,$199808.00,155,$2769.75
2024-08-06,22:37:00,18085.0,SELL,3,0.02h,Break Even,$0.75,$2770.50,$199808.75,155,$2770.50
2024-08-06,22:56:00,18100.0,BUY,3,0.02h,Break Even,$0.75,$2771.25,$199809.50,155,$2771.25
,,,,,,,,,,,
2024-08-07,12:56:00,18416.5,SELL,3,0.02h,Stop Loss,$-18.00,$-18.00,$199791.50,156,$-18.00
2024-08-07,13:01:00,18436.0,BUY,3,0.02h,Stop Loss,$27.00,$9.00,$199818.50,156,$9.00
2024-08-07,13:04:00,18425.5,SELL,3,0.02h,Stop Loss,$15.75,$24.75,$199834.25,156,$24.75
2024-08-07,13:10:00,18438.0,BUY,3,0.02h,Break Even,$0.75,$25.50,$199835.00,156,$25.50
2024-08-07,13:13:00,18418.5,SELL,3,0.02h,Stop Loss,$135.75,$161.25,$199970.75,156,$161.25
2024-08-07,13:26:00,18433.75,BUY,3,0.02h,Stop Loss,$45.75,$207.00,$200016.50,156,$207.00
2024-08-07,14:08:00,18503.25,SELL,3,0.02h,Stop Loss,$34.50,$241.50,$200051.00,156,$241.50
2024-08-07,14:10:00,18533.5,BUY,3,0.02h,Stop Loss,$135.75,$377.25,$200186.75,156,$377.25
2024-08-07,14:18:00,18482.75,SELL,3,0.02h,Stop Loss,$593.25,$970.50,$200780.00,156,$970.50
2024-08-07,14:45:00,18503.25,BUY,3,0.02h,Stop Loss,$304.50,$1275.00,$201084.50,156,$1275.00
2024-08-07,15:14:00,18491.75,SELL,3,0.02h,Stop Loss,$128.25,$1403.25,$201212.75,156,$1403.25
2024-08-07,16:22:00,18382.0,BUY,3,0.02h,Stop Loss,$60.75,$1464.00,$201273.50,156,$1464.00
2024-08-07,16:43:00,18351.5,SELL,3,0.02h,Stop Loss,$293.25,$1757.25,$201566.75,156,$1757.25
2024-08-07,17:38:00,18232.0,BUY,3,0.02h,Stop Loss,$177.00,$1934.25,$201743.75,156,$1934.25
2024-08-07,17:42:00,18196.0,SELL,3,0.02h,Stop Loss,$72.00,$2006.25,$201815.75,156,$2006.25
2024-08-07,18:30:00,18080.0,BUY,3,0.02h,Stop Loss,$-18.00,$1988.25,$201797.75,156,$1988.25
2024-08-07,18:32:00,18049.5,SELL,3,0.02h,Stop Loss,$282.00,$2270.25,$202079.75,156,$2270.25
2024-08-07,19:03:00,18085.25,BUY,3,0.02h,Stop Loss,$289.50,$2559.75,$202369.25,156,$2559.75
2024-08-07,19:27:00,18077.0,SELL,3,0.02h,Stop Loss,$165.75,$2725.50,$202535.00,156,$2725.50
2024-08-07,19:38:00,18103.25,BUY,3,0.02h,Stop Loss,$139.50,$2865.00,$202674.50,156,$2865.00
2024-08-07,19:41:00,18076.0,SELL,3,0.02h,Stop Loss,$53.25,$2918.25,$202727.75,156,$2918.25
2024-08-07,22:19:00,17891.0,BUY,3,0.02h,Stop Loss,$109.50,$3027.75,$202837.25,156,$3027.75
2024-08-07,22:47:00,17897.5,SELL,3,0.02h,Stop Loss,$105.75,$3133.50,$202943.00,156,$3133.50
2024-08-07,22:59:00,17906.75,BUY,3,0.02h,Stop Loss,$-18.00,$3115.50,$202925.00,156,$3115.50
,,,,,,,,,,,
2024-08-08,12:27:00,17966.5,SELL,3,0.02h,Break Even,$0.75,$0.75,$202925.75,157,$0.75
2024-08-08,12:29:00,17981.0,BUY,3,0.02h,Stop Loss,$162.00,$162.75,$203087.75,157,$162.75
2024-08-08,13:38:00,18163.75,SELL,3,0.02h,Stop Loss,$263.25,$426.00,$203351.00,157,$426.00
2024-08-08,13:59:00,18174.5,BUY,3,0.02h,Stop Loss,$540.75,$966.75,$203891.75,157,$966.75
2024-08-08,15:08:00,18383.5,SELL,3,0.02h,Stop Loss,$102.00,$1068.75,$203993.75,157,$1068.75
2024-08-08,15:25:00,18395.75,BUY,3,0.02h,Stop Loss,$30.75,$1099.50,$204024.50,157,$1099.50
2024-08-08,15:42:00,18377.75,SELL,3,0.02h,Stop Loss,$53.25,$1152.75,$204077.75,157,$1152.75
2024-08-08,15:43:00,18389.25,BUY,3,0.02h,Stop Loss,$-18.00,$1134.75,$204059.75,157,$1134.75
2024-08-08,15:47:00,18376.0,SELL,3,0.02h,Break Even,$0.75,$1135.50,$204060.50,157,$1135.50
2024-08-08,15:55:00,18396.75,BUY,3,0.02h,Stop Loss,$83.25,$1218.75,$204143.75,157,$1218.75
2024-08-08,16:31:00,18408.5,SELL,3,0.02h,Stop Loss,$334.50,$1553.25,$204478.25,157,$1553.25
2024-08-08,16:53:00,18411.0,BUY,3,0.02h,Stop Loss,$132.00,$1685.25,$204610.25,157,$1685.25
2024-08-08,17:03:00,18381.25,SELL,3,0.02h,Stop Loss,$158.25,$1843.50,$204768.50,157,$1843.50
2024-08-08,17:13:00,18412.0,BUY,3,0.02h,Stop Loss,$158.25,$2001.75,$204926.75,157,$2001.75
2024-08-08,18:28:00,18498.75,SELL,3,0.02h,Break Even,$0.75,$2002.50,$204927.50,157,$2002.50
2024-08-08,19:13:00,18506.0,BUY,3,0.02h,Stop Loss,$19.50,$2022.00,$204947.00,157,$2022.00
2024-08-08,19:18:00,18484.75,SELL,3,0.02h,Stop Loss,$180.75,$2202.75,$205127.75,157,$2202.75
2024-08-08,19:23:00,18501.0,BUY,3,0.02h,Stop Loss,$57.00,$2259.75,$205184.75,157,$2259.75
2024-08-08,19:29:00,18463.25,SELL,3,0.02h,Stop Loss,$323.25,$2583.00,$205508.00,157,$2583.00
2024-08-08,19:44:00,18495.0,BUY,3,0.02h,Stop Loss,$192.00,$2775.00,$205700.00,157,$2775.00
2024-08-08,20:53:00,18563.0,SELL,3,0.02h,Break Even,$0.75,$2775.75,$205700.75,157,$2775.75
2024-08-08,20:56:00,18566.0,BUY,3,0.02h,Stop Loss,$-18.00,$2757.75,$205682.75,157,$2757.75
2024-08-08,21:00:00,18557.5,SELL,3,1.02h,Stop Loss,$289.50,$3047.25,$205972.25,157,$3047.25
2024-08-08,22:03:00,18573.75,BUY,3,0.02h,Break Even,$0.75,$3048.00,$205973.00,157,$3048.00
2024-08-08,22:06:00,18555.0,SELL,3,0.02h,Break Even,$0.75,$3048.75,$205973.75,157,$3048.75
2024-08-08,22:25:00,18552.75,BUY,3,0.02h,Stop Loss,$27.00,$3075.75,$206000.75,157,$3075.75
2024-08-08,22:42:00,18545.25,SELL,3,0.02h,Break Even,$0.75,$3076.50,$206001.50,157,$3076.50
2024-08-08,23:00:00,18561.5,BUY,3,13.00h,Stop Loss,$-18.00,$3058.50,$205983.50,157,$3058.50
,,,,,,,,,,,
2024-08-09,12:00:00,18525.25,SELL,3,0.02h,Stop Loss,$128.25,$128.25,$206111.75,158,$128.25
2024-08-09,12:53:00,18439.25,BUY,3,0.02h,Break Even,$0.75,$129.00,$206112.50,158,$129.00
2024-08-09,12:54:00,18429.5,SELL,3,0.02h,Stop Loss,$274.50,$403.50,$206387.00,158,$403.50
2024-08-09,12:57:00,18440.75,BUY,3,0.02h,Stop Loss,$-18.00,$385.50,$206369.00,158,$385.50
2024-08-09,13:00:00,18424.0,SELL,3,0.02h,Stop Loss,$173.25,$558.75,$206542.25,158,$558.75
2024-08-09,13:07:00,18439.75,BUY,3,0.02h,Break Even,$0.75,$559.50,$206543.00,158,$559.50
2024-08-09,13:25:00,18429.25,SELL,3,0.02h,Stop Loss,$-18.00,$541.50,$206525.00,158,$541.50
2024-08-09,13:29:00,18448.0,BUY,3,0.02h,Stop Loss,$75.75,$617.25,$206600.75,158,$617.25
2024-08-09,13:47:00,18437.0,SELL,3,0.02h,Break Even,$0.75,$618.00,$206601.50,158,$618.00
2024-08-09,13:54:00,18475.25,BUY,3,0.02h,Stop Loss,$117.00,$735.00,$206718.50,158,$735.00
2024-08-09,13:57:00,18437.5,SELL,3,0.02h,Stop Loss,$120.75,$855.75,$206839.25,158,$855.75
2024-08-09,14:05:00,18490.5,BUY,3,0.02h,Break Even,$0.75,$856.50,$206840.00,158,$856.50
2024-08-09,14:30:00,18495.25,SELL,3,0.02h,Stop Loss,$327.00,$1183.50,$207167.00,158,$1183.50
2024-08-09,14:48:00,18501.0,BUY,3,0.02h,Stop Loss,$120.75,$1304.25,$207287.75,158,$1304.25
2024-08-09,15:25:00,18535.0,SELL,3,0.02h,Stop Loss,$-18.00,$1286.25,$207269.75,158,$1286.25
2024-08-09,15:27:00,18546.5,BUY,3,0.02h,Stop Loss,$105.75,$1392.00,$207375.50,158,$1392.00
2024-08-09,15:29:00,18531.5,SELL,3,0.02h,Stop Loss,$323.25,$1715.25,$207698.75,158,$1715.25
2024-08-09,15:50:00,18530.0,BUY,3,0.02h,Stop Loss,$23.25,$1738.50,$207722.00,158,$1738.50
2024-08-09,15:57:00,18481.25,SELL,3,0.02h,Stop Loss,$79.50,$1818.00,$207801.50,158,$1818.00
2024-08-09,16:30:00,18481.25,BUY,3,0.02h,Stop Loss,$267.00,$2085.00,$208068.50,158,$2085.00
2024-08-09,17:51:00,18619.25,SELL,3,0.02h,Break Even,$0.75,$2085.75,$208069.25,158,$2085.75
2024-08-09,18:41:00,18601.0,BUY,3,0.02h,Stop Loss,$12.00,$2097.75,$208081.25,158,$2097.75
2024-08-09,18:53:00,18584.5,SELL,3,0.02h,Stop Loss,$188.25,$2286.00,$208269.50,158,$2286.00
2024-08-09,19:08:00,18600.0,BUY,3,0.02h,Stop Loss,$53.25,$2339.25,$208322.75,158,$2339.25
2024-08-09,19:54:00,18596.5,SELL,3,0.02h,Stop Loss,$255.75,$2595.00,$208578.50,158,$2595.00
2024-08-09,20:04:00,18617.75,BUY,3,0.02h,Break Even,$0.75,$2595.75,$208579.25,158,$2595.75
2024-08-09,20:22:00,18608.5,SELL,3,0.02h,Stop Loss,$-18.00,$2577.75,$208561.25,158,$2577.75
,,,,,,,,,,,
2024-08-12,12:00:00,18664.5,BUY,3,0.02h,Break Even,$0.75,$0.75,$208562.00,159,$0.75
2024-08-12,12:43:00,18666.75,SELL,3,0.02h,Stop Loss,$42.00,$42.75,$208604.00,159,$42.75
2024-08-12,13:03:00,18671.0,BUY,3,0.02h,Stop Loss,$-18.00,$24.75,$208586.00,159,$24.75
2024-08-12,13:10:00,18655.0,SELL,3,0.02h,Stop Loss,$-18.00,$6.75,$208568.00,159,$6.75
2024-08-12,13:27:00,18663.0,BUY,3,0.02h,Break Even,$0.75,$7.50,$208568.75,159,$7.50
2024-08-12,13:29:00,18639.25,SELL,3,0.02h,Break Even,$0.75,$8.25,$208569.50,159,$8.25
2024-08-12,14:07:00,18605.25,BUY,3,0.02h,Stop Loss,$150.75,$159.00,$208720.25,159,$159.00
2024-08-12,15:23:00,18682.0,SELL,3,0.02h,Stop Loss,$623.25,$782.25,$209343.50,159,$782.25
2024-08-12,15:51:00,18670.75,BUY,3,0.02h,Stop Loss,$207.00,$989.25,$209550.50,159,$989.25
2024-08-12,16:19:00,18686.25,SELL,3,0.02h,Break Even,$0.75,$990.00,$209551.25,159,$990.00
2024-08-12,16:26:00,18699.75,BUY,3,0.02h,Stop Loss,$15.75,$1005.75,$209567.00,159,$1005.75
2024-08-12,16:29:00,18685.25,SELL,3,0.02h,Break Even,$0.75,$1006.50,$209567.75,159,$1006.50
2024-08-12,16:30:00,18694.75,BUY,3,0.02h,Stop Loss,$60.75,$1067.25,$209628.50,159,$1067.25
2024-08-12,16:37:00,18688.75,SELL,3,0.02h,Stop Loss,$38.25,$1105.50,$209666.75,159,$1105.50
2024-08-12,16:40:00,18709.75,BUY,3,0.02h,Stop Loss,$45.75,$1151.25,$209712.50,159,$1151.25
2024-08-12,16:43:00,18686.5,SELL,3,0.02h,Stop Loss,$-18.00,$1133.25,$209694.50,159,$1133.25
2024-08-12,16:44:00,18698.75,BUY,3,0.02h,Break Even,$0.75,$1134.00,$209695.25,159,$1134.00
2024-08-12,16:53:00,18686.25,SELL,3,0.02h,Break Even,$0.75,$1134.75,$209696.00,159,$1134.75
2024-08-12,17:20:00,18664.0,BUY,3,0.02h,Stop Loss,$109.50,$1244.25,$209805.50,159,$1244.25
2024-08-12,17:39:00,18642.75,SELL,3,0.02h,Stop Loss,$-18.00,$1226.25,$209787.50,159,$1226.25
2024-08-12,18:17:00,18627.0,BUY,3,0.02h,Break Even,$0.75,$1227.00,$209788.25,159,$1227.00
2024-08-12,18:31:00,18608.75,SELL,3,0.02h,Break Even,$0.75,$1227.75,$209789.00,159,$1227.75
2024-08-12,18:37:00,18629.25,BUY,3,0.02h,Stop Loss,$15.75,$1243.50,$209804.75,159,$1243.50
2024-08-12,19:09:00,18619.25,SELL,3,0.02h,Stop Loss,$53.25,$1296.75,$209858.00,159,$1296.75
2024-08-12,19:13:00,18635.0,BUY,3,0.02h,Stop Loss,$-18.00,$1278.75,$209840.00,159,$1278.75
2024-08-12,19:14:00,18617.0,SELL,3,0.02h,Stop Loss,$15.75,$1294.50,$209855.75,159,$1294.50
2024-08-12,19:26:00,18631.25,BUY,3,0.02h,Stop Loss,$68.25,$1362.75,$209924.00,159,$1362.75
2024-08-12,19:30:00,18620.5,SELL,3,0.02h,Stop Loss,$-18.00,$1344.75,$209906.00,159,$1344.75
2024-08-12,19:31:00,18631.5,BUY,3,0.02h,Break Even,$0.75,$1345.50,$209906.75,159,$1345.50
2024-08-12,19:33:00,18623.75,SELL,3,0.02h,Stop Loss,$49.50,$1395.00,$209956.25,159,$1395.00
2024-08-12,19:59:00,18618.25,BUY,3,0.02h,Stop Loss,$394.50,$1789.50,$210350.75,159,$1789.50
2024-08-12,20:30:00,18631.5,SELL,3,0.02h,Break Even,$0.75,$1790.25,$210351.50,159,$1790.25
2024-08-12,22:01:00,18645.0,BUY,3,0.02h,Stop Loss,$19.50,$1809.75,$210371.00,159,$1809.75
2024-08-12,22:32:00,18636.25,SELL,3,0.02h,Stop Loss,$45.75,$1855.50,$210416.75,159,$1855.50
2024-08-12,22:51:00,18641.5,BUY,3,0.02h,Break Even,$0.75,$1856.25,$210417.50,159,$1856.25
2024-08-12,22:56:00,18634.5,SELL,3,0.02h,Stop Loss,$-18.00,$1838.25,$210399.50,159,$1838.25
2024-08-12,22:57:00,18636.5,BUY,3,0.02h,Break Even,$0.75,$1839.00,$210400.25,159,$1839.00
,,,,,,,,,,,
2024-08-13,13:17:00,18800.0,SELL,3,0.02h,Break Even,$0.75,$0.75,$210401.00,160,$0.75
2024-08-13,13:19:00,18813.5,BUY,3,0.02h,Stop Loss,$-18.00,$-17.25,$210383.00,160,$-17.25
2024-08-13,14:19:00,18878.0,SELL,3,0.02h,Break Even,$0.75,$-16.50,$210383.75,160,$-16.50
2024-08-13,14:27:00,18902.75,BUY,3,0.02h,Stop Loss,$75.75,$59.25,$210459.50,160,$59.25
2024-08-13,14:32:00,18873.5,SELL,3,0.02h,Stop Loss,$34.50,$93.75,$210494.00,160,$93.75
2024-08-13,14:38:00,18903.0,BUY,3,0.02h,Stop Loss,$-18.00,$75.75,$210476.00,160,$75.75
2024-08-13,17:27:00,19067.0,SELL,3,0.02h,Stop Loss,$113.25,$189.00,$210589.25,160,$189.00
2024-08-13,17:32:00,19078.5,BUY,3,0.02h,Stop Loss,$38.25,$227.25,$210627.50,160,$227.25
2024-08-13,17:34:00,19065.5,SELL,3,0.02h,Stop Loss,$128.25,$355.50,$210755.75,160,$355.50
2024-08-13,17:44:00,19079.0,BUY,3,0.02h,Break Even,$0.75,$356.25,$210756.50,160,$356.25
2024-08-13,17:47:00,19015.75,SELL,3,0.02h,Stop Loss,$30.75,$387.00,$210787.25,160,$387.00
2024-08-13,18:06:00,19059.0,BUY,3,0.02h,Stop Loss,$64.50,$451.50,$210851.75,160,$451.50
2024-08-13,18:19:00,19045.0,SELL,3,0.02h,Break Even,$0.75,$452.25,$210852.50,160,$452.25
2024-08-13,18:24:00,19063.0,BUY,3,0.02h,Stop Loss,$60.75,$513.00,$210913.25,160,$513.00
2024-08-13,19:06:00,19052.5,SELL,3,0.02h,Break Even,$0.75,$513.75,$210914.00,160,$513.75
2024-08-13,19:31:00,19063.5,BUY,3,0.02h,Stop Loss,$64.50,$578.25,$210978.50,160,$578.25
2024-08-13,20:30:00,19097.25,SELL,3,0.02h,Stop Loss,$102.00,$680.25,$211080.50,160,$680.25
2024-08-13,20:59:00,19096.5,BUY,3,0.02h,Stop Loss,$23.25,$703.50,$211103.75,160,$703.50
2024-08-13,22:20:00,19099.25,SELL,3,0.02h,Stop Loss,$79.50,$783.00,$211183.25,160,$783.00
2024-08-13,22:54:00,19099.0,BUY,3,0.02h,Stop Loss,$-18.00,$765.00,$211165.25,160,$765.00
2024-08-13,22:55:00,19097.0,SELL,3,0.02h,Stop Loss,$-18.00,$747.00,$211147.25,160,$747.00
2024-08-13,22:57:00,19098.75,BUY,3,0.02h,Stop Loss,$-18.00,$729.00,$211129.25,160,$729.00
2024-08-13,22:58:00,19097.75,SELL,3,0.02h,Stop Loss,$-18.00,$711.00,$211111.25,160,$711.00
2024-08-13,23:00:00,19099.0,BUY,3,13.00h,Stop Loss,$195.75,$906.75,$211307.00,160,$906.75
,,,,,,,,,,,
2024-08-14,12:13:00,19099.75,SELL,3,0.02h,Stop Loss,$12.00,$12.00,$211319.00,161,$12.00
2024-08-14,12:28:00,19104.75,BUY,3,0.02h,Stop Loss,$124.50,$136.50,$211443.50,161,$136.50
2024-08-14,12:33:00,19063.5,SELL,3,0.02h,Stop Loss,$132.00,$268.50,$211575.50,161,$268.50
2024-08-14,12:40:00,19122.5,BUY,3,0.02h,Stop Loss,$-18.00,$250.50,$211557.50,161,$250.50
2024-08-14,13:21:00,19133.75,SELL,3,0.02h,Break Even,$0.75,$251.25,$211558.25,161,$251.25
2024-08-14,13:22:00,19138.75,BUY,3,0.02h,Break Even,$0.75,$252.00,$211559.00,161,$252.00
2024-08-14,13:29:00,19126.25,SELL,3,0.02h,Break Even,$0.75,$252.75,$211559.75,161,$252.75
2024-08-14,13:31:00,19162.5,BUY,3,0.02h,Stop Loss,$139.50,$392.25,$211699.25,161,$392.25
2024-08-14,13:35:00,19108.25,SELL,3,0.02h,Stop Loss,$330.75,$723.00,$212030.00,161,$723.00
2024-08-14,14:44:00,18995.75,BUY,3,0.02h,Stop Loss,$27.00,$750.00,$212057.00,161,$750.00
2024-08-14,16:15:00,19162.0,SELL,3,0.02h,Stop Loss,$218.25,$968.25,$212275.25,161,$968.25
2024-08-14,17:02:00,19068.75,BUY,3,0.02h,Stop Loss,$79.50,$1047.75,$212354.75,161,$1047.75
2024-08-14,17:28:00,19064.75,SELL,3,0.02h,Stop Loss,$-18.00,$1029.75,$212336.75,161,$1029.75
2024-08-14,17:30:00,19084.5,BUY,3,0.02h,Stop Loss,$34.50,$1064.25,$212371.25,161,$1064.25
2024-08-14,17:40:00,19071.0,SELL,3,0.02h,Break Even,$0.75,$1065.00,$212372.00,161,$1065.00
2024-08-14,17:50:00,19084.25,BUY,3,0.02h,Stop Loss,$23.25,$1088.25,$212395.25,161,$1088.25
2024-08-14,17:52:00,19073.25,SELL,3,0.02h,Stop Loss,$-18.00,$1070.25,$212377.25,161,$1070.25
2024-08-14,17:54:00,19086.75,BUY,3,0.02h,Break Even,$0.75,$1071.00,$212378.00,161,$1071.00
2024-08-14,18:01:00,19051.75,SELL,3,0.02h,Break Even,$0.75,$1071.75,$212378.75,161,$1071.75
2024-08-14,18:21:00,19082.25,BUY,3,0.02h,Stop Loss,$45.75,$1117.50,$212424.50,161,$1117.50
2024-08-14,18:47:00,19078.5,SELL,3,0.02h,Stop Loss,$49.50,$1167.00,$212474.00,161,$1167.00
2024-08-14,18:53:00,19091.5,BUY,3,0.02h,Stop Loss,$19.50,$1186.50,$212493.50,161,$1186.50
2024-08-14,19:11:00,19076.5,SELL,3,0.02h,Break Even,$0.75,$1187.25,$212494.25,161,$1187.25
2024-08-14,19:42:00,19071.5,BUY,3,0.02h,Stop Loss,$30.75,$1218.00,$212525.00,161,$1218.00
2024-08-14,20:36:00,19143.75,SELL,3,0.02h,Stop Loss,$-18.00,$1200.00,$212507.00,161,$1200.00
2024-08-14,20:48:00,19148.25,BUY,3,0.02h,Stop Loss,$-18.00,$1182.00,$212489.00,161,$1182.00
2024-08-14,20:53:00,19144.75,SELL,3,0.02h,Break Even,$0.75,$1182.75,$212489.75,161,$1182.75
2024-08-14,22:54:00,19133.0,BUY,3,0.02h,Stop Loss,$-18.00,$1164.75,$212471.75,161,$1164.75
2024-08-14,22:56:00,19126.75,SELL,3,0.03h,Stop Loss,$-18.00,$1146.75,$212453.75,161,$1146.75
,,,,,,,,,,,
2024-08-15,12:00:00,19163.0,BUY,3,0.02h,Stop Loss,$15.75,$15.75,$212469.50,162,$15.75
2024-08-15,13:18:00,19322.25,SELL,3,0.02h,Stop Loss,$30.75,$46.50,$212500.25,162,$46.50
2024-08-15,13:25:00,19335.75,BUY,3,0.02h,Stop Loss,$12.00,$58.50,$212512.25,162,$58.50
2024-08-15,14:57:00,19472.25,SELL,3,0.02h,Stop Loss,$23.25,$81.75,$212535.50,162,$81.75
2024-08-15,15:05:00,19494.25,BUY,3,0.02h,Stop Loss,$34.50,$116.25,$212570.00,162,$116.25
2024-08-15,15:36:00,19505.5,SELL,3,0.02h,Break Even,$0.75,$117.00,$212570.75,162,$117.00
2024-08-15,15:37:00,19515.0,BUY,3,0.02h,Stop Loss,$27.00,$144.00,$212597.75,162,$144.00
2024-08-15,16:41:00,19547.0,SELL,3,0.02h,Stop Loss,$225.75,$369.75,$212823.50,162,$369.75
2024-08-15,17:16:00,19539.25,BUY,3,0.02h,Stop Loss,$42.00,$411.75,$212865.50,162,$411.75
2024-08-15,18:17:00,19569.0,SELL,3,0.02h,Stop Loss,$-18.00,$393.75,$212847.50,162,$393.75
2024-08-15,18:22:00,19586.0,BUY,3,0.02h,Stop Loss,$-18.00,$375.75,$212829.50,162,$375.75
2024-08-15,18:33:00,19578.5,SELL,3,0.02h,Break Even,$0.75,$376.50,$212830.25,162,$376.50
2024-08-15,18:34:00,19583.0,BUY,3,0.02h,Break Even,$0.75,$377.25,$212831.00,162,$377.25
2024-08-15,18:40:00,19580.0,SELL,3,0.02h,Stop Loss,$19.50,$396.75,$212850.50,162,$396.75
2024-08-15,18:49:00,19582.75,BUY,3,0.02h,Break Even,$0.75,$397.50,$212851.25,162,$397.50
2024-08-15,18:51:00,19573.5,SELL,3,0.02h,Stop Loss,$57.00,$454.50,$212908.25,162,$454.50
2024-08-15,18:58:00,19584.5,BUY,3,0.02h,Stop Loss,$-18.00,$436.50,$212890.25,162,$436.50
2024-08-15,19:01:00,19566.75,SELL,3,0.02h,Break Even,$0.75,$437.25,$212891.00,162,$437.25
2024-08-15,19:07:00,19585.5,BUY,3,0.02h,Break Even,$0.75,$438.00,$212891.75,162,$438.00
2024-08-15,19:13:00,19571.5,SELL,3,0.02h,Break Even,$0.75,$438.75,$212892.50,162,$438.75
2024-08-15,19:20:00,19584.0,BUY,3,0.02h,Stop Loss,$-18.00,$420.75,$212874.50,162,$420.75
2024-08-15,19:49:00,19586.0,SELL,3,0.02h,Stop Loss,$150.75,$571.50,$213025.25,162,$571.50
2024-08-15,20:03:00,19579.5,BUY,3,0.02h,Break Even,$0.75,$572.25,$213026.00,162,$572.25
2024-08-15,20:04:00,19573.25,SELL,3,0.02h,Stop Loss,$72.00,$644.25,$213098.00,162,$644.25
2024-08-15,20:10:00,19583.0,BUY,3,0.02h,Break Even,$0.75,$645.00,$213098.75,162,$645.00
2024-08-15,20:15:00,19566.0,SELL,3,0.02h,Stop Loss,$-18.00,$627.00,$213080.75,162,$627.00
2024-08-15,20:29:00,19583.25,BUY,3,0.02h,Stop Loss,$30.75,$657.75,$213111.50,162,$657.75
2024-08-15,20:50:00,19577.5,SELL,3,0.02h,Break Even,$0.75,$658.50,$213112.25,162,$658.50
2024-08-15,22:13:00,19579.75,BUY,3,0.02h,Stop Loss,$-18.00,$640.50,$213094.25,162,$640.50
,,,,,,,,,,,
2024-08-16,12:00:00,19553.25,SELL,3,0.02h,Stop Loss,$-18.00,$-18.00,$213076.25,163,$-18.00
2024-08-16,13:01:00,19479.25,BUY,3,0.02h,Break Even,$0.75,$-17.25,$213077.00,163,$-17.25
2024-08-16,13:31:00,19466.0,SELL,3,0.02h,Break Even,$0.75,$-16.50,$213077.75,163,$-16.50
2024-08-16,13:33:00,19503.25,BUY,3,0.02h,Stop Loss,$124.50,$108.00,$213202.25,163,$108.00
2024-08-16,13:47:00,19486.5,SELL,3,0.02h,Stop Loss,$27.00,$135.00,$213229.25,163,$135.00
2024-08-16,13:51:00,19521.25,BUY,3,0.02h,Stop Loss,$102.00,$237.00,$213331.25,163,$237.00
2024-08-16,14:00:00,19495.75,SELL,3,0.02h,Stop Loss,$38.25,$275.25,$213369.50,163,$275.25
2024-08-16,14:01:00,19525.5,BUY,3,0.02h,Stop Loss,$23.25,$298.50,$213392.75,163,$298.50
2024-08-16,14:41:00,19553.5,SELL,3,0.02h,Stop Loss,$132.00,$430.50,$213524.75,163,$430.50
2024-08-16,15:29:00,19532.0,BUY,3,0.02h,Break Even,$0.75,$431.25,$213525.50,163,$431.25
2024-08-16,17:16:00,19627.0,SELL,3,0.02h,Break Even,$0.75,$432.00,$213526.25,163,$432.00
2024-08-16,17:21:00,19636.5,BUY,3,0.02h,Break Even,$0.75,$432.75,$213527.00,163,$432.75
2024-08-16,17:22:00,19633.5,SELL,3,0.02h,Stop Loss,$-18.00,$414.75,$213509.00,163,$414.75
2024-08-16,17:23:00,19637.25,BUY,3,0.02h,Stop Loss,$38.25,$453.00,$213547.25,163,$453.00
2024-08-16,17:42:00,19629.75,SELL,3,0.02h,Stop Loss,$-18.00,$435.00,$213529.25,163,$435.00
2024-08-16,17:44:00,19640.25,BUY,3,0.02h,Stop Loss,$57.00,$492.00,$213586.25,163,$492.00
2024-08-16,17:48:00,19630.0,SELL,3,0.02h,Stop Loss,$-18.00,$474.00,$213568.25,163,$474.00
2024-08-16,18:30:00,19615.5,BUY,3,0.02h,Stop Loss,$12.00,$486.00,$213580.25,163,$486.00
2024-08-16,18:44:00,19603.0,SELL,3,0.02h,Stop Loss,$34.50,$520.50,$213614.75,163,$520.50
2024-08-16,18:55:00,19616.0,BUY,3,0.02h,Break Even,$0.75,$521.25,$213615.50,163,$521.25
2024-08-16,19:11:00,19606.5,SELL,3,0.02h,Break Even,$0.75,$522.00,$213616.25,163,$522.00
2024-08-16,19:35:00,19611.75,BUY,3,0.02h,Break Even,$0.75,$522.75,$213617.00,163,$522.75
2024-08-16,19:40:00,19603.25,SELL,3,0.02h,Break Even,$0.75,$523.50,$213617.75,163,$523.50
2024-08-16,19:57:00,19608.75,BUY,3,0.02h,Stop Loss,$12.00,$535.50,$213629.75,163,$535.50
2024-08-16,20:32:00,19606.25,SELL,3,0.02h,Stop Loss,$15.75,$551.25,$213645.50,163,$551.25
2024-08-16,20:53:00,19610.5,BUY,3,0.02h,Break Even,$0.75,$552.00,$213646.25,163,$552.00
2024-08-16,21:00:00,19604.5,SELL,3,63.00h,Stop Loss,$-18.00,$534.00,$213628.25,163,$534.00
,,,,,,,,,,,
2024-08-19,12:04:00,19618.0,BUY,3,0.02h,Break Even,$0.75,$0.75,$213629.00,164,$0.75
2024-08-19,12:37:00,19621.25,SELL,3,0.02h,Stop Loss,$-18.00,$-17.25,$213611.00,164,$-17.25
2024-08-19,12:48:00,19628.75,BUY,3,0.02h,Stop Loss,$-18.00,$-35.25,$213593.00,164,$-35.25
2024-08-19,12:53:00,19618.5,SELL,3,0.02h,Stop Loss,$-18.00,$-53.25,$213575.00,164,$-53.25
2024-08-19,13:06:00,19630.5,BUY,3,0.02h,Break Even,$0.75,$-52.50,$213575.75,164,$-52.50
2024-08-19,13:23:00,19623.0,SELL,3,0.02h,Break Even,$0.75,$-51.75,$213576.50,164,$-51.75
2024-08-19,13:48:00,19613.5,BUY,3,0.02h,Stop Loss,$105.75,$54.00,$213682.25,164,$54.00
2024-08-19,13:55:00,19583.25,SELL,3,0.02h,Stop Loss,$72.00,$126.00,$213754.25,164,$126.00
2024-08-19,14:09:00,19619.0,BUY,3,0.02h,Stop Loss,$-18.00,$108.00,$213736.25,164,$108.00
2024-08-19,14:18:00,19549.25,SELL,3,0.02h,Stop Loss,$-18.00,$90.00,$213718.25,164,$90.00
2024-08-19,14:28:00,19610.25,BUY,3,0.02h,Stop Loss,$38.25,$128.25,$213756.50,164,$128.25
2024-08-19,15:19:00,19643.0,SELL,3,0.02h,Break Even,$0.75,$129.00,$213757.25,164,$129.00
2024-08-19,15:25:00,19662.5,BUY,3,0.02h,Stop Loss,$-18.00,$111.00,$213739.25,164,$111.00
2024-08-19,15:42:00,19655.0,SELL,3,0.02h,Break Even,$0.75,$111.75,$213740.00,164,$111.75
2024-08-19,15:45:00,19659.5,BUY,3,0.02h,Stop Loss,$57.00,$168.75,$213797.00,164,$168.75
2024-08-19,15:58:00,19644.75,SELL,3,0.02h,Stop Loss,$334.50,$503.25,$214131.50,164,$503.25
2024-08-19,16:17:00,19655.0,BUY,3,0.02h,Stop Loss,$45.75,$549.00,$214177.25,164,$549.00
2024-08-19,16:36:00,19649.0,SELL,3,0.02h,Stop Loss,$-18.00,$531.00,$214159.25,164,$531.00
2024-08-19,16:39:00,19660.75,BUY,3,0.02h,Break Even,$0.75,$531.75,$214160.00,164,$531.75
2024-08-19,17:15:00,19681.75,SELL,3,0.02h,Stop Loss,$64.50,$596.25,$214224.50,164,$596.25
2024-08-19,17:22:00,19690.5,BUY,3,0.02h,Stop Loss,$-18.00,$578.25,$214206.50,164,$578.25
2024-08-19,19:03:00,19761.75,SELL,3,0.02h,Stop Loss,$-18.00,$560.25,$214188.50,164,$560.25
2024-08-19,19:16:00,19767.75,BUY,3,0.02h,Stop Loss,$19.50,$579.75,$214208.00,164,$579.75
2024-08-19,19:47:00,19768.5,SELL,3,0.02h,Stop Loss,$-18.00,$561.75,$214190.00,164,$561.75
2024-08-19,19:52:00,19792.5,BUY,3,0.02h,Stop Loss,$124.50,$686.25,$214314.50,164,$686.25
2024-08-19,20:48:00,19860.25,SELL,3,0.02h,Stop Loss,$-18.00,$668.25,$214296.50,164,$668.25
2024-08-19,22:02:00,19868.25,BUY,3,0.02h,Stop Loss,$-18.00,$650.25,$214278.50,164,$650.25
2024-08-19,22:48:00,19864.75,SELL,3,0.02h,Stop Loss,$-18.00,$632.25,$214260.50,164,$632.25
,,,,,,,,,,,
2024-08-20,12:01:00,19878.25,BUY,3,0.02h,Stop Loss,$-18.00,$-18.00,$214242.50,165,$-18.00
2024-08-20,12:09:00,19869.0,SELL,3,0.02h,Stop Loss,$-18.00,$-36.00,$214224.50,165,$-36.00
2024-08-20,12:10:00,19877.0,BUY,3,0.02h,Break Even,$0.75,$-35.25,$214225.25,165,$-35.25
2024-08-20,12:23:00,19867.25,SELL,3,0.02h,Stop Loss,$-18.00,$-53.25,$214207.25,165,$-53.25
2024-08-20,13:32:00,19839.75,BUY,3,0.02h,Stop Loss,$79.50,$26.25,$214286.75,165,$26.25
2024-08-20,14:12:00,19862.5,SELL,3,0.02h,Stop Loss,$495.75,$522.00,$214782.50,165,$522.00
2024-08-20,14:54:00,19808.5,BUY,3,0.02h,Break Even,$0.75,$522.75,$214783.25,165,$522.75
2024-08-20,14:58:00,19783.25,SELL,3,0.02h,Break Even,$0.75,$523.50,$214784.00,165,$523.50
2024-08-20,15:14:00,19800.75,BUY,3,0.02h,Break Even,$0.75,$524.25,$214784.75,165,$524.25
2024-08-20,15:31:00,19797.0,SELL,3,0.02h,Break Even,$0.75,$525.00,$214785.50,165,$525.00
2024-08-20,15:32:00,19807.25,BUY,3,0.02h,Stop Loss,$27.00,$552.00,$214812.50,165,$552.00
2024-08-20,15:45:00,19795.0,SELL,3,0.02h,Stop Loss,$169.50,$721.50,$214982.00,165,$721.50
2024-08-20,15:54:00,19820.5,BUY,3,0.02h,Stop Loss,$30.75,$752.25,$215012.75,165,$752.25
2024-08-20,16:17:00,19820.25,SELL,3,0.02h,Stop Loss,$98.25,$850.50,$215111.00,165,$850.50
2024-08-20,16:51:00,19813.5,BUY,3,0.02h,Break Even,$0.75,$851.25,$215111.75,165,$851.25
2024-08-20,16:52:00,19807.0,SELL,3,0.02h,Stop Loss,$34.50,$885.75,$215146.25,165,$885.75
2024-08-20,17:28:00,19792.25,BUY,3,0.02h,Stop Loss,$-18.00,$867.75,$215128.25,165,$867.75
2024-08-20,18:50:00,19849.75,SELL,3,0.02h,Break Even,$0.75,$868.50,$215129.00,165,$868.50
2024-08-20,19:05:00,19853.0,BUY,3,0.02h,Stop Loss,$19.50,$888.00,$215148.50,165,$888.00
2024-08-20,19:09:00,19839.75,SELL,3,0.02h,Break Even,$0.75,$888.75,$215149.25,165,$888.75
2024-08-20,19:49:00,19837.5,BUY,3,0.02h,Stop Loss,$64.50,$953.25,$215213.75,165,$953.25
2024-08-20,19:55:00,19826.75,SELL,3,0.02h,Stop Loss,$124.50,$1077.75,$215338.25,165,$1077.75
2024-08-20,20:15:00,19831.5,BUY,3,0.02h,Stop Loss,$-18.00,$1059.75,$215320.25,165,$1059.75
2024-08-20,20:24:00,19818.75,SELL,3,0.02h,Stop Loss,$-18.00,$1041.75,$215302.25,165,$1041.75
2024-08-20,22:26:00,19803.25,BUY,3,0.02h,Break Even,$0.75,$1042.50,$215303.00,165,$1042.50
2024-08-20,22:29:00,19799.0,SELL,3,0.02h,Stop Loss,$-18.00,$1024.50,$215285.00,165,$1024.50
2024-08-20,22:32:00,19803.5,BUY,3,0.02h,Break Even,$0.75,$1025.25,$215285.75,165,$1025.25
2024-08-20,22:47:00,19800.5,SELL,3,0.02h,Stop Loss,$-18.00,$1007.25,$215267.75,165,$1007.25
,,,,,,,,,,,
2024-08-21,12:00:00,19832.25,BUY,3,0.02h,Break Even,$0.75,$0.75,$215268.50,166,$0.75
2024-08-21,12:51:00,19845.25,SELL,3,0.02h,Break Even,$0.75,$1.50,$215269.25,166,$1.50
2024-08-21,13:06:00,19853.0,BUY,3,0.02h,Stop Loss,$-18.00,$-16.50,$215251.25,166,$-16.50
2024-08-21,13:21:00,19843.75,SELL,3,0.02h,Break Even,$0.75,$-15.75,$215252.00,166,$-15.75
2024-08-21,13:25:00,19854.5,BUY,3,0.02h,Stop Loss,$-18.00,$-33.75,$215234.00,166,$-33.75
2024-08-21,13:29:00,19844.0,SELL,3,0.02h,Stop Loss,$27.00,$-6.75,$215261.00,166,$-6.75
2024-08-21,13:42:00,19855.5,BUY,3,0.02h,Break Even,$0.75,$-6.00,$215261.75,166,$-6.00
2024-08-21,14:17:00,19869.0,SELL,3,0.02h,Stop Loss,$79.50,$73.50,$215341.25,166,$73.50
2024-08-21,14:20:00,19898.25,BUY,3,0.02h,Stop Loss,$79.50,$153.00,$215420.75,166,$153.00
2024-08-21,14:28:00,19881.75,SELL,3,0.02h,Break Even,$0.75,$153.75,$215421.50,166,$153.75
2024-08-21,14:37:00,19935.5,BUY,3,0.02h,Stop Loss,$79.50,$233.25,$215501.00,166,$233.25
2024-08-21,14:52:00,19859.75,SELL,3,0.02h,Stop Loss,$750.75,$984.00,$216251.75,166,$984.00
2024-08-21,15:13:00,19879.75,BUY,3,0.02h,Stop Loss,$128.25,$1112.25,$216380.00,166,$1112.25
2024-08-21,15:27:00,19864.0,SELL,3,0.02h,Break Even,$0.75,$1113.00,$216380.75,166,$1113.00
2024-08-21,16:19:00,19818.25,BUY,3,0.02h,Stop Loss,$173.25,$1286.25,$216554.00,166,$1286.25
2024-08-21,17:19:00,19858.5,SELL,3,0.02h,Stop Loss,$-18.00,$1268.25,$216536.00,166,$1268.25
2024-08-21,17:32:00,19868.25,BUY,3,0.02h,Break Even,$0.75,$1269.00,$216536.75,166,$1269.00
2024-08-21,18:40:00,19904.25,SELL,3,0.02h,Stop Loss,$75.75,$1344.75,$216612.50,166,$1344.75
2024-08-21,18:55:00,19915.0,BUY,3,0.02h,Break Even,$0.75,$1345.50,$216613.25,166,$1345.50
2024-08-21,19:01:00,19898.25,SELL,3,0.02h,Stop Loss,$87.00,$1432.50,$216700.25,166,$1432.50
2024-08-21,19:34:00,19875.0,BUY,3,0.02h,Stop Loss,$-18.00,$1414.50,$216682.25,166,$1414.50
2024-08-21,19:39:00,19865.0,SELL,3,0.02h,Stop Loss,$-18.00,$1396.50,$216664.25,166,$1396.50
2024-08-21,19:40:00,19875.25,BUY,3,0.02h,Break Even,$0.75,$1397.25,$216665.00,166,$1397.25
2024-08-21,19:44:00,19859.75,SELL,3,0.02h,Stop Loss,$-18.00,$1379.25,$216647.00,166,$1379.25
2024-08-21,19:49:00,19879.0,BUY,3,0.02h,Stop Loss,$60.75,$1440.00,$216707.75,166,$1440.00
2024-08-21,20:48:00,19912.75,SELL,3,0.02h,Stop Loss,$-18.00,$1422.00,$216689.75,166,$1422.00
2024-08-21,20:52:00,19918.75,BUY,3,0.02h,Stop Loss,$-18.00,$1404.00,$216671.75,166,$1404.00
2024-08-21,22:06:00,19913.75,SELL,3,0.02h,Stop Loss,$-18.00,$1386.00,$216653.75,166,$1386.00
2024-08-21,22:07:00,19922.5,BUY,3,0.02h,Stop Loss,$19.50,$1405.50,$216673.25,166,$1405.50
2024-08-21,23:00:00,19935.0,SELL,3,13.00h,Stop Loss,$-18.00,$1387.50,$216655.25,166,$1387.50
,,,,,,,,,,,
2024-08-22,12:00:00,19976.75,BUY,3,0.02h,Stop Loss,$12.00,$12.00,$216667.25,167,$12.00
2024-08-22,12:21:00,19964.25,SELL,3,0.02h,Stop Loss,$60.75,$72.75,$216728.00,167,$72.75
2024-08-22,12:31:00,19981.25,BUY,3,0.02h,Stop Loss,$34.50,$107.25,$216762.50,167,$107.25
2024-08-22,12:37:00,19963.5,SELL,3,0.02h,Stop Loss,$225.75,$333.00,$216988.25,167,$333.00
2024-08-22,12:45:00,19969.75,BUY,3,0.02h,Break Even,$0.75,$333.75,$216989.00,167,$333.75
2024-08-22,12:46:00,19959.75,SELL,3,0.02h,Stop Loss,$68.25,$402.00,$217057.25,167,$402.00
2024-08-22,12:52:00,19971.75,BUY,3,0.02h,Stop Loss,$19.50,$421.50,$217076.75,167,$421.50
2024-08-22,13:39:00,19981.25,SELL,3,0.02h,Stop Loss,$120.75,$542.25,$217197.50,167,$542.25
2024-08-22,13:57:00,20003.75,BUY,3,0.02h,Stop Loss,$30.75,$573.00,$217228.25,167,$573.00
2024-08-22,14:01:00,19973.75,SELL,3,0.02h,Stop Loss,$240.75,$813.75,$217469.00,167,$813.75
2024-08-22,15:03:00,19905.5,BUY,3,0.02h,Stop Loss,$27.00,$840.75,$217496.00,167,$840.75
2024-08-22,15:11:00,19869.0,SELL,3,0.02h,Stop Loss,$117.00,$957.75,$217613.00,167,$957.75
2024-08-22,16:06:00,19736.0,BUY,3,0.02h,Stop Loss,$23.25,$981.00,$217636.25,167,$981.00
2024-08-22,16:51:00,19775.25,SELL,3,0.02h,Stop Loss,$240.75,$1221.75,$217877.00,167,$1221.75
2024-08-22,17:28:00,19720.75,BUY,3,0.02h,Break Even,$0.75,$1222.50,$217877.75,167,$1222.50
2024-08-22,17:30:00,19709.25,SELL,3,0.02h,Stop Loss,$23.25,$1245.75,$217901.00,167,$1245.75
2024-08-22,18:16:00,19639.75,BUY,3,0.02h,Break Even,$0.75,$1246.50,$217901.75,167,$1246.50
2024-08-22,18:55:00,19629.25,SELL,3,0.02h,Stop Loss,$-18.00,$1228.50,$217883.75,167,$1228.50
2024-08-22,19:05:00,19660.75,BUY,3,0.02h,Break Even,$0.75,$1229.25,$217884.50,167,$1229.25
2024-08-22,19:11:00,19630.0,SELL,3,0.02h,Stop Loss,$-18.00,$1211.25,$217866.50,167,$1211.25
2024-08-22,20:03:00,19597.25,BUY,3,0.02h,Stop Loss,$49.50,$1260.75,$217916.00,167,$1260.75
2024-08-22,20:44:00,19609.5,SELL,3,0.02h,Break Even,$0.75,$1261.50,$217916.75,167,$1261.50
2024-08-22,20:45:00,19613.5,BUY,3,0.02h,Stop Loss,$42.00,$1303.50,$217958.75,167,$1303.50
2024-08-22,22:23:00,19619.0,SELL,3,0.02h,Stop Loss,$-18.00,$1285.50,$217940.75,167,$1285.50
2024-08-22,22:24:00,19622.25,BUY,3,0.02h,Break Even,$0.75,$1286.25,$217941.50,167,$1286.25
,,,,,,,,,,,
2024-08-23,13:27:00,19761.5,SELL,3,0.02h,Stop Loss,$30.75,$30.75,$217972.25,168,$30.75
2024-08-23,13:50:00,19749.5,BUY,3,0.02h,Stop Loss,$57.00,$87.75,$218029.25,168,$87.75
2024-08-23,14:38:00,19830.25,SELL,3,0.02h,Stop Loss,$330.75,$418.50,$218360.00,168,$418.50
2024-08-23,15:16:00,19780.25,BUY,3,0.02h,Break Even,$0.75,$419.25,$218360.75,168,$419.25
2024-08-23,15:46:00,19718.0,SELL,3,0.02h,Stop Loss,$90.75,$510.00,$218451.50,168,$510.00
2024-08-23,16:36:00,19690.75,BUY,3,0.02h,Stop Loss,$90.75,$600.75,$218542.25,168,$600.75
2024-08-23,16:43:00,19608.25,SELL,3,0.02h,Stop Loss,$19.50,$620.25,$218561.75,168,$620.25
2024-08-23,16:56:00,19689.75,BUY,3,0.02h,Stop Loss,$102.00,$722.25,$218663.75,168,$722.25
2024-08-23,18:00:00,19732.75,SELL,3,0.02h,Stop Loss,$105.75,$828.00,$218769.50,168,$828.00
2024-08-23,18:05:00,19748.75,BUY,3,0.02h,Break Even,$0.75,$828.75,$218770.25,168,$828.75
2024-08-23,18:33:00,19742.25,SELL,3,0.02h,Break Even,$0.75,$829.50,$218771.00,168,$829.50
2024-08-23,18:41:00,19753.75,BUY,3,0.02h,Stop Loss,$109.50,$939.00,$218880.50,168,$939.00
2024-08-23,18:58:00,19742.5,SELL,3,0.02h,Stop Loss,$252.00,$1191.00,$219132.50,168,$1191.00
2024-08-23,19:13:00,19755.25,BUY,3,0.02h,Stop Loss,$417.00,$1608.00,$219549.50,168,$1608.00
2024-08-23,19:39:00,19770.25,SELL,3,0.02h,Stop Loss,$139.50,$1747.50,$219689.00,168,$1747.50
2024-08-23,19:54:00,19781.75,BUY,3,0.02h,Stop Loss,$323.25,$2070.75,$220012.25,168,$2070.75
2024-08-23,20:34:00,19786.75,SELL,3,0.02h,Break Even,$0.75,$2071.50,$220013.00,168,$2071.50
,,,,,,,,,,,
2024-08-26,12:12:00,19784.5,BUY,3,0.02h,Break Even,$0.75,$0.75,$220013.75,169,$0.75
2024-08-26,12:28:00,19776.5,SELL,3,0.02h,Stop Loss,$-18.00,$-17.25,$219995.75,169,$-17.25
2024-08-26,12:55:00,19773.0,BUY,3,0.02h,Break Even,$0.75,$-16.50,$219996.50,169,$-16.50
2024-08-26,13:05:00,19760.25,SELL,3,0.02h,Stop Loss,$-18.00,$-34.50,$219978.50,169,$-34.50
2024-08-26,13:09:00,19774.0,BUY,3,0.02h,Stop Loss,$-18.00,$-52.50,$219960.50,169,$-52.50
2024-08-26,13:31:00,19768.25,SELL,3,0.02h,Stop Loss,$334.50,$282.00,$220295.00,169,$282.00
2024-08-26,13:34:00,19793.75,BUY,3,0.02h,Stop Loss,$68.25,$350.25,$220363.25,169,$350.25
2024-08-26,13:43:00,19760.25,SELL,3,0.02h,Stop Loss,$158.25,$508.50,$220521.50,169,$508.50
2024-08-26,14:57:00,19576.75,BUY,3,0.02h,Stop Loss,$109.50,$618.00,$220631.00,169,$618.00
2024-08-26,15:33:00,19595.25,SELL,3,0.02h,Stop Loss,$-18.00,$600.00,$220613.00,169,$600.00
2024-08-26,15:43:00,19611.0,BUY,3,0.02h,Stop Loss,$105.75,$705.75,$220718.75,169,$705.75
2024-08-26,15:46:00,19588.5,SELL,3,0.02h,Stop Loss,$19.50,$725.25,$220738.25,169,$725.25
2024-08-26,16:18:00,19579.0,BUY,3,0.02h,Break Even,$0.75,$726.00,$220739.00,169,$726.00
2024-08-26,16:57:00,19619.5,SELL,3,0.02h,Break Even,$0.75,$726.75,$220739.75,169,$726.75
2024-08-26,17:26:00,19618.25,BUY,3,0.02h,Stop Loss,$-18.00,$708.75,$220721.75,169,$708.75
2024-08-26,17:30:00,19595.25,SELL,3,0.02h,Break Even,$0.75,$709.50,$220722.50,169,$709.50
2024-08-26,18:17:00,19541.25,BUY,3,0.02h,Break Even,$0.75,$710.25,$220723.25,169,$710.25
2024-08-26,19:09:00,19597.25,SELL,3,0.02h,Break Even,$0.75,$711.00,$220724.00,169,$711.00
2024-08-26,19:55:00,19586.5,BUY,3,0.02h,Break Even,$0.75,$711.75,$220724.75,169,$711.75
2024-08-26,19:57:00,19571.0,SELL,3,0.02h,Stop Loss,$169.50,$881.25,$220894.25,169,$881.25
2024-08-26,20:00:00,19593.5,BUY,3,0.02h,Stop Loss,$12.00,$893.25,$220906.25,169,$893.25
2024-08-26,20:06:00,19575.25,SELL,3,0.02h,Break Even,$0.75,$894.00,$220907.00,169,$894.00
2024-08-26,20:55:00,19566.5,BUY,3,0.02h,Break Even,$0.75,$894.75,$220907.75,169,$894.75
2024-08-26,21:00:00,19549.75,SELL,3,1.02h,Stop Loss,$-18.00,$876.75,$220889.75,169,$876.75
2024-08-26,22:01:00,19565.75,BUY,3,0.02h,Stop Loss,$34.50,$911.25,$220924.25,169,$911.25
2024-08-26,22:10:00,19535.75,SELL,3,0.02h,Break Even,$0.75,$912.00,$220925.00,169,$912.00
2024-08-26,22:58:00,19535.75,BUY,3,0.03h,Break Even,$0.75,$912.75,$220925.75,169,$912.75
,,,,,,,,,,,
2024-08-27,12:21:00,19554.5,SELL,3,0.02h,Stop Loss,$12.00,$12.00,$220937.75,170,$12.00
2024-08-27,13:24:00,19516.0,BUY,3,0.02h,Stop Loss,$12.00,$24.00,$220949.75,170,$24.00
2024-08-27,13:38:00,19488.25,SELL,3,0.02h,Stop Loss,$252.00,$276.00,$221201.75,170,$276.00
2024-08-27,13:52:00,19509.75,BUY,3,0.02h,Stop Loss,$319.50,$595.50,$221521.25,170,$595.50
2024-08-27,15:20:00,19656.0,SELL,3,0.02h,Stop Loss,$60.75,$656.25,$221582.00,170,$656.25
2024-08-27,16:03:00,19614.5,BUY,3,0.02h,Stop Loss,$12.00,$668.25,$221594.00,170,$668.25
2024-08-27,16:32:00,19618.0,SELL,3,0.02h,Stop Loss,$-18.00,$650.25,$221576.00,170,$650.25
2024-08-27,16:33:00,19635.75,BUY,3,0.02h,Stop Loss,$90.75,$741.00,$221666.75,170,$741.00
2024-08-27,16:42:00,19610.5,SELL,3,0.02h,Stop Loss,$364.50,$1105.50,$222031.25,170,$1105.50
2024-08-27,16:51:00,19638.5,BUY,3,0.02h,Stop Loss,$83.25,$1188.75,$222114.50,170,$1188.75
2024-08-27,17:05:00,19622.25,SELL,3,0.02h,Stop Loss,$30.75,$1219.50,$222145.25,170,$1219.50
2024-08-27,17:06:00,19631.5,BUY,3,0.02h,Break Even,$0.75,$1220.25,$222146.00,170,$1220.25
2024-08-27,18:12:00,19670.75,SELL,3,0.02h,Stop Loss,$113.25,$1333.50,$222259.25,170,$1333.50
2024-08-27,18:46:00,19667.0,BUY,3,0.02h,Stop Loss,$-18.00,$1315.50,$222241.25,170,$1315.50
2024-08-27,18:50:00,19658.75,SELL,3,0.02h,Stop Loss,$233.25,$1548.75,$222474.50,170,$1548.75
2024-08-27,19:28:00,19656.5,BUY,3,0.02h,Stop Loss,$-18.00,$1530.75,$222456.50,170,$1530.75
2024-08-27,19:32:00,19640.25,SELL,3,0.02h,Stop Loss,$49.50,$1580.25,$222506.00,170,$1580.25
2024-08-27,19:40:00,19650.5,BUY,3,0.02h,Stop Loss,$53.25,$1633.50,$222559.25,170,$1633.50
2024-08-27,19:54:00,19636.75,SELL,3,0.02h,Break Even,$0.75,$1634.25,$222560.00,170,$1634.25
2024-08-27,20:04:00,19654.25,BUY,3,0.02h,Stop Loss,$53.25,$1687.50,$222613.25,170,$1687.50
2024-08-27,20:13:00,19646.0,SELL,3,0.02h,Stop Loss,$-18.00,$1669.50,$222595.25,170,$1669.50
2024-08-27,22:02:00,19644.25,BUY,3,0.02h,Break Even,$0.75,$1670.25,$222596.00,170,$1670.25
2024-08-27,22:11:00,19607.25,SELL,3,0.02h,Stop Loss,$42.00,$1712.25,$222638.00,170,$1712.25
2024-08-27,23:00:00,19595.75,BUY,3,13.00h,Stop Loss,$327.00,$2039.25,$222965.00,170,$2039.25
,,,,,,,,,,,
2024-08-28,13:07:00,19630.25,SELL,3,0.02h,Stop Loss,$154.50,$154.50,$223119.50,171,$154.50
2024-08-28,13:31:00,19653.75,BUY,3,0.02h,Break Even,$0.75,$155.25,$223120.25,171,$155.25
2024-08-28,13:38:00,19610.75,SELL,3,0.02h,Stop Loss,$83.25,$238.50,$223203.50,171,$238.50
2024-08-28,14:20:00,19568.5,BUY,3,0.02h,Stop Loss,$72.00,$310.50,$223275.50,171,$310.50
2024-08-28,14:38:00,19559.0,SELL,3,0.02h,Break Even,$0.75,$311.25,$223276.25,171,$311.25
2024-08-28,15:37:00,19400.75,BUY,3,0.02h,Stop Loss,$30.75,$342.00,$223307.00,171,$342.00
2024-08-28,16:16:00,19406.25,SELL,3,0.02h,Stop Loss,$252.00,$594.00,$223559.00,171,$594.00
2024-08-28,16:35:00,19417.0,BUY,3,0.02h,Stop Loss,$38.25,$632.25,$223597.25,171,$632.25
2024-08-28,17:15:00,19417.25,SELL,3,0.02h,Stop Loss,$38.25,$670.50,$223635.50,171,$670.50
2024-08-28,17:36:00,19436.5,BUY,3,0.02h,Stop Loss,$-18.00,$652.50,$223617.50,171,$652.50
2024-08-28,17:39:00,19430.0,SELL,3,0.02h,Stop Loss,$113.25,$765.75,$223730.75,171,$765.75
2024-08-28,18:24:00,19333.5,BUY,3,0.02h,Break Even,$0.75,$766.50,$223731.50,171,$766.50
2024-08-28,18:25:00,19326.0,SELL,3,0.02h,Stop Loss,$27.00,$793.50,$223758.50,171,$793.50
2024-08-28,18:34:00,19334.5,BUY,3,0.02h,Break Even,$0.75,$794.25,$223759.25,171,$794.25
2024-08-28,18:45:00,19324.75,SELL,3,0.02h,Break Even,$0.75,$795.00,$223760.00,171,$795.00
2024-08-28,18:51:00,19342.5,BUY,3,0.02h,Stop Loss,$229.50,$1024.50,$223989.50,171,$1024.50
2024-08-28,19:58:00,19432.5,SELL,3,0.02h,Stop Loss,$173.25,$1197.75,$224162.75,171,$1197.75
2024-08-28,20:20:00,19449.0,BUY,3,0.02h,Break Even,$0.75,$1198.50,$224163.50,171,$1198.50
2024-08-28,20:24:00,19347.25,SELL,3,0.02h,Stop Loss,$1264.50,$2463.00,$225428.00,171,$2463.00
,,,,,,,,,,,
2024-08-29,12:00:00,19466.25,BUY,3,0.02h,Stop Loss,$30.75,$30.75,$225458.75,172,$30.75
2024-08-29,12:44:00,19451.75,SELL,3,0.02h,Stop Loss,$83.25,$114.00,$225542.00,172,$114.00
2024-08-29,12:49:00,19482.25,BUY,3,0.02h,Break Even,$0.75,$114.75,$225542.75,172,$114.75
2024-08-29,13:01:00,19464.75,SELL,3,0.02h,Stop Loss,$-18.00,$96.75,$225524.75,172,$96.75
2024-08-29,13:02:00,19473.75,BUY,3,0.02h,Stop Loss,$30.75,$127.50,$225555.50,172,$127.50
2024-08-29,13:27:00,19474.75,SELL,3,0.02h,Stop Loss,$53.25,$180.75,$225608.75,172,$180.75
2024-08-29,13:29:00,19493.5,BUY,3,0.02h,Stop Loss,$105.75,$286.50,$225714.50,172,$286.50
2024-08-29,14:16:00,19605.0,SELL,3,0.02h,Stop Loss,$267.00,$553.50,$225981.50,172,$553.50
2024-08-29,14:30:00,19599.25,BUY,3,0.02h,Stop Loss,$158.25,$711.75,$226139.75,172,$711.75
2024-08-29,15:06:00,19637.75,SELL,3,0.02h,Stop Loss,$199.50,$911.25,$226339.25,172,$911.25
2024-08-29,15:11:00,19663.75,BUY,3,0.02h,Stop Loss,$-18.00,$893.25,$226321.25,172,$893.25
2024-08-29,15:20:00,19637.25,SELL,3,0.02h,Stop Loss,$274.50,$1167.75,$226595.75,172,$1167.75
2024-08-29,15:40:00,19649.0,BUY,3,0.02h,Break Even,$0.75,$1168.50,$226596.50,172,$1168.50
2024-08-29,15:45:00,19622.75,SELL,3,0.02h,Break Even,$0.75,$1169.25,$226597.25,172,$1169.25
2024-08-29,16:01:00,19645.0,BUY,3,0.02h,Stop Loss,$57.00,$1226.25,$226654.25,172,$1226.25
2024-08-29,16:51:00,19657.5,SELL,3,0.02h,Break Even,$0.75,$1227.00,$226655.00,172,$1227.00
2024-08-29,17:37:00,19623.75,BUY,3,0.02h,Stop Loss,$-18.00,$1209.00,$226637.00,172,$1209.00
2024-08-29,17:38:00,19615.5,SELL,3,0.02h,Break Even,$0.75,$1209.75,$226637.75,172,$1209.75
2024-08-29,17:57:00,19627.0,BUY,3,0.02h,Break Even,$0.75,$1210.50,$226638.50,172,$1210.50
2024-08-29,18:02:00,19584.75,SELL,3,0.02h,Break Even,$0.75,$1211.25,$226639.25,172,$1211.25
2024-08-29,19:26:00,19401.25,BUY,3,0.02h,Stop Loss,$19.50,$1230.75,$226658.75,172,$1230.75
2024-08-29,19:51:00,19402.75,SELL,3,0.02h,Stop Loss,$199.50,$1430.25,$226858.25,172,$1430.25
2024-08-29,20:07:00,19420.5,BUY,3,0.02h,Stop Loss,$42.00,$1472.25,$226900.25,172,$1472.25
2024-08-29,20:50:00,19441.25,SELL,3,0.02h,Stop Loss,$-18.00,$1454.25,$226882.25,172,$1454.25
2024-08-29,20:55:00,19447.0,BUY,3,0.02h,Break Even,$0.75,$1455.00,$226883.00,172,$1455.00
2024-08-29,22:06:00,19437.25,SELL,3,0.02h,Stop Loss,$173.25,$1628.25,$227056.25,172,$1628.25
2024-08-29,22:32:00,19438.25,BUY,3,0.02h,Stop Loss,$-18.00,$1610.25,$227038.25,172,$1610.25
2024-08-29,22:37:00,19431.0,SELL,3,0.02h,Stop Loss,$-18.00,$1592.25,$227020.25,172,$1592.25
2024-08-29,22:45:00,19438.0,BUY,3,0.02h,Break Even,$0.75,$1593.00,$227021.00,172,$1593.00
2024-08-29,22:51:00,19430.75,SELL,3,0.02h,Break Even,$0.75,$1593.75,$227021.75,172,$1593.75
,,,,,,,,,,,
2024-08-30,12:00:00,19526.75,BUY,3,0.02h,Stop Loss,$113.25,$113.25,$227135.00,173,$113.25
2024-08-30,12:36:00,19517.0,SELL,3,0.02h,Stop Loss,$83.25,$196.50,$227218.25,173,$196.50
2024-08-30,12:44:00,19554.0,BUY,3,0.02h,Stop Loss,$-18.00,$178.50,$227200.25,173,$178.50
2024-08-30,12:47:00,19534.25,SELL,3,0.02h,Stop Loss,$75.75,$254.25,$227276.00,173,$254.25
2024-08-30,13:09:00,19536.75,BUY,3,0.02h,Stop Loss,$53.25,$307.50,$227329.25,173,$307.50
2024-08-30,13:34:00,19525.5,SELL,3,0.02h,Stop Loss,$105.75,$413.25,$227435.00,173,$413.25
2024-08-30,13:42:00,19565.0,BUY,3,0.02h,Stop Loss,$49.50,$462.75,$227484.50,173,$462.75
2024-08-30,14:15:00,19575.25,SELL,3,0.02h,Stop Loss,$192.00,$654.75,$227676.50,173,$654.75
2024-08-30,14:37:00,19583.0,BUY,3,0.02h,Stop Loss,$-18.00,$636.75,$227658.50,173,$636.75
2024-08-30,14:47:00,19555.25,SELL,3,0.02h,Stop Loss,$75.75,$712.50,$227734.25,173,$712.50
2024-08-30,14:50:00,19588.5,BUY,3,0.02h,Break Even,$0.75,$713.25,$227735.00,173,$713.25
2024-08-30,14:53:00,19563.25,SELL,3,0.02h,Stop Loss,$330.75,$1044.00,$228065.75,173,$1044.00
2024-08-30,15:54:00,19470.75,BUY,3,0.02h,Stop Loss,$19.50,$1063.50,$228085.25,173,$1063.50
2024-08-30,16:01:00,19424.25,SELL,3,0.02h,Stop Loss,$128.25,$1191.75,$228213.50,173,$1191.75
2024-08-30,16:08:00,19467.5,BUY,3,0.02h,Stop Loss,$72.00,$1263.75,$228285.50,173,$1263.75
2024-08-30,16:22:00,19456.0,SELL,3,0.02h,Stop Loss,$53.25,$1317.00,$228338.75,173,$1317.00
2024-08-30,16:52:00,19431.75,BUY,3,0.02h,Stop Loss,$195.75,$1512.75,$228534.50,173,$1512.75
2024-08-30,17:24:00,19458.25,SELL,3,0.02h,Stop Loss,$83.25,$1596.00,$228617.75,173,$1596.00
2024-08-30,17:32:00,19472.75,BUY,3,0.02h,Stop Loss,$109.50,$1705.50,$228727.25,173,$1705.50
2024-08-30,17:45:00,19467.0,SELL,3,0.02h,Stop Loss,$64.50,$1770.00,$228791.75,173,$1770.00
2024-08-30,18:12:00,19469.25,BUY,3,0.02h,Stop Loss,$57.00,$1827.00,$228848.75,173,$1827.00
2024-08-30,19:13:00,19504.5,SELL,3,0.02h,Stop Loss,$124.50,$1951.50,$228973.25,173,$1951.50
2024-08-30,19:19:00,19520.25,BUY,3,0.02h,Stop Loss,$19.50,$1971.00,$228992.75,173,$1971.00
2024-08-30,19:44:00,19529.5,SELL,3,0.02h,Break Even,$0.75,$1971.75,$228993.50,173,$1971.75
2024-08-30,19:51:00,19593.5,BUY,3,0.02h,Stop Loss,$158.25,$2130.00,$229151.75,173,$2130.00
2024-08-30,20:42:00,19597.75,SELL,3,0.02h,Stop Loss,$-18.00,$2112.00,$229133.75,173,$2112.00
,,,,,,,,,,,
2024-09-02,12:01:00,19610.5,BUY,3,0.02h,Break Even,$0.75,$0.75,$229134.50,174,$0.75
2024-09-02,12:29:00,19613.0,SELL,3,0.02h,Stop Loss,$-18.00,$-17.25,$229116.50,174,$-17.25
2024-09-02,12:32:00,19616.75,BUY,3,0.02h,Break Even,$0.75,$-16.50,$229117.25,174,$-16.50
2024-09-02,12:35:00,19613.5,SELL,3,0.02h,Stop Loss,$-18.00,$-34.50,$229099.25,174,$-34.50
2024-09-02,12:53:00,19613.25,BUY,3,0.02h,Stop Loss,$-18.00,$-52.50,$229081.25,174,$-52.50
2024-09-02,12:58:00,19609.75,SELL,3,0.02h,Break Even,$0.75,$-51.75,$229082.00,174,$-51.75
2024-09-02,13:02:00,19615.25,BUY,3,0.02h,Stop Loss,$15.75,$-36.00,$229097.75,174,$-36.00
2024-09-02,13:30:00,19618.0,SELL,3,0.02h,Stop Loss,$-18.00,$-54.00,$229079.75,174,$-54.00
2024-09-02,13:31:00,19621.75,BUY,3,0.02h,Stop Loss,$15.75,$-38.25,$229095.50,174,$-38.25
2024-09-02,13:35:00,19617.75,SELL,3,0.02h,Break Even,$0.75,$-37.50,$229096.25,174,$-37.50
2024-09-02,13:39:00,19625.5,BUY,3,0.02h,Break Even,$0.75,$-36.75,$229097.00,174,$-36.75
2024-09-02,14:00:00,19619.5,SELL,3,0.02h,Break Even,$0.75,$-36.00,$229097.75,174,$-36.00
2024-09-02,14:32:00,19617.75,BUY,3,0.02h,Stop Loss,$150.75,$114.75,$229248.50,174,$114.75
2024-09-02,15:26:00,19656.25,SELL,3,0.02h,Break Even,$0.75,$115.50,$229249.25,174,$115.50
2024-09-02,15:51:00,19653.75,BUY,3,0.02h,Break Even,$0.75,$116.25,$229250.00,174,$116.25
2024-09-02,16:08:00,19650.0,SELL,3,0.02h,Stop Loss,$-18.00,$98.25,$229232.00,174,$98.25
2024-09-02,16:10:00,19654.75,BUY,3,0.02h,Break Even,$0.75,$99.00,$229232.75,174,$99.00
2024-09-02,16:21:00,19651.25,SELL,3,0.02h,Break Even,$0.75,$99.75,$229233.50,174,$99.75
2024-09-02,16:42:00,19653.5,BUY,3,0.02h,Stop Loss,$-18.00,$81.75,$229215.50,174,$81.75
2024-09-02,16:49:00,19648.0,SELL,3,0.02h,Stop Loss,$27.00,$108.75,$229242.50,174,$108.75
2024-09-02,22:01:00,19663.0,BUY,3,0.02h,Stop Loss,$-18.00,$90.75,$229224.50,174,$90.75
2024-09-02,22:25:00,19663.75,SELL,3,0.02h,Stop Loss,$53.25,$144.00,$229277.75,174,$144.00
,,,,,,,,,,,
2024-09-03,12:41:00,19514.75,BUY,3,0.02h,Stop Loss,$42.00,$42.00,$229319.75,175,$42.00
2024-09-03,12:54:00,19507.0,SELL,3,0.02h,Stop Loss,$30.75,$72.75,$229350.50,175,$72.75
2024-09-03,13:22:00,19495.0,BUY,3,0.02h,Stop Loss,$-18.00,$54.75,$229332.50,175,$54.75
2024-09-03,13:30:00,19478.25,SELL,3,0.02h,Stop Loss,$383.25,$438.00,$229715.75,175,$438.00
2024-09-03,15:13:00,19216.5,BUY,3,0.02h,Stop Loss,$75.75,$513.75,$229791.50,175,$513.75
2024-09-03,15:25:00,19195.75,SELL,3,0.02h,Stop Loss,$57.00,$570.75,$229848.50,175,$570.75
2024-09-03,15:37:00,19219.75,BUY,3,0.02h,Break Even,$0.75,$571.50,$229849.25,175,$571.50
2024-09-03,15:41:00,19184.75,SELL,3,0.02h,Stop Loss,$94.50,$666.00,$229943.75,175,$666.00
2024-09-03,16:16:00,19176.5,BUY,3,0.02h,Stop Loss,$248.25,$914.25,$230192.00,175,$914.25
2024-09-03,16:27:00,19159.25,SELL,3,0.02h,Stop Loss,$19.50,$933.75,$230211.50,175,$933.75
2024-09-03,17:08:00,19157.75,BUY,3,0.02h,Stop Loss,$72.00,$1005.75,$230283.50,175,$1005.75
2024-09-03,17:13:00,19139.0,SELL,3,0.02h,Stop Loss,$147.00,$1152.75,$230430.50,175,$1152.75
2024-09-03,17:22:00,19168.0,BUY,3,0.02h,Stop Loss,$109.50,$1262.25,$230540.00,175,$1262.25
2024-09-03,17:35:00,19138.25,SELL,3,0.02h,Stop Loss,$-18.00,$1244.25,$230522.00,175,$1244.25
2024-09-03,18:40:00,19056.25,BUY,3,0.02h,Stop Loss,$30.75,$1275.00,$230552.75,175,$1275.00
2024-09-03,18:43:00,19049.75,SELL,3,0.02h,Stop Loss,$42.00,$1317.00,$230594.75,175,$1317.00
2024-09-03,19:02:00,19055.75,BUY,3,0.02h,Break Even,$0.75,$1317.75,$230595.50,175,$1317.75
2024-09-03,19:12:00,19045.75,SELL,3,0.02h,Stop Loss,$45.75,$1363.50,$230641.25,175,$1363.50
2024-09-03,19:22:00,19060.25,BUY,3,0.02h,Break Even,$0.75,$1364.25,$230642.00,175,$1364.25
2024-09-03,19:25:00,19044.25,SELL,3,0.02h,Stop Loss,$30.75,$1395.00,$230672.75,175,$1395.00
2024-09-03,19:59:00,19001.25,BUY,3,0.02h,Stop Loss,$165.75,$1560.75,$230838.50,175,$1560.75
2024-09-03,20:19:00,18994.0,SELL,3,0.02h,Stop Loss,$-18.00,$1542.75,$230820.50,175,$1542.75
2024-09-03,20:55:00,18987.5,BUY,3,0.02h,Stop Loss,$57.00,$1599.75,$230877.50,175,$1599.75
2024-09-03,22:06:00,18971.0,SELL,3,0.02h,Break Even,$0.75,$1600.50,$230878.25,175,$1600.50
2024-09-03,22:20:00,18982.0,BUY,3,0.02h,Stop Loss,$49.50,$1650.00,$230927.75,175,$1650.00
2024-09-03,22:50:00,18981.0,SELL,3,0.02h,Stop Loss,$-18.00,$1632.00,$230909.75,175,$1632.00
,,,,,,,,,,,
2024-09-04,12:44:00,18888.75,BUY,3,0.02h,Stop Loss,$49.50,$49.50,$230959.25,176,$49.50
2024-09-04,13:11:00,18892.25,SELL,3,0.02h,Stop Loss,$15.75,$65.25,$230975.00,176,$65.25
2024-09-04,13:35:00,18922.25,BUY,3,0.02h,Break Even,$0.75,$66.00,$230975.75,176,$66.00
2024-09-04,14:01:00,18852.0,SELL,3,0.02h,Break Even,$0.75,$66.75,$230976.50,176,$66.75
2024-09-04,14:10:00,18971.75,BUY,3,0.02h,Stop Loss,$398.25,$465.00,$231374.75,176,$465.00
2024-09-04,14:19:00,18931.5,SELL,3,0.02h,Stop Loss,$68.25,$533.25,$231443.00,176,$533.25
2024-09-04,14:24:00,18962.0,BUY,3,0.02h,Stop Loss,$124.50,$657.75,$231567.50,176,$657.75
2024-09-04,15:16:00,19054.75,SELL,3,0.02h,Stop Loss,$83.25,$741.00,$231650.75,176,$741.00
2024-09-04,15:55:00,19029.25,BUY,3,0.02h,Stop Loss,$-18.00,$723.00,$231632.75,176,$723.00
2024-09-04,15:57:00,18991.25,SELL,3,0.02h,Stop Loss,$23.25,$746.25,$231656.00,176,$746.25
2024-09-04,16:17:00,19023.5,BUY,3,0.02h,Stop Loss,$120.75,$867.00,$231776.75,176,$867.00
2024-09-04,16:47:00,19032.5,SELL,3,0.02h,Break Even,$0.75,$867.75,$231777.50,176,$867.75
2024-09-04,16:56:00,19053.25,BUY,3,0.02h,Stop Loss,$38.25,$906.00,$231815.75,176,$906.00
2024-09-04,17:05:00,19041.25,SELL,3,0.02h,Stop Loss,$-18.00,$888.00,$231797.75,176,$888.00
2024-09-04,17:11:00,19060.0,BUY,3,0.02h,Stop Loss,$57.00,$945.00,$231854.75,176,$945.00
2024-09-04,17:15:00,19036.75,SELL,3,0.02h,Break Even,$0.75,$945.75,$231855.50,176,$945.75
2024-09-04,17:23:00,19058.75,BUY,3,0.02h,Stop Loss,$-18.00,$927.75,$231837.50,176,$927.75
2024-09-04,17:25:00,19037.5,SELL,3,0.02h,Stop Loss,$60.75,$988.50,$231898.25,176,$988.50
2024-09-04,18:15:00,19016.75,BUY,3,0.02h,Stop Loss,$90.75,$1079.25,$231989.00,176,$1079.25
2024-09-04,18:20:00,18991.0,SELL,3,0.02h,Stop Loss,$34.50,$1113.75,$232023.50,176,$1113.75
2024-09-04,18:27:00,19018.25,BUY,3,0.02h,Break Even,$0.75,$1114.50,$232024.25,176,$1114.50
2024-09-04,18:35:00,18991.25,SELL,3,0.02h,Stop Loss,$270.75,$1385.25,$232295.00,176,$1385.25
2024-09-04,19:24:00,18937.75,BUY,3,0.02h,Stop Loss,$177.00,$1562.25,$232472.00,176,$1562.25
2024-09-04,20:01:00,18960.75,SELL,3,0.02h,Stop Loss,$98.25,$1660.50,$232570.25,176,$1660.50
2024-09-04,20:30:00,18954.75,BUY,3,0.02h,Break Even,$0.75,$1661.25,$232571.00,176,$1661.25
2024-09-04,22:20:00,18962.75,SELL,3,0.02h,Stop Loss,$-18.00,$1643.25,$232553.00,176,$1643.25
2024-09-04,22:33:00,18971.75,BUY,3,0.02h,Stop Loss,$75.75,$1719.00,$232628.75,176,$1719.00
2024-09-04,22:59:00,18974.25,SELL,3,0.02h,Break Even,$0.75,$1719.75,$232629.50,176,$1719.75
,,,,,,,,,,,
2024-09-05,12:33:00,18911.5,BUY,3,0.02h,Stop Loss,$15.75,$15.75,$232645.25,177,$15.75
2024-09-05,12:41:00,18861.75,SELL,3,0.02h,Stop Loss,$90.75,$106.50,$232736.00,177,$106.50
2024-09-05,12:48:00,18889.75,BUY,3,0.02h,Stop Loss,$75.75,$182.25,$232811.75,177,$182.25
2024-09-05,13:26:00,18897.5,SELL,3,0.02h,Stop Loss,$42.00,$224.25,$232853.75,177,$224.25
2024-09-05,13:34:00,18932.25,BUY,3,0.02h,Stop Loss,$53.25,$277.50,$232907.00,177,$277.50
2024-09-05,14:17:00,19048.75,SELL,3,0.02h,Stop Loss,$57.00,$334.50,$232964.00,177,$334.50
2024-09-05,14:18:00,19058.25,BUY,3,0.02h,Stop Loss,$98.25,$432.75,$233062.25,177,$432.75
2024-09-05,14:45:00,19071.0,SELL,3,0.02h,Stop Loss,$518.25,$951.00,$233580.50,177,$951.00
2024-09-05,16:04:00,18907.25,BUY,3,0.02h,Stop Loss,$-18.00,$933.00,$233562.50,177,$933.00
2024-09-05,16:17:00,18879.75,SELL,3,0.02h,Stop Loss,$30.75,$963.75,$233593.25,177,$963.75
2024-09-05,16:21:00,18899.75,BUY,3,0.02h,Stop Loss,$42.00,$1005.75,$233635.25,177,$1005.75
2024-09-05,16:53:00,18932.0,SELL,3,0.02h,Stop Loss,$98.25,$1104.00,$233733.50,177,$1104.00
2024-09-05,16:58:00,18950.75,BUY,3,0.02h,Break Even,$0.75,$1104.75,$233734.25,177,$1104.75
2024-09-05,17:06:00,18930.5,SELL,3,0.02h,Stop Loss,$342.00,$1446.75,$234076.25,177,$1446.75
2024-09-05,17:38:00,18950.25,BUY,3,0.02h,Break Even,$0.75,$1447.50,$234077.00,177,$1447.50
2024-09-05,18:26:00,18993.25,SELL,3,0.02h,Break Even,$0.75,$1448.25,$234077.75,177,$1448.25
2024-09-05,18:38:00,19009.5,BUY,3,0.02h,Stop Loss,$-18.00,$1430.25,$234059.75,177,$1430.25
2024-09-05,18:43:00,18989.25,SELL,3,0.02h,Break Even,$0.75,$1431.00,$234060.50,177,$1431.00
2024-09-05,18:48:00,19012.0,BUY,3,0.02h,Break Even,$0.75,$1431.75,$234061.25,177,$1431.75
2024-09-05,18:59:00,18992.5,SELL,3,0.02h,Stop Loss,$19.50,$1451.25,$234080.75,177,$1451.25
2024-09-05,19:32:00,18971.5,BUY,3,0.02h,Stop Loss,$117.00,$1568.25,$234197.75,177,$1568.25
2024-09-05,19:42:00,18942.5,SELL,3,0.02h,Stop Loss,$139.50,$1707.75,$234337.25,177,$1707.75
2024-09-05,20:00:00,18975.75,BUY,3,0.02h,Stop Loss,$128.25,$1836.00,$234465.50,177,$1836.00
2024-09-05,20:17:00,18933.5,SELL,3,0.02h,Stop Loss,$259.50,$2095.50,$234725.00,177,$2095.50
2024-09-05,20:47:00,18931.0,BUY,3,0.02h,Stop Loss,$-18.00,$2077.50,$234707.00,177,$2077.50
2024-09-05,20:49:00,18926.5,SELL,3,0.02h,Stop Loss,$94.50,$2172.00,$234801.50,177,$2172.00
2024-09-05,22:02:00,18929.75,BUY,3,0.02h,Stop Loss,$-18.00,$2154.00,$234783.50,177,$2154.00
2024-09-05,22:11:00,18918.5,SELL,3,0.02h,Stop Loss,$45.75,$2199.75,$234829.25,177,$2199.75
2024-09-05,22:44:00,18915.5,BUY,3,0.02h,Stop Loss,$-18.00,$2181.75,$234811.25,177,$2181.75
2024-09-05,22:48:00,18910.75,SELL,3,0.02h,Stop Loss,$-18.00,$2163.75,$234793.25,177,$2163.75
2024-09-05,22:53:00,18921.0,BUY,3,0.02h,Stop Loss,$-18.00,$2145.75,$234775.25,177,$2145.75
,,,,,,,,,,,
2024-09-06,12:00:00,18782.75,SELL,3,0.02h,Break Even,$0.75,$0.75,$234776.00,178,$0.75
2024-09-06,12:31:00,18853.25,BUY,3,0.02h,Stop Loss,$27.00,$27.75,$234803.00,178,$27.75
2024-09-06,13:33:00,18891.75,SELL,3,0.02h,Stop Loss,$53.25,$81.00,$234856.25,178,$81.00
2024-09-06,15:03:00,18603.5,BUY,3,0.02h,Stop Loss,$158.25,$239.25,$235014.50,178,$239.25
2024-09-06,15:09:00,18536.0,SELL,3,0.02h,Stop Loss,$87.00,$326.25,$235101.50,178,$326.25
2024-09-06,15:34:00,18544.75,BUY,3,0.02h,Stop Loss,$-18.00,$308.25,$235083.50,178,$308.25
2024-09-06,15:36:00,18520.5,SELL,3,0.02h,Stop Loss,$199.50,$507.75,$235283.00,178,$507.75
2024-09-06,16:14:00,18477.5,BUY,3,0.02h,Stop Loss,$135.75,$643.50,$235418.75,178,$643.50
2024-09-06,16:15:00,18470.0,SELL,3,0.02h,Stop Loss,$117.00,$760.50,$235535.75,178,$760.50
2024-09-06,16:26:00,18484.5,BUY,3,0.02h,Break Even,$0.75,$761.25,$235536.50,178,$761.25
2024-09-06,16:29:00,18456.25,SELL,3,0.02h,Stop Loss,$79.50,$840.75,$235616.00,178,$840.75
2024-09-06,16:36:00,18484.25,BUY,3,0.02h,Stop Loss,$68.25,$909.00,$235684.25,178,$909.00
2024-09-06,16:41:00,18449.0,SELL,3,0.02h,Stop Loss,$23.25,$932.25,$235707.50,178,$932.25
2024-09-06,16:46:00,18472.5,BUY,3,0.02h,Break Even,$0.75,$933.00,$235708.25,178,$933.00
2024-09-06,16:47:00,18463.25,SELL,3,0.02h,Stop Loss,$45.75,$978.75,$235754.00,178,$978.75
2024-09-06,17:05:00,18470.25,BUY,3,0.02h,Break Even,$0.75,$979.50,$235754.75,178,$979.50
2024-09-06,17:33:00,18494.25,SELL,3,0.02h,Stop Loss,$147.00,$1126.50,$235901.75,178,$1126.50
2024-09-06,17:57:00,18490.75,BUY,3,0.02h,Stop Loss,$-18.00,$1108.50,$235883.75,178,$1108.50
2024-09-06,18:03:00,18457.25,SELL,3,0.02h,Stop Loss,$38.25,$1146.75,$235922.00,178,$1146.75
2024-09-06,18:42:00,18458.25,BUY,3,0.02h,Stop Loss,$79.50,$1226.25,$236001.50,178,$1226.25
2024-09-06,19:37:00,18495.5,SELL,3,0.02h,Stop Loss,$282.00,$1508.25,$236283.50,178,$1508.25
2024-09-06,19:50:00,18516.75,BUY,3,0.02h,Stop Loss,$180.75,$1689.00,$236464.25,178,$1689.00
2024-09-06,19:52:00,18477.5,SELL,3,0.02h,Stop Loss,$135.75,$1824.75,$236600.00,178,$1824.75
,,,,,,,,,,,
2024-09-09,12:00:00,18596.5,BUY,3,0.02h,Stop Loss,$64.50,$64.50,$236664.50,179,$64.50
2024-09-09,14:20:00,18651.75,SELL,3,0.02h,Stop Loss,$132.00,$196.50,$236796.50,179,$196.50
2024-09-09,15:27:00,18541.5,BUY,3,0.02h,Stop Loss,$27.00,$223.50,$236823.50,179,$223.50
2024-09-09,17:25:00,18709.0,SELL,3,0.02h,Break Even,$0.75,$224.25,$236824.25,179,$224.25
2024-09-09,18:47:00,18613.25,BUY,3,0.02h,Stop Loss,$12.00,$236.25,$236836.25,179,$236.25
2024-09-09,19:00:00,18603.75,SELL,3,0.02h,Stop Loss,$64.50,$300.75,$236900.75,179,$300.75
2024-09-09,19:11:00,18608.0,BUY,3,0.02h,Stop Loss,$23.25,$324.00,$236924.00,179,$324.00
2024-09-09,19:12:00,18600.0,SELL,3,0.02h,Break Even,$0.75,$324.75,$236924.75,179,$324.75
2024-09-09,19:13:00,18604.25,BUY,3,0.02h,Break Even,$0.75,$325.50,$236925.50,179,$325.50
2024-09-09,19:15:00,18596.5,SELL,3,0.02h,Stop Loss,$-18.00,$307.50,$236907.50,179,$307.50
2024-09-09,19:16:00,18606.25,BUY,3,0.02h,Stop Loss,$57.00,$364.50,$236964.50,179,$364.50
2024-09-09,19:21:00,18596.5,SELL,3,0.02h,Stop Loss,$139.50,$504.00,$237104.00,179,$504.00
2024-09-09,19:26:00,18608.25,BUY,3,0.02h,Stop Loss,$158.25,$662.25,$237262.25,179,$662.25
2024-09-09,20:49:00,18716.5,SELL,3,0.02h,Stop Loss,$-18.00,$644.25,$237244.25,179,$644.25
2024-09-09,22:01:00,18735.0,BUY,3,0.02h,Stop Loss,$-18.00,$626.25,$237226.25,179,$626.25
2024-09-09,22:12:00,18716.25,SELL,3,0.02h,Stop Loss,$60.75,$687.00,$237287.00,179,$687.00
2024-09-09,22:32:00,18724.5,BUY,3,0.02h,Stop Loss,$-18.00,$669.00,$237269.00,179,$669.00
2024-09-09,22:44:00,18712.0,SELL,3,0.02h,Stop Loss,$27.00,$696.00,$237296.00,179,$696.00
,,,,,,,,,,,
2024-09-10,12:10:00,18715.0,BUY,3,0.02h,Stop Loss,$23.25,$23.25,$237319.25,180,$23.25
2024-09-10,13:17:00,18756.0,SELL,3,0.02h,Break Even,$0.75,$24.00,$237320.00,180,$24.00
2024-09-10,13:19:00,18760.0,BUY,3,0.02h,Stop Loss,$45.75,$69.75,$237365.75,180,$69.75
2024-09-10,13:38:00,18747.0,SELL,3,0.02h,Stop Loss,$173.25,$243.00,$237539.00,180,$243.00
2024-09-10,13:54:00,18772.75,BUY,3,0.02h,Stop Loss,$120.75,$363.75,$237659.75,180,$363.75
2024-09-10,14:13:00,18739.5,SELL,3,0.02h,Stop Loss,$469.50,$833.25,$238129.25,180,$833.25
2024-09-10,14:30:00,18780.75,BUY,3,0.02h,Stop Loss,$30.75,$864.00,$238160.00,180,$864.00
2024-09-10,14:44:00,18734.0,SELL,3,0.02h,Stop Loss,$229.50,$1093.50,$238389.50,180,$1093.50
2024-09-10,15:10:00,18732.25,BUY,3,0.02h,Stop Loss,$233.25,$1326.75,$238622.75,180,$1326.75
2024-09-10,15:40:00,18742.0,SELL,3,0.02h,Stop Loss,$27.00,$1353.75,$238649.75,180,$1353.75
2024-09-10,16:25:00,18647.0,BUY,3,0.02h,Stop Loss,$72.00,$1425.75,$238721.75,180,$1425.75
2024-09-10,18:53:00,18820.75,SELL,3,0.02h,Stop Loss,$-18.00,$1407.75,$238703.75,180,$1407.75
2024-09-10,19:10:00,18833.0,BUY,3,0.02h,Stop Loss,$124.50,$1532.25,$238828.25,180,$1532.25
2024-09-10,19:45:00,18848.0,SELL,3,0.02h,Break Even,$0.75,$1533.00,$238829.00,180,$1533.00
2024-09-10,19:48:00,18858.25,BUY,3,0.02h,Stop Loss,$-18.00,$1515.00,$238811.00,180,$1515.00
2024-09-10,19:51:00,18840.25,SELL,3,0.02h,Stop Loss,$-18.00,$1497.00,$238793.00,180,$1497.00
2024-09-10,19:56:00,18855.75,BUY,3,0.02h,Stop Loss,$42.00,$1539.00,$238835.00,180,$1539.00
2024-09-10,20:03:00,18846.25,SELL,3,0.02h,Break Even,$0.75,$1539.75,$238835.75,180,$1539.75
2024-09-10,20:55:00,18831.25,BUY,3,0.02h,Stop Loss,$-18.00,$1521.75,$238817.75,180,$1521.75
2024-09-10,22:13:00,18828.0,SELL,3,0.02h,Break Even,$0.75,$1522.50,$238818.50,180,$1522.50
2024-09-10,22:16:00,18834.25,BUY,3,0.02h,Stop Loss,$-18.00,$1504.50,$238800.50,180,$1504.50
2024-09-10,22:31:00,18828.75,SELL,3,0.02h,Stop Loss,$-18.00,$1486.50,$238782.50,180,$1486.50
2024-09-10,22:41:00,18834.0,BUY,3,0.02h,Stop Loss,$68.25,$1554.75,$238850.75,180,$1554.75
,,,,,,,,,,,
2024-09-11,12:01:00,18828.5,SELL,3,0.02h,Stop Loss,$30.75,$30.75,$238881.50,181,$30.75
2024-09-11,12:14:00,18839.0,BUY,3,0.02h,Stop Loss,$-18.00,$12.75,$238863.50,181,$12.75
2024-09-11,12:31:00,18754.25,SELL,3,0.02h,Stop Loss,$304.50,$317.25,$239168.00,181,$317.25
2024-09-11,12:50:00,18822.5,BUY,3,0.02h,Stop Loss,$79.50,$396.75,$239247.50,181,$396.75
2024-09-11,13:32:00,18891.0,SELL,3,0.02h,Stop Loss,$248.25,$645.00,$239495.75,181,$645.00
2024-09-11,15:05:00,18607.25,BUY,3,0.02h,Stop Loss,$567.00,$1212.00,$240062.75,181,$1212.00
2024-09-11,16:48:00,18885.25,SELL,3,0.02h,Stop Loss,$72.00,$1284.00,$240134.75,181,$1284.00
2024-09-11,16:55:00,18916.0,BUY,3,0.02h,Stop Loss,$-18.00,$1266.00,$240116.75,181,$1266.00
2024-09-11,18:55:00,19107.25,SELL,3,0.02h,Break Even,$0.75,$1266.75,$240117.50,181,$1266.75
2024-09-11,18:56:00,19134.75,BUY,3,0.02h,Stop Loss,$45.75,$1312.50,$240163.25,181,$1312.50
2024-09-11,19:00:00,19127.75,SELL,3,0.02h,Stop Loss,$207.00,$1519.50,$240370.25,181,$1519.50
2024-09-11,19:08:00,19138.5,BUY,3,0.02h,Stop Loss,$105.75,$1625.25,$240476.00,181,$1625.25
2024-09-11,20:47:00,19246.25,SELL,3,0.02h,Break Even,$0.75,$1626.00,$240476.75,181,$1626.00
2024-09-11,20:48:00,19249.0,BUY,3,0.02h,Stop Loss,$-18.00,$1608.00,$240458.75,181,$1608.00
2024-09-11,20:50:00,19246.25,SELL,3,0.02h,Break Even,$0.75,$1608.75,$240459.50,181,$1608.75
2024-09-11,20:52:00,19249.5,BUY,3,0.02h,Stop Loss,$-18.00,$1590.75,$240441.50,181,$1590.75
2024-09-11,20:57:00,19242.75,SELL,3,0.02h,Stop Loss,$-18.00,$1572.75,$240423.50,181,$1572.75
2024-09-11,22:21:00,19245.25,BUY,3,0.02h,Break Even,$0.75,$1573.50,$240424.25,181,$1573.50
,,,,,,,,,,,
2024-09-12,12:35:00,19269.25,SELL,3,0.02h,Stop Loss,$12.00,$12.00,$240436.25,182,$12.00
2024-09-12,12:55:00,19501.5,BUY,3,0.02h,Break Even,$0.75,$12.75,$240437.00,182,$12.75
2024-09-12,12:58:00,19267.5,SELL,3,0.02h,Stop Loss,$-18.00,$-5.25,$240419.00,182,$-5.25
2024-09-12,12:59:00,19495.75,BUY,3,0.02h,Stop Loss,$-18.00,$-23.25,$240401.00,182,$-23.25
2024-09-12,13:01:00,19256.25,SELL,3,0.02h,Stop Loss,$-18.00,$-41.25,$240383.00,182,$-41.25
2024-09-12,13:02:00,19498.0,BUY,3,0.02h,Stop Loss,$-18.00,$-59.25,$240365.00,182,$-59.25
2024-09-12,13:03:00,19267.75,SELL,3,0.02h,Stop Loss,$-18.00,$-77.25,$240347.00,182,$-77.25
2024-09-12,13:04:00,19498.25,BUY,3,0.02h,Stop Loss,$87.00,$9.75,$240434.00,182,$9.75
2024-09-12,13:09:00,19273.0,SELL,3,0.02h,Stop Loss,$-18.00,$-8.25,$240416.00,182,$-8.25
2024-09-12,13:10:00,19512.0,BUY,3,0.02h,Stop Loss,$23.25,$15.00,$240439.25,182,$15.00
2024-09-12,13:21:00,19261.5,SELL,3,0.02h,Stop Loss,$-18.00,$-3.00,$240421.25,182,$-3.00
2024-09-12,13:22:00,19495.75,BUY,3,0.02h,Stop Loss,$-18.00,$-21.00,$240403.25,182,$-21.00
2024-09-12,13:23:00,19261.5,SELL,3,0.02h,Stop Loss,$-18.00,$-39.00,$240385.25,182,$-39.00
2024-09-12,13:26:00,19499.5,BUY,3,0.02h,Stop Loss,$60.75,$21.75,$240446.00,182,$21.75
2024-09-12,13:30:00,19259.0,SELL,3,0.02h,Stop Loss,$368.25,$390.00,$240814.25,182,$390.00
2024-09-12,13:42:00,19495.0,BUY,3,0.02h,Stop Loss,$304.50,$694.50,$241118.75,182,$694.50
2024-09-12,13:47:00,19247.0,SELL,3,0.02h,Stop Loss,$390.75,$1085.25,$241509.50,182,$1085.25
2024-09-12,13:52:00,19441.25,BUY,3,0.02h,Stop Loss,$-18.00,$1067.25,$241491.50,182,$1067.25
2024-09-12,13:53:00,19232.0,SELL,3,0.02h,Stop Loss,$-18.00,$1049.25,$241473.50,182,$1049.25
2024-09-12,13:55:00,19494.25,BUY,3,0.02h,Stop Loss,$-18.00,$1031.25,$241455.50,182,$1031.25
2024-09-12,13:56:00,19240.75,SELL,3,0.02h,Stop Loss,$49.50,$1080.75,$241505.00,182,$1080.75
2024-09-12,14:01:00,19490.0,BUY,3,0.02h,Stop Loss,$147.00,$1227.75,$241652.00,182,$1227.75
2024-09-12,14:05:00,19241.0,SELL,3,0.02h,Stop Loss,$117.00,$1344.75,$241769.00,182,$1344.75
2024-09-12,14:14:00,19548.0,BUY,3,0.02h,Stop Loss,$57.00,$1401.75,$241826.00,182,$1401.75
2024-09-12,14:25:00,19323.75,SELL,3,0.02h,Stop Loss,$-18.00,$1383.75,$241808.00,182,$1383.75
2024-09-12,14:26:00,19561.25,BUY,3,0.02h,Stop Loss,$-18.00,$1365.75,$241790.00,182,$1365.75
2024-09-12,14:28:00,19331.25,SELL,3,0.02h,Stop Loss,$-18.00,$1347.75,$241772.00,182,$1347.75
2024-09-12,14:29:00,19574.5,BUY,3,0.02h,Break Even,$0.75,$1348.50,$241772.75,182,$1348.50
2024-09-12,14:38:00,19301.5,SELL,3,0.02h,Stop Loss,$109.50,$1458.00,$241882.25,182,$1458.00
2024-09-12,14:51:00,19543.0,BUY,3,0.02h,Stop Loss,$60.75,$1518.75,$241943.00,182,$1518.75
2024-09-12,14:54:00,19312.5,SELL,3,0.02h,Stop Loss,$-18.00,$1500.75,$241925.00,182,$1500.75
2024-09-12,14:56:00,19582.25,BUY,3,0.02h,Stop Loss,$-18.00,$1482.75,$241907.00,182,$1482.75
2024-09-12,14:57:00,19334.5,SELL,3,0.02h,Stop Loss,$-18.00,$1464.75,$241889.00,182,$1464.75
2024-09-12,14:58:00,19546.25,BUY,3,0.02h,Stop Loss,$15.75,$1480.50,$241904.75,182,$1480.50
2024-09-12,15:01:00,19266.25,SELL,3,0.02h,Break Even,$0.75,$1481.25,$241905.50,182,$1481.25
2024-09-12,15:06:00,19563.5,BUY,3,0.02h,Break Even,$0.75,$1482.00,$241906.25,182,$1482.00
2024-09-12,15:15:00,19375.25,SELL,3,0.02h,Stop Loss,$754.50,$2236.50,$242660.75,182,$2236.50
2024-09-12,15:20:00,19570.25,BUY,3,0.02h,Break Even,$0.75,$2237.25,$242661.50,182,$2237.25
2024-09-12,15:23:00,19317.5,SELL,3,0.02h,Stop Loss,$184.50,$2421.75,$242846.00,182,$2421.75
2024-09-12,15:27:00,19529.5,BUY,3,0.02h,Stop Loss,$-18.00,$2403.75,$242828.00,182,$2403.75
2024-09-12,15:28:00,19309.25,SELL,3,0.02h,Stop Loss,$-18.00,$2385.75,$242810.00,182,$2385.75
2024-09-12,15:29:00,19536.25,BUY,3,0.02h,Stop Loss,$-18.00,$2367.75,$242792.00,182,$2367.75
2024-09-12,15:30:00,19288.25,SELL,3,0.02h,Stop Loss,$-18.00,$2349.75,$242774.00,182,$2349.75
2024-09-12,15:31:00,19523.25,BUY,3,0.02h,Stop Loss,$199.50,$2549.25,$242973.50,182,$2549.25
2024-09-12,15:33:00,19299.75,SELL,3,0.02h,Stop Loss,$-18.00,$2531.25,$242955.50,182,$2531.25
2024-09-12,15:34:00,19528.0,BUY,3,0.02h,Stop Loss,$-18.00,$2513.25,$242937.50,182,$2513.25
2024-09-12,15:35:00,19282.5,SELL,3,0.02h,Break Even,$0.75,$2514.00,$242938.25,182,$2514.00
2024-09-12,15:38:00,19535.75,BUY,3,0.02h,Stop Loss,$-18.00,$2496.00,$242920.25,182,$2496.00
2024-09-12,15:46:00,19268.0,SELL,3,0.02h,Stop Loss,$-18.00,$2478.00,$242902.25,182,$2478.00
2024-09-12,15:48:00,19499.25,BUY,3,0.02h,Break Even,$0.75,$2478.75,$242903.00,182,$2478.75
2024-09-12,15:57:00,19272.25,SELL,3,0.02h,Stop Loss,$-18.00,$2460.75,$242885.00,182,$2460.75
2024-09-12,15:59:00,19494.5,BUY,3,0.02h,Stop Loss,$-18.00,$2442.75,$242867.00,182,$2442.75
2024-09-12,16:00:00,19265.5,SELL,3,0.02h,Stop Loss,$68.25,$2511.00,$242935.25,182,$2511.00
2024-09-12,16:06:00,19521.25,BUY,3,0.02h,Stop Loss,$-18.00,$2493.00,$242917.25,182,$2493.00
2024-09-12,16:07:00,19298.25,SELL,3,0.02h,Stop Loss,$-18.00,$2475.00,$242899.25,182,$2475.00
2024-09-12,16:15:00,19539.0,BUY,3,0.02h,Stop Loss,$15.75,$2490.75,$242915.00,182,$2490.75
2024-09-12,16:18:00,19301.25,SELL,3,0.02h,Break Even,$0.75,$2491.50,$242915.75,182,$2491.50
2024-09-12,16:24:00,19530.5,BUY,3,0.02h,Stop Loss,$-18.00,$2473.50,$242897.75,182,$2473.50
2024-09-12,16:25:00,19303.0,SELL,3,0.02h,Stop Loss,$-18.00,$2455.50,$242879.75,182,$2455.50
2024-09-12,16:27:00,19553.75,BUY,3,0.02h,Stop Loss,$-18.00,$2437.50,$242861.75,182,$2437.50
2024-09-12,16:28:00,19307.0,SELL,3,0.02h,Break Even,$0.75,$2438.25,$242862.50,182,$2438.25
2024-09-12,16:34:00,19550.25,BUY,3,0.02h,Stop Loss,$-18.00,$2420.25,$242844.50,182,$2420.25
2024-09-12,16:55:00,19357.5,SELL,3,0.02h,Stop Loss,$87.00,$2507.25,$242931.50,182,$2507.25
2024-09-12,16:58:00,19613.25,BUY,3,0.02h,Stop Loss,$-18.00,$2489.25,$242913.50,182,$2489.25
2024-09-12,16:59:00,19381.25,SELL,3,0.02h,Stop Loss,$-18.00,$2471.25,$242895.50,182,$2471.25
2024-09-12,17:00:00,19615.5,BUY,3,0.02h,Stop Loss,$135.75,$2607.00,$243031.25,182,$2607.00
2024-09-12,17:11:00,19389.5,SELL,3,0.02h,Stop Loss,$-18.00,$2589.00,$243013.25,182,$2589.00
2024-09-12,17:12:00,19617.0,BUY,3,0.02h,Stop Loss,$-18.00,$2571.00,$242995.25,182,$2571.00
2024-09-12,17:13:00,19388.75,SELL,3,0.02h,Stop Loss,$-18.00,$2553.00,$242977.25,182,$2553.00
2024-09-12,17:18:00,19635.25,BUY,3,0.02h,Break Even,$0.75,$2553.75,$242978.00,182,$2553.75
2024-09-12,17:29:00,19413.25,SELL,3,0.02h,Stop Loss,$-18.00,$2535.75,$242960.00,182,$2535.75
2024-09-12,17:30:00,19639.25,BUY,3,0.02h,Stop Loss,$19.50,$2555.25,$242979.50,182,$2555.25
2024-09-12,17:34:00,19404.75,SELL,3,0.02h,Stop Loss,$-18.00,$2537.25,$242961.50,182,$2537.25
2024-09-12,17:35:00,19644.75,BUY,3,0.02h,Stop Loss,$-18.00,$2519.25,$242943.50,182,$2519.25
2024-09-12,17:36:00,19410.5,SELL,3,0.02h,Stop Loss,$-18.00,$2501.25,$242925.50,182,$2501.25
2024-09-12,17:39:00,19662.75,BUY,3,0.02h,Stop Loss,$42.00,$2543.25,$242967.50,182,$2543.25
2024-09-12,17:43:00,19424.5,SELL,3,0.02h,Stop Loss,$83.25,$2626.50,$243050.75,182,$2626.50
2024-09-12,17:55:00,19691.75,BUY,3,0.02h,Stop Loss,$113.25,$2739.75,$243164.00,182,$2739.75
2024-09-12,18:06:00,19463.75,SELL,3,0.02h,Stop Loss,$38.25,$2778.00,$243202.25,182,$2778.00
2024-09-12,18:08:00,19696.0,BUY,3,0.02h,Stop Loss,$-18.00,$2760.00,$243184.25,182,$2760.00
2024-09-12,18:10:00,19454.25,SELL,3,0.02h,Stop Loss,$184.50,$2944.50,$243368.75,182,$2944.50
2024-09-12,18:14:00,19682.25,BUY,3,0.02h,Stop Loss,$-18.00,$2926.50,$243350.75,182,$2926.50
2024-09-12,18:16:00,19445.0,SELL,3,0.02h,Stop Loss,$-18.00,$2908.50,$243332.75,182,$2908.50
2024-09-12,18:17:00,19679.5,BUY,3,0.02h,Stop Loss,$-18.00,$2890.50,$243314.75,182,$2890.50
2024-09-12,18:18:00,19447.25,SELL,3,0.02h,Break Even,$0.75,$2891.25,$243315.50,182,$2891.25
2024-09-12,18:24:00,19689.5,BUY,3,0.02h,Stop Loss,$-18.00,$2873.25,$243297.50,182,$2873.25
2024-09-12,18:25:00,19470.25,SELL,3,0.02h,Break Even,$0.75,$2874.00,$243298.25,182,$2874.00
2024-09-12,18:28:00,19706.5,BUY,3,0.02h,Stop Loss,$-18.00,$2856.00,$243280.25,182,$2856.00
2024-09-12,18:29:00,19474.75,SELL,3,0.02h,Stop Loss,$-18.00,$2838.00,$243262.25,182,$2838.00
2024-09-12,18:30:00,19705.75,BUY,3,0.02h,Stop Loss,$109.50,$2947.50,$243371.75,182,$2947.50
2024-09-12,18:33:00,19453.0,SELL,3,0.02h,Stop Loss,$-18.00,$2929.50,$243353.75,182,$2929.50
2024-09-12,18:35:00,19700.75,BUY,3,0.02h,Stop Loss,$64.50,$2994.00,$243418.25,182,$2994.00
2024-09-12,18:46:00,19464.5,SELL,3,0.02h,Stop Loss,$-18.00,$2976.00,$243400.25,182,$2976.00
2024-09-12,18:47:00,19701.5,BUY,3,0.02h,Stop Loss,$-18.00,$2958.00,$243382.25,182,$2958.00
2024-09-12,18:48:00,19474.25,SELL,3,0.02h,Stop Loss,$192.00,$3150.00,$243574.25,182,$3150.00
2024-09-12,19:04:00,19677.0,BUY,3,0.02h,Stop Loss,$-18.00,$3132.00,$243556.25,182,$3132.00
2024-09-12,19:05:00,19439.75,SELL,3,0.02h,Stop Loss,$-18.00,$3114.00,$243538.25,182,$3114.00
2024-09-12,19:10:00,19692.25,BUY,3,0.02h,Stop Loss,$-18.00,$3096.00,$243520.25,182,$3096.00
2024-09-12,19:11:00,19460.25,SELL,3,0.02h,Stop Loss,$-18.00,$3078.00,$243502.25,182,$3078.00
2024-09-12,19:12:00,19684.75,BUY,3,0.02h,Stop Loss,$45.75,$3123.75,$243548.00,182,$3123.75
2024-09-12,19:21:00,19452.75,SELL,3,0.02h,Stop Loss,$162.00,$3285.75,$243710.00,182,$3285.75
2024-09-12,19:25:00,19684.75,BUY,3,0.02h,Stop Loss,$38.25,$3324.00,$243748.25,182,$3324.00
2024-09-12,19:35:00,19445.0,SELL,3,0.02h,Break Even,$0.75,$3324.75,$243749.00,182,$3324.75
2024-09-12,19:45:00,19690.0,BUY,3,0.02h,Break Even,$0.75,$3325.50,$243749.75,182,$3325.50
2024-09-12,19:47:00,19443.5,SELL,3,0.02h,Stop Loss,$-18.00,$3307.50,$243731.75,182,$3307.50
2024-09-12,19:48:00,19670.5,BUY,3,0.02h,Stop Loss,$12.00,$3319.50,$243743.75,182,$3319.50
2024-09-12,19:52:00,19437.25,SELL,3,0.02h,Stop Loss,$-18.00,$3301.50,$243725.75,182,$3301.50
2024-09-12,19:53:00,19665.0,BUY,3,0.02h,Stop Loss,$30.75,$3332.25,$243756.50,182,$3332.25
2024-09-12,19:56:00,19431.25,SELL,3,0.02h,Stop Loss,$-18.00,$3314.25,$243738.50,182,$3314.25
2024-09-12,19:57:00,19669.75,BUY,3,0.02h,Stop Loss,$-18.00,$3296.25,$243720.50,182,$3296.25
2024-09-12,19:58:00,19431.0,SELL,3,0.02h,Break Even,$0.75,$3297.00,$243721.25,182,$3297.00
2024-09-12,20:01:00,19683.0,BUY,3,0.02h,Stop Loss,$75.75,$3372.75,$243797.00,182,$3372.75
2024-09-12,20:04:00,19447.75,SELL,3,0.02h,Stop Loss,$-18.00,$3354.75,$243779.00,182,$3354.75
2024-09-12,20:05:00,19683.0,BUY,3,0.02h,Stop Loss,$-18.00,$3336.75,$243761.00,182,$3336.75
2024-09-12,20:07:00,19419.5,SELL,3,0.02h,Stop Loss,$222.00,$3558.75,$243983.00,182,$3558.75
2024-09-12,20:14:00,19653.25,BUY,3,0.03h,Break Even,$0.75,$3559.50,$243983.75,182,$3559.50
2024-09-12,20:23:00,19429.5,SELL,3,0.02h,Stop Loss,$-18.00,$3541.50,$243965.75,182,$3541.50
2024-09-12,20:25:00,19662.25,BUY,3,0.02h,Stop Loss,$-18.00,$3523.50,$243947.75,182,$3523.50
2024-09-12,20:26:00,19429.0,SELL,3,0.02h,Break Even,$0.75,$3524.25,$243948.50,182,$3524.25
2024-09-12,20:32:00,19663.5,BUY,3,0.02h,Stop Loss,$42.00,$3566.25,$243990.50,182,$3566.25
2024-09-12,20:37:00,19423.0,SELL,3,0.02h,Stop Loss,$-18.00,$3548.25,$243972.50,182,$3548.25
2024-09-12,20:38:00,19660.5,BUY,3,0.02h,Stop Loss,$-18.00,$3530.25,$243954.50,182,$3530.25
2024-09-12,20:39:00,19422.25,SELL,3,0.02h,Stop Loss,$-18.00,$3512.25,$243936.50,182,$3512.25
2024-09-12,20:41:00,19659.0,BUY,3,0.02h,Stop Loss,$-18.00,$3494.25,$243918.50,182,$3494.25
2024-09-12,20:42:00,19428.0,SELL,3,0.02h,Break Even,$0.75,$3495.00,$243919.25,182,$3495.00
2024-09-12,20:53:00,19652.5,BUY,3,0.02h,Stop Loss,$-18.00,$3477.00,$243901.25,182,$3477.00
2024-09-12,20:54:00,19417.5,SELL,3,0.02h,Stop Loss,$-18.00,$3459.00,$243883.25,182,$3459.00
2024-09-12,20:55:00,19651.0,BUY,3,0.02h,Stop Loss,$-18.00,$3441.00,$243865.25,182,$3441.00
2024-09-12,20:56:00,19417.75,SELL,3,0.02h,Stop Loss,$-18.00,$3423.00,$243847.25,182,$3423.00
2024-09-12,20:58:00,19653.5,BUY,3,0.02h,Stop Loss,$-18.00,$3405.00,$243829.25,182,$3405.00
2024-09-12,20:59:00,19412.5,SELL,3,0.02h,Stop Loss,$-18.00,$3387.00,$243811.25,182,$3387.00
2024-09-12,21:00:00,19647.25,BUY,3,1.02h,Stop Loss,$68.25,$3455.25,$243879.50,182,$3455.25
2024-09-12,22:07:00,19423.0,SELL,3,0.02h,Break Even,$0.75,$3456.00,$243880.25,182,$3456.00
2024-09-12,22:11:00,19660.0,BUY,3,0.03h,Stop Loss,$57.00,$3513.00,$243937.25,182,$3513.00
2024-09-12,22:22:00,19431.75,SELL,3,0.02h,Stop Loss,$-18.00,$3495.00,$243919.25,182,$3495.00
2024-09-12,22:25:00,19665.0,BUY,3,0.02h,Break Even,$0.75,$3495.75,$243920.00,182,$3495.75
2024-09-12,22:29:00,19437.5,SELL,3,0.02h,Break Even,$0.75,$3496.50,$243920.75,182,$3496.50
2024-09-12,22:40:00,19671.5,BUY,3,0.02h,Stop Loss,$-18.00,$3478.50,$243902.75,182,$3478.50
2024-09-12,22:41:00,19437.75,SELL,3,0.02h,Stop Loss,$-18.00,$3460.50,$243884.75,182,$3460.50
2024-09-12,22:42:00,19673.25,BUY,3,0.02h,Stop Loss,$-18.00,$3442.50,$243866.75,182,$3442.50
2024-09-12,22:43:00,19437.0,SELL,3,0.02h,Stop Loss,$-18.00,$3424.50,$243848.75,182,$3424.50
2024-09-12,22:44:00,19673.0,BUY,3,0.02h,Break Even,$0.75,$3425.25,$243849.50,182,$3425.25
2024-09-12,22:47:00,19444.5,SELL,3,0.02h,Break Even,$0.75,$3426.00,$243850.25,182,$3426.00
2024-09-12,23:00:00,19677.0,BUY,3,13.00h,Stop Loss,$-18.00,$3408.00,$243832.25,182,$3408.00
,,,,,,,,,,,
2024-09-13,12:00:00,19453.75,SELL,3,0.02h,Stop Loss,$12.00,$12.00,$243844.25,183,$12.00
2024-09-13,12:02:00,19696.0,BUY,3,0.02h,Stop Loss,$-18.00,$-6.00,$243826.25,183,$-6.00
2024-09-13,12:04:00,19462.0,SELL,3,0.02h,Stop Loss,$-18.00,$-24.00,$243808.25,183,$-24.00
2024-09-13,12:05:00,19701.0,BUY,3,0.02h,Stop Loss,$-18.00,$-42.00,$243790.25,183,$-42.00
2024-09-13,12:22:00,19462.75,SELL,3,0.02h,Stop Loss,$-18.00,$-60.00,$243772.25,183,$-60.00
2024-09-13,12:23:00,19696.25,BUY,3,0.02h,Stop Loss,$-18.00,$-78.00,$243754.25,183,$-78.00
2024-09-13,12:24:00,19458.25,SELL,3,0.02h,Stop Loss,$-18.00,$-96.00,$243736.25,183,$-96.00
2024-09-13,12:30:00,19688.75,BUY,3,0.02h,Stop Loss,$-18.00,$-114.00,$243718.25,183,$-114.00
2024-09-13,12:31:00,19448.25,SELL,3,0.02h,Break Even,$0.75,$-113.25,$243719.00,183,$-113.25
2024-09-13,12:33:00,19688.0,BUY,3,0.02h,Stop Loss,$34.50,$-78.75,$243753.50,183,$-78.75
2024-09-13,12:35:00,19448.75,SELL,3,0.02h,Stop Loss,$-18.00,$-96.75,$243735.50,183,$-96.75
2024-09-13,12:36:00,19686.0,BUY,3,0.02h,Break Even,$0.75,$-96.00,$243736.25,183,$-96.00
2024-09-13,12:42:00,19421.5,SELL,3,0.02h,Stop Loss,$87.00,$-9.00,$243823.25,183,$-9.00
2024-09-13,12:45:00,19669.0,BUY,3,0.02h,Stop Loss,$53.25,$44.25,$243876.50,183,$44.25
2024-09-13,12:50:00,19442.75,SELL,3,0.02h,Stop Loss,$-18.00,$26.25,$243858.50,183,$26.25
2024-09-13,13:01:00,19685.75,BUY,3,0.02h,Stop Loss,$-18.00,$8.25,$243840.50,183,$8.25
2024-09-13,13:02:00,19446.75,SELL,3,0.02h,Stop Loss,$-18.00,$-9.75,$243822.50,183,$-9.75
2024-09-13,13:03:00,19680.5,BUY,3,0.02h,Break Even,$0.75,$-9.00,$243823.25,183,$-9.00
2024-09-13,13:17:00,19430.0,SELL,3,0.02h,Stop Loss,$-18.00,$-27.00,$243805.25,183,$-27.00
2024-09-13,13:28:00,19671.5,BUY,3,0.02h,Stop Loss,$-18.00,$-45.00,$243787.25,183,$-45.00
2024-09-13,13:33:00,19420.75,SELL,3,0.02h,Stop Loss,$-18.00,$-63.00,$243769.25,183,$-63.00
2024-09-13,13:34:00,19673.25,BUY,3,0.02h,Stop Loss,$-18.00,$-81.00,$243751.25,183,$-81.00
2024-09-13,13:35:00,19446.5,SELL,3,0.02h,Stop Loss,$-18.00,$-99.00,$243733.25,183,$-99.00
2024-09-13,13:36:00,19683.5,BUY,3,0.02h,Stop Loss,$210.75,$111.75,$243944.00,183,$111.75
2024-09-13,13:40:00,19470.75,SELL,3,0.02h,Stop Loss,$34.50,$146.25,$243978.50,183,$146.25
2024-09-13,13:42:00,19711.75,BUY,3,0.02h,Stop Loss,$128.25,$274.50,$244106.75,183,$274.50
2024-09-13,13:46:00,19477.5,SELL,3,0.02h,Stop Loss,$214.50,$489.00,$244321.25,183,$489.00
2024-09-13,13:49:00,19725.0,BUY,3,0.02h,Stop Loss,$-18.00,$471.00,$244303.25,183,$471.00
2024-09-13,13:50:00,19474.5,SELL,3,0.02h,Stop Loss,$105.75,$576.75,$244409.00,183,$576.75
2024-09-13,13:52:00,19720.75,BUY,3,0.02h,Stop Loss,$34.50,$611.25,$244443.50,183,$611.25
2024-09-13,13:55:00,19479.0,SELL,3,0.02h,Stop Loss,$-18.00,$593.25,$244425.50,183,$593.25
2024-09-13,13:56:00,19708.5,BUY,3,0.02h,Stop Loss,$-18.00,$575.25,$244407.50,183,$575.25
2024-09-13,13:57:00,19477.25,SELL,3,0.02h,Stop Loss,$-18.00,$557.25,$244389.50,183,$557.25
2024-09-13,13:58:00,19704.75,BUY,3,0.02h,Stop Loss,$83.25,$640.50,$244472.75,183,$640.50
2024-09-13,14:01:00,19459.5,SELL,3,0.02h,Stop Loss,$34.50,$675.00,$244507.25,183,$675.00
2024-09-13,14:04:00,19703.0,BUY,3,0.02h,Stop Loss,$-18.00,$657.00,$244489.25,183,$657.00
2024-09-13,14:05:00,19482.25,SELL,3,0.02h,Stop Loss,$-18.00,$639.00,$244471.25,183,$639.00
2024-09-13,14:06:00,19711.0,BUY,3,0.02h,Stop Loss,$349.50,$988.50,$244820.75,183,$988.50
2024-09-13,14:09:00,19502.5,SELL,3,0.02h,Break Even,$0.75,$989.25,$244821.50,183,$989.25
2024-09-13,14:13:00,19742.5,BUY,3,0.02h,Stop Loss,$-18.00,$971.25,$244803.50,183,$971.25
2024-09-13,14:14:00,19484.75,SELL,3,0.02h,Stop Loss,$105.75,$1077.00,$244909.25,183,$1077.00
2024-09-13,14:16:00,19738.0,BUY,3,0.02h,Stop Loss,$-18.00,$1059.00,$244891.25,183,$1059.00
2024-09-13,14:17:00,19506.0,SELL,3,0.02h,Break Even,$0.75,$1059.75,$244892.00,183,$1059.75
2024-09-13,14:21:00,19740.25,BUY,3,0.02h,Break Even,$0.75,$1060.50,$244892.75,183,$1060.50
2024-09-13,14:27:00,19494.25,SELL,3,0.02h,Stop Loss,$248.25,$1308.75,$245141.00,183,$1308.75
2024-09-13,14:38:00,19698.25,BUY,3,0.02h,Stop Loss,$57.00,$1365.75,$245198.00,183,$1365.75
2024-09-13,14:52:00,19502.25,SELL,3,0.02h,Stop Loss,$188.25,$1554.00,$245386.25,183,$1554.00
2024-09-13,14:55:00,19744.75,BUY,3,0.02h,Stop Loss,$-18.00,$1536.00,$245368.25,183,$1536.00
2024-09-13,14:56:00,19514.75,SELL,3,0.02h,Stop Loss,$-18.00,$1518.00,$245350.25,183,$1518.00
2024-09-13,15:00:00,19749.25,BUY,3,0.02h,Stop Loss,$30.75,$1548.75,$245381.00,183,$1548.75
2024-09-13,15:11:00,19518.25,SELL,3,0.02h,Stop Loss,$23.25,$1572.00,$245404.25,183,$1572.00
2024-09-13,15:13:00,19764.75,BUY,3,0.02h,Stop Loss,$64.50,$1636.50,$245468.75,183,$1636.50
2024-09-13,15:23:00,19536.25,SELL,3,0.02h,Stop Loss,$-18.00,$1618.50,$245450.75,183,$1618.50
2024-09-13,15:33:00,19761.5,BUY,3,0.02h,Stop Loss,$-18.00,$1600.50,$245432.75,183,$1600.50
2024-09-13,15:34:00,19522.0,SELL,3,0.02h,Stop Loss,$34.50,$1635.00,$245467.25,183,$1635.00
2024-09-13,15:40:00,19745.5,BUY,3,0.02h,Stop Loss,$-18.00,$1617.00,$245449.25,183,$1617.00
2024-09-13,15:41:00,19526.0,SELL,3,0.02h,Stop Loss,$68.25,$1685.25,$245517.50,183,$1685.25
2024-09-13,15:43:00,19762.25,BUY,3,0.02h,Break Even,$0.75,$1686.00,$245518.25,183,$1686.00
2024-09-13,15:50:00,19531.25,SELL,3,0.02h,Stop Loss,$83.25,$1769.25,$245601.50,183,$1769.25
2024-09-13,15:52:00,19765.5,BUY,3,0.02h,Stop Loss,$34.50,$1803.75,$245636.00,183,$1803.75
2024-09-13,15:58:00,19538.5,SELL,3,0.02h,Stop Loss,$68.25,$1872.00,$245704.25,183,$1872.00
2024-09-13,16:04:00,19782.75,BUY,3,0.02h,Stop Loss,$-18.00,$1854.00,$245686.25,183,$1854.00
2024-09-13,16:05:00,19547.25,SELL,3,0.02h,Stop Loss,$128.25,$1982.25,$245814.50,183,$1982.25
2024-09-13,16:12:00,19757.0,BUY,3,0.02h,Stop Loss,$-18.00,$1964.25,$245796.50,183,$1964.25
2024-09-13,16:13:00,19527.25,SELL,3,0.02h,Stop Loss,$342.00,$2306.25,$246138.50,183,$2306.25
2024-09-13,16:15:00,19741.25,BUY,3,0.02h,Stop Loss,$-18.00,$2288.25,$246120.50,183,$2288.25
2024-09-13,16:16:00,19492.75,SELL,3,0.02h,Stop Loss,$57.00,$2345.25,$246177.50,183,$2345.25
2024-09-13,16:19:00,19731.25,BUY,3,0.02h,Stop Loss,$45.75,$2391.00,$246223.25,183,$2391.00
2024-09-13,16:42:00,19494.25,SELL,3,0.02h,Stop Loss,$-18.00,$2373.00,$246205.25,183,$2373.00
2024-09-13,16:46:00,19724.5,BUY,3,0.02h,Stop Loss,$15.75,$2388.75,$246221.00,183,$2388.75
2024-09-13,16:50:00,19489.75,SELL,3,0.02h,Stop Loss,$-18.00,$2370.75,$246203.00,183,$2370.75
2024-09-13,17:01:00,19778.25,BUY,3,0.02h,Stop Loss,$-18.00,$2352.75,$246185.00,183,$2352.75
2024-09-13,17:02:00,19544.75,SELL,3,0.02h,Stop Loss,$75.75,$2428.50,$246260.75,183,$2428.50
2024-09-13,17:06:00,19787.25,BUY,3,0.02h,Stop Loss,$30.75,$2459.25,$246291.50,183,$2459.25
2024-09-13,17:11:00,19551.5,SELL,3,0.02h,Stop Loss,$34.50,$2493.75,$246326.00,183,$2493.75
2024-09-13,17:17:00,19792.5,BUY,3,0.02h,Stop Loss,$-18.00,$2475.75,$246308.00,183,$2475.75
2024-09-13,17:18:00,19559.75,SELL,3,0.02h,Stop Loss,$-18.00,$2457.75,$246290.00,183,$2457.75
2024-09-13,17:19:00,19798.5,BUY,3,0.02h,Stop Loss,$-18.00,$2439.75,$246272.00,183,$2439.75
2024-09-13,17:28:00,19549.75,SELL,3,0.02h,Break Even,$0.75,$2440.50,$246272.75,183,$2440.50
2024-09-13,17:33:00,19803.0,BUY,3,0.02h,Break Even,$0.75,$2441.25,$246273.50,183,$2441.25
2024-09-13,17:42:00,19556.5,SELL,3,0.02h,Stop Loss,$30.75,$2472.00,$246304.25,183,$2472.00
2024-09-13,17:45:00,19800.75,BUY,3,0.02h,Stop Loss,$-18.00,$2454.00,$246286.25,183,$2454.00
2024-09-13,17:46:00,19563.25,SELL,3,0.02h,Stop Loss,$-18.00,$2436.00,$246268.25,183,$2436.00
2024-09-13,17:47:00,19802.0,BUY,3,0.02h,Break Even,$0.75,$2436.75,$246269.00,183,$2436.75
2024-09-13,17:54:00,19571.75,SELL,3,0.02h,Stop Loss,$-18.00,$2418.75,$246251.00,183,$2418.75
2024-09-13,17:55:00,19804.5,BUY,3,0.02h,Stop Loss,$-18.00,$2400.75,$246233.00,183,$2400.75
2024-09-13,17:56:00,19569.0,SELL,3,0.02h,Stop Loss,$-18.00,$2382.75,$246215.00,183,$2382.75
2024-09-13,17:57:00,19806.5,BUY,3,0.02h,Stop Loss,$-18.00,$2364.75,$246197.00,183,$2364.75
2024-09-13,17:58:00,19568.25,SELL,3,0.02h,Stop Loss,$-18.00,$2346.75,$246179.00,183,$2346.75
2024-09-13,18:02:00,19780.5,BUY,3,0.02h,Stop Loss,$-18.00,$2328.75,$246161.00,183,$2328.75
2024-09-13,18:03:00,19545.0,SELL,3,0.02h,Stop Loss,$-18.00,$2310.75,$246143.00,183,$2310.75
2024-09-13,18:05:00,19782.5,BUY,3,0.02h,Stop Loss,$102.00,$2412.75,$246245.00,183,$2412.75
2024-09-13,18:08:00,19566.25,SELL,3,0.02h,Break Even,$0.75,$2413.50,$246245.75,183,$2413.50
2024-09-13,18:17:00,19776.75,BUY,3,0.02h,Stop Loss,$-18.00,$2395.50,$246227.75,183,$2395.50
2024-09-13,18:18:00,19537.0,SELL,3,0.02h,Stop Loss,$45.75,$2441.25,$246273.50,183,$2441.25
2024-09-13,18:24:00,19764.25,BUY,3,0.02h,Stop Loss,$-18.00,$2423.25,$246255.50,183,$2423.25
2024-09-13,18:25:00,19512.5,SELL,3,0.02h,Stop Loss,$-18.00,$2405.25,$246237.50,183,$2405.25
2024-09-13,18:27:00,19751.25,BUY,3,0.02h,Stop Loss,$-18.00,$2387.25,$246219.50,183,$2387.25
2024-09-13,18:28:00,19510.0,SELL,3,0.02h,Stop Loss,$-18.00,$2369.25,$246201.50,183,$2369.25
2024-09-13,18:36:00,19738.75,BUY,3,0.02h,Stop Loss,$60.75,$2430.00,$246262.25,183,$2430.00
2024-09-13,18:38:00,19503.0,SELL,3,0.02h,Stop Loss,$-18.00,$2412.00,$246244.25,183,$2412.00
2024-09-13,18:46:00,19761.75,BUY,3,0.02h,Stop Loss,$-18.00,$2394.00,$246226.25,183,$2394.00
2024-09-13,18:47:00,19523.0,SELL,3,0.02h,Stop Loss,$64.50,$2458.50,$246290.75,183,$2458.50
2024-09-13,18:49:00,19749.0,BUY,3,0.02h,Stop Loss,$-18.00,$2440.50,$246272.75,183,$2440.50
2024-09-13,18:50:00,19510.5,SELL,3,0.02h,Stop Loss,$-18.00,$2422.50,$246254.75,183,$2422.50
2024-09-13,18:51:00,19736.75,BUY,3,0.02h,Stop Loss,$-18.00,$2404.50,$246236.75,183,$2404.50
2024-09-13,18:52:00,19506.25,SELL,3,0.02h,Stop Loss,$64.50,$2469.00,$246301.25,183,$2469.00
2024-09-13,18:57:00,19746.0,BUY,3,0.02h,Stop Loss,$-18.00,$2451.00,$246283.25,183,$2451.00
2024-09-13,18:58:00,19509.5,SELL,3,0.02h,Stop Loss,$15.75,$2466.75,$246299.00,183,$2466.75
2024-09-13,19:09:00,19740.5,BUY,3,0.02h,Stop Loss,$-18.00,$2448.75,$246281.00,183,$2448.75
2024-09-13,19:10:00,19504.75,SELL,3,0.02h,Stop Loss,$-18.00,$2430.75,$246263.00,183,$2430.75
2024-09-13,19:11:00,19738.75,BUY,3,0.02h,Break Even,$0.75,$2431.50,$246263.75,183,$2431.50
2024-09-13,19:15:00,19511.75,SELL,3,0.02h,Stop Loss,$-18.00,$2413.50,$246245.75,183,$2413.50
2024-09-13,19:16:00,19750.25,BUY,3,0.02h,Stop Loss,$68.25,$2481.75,$246314.00,183,$2481.75
2024-09-13,19:24:00,19525.0,SELL,3,0.02h,Stop Loss,$-18.00,$2463.75,$246296.00,183,$2463.75
2024-09-13,19:25:00,19765.0,BUY,3,0.02h,Stop Loss,$-18.00,$2445.75,$246278.00,183,$2445.75
2024-09-13,19:42:00,19528.5,SELL,3,0.02h,Break Even,$0.75,$2446.50,$246278.75,183,$2446.50
2024-09-13,19:45:00,19771.0,BUY,3,0.02h,Stop Loss,$-18.00,$2428.50,$246260.75,183,$2428.50
2024-09-13,19:46:00,19536.75,SELL,3,0.02h,Break Even,$0.75,$2429.25,$246261.50,183,$2429.25
2024-09-13,19:53:00,19780.5,BUY,3,0.02h,Break Even,$0.75,$2430.00,$246262.25,183,$2430.00
2024-09-13,19:58:00,19537.25,SELL,3,0.02h,Break Even,$0.75,$2430.75,$246263.00,183,$2430.75
2024-09-13,20:02:00,19752.5,BUY,3,0.02h,Stop Loss,$-18.00,$2412.75,$246245.00,183,$2412.75
2024-09-13,20:03:00,19507.0,SELL,3,0.02h,Stop Loss,$-18.00,$2394.75,$246227.00,183,$2394.75
2024-09-13,20:14:00,19743.0,BUY,3,0.02h,Stop Loss,$53.25,$2448.00,$246280.25,183,$2448.00
2024-09-13,20:18:00,19517.5,SELL,3,0.02h,Stop Loss,$-18.00,$2430.00,$246262.25,183,$2430.00
2024-09-13,20:19:00,19755.5,BUY,3,0.02h,Stop Loss,$-18.00,$2412.00,$246244.25,183,$2412.00
2024-09-13,20:20:00,19519.5,SELL,3,0.02h,Break Even,$0.75,$2412.75,$246245.00,183,$2412.75
2024-09-13,20:29:00,19758.75,BUY,3,0.02h,Break Even,$0.75,$2413.50,$246245.75,183,$2413.50
2024-09-13,20:32:00,19518.5,SELL,3,0.02h,Stop Loss,$-18.00,$2395.50,$246227.75,183,$2395.50
2024-09-13,20:41:00,19756.5,BUY,3,0.02h,Stop Loss,$-18.00,$2377.50,$246209.75,183,$2377.50
2024-09-13,20:42:00,19520.75,SELL,3,0.02h,Stop Loss,$-18.00,$2359.50,$246191.75,183,$2359.50
2024-09-13,20:43:00,19757.75,BUY,3,0.03h,Stop Loss,$-18.00,$2341.50,$246173.75,183,$2341.50
2024-09-13,20:54:00,19506.0,SELL,3,0.02h,Stop Loss,$-18.00,$2323.50,$246155.75,183,$2323.50
2024-09-13,20:55:00,19742.75,BUY,3,0.02h,Stop Loss,$-18.00,$2305.50,$246137.75,183,$2305.50
2024-09-13,20:56:00,19503.5,SELL,3,0.02h,Stop Loss,$-18.00,$2287.50,$246119.75,183,$2287.50
2024-09-13,20:57:00,19741.0,BUY,3,0.05h,Break Even,$0.75,$2288.25,$246120.50,183,$2288.25
,,,,,,,,,,,
2024-09-16,12:21:00,19676.75,SELL,3,0.02h,Break Even,$0.75,$0.75,$246121.25,184,$0.75
2024-09-16,12:41:00,19678.25,BUY,3,0.02h,Stop Loss,$-18.00,$-17.25,$246103.25,184,$-17.25
2024-09-16,12:42:00,19669.25,SELL,3,0.02h,Stop Loss,$-18.00,$-35.25,$246085.25,184,$-35.25
2024-09-16,13:01:00,19673.5,BUY,3,0.02h,Stop Loss,$30.75,$-4.50,$246116.00,184,$-4.50
2024-09-16,13:08:00,19667.0,SELL,3,0.02h,Stop Loss,$-18.00,$-22.50,$246098.00,184,$-22.50
2024-09-16,13:50:00,19641.75,BUY,3,0.02h,Stop Loss,$139.50,$117.00,$246237.50,184,$117.00
2024-09-16,14:21:00,19640.75,SELL,3,0.02h,Stop Loss,$-18.00,$99.00,$246219.50,184,$99.00
2024-09-16,15:12:00,19597.75,BUY,3,0.02h,Stop Loss,$113.25,$212.25,$246332.75,184,$212.25
2024-09-16,15:39:00,19595.0,SELL,3,0.02h,Stop Loss,$-18.00,$194.25,$246314.75,184,$194.25
2024-09-16,15:59:00,19597.5,BUY,3,0.02h,Break Even,$0.75,$195.00,$246315.50,184,$195.00
2024-09-16,16:14:00,19583.5,SELL,3,0.02h,Break Even,$0.75,$195.75,$246316.25,184,$195.75
2024-09-16,16:29:00,19598.25,BUY,3,0.02h,Break Even,$0.75,$196.50,$246317.00,184,$196.50
2024-09-16,16:45:00,19577.75,SELL,3,0.02h,Stop Loss,$12.00,$208.50,$246329.00,184,$208.50
2024-09-16,16:51:00,19599.5,BUY,3,0.02h,Stop Loss,$68.25,$276.75,$246397.25,184,$276.75
2024-09-16,17:20:00,19606.75,SELL,3,0.02h,Stop Loss,$45.75,$322.50,$246443.00,184,$322.50
2024-09-16,17:26:00,19623.0,BUY,3,0.02h,Stop Loss,$75.75,$398.25,$246518.75,184,$398.25
2024-09-16,18:08:00,19641.25,SELL,3,0.02h,Break Even,$0.75,$399.00,$246519.50,184,$399.00
2024-09-16,18:12:00,19665.75,BUY,3,0.02h,Stop Loss,$15.75,$414.75,$246535.25,184,$414.75
2024-09-16,18:41:00,19645.25,SELL,3,0.02h,Stop Loss,$-18.00,$396.75,$246517.25,184,$396.75
2024-09-16,19:00:00,19665.5,BUY,3,0.02h,Break Even,$0.75,$397.50,$246518.00,184,$397.50
2024-09-16,19:15:00,19648.0,SELL,3,0.02h,Stop Loss,$60.75,$458.25,$246578.75,184,$458.25
2024-09-16,19:32:00,19654.0,BUY,3,0.02h,Stop Loss,$23.25,$481.50,$246602.00,184,$481.50
2024-09-16,20:03:00,19664.25,SELL,3,0.02h,Stop Loss,$27.00,$508.50,$246629.00,184,$508.50
2024-09-16,20:23:00,19667.5,BUY,3,0.02h,Break Even,$0.75,$509.25,$246629.75,184,$509.25
2024-09-16,20:34:00,19662.0,SELL,3,0.02h,Break Even,$0.75,$510.00,$246630.50,184,$510.00
2024-09-16,22:04:00,19661.75,BUY,3,0.02h,Stop Loss,$75.75,$585.75,$246706.25,184,$585.75
2024-09-16,22:51:00,19686.0,SELL,3,0.02h,Stop Loss,$-18.00,$567.75,$246688.25,184,$567.75
2024-09-16,22:53:00,19690.75,BUY,3,0.02h,Stop Loss,$19.50,$587.25,$246707.75,184,$587.25
2024-09-16,22:57:00,19683.0,SELL,3,0.02h,Break Even,$0.75,$588.00,$246708.50,184,$588.00
,,,,,,,,,,,
2024-09-17,12:01:00,19793.25,BUY,3,0.02h,Stop Loss,$-18.00,$-18.00,$246690.50,185,$-18.00
2024-09-17,12:03:00,19557.5,SELL,3,0.02h,Break Even,$0.75,$-17.25,$246691.25,185,$-17.25
2024-09-17,12:12:00,19782.75,BUY,3,0.02h,Stop Loss,$-18.00,$-35.25,$246673.25,185,$-35.25
2024-09-17,12:18:00,19534.0,SELL,3,0.02h,Break Even,$0.75,$-34.50,$246674.00,185,$-34.50
2024-09-17,12:25:00,19773.5,BUY,3,0.02h,Stop Loss,$30.75,$-3.75,$246704.75,185,$-3.75
2024-09-17,12:27:00,19542.5,SELL,3,0.02h,Stop Loss,$-18.00,$-21.75,$246686.75,185,$-21.75
2024-09-17,12:28:00,19780.5,BUY,3,0.02h,Stop Loss,$-18.00,$-39.75,$246668.75,185,$-39.75
2024-09-17,12:29:00,19548.5,SELL,3,0.02h,Stop Loss,$98.25,$58.50,$246767.00,185,$58.50
2024-09-17,12:31:00,19788.0,BUY,3,0.02h,Break Even,$0.75,$59.25,$246767.75,185,$59.25
2024-09-17,12:40:00,19550.75,SELL,3,0.02h,Break Even,$0.75,$60.00,$246768.50,185,$60.00
2024-09-17,12:48:00,19782.0,BUY,3,0.02h,Stop Loss,$15.75,$75.75,$246784.25,185,$75.75
2024-09-17,13:01:00,19567.75,SELL,3,0.02h,Stop Loss,$-18.00,$57.75,$246766.25,185,$57.75
2024-09-17,13:02:00,19801.75,BUY,3,0.02h,Break Even,$0.75,$58.50,$246767.00,185,$58.50
2024-09-17,13:08:00,19573.0,SELL,3,0.02h,Stop Loss,$-18.00,$40.50,$246749.00,185,$40.50
2024-09-17,13:10:00,19810.0,BUY,3,0.02h,Break Even,$0.75,$41.25,$246749.75,185,$41.25
2024-09-17,13:15:00,19568.5,SELL,3,0.02h,Break Even,$0.75,$42.00,$246750.50,185,$42.00
2024-09-17,13:20:00,19797.5,BUY,3,0.02h,Stop Loss,$-18.00,$24.00,$246732.50,185,$24.00
2024-09-17,13:24:00,19558.0,SELL,3,0.02h,Break Even,$0.75,$24.75,$246733.25,185,$24.75
2024-09-17,13:36:00,19768.25,BUY,3,0.02h,Stop Loss,$334.50,$359.25,$247067.75,185,$359.25
2024-09-17,13:38:00,19539.75,SELL,3,0.02h,Stop Loss,$218.25,$577.50,$247286.00,185,$577.50
2024-09-17,13:48:00,19797.0,BUY,3,0.02h,Stop Loss,$132.00,$709.50,$247418.00,185,$709.50
2024-09-17,14:01:00,19514.5,SELL,3,0.02h,Stop Loss,$79.50,$789.00,$247497.50,185,$789.00
2024-09-17,14:04:00,19778.0,BUY,3,0.02h,Stop Loss,$207.00,$996.00,$247704.50,185,$996.00
2024-09-17,14:25:00,19559.75,SELL,3,0.02h,Stop Loss,$-18.00,$978.00,$247686.50,185,$978.00
2024-09-17,14:27:00,19802.5,BUY,3,0.02h,Stop Loss,$64.50,$1042.50,$247751.00,185,$1042.50
2024-09-17,14:33:00,19557.0,SELL,3,0.02h,Stop Loss,$263.25,$1305.75,$248014.25,185,$1305.75
2024-09-17,14:45:00,19817.75,BUY,3,0.02h,Stop Loss,$357.00,$1662.75,$248371.25,185,$1662.75
2024-09-17,14:55:00,19581.75,SELL,3,0.02h,Stop Loss,$-18.00,$1644.75,$248353.25,185,$1644.75
2024-09-17,14:56:00,19816.25,BUY,3,0.02h,Break Even,$0.75,$1645.50,$248354.00,185,$1645.50
2024-09-17,14:59:00,19546.25,SELL,3,0.02h,Stop Loss,$477.00,$2122.50,$248831.00,185,$2122.50
2024-09-17,15:06:00,19773.0,BUY,3,0.02h,Stop Loss,$90.75,$2213.25,$248921.75,185,$2213.25
2024-09-17,15:14:00,19561.0,SELL,3,0.02h,Stop Loss,$-18.00,$2195.25,$248903.75,185,$2195.25
2024-09-17,15:15:00,19800.25,BUY,3,0.02h,Stop Loss,$64.50,$2259.75,$248968.25,185,$2259.75
2024-09-17,15:17:00,19576.0,SELL,3,0.02h,Stop Loss,$147.00,$2406.75,$249115.25,185,$2406.75
2024-09-17,15:23:00,19771.75,BUY,3,0.02h,Stop Loss,$132.00,$2538.75,$249247.25,185,$2538.75
2024-09-17,15:25:00,19553.25,SELL,3,0.02h,Break Even,$0.75,$2539.50,$249248.00,185,$2539.50
2024-09-17,15:44:00,19759.75,BUY,3,0.02h,Stop Loss,$-18.00,$2521.50,$249230.00,185,$2521.50
2024-09-17,15:45:00,19524.25,SELL,3,0.02h,Break Even,$0.75,$2522.25,$249230.75,185,$2522.25
2024-09-17,15:47:00,19776.25,BUY,3,0.02h,Stop Loss,$-18.00,$2504.25,$249212.75,185,$2504.25
2024-09-17,15:56:00,19521.5,SELL,3,0.02h,Stop Loss,$-18.00,$2486.25,$249194.75,185,$2486.25
2024-09-17,15:57:00,19767.5,BUY,3,0.02h,Stop Loss,$-18.00,$2468.25,$249176.75,185,$2468.25
2024-09-17,15:58:00,19531.5,SELL,3,0.02h,Stop Loss,$-18.00,$2450.25,$249158.75,185,$2450.25
2024-09-17,15:59:00,19772.5,BUY,3,0.02h,Stop Loss,$23.25,$2473.50,$249182.00,185,$2473.50
2024-09-17,16:02:00,19542.5,SELL,3,0.02h,Stop Loss,$-18.00,$2455.50,$249164.00,185,$2455.50
2024-09-17,16:03:00,19780.5,BUY,3,0.02h,Stop Loss,$23.25,$2478.75,$249187.25,185,$2478.75
2024-09-17,16:05:00,19530.0,SELL,3,0.02h,Stop Loss,$-18.00,$2460.75,$249169.25,185,$2460.75
2024-09-17,16:07:00,19767.0,BUY,3,0.02h,Stop Loss,$42.00,$2502.75,$249211.25,185,$2502.75
2024-09-17,16:09:00,19526.25,SELL,3,0.02h,Stop Loss,$64.50,$2567.25,$249275.75,185,$2567.25
2024-09-17,16:12:00,19754.25,BUY,3,0.02h,Break Even,$0.75,$2568.00,$249276.50,185,$2568.00
2024-09-17,16:15:00,19514.0,SELL,3,0.02h,Stop Loss,$-18.00,$2550.00,$249258.50,185,$2550.00
2024-09-17,16:16:00,19738.25,BUY,3,0.02h,Stop Loss,$-18.00,$2532.00,$249240.50,185,$2532.00
2024-09-17,16:18:00,19496.75,SELL,3,0.02h,Stop Loss,$345.75,$2877.75,$249586.25,185,$2877.75
2024-09-17,16:33:00,19689.5,BUY,3,0.02h,Stop Loss,$19.50,$2897.25,$249605.75,185,$2897.25
2024-09-17,16:39:00,19448.75,SELL,3,0.02h,Stop Loss,$-18.00,$2879.25,$249587.75,185,$2879.25
2024-09-17,16:55:00,19641.75,BUY,3,0.02h,Stop Loss,$180.75,$3060.00,$249768.50,185,$3060.00
2024-09-17,16:57:00,19424.25,SELL,3,0.02h,Stop Loss,$-18.00,$3042.00,$249750.50,185,$3042.00
2024-09-17,16:58:00,19658.5,BUY,3,0.02h,Break Even,$0.75,$3042.75,$249751.25,185,$3042.75
2024-09-17,17:03:00,19407.75,SELL,3,0.02h,Stop Loss,$64.50,$3107.25,$249815.75,185,$3107.25
2024-09-17,17:08:00,19635.75,BUY,3,0.02h,Stop Loss,$83.25,$3190.50,$249899.00,185,$3190.50
2024-09-17,17:10:00,19408.25,SELL,3,0.02h,Stop Loss,$98.25,$3288.75,$249997.25,185,$3288.75
2024-09-17,17:13:00,19634.75,BUY,3,0.02h,Stop Loss,$158.25,$3447.00,$250155.50,185,$3447.00
2024-09-17,17:15:00,19412.75,SELL,3,0.02h,Stop Loss,$75.75,$3522.75,$250231.25,185,$3522.75
2024-09-17,17:20:00,19654.0,BUY,3,0.02h,Stop Loss,$105.75,$3628.50,$250337.00,185,$3628.50
2024-09-17,17:31:00,19458.25,SELL,3,0.02h,Stop Loss,$64.50,$3693.00,$250401.50,185,$3693.00
2024-09-17,17:38:00,19667.5,BUY,3,0.02h,Stop Loss,$-18.00,$3675.00,$250383.50,185,$3675.00
2024-09-17,17:43:00,19389.75,SELL,3,0.02h,Stop Loss,$237.00,$3912.00,$250620.50,185,$3912.00
2024-09-17,17:53:00,19654.0,BUY,3,0.02h,Stop Loss,$214.50,$4126.50,$250835.00,185,$4126.50
2024-09-17,17:59:00,19426.25,SELL,3,0.02h,Break Even,$0.75,$4127.25,$250835.75,185,$4127.25
2024-09-17,18:03:00,19666.25,BUY,3,0.02h,Stop Loss,$68.25,$4195.50,$250904.00,185,$4195.50
2024-09-17,18:05:00,19435.75,SELL,3,0.02h,Stop Loss,$-18.00,$4177.50,$250886.00,185,$4177.50
2024-09-17,18:06:00,19671.0,BUY,3,0.02h,Break Even,$0.75,$4178.25,$250886.75,185,$4178.25
2024-09-17,18:09:00,19433.0,SELL,3,0.02h,Stop Loss,$-18.00,$4160.25,$250868.75,185,$4160.25
2024-09-17,18:19:00,19655.75,BUY,3,0.02h,Stop Loss,$-18.00,$4142.25,$250850.75,185,$4142.25
2024-09-17,18:20:00,19417.25,SELL,3,0.02h,Stop Loss,$-18.00,$4124.25,$250832.75,185,$4124.25
2024-09-17,18:21:00,19646.25,BUY,3,0.02h,Stop Loss,$315.75,$4440.00,$251148.50,185,$4440.00
2024-09-17,18:24:00,19443.25,SELL,3,0.02h,Stop Loss,$-18.00,$4422.00,$251130.50,185,$4422.00
2024-09-17,18:25:00,19678.0,BUY,3,0.02h,Stop Loss,$-18.00,$4404.00,$251112.50,185,$4404.00
2024-09-17,18:29:00,19427.75,SELL,3,0.02h,Stop Loss,$-18.00,$4386.00,$251094.50,185,$4386.00
2024-09-17,18:30:00,19662.0,BUY,3,0.02h,Stop Loss,$-18.00,$4368.00,$251076.50,185,$4368.00
2024-09-17,18:31:00,19417.5,SELL,3,0.02h,Stop Loss,$124.50,$4492.50,$251201.00,185,$4492.50
2024-09-17,18:37:00,19662.0,BUY,3,0.02h,Stop Loss,$-18.00,$4474.50,$251183.00,185,$4474.50
2024-09-17,18:38:00,19425.0,SELL,3,0.02h,Stop Loss,$-18.00,$4456.50,$251165.00,185,$4456.50
2024-09-17,18:39:00,19661.75,BUY,3,0.02h,Stop Loss,$-18.00,$4438.50,$251147.00,185,$4438.50
2024-09-17,18:40:00,19427.25,SELL,3,0.02h,Stop Loss,$-18.00,$4420.50,$251129.00,185,$4420.50
2024-09-17,18:41:00,19664.5,BUY,3,0.02h,Stop Loss,$-18.00,$4402.50,$251111.00,185,$4402.50
2024-09-17,18:45:00,19433.5,SELL,3,0.02h,Stop Loss,$-18.00,$4384.50,$251093.00,185,$4384.50
2024-09-17,18:46:00,19662.25,BUY,3,0.02h,Stop Loss,$-18.00,$4366.50,$251075.00,185,$4366.50
2024-09-17,18:47:00,19420.75,SELL,3,0.02h,Stop Loss,$-18.00,$4348.50,$251057.00,185,$4348.50
2024-09-17,18:48:00,19657.75,BUY,3,0.02h,Stop Loss,$-18.00,$4330.50,$251039.00,185,$4330.50
2024-09-17,18:49:00,19388.25,SELL,3,0.02h,Break Even,$0.75,$4331.25,$251039.75,185,$4331.25
2024-09-17,18:53:00,19624.0,BUY,3,0.02h,Stop Loss,$-18.00,$4313.25,$251021.75,185,$4313.25
2024-09-17,18:54:00,19378.0,SELL,3,0.02h,Stop Loss,$-18.00,$4295.25,$251003.75,185,$4295.25
2024-09-17,18:55:00,19631.25,BUY,3,0.02h,Stop Loss,$124.50,$4419.75,$251128.25,185,$4419.75
2024-09-17,18:59:00,19398.25,SELL,3,0.02h,Stop Loss,$-18.00,$4401.75,$251110.25,185,$4401.75
2024-09-17,19:00:00,19640.5,BUY,3,0.02h,Stop Loss,$-18.00,$4383.75,$251092.25,185,$4383.75
2024-09-17,19:01:00,19404.25,SELL,3,0.02h,Stop Loss,$-18.00,$4365.75,$251074.25,185,$4365.75
2024-09-17,19:02:00,19651.75,BUY,3,0.02h,Stop Loss,$-18.00,$4347.75,$251056.25,185,$4347.75
2024-09-17,19:03:00,19414.0,SELL,3,0.02h,Stop Loss,$-18.00,$4329.75,$251038.25,185,$4329.75
2024-09-17,19:04:00,19642.25,BUY,3,0.02h,Break Even,$0.75,$4330.50,$251039.00,185,$4330.50
2024-09-17,19:09:00,19413.75,SELL,3,0.02h,Break Even,$0.75,$4331.25,$251039.75,185,$4331.25
2024-09-17,19:13:00,19661.75,BUY,3,0.02h,Stop Loss,$-18.00,$4313.25,$251021.75,185,$4313.25
2024-09-17,19:14:00,19421.0,SELL,3,0.02h,Break Even,$0.75,$4314.00,$251022.50,185,$4314.00
2024-09-17,19:16:00,19664.25,BUY,3,0.02h,Break Even,$0.75,$4314.75,$251023.25,185,$4314.75
2024-09-17,19:31:00,19413.5,SELL,3,0.02h,Stop Loss,$-18.00,$4296.75,$251005.25,185,$4296.75
2024-09-17,19:43:00,19645.25,BUY,3,0.02h,Break Even,$0.75,$4297.50,$251006.00,185,$4297.50
2024-09-17,19:45:00,19403.75,SELL,3,0.02h,Break Even,$0.75,$4298.25,$251006.75,185,$4298.25
2024-09-17,19:49:00,19653.25,BUY,3,0.02h,Stop Loss,$64.50,$4362.75,$251071.25,185,$4362.75
2024-09-17,19:54:00,19436.5,SELL,3,0.02h,Break Even,$0.75,$4363.50,$251072.00,185,$4363.50
2024-09-17,20:00:00,19682.0,BUY,3,0.02h,Stop Loss,$-18.00,$4345.50,$251054.00,185,$4345.50
2024-09-17,20:25:00,19455.25,SELL,3,0.02h,Stop Loss,$-18.00,$4327.50,$251036.00,185,$4327.50
2024-09-17,20:33:00,19700.75,BUY,3,0.02h,Stop Loss,$-18.00,$4309.50,$251018.00,185,$4309.50
2024-09-17,20:34:00,19459.75,SELL,3,0.03h,Stop Loss,$-18.00,$4291.50,$251000.00,185,$4291.50
2024-09-17,20:44:00,19693.0,BUY,3,0.02h,Break Even,$0.75,$4292.25,$251000.75,185,$4292.25
2024-09-17,22:03:00,19445.75,SELL,3,0.03h,Stop Loss,$-18.00,$4274.25,$250982.75,185,$4274.25
2024-09-17,22:19:00,19691.5,BUY,3,0.02h,Stop Loss,$-18.00,$4256.25,$250964.75,185,$4256.25
2024-09-17,22:24:00,19458.5,SELL,3,0.02h,Stop Loss,$-18.00,$4238.25,$250946.75,185,$4238.25
2024-09-17,22:25:00,19693.5,BUY,3,0.02h,Stop Loss,$-18.00,$4220.25,$250928.75,185,$4220.25
2024-09-17,22:35:00,19457.25,SELL,3,0.02h,Stop Loss,$-18.00,$4202.25,$250910.75,185,$4202.25
2024-09-17,22:43:00,19689.75,BUY,3,0.02h,Stop Loss,$-18.00,$4184.25,$250892.75,185,$4184.25
2024-09-17,22:44:00,19453.5,SELL,3,0.03h,Break Even,$0.75,$4185.00,$250893.50,185,$4185.00
2024-09-17,22:46:00,19687.0,BUY,3,0.02h,Stop Loss,$-18.00,$4167.00,$250875.50,185,$4167.00
2024-09-17,22:47:00,19453.75,SELL,3,0.02h,Stop Loss,$-18.00,$4149.00,$250857.50,185,$4149.00
2024-09-17,22:52:00,19697.25,BUY,3,0.02h,Stop Loss,$-18.00,$4131.00,$250839.50,185,$4131.00
2024-09-17,22:53:00,19458.25,SELL,3,0.02h,Stop Loss,$-18.00,$4113.00,$250821.50,185,$4113.00
2024-09-17,22:54:00,19691.25,BUY,3,0.02h,Stop Loss,$-18.00,$4095.00,$250803.50,185,$4095.00
2024-09-17,22:55:00,19455.75,SELL,3,0.02h,Break Even,$0.75,$4095.75,$250804.25,185,$4095.75
2024-09-17,22:57:00,19684.5,BUY,3,0.02h,Stop Loss,$15.75,$4111.50,$250820.00,185,$4111.50
,,,,,,,,,,,
2024-09-18,12:00:00,19467.5,SELL,3,0.02h,Stop Loss,$42.00,$42.00,$250862.00,186,$42.00
2024-09-18,12:07:00,19685.0,BUY,3,0.02h,Stop Loss,$27.00,$69.00,$250889.00,186,$69.00
2024-09-18,12:11:00,19452.25,SELL,3,0.02h,Stop Loss,$-18.00,$51.00,$250871.00,186,$51.00
2024-09-18,12:12:00,19684.75,BUY,3,0.02h,Stop Loss,$-18.00,$33.00,$250853.00,186,$33.00
2024-09-18,12:13:00,19447.25,SELL,3,0.02h,Stop Loss,$-18.00,$15.00,$250835.00,186,$15.00
2024-09-18,12:14:00,19679.5,BUY,3,0.02h,Stop Loss,$-18.00,$-3.00,$250817.00,186,$-3.00
2024-09-18,12:21:00,19451.5,SELL,3,0.02h,Stop Loss,$-18.00,$-21.00,$250799.00,186,$-21.00
2024-09-18,12:24:00,19695.0,BUY,3,0.02h,Stop Loss,$-18.00,$-39.00,$250781.00,186,$-39.00
2024-09-18,12:25:00,19461.5,SELL,3,0.02h,Stop Loss,$-18.00,$-57.00,$250763.00,186,$-57.00
2024-09-18,12:26:00,19696.75,BUY,3,0.02h,Stop Loss,$-18.00,$-75.00,$250745.00,186,$-75.00
2024-09-18,12:27:00,19459.5,SELL,3,0.02h,Stop Loss,$-18.00,$-93.00,$250727.00,186,$-93.00
2024-09-18,12:28:00,19698.25,BUY,3,0.02h,Break Even,$0.75,$-92.25,$250727.75,186,$-92.25
2024-09-18,12:30:00,19464.5,SELL,3,0.02h,Stop Loss,$-18.00,$-110.25,$250709.75,186,$-110.25
2024-09-18,12:41:00,19728.0,BUY,3,0.02h,Stop Loss,$-18.00,$-128.25,$250691.75,186,$-128.25
2024-09-18,12:42:00,19487.0,SELL,3,0.02h,Stop Loss,$-18.00,$-146.25,$250673.75,186,$-146.25
2024-09-18,12:43:00,19722.5,BUY,3,0.02h,Stop Loss,$12.00,$-134.25,$250685.75,186,$-134.25
2024-09-18,12:53:00,19486.0,SELL,3,0.02h,Stop Loss,$-18.00,$-152.25,$250667.75,186,$-152.25
2024-09-18,12:54:00,19721.75,BUY,3,0.02h,Break Even,$0.75,$-151.50,$250668.50,186,$-151.50
2024-09-18,13:00:00,19490.75,SELL,3,0.02h,Stop Loss,$-18.00,$-169.50,$250650.50,186,$-169.50
2024-09-18,13:06:00,19727.0,BUY,3,0.02h,Break Even,$0.75,$-168.75,$250651.25,186,$-168.75
2024-09-18,13:11:00,19488.0,SELL,3,0.02h,Stop Loss,$-18.00,$-186.75,$250633.25,186,$-186.75
2024-09-18,13:12:00,19725.75,BUY,3,0.02h,Stop Loss,$-18.00,$-204.75,$250615.25,186,$-204.75
2024-09-18,13:13:00,19492.75,SELL,3,0.02h,Stop Loss,$-18.00,$-222.75,$250597.25,186,$-222.75
2024-09-18,13:14:00,19728.25,BUY,3,0.02h,Stop Loss,$-18.00,$-240.75,$250579.25,186,$-240.75
2024-09-18,13:15:00,19494.0,SELL,3,0.02h,Stop Loss,$-18.00,$-258.75,$250561.25,186,$-258.75
2024-09-18,13:18:00,19726.75,BUY,3,0.02h,Stop Loss,$-18.00,$-276.75,$250543.25,186,$-276.75
2024-09-18,13:19:00,19489.75,SELL,3,0.02h,Stop Loss,$-18.00,$-294.75,$250525.25,186,$-294.75
2024-09-18,13:20:00,19727.75,BUY,3,0.02h,Break Even,$0.75,$-294.00,$250526.00,186,$-294.00
2024-09-18,13:29:00,19497.25,SELL,3,0.02h,Stop Loss,$72.00,$-222.00,$250598.00,186,$-222.00
2024-09-18,13:32:00,19712.25,BUY,3,0.02h,Stop Loss,$-18.00,$-240.00,$250580.00,186,$-240.00
2024-09-18,13:33:00,19480.75,SELL,3,0.02h,Stop Loss,$60.75,$-179.25,$250640.75,186,$-179.25
2024-09-18,13:52:00,19699.0,BUY,3,0.02h,Stop Loss,$-18.00,$-197.25,$250622.75,186,$-197.25
2024-09-18,13:53:00,19467.25,SELL,3,0.02h,Stop Loss,$49.50,$-147.75,$250672.25,186,$-147.75
2024-09-18,13:55:00,19694.25,BUY,3,0.02h,Stop Loss,$177.00,$29.25,$250849.25,186,$29.25
2024-09-18,14:03:00,19456.5,SELL,3,0.02h,Break Even,$0.75,$30.00,$250850.00,186,$30.00
2024-09-18,14:06:00,19698.5,BUY,3,0.02h,Stop Loss,$23.25,$53.25,$250873.25,186,$53.25
2024-09-18,14:10:00,19447.0,SELL,3,0.02h,Stop Loss,$64.50,$117.75,$250937.75,186,$117.75
2024-09-18,14:14:00,19668.0,BUY,3,0.02h,Stop Loss,$-18.00,$99.75,$250919.75,186,$99.75
2024-09-18,14:15:00,19452.0,SELL,3,0.02h,Stop Loss,$-18.00,$81.75,$250901.75,186,$81.75
2024-09-18,14:16:00,19687.5,BUY,3,0.02h,Stop Loss,$-18.00,$63.75,$250883.75,186,$63.75
2024-09-18,14:17:00,19443.25,SELL,3,0.02h,Stop Loss,$34.50,$98.25,$250918.25,186,$98.25
2024-09-18,14:19:00,19671.5,BUY,3,0.02h,Break Even,$0.75,$99.00,$250919.00,186,$99.00
2024-09-18,14:21:00,19426.5,SELL,3,0.02h,Stop Loss,$49.50,$148.50,$250968.50,186,$148.50
2024-09-18,14:36:00,19681.5,BUY,3,0.02h,Stop Loss,$12.00,$160.50,$250980.50,186,$160.50
2024-09-18,15:00:00,19455.5,SELL,3,0.02h,Stop Loss,$27.00,$187.50,$251007.50,186,$187.50
2024-09-18,15:15:00,19674.0,BUY,3,0.02h,Stop Loss,$-18.00,$169.50,$250989.50,186,$169.50
2024-09-18,15:16:00,19434.25,SELL,3,0.02h,Stop Loss,$-18.00,$151.50,$250971.50,186,$151.50
2024-09-18,15:17:00,19665.0,BUY,3,0.02h,Stop Loss,$-18.00,$133.50,$250953.50,186,$133.50
2024-09-18,15:18:00,19431.25,SELL,3,0.02h,Stop Loss,$-18.00,$115.50,$250935.50,186,$115.50
2024-09-18,15:19:00,19664.75,BUY,3,0.02h,Stop Loss,$-18.00,$97.50,$250917.50,186,$97.50
2024-09-18,15:20:00,19429.75,SELL,3,0.02h,Stop Loss,$154.50,$252.00,$251072.00,186,$252.00
2024-09-18,15:25:00,19642.0,BUY,3,0.02h,Break Even,$0.75,$252.75,$251072.75,186,$252.75
2024-09-18,15:29:00,19428.5,SELL,3,0.02h,Stop Loss,$38.25,$291.00,$251111.00,186,$291.00
2024-09-18,15:33:00,19640.25,BUY,3,0.02h,Stop Loss,$-18.00,$273.00,$251093.00,186,$273.00
2024-09-18,15:34:00,19402.25,SELL,3,0.02h,Stop Loss,$-18.00,$255.00,$251075.00,186,$255.00
2024-09-18,15:35:00,19634.5,BUY,3,0.02h,Stop Loss,$-18.00,$237.00,$251057.00,186,$237.00
2024-09-18,15:36:00,19404.0,SELL,3,0.02h,Stop Loss,$-18.00,$219.00,$251039.00,186,$219.00
2024-09-18,15:37:00,19636.25,BUY,3,0.02h,Stop Loss,$-18.00,$201.00,$251021.00,186,$201.00
2024-09-18,15:38:00,19406.0,SELL,3,0.02h,Stop Loss,$-18.00,$183.00,$251003.00,186,$183.00
2024-09-18,15:39:00,19638.0,BUY,3,0.02h,Stop Loss,$-18.00,$165.00,$250985.00,186,$165.00
2024-09-18,15:46:00,19380.5,SELL,3,0.02h,Stop Loss,$-18.00,$147.00,$250967.00,186,$147.00
2024-09-18,16:05:00,19588.75,BUY,3,0.02h,Stop Loss,$38.25,$185.25,$251005.25,186,$185.25
2024-09-18,16:10:00,19373.5,SELL,3,0.02h,Stop Loss,$-18.00,$167.25,$250987.25,186,$167.25
2024-09-18,16:11:00,19622.25,BUY,3,0.02h,Stop Loss,$-18.00,$149.25,$250969.25,186,$149.25
2024-09-18,16:12:00,19390.25,SELL,3,0.02h,Break Even,$0.75,$150.00,$250970.00,186,$150.00
2024-09-18,16:16:00,19637.0,BUY,3,0.02h,Stop Loss,$98.25,$248.25,$251068.25,186,$248.25
2024-09-18,16:27:00,19432.0,SELL,3,0.02h,Stop Loss,$-18.00,$230.25,$251050.25,186,$230.25
2024-09-18,16:28:00,19670.0,BUY,3,0.02h,Stop Loss,$-18.00,$212.25,$251032.25,186,$212.25
2024-09-18,16:29:00,19437.0,SELL,3,0.02h,Break Even,$0.75,$213.00,$251033.00,186,$213.00
2024-09-18,16:31:00,19667.75,BUY,3,0.02h,Break Even,$0.75,$213.75,$251033.75,186,$213.75
2024-09-18,16:37:00,19431.5,SELL,3,0.02h,Break Even,$0.75,$214.50,$251034.50,186,$214.50
2024-09-18,16:39:00,19668.25,BUY,3,0.02h,Stop Loss,$-18.00,$196.50,$251016.50,186,$196.50
2024-09-18,16:40:00,19430.25,SELL,3,0.02h,Stop Loss,$-18.00,$178.50,$250998.50,186,$178.50
2024-09-18,16:41:00,19655.25,BUY,3,0.02h,Stop Loss,$-18.00,$160.50,$250980.50,186,$160.50
2024-09-18,16:42:00,19426.0,SELL,3,0.02h,Stop Loss,$-18.00,$142.50,$250962.50,186,$142.50
2024-09-18,16:47:00,19668.5,BUY,3,0.02h,Stop Loss,$64.50,$207.00,$251027.00,186,$207.00
2024-09-18,16:52:00,19447.75,SELL,3,0.02h,Stop Loss,$-18.00,$189.00,$251009.00,186,$189.00
2024-09-18,16:53:00,19686.25,BUY,3,0.02h,Break Even,$0.75,$189.75,$251009.75,186,$189.75
2024-09-18,17:07:00,19464.75,SELL,3,0.02h,Stop Loss,$-18.00,$171.75,$250991.75,186,$171.75
2024-09-18,17:09:00,19702.0,BUY,3,0.02h,Stop Loss,$-18.00,$153.75,$250973.75,186,$153.75
2024-09-18,17:10:00,19463.75,SELL,3,0.02h,Break Even,$0.75,$154.50,$250974.50,186,$154.50
2024-09-18,17:16:00,19689.5,BUY,3,0.02h,Stop Loss,$-18.00,$136.50,$250956.50,186,$136.50
2024-09-18,17:17:00,19452.0,SELL,3,0.02h,Stop Loss,$-18.00,$118.50,$250938.50,186,$118.50
2024-09-18,17:18:00,19686.5,BUY,3,0.02h,Stop Loss,$-18.00,$100.50,$250920.50,186,$100.50
2024-09-18,17:19:00,19451.25,SELL,3,0.02h,Break Even,$0.75,$101.25,$250921.25,186,$101.25
2024-09-18,17:25:00,19677.0,BUY,3,0.02h,Stop Loss,$-18.00,$83.25,$250903.25,186,$83.25
2024-09-18,17:26:00,19453.25,SELL,3,0.02h,Stop Loss,$-18.00,$65.25,$250885.25,186,$65.25
2024-09-18,17:27:00,19688.5,BUY,3,0.02h,Stop Loss,$19.50,$84.75,$250904.75,186,$84.75
2024-09-18,17:31:00,19472.5,SELL,3,0.02h,Stop Loss,$-18.00,$66.75,$250886.75,186,$66.75
2024-09-18,17:39:00,19690.25,BUY,3,0.02h,Stop Loss,$-18.00,$48.75,$250868.75,186,$48.75
2024-09-18,17:40:00,19453.75,SELL,3,0.02h,Stop Loss,$-18.00,$30.75,$250850.75,186,$30.75
2024-09-18,17:41:00,19689.0,BUY,3,0.02h,Break Even,$0.75,$31.50,$250851.50,186,$31.50
2024-09-18,17:46:00,19466.5,SELL,3,0.02h,Stop Loss,$177.00,$208.50,$251028.50,186,$208.50
2024-09-18,17:55:00,19689.25,BUY,3,0.02h,Stop Loss,$-18.00,$190.50,$251010.50,186,$190.50
2024-09-18,18:13:00,19453.75,SELL,3,0.02h,Stop Loss,$-18.00,$172.50,$250992.50,186,$172.50
2024-09-18,18:14:00,19701.5,BUY,3,0.02h,Stop Loss,$582.00,$754.50,$251574.50,186,$754.50
2024-09-18,18:16:00,19516.5,SELL,3,0.02h,Stop Loss,$-18.00,$736.50,$251556.50,186,$736.50
2024-09-18,18:17:00,19766.0,BUY,3,0.02h,Stop Loss,$495.75,$1232.25,$252052.25,186,$1232.25
2024-09-18,18:25:00,19565.75,SELL,3,0.02h,Stop Loss,$42.00,$1274.25,$252094.25,186,$1274.25
2024-09-18,18:27:00,19792.25,BUY,3,0.02h,Stop Loss,$-18.00,$1256.25,$252076.25,186,$1256.25
2024-09-18,18:28:00,19548.5,SELL,3,0.02h,Break Even,$0.75,$1257.00,$252077.00,186,$1257.00
2024-09-18,18:32:00,19817.75,BUY,3,0.02h,Stop Loss,$-18.00,$1239.00,$252059.00,186,$1239.00
2024-09-18,18:33:00,19605.0,SELL,3,0.02h,Stop Loss,$15.75,$1254.75,$252074.75,186,$1254.75
2024-09-18,18:35:00,19864.0,BUY,3,0.02h,Break Even,$0.75,$1255.50,$252075.50,186,$1255.50
2024-09-18,18:46:00,19515.25,SELL,3,0.02h,Stop Loss,$-18.00,$1237.50,$252057.50,186,$1237.50
2024-09-18,18:47:00,19793.5,BUY,3,0.02h,Stop Loss,$192.00,$1429.50,$252249.50,186,$1429.50
2024-09-18,18:50:00,19543.0,SELL,3,0.02h,Stop Loss,$-18.00,$1411.50,$252231.50,186,$1411.50
2024-09-18,18:51:00,19776.5,BUY,3,0.02h,Stop Loss,$312.00,$1723.50,$252543.50,186,$1723.50
2024-09-18,18:53:00,19581.5,SELL,3,0.02h,Stop Loss,$105.75,$1829.25,$252649.25,186,$1829.25
2024-09-18,19:19:00,19680.0,BUY,3,0.02h,Stop Loss,$-18.00,$1811.25,$252631.25,186,$1811.25
2024-09-18,19:20:00,19468.5,SELL,3,0.02h,Stop Loss,$987.00,$2798.25,$253618.25,186,$2798.25
2024-09-18,19:24:00,19676.0,BUY,3,0.02h,Stop Loss,$184.50,$2982.75,$253802.75,186,$2982.75
2024-09-18,19:37:00,19431.0,SELL,3,0.02h,Stop Loss,$-18.00,$2964.75,$253784.75,186,$2964.75
2024-09-18,19:56:00,19595.75,BUY,3,0.02h,Stop Loss,$72.00,$3036.75,$253856.75,186,$3036.75
2024-09-18,20:01:00,19351.25,SELL,3,0.02h,Stop Loss,$195.75,$3232.50,$254052.50,186,$3232.50
2024-09-18,20:08:00,19632.0,BUY,3,0.02h,Stop Loss,$210.75,$3443.25,$254263.25,186,$3443.25
2024-09-18,20:12:00,19403.0,SELL,3,0.02h,Break Even,$0.75,$3444.00,$254264.00,186,$3444.00
2024-09-18,20:18:00,19654.0,BUY,3,0.02h,Stop Loss,$-18.00,$3426.00,$254246.00,186,$3426.00
2024-09-18,20:19:00,19428.5,SELL,3,0.02h,Stop Loss,$-18.00,$3408.00,$254228.00,186,$3408.00
2024-09-18,20:20:00,19661.0,BUY,3,0.02h,Break Even,$0.75,$3408.75,$254228.75,186,$3408.75
2024-09-18,20:29:00,19411.75,SELL,3,0.02h,Stop Loss,$-18.00,$3390.75,$254210.75,186,$3390.75
2024-09-18,20:30:00,19643.75,BUY,3,0.02h,Stop Loss,$-18.00,$3372.75,$254192.75,186,$3372.75
2024-09-18,20:31:00,19419.5,SELL,3,0.02h,Break Even,$0.75,$3373.50,$254193.50,186,$3373.50
2024-09-18,20:44:00,19623.75,BUY,3,0.02h,Stop Loss,$-18.00,$3355.50,$254175.50,186,$3355.50
2024-09-18,20:45:00,19399.75,SELL,3,0.02h,Stop Loss,$-18.00,$3337.50,$254157.50,186,$3337.50
2024-09-18,20:46:00,19626.75,BUY,3,0.02h,Break Even,$0.75,$3338.25,$254158.25,186,$3338.25
2024-09-18,20:51:00,19406.25,SELL,3,0.02h,Stop Loss,$-18.00,$3320.25,$254140.25,186,$3320.25
2024-09-18,20:52:00,19629.75,BUY,3,0.02h,Stop Loss,$-18.00,$3302.25,$254122.25,186,$3302.25
2024-09-18,20:53:00,19397.25,SELL,3,0.03h,Break Even,$0.75,$3303.00,$254123.00,186,$3303.00
2024-09-18,20:55:00,19632.0,BUY,3,0.02h,Break Even,$0.75,$3303.75,$254123.75,186,$3303.75
2024-09-18,21:00:00,19403.75,SELL,3,1.02h,Stop Loss,$-18.00,$3285.75,$254105.75,186,$3285.75
2024-09-18,22:01:00,19645.0,BUY,3,0.02h,Break Even,$0.75,$3286.50,$254106.50,186,$3286.50
2024-09-18,22:04:00,19433.25,SELL,3,0.02h,Stop Loss,$-18.00,$3268.50,$254088.50,186,$3268.50
2024-09-18,22:05:00,19660.5,BUY,3,0.02h,Stop Loss,$-18.00,$3250.50,$254070.50,186,$3250.50
2024-09-18,22:06:00,19425.5,SELL,3,0.02h,Stop Loss,$-18.00,$3232.50,$254052.50,186,$3232.50
2024-09-18,22:07:00,19653.75,BUY,3,0.02h,Stop Loss,$-18.00,$3214.50,$254034.50,186,$3214.50
2024-09-18,22:08:00,19422.25,SELL,3,0.02h,Stop Loss,$-18.00,$3196.50,$254016.50,186,$3196.50
2024-09-18,22:09:00,19650.25,BUY,3,0.02h,Break Even,$0.75,$3197.25,$254017.25,186,$3197.25
2024-09-18,22:15:00,19428.75,SELL,3,0.02h,Stop Loss,$-18.00,$3179.25,$253999.25,186,$3179.25
2024-09-18,22:16:00,19664.0,BUY,3,0.02h,Stop Loss,$-18.00,$3161.25,$253981.25,186,$3161.25
2024-09-18,22:17:00,19436.0,SELL,3,0.02h,Stop Loss,$-18.00,$3143.25,$253963.25,186,$3143.25
2024-09-18,22:19:00,19675.5,BUY,3,0.02h,Break Even,$0.75,$3144.00,$253964.00,186,$3144.00
2024-09-18,22:22:00,19445.25,SELL,3,0.02h,Break Even,$0.75,$3144.75,$253964.75,186,$3144.75
2024-09-18,22:24:00,19673.5,BUY,3,0.02h,Stop Loss,$-18.00,$3126.75,$253946.75,186,$3126.75
2024-09-18,22:36:00,19452.75,SELL,3,0.02h,Stop Loss,$-18.00,$3108.75,$253928.75,186,$3108.75
2024-09-18,22:37:00,19685.0,BUY,3,0.02h,Break Even,$0.75,$3109.50,$253929.50,186,$3109.50
2024-09-18,22:39:00,19451.75,SELL,3,0.02h,Stop Loss,$-18.00,$3091.50,$253911.50,186,$3091.50
2024-09-18,22:44:00,19683.5,BUY,3,0.02h,Break Even,$0.75,$3092.25,$253912.25,186,$3092.25
2024-09-18,22:46:00,19448.0,SELL,3,0.02h,Break Even,$0.75,$3093.00,$253913.00,186,$3093.00
2024-09-18,22:56:00,19664.0,BUY,3,0.02h,Break Even,$0.75,$3093.75,$253913.75,186,$3093.75
,,,,,,,,,,,
2024-09-19,12:37:00,19766.75,SELL,3,0.02h,Stop Loss,$34.50,$34.50,$253948.25,187,$34.50
2024-09-19,12:40:00,20003.0,BUY,3,0.02h,Stop Loss,$147.00,$181.50,$254095.25,187,$181.50
2024-09-19,12:53:00,19763.25,SELL,3,0.02h,Stop Loss,$-18.00,$163.50,$254077.25,187,$163.50
2024-09-19,12:54:00,19995.5,BUY,3,0.02h,Stop Loss,$-18.00,$145.50,$254059.25,187,$145.50
2024-09-19,12:55:00,19762.25,SELL,3,0.02h,Stop Loss,$-18.00,$127.50,$254041.25,187,$127.50
2024-09-19,13:04:00,19994.75,BUY,3,0.02h,Stop Loss,$-18.00,$109.50,$254023.25,187,$109.50
2024-09-19,13:24:00,19796.5,SELL,3,0.02h,Break Even,$0.75,$110.25,$254024.00,187,$110.25
2024-09-19,13:32:00,20039.5,BUY,3,0.02h,Stop Loss,$102.00,$212.25,$254126.00,187,$212.25
2024-09-19,13:34:00,19798.75,SELL,3,0.02h,Stop Loss,$165.75,$378.00,$254291.75,187,$378.00
2024-09-19,13:36:00,20020.0,BUY,3,0.02h,Break Even,$0.75,$378.75,$254292.50,187,$378.75
2024-09-19,13:40:00,19812.75,SELL,3,0.02h,Stop Loss,$-18.00,$360.75,$254274.50,187,$360.75
2024-09-19,13:41:00,20060.5,BUY,3,0.02h,Stop Loss,$139.50,$500.25,$254414.00,187,$500.25
2024-09-19,13:47:00,19784.25,SELL,3,0.02h,Stop Loss,$83.25,$583.50,$254497.25,187,$583.50
2024-09-19,13:50:00,20015.25,BUY,3,0.02h,Stop Loss,$-18.00,$565.50,$254479.25,187,$565.50
2024-09-19,13:58:00,19767.0,SELL,3,0.02h,Stop Loss,$-18.00,$547.50,$254461.25,187,$547.50
2024-09-19,13:59:00,20008.25,BUY,3,0.02h,Stop Loss,$23.25,$570.75,$254484.50,187,$570.75
2024-09-19,14:07:00,19794.0,SELL,3,0.02h,Stop Loss,$-18.00,$552.75,$254466.50,187,$552.75
2024-09-19,14:09:00,20040.0,BUY,3,0.02h,Break Even,$0.75,$553.50,$254467.25,187,$553.50
2024-09-19,14:12:00,19809.0,SELL,3,0.02h,Break Even,$0.75,$554.25,$254468.00,187,$554.25
2024-09-19,14:16:00,20059.0,BUY,3,0.02h,Stop Loss,$-18.00,$536.25,$254450.00,187,$536.25
2024-09-19,14:17:00,19821.0,SELL,3,0.02h,Stop Loss,$-18.00,$518.25,$254432.00,187,$518.25
2024-09-19,14:18:00,20071.25,BUY,3,0.02h,Stop Loss,$143.25,$661.50,$254575.25,187,$661.50
2024-09-19,14:23:00,19843.5,SELL,3,0.02h,Stop Loss,$-18.00,$643.50,$254557.25,187,$643.50
2024-09-19,14:24:00,20075.75,BUY,3,0.02h,Stop Loss,$218.25,$861.75,$254775.50,187,$861.75
2024-09-19,14:27:00,19862.0,SELL,3,0.02h,Stop Loss,$-18.00,$843.75,$254757.50,187,$843.75
2024-09-19,14:29:00,20129.25,BUY,3,0.02h,Stop Loss,$-18.00,$825.75,$254739.50,187,$825.75
2024-09-19,14:30:00,19893.0,SELL,3,0.02h,Break Even,$0.75,$826.50,$254740.25,187,$826.50
2024-09-19,14:32:00,20153.75,BUY,3,0.02h,Stop Loss,$23.25,$849.75,$254763.50,187,$849.75
2024-09-19,14:39:00,19895.5,SELL,3,0.02h,Stop Loss,$-18.00,$831.75,$254745.50,187,$831.75
2024-09-19,14:40:00,20142.5,BUY,3,0.02h,Stop Loss,$-18.00,$813.75,$254727.50,187,$813.75
2024-09-19,14:43:00,19879.5,SELL,3,0.02h,Stop Loss,$143.25,$957.00,$254870.75,187,$957.00
2024-09-19,14:49:00,20095.75,BUY,3,0.02h,Stop Loss,$188.25,$1145.25,$255059.00,187,$1145.25
2024-09-19,14:51:00,19862.5,SELL,3,0.02h,Stop Loss,$-18.00,$1127.25,$255041.00,187,$1127.25
2024-09-19,14:52:00,20092.25,BUY,3,0.02h,Stop Loss,$-18.00,$1109.25,$255023.00,187,$1109.25
2024-09-19,14:53:00,19846.25,SELL,3,0.02h,Stop Loss,$-18.00,$1091.25,$255005.00,187,$1091.25
2024-09-19,14:54:00,20086.25,BUY,3,0.02h,Stop Loss,$-18.00,$1073.25,$254987.00,187,$1073.25
2024-09-19,14:55:00,19844.0,SELL,3,0.02h,Stop Loss,$128.25,$1201.50,$255115.25,187,$1201.50
2024-09-19,15:05:00,20104.25,BUY,3,0.02h,Break Even,$0.75,$1202.25,$255116.00,187,$1202.25
2024-09-19,15:09:00,19835.5,SELL,3,0.02h,Stop Loss,$-18.00,$1184.25,$255098.00,187,$1184.25
2024-09-19,15:16:00,20101.75,BUY,3,0.02h,Stop Loss,$327.00,$1511.25,$255425.00,187,$1511.25
2024-09-19,15:26:00,19903.25,SELL,3,0.02h,Stop Loss,$64.50,$1575.75,$255489.50,187,$1575.75
2024-09-19,15:28:00,20134.75,BUY,3,0.02h,Break Even,$0.75,$1576.50,$255490.25,187,$1576.50
2024-09-19,15:33:00,19891.75,SELL,3,0.02h,Stop Loss,$109.50,$1686.00,$255599.75,187,$1686.00
2024-09-19,15:36:00,20137.25,BUY,3,0.02h,Stop Loss,$-18.00,$1668.00,$255581.75,187,$1668.00
2024-09-19,15:37:00,19900.25,SELL,3,0.02h,Stop Loss,$-18.00,$1650.00,$255563.75,187,$1650.00
2024-09-19,15:38:00,20137.5,BUY,3,0.02h,Stop Loss,$-18.00,$1632.00,$255545.75,187,$1632.00
2024-09-19,15:39:00,19898.25,SELL,3,0.02h,Stop Loss,$-18.00,$1614.00,$255527.75,187,$1614.00
2024-09-19,15:40:00,20135.25,BUY,3,0.02h,Stop Loss,$-18.00,$1596.00,$255509.75,187,$1596.00
2024-09-19,15:51:00,19901.5,SELL,3,0.02h,Stop Loss,$-18.00,$1578.00,$255491.75,187,$1578.00
2024-09-19,15:52:00,20113.5,BUY,3,0.02h,Stop Loss,$-18.00,$1560.00,$255473.75,187,$1560.00
2024-09-19,15:54:00,19868.5,SELL,3,0.02h,Stop Loss,$-18.00,$1542.00,$255455.75,187,$1542.00
2024-09-19,16:00:00,20098.25,BUY,3,0.02h,Stop Loss,$90.75,$1632.75,$255546.50,187,$1632.75
2024-09-19,16:02:00,19880.0,SELL,3,0.02h,Stop Loss,$-18.00,$1614.75,$255528.50,187,$1614.75
2024-09-19,16:03:00,20123.75,BUY,3,0.02h,Stop Loss,$83.25,$1698.00,$255611.75,187,$1698.00
2024-09-19,16:05:00,19898.5,SELL,3,0.02h,Stop Loss,$-18.00,$1680.00,$255593.75,187,$1680.00
2024-09-19,16:06:00,20130.5,BUY,3,0.02h,Stop Loss,$12.00,$1692.00,$255605.75,187,$1692.00
2024-09-19,16:11:00,19906.25,SELL,3,0.02h,Stop Loss,$154.50,$1846.50,$255760.25,187,$1846.50
2024-09-19,16:14:00,20124.75,BUY,3,0.02h,Stop Loss,$-18.00,$1828.50,$255742.25,187,$1828.50
2024-09-19,16:18:00,19905.0,SELL,3,0.02h,Stop Loss,$-18.00,$1810.50,$255724.25,187,$1810.50
2024-09-19,16:19:00,20137.0,BUY,3,0.02h,Stop Loss,$94.50,$1905.00,$255818.75,187,$1905.00
2024-09-19,16:26:00,19918.75,SELL,3,0.02h,Break Even,$0.75,$1905.75,$255819.50,187,$1905.75
2024-09-19,16:31:00,20163.5,BUY,3,0.02h,Stop Loss,$-18.00,$1887.75,$255801.50,187,$1887.75
2024-09-19,16:32:00,19918.5,SELL,3,0.02h,Break Even,$0.75,$1888.50,$255802.25,187,$1888.50
2024-09-19,16:35:00,20161.75,BUY,3,0.02h,Break Even,$0.75,$1889.25,$255803.00,187,$1889.25
2024-09-19,16:39:00,19930.5,SELL,3,0.02h,Break Even,$0.75,$1890.00,$255803.75,187,$1890.00
2024-09-19,16:41:00,20168.0,BUY,3,0.02h,Stop Loss,$-18.00,$1872.00,$255785.75,187,$1872.00
2024-09-19,16:42:00,19924.25,SELL,3,0.02h,Stop Loss,$-18.00,$1854.00,$255767.75,187,$1854.00
2024-09-19,16:43:00,20159.75,BUY,3,0.02h,Break Even,$0.75,$1854.75,$255768.50,187,$1854.75
2024-09-19,16:50:00,19929.5,SELL,3,0.02h,Stop Loss,$-18.00,$1836.75,$255750.50,187,$1836.75
2024-09-19,16:51:00,20167.25,BUY,3,0.02h,Stop Loss,$-18.00,$1818.75,$255732.50,187,$1818.75
2024-09-19,16:52:00,19930.0,SELL,3,0.02h,Stop Loss,$-18.00,$1800.75,$255714.50,187,$1800.75
2024-09-19,16:53:00,20168.0,BUY,3,0.02h,Break Even,$0.75,$1801.50,$255715.25,187,$1801.50
2024-09-19,16:57:00,19926.0,SELL,3,0.02h,Stop Loss,$-18.00,$1783.50,$255697.25,187,$1783.50
2024-09-19,17:05:00,20160.25,BUY,3,0.02h,Stop Loss,$-18.00,$1765.50,$255679.25,187,$1765.50
2024-09-19,17:06:00,19921.25,SELL,3,0.02h,Stop Loss,$-18.00,$1747.50,$255661.25,187,$1747.50
2024-09-19,17:07:00,20148.25,BUY,3,0.02h,Stop Loss,$-18.00,$1729.50,$255643.25,187,$1729.50
2024-09-19,17:08:00,19915.75,SELL,3,0.02h,Stop Loss,$-18.00,$1711.50,$255625.25,187,$1711.50
2024-09-19,17:09:00,20149.0,BUY,3,0.02h,Stop Loss,$-18.00,$1693.50,$255607.25,187,$1693.50
2024-09-19,17:10:00,19918.5,SELL,3,0.02h,Stop Loss,$-18.00,$1675.50,$255589.25,187,$1675.50
2024-09-19,17:11:00,20151.75,BUY,3,0.02h,Stop Loss,$-18.00,$1657.50,$255571.25,187,$1657.50
2024-09-19,17:12:00,19916.25,SELL,3,0.02h,Stop Loss,$72.00,$1729.50,$255643.25,187,$1729.50
2024-09-19,17:17:00,20165.75,BUY,3,0.02h,Stop Loss,$-18.00,$1711.50,$255625.25,187,$1711.50
2024-09-19,17:18:00,19932.75,SELL,3,0.02h,Stop Loss,$-18.00,$1693.50,$255607.25,187,$1693.50
2024-09-19,17:19:00,20164.75,BUY,3,0.02h,Stop Loss,$12.00,$1705.50,$255619.25,187,$1705.50
2024-09-19,17:31:00,19931.75,SELL,3,0.02h,Stop Loss,$49.50,$1755.00,$255668.75,187,$1755.00
2024-09-19,17:37:00,20167.25,BUY,3,0.02h,Stop Loss,$-18.00,$1737.00,$255650.75,187,$1737.00
2024-09-19,17:38:00,19938.5,SELL,3,0.02h,Stop Loss,$-18.00,$1719.00,$255632.75,187,$1719.00
2024-09-19,17:39:00,20172.25,BUY,3,0.02h,Stop Loss,$12.00,$1731.00,$255644.75,187,$1731.00
2024-09-19,17:42:00,19943.0,SELL,3,0.02h,Stop Loss,$-18.00,$1713.00,$255626.75,187,$1713.00
2024-09-19,17:43:00,20183.0,BUY,3,0.02h,Stop Loss,$-18.00,$1695.00,$255608.75,187,$1695.00
2024-09-19,17:44:00,19936.5,SELL,3,0.02h,Stop Loss,$-18.00,$1677.00,$255590.75,187,$1677.00
2024-09-19,17:45:00,20183.0,BUY,3,0.02h,Break Even,$0.75,$1677.75,$255591.50,187,$1677.75
2024-09-19,17:50:00,19955.75,SELL,3,0.02h,Stop Loss,$83.25,$1761.00,$255674.75,187,$1761.00
2024-09-19,18:01:00,20198.5,BUY,3,0.02h,Stop Loss,$-18.00,$1743.00,$255656.75,187,$1743.00
2024-09-19,18:02:00,19958.75,SELL,3,0.02h,Stop Loss,$-18.00,$1725.00,$255638.75,187,$1725.00
2024-09-19,18:03:00,20191.25,BUY,3,0.02h,Stop Loss,$15.75,$1740.75,$255654.50,187,$1740.75
2024-09-19,18:07:00,19956.0,SELL,3,0.02h,Stop Loss,$147.00,$1887.75,$255801.50,187,$1887.75
2024-09-19,18:13:00,20170.75,BUY,3,0.02h,Stop Loss,$-18.00,$1869.75,$255783.50,187,$1869.75
2024-09-19,18:20:00,19902.25,SELL,3,0.02h,Stop Loss,$27.00,$1896.75,$255810.50,187,$1896.75
2024-09-19,18:32:00,20148.25,BUY,3,0.02h,Break Even,$0.75,$1897.50,$255811.25,187,$1897.50
2024-09-19,18:39:00,19906.0,SELL,3,0.02h,Stop Loss,$-18.00,$1879.50,$255793.25,187,$1879.50
2024-09-19,18:40:00,20151.5,BUY,3,0.02h,Stop Loss,$-18.00,$1861.50,$255775.25,187,$1861.50
2024-09-19,18:41:00,19908.25,SELL,3,0.02h,Stop Loss,$19.50,$1881.00,$255794.75,187,$1881.00
2024-09-19,18:46:00,20142.25,BUY,3,0.02h,Stop Loss,$105.75,$1986.75,$255900.50,187,$1986.75
2024-09-19,18:53:00,19893.25,SELL,3,0.02h,Stop Loss,$45.75,$2032.50,$255946.25,187,$2032.50
2024-09-19,18:59:00,20142.25,BUY,3,0.02h,Stop Loss,$68.25,$2100.75,$256014.50,187,$2100.75
2024-09-19,19:05:00,19904.5,SELL,3,0.02h,Stop Loss,$169.50,$2270.25,$256184.00,187,$2270.25
2024-09-19,19:08:00,20130.25,BUY,3,0.02h,Stop Loss,$-18.00,$2252.25,$256166.00,187,$2252.25
2024-09-19,19:09:00,19890.5,SELL,3,0.02h,Stop Loss,$83.25,$2335.50,$256249.25,187,$2335.50
2024-09-19,19:19:00,20097.0,BUY,3,0.02h,Stop Loss,$23.25,$2358.75,$256272.50,187,$2358.75
2024-09-19,19:21:00,19842.0,SELL,3,0.02h,Stop Loss,$-18.00,$2340.75,$256254.50,187,$2340.75
2024-09-19,19:22:00,20089.25,BUY,3,0.02h,Stop Loss,$-18.00,$2322.75,$256236.50,187,$2322.75
2024-09-19,19:23:00,19863.5,SELL,3,0.02h,Stop Loss,$-18.00,$2304.75,$256218.50,187,$2304.75
2024-09-19,19:26:00,20111.25,BUY,3,0.02h,Stop Loss,$-18.00,$2286.75,$256200.50,187,$2286.75
2024-09-19,19:30:00,19871.75,SELL,3,0.02h,Stop Loss,$184.50,$2471.25,$256385.00,187,$2471.25
2024-09-19,19:44:00,20117.75,BUY,3,0.02h,Break Even,$0.75,$2472.00,$256385.75,187,$2472.00
2024-09-19,19:52:00,19840.75,SELL,3,0.02h,Stop Loss,$-18.00,$2454.00,$256367.75,187,$2454.00
2024-09-19,19:53:00,20070.25,BUY,3,0.02h,Stop Loss,$-18.00,$2436.00,$256349.75,187,$2436.00
2024-09-19,19:54:00,19834.25,SELL,3,0.02h,Stop Loss,$-18.00,$2418.00,$256331.75,187,$2418.00
2024-09-19,19:55:00,20091.5,BUY,3,0.02h,Stop Loss,$75.75,$2493.75,$256407.50,187,$2493.75
2024-09-19,19:58:00,19844.0,SELL,3,0.02h,Stop Loss,$135.75,$2629.50,$256543.25,187,$2629.50
2024-09-19,20:02:00,20076.75,BUY,3,0.02h,Stop Loss,$12.00,$2641.50,$256555.25,187,$2641.50
2024-09-19,20:04:00,19839.25,SELL,3,0.02h,Stop Loss,$19.50,$2661.00,$256574.75,187,$2661.00
2024-09-19,20:18:00,20060.25,BUY,3,0.02h,Stop Loss,$-18.00,$2643.00,$256556.75,187,$2643.00
2024-09-19,20:19:00,19826.0,SELL,3,0.02h,Stop Loss,$-18.00,$2625.00,$256538.75,187,$2625.00
2024-09-19,20:24:00,20060.75,BUY,3,0.02h,Stop Loss,$15.75,$2640.75,$256554.50,187,$2640.75
2024-09-19,20:27:00,19830.75,SELL,3,0.02h,Break Even,$0.75,$2641.50,$256555.25,187,$2641.50
2024-09-19,20:33:00,20063.25,BUY,3,0.02h,Stop Loss,$-18.00,$2623.50,$256537.25,187,$2623.50
2024-09-19,20:45:00,19834.5,SELL,3,0.02h,Stop Loss,$113.25,$2736.75,$256650.50,187,$2736.75
2024-09-19,20:52:00,20065.0,BUY,3,0.02h,Stop Loss,$-18.00,$2718.75,$256632.50,187,$2718.75
2024-09-19,20:54:00,19824.5,SELL,3,0.03h,Break Even,$0.75,$2719.50,$256633.25,187,$2719.50
2024-09-19,21:00:00,20063.25,BUY,3,1.02h,Stop Loss,$79.50,$2799.00,$256712.75,187,$2799.00
2024-09-19,22:08:00,19835.25,SELL,3,0.03h,Break Even,$0.75,$2799.75,$256713.50,187,$2799.75
2024-09-19,22:16:00,20069.5,BUY,3,0.02h,Break Even,$0.75,$2800.50,$256714.25,187,$2800.50
2024-09-19,22:18:00,19822.0,SELL,3,0.02h,Stop Loss,$-18.00,$2782.50,$256696.25,187,$2782.50
2024-09-19,22:23:00,20060.25,BUY,3,0.02h,Stop Loss,$-18.00,$2764.50,$256678.25,187,$2764.50
2024-09-19,22:24:00,19826.75,SELL,3,0.03h,Break Even,$0.75,$2765.25,$256679.00,187,$2765.25
2024-09-19,22:26:00,20063.75,BUY,3,0.02h,Stop Loss,$15.75,$2781.00,$256694.75,187,$2781.00
2024-09-19,22:31:00,19828.5,SELL,3,0.02h,Stop Loss,$-18.00,$2763.00,$256676.75,187,$2763.00
2024-09-19,22:32:00,20060.25,BUY,3,0.02h,Break Even,$0.75,$2763.75,$256677.50,187,$2763.75
2024-09-19,22:37:00,19816.5,SELL,3,0.02h,Stop Loss,$-18.00,$2745.75,$256659.50,187,$2745.75
2024-09-19,22:38:00,20054.75,BUY,3,0.02h,Stop Loss,$-18.00,$2727.75,$256641.50,187,$2727.75
2024-09-19,22:40:00,19801.25,SELL,3,0.02h,Break Even,$0.75,$2728.50,$256642.25,187,$2728.50
2024-09-19,22:45:00,20040.75,BUY,3,0.02h,Stop Loss,$-18.00,$2710.50,$256624.25,187,$2710.50
2024-09-19,22:46:00,19805.0,SELL,3,0.02h,Stop Loss,$60.75,$2771.25,$256685.00,187,$2771.25
2024-09-19,22:52:00,20038.5,BUY,3,0.02h,Stop Loss,$38.25,$2809.50,$256723.25,187,$2809.50
2024-09-19,22:54:00,19805.0,SELL,3,0.02h,Stop Loss,$-18.00,$2791.50,$256705.25,187,$2791.50
2024-09-19,22:55:00,20044.0,BUY,3,0.02h,Stop Loss,$-18.00,$2773.50,$256687.25,187,$2773.50
,,,,,,,,,,,
2024-09-20,12:02:00,19791.0,SELL,3,0.02h,Stop Loss,$-18.00,$-18.00,$256669.25,188,$-18.00
2024-09-20,12:05:00,20033.5,BUY,3,0.02h,Stop Loss,$-18.00,$-36.00,$256651.25,188,$-36.00
2024-09-20,12:06:00,19802.0,SELL,3,0.02h,Stop Loss,$60.75,$24.75,$256712.00,188,$24.75
2024-09-20,12:16:00,20050.25,BUY,3,0.02h,Break Even,$0.75,$25.50,$256712.75,188,$25.50
2024-09-20,12:23:00,19810.5,SELL,3,0.02h,Stop Loss,$-18.00,$7.50,$256694.75,188,$7.50
2024-09-20,12:25:00,20046.75,BUY,3,0.02h,Stop Loss,$27.00,$34.50,$256721.75,188,$34.50
2024-09-20,12:34:00,19821.75,SELL,3,0.02h,Stop Loss,$-18.00,$16.50,$256703.75,188,$16.50
2024-09-20,12:37:00,20057.25,BUY,3,0.02h,Stop Loss,$-18.00,$-1.50,$256685.75,188,$-1.50
2024-09-20,12:38:00,19823.25,SELL,3,0.02h,Stop Loss,$-18.00,$-19.50,$256667.75,188,$-19.50
2024-09-20,12:45:00,20071.0,BUY,3,0.02h,Stop Loss,$-18.00,$-37.50,$256649.75,188,$-37.50
2024-09-20,12:46:00,19830.75,SELL,3,0.02h,Stop Loss,$-18.00,$-55.50,$256631.75,188,$-55.50
2024-09-20,12:48:00,20070.0,BUY,3,0.02h,Stop Loss,$27.00,$-28.50,$256658.75,188,$-28.50
2024-09-20,12:58:00,19824.5,SELL,3,0.02h,Break Even,$0.75,$-27.75,$256659.50,188,$-27.75
2024-09-20,13:01:00,20064.0,BUY,3,0.02h,Stop Loss,$-18.00,$-45.75,$256641.50,188,$-45.75
2024-09-20,13:21:00,19795.25,SELL,3,0.02h,Stop Loss,$-18.00,$-63.75,$256623.50,188,$-63.75
2024-09-20,13:33:00,20040.75,BUY,3,0.02h,Stop Loss,$87.00,$23.25,$256710.50,188,$23.25
2024-09-20,13:59:00,20007.75,SELL,3,0.02h,Stop Loss,$199.50,$222.75,$256910.00,188,$222.75
2024-09-20,14:29:00,20007.75,BUY,3,0.02h,Break Even,$0.75,$223.50,$256910.75,188,$223.50
2024-09-20,14:31:00,19989.75,SELL,3,0.02h,Stop Loss,$158.25,$381.75,$257069.00,188,$381.75
2024-09-20,14:40:00,20009.25,BUY,3,0.02h,Stop Loss,$-18.00,$363.75,$257051.00,188,$363.75
2024-09-20,14:44:00,19991.5,SELL,3,0.02h,Stop Loss,$53.25,$417.00,$257104.25,188,$417.00
2024-09-20,15:34:00,19930.75,BUY,3,0.02h,Stop Loss,$263.25,$680.25,$257367.50,188,$680.25
2024-09-20,17:05:00,20004.25,SELL,3,0.02h,Break Even,$0.75,$681.00,$257368.25,188,$681.00
2024-09-20,17:18:00,20018.5,BUY,3,0.02h,Break Even,$0.75,$681.75,$257369.00,188,$681.75
2024-09-20,17:23:00,20008.0,SELL,3,0.02h,Break Even,$0.75,$682.50,$257369.75,188,$682.50
2024-09-20,17:34:00,20021.5,BUY,3,0.02h,Stop Loss,$23.25,$705.75,$257393.00,188,$705.75
2024-09-20,17:46:00,20011.0,SELL,3,0.02h,Stop Loss,$60.75,$766.50,$257453.75,188,$766.50
2024-09-20,18:50:00,19957.5,BUY,3,0.02h,Stop Loss,$34.50,$801.00,$257488.25,188,$801.00
2024-09-20,19:53:00,20036.75,SELL,3,0.02h,Break Even,$0.75,$801.75,$257489.00,188,$801.75
2024-09-20,20:41:00,20022.25,BUY,3,0.02h,Stop Loss,$-18.00,$783.75,$257471.00,188,$783.75
,,,,,,,,,,,
2024-09-23,12:51:00,20073.5,SELL,3,0.02h,Break Even,$0.75,$0.75,$257471.75,189,$0.75
2024-09-23,12:58:00,20089.75,BUY,3,0.02h,Stop Loss,$23.25,$24.00,$257495.00,189,$24.00
2024-09-23,13:12:00,20080.5,SELL,3,0.02h,Stop Loss,$83.25,$107.25,$257578.25,189,$107.25
2024-09-23,13:49:00,20082.25,BUY,3,0.02h,Stop Loss,$233.25,$340.50,$257811.50,189,$340.50
2024-09-23,14:15:00,20057.25,SELL,3,0.02h,Stop Loss,$105.75,$446.25,$257917.25,189,$446.25
2024-09-23,14:22:00,20086.75,BUY,3,0.02h,Stop Loss,$173.25,$619.50,$258090.50,189,$619.50
2024-09-23,14:39:00,20074.5,SELL,3,0.02h,Stop Loss,$214.50,$834.00,$258305.00,189,$834.00
2024-09-23,14:45:00,20104.75,BUY,3,0.02h,Break Even,$0.75,$834.75,$258305.75,189,$834.75
2024-09-23,15:02:00,20083.25,SELL,3,0.02h,Stop Loss,$90.75,$925.50,$258396.50,189,$925.50
2024-09-23,15:27:00,20083.75,BUY,3,0.02h,Stop Loss,$-18.00,$907.50,$258378.50,189,$907.50
2024-09-23,16:03:00,20102.25,SELL,3,0.02h,Stop Loss,$60.75,$968.25,$258439.25,189,$968.25
2024-09-23,17:20:00,20051.75,BUY,3,0.02h,Stop Loss,$53.25,$1021.50,$258492.50,189,$1021.50
2024-09-23,17:29:00,20037.25,SELL,3,0.02h,Break Even,$0.75,$1022.25,$258493.25,189,$1022.25
2024-09-23,17:33:00,20049.5,BUY,3,0.02h,Stop Loss,$68.25,$1090.50,$258561.50,189,$1090.50
2024-09-23,18:30:00,20067.0,SELL,3,0.02h,Break Even,$0.75,$1091.25,$258562.25,189,$1091.25
2024-09-23,18:43:00,20075.75,BUY,3,0.02h,Stop Loss,$-18.00,$1073.25,$258544.25,189,$1073.25
2024-09-23,18:46:00,20068.5,SELL,3,0.02h,Stop Loss,$-18.00,$1055.25,$258526.25,189,$1055.25
2024-09-23,18:51:00,20076.5,BUY,3,0.02h,Stop Loss,$-18.00,$1037.25,$258508.25,189,$1037.25
2024-09-23,19:10:00,20068.25,SELL,3,0.02h,Stop Loss,$34.50,$1071.75,$258542.75,189,$1071.75
2024-09-23,19:23:00,20077.25,BUY,3,0.02h,Stop Loss,$-18.00,$1053.75,$258524.75,189,$1053.75
2024-09-23,19:44:00,20069.75,SELL,3,0.02h,Stop Loss,$188.25,$1242.00,$258713.00,189,$1242.00
2024-09-23,19:50:00,20085.0,BUY,3,0.02h,Break Even,$0.75,$1242.75,$258713.75,189,$1242.75
2024-09-23,19:54:00,20067.25,SELL,3,0.02h,Break Even,$0.75,$1243.50,$258714.50,189,$1243.50
2024-09-23,19:57:00,20076.75,BUY,3,0.02h,Stop Loss,$30.75,$1274.25,$258745.25,189,$1274.25
2024-09-23,20:08:00,20067.0,SELL,3,0.02h,Break Even,$0.75,$1275.00,$258746.00,189,$1275.00
2024-09-23,20:53:00,20062.0,BUY,3,0.02h,Stop Loss,$-18.00,$1257.00,$258728.00,189,$1257.00
2024-09-23,20:59:00,20058.25,SELL,3,0.02h,Stop Loss,$-18.00,$1239.00,$258710.00,189,$1239.00
2024-09-23,21:00:00,20063.25,BUY,3,1.02h,Stop Loss,$19.50,$1258.50,$258729.50,189,$1258.50
2024-09-23,22:07:00,20054.75,SELL,3,0.02h,Stop Loss,$57.00,$1315.50,$258786.50,189,$1315.50
2024-09-23,22:33:00,20055.25,BUY,3,0.02h,Stop Loss,$-18.00,$1297.50,$258768.50,189,$1297.50
2024-09-23,22:39:00,20052.0,SELL,3,0.02h,Stop Loss,$23.25,$1320.75,$258791.75,189,$1320.75
2024-09-23,23:00:00,20051.25,BUY,3,13.00h,Stop Loss,$769.50,$2090.25,$259561.25,189,$2090.25
,,,,,,,,,,,
2024-09-24,12:33:00,20098.5,SELL,3,0.02h,Stop Loss,$30.75,$30.75,$259592.00,190,$30.75
2024-09-24,12:49:00,20109.0,BUY,3,0.02h,Stop Loss,$12.00,$42.75,$259604.00,190,$42.75
2024-09-24,13:33:00,20117.75,SELL,3,0.02h,Stop Loss,$79.50,$122.25,$259683.50,190,$122.25
2024-09-24,14:48:00,20014.25,BUY,3,0.02h,Stop Loss,$27.00,$149.25,$259710.50,190,$149.25
2024-09-24,16:26:00,20183.5,SELL,3,0.02h,Stop Loss,$135.75,$285.00,$259846.25,190,$285.00
2024-09-24,16:34:00,20197.0,BUY,3,0.02h,Break Even,$0.75,$285.75,$259847.00,190,$285.75
2024-09-24,16:54:00,20191.75,SELL,3,0.02h,Stop Loss,$150.75,$436.50,$259997.75,190,$436.50
2024-09-24,17:17:00,20185.5,BUY,3,0.02h,Stop Loss,$60.75,$497.25,$260058.50,190,$497.25
2024-09-24,17:24:00,20173.25,SELL,3,0.02h,Break Even,$0.75,$498.00,$260059.25,190,$498.00
2024-09-24,17:34:00,20183.0,BUY,3,0.02h,Stop Loss,$30.75,$528.75,$260090.00,190,$528.75
2024-09-24,17:49:00,20177.5,SELL,3,0.02h,Stop Loss,$94.50,$623.25,$260184.50,190,$623.25
2024-09-24,18:54:00,20153.0,BUY,3,0.02h,Break Even,$0.75,$624.00,$260185.25,190,$624.00
2024-09-24,19:19:00,20146.0,SELL,3,0.02h,Break Even,$0.75,$624.75,$260186.00,190,$624.75
2024-09-24,19:21:00,20153.5,BUY,3,0.02h,Stop Loss,$12.00,$636.75,$260198.00,190,$636.75
2024-09-24,19:31:00,20146.5,SELL,3,0.02h,Break Even,$0.75,$637.50,$260198.75,190,$637.50
2024-09-24,19:39:00,20154.25,BUY,3,0.02h,Stop Loss,$75.75,$713.25,$260274.50,190,$713.25
2024-09-24,19:57:00,20151.75,SELL,3,0.02h,Break Even,$0.75,$714.00,$260275.25,190,$714.00
2024-09-24,20:01:00,20165.75,BUY,3,0.02h,Break Even,$0.75,$714.75,$260276.00,190,$714.75
2024-09-24,22:01:00,20183.25,SELL,3,0.02h,Break Even,$0.75,$715.50,$260276.75,190,$715.50
2024-09-24,22:14:00,20185.5,BUY,3,0.02h,Break Even,$0.75,$716.25,$260277.50,190,$716.25
2024-09-24,22:19:00,20184.25,SELL,3,0.02h,Stop Loss,$12.00,$728.25,$260289.50,190,$728.25
2024-09-24,22:46:00,20185.5,BUY,3,0.02h,Stop Loss,$-18.00,$710.25,$260271.50,190,$710.25
,,,,,,,,,,,
2024-09-25,12:00:00,20140.75,SELL,3,0.02h,Stop Loss,$-18.00,$-18.00,$260253.50,191,$-18.00
2024-09-25,12:28:00,20144.0,BUY,3,0.02h,Break Even,$0.75,$-17.25,$260254.25,191,$-17.25
2024-09-25,12:29:00,20142.25,SELL,3,0.02h,Break Even,$0.75,$-16.50,$260255.00,191,$-16.50
2024-09-25,12:31:00,20145.5,BUY,3,0.02h,Stop Loss,$27.00,$10.50,$260282.00,191,$10.50
2024-09-25,12:48:00,20141.25,SELL,3,0.02h,Break Even,$0.75,$11.25,$260282.75,191,$11.25
2024-09-25,12:55:00,20149.0,BUY,3,0.02h,Stop Loss,$-18.00,$-6.75,$260264.75,191,$-6.75
2024-09-25,12:57:00,20142.75,SELL,3,0.02h,Break Even,$0.75,$-6.00,$260265.50,191,$-6.00
2024-09-25,12:59:00,20150.0,BUY,3,0.02h,Stop Loss,$-18.00,$-24.00,$260247.50,191,$-24.00
2024-09-25,13:04:00,20142.0,SELL,3,0.02h,Stop Loss,$-18.00,$-42.00,$260229.50,191,$-42.00
2024-09-25,13:10:00,20151.0,BUY,3,0.02h,Stop Loss,$-18.00,$-60.00,$260211.50,191,$-60.00
2024-09-25,13:20:00,20146.0,SELL,3,0.02h,Stop Loss,$-18.00,$-78.00,$260193.50,191,$-78.00
2024-09-25,13:31:00,20160.75,BUY,3,0.02h,Stop Loss,$188.25,$110.25,$260381.75,191,$110.25
2024-09-25,14:30:00,20227.5,SELL,3,0.02h,Stop Loss,$184.50,$294.75,$260566.25,191,$294.75
2024-09-25,15:09:00,20243.75,BUY,3,0.02h,Break Even,$0.75,$295.50,$260567.00,191,$295.50
2024-09-25,15:13:00,20222.25,SELL,3,0.02h,Stop Loss,$53.25,$348.75,$260620.25,191,$348.75
2024-09-25,15:39:00,20238.5,BUY,3,0.02h,Stop Loss,$-18.00,$330.75,$260602.25,191,$330.75
2024-09-25,15:47:00,20208.5,SELL,3,0.02h,Break Even,$0.75,$331.50,$260603.00,191,$331.50
2024-09-25,16:21:00,20207.0,BUY,3,0.02h,Stop Loss,$27.00,$358.50,$260630.00,191,$358.50
2024-09-25,16:44:00,20195.75,SELL,3,0.02h,Break Even,$0.75,$359.25,$260630.75,191,$359.25
2024-09-25,17:27:00,20181.0,BUY,3,0.02h,Stop Loss,$27.00,$386.25,$260657.75,191,$386.25
2024-09-25,17:36:00,20162.0,SELL,3,0.02h,Break Even,$0.75,$387.00,$260658.50,191,$387.00
2024-09-25,17:55:00,20186.0,BUY,3,0.02h,Stop Loss,$38.25,$425.25,$260696.75,191,$425.25
2024-09-25,18:13:00,20176.0,SELL,3,0.02h,Break Even,$0.75,$426.00,$260697.50,191,$426.00
2024-09-25,18:27:00,20185.5,BUY,3,0.02h,Stop Loss,$15.75,$441.75,$260713.25,191,$441.75
2024-09-25,18:58:00,20182.75,SELL,3,0.02h,Stop Loss,$90.75,$532.50,$260804.00,191,$532.50
2024-09-25,19:04:00,20198.5,BUY,3,0.02h,Stop Loss,$-18.00,$514.50,$260786.00,191,$514.50
2024-09-25,19:09:00,20186.75,SELL,3,0.02h,Break Even,$0.75,$515.25,$260786.75,191,$515.25
2024-09-25,19:38:00,20185.0,BUY,3,0.02h,Break Even,$0.75,$516.00,$260787.50,191,$516.00
2024-09-25,19:40:00,20179.0,SELL,3,0.02h,Stop Loss,$12.00,$528.00,$260799.50,191,$528.00
2024-09-25,19:49:00,20189.0,BUY,3,0.02h,Break Even,$0.75,$528.75,$260800.25,191,$528.75
2024-09-25,22:03:00,20232.5,SELL,3,0.02h,Stop Loss,$-18.00,$510.75,$260782.25,191,$510.75
2024-09-25,22:29:00,20237.5,BUY,3,0.02h,Stop Loss,$-18.00,$492.75,$260764.25,191,$492.75
,,,,,,,,,,,
2024-09-26,13:26:00,20508.0,SELL,3,0.02h,Break Even,$0.75,$0.75,$260765.00,192,$0.75
2024-09-26,15:18:00,20274.5,BUY,3,0.02h,Stop Loss,$-18.00,$-17.25,$260747.00,192,$-17.25
2024-09-26,15:19:00,20257.0,SELL,3,0.02h,Stop Loss,$297.00,$279.75,$261044.00,192,$279.75
2024-09-26,15:42:00,20250.0,BUY,3,0.02h,Stop Loss,$105.75,$385.50,$261149.75,192,$385.50
2024-09-26,16:12:00,20277.0,SELL,3,0.02h,Stop Loss,$49.50,$435.00,$261199.25,192,$435.00
2024-09-26,16:54:00,20259.0,BUY,3,0.02h,Stop Loss,$-18.00,$417.00,$261181.25,192,$417.00
2024-09-26,16:55:00,20252.25,SELL,3,0.02h,Stop Loss,$19.50,$436.50,$261200.75,192,$436.50
2024-09-26,17:31:00,20256.5,BUY,3,0.02h,Stop Loss,$135.75,$572.25,$261336.50,192,$572.25
2024-09-26,18:48:00,20326.0,SELL,3,0.02h,Stop Loss,$-18.00,$554.25,$261318.50,192,$554.25
2024-09-26,18:52:00,20334.0,BUY,3,0.02h,Break Even,$0.75,$555.00,$261319.25,192,$555.00
2024-09-26,19:03:00,20323.25,SELL,3,0.02h,Stop Loss,$-18.00,$537.00,$261301.25,192,$537.00
2024-09-26,19:06:00,20337.75,BUY,3,0.02h,Stop Loss,$-18.00,$519.00,$261283.25,192,$519.00
2024-09-26,19:40:00,20345.75,SELL,3,0.02h,Break Even,$0.75,$519.75,$261284.00,192,$519.75
2024-09-26,19:50:00,20353.5,BUY,3,0.02h,Break Even,$0.75,$520.50,$261284.75,192,$520.50
2024-09-26,19:51:00,20346.25,SELL,3,0.02h,Stop Loss,$154.50,$675.00,$261439.25,192,$675.00
2024-09-26,20:08:00,20352.0,BUY,3,0.02h,Break Even,$0.75,$675.75,$261440.00,192,$675.75
2024-09-26,20:21:00,20344.0,SELL,3,0.02h,Break Even,$0.75,$676.50,$261440.75,192,$676.50
2024-09-26,20:27:00,20347.0,BUY,3,0.02h,Stop Loss,$-18.00,$658.50,$261422.75,192,$658.50
2024-09-26,20:30:00,20346.25,SELL,3,0.02h,Stop Loss,$-18.00,$640.50,$261404.75,192,$640.50
2024-09-26,20:31:00,20348.0,BUY,3,0.02h,Stop Loss,$-18.00,$622.50,$261386.75,192,$622.50
2024-09-26,20:43:00,20343.25,SELL,3,0.02h,Stop Loss,$-18.00,$604.50,$261368.75,192,$604.50
2024-09-26,22:01:00,20350.0,BUY,3,0.02h,Stop Loss,$15.75,$620.25,$261384.50,192,$620.25
2024-09-26,22:39:00,20368.75,SELL,3,0.02h,Stop Loss,$27.00,$647.25,$261411.50,192,$647.25
2024-09-26,22:46:00,20371.5,BUY,3,0.02h,Break Even,$0.75,$648.00,$261412.25,192,$648.00
2024-09-26,22:53:00,20367.0,SELL,3,0.02h,Break Even,$0.75,$648.75,$261413.00,192,$648.75
,,,,,,,,,,,
2024-09-27,12:23:00,20359.25,BUY,3,0.02h,Stop Loss,$-18.00,$-18.00,$261395.00,193,$-18.00
2024-09-27,12:24:00,20356.5,SELL,3,0.02h,Break Even,$0.75,$-17.25,$261395.75,193,$-17.25
2024-09-27,12:28:00,20359.75,BUY,3,0.02h,Break Even,$0.75,$-16.50,$261396.50,193,$-16.50
2024-09-27,12:55:00,20361.5,SELL,3,0.02h,Stop Loss,$-18.00,$-34.50,$261378.50,193,$-34.50
2024-09-27,13:05:00,20379.25,BUY,3,0.02h,Stop Loss,$30.75,$-3.75,$261409.25,193,$-3.75
2024-09-27,13:26:00,20373.5,SELL,3,0.02h,Break Even,$0.75,$-3.00,$261410.00,193,$-3.00
2024-09-27,14:04:00,20370.25,BUY,3,0.02h,Stop Loss,$34.50,$31.50,$261444.50,193,$31.50
2024-09-27,14:06:00,20331.0,SELL,3,0.02h,Break Even,$0.75,$32.25,$261445.25,193,$32.25
2024-09-27,14:42:00,20325.5,BUY,3,0.02h,Stop Loss,$15.75,$48.00,$261461.00,193,$48.00
2024-09-27,14:51:00,20298.5,SELL,3,0.02h,Break Even,$0.75,$48.75,$261461.75,193,$48.75
2024-09-27,15:43:00,20282.5,BUY,3,0.02h,Break Even,$0.75,$49.50,$261462.50,193,$49.50
2024-09-27,15:50:00,20253.0,SELL,3,0.02h,Stop Loss,$252.00,$301.50,$261714.50,193,$301.50
2024-09-27,16:28:00,20249.75,BUY,3,0.02h,Stop Loss,$105.75,$407.25,$261820.25,193,$407.25
2024-09-27,17:11:00,20252.75,SELL,3,0.02h,Stop Loss,$30.75,$438.00,$261851.00,193,$438.00
2024-09-27,17:48:00,20243.75,BUY,3,0.02h,Break Even,$0.75,$438.75,$261851.75,193,$438.75
2024-09-27,18:13:00,20255.25,SELL,3,0.02h,Stop Loss,$38.25,$477.00,$261890.00,193,$477.00
2024-09-27,18:48:00,20229.75,BUY,3,0.02h,Stop Loss,$15.75,$492.75,$261905.75,193,$492.75
2024-09-27,19:24:00,20235.75,SELL,3,0.02h,Stop Loss,$68.25,$561.00,$261974.00,193,$561.00
2024-09-27,19:54:00,20232.25,BUY,3,0.02h,Stop Loss,$117.00,$678.00,$262091.00,193,$678.00
2024-09-27,20:00:00,20223.0,SELL,3,0.02h,Stop Loss,$113.25,$791.25,$262204.25,193,$791.25
2024-09-27,20:34:00,20207.25,BUY,3,0.02h,Stop Loss,$-18.00,$773.25,$262186.25,193,$773.25
2024-09-27,20:38:00,20204.0,SELL,3,0.02h,Stop Loss,$15.75,$789.00,$262202.00,193,$789.00
,,,,,,,,,,,
2024-09-30,12:30:00,20162.25,BUY,3,0.02h,Break Even,$0.75,$0.75,$262202.75,194,$0.75
2024-09-30,12:42:00,20154.0,SELL,3,0.02h,Break Even,$0.75,$1.50,$262203.50,194,$1.50
2024-09-30,12:51:00,20169.0,BUY,3,0.02h,Break Even,$0.75,$2.25,$262204.25,194,$2.25
2024-09-30,13:24:00,20173.25,SELL,3,0.02h,Break Even,$0.75,$3.00,$262205.00,194,$3.00
2024-09-30,13:29:00,20178.75,BUY,3,0.02h,Stop Loss,$15.75,$18.75,$262220.75,194,$18.75
2024-09-30,13:59:00,20216.75,SELL,3,0.02h,Stop Loss,$214.50,$233.25,$262435.25,194,$233.25
2024-09-30,14:33:00,20177.75,BUY,3,0.02h,Stop Loss,$225.75,$459.00,$262661.00,194,$459.00
2024-09-30,14:47:00,20177.25,SELL,3,0.02h,Stop Loss,$109.50,$568.50,$262770.50,194,$568.50
2024-09-30,14:51:00,20186.0,BUY,3,0.02h,Stop Loss,$-18.00,$550.50,$262752.50,194,$550.50
2024-09-30,14:52:00,20178.25,SELL,3,0.02h,Break Even,$0.75,$551.25,$262753.25,194,$551.25
2024-09-30,14:54:00,20186.25,BUY,3,0.02h,Break Even,$0.75,$552.00,$262754.00,194,$552.00
2024-09-30,14:55:00,20177.5,SELL,3,0.02h,Break Even,$0.75,$552.75,$262754.75,194,$552.75
2024-09-30,15:02:00,20184.5,BUY,3,0.02h,Stop Loss,$42.00,$594.75,$262796.75,194,$594.75
2024-09-30,15:38:00,20186.0,SELL,3,0.02h,Stop Loss,$38.25,$633.00,$262835.00,194,$633.00
2024-09-30,15:48:00,20217.75,BUY,3,0.02h,Break Even,$0.75,$633.75,$262835.75,194,$633.75
2024-09-30,16:33:00,20225.75,SELL,3,0.02h,Break Even,$0.75,$634.50,$262836.50,194,$634.50
2024-09-30,17:53:00,20188.5,BUY,3,0.02h,Stop Loss,$53.25,$687.75,$262889.75,194,$687.75
2024-09-30,18:11:00,20180.75,SELL,3,0.02h,Stop Loss,$72.00,$759.75,$262961.75,194,$759.75
2024-09-30,18:38:00,20146.75,BUY,3,0.02h,Stop Loss,$12.00,$771.75,$262973.75,194,$771.75
2024-09-30,19:02:00,20137.25,SELL,3,0.02h,Stop Loss,$75.75,$847.50,$263049.50,194,$847.50
2024-09-30,19:20:00,20156.5,BUY,3,0.02h,Break Even,$0.75,$848.25,$263050.25,194,$848.25
2024-09-30,20:42:00,20253.5,SELL,3,0.02h,Stop Loss,$-18.00,$830.25,$263032.25,194,$830.25
2024-09-30,22:29:00,20237.25,BUY,3,0.02h,Stop Loss,$-18.00,$812.25,$263014.25,194,$812.25
2024-09-30,23:00:00,20234.75,SELL,3,13.00h,Stop Loss,$-18.00,$794.25,$262996.25,194,$794.25
,,,,,,,,,,,
2024-10-01,12:00:00,20272.25,BUY,3,0.02h,Break Even,$0.75,$0.75,$262997.00,195,$0.75
2024-10-01,12:32:00,20262.5,SELL,3,0.02h,Stop Loss,$12.00,$12.75,$263009.00,195,$12.75
2024-10-01,12:55:00,20269.75,BUY,3,0.02h,Break Even,$0.75,$13.50,$263009.75,195,$13.50
2024-10-01,13:16:00,20258.75,SELL,3,0.02h,Break Even,$0.75,$14.25,$263010.50,195,$14.25
2024-10-01,14:43:00,19960.5,BUY,3,0.02h,Stop Loss,$12.00,$26.25,$263022.50,195,$26.25
2024-10-01,14:53:00,19921.0,SELL,3,0.02h,Break Even,$0.75,$27.00,$263023.25,195,$27.00
2024-10-01,15:30:00,19893.5,BUY,3,0.02h,Stop Loss,$45.75,$72.75,$263069.00,195,$72.75
2024-10-01,16:02:00,19919.5,SELL,3,0.02h,Stop Loss,$38.25,$111.00,$263107.25,195,$111.00
2024-10-01,16:04:00,19955.5,BUY,3,0.02h,Stop Loss,$158.25,$269.25,$263265.50,195,$269.25
2024-10-01,16:27:00,19948.25,SELL,3,0.02h,Stop Loss,$207.00,$476.25,$263472.50,195,$476.25
2024-10-01,16:56:00,19927.5,BUY,3,0.02h,Stop Loss,$57.00,$533.25,$263529.50,195,$533.25
2024-10-01,17:05:00,19894.5,SELL,3,0.02h,Stop Loss,$244.50,$777.75,$263774.00,195,$777.75
2024-10-01,17:33:00,19888.5,BUY,3,0.02h,Stop Loss,$237.00,$1014.75,$264011.00,195,$1014.75
2024-10-01,18:53:00,20040.0,SELL,3,0.02h,Stop Loss,$113.25,$1128.00,$264124.25,195,$1128.00
2024-10-01,18:57:00,20061.0,BUY,3,0.02h,Stop Loss,$23.25,$1151.25,$264147.50,195,$1151.25
2024-10-01,19:06:00,20044.5,SELL,3,0.02h,Break Even,$0.75,$1152.00,$264148.25,195,$1152.00
2024-10-01,19:08:00,20053.5,BUY,3,0.02h,Stop Loss,$117.00,$1269.00,$264265.25,195,$1269.00
2024-10-01,19:13:00,20039.0,SELL,3,0.02h,Stop Loss,$120.75,$1389.75,$264386.00,195,$1389.75
2024-10-01,20:02:00,20008.75,BUY,3,0.02h,Stop Loss,$79.50,$1469.25,$264465.50,195,$1469.25
2024-10-01,20:09:00,19983.0,SELL,3,0.02h,Stop Loss,$-18.00,$1451.25,$264447.50,195,$1451.25
2024-10-01,22:01:00,19980.75,BUY,3,0.02h,Stop Loss,$-18.00,$1433.25,$264429.50,195,$1433.25
2024-10-01,22:03:00,19952.5,SELL,3,0.02h,Break Even,$0.75,$1434.00,$264430.25,195,$1434.00
2024-10-01,22:37:00,19941.25,BUY,3,0.02h,Break Even,$0.75,$1434.75,$264431.00,195,$1434.75
2024-10-01,22:45:00,19912.75,SELL,3,0.02h,Stop Loss,$-18.00,$1416.75,$264413.00,195,$1416.75
,,,,,,,,,,,
2024-10-02,12:01:00,19933.5,BUY,3,0.02h,Stop Loss,$79.50,$79.50,$264492.50,196,$79.50
2024-10-02,12:30:00,19931.5,SELL,3,0.02h,Stop Loss,$-18.00,$61.50,$264474.50,196,$61.50
2024-10-02,12:36:00,19954.25,BUY,3,0.02h,Stop Loss,$87.00,$148.50,$264561.50,196,$148.50
2024-10-02,13:01:00,19963.75,SELL,3,0.02h,Stop Loss,$94.50,$243.00,$264656.00,196,$243.00
2024-10-02,13:56:00,19922.75,BUY,3,0.02h,Break Even,$0.75,$243.75,$264656.75,196,$243.75
2024-10-02,14:57:00,20002.25,SELL,3,0.02h,Stop Loss,$23.25,$267.00,$264680.00,196,$267.00
2024-10-02,15:04:00,20033.25,BUY,3,0.02h,Stop Loss,$105.75,$372.75,$264785.75,196,$372.75
2024-10-02,15:55:00,20046.0,SELL,3,0.02h,Stop Loss,$72.00,$444.75,$264857.75,196,$444.75
2024-10-02,16:02:00,20062.25,BUY,3,0.02h,Stop Loss,$150.75,$595.50,$265008.50,196,$595.50
2024-10-02,16:20:00,20047.5,SELL,3,0.02h,Stop Loss,$135.75,$731.25,$265144.25,196,$731.25
2024-10-02,16:27:00,20075.25,BUY,3,0.02h,Break Even,$0.75,$732.00,$265145.00,196,$732.00
2024-10-02,16:32:00,20049.25,SELL,3,0.02h,Break Even,$0.75,$732.75,$265145.75,196,$732.75
2024-10-02,17:29:00,20018.5,BUY,3,0.02h,Break Even,$0.75,$733.50,$265146.50,196,$733.50
2024-10-02,17:35:00,19976.25,SELL,3,0.02h,Stop Loss,$75.75,$809.25,$265222.25,196,$809.25
2024-10-02,17:39:00,20005.75,BUY,3,0.02h,Stop Loss,$42.00,$851.25,$265264.25,196,$851.25
2024-10-02,18:25:00,20036.0,SELL,3,0.02h,Break Even,$0.75,$852.00,$265265.00,196,$852.00
2024-10-02,19:05:00,20028.75,BUY,3,0.02h,Break Even,$0.75,$852.75,$265265.75,196,$852.75
2024-10-02,19:41:00,20024.75,SELL,3,0.02h,Stop Loss,$-18.00,$834.75,$265247.75,196,$834.75
2024-10-02,19:45:00,20043.75,BUY,3,0.02h,Stop Loss,$68.25,$903.00,$265316.00,196,$903.00
2024-10-02,19:55:00,20030.75,SELL,3,0.02h,Stop Loss,$79.50,$982.50,$265395.50,196,$982.50
2024-10-02,20:11:00,20035.5,BUY,3,0.02h,Stop Loss,$12.00,$994.50,$265407.50,196,$994.50
2024-10-02,22:02:00,20049.0,SELL,3,0.02h,Stop Loss,$105.75,$1100.25,$265513.25,196,$1100.25
2024-10-02,22:10:00,20067.75,BUY,3,0.02h,Stop Loss,$-18.00,$1082.25,$265495.25,196,$1082.25
2024-10-02,22:16:00,20055.5,SELL,3,0.02h,Break Even,$0.75,$1083.00,$265496.00,196,$1083.00
,,,,,,,,,,,
2024-10-03,12:34:00,19982.75,BUY,3,0.02h,Stop Loss,$-18.00,$-18.00,$265478.00,197,$-18.00
2024-10-03,12:35:00,19964.25,SELL,3,0.02h,Stop Loss,$240.75,$222.75,$265718.75,197,$222.75
2024-10-03,13:33:00,19940.5,BUY,3,0.02h,Stop Loss,$278.25,$501.00,$265997.00,197,$501.00
2024-10-03,14:20:00,20028.25,SELL,3,0.02h,Stop Loss,$177.00,$678.00,$266174.00,197,$678.00
2024-10-03,14:52:00,20019.5,BUY,3,0.02h,Stop Loss,$27.00,$705.00,$266201.00,197,$705.00
2024-10-03,15:00:00,19939.75,SELL,3,0.02h,Stop Loss,$53.25,$758.25,$266254.25,197,$758.25
2024-10-03,15:17:00,19983.0,BUY,3,0.02h,Break Even,$0.75,$759.00,$266255.00,197,$759.00
2024-10-03,16:07:00,20030.0,SELL,3,0.02h,Stop Loss,$124.50,$883.50,$266379.50,197,$883.50
2024-10-03,16:11:00,20042.75,BUY,3,0.02h,Break Even,$0.75,$884.25,$266380.25,197,$884.25
2024-10-03,16:17:00,20032.25,SELL,3,0.02h,Stop Loss,$60.75,$945.00,$266441.00,197,$945.00
2024-10-03,16:23:00,20047.5,BUY,3,0.02h,Stop Loss,$-18.00,$927.00,$266423.00,197,$927.00
2024-10-03,16:31:00,20014.0,SELL,3,0.02h,Stop Loss,$27.00,$954.00,$266450.00,197,$954.00
2024-10-03,17:22:00,19936.75,BUY,3,0.02h,Stop Loss,$109.50,$1063.50,$266559.50,197,$1063.50
2024-10-03,17:43:00,19937.75,SELL,3,0.02h,Break Even,$0.75,$1064.25,$266560.25,197,$1064.25
2024-10-03,17:46:00,19960.25,BUY,3,0.02h,Stop Loss,$15.75,$1080.00,$266576.00,197,$1080.00
2024-10-03,17:51:00,19941.5,SELL,3,0.02h,Break Even,$0.75,$1080.75,$266576.75,197,$1080.75
2024-10-03,17:55:00,19956.25,BUY,3,0.02h,Stop Loss,$90.75,$1171.50,$266667.50,197,$1171.50
2024-10-03,18:18:00,19955.75,SELL,3,0.02h,Break Even,$0.75,$1172.25,$266668.25,197,$1172.25
2024-10-03,18:20:00,19965.75,BUY,3,0.02h,Break Even,$0.75,$1173.00,$266669.00,197,$1173.00
2024-10-03,18:23:00,19933.75,SELL,3,0.02h,Break Even,$0.75,$1173.75,$266669.75,197,$1173.75
2024-10-03,18:41:00,19956.5,BUY,3,0.02h,Stop Loss,$75.75,$1249.50,$266745.50,197,$1249.50
2024-10-03,18:58:00,19948.5,SELL,3,0.02h,Stop Loss,$30.75,$1280.25,$266776.25,197,$1280.25
2024-10-03,19:25:00,19940.0,BUY,3,0.02h,Break Even,$0.75,$1281.00,$266777.00,197,$1281.00
2024-10-03,19:29:00,19918.0,SELL,3,0.02h,Stop Loss,$-18.00,$1263.00,$266759.00,197,$1263.00
2024-10-03,19:35:00,19944.25,BUY,3,0.02h,Stop Loss,$27.00,$1290.00,$266786.00,197,$1290.00
2024-10-03,20:26:00,19983.5,SELL,3,0.02h,Break Even,$0.75,$1290.75,$266786.75,197,$1290.75
2024-10-03,22:29:00,19955.75,BUY,3,0.02h,Stop Loss,$-18.00,$1272.75,$266768.75,197,$1272.75
,,,,,,,,,,,
2024-10-04,13:25:00,20225.0,SELL,3,0.02h,Break Even,$0.75,$0.75,$266769.50,198,$0.75
2024-10-04,14:44:00,20079.25,BUY,3,0.02h,Stop Loss,$203.25,$204.00,$266972.75,198,$204.00
2024-10-04,15:16:00,20099.0,SELL,3,0.02h,Break Even,$0.75,$204.75,$266973.50,198,$204.75
2024-10-04,15:53:00,20088.0,BUY,3,0.02h,Stop Loss,$173.25,$378.00,$267146.75,198,$378.00
2024-10-04,16:14:00,20100.25,SELL,3,0.02h,Stop Loss,$75.75,$453.75,$267222.50,198,$453.75
2024-10-04,16:34:00,20111.75,BUY,3,0.02h,Stop Loss,$-18.00,$435.75,$267204.50,198,$435.75
2024-10-04,17:03:00,20142.75,SELL,3,0.02h,Stop Loss,$-18.00,$417.75,$267186.50,198,$417.75
2024-10-04,17:16:00,20156.5,BUY,3,0.02h,Stop Loss,$102.00,$519.75,$267288.50,198,$519.75
2024-10-04,17:30:00,20145.0,SELL,3,0.02h,Stop Loss,$42.00,$561.75,$267330.50,198,$561.75
2024-10-04,17:45:00,20168.0,BUY,3,0.02h,Stop Loss,$-18.00,$543.75,$267312.50,198,$543.75
2024-10-04,17:54:00,20130.0,SELL,3,0.02h,Stop Loss,$60.75,$604.50,$267373.25,198,$604.50
2024-10-04,18:23:00,20141.75,BUY,3,0.02h,Stop Loss,$-18.00,$586.50,$267355.25,198,$586.50
2024-10-04,20:17:00,20214.0,SELL,3,0.02h,Stop Loss,$-18.00,$568.50,$267337.25,198,$568.50
,,,,,,,,,,,
2024-10-07,12:38:00,20136.0,BUY,3,0.02h,Stop Loss,$-18.00,$-18.00,$267319.25,199,$-18.00
2024-10-07,12:55:00,20132.25,SELL,3,0.02h,Stop Loss,$45.75,$27.75,$267365.00,199,$27.75
2024-10-07,13:09:00,20142.5,BUY,3,0.02h,Stop Loss,$-18.00,$9.75,$267347.00,199,$9.75
2024-10-07,13:44:00,20118.75,SELL,3,0.02h,Stop Loss,$124.50,$134.25,$267471.50,199,$134.25
2024-10-07,14:06:00,20142.5,BUY,3,0.02h,Stop Loss,$-18.00,$116.25,$267453.50,199,$116.25
2024-10-07,14:45:00,20147.75,SELL,3,0.02h,Stop Loss,$38.25,$154.50,$267491.75,199,$154.50
2024-10-07,14:57:00,20165.25,BUY,3,0.02h,Stop Loss,$98.25,$252.75,$267590.00,199,$252.75
2024-10-07,15:02:00,20142.75,SELL,3,0.02h,Stop Loss,$203.25,$456.00,$267793.25,199,$456.00
2024-10-07,15:15:00,20158.75,BUY,3,0.02h,Break Even,$0.75,$456.75,$267794.00,199,$456.75
2024-10-07,15:39:00,20148.5,SELL,3,0.02h,Break Even,$0.75,$457.50,$267794.75,199,$457.50
2024-10-07,15:41:00,20168.0,BUY,3,0.02h,Break Even,$0.75,$458.25,$267795.50,199,$458.25
2024-10-07,15:44:00,20149.25,SELL,3,0.02h,Break Even,$0.75,$459.00,$267796.25,199,$459.00
2024-10-07,16:18:00,20159.5,BUY,3,0.02h,Break Even,$0.75,$459.75,$267797.00,199,$459.75
2024-10-07,16:33:00,20137.0,SELL,3,0.02h,Break Even,$0.75,$460.50,$267797.75,199,$460.50
2024-10-07,17:03:00,20150.25,BUY,3,0.02h,Stop Loss,$19.50,$480.00,$267817.25,199,$480.00
2024-10-07,17:24:00,20132.75,SELL,3,0.02h,Stop Loss,$-18.00,$462.00,$267799.25,199,$462.00
2024-10-07,17:57:00,20134.25,BUY,3,0.02h,Stop Loss,$34.50,$496.50,$267833.75,199,$496.50
2024-10-07,18:03:00,20121.5,SELL,3,0.02h,Stop Loss,$42.00,$538.50,$267875.75,199,$538.50
2024-10-07,19:23:00,20015.75,BUY,3,0.02h,Stop Loss,$23.25,$561.75,$267899.00,199,$561.75
2024-10-07,19:29:00,19994.75,SELL,3,0.02h,Stop Loss,$38.25,$600.00,$267937.25,199,$600.00
2024-10-07,19:52:00,20008.75,BUY,3,0.02h,Stop Loss,$45.75,$645.75,$267983.00,199,$645.75
2024-10-07,20:56:00,20018.5,SELL,3,0.02h,Break Even,$0.75,$646.50,$267983.75,199,$646.50
2024-10-07,22:02:00,20029.0,BUY,3,0.02h,Break Even,$0.75,$647.25,$267984.50,199,$647.25
2024-10-07,22:05:00,20017.5,SELL,3,0.02h,Stop Loss,$79.50,$726.75,$268064.00,199,$726.75
,,,,,,,,,,,
2024-10-08,12:00:00,20094.0,BUY,3,0.02h,Stop Loss,$23.25,$23.25,$268087.25,200,$23.25
2024-10-08,12:42:00,20061.75,SELL,3,0.02h,Stop Loss,$-18.00,$5.25,$268069.25,200,$5.25
2024-10-08,13:05:00,20067.0,BUY,3,0.02h,Break Even,$0.75,$6.00,$268070.00,200,$6.00
2024-10-08,13:06:00,20064.0,SELL,3,0.02h,Stop Loss,$23.25,$29.25,$268093.25,200,$29.25
2024-10-08,13:10:00,20072.0,BUY,3,0.02h,Stop Loss,$30.75,$60.00,$268124.00,200,$60.00
2024-10-08,15:12:00,20228.25,SELL,3,0.02h,Stop Loss,$38.25,$98.25,$268162.25,200,$98.25
2024-10-08,15:42:00,20235.5,BUY,3,0.02h,Stop Loss,$34.50,$132.75,$268196.75,200,$132.75
2024-10-08,16:04:00,20230.25,SELL,3,0.02h,Stop Loss,$87.00,$219.75,$268283.75,200,$219.75
2024-10-08,16:23:00,20233.5,BUY,3,0.02h,Break Even,$0.75,$220.50,$268284.50,200,$220.50
2024-10-08,16:25:00,20224.0,SELL,3,0.02h,Stop Loss,$-18.00,$202.50,$268266.50,200,$202.50
2024-10-08,16:28:00,20238.5,BUY,3,0.02h,Break Even,$0.75,$203.25,$268267.25,200,$203.25
2024-10-08,16:50:00,20222.75,SELL,3,0.02h,Stop Loss,$45.75,$249.00,$268313.00,200,$249.00
2024-10-08,17:01:00,20234.5,BUY,3,0.02h,Stop Loss,$-18.00,$231.00,$268295.00,200,$231.00
2024-10-08,17:02:00,20230.75,SELL,3,0.02h,Stop Loss,$27.00,$258.00,$268322.00,200,$258.00
2024-10-08,17:35:00,20207.75,BUY,3,0.02h,Stop Loss,$98.25,$356.25,$268420.25,200,$356.25
2024-10-08,18:32:00,20228.0,SELL,3,0.02h,Stop Loss,$23.25,$379.50,$268443.50,200,$379.50
2024-10-08,18:36:00,20242.0,BUY,3,0.02h,Break Even,$0.75,$380.25,$268444.25,200,$380.25
2024-10-08,20:01:00,20286.5,SELL,3,0.02h,Stop Loss,$49.50,$429.75,$268493.75,200,$429.75
2024-10-08,20:38:00,20292.5,BUY,3,0.02h,Break Even,$0.75,$430.50,$268494.50,200,$430.50
2024-10-08,20:56:00,20280.5,SELL,3,0.02h,Stop Loss,$-18.00,$412.50,$268476.50,200,$412.50
2024-10-08,22:26:00,20286.25,BUY,3,0.02h,Stop Loss,$-18.00,$394.50,$268458.50,200,$394.50
2024-10-08,22:27:00,20284.25,SELL,3,0.03h,Break Even,$0.75,$395.25,$268459.25,200,$395.25
2024-10-08,22:56:00,20284.5,BUY,3,0.02h,Stop Loss,$94.50,$489.75,$268553.75,200,$489.75
,,,,,,,,,,,
2024-10-09,12:00:00,20257.25,SELL,3,0.02h,Break Even,$0.75,$0.75,$268554.50,201,$0.75
2024-10-09,12:30:00,20271.75,BUY,3,0.02h,Stop Loss,$-18.00,$-17.25,$268536.50,201,$-17.25
2024-10-09,12:45:00,20264.5,SELL,3,0.02h,Stop Loss,$49.50,$32.25,$268586.00,201,$32.25
2024-10-09,12:57:00,20272.75,BUY,3,0.02h,Break Even,$0.75,$33.00,$268586.75,201,$33.00
2024-10-09,13:31:00,20284.25,SELL,3,0.02h,Stop Loss,$244.50,$277.50,$268831.25,201,$277.50
2024-10-09,14:02:00,20271.25,BUY,3,0.02h,Stop Loss,$34.50,$312.00,$268865.75,201,$312.00
2024-10-09,14:48:00,20321.5,SELL,3,0.02h,Break Even,$0.75,$312.75,$268866.50,201,$312.75
2024-10-09,14:58:00,20347.75,BUY,3,0.02h,Stop Loss,$15.75,$328.50,$268882.25,201,$328.50
2024-10-09,16:06:00,20403.5,SELL,3,0.02h,Break Even,$0.75,$329.25,$268883.00,201,$329.25
2024-10-09,16:31:00,20409.0,BUY,3,0.02h,Stop Loss,$64.50,$393.75,$268947.50,201,$393.75
2024-10-09,16:53:00,20403.75,SELL,3,0.02h,Stop Loss,$109.50,$503.25,$269057.00,201,$503.25
2024-10-09,17:14:00,20407.0,BUY,3,0.02h,Break Even,$0.75,$504.00,$269057.75,201,$504.00
2024-10-09,17:52:00,20411.5,SELL,3,0.02h,Stop Loss,$229.50,$733.50,$269287.25,201,$733.50
2024-10-09,18:08:00,20410.5,BUY,3,0.02h,Break Even,$0.75,$734.25,$269288.00,201,$734.25
2024-10-09,18:12:00,20400.0,SELL,3,0.02h,Stop Loss,$27.00,$761.25,$269315.00,201,$761.25
2024-10-09,18:15:00,20410.75,BUY,3,0.02h,Stop Loss,$-18.00,$743.25,$269297.00,201,$743.25
2024-10-09,18:17:00,20401.5,SELL,3,0.02h,Break Even,$0.75,$744.00,$269297.75,201,$744.00
2024-10-09,18:25:00,20413.25,BUY,3,0.02h,Stop Loss,$173.25,$917.25,$269471.00,201,$917.25
2024-10-09,19:01:00,20427.75,SELL,3,0.02h,Stop Loss,$53.25,$970.50,$269524.25,201,$970.50
2024-10-09,19:06:00,20441.25,BUY,3,0.02h,Stop Loss,$-18.00,$952.50,$269506.25,201,$952.50
2024-10-09,19:08:00,20420.5,SELL,3,0.02h,Stop Loss,$79.50,$1032.00,$269585.75,201,$1032.00
2024-10-09,19:19:00,20435.0,BUY,3,0.02h,Stop Loss,$12.00,$1044.00,$269597.75,201,$1044.00
2024-10-09,20:03:00,20441.25,SELL,3,0.02h,Stop Loss,$30.75,$1074.75,$269628.50,201,$1074.75
2024-10-09,20:38:00,20436.75,BUY,3,0.02h,Stop Loss,$-18.00,$1056.75,$269610.50,201,$1056.75
2024-10-09,22:09:00,20437.0,SELL,3,0.02h,Stop Loss,$-18.00,$1038.75,$269592.50,201,$1038.75
2024-10-09,22:13:00,20440.0,BUY,3,0.02h,Break Even,$0.75,$1039.50,$269593.25,201,$1039.50
2024-10-09,22:15:00,20437.0,SELL,3,0.02h,Stop Loss,$-18.00,$1021.50,$269575.25,201,$1021.50
2024-10-09,22:17:00,20441.0,BUY,3,0.02h,Break Even,$0.75,$1022.25,$269576.00,201,$1022.25
,,,,,,,,,,,
2024-10-10,12:00:00,20437.25,SELL,3,0.02h,Break Even,$0.75,$0.75,$269576.75,202,$0.75
2024-10-10,12:09:00,20450.75,BUY,3,0.02h,Break Even,$0.75,$1.50,$269577.50,202,$1.50
2024-10-10,12:16:00,20444.75,SELL,3,0.02h,Break Even,$0.75,$2.25,$269578.25,202,$2.25
2024-10-10,13:05:00,20380.25,BUY,3,0.02h,Break Even,$0.75,$3.00,$269579.00,202,$3.00
2024-10-10,13:10:00,20362.5,SELL,3,0.02h,Stop Loss,$64.50,$67.50,$269643.50,202,$67.50
2024-10-10,13:32:00,20380.25,BUY,3,0.02h,Stop Loss,$83.25,$150.75,$269726.75,202,$150.75
2024-10-10,13:48:00,20331.75,SELL,3,0.02h,Stop Loss,$233.25,$384.00,$269960.00,202,$384.00
2024-10-10,13:58:00,20371.25,BUY,3,0.02h,Stop Loss,$98.25,$482.25,$270058.25,202,$482.25
2024-10-10,14:26:00,20381.0,SELL,3,0.02h,Break Even,$0.75,$483.00,$270059.00,202,$483.00
2024-10-10,14:27:00,20391.75,BUY,3,0.02h,Stop Loss,$229.50,$712.50,$270288.50,202,$712.50
2024-10-10,14:35:00,20380.0,SELL,3,0.02h,Stop Loss,$42.00,$754.50,$270330.50,202,$754.50
2024-10-10,14:44:00,20410.0,BUY,3,0.02h,Stop Loss,$79.50,$834.00,$270410.00,202,$834.00
2024-10-10,14:54:00,20377.25,SELL,3,0.02h,Stop Loss,$45.75,$879.75,$270455.75,202,$879.75
2024-10-10,15:08:00,20403.25,BUY,3,0.02h,Stop Loss,$113.25,$993.00,$270569.00,202,$993.00
2024-10-10,16:28:00,20478.75,SELL,3,0.02h,Stop Loss,$135.75,$1128.75,$270704.75,202,$1128.75
2024-10-10,17:21:00,20455.75,BUY,3,0.02h,Stop Loss,$53.25,$1182.00,$270758.00,202,$1182.00
2024-10-10,17:47:00,20446.5,SELL,3,0.02h,Stop Loss,$207.00,$1389.00,$270965.00,202,$1389.00
2024-10-10,18:50:00,20411.0,BUY,3,0.02h,Stop Loss,$-18.00,$1371.00,$270947.00,202,$1371.00
2024-10-10,18:51:00,20402.5,SELL,3,0.02h,Stop Loss,$-18.00,$1353.00,$270929.00,202,$1353.00
2024-10-10,18:53:00,20410.25,BUY,3,0.02h,Break Even,$0.75,$1353.75,$270929.75,202,$1353.75
2024-10-10,19:05:00,20401.5,SELL,3,0.02h,Stop Loss,$87.00,$1440.75,$271016.75,202,$1440.75
2024-10-10,19:20:00,20413.5,BUY,3,0.02h,Stop Loss,$19.50,$1460.25,$271036.25,202,$1460.25
2024-10-10,19:37:00,20404.5,SELL,3,0.02h,Stop Loss,$68.25,$1528.50,$271104.50,202,$1528.50
2024-10-10,19:48:00,20416.5,BUY,3,0.02h,Break Even,$0.75,$1529.25,$271105.25,202,$1529.25
2024-10-10,20:10:00,20420.0,SELL,3,0.02h,Stop Loss,$-18.00,$1511.25,$271087.25,202,$1511.25
2024-10-10,20:17:00,20430.0,BUY,3,0.02h,Stop Loss,$-18.00,$1493.25,$271069.25,202,$1493.25
2024-10-10,22:01:00,20432.0,SELL,3,0.02h,Stop Loss,$15.75,$1509.00,$271085.00,202,$1509.00
2024-10-10,22:24:00,20433.0,BUY,3,0.02h,Stop Loss,$-18.00,$1491.00,$271067.00,202,$1491.00
2024-10-10,22:39:00,20430.5,SELL,3,0.02h,Break Even,$0.75,$1491.75,$271067.75,202,$1491.75
2024-10-10,22:40:00,20433.75,BUY,3,0.02h,Break Even,$0.75,$1492.50,$271068.50,202,$1492.50
2024-10-10,22:56:00,20433.0,SELL,3,0.02h,Stop Loss,$-18.00,$1474.50,$271050.50,202,$1474.50
,,,,,,,,,,,
2024-10-11,12:32:00,20408.25,BUY,3,0.02h,Stop Loss,$34.50,$34.50,$271085.00,203,$34.50
2024-10-11,12:39:00,20383.75,SELL,3,0.02h,Stop Loss,$135.75,$170.25,$271220.75,203,$170.25
2024-10-11,13:48:00,20354.5,BUY,3,0.02h,Break Even,$0.75,$171.00,$271221.50,203,$171.00
2024-10-11,14:46:00,20434.25,SELL,3,0.02h,Stop Loss,$-18.00,$153.00,$271203.50,203,$153.00
2024-10-11,15:04:00,20441.5,BUY,3,0.02h,Stop Loss,$117.00,$270.00,$271320.50,203,$270.00
2024-10-11,15:19:00,20423.5,SELL,3,0.02h,Stop Loss,$162.00,$432.00,$271482.50,203,$432.00
2024-10-11,15:34:00,20442.75,BUY,3,0.02h,Stop Loss,$57.00,$489.00,$271539.50,203,$489.00
2024-10-11,16:16:00,20452.75,SELL,3,0.02h,Stop Loss,$34.50,$523.50,$271574.00,203,$523.50
2024-10-11,16:59:00,20439.5,BUY,3,0.02h,Break Even,$0.75,$524.25,$271574.75,203,$524.25
2024-10-11,17:14:00,20424.25,SELL,3,0.02h,Stop Loss,$-18.00,$506.25,$271556.75,203,$506.25
2024-10-11,17:25:00,20437.75,BUY,3,0.02h,Stop Loss,$23.25,$529.50,$271580.00,203,$529.50
2024-10-11,18:01:00,20437.5,SELL,3,0.02h,Break Even,$0.75,$530.25,$271580.75,203,$530.25
2024-10-11,18:06:00,20444.5,BUY,3,0.02h,Break Even,$0.75,$531.00,$271581.50,203,$531.00
2024-10-11,18:37:00,20454.0,SELL,3,0.02h,Stop Loss,$12.00,$543.00,$271593.50,203,$543.00
2024-10-11,18:49:00,20459.0,BUY,3,0.02h,Break Even,$0.75,$543.75,$271594.25,203,$543.75
2024-10-11,19:38:00,20473.5,SELL,3,0.02h,Stop Loss,$30.75,$574.50,$271625.00,203,$574.50
,,,,,,,,,,,
2024-10-14,12:00:00,20506.75,BUY,3,0.02h,Break Even,$0.75,$0.75,$271625.75,204,$0.75
2024-10-14,13:30:00,20550.5,SELL,3,0.02h,Stop Loss,$98.25,$99.00,$271724.00,204,$99.00
2024-10-14,13:32:00,20557.0,BUY,3,0.02h,Stop Loss,$207.00,$306.00,$271931.00,204,$306.00
2024-10-14,14:14:00,20627.75,SELL,3,0.02h,Stop Loss,$27.00,$333.00,$271958.00,204,$333.00
2024-10-14,14:29:00,20638.25,BUY,3,0.02h,Stop Loss,$53.25,$386.25,$272011.25,204,$386.25
2024-10-14,14:46:00,20627.0,SELL,3,0.02h,Stop Loss,$12.00,$398.25,$272023.25,204,$398.25
2024-10-14,15:22:00,20578.5,BUY,3,0.02h,Stop Loss,$79.50,$477.75,$272102.75,204,$477.75
2024-10-14,15:26:00,20561.0,SELL,3,0.02h,Stop Loss,$150.75,$628.50,$272253.50,204,$628.50
2024-10-14,15:48:00,20568.0,BUY,3,0.02h,Stop Loss,$27.00,$655.50,$272280.50,204,$655.50
2024-10-14,16:58:00,20601.25,SELL,3,0.02h,Stop Loss,$-18.00,$637.50,$272262.50,204,$637.50
2024-10-14,17:04:00,20618.5,BUY,3,0.02h,Stop Loss,$19.50,$657.00,$272282.00,204,$657.00
2024-10-14,17:11:00,20606.75,SELL,3,0.02h,Stop Loss,$64.50,$721.50,$272346.50,204,$721.50
2024-10-14,17:27:00,20611.5,BUY,3,0.02h,Stop Loss,$-18.00,$703.50,$272328.50,204,$703.50
2024-10-14,17:34:00,20600.0,SELL,3,0.02h,Stop Loss,$38.25,$741.75,$272366.75,204,$741.75
2024-10-14,17:39:00,20612.5,BUY,3,0.02h,Break Even,$0.75,$742.50,$272367.50,204,$742.50
2024-10-14,18:01:00,20603.0,SELL,3,0.02h,Break Even,$0.75,$743.25,$272368.25,204,$743.25
2024-10-14,18:06:00,20611.0,BUY,3,0.02h,Break Even,$0.75,$744.00,$272369.00,204,$744.00
2024-10-14,19:01:00,20620.0,SELL,3,0.02h,Stop Loss,$15.75,$759.75,$272384.75,204,$759.75
2024-10-14,19:15:00,20627.25,BUY,3,0.02h,Stop Loss,$38.25,$798.00,$272423.00,204,$798.00
2024-10-14,19:55:00,20633.5,SELL,3,0.02h,Stop Loss,$79.50,$877.50,$272502.50,204,$877.50
2024-10-14,20:44:00,20627.5,BUY,3,0.02h,Stop Loss,$-18.00,$859.50,$272484.50,204,$859.50
2024-10-14,22:12:00,20625.0,SELL,3,0.03h,Break Even,$0.75,$860.25,$272485.25,204,$860.25
2024-10-14,22:29:00,20631.0,BUY,3,0.02h,Stop Loss,$-18.00,$842.25,$272467.25,204,$842.25
2024-10-14,22:36:00,20624.75,SELL,3,0.02h,Break Even,$0.75,$843.00,$272468.00,204,$843.00
2024-10-14,22:59:00,20625.5,BUY,3,13.02h,Stop Loss,$-18.00,$825.00,$272450.00,204,$825.00
,,,,,,,,,,,
2024-10-15,12:00:00,20613.0,SELL,3,0.02h,Stop Loss,$19.50,$19.50,$272469.50,205,$19.50
2024-10-15,12:19:00,20628.5,BUY,3,0.02h,Break Even,$0.75,$20.25,$272470.25,205,$20.25
2024-10-15,12:27:00,20614.5,SELL,3,0.02h,Break Even,$0.75,$21.00,$272471.00,205,$21.00
2024-10-15,12:53:00,20616.75,BUY,3,0.02h,Stop Loss,$23.25,$44.25,$272494.25,205,$44.25
2024-10-15,13:30:00,20631.25,SELL,3,0.02h,Stop Loss,$334.50,$378.75,$272828.75,205,$378.75
2024-10-15,13:55:00,20639.75,BUY,3,0.02h,Stop Loss,$210.75,$589.50,$273039.50,205,$589.50
2024-10-15,14:10:00,20621.25,SELL,3,0.02h,Stop Loss,$240.75,$830.25,$273280.25,205,$830.25
2024-10-15,15:16:00,20436.0,BUY,3,0.02h,Stop Loss,$60.75,$891.00,$273341.00,205,$891.00
2024-10-15,15:26:00,20402.75,SELL,3,0.02h,Stop Loss,$27.00,$918.00,$273368.00,205,$918.00
2024-10-15,15:34:00,20422.75,BUY,3,0.02h,Stop Loss,$113.25,$1031.25,$273481.25,205,$1031.25
2024-10-15,15:40:00,20400.0,SELL,3,0.02h,Stop Loss,$94.50,$1125.75,$273575.75,205,$1125.75
2024-10-15,16:11:00,20390.5,BUY,3,0.02h,Stop Loss,$15.75,$1141.50,$273591.50,205,$1141.50
2024-10-15,16:46:00,20391.5,SELL,3,0.02h,Stop Loss,$135.75,$1277.25,$273727.25,205,$1277.25
2024-10-15,17:41:00,20373.0,BUY,3,0.02h,Break Even,$0.75,$1278.00,$273728.00,205,$1278.00
2024-10-15,17:58:00,20356.25,SELL,3,0.02h,Stop Loss,$-18.00,$1260.00,$273710.00,205,$1260.00
2024-10-15,18:04:00,20385.25,BUY,3,0.02h,Break Even,$0.75,$1260.75,$273710.75,205,$1260.75
2024-10-15,18:10:00,20364.75,SELL,3,0.02h,Stop Loss,$12.00,$1272.75,$273722.75,205,$1272.75
2024-10-15,18:22:00,20378.75,BUY,3,0.02h,Break Even,$0.75,$1273.50,$273723.50,205,$1273.50
2024-10-15,18:34:00,20363.0,SELL,3,0.02h,Stop Loss,$34.50,$1308.00,$273758.00,205,$1308.00
2024-10-15,19:43:00,20306.75,BUY,3,0.02h,Break Even,$0.75,$1308.75,$273758.75,205,$1308.75
2024-10-15,20:18:00,20321.75,SELL,3,0.02h,Stop Loss,$-18.00,$1290.75,$273740.75,205,$1290.75
2024-10-15,20:25:00,20336.5,BUY,3,0.02h,Break Even,$0.75,$1291.50,$273741.50,205,$1291.50
2024-10-15,20:47:00,20332.5,SELL,3,0.02h,Stop Loss,$-18.00,$1273.50,$273723.50,205,$1273.50
2024-10-15,20:49:00,20336.5,BUY,3,0.02h,Break Even,$0.75,$1274.25,$273724.25,205,$1274.25
2024-10-15,20:57:00,20333.75,SELL,3,0.02h,Break Even,$0.75,$1275.00,$273725.00,205,$1275.00
2024-10-15,22:22:00,20329.25,BUY,3,0.02h,Stop Loss,$-18.00,$1257.00,$273707.00,205,$1257.00
,,,,,,,,,,,
2024-10-16,12:21:00,20354.75,SELL,3,0.02h,Break Even,$0.75,$0.75,$273707.75,206,$0.75
2024-10-16,12:53:00,20359.75,BUY,3,0.02h,Break Even,$0.75,$1.50,$273708.50,206,$1.50
2024-10-16,13:00:00,20351.25,SELL,3,0.02h,Break Even,$0.75,$2.25,$273709.25,206,$2.25
2024-10-16,13:01:00,20355.5,BUY,3,0.02h,Break Even,$0.75,$3.00,$273710.00,206,$3.00
2024-10-16,13:23:00,20355.5,SELL,3,0.02h,Break Even,$0.75,$3.75,$273710.75,206,$3.75
2024-10-16,14:09:00,20265.5,BUY,3,0.02h,Stop Loss,$274.50,$278.25,$273985.25,206,$278.25
2024-10-16,14:40:00,20280.0,SELL,3,0.02h,Stop Loss,$154.50,$432.75,$274139.75,206,$432.75
2024-10-16,15:12:00,20297.0,BUY,3,0.02h,Stop Loss,$90.75,$523.50,$274230.50,206,$523.50
2024-10-16,15:47:00,20294.5,SELL,3,0.02h,Stop Loss,$90.75,$614.25,$274321.25,206,$614.25
2024-10-16,16:11:00,20298.75,BUY,3,0.02h,Break Even,$0.75,$615.00,$274322.00,206,$615.00
2024-10-16,16:14:00,20279.75,SELL,3,0.02h,Break Even,$0.75,$615.75,$274322.75,206,$615.75
2024-10-16,16:24:00,20296.0,BUY,3,0.02h,Stop Loss,$12.00,$627.75,$274334.75,206,$627.75
2024-10-16,17:19:00,20313.0,SELL,3,0.02h,Stop Loss,$49.50,$677.25,$274384.25,206,$677.25
2024-10-16,17:35:00,20326.0,BUY,3,0.02h,Break Even,$0.75,$678.00,$274385.00,206,$678.00
2024-10-16,17:41:00,20311.25,SELL,3,0.02h,Break Even,$0.75,$678.75,$274385.75,206,$678.75
2024-10-16,17:44:00,20326.25,BUY,3,0.02h,Stop Loss,$38.25,$717.00,$274424.00,206,$717.00
2024-10-16,18:08:00,20323.75,SELL,3,0.02h,Stop Loss,$34.50,$751.50,$274458.50,206,$751.50
2024-10-16,18:11:00,20336.25,BUY,3,0.02h,Break Even,$0.75,$752.25,$274459.25,206,$752.25
2024-10-16,19:02:00,20356.75,SELL,3,0.02h,Stop Loss,$30.75,$783.00,$274490.00,206,$783.00
2024-10-16,19:12:00,20364.25,BUY,3,0.02h,Stop Loss,$-18.00,$765.00,$274472.00,206,$765.00
2024-10-16,19:13:00,20358.0,SELL,3,0.02h,Break Even,$0.75,$765.75,$274472.75,206,$765.75
2024-10-16,19:17:00,20361.75,BUY,3,0.02h,Break Even,$0.75,$766.50,$274473.50,206,$766.50
2024-10-16,19:18:00,20358.5,SELL,3,0.02h,Break Even,$0.75,$767.25,$274474.25,206,$767.25
2024-10-16,20:32:00,20339.0,BUY,3,0.02h,Break Even,$0.75,$768.00,$274475.00,206,$768.00
2024-10-16,20:50:00,20333.25,SELL,3,0.02h,Stop Loss,$-18.00,$750.00,$274457.00,206,$750.00
2024-10-16,22:31:00,20328.5,BUY,3,0.02h,Stop Loss,$-18.00,$732.00,$274439.00,206,$732.00
2024-10-16,22:37:00,20323.75,SELL,3,0.02h,Stop Loss,$-18.00,$714.00,$274421.00,206,$714.00
2024-10-16,22:47:00,20328.5,BUY,3,0.02h,Break Even,$0.75,$714.75,$274421.75,206,$714.75
,,,,,,,,,,,
2024-10-17,13:31:00,20548.0,SELL,3,0.02h,Stop Loss,$79.50,$79.50,$274501.25,207,$79.50
2024-10-17,14:21:00,20444.5,BUY,3,0.02h,Stop Loss,$34.50,$114.00,$274535.75,207,$114.00
2024-10-17,14:38:00,20414.25,SELL,3,0.02h,Stop Loss,$154.50,$268.50,$274690.25,207,$268.50
2024-10-17,15:10:00,20424.0,BUY,3,0.02h,Stop Loss,$60.75,$329.25,$274751.00,207,$329.25
2024-10-17,16:23:00,20487.75,SELL,3,0.02h,Break Even,$0.75,$330.00,$274751.75,207,$330.00
2024-10-17,16:45:00,20488.25,BUY,3,0.02h,Stop Loss,$-18.00,$312.00,$274733.75,207,$312.00
2024-10-17,16:54:00,20471.75,SELL,3,0.02h,Stop Loss,$-18.00,$294.00,$274715.75,207,$294.00
2024-10-17,16:56:00,20486.25,BUY,3,0.02h,Stop Loss,$-18.00,$276.00,$274697.75,207,$276.00
2024-10-17,16:58:00,20474.25,SELL,3,0.02h,Stop Loss,$229.50,$505.50,$274927.25,207,$505.50
2024-10-17,17:05:00,20489.5,BUY,3,0.02h,Stop Loss,$-18.00,$487.50,$274909.25,207,$487.50
2024-10-17,17:20:00,20475.5,SELL,3,0.02h,Break Even,$0.75,$488.25,$274910.00,207,$488.25
2024-10-17,17:40:00,20478.0,BUY,3,0.02h,Break Even,$0.75,$489.00,$274910.75,207,$489.00
2024-10-17,17:57:00,20476.75,SELL,3,0.02h,Stop Loss,$53.25,$542.25,$274964.00,207,$542.25
2024-10-17,18:48:00,20413.25,BUY,3,0.02h,Stop Loss,$-18.00,$524.25,$274946.00,207,$524.25
2024-10-17,19:21:00,20409.0,SELL,3,0.02h,Stop Loss,$105.75,$630.00,$275051.75,207,$630.00
2024-10-17,20:02:00,20383.75,BUY,3,0.02h,Stop Loss,$79.50,$709.50,$275131.25,207,$709.50
2024-10-17,20:03:00,20372.75,SELL,3,0.02h,Break Even,$0.75,$710.25,$275132.00,207,$710.25
2024-10-17,20:04:00,20379.25,BUY,3,0.02h,Stop Loss,$19.50,$729.75,$275151.50,207,$729.75
2024-10-17,20:28:00,20388.75,SELL,3,0.02h,Stop Loss,$-18.00,$711.75,$275133.50,207,$711.75
2024-10-17,22:02:00,20388.0,BUY,3,0.02h,Stop Loss,$-18.00,$693.75,$275115.50,207,$693.75
2024-10-17,22:03:00,20385.25,SELL,3,0.02h,Stop Loss,$68.25,$762.00,$275183.75,207,$762.00
2024-10-17,22:14:00,20386.0,BUY,3,0.02h,Break Even,$0.75,$762.75,$275184.50,207,$762.75
,,,,,,,,,,,
2024-10-18,13:27:00,20462.0,SELL,3,0.02h,Break Even,$0.75,$0.75,$275185.25,208,$0.75
2024-10-18,13:44:00,20489.25,BUY,3,0.02h,Stop Loss,$147.00,$147.75,$275332.25,208,$147.75
2024-10-18,13:51:00,20463.0,SELL,3,0.02h,Stop Loss,$109.50,$257.25,$275441.75,208,$257.25
2024-10-18,13:56:00,20485.0,BUY,3,0.02h,Stop Loss,$12.00,$269.25,$275453.75,208,$269.25
2024-10-18,14:20:00,20487.5,SELL,3,0.02h,Stop Loss,$12.00,$281.25,$275465.75,208,$281.25
2024-10-18,14:22:00,20492.75,BUY,3,0.02h,Break Even,$0.75,$282.00,$275466.50,208,$282.00
2024-10-18,14:23:00,20487.5,SELL,3,0.02h,Stop Loss,$105.75,$387.75,$275572.25,208,$387.75
2024-10-18,14:25:00,20492.5,BUY,3,0.02h,Stop Loss,$12.00,$399.75,$275584.25,208,$399.75
2024-10-18,14:26:00,20487.0,SELL,3,0.02h,Break Even,$0.75,$400.50,$275585.00,208,$400.50
2024-10-18,14:27:00,20492.0,BUY,3,0.02h,Stop Loss,$-18.00,$382.50,$275567.00,208,$382.50
2024-10-18,14:28:00,20480.0,SELL,3,0.02h,Stop Loss,$42.00,$424.50,$275609.00,208,$424.50
2024-10-18,14:30:00,20499.5,BUY,3,0.02h,Stop Loss,$60.75,$485.25,$275669.75,208,$485.25
2024-10-18,14:37:00,20475.75,SELL,3,0.02h,Stop Loss,$30.75,$516.00,$275700.50,208,$516.00
2024-10-18,14:43:00,20494.25,BUY,3,0.02h,Break Even,$0.75,$516.75,$275701.25,208,$516.75
2024-10-18,14:53:00,20481.75,SELL,3,0.02h,Stop Loss,$57.00,$573.75,$275758.25,208,$573.75
2024-10-18,15:07:00,20487.5,BUY,3,0.02h,Stop Loss,$30.75,$604.50,$275789.00,208,$604.50
2024-10-18,15:39:00,20491.5,SELL,3,0.02h,Stop Loss,$-18.00,$586.50,$275771.00,208,$586.50
2024-10-18,16:33:00,20468.0,BUY,3,0.02h,Stop Loss,$53.25,$639.75,$275824.25,208,$639.75
2024-10-18,17:27:00,20500.75,SELL,3,0.02h,Stop Loss,$150.75,$790.50,$275975.00,208,$790.50
2024-10-18,17:47:00,20503.0,BUY,3,0.02h,Stop Loss,$-18.00,$772.50,$275957.00,208,$772.50
2024-10-18,17:51:00,20494.5,SELL,3,0.02h,Break Even,$0.75,$773.25,$275957.75,208,$773.25
2024-10-18,18:13:00,20495.75,BUY,3,0.02h,Break Even,$0.75,$774.00,$275958.50,208,$774.00
2024-10-18,18:38:00,20495.0,SELL,3,0.02h,Stop Loss,$42.00,$816.00,$276000.50,208,$816.00
2024-10-18,19:28:00,20490.5,BUY,3,0.02h,Stop Loss,$34.50,$850.50,$276035.00,208,$850.50
2024-10-18,19:35:00,20481.0,SELL,3,0.02h,Stop Loss,$27.00,$877.50,$276062.00,208,$877.50
2024-10-18,19:38:00,20489.25,BUY,3,0.02h,Stop Loss,$-18.00,$859.50,$276044.00,208,$859.50
2024-10-18,19:39:00,20481.0,SELL,3,0.02h,Break Even,$0.75,$860.25,$276044.75,208,$860.25
2024-10-18,19:58:00,20488.5,BUY,3,0.02h,Stop Loss,$-18.00,$842.25,$276026.75,208,$842.25
2024-10-18,20:30:00,20489.75,SELL,3,0.02h,Break Even,$0.75,$843.00,$276027.50,208,$843.00
2024-10-18,20:32:00,20491.0,BUY,3,0.03h,Break Even,$0.75,$843.75,$276028.25,208,$843.75
2024-10-18,20:35:00,20488.0,SELL,3,0.02h,Stop Loss,$-18.00,$825.75,$276010.25,208,$825.75
2024-10-18,20:40:00,20492.25,BUY,3,0.02h,Stop Loss,$-18.00,$807.75,$275992.25,208,$807.75
2024-10-18,20:49:00,20489.5,SELL,3,0.02h,Break Even,$0.75,$808.50,$275993.00,208,$808.50
,,,,,,,,,,,
2024-10-21,12:31:00,20390.75,BUY,3,0.02h,Break Even,$0.75,$0.75,$275993.75,209,$0.75
2024-10-21,12:41:00,20388.0,SELL,3,0.02h,Stop Loss,$-18.00,$-17.25,$275975.75,209,$-17.25
2024-10-21,12:42:00,20392.25,BUY,3,0.02h,Stop Loss,$-18.00,$-35.25,$275957.75,209,$-35.25
2024-10-21,12:43:00,20385.25,SELL,3,0.02h,Stop Loss,$-18.00,$-53.25,$275939.75,209,$-53.25
2024-10-21,12:46:00,20396.25,BUY,3,0.02h,Stop Loss,$-18.00,$-71.25,$275921.75,209,$-71.25
2024-10-21,14:29:00,20507.0,SELL,3,0.02h,Stop Loss,$42.00,$-29.25,$275963.75,209,$-29.25
2024-10-21,15:39:00,20379.75,BUY,3,0.02h,Stop Loss,$297.00,$267.75,$276260.75,209,$267.75
2024-10-21,16:29:00,20441.0,SELL,3,0.02h,Stop Loss,$-18.00,$249.75,$276242.75,209,$249.75
2024-10-21,16:35:00,20453.0,BUY,3,0.02h,Break Even,$0.75,$250.50,$276243.50,209,$250.50
2024-10-21,16:36:00,20444.0,SELL,3,0.02h,Stop Loss,$79.50,$330.00,$276323.00,209,$330.00
2024-10-21,16:50:00,20445.5,BUY,3,0.02h,Stop Loss,$19.50,$349.50,$276342.50,209,$349.50
2024-10-21,17:23:00,20463.75,SELL,3,0.02h,Stop Loss,$-18.00,$331.50,$276324.50,209,$331.50
2024-10-21,17:28:00,20474.0,BUY,3,0.02h,Stop Loss,$-18.00,$313.50,$276306.50,209,$313.50
2024-10-21,18:07:00,20478.25,SELL,3,0.02h,Stop Loss,$30.75,$344.25,$276337.25,209,$344.25
2024-10-21,18:17:00,20491.75,BUY,3,0.02h,Break Even,$0.75,$345.00,$276338.00,209,$345.00
2024-10-21,18:21:00,20480.5,SELL,3,0.02h,Stop Loss,$30.75,$375.75,$276368.75,209,$375.75
2024-10-21,19:11:00,20470.25,BUY,3,0.02h,Stop Loss,$-18.00,$357.75,$276350.75,209,$357.75
2024-10-21,19:32:00,20469.75,SELL,3,0.02h,Stop Loss,$15.75,$373.50,$276366.50,209,$373.50
2024-10-21,19:47:00,20481.75,BUY,3,0.02h,Stop Loss,$-18.00,$355.50,$276348.50,209,$355.50
2024-10-21,20:55:00,20536.75,SELL,3,0.02h,Stop Loss,$-18.00,$337.50,$276330.50,209,$337.50
2024-10-21,20:59:00,20543.75,BUY,3,0.02h,Stop Loss,$-18.00,$319.50,$276312.50,209,$319.50
2024-10-21,22:01:00,20536.75,SELL,3,0.02h,Stop Loss,$38.25,$357.75,$276350.75,209,$357.75
2024-10-21,22:16:00,20539.0,BUY,3,0.02h,Stop Loss,$-18.00,$339.75,$276332.75,209,$339.75
2024-10-21,22:17:00,20531.75,SELL,3,0.02h,Break Even,$0.75,$340.50,$276333.50,209,$340.50
,,,,,,,,,,,
2024-10-22,13:15:00,20391.75,BUY,3,0.02h,Break Even,$0.75,$0.75,$276334.25,210,$0.75
2024-10-22,14:40:00,20482.25,SELL,3,0.02h,Stop Loss,$-18.00,$-17.25,$276316.25,210,$-17.25
2024-10-22,14:56:00,20492.0,BUY,3,0.02h,Break Even,$0.75,$-16.50,$276317.00,210,$-16.50
2024-10-22,15:12:00,20479.0,SELL,3,0.02h,Stop Loss,$23.25,$6.75,$276340.25,210,$6.75
2024-10-22,15:33:00,20486.25,BUY,3,0.02h,Break Even,$0.75,$7.50,$276341.00,210,$7.50
2024-10-22,15:51:00,20474.75,SELL,3,0.02h,Stop Loss,$68.25,$75.75,$276409.25,210,$75.75
2024-10-22,15:56:00,20490.25,BUY,3,0.02h,Stop Loss,$-18.00,$57.75,$276391.25,210,$57.75
2024-10-22,16:00:00,20472.75,SELL,3,0.02h,Stop Loss,$79.50,$137.25,$276470.75,210,$137.25
2024-10-22,16:50:00,20463.25,BUY,3,0.02h,Stop Loss,$158.25,$295.50,$276629.00,210,$295.50
2024-10-22,18:14:00,20549.5,SELL,3,0.02h,Stop Loss,$23.25,$318.75,$276652.25,210,$318.75
2024-10-22,19:12:00,20543.25,BUY,3,0.02h,Break Even,$0.75,$319.50,$276653.00,210,$319.50
2024-10-22,19:43:00,20544.25,SELL,3,0.02h,Break Even,$0.75,$320.25,$276653.75,210,$320.25
2024-10-22,19:44:00,20548.25,BUY,3,0.02h,Break Even,$0.75,$321.00,$276654.50,210,$321.00
2024-10-22,20:01:00,20524.25,SELL,3,0.02h,Stop Loss,$207.00,$528.00,$276861.50,210,$528.00
2024-10-22,20:36:00,20527.25,BUY,3,0.02h,Break Even,$0.75,$528.75,$276862.25,210,$528.75
2024-10-22,20:46:00,20518.25,SELL,3,0.02h,Stop Loss,$-18.00,$510.75,$276844.25,210,$510.75
2024-10-22,20:50:00,20527.25,BUY,3,0.02h,Stop Loss,$-18.00,$492.75,$276826.25,210,$492.75
2024-10-22,20:51:00,20521.25,SELL,3,0.02h,Stop Loss,$-18.00,$474.75,$276808.25,210,$474.75
2024-10-22,20:52:00,20525.25,BUY,3,0.02h,Break Even,$0.75,$475.50,$276809.00,210,$475.50
2024-10-22,21:00:00,20517.5,SELL,3,1.02h,Stop Loss,$177.00,$652.50,$276986.00,210,$652.50
2024-10-22,22:34:00,20508.25,BUY,3,0.02h,Stop Loss,$-18.00,$634.50,$276968.00,210,$634.50
2024-10-22,22:40:00,20502.5,SELL,3,0.02h,Stop Loss,$-18.00,$616.50,$276950.00,210,$616.50
2024-10-22,22:47:00,20505.75,BUY,3,0.05h,Stop Loss,$-18.00,$598.50,$276932.00,210,$598.50
2024-10-22,22:51:00,20503.25,SELL,3,0.02h,Stop Loss,$-18.00,$580.50,$276914.00,210,$580.50
,,,,,,,,,,,
2024-10-23,12:20:00,20493.75,BUY,3,0.02h,Stop Loss,$-18.00,$-18.00,$276896.00,211,$-18.00
2024-10-23,12:34:00,20469.5,SELL,3,0.02h,Stop Loss,$45.75,$27.75,$276941.75,211,$27.75
2024-10-23,13:42:00,20436.75,BUY,3,0.02h,Stop Loss,$68.25,$96.00,$277010.00,211,$96.00
2024-10-23,13:45:00,20427.0,SELL,3,0.02h,Stop Loss,$113.25,$209.25,$277123.25,211,$209.25
2024-10-23,13:49:00,20442.25,BUY,3,0.02h,Stop Loss,$-18.00,$191.25,$277105.25,211,$191.25
2024-10-23,13:51:00,20423.5,SELL,3,0.02h,Stop Loss,$143.25,$334.50,$277248.50,211,$334.50
2024-10-23,13:57:00,20440.5,BUY,3,0.02h,Stop Loss,$57.00,$391.50,$277305.50,211,$391.50
2024-10-23,14:01:00,20418.75,SELL,3,0.02h,Stop Loss,$233.25,$624.75,$277538.75,211,$624.75
2024-10-23,14:30:00,20418.25,BUY,3,0.02h,Stop Loss,$90.75,$715.50,$277629.50,211,$715.50
2024-10-23,14:55:00,20407.75,SELL,3,0.02h,Stop Loss,$105.75,$821.25,$277735.25,211,$821.25
2024-10-23,15:46:00,20348.0,BUY,3,0.02h,Stop Loss,$15.75,$837.00,$277751.00,211,$837.00
2024-10-23,16:04:00,20296.0,SELL,3,0.02h,Stop Loss,$34.50,$871.50,$277785.50,211,$871.50
2024-10-23,16:49:00,20273.75,BUY,3,0.02h,Stop Loss,$53.25,$924.75,$277838.75,211,$924.75
2024-10-23,16:52:00,20256.5,SELL,3,0.02h,Stop Loss,$79.50,$1004.25,$277918.25,211,$1004.25
2024-10-23,18:26:00,20128.0,BUY,3,0.02h,Stop Loss,$72.00,$1076.25,$277990.25,211,$1076.25
2024-10-23,19:11:00,20166.25,SELL,3,0.02h,Stop Loss,$139.50,$1215.75,$278129.75,211,$1215.75
2024-10-23,19:19:00,20174.0,BUY,3,0.02h,Stop Loss,$72.00,$1287.75,$278201.75,211,$1287.75
2024-10-23,20:48:00,20278.0,SELL,3,0.02h,Stop Loss,$-18.00,$1269.75,$278183.75,211,$1269.75
2024-10-23,20:50:00,20283.25,BUY,3,0.02h,Stop Loss,$-18.00,$1251.75,$278165.75,211,$1251.75
2024-10-23,20:51:00,20281.0,SELL,3,0.02h,Stop Loss,$-18.00,$1233.75,$278147.75,211,$1233.75
2024-10-23,20:53:00,20286.25,BUY,3,0.03h,Break Even,$0.75,$1234.50,$278148.50,211,$1234.50
2024-10-23,20:56:00,20278.0,SELL,3,0.02h,Stop Loss,$53.25,$1287.75,$278201.75,211,$1287.75
2024-10-23,22:02:00,20293.5,BUY,3,0.02h,Break Even,$0.75,$1288.50,$278202.50,211,$1288.50
2024-10-23,22:18:00,20281.5,SELL,3,0.02h,Stop Loss,$-18.00,$1270.50,$278184.50,211,$1270.50
2024-10-23,22:26:00,20290.25,BUY,3,0.02h,Stop Loss,$-18.00,$1252.50,$278166.50,211,$1252.50
2024-10-23,22:32:00,20276.25,SELL,3,0.02h,Stop Loss,$-18.00,$1234.50,$278148.50,211,$1234.50
2024-10-23,22:58:00,20286.75,BUY,3,0.02h,Break Even,$0.75,$1235.25,$278149.25,211,$1235.25
,,,,,,,,,,,
2024-10-24,12:48:00,20398.0,SELL,3,0.02h,Stop Loss,$-18.00,$-18.00,$278131.25,212,$-18.00
2024-10-24,13:14:00,20402.5,BUY,3,0.02h,Break Even,$0.75,$-17.25,$278132.00,212,$-17.25
2024-10-24,13:22:00,20392.75,SELL,3,0.02h,Stop Loss,$23.25,$6.00,$278155.25,212,$6.00
2024-10-24,14:02:00,20351.0,BUY,3,0.02h,Stop Loss,$379.50,$385.50,$278534.75,212,$385.50
2024-10-24,14:23:00,20335.25,SELL,3,0.02h,Break Even,$0.75,$386.25,$278535.50,212,$386.25
2024-10-24,14:25:00,20357.5,BUY,3,0.02h,Break Even,$0.75,$387.00,$278536.25,212,$387.00
2024-10-24,14:27:00,20330.0,SELL,3,0.02h,Stop Loss,$237.00,$624.00,$278773.25,212,$624.00
2024-10-24,14:34:00,20355.25,BUY,3,0.02h,Stop Loss,$102.00,$726.00,$278875.25,212,$726.00
2024-10-24,14:49:00,20340.5,SELL,3,0.02h,Stop Loss,$90.75,$816.75,$278966.00,212,$816.75
2024-10-24,15:12:00,20340.75,BUY,3,0.02h,Break Even,$0.75,$817.50,$278966.75,212,$817.50
2024-10-24,15:30:00,20340.25,SELL,3,0.02h,Break Even,$0.75,$818.25,$278967.50,212,$818.25
2024-10-24,15:32:00,20347.0,BUY,3,0.02h,Break Even,$0.75,$819.00,$278968.25,212,$819.00
2024-10-24,15:33:00,20341.25,SELL,3,0.02h,Stop Loss,$49.50,$868.50,$279017.75,212,$868.50
2024-10-24,16:00:00,20327.75,BUY,3,0.02h,Stop Loss,$132.00,$1000.50,$279149.75,212,$1000.50
2024-10-24,16:07:00,20291.5,SELL,3,0.02h,Stop Loss,$124.50,$1125.00,$279274.25,212,$1125.00
2024-10-24,16:25:00,20307.0,BUY,3,0.02h,Stop Loss,$45.75,$1170.75,$279320.00,212,$1170.75
2024-10-24,17:23:00,20362.5,SELL,3,0.02h,Stop Loss,$34.50,$1205.25,$279354.50,212,$1205.25
2024-10-24,17:39:00,20369.75,BUY,3,0.02h,Break Even,$0.75,$1206.00,$279355.25,212,$1206.00
2024-10-24,17:52:00,20355.75,SELL,3,0.02h,Stop Loss,$12.00,$1218.00,$279367.25,212,$1218.00
2024-10-24,18:13:00,20364.75,BUY,3,0.02h,Stop Loss,$27.00,$1245.00,$279394.25,212,$1245.00
2024-10-24,18:31:00,20364.0,SELL,3,0.02h,Break Even,$0.75,$1245.75,$279395.00,212,$1245.75
2024-10-24,18:51:00,20364.0,BUY,3,0.02h,Stop Loss,$34.50,$1280.25,$279429.50,212,$1280.25
2024-10-24,19:02:00,20349.0,SELL,3,0.02h,Break Even,$0.75,$1281.00,$279430.25,212,$1281.00
2024-10-24,19:10:00,20368.0,BUY,3,0.02h,Stop Loss,$34.50,$1315.50,$279464.75,212,$1315.50
2024-10-24,19:44:00,20379.5,SELL,3,0.02h,Stop Loss,$-18.00,$1297.50,$279446.75,212,$1297.50
2024-10-24,19:48:00,20396.0,BUY,3,0.02h,Stop Loss,$23.25,$1320.75,$279470.00,212,$1320.75
2024-10-24,19:54:00,20385.0,SELL,3,0.02h,Break Even,$0.75,$1321.50,$279470.75,212,$1321.50
2024-10-24,19:55:00,20397.75,BUY,3,0.02h,Break Even,$0.75,$1322.25,$279471.50,212,$1322.25
2024-10-24,19:59:00,20384.5,SELL,3,0.02h,Stop Loss,$98.25,$1420.50,$279569.75,212,$1420.50
2024-10-24,20:03:00,20391.5,BUY,3,0.02h,Stop Loss,$19.50,$1440.00,$279589.25,212,$1440.00
2024-10-24,20:23:00,20394.0,SELL,3,0.02h,Stop Loss,$-18.00,$1422.00,$279571.25,212,$1422.00
2024-10-24,21:00:00,20391.0,BUY,3,1.02h,Stop Loss,$64.50,$1486.50,$279635.75,212,$1486.50
2024-10-24,22:05:00,20381.5,SELL,3,0.02h,Break Even,$0.75,$1487.25,$279636.50,212,$1487.25
2024-10-24,22:17:00,20384.75,BUY,3,0.02h,Stop Loss,$-18.00,$1469.25,$279618.50,212,$1469.25
2024-10-24,22:34:00,20378.5,SELL,3,0.02h,Break Even,$0.75,$1470.00,$279619.25,212,$1470.00
2024-10-24,22:59:00,20380.75,BUY,3,0.02h,Stop Loss,$-18.00,$1452.00,$279601.25,212,$1452.00
,,,,,,,,,,,
2024-10-25,13:30:00,20491.25,SELL,3,0.02h,Stop Loss,$-18.00,$-18.00,$279583.25,213,$-18.00
2024-10-25,13:31:00,20519.25,BUY,3,0.02h,Stop Loss,$207.00,$189.00,$279790.25,213,$189.00
2024-10-25,14:44:00,20665.75,SELL,3,0.02h,Stop Loss,$192.00,$381.00,$279982.25,213,$381.00
2024-10-25,15:06:00,20666.25,BUY,3,0.02h,Stop Loss,$113.25,$494.25,$280095.50,213,$494.25
2024-10-25,15:12:00,20645.75,SELL,3,0.02h,Break Even,$0.75,$495.00,$280096.25,213,$495.00
2024-10-25,15:16:00,20666.0,BUY,3,0.02h,Break Even,$0.75,$495.75,$280097.00,213,$495.75
2024-10-25,15:27:00,20646.0,SELL,3,0.02h,Stop Loss,$12.00,$507.75,$280109.00,213,$507.75
2024-10-25,16:07:00,20634.75,BUY,3,0.02h,Break Even,$0.75,$508.50,$280109.75,213,$508.50
2024-10-25,16:50:00,20641.25,SELL,3,0.02h,Stop Loss,$-18.00,$490.50,$280091.75,213,$490.50
2024-10-25,16:54:00,20653.75,BUY,3,0.02h,Stop Loss,$-18.00,$472.50,$280073.75,213,$472.50
2024-10-25,16:57:00,20643.5,SELL,3,0.02h,Stop Loss,$27.00,$499.50,$280100.75,213,$499.50
2024-10-25,17:54:00,20554.25,BUY,3,0.02h,Break Even,$0.75,$500.25,$280101.50,213,$500.25
2024-10-25,17:56:00,20533.25,SELL,3,0.02h,Break Even,$0.75,$501.00,$280102.25,213,$501.00
2024-10-25,18:26:00,20514.25,BUY,3,0.02h,Stop Loss,$45.75,$546.75,$280148.00,213,$546.75
2024-10-25,19:05:00,20533.0,SELL,3,0.02h,Stop Loss,$60.75,$607.50,$280208.75,213,$607.50
2024-10-25,19:38:00,20524.5,BUY,3,0.02h,Stop Loss,$19.50,$627.00,$280228.25,213,$627.00
2024-10-25,19:44:00,20515.75,SELL,3,0.02h,Break Even,$0.75,$627.75,$280229.00,213,$627.75
2024-10-25,19:47:00,20524.0,BUY,3,0.02h,Stop Loss,$-18.00,$609.75,$280211.00,213,$609.75
2024-10-25,19:51:00,20510.5,SELL,3,0.02h,Break Even,$0.75,$610.50,$280211.75,213,$610.50
,,,,,,,,,,,
2024-10-28,12:00:00,20618.5,BUY,3,0.02h,Stop Loss,$42.00,$42.00,$280253.75,214,$42.00
2024-10-28,13:12:00,20642.25,SELL,3,0.02h,Stop Loss,$12.00,$54.00,$280265.75,214,$54.00
2024-10-28,14:08:00,20567.5,BUY,3,0.02h,Stop Loss,$225.75,$279.75,$280491.50,214,$279.75
2024-10-28,14:37:00,20583.0,SELL,3,0.02h,Stop Loss,$34.50,$314.25,$280526.00,214,$314.25
2024-10-28,14:38:00,20589.25,BUY,3,0.02h,Break Even,$0.75,$315.00,$280526.75,214,$315.00
2024-10-28,14:39:00,20583.75,SELL,3,0.02h,Stop Loss,$-18.00,$297.00,$280508.75,214,$297.00
2024-10-28,14:40:00,20595.25,BUY,3,0.02h,Stop Loss,$60.75,$357.75,$280569.50,214,$357.75
2024-10-28,14:57:00,20589.0,SELL,3,0.02h,Stop Loss,$87.00,$444.75,$280656.50,214,$444.75
2024-10-28,16:11:00,20548.25,BUY,3,0.02h,Break Even,$0.75,$445.50,$280657.25,214,$445.50
2024-10-28,16:35:00,20537.75,SELL,3,0.02h,Stop Loss,$90.75,$536.25,$280748.00,214,$536.25
2024-10-28,16:46:00,20554.25,BUY,3,0.02h,Break Even,$0.75,$537.00,$280748.75,214,$537.00
2024-10-28,16:49:00,20535.75,SELL,3,0.02h,Break Even,$0.75,$537.75,$280749.50,214,$537.75
2024-10-28,17:09:00,20547.25,BUY,3,0.02h,Stop Loss,$-18.00,$519.75,$280731.50,214,$519.75
2024-10-28,17:12:00,20534.5,SELL,3,0.02h,Stop Loss,$192.00,$711.75,$280923.50,214,$711.75
2024-10-28,17:21:00,20549.0,BUY,3,0.02h,Stop Loss,$19.50,$731.25,$280943.00,214,$731.25
2024-10-28,17:51:00,20541.0,SELL,3,0.02h,Stop Loss,$-18.00,$713.25,$280925.00,214,$713.25
2024-10-28,17:52:00,20550.0,BUY,3,0.02h,Stop Loss,$45.75,$759.00,$280970.75,214,$759.00
2024-10-28,18:04:00,20544.25,SELL,3,0.02h,Stop Loss,$-18.00,$741.00,$280952.75,214,$741.00
2024-10-28,18:07:00,20554.25,BUY,3,0.02h,Break Even,$0.75,$741.75,$280953.50,214,$741.75
2024-10-28,18:14:00,20541.0,SELL,3,0.02h,Break Even,$0.75,$742.50,$280954.25,214,$742.50
2024-10-28,18:54:00,20541.5,BUY,3,0.02h,Stop Loss,$45.75,$788.25,$281000.00,214,$788.25
2024-10-28,19:05:00,20526.25,SELL,3,0.02h,Stop Loss,$60.75,$849.00,$281060.75,214,$849.00
2024-10-28,19:28:00,20526.5,BUY,3,0.02h,Break Even,$0.75,$849.75,$281061.50,214,$849.75
2024-10-28,19:44:00,20520.5,SELL,3,0.02h,Break Even,$0.75,$850.50,$281062.25,214,$850.50
2024-10-28,20:23:00,20508.25,BUY,3,0.02h,Break Even,$0.75,$851.25,$281063.00,214,$851.25
2024-10-28,20:52:00,20511.75,SELL,3,0.03h,Break Even,$0.75,$852.00,$281063.75,214,$852.00
2024-10-28,22:40:00,20499.0,BUY,3,0.02h,Stop Loss,$-18.00,$834.00,$281045.75,214,$834.00
2024-10-28,22:47:00,20495.0,SELL,3,0.02h,Stop Loss,$-18.00,$816.00,$281027.75,214,$816.00
,,,,,,,,,,,
2024-10-29,12:20:00,20493.0,BUY,3,0.02h,Stop Loss,$-18.00,$-18.00,$281009.75,215,$-18.00
2024-10-29,12:21:00,20483.5,SELL,3,0.02h,Break Even,$0.75,$-17.25,$281010.50,215,$-17.25
2024-10-29,12:30:00,20493.75,BUY,3,0.02h,Break Even,$0.75,$-16.50,$281011.25,215,$-16.50
2024-10-29,12:51:00,20490.5,SELL,3,0.02h,Break Even,$0.75,$-15.75,$281012.00,215,$-15.75
2024-10-29,12:53:00,20500.0,BUY,3,0.02h,Break Even,$0.75,$-15.00,$281012.75,215,$-15.00
2024-10-29,13:00:00,20489.0,SELL,3,0.02h,Break Even,$0.75,$-14.25,$281013.50,215,$-14.25
2024-10-29,13:06:00,20496.5,BUY,3,0.02h,Stop Loss,$30.75,$16.50,$281044.25,215,$16.50
2024-10-29,13:15:00,20491.75,SELL,3,0.02h,Break Even,$0.75,$17.25,$281045.00,215,$17.25
2024-10-29,13:29:00,20510.25,BUY,3,0.02h,Break Even,$0.75,$18.00,$281045.75,215,$18.00
2024-10-29,13:32:00,20479.5,SELL,3,0.02h,Stop Loss,$473.25,$491.25,$281519.00,215,$491.25
2024-10-29,13:46:00,20509.75,BUY,3,0.02h,Stop Loss,$60.75,$552.00,$281579.75,215,$552.00
2024-10-29,15:11:00,20582.5,SELL,3,0.02h,Stop Loss,$30.75,$582.75,$281610.50,215,$582.75
2024-10-29,15:16:00,20596.75,BUY,3,0.02h,Stop Loss,$203.25,$786.00,$281813.75,215,$786.00
2024-10-29,15:36:00,20585.25,SELL,3,0.02h,Stop Loss,$19.50,$805.50,$281833.25,215,$805.50
2024-10-29,15:39:00,20604.25,BUY,3,0.02h,Stop Loss,$-18.00,$787.50,$281815.25,215,$787.50
2024-10-29,16:30:00,20614.75,SELL,3,0.02h,Stop Loss,$-18.00,$769.50,$281797.25,215,$769.50
2024-10-29,16:43:00,20628.5,BUY,3,0.02h,Stop Loss,$79.50,$849.00,$281876.75,215,$849.00
2024-10-29,17:28:00,20659.0,SELL,3,0.02h,Stop Loss,$-18.00,$831.00,$281858.75,215,$831.00
2024-10-29,17:35:00,20676.75,BUY,3,0.02h,Stop Loss,$27.00,$858.00,$281885.75,215,$858.00
2024-10-29,17:44:00,20661.5,SELL,3,0.02h,Stop Loss,$34.50,$892.50,$281920.25,215,$892.50
2024-10-29,17:51:00,20679.5,BUY,3,0.02h,Stop Loss,$-18.00,$874.50,$281902.25,215,$874.50
2024-10-29,18:06:00,20666.0,SELL,3,0.02h,Break Even,$0.75,$875.25,$281903.00,215,$875.25
2024-10-29,18:20:00,20680.75,BUY,3,0.02h,Break Even,$0.75,$876.00,$281903.75,215,$876.00
2024-10-29,18:57:00,20695.5,SELL,3,0.02h,Break Even,$0.75,$876.75,$281904.50,215,$876.75
2024-10-29,19:07:00,20703.0,BUY,3,0.02h,Stop Loss,$15.75,$892.50,$281920.25,215,$892.50
2024-10-29,19:42:00,20721.5,SELL,3,0.02h,Stop Loss,$-18.00,$874.50,$281902.25,215,$874.50
2024-10-29,19:45:00,20734.5,BUY,3,0.02h,Stop Loss,$64.50,$939.00,$281966.75,215,$939.00
2024-10-29,19:52:00,20720.25,SELL,3,0.02h,Break Even,$0.75,$939.75,$281967.50,215,$939.75
2024-10-29,20:07:00,20731.0,BUY,3,0.02h,Stop Loss,$57.00,$996.75,$282024.50,215,$996.75
2024-10-29,20:19:00,20708.0,SELL,3,0.02h,Stop Loss,$45.75,$1042.50,$282070.25,215,$1042.50
2024-10-29,20:54:00,20717.25,BUY,3,0.02h,Stop Loss,$-18.00,$1024.50,$282052.25,215,$1024.50
2024-10-29,20:59:00,20706.0,SELL,3,0.02h,Break Even,$0.75,$1025.25,$282053.00,215,$1025.25
2024-10-29,22:01:00,20721.0,BUY,3,0.02h,Stop Loss,$15.75,$1041.00,$282068.75,215,$1041.00
,,,,,,,,,,,
2024-10-30,12:00:00,20714.5,SELL,3,0.02h,Stop Loss,$-18.00,$-18.00,$282050.75,216,$-18.00
2024-10-30,12:39:00,20712.75,BUY,3,0.02h,Stop Loss,$12.00,$-6.00,$282062.75,216,$-6.00
2024-10-30,12:47:00,20706.0,SELL,3,0.02h,Stop Loss,$15.75,$9.75,$282078.50,216,$9.75
2024-10-30,13:57:00,20627.25,BUY,3,0.02h,Stop Loss,$34.50,$44.25,$282113.00,216,$44.25
2024-10-30,14:47:00,20671.75,SELL,3,0.02h,Stop Loss,$64.50,$108.75,$282177.50,216,$108.75
2024-10-30,15:25:00,20650.5,BUY,3,0.02h,Stop Loss,$57.00,$165.75,$282234.50,216,$165.75
2024-10-30,16:10:00,20659.25,SELL,3,0.02h,Stop Loss,$42.00,$207.75,$282276.50,216,$207.75
2024-10-30,16:41:00,20658.25,BUY,3,0.02h,Stop Loss,$-18.00,$189.75,$282258.50,216,$189.75
2024-10-30,16:42:00,20645.5,SELL,3,0.02h,Stop Loss,$-18.00,$171.75,$282240.50,216,$171.75
2024-10-30,16:46:00,20659.0,BUY,3,0.02h,Break Even,$0.75,$172.50,$282241.25,216,$172.50
2024-10-30,16:57:00,20648.25,SELL,3,0.02h,Stop Loss,$49.50,$222.00,$282290.75,216,$222.00
2024-10-30,18:08:00,20612.75,BUY,3,0.02h,Stop Loss,$30.75,$252.75,$282321.50,216,$252.75
2024-10-30,18:30:00,20596.0,SELL,3,0.02h,Break Even,$0.75,$253.50,$282322.25,216,$253.50
2024-10-30,18:34:00,20607.5,BUY,3,0.02h,Stop Loss,$15.75,$269.25,$282338.00,216,$269.25
2024-10-30,18:58:00,20609.0,SELL,3,0.02h,Stop Loss,$34.50,$303.75,$282372.50,216,$303.75
2024-10-30,20:05:00,20571.25,BUY,3,0.02h,Break Even,$0.75,$304.50,$282373.25,216,$304.50
2024-10-30,20:06:00,20533.75,SELL,3,0.02h,Stop Loss,$177.00,$481.50,$282550.25,216,$481.50
2024-10-30,20:30:00,20542.5,BUY,3,0.02h,Stop Loss,$113.25,$594.75,$282663.50,216,$594.75
2024-10-30,20:44:00,20514.0,SELL,3,0.02h,Stop Loss,$-18.00,$576.75,$282645.50,216,$576.75
2024-10-30,20:46:00,20529.0,BUY,3,0.02h,Break Even,$0.75,$577.50,$282646.25,216,$577.50
2024-10-30,20:51:00,20511.25,SELL,3,0.02h,Break Even,$0.75,$578.25,$282647.00,216,$578.25
2024-10-30,22:37:00,20454.0,BUY,3,0.02h,Break Even,$0.75,$579.00,$282647.75,216,$579.00
2024-10-30,22:41:00,20446.5,SELL,3,0.02h,Stop Loss,$-18.00,$561.00,$282629.75,216,$561.00
2024-10-30,22:42:00,20453.0,BUY,3,0.02h,Stop Loss,$34.50,$595.50,$282664.25,216,$595.50
2024-10-30,22:48:00,20437.25,SELL,3,0.02h,Stop Loss,$15.75,$611.25,$282680.00,216,$611.25
,,,,,,,,,,,
2024-10-31,12:26:00,20407.75,BUY,3,0.02h,Break Even,$0.75,$0.75,$282680.75,217,$0.75
2024-10-31,12:36:00,20389.25,SELL,3,0.02h,Stop Loss,$38.25,$39.00,$282719.00,217,$39.00
2024-10-31,12:46:00,20411.25,BUY,3,0.02h,Break Even,$0.75,$39.75,$282719.75,217,$39.75
2024-10-31,12:50:00,20387.0,SELL,3,0.02h,Stop Loss,$-18.00,$21.75,$282701.75,217,$21.75
2024-10-31,12:52:00,20403.75,BUY,3,0.02h,Stop Loss,$-18.00,$3.75,$282683.75,217,$3.75
2024-10-31,12:55:00,20387.0,SELL,3,0.02h,Stop Loss,$34.50,$38.25,$282718.25,217,$38.25
2024-10-31,13:17:00,20393.75,BUY,3,0.02h,Stop Loss,$-18.00,$20.25,$282700.25,217,$20.25
2024-10-31,13:21:00,20382.25,SELL,3,0.02h,Stop Loss,$-18.00,$2.25,$282682.25,217,$2.25
2024-10-31,13:24:00,20389.75,BUY,3,0.02h,Break Even,$0.75,$3.00,$282683.00,217,$3.00
2024-10-31,13:26:00,20376.0,SELL,3,0.02h,Break Even,$0.75,$3.75,$282683.75,217,$3.75
2024-10-31,14:20:00,20187.0,BUY,3,0.02h,Stop Loss,$15.75,$19.50,$282699.50,217,$19.50
2024-10-31,14:28:00,20149.75,SELL,3,0.02h,Stop Loss,$135.75,$155.25,$282835.25,217,$155.25
2024-10-31,15:22:00,20107.0,BUY,3,0.02h,Stop Loss,$23.25,$178.50,$282858.50,217,$178.50
2024-10-31,15:33:00,20076.75,SELL,3,0.02h,Stop Loss,$72.00,$250.50,$282930.50,217,$250.50
2024-10-31,16:02:00,20063.75,BUY,3,0.02h,Stop Loss,$-18.00,$232.50,$282912.50,217,$232.50
2024-10-31,16:03:00,20050.25,SELL,3,0.02h,Stop Loss,$-18.00,$214.50,$282894.50,217,$214.50
2024-10-31,16:05:00,20068.25,BUY,3,0.02h,Stop Loss,$199.50,$414.00,$283094.00,217,$414.00
2024-10-31,16:35:00,20072.75,SELL,3,0.02h,Break Even,$0.75,$414.75,$283094.75,217,$414.75
2024-10-31,16:41:00,20083.25,BUY,3,0.02h,Stop Loss,$-18.00,$396.75,$283076.75,217,$396.75
2024-10-31,16:42:00,20072.5,SELL,3,0.02h,Stop Loss,$-18.00,$378.75,$283058.75,217,$378.75
2024-10-31,16:44:00,20089.75,BUY,3,0.02h,Stop Loss,$87.00,$465.75,$283145.75,217,$465.75
2024-10-31,17:16:00,20087.5,SELL,3,0.02h,Stop Loss,$19.50,$485.25,$283165.25,217,$485.25
2024-10-31,17:22:00,20098.0,BUY,3,0.02h,Stop Loss,$19.50,$504.75,$283184.75,217,$504.75
2024-10-31,17:27:00,20087.0,SELL,3,0.02h,Stop Loss,$177.00,$681.75,$283361.75,217,$681.75
2024-10-31,18:31:00,20044.5,BUY,3,0.02h,Break Even,$0.75,$682.50,$283362.50,217,$682.50
2024-10-31,18:34:00,20017.5,SELL,3,0.02h,Stop Loss,$64.50,$747.00,$283427.00,217,$747.00
2024-10-31,18:46:00,20037.0,BUY,3,0.02h,Break Even,$0.75,$747.75,$283427.75,217,$747.75
2024-10-31,18:49:00,20023.75,SELL,3,0.02h,Stop Loss,$60.75,$808.50,$283488.50,217,$808.50
2024-10-31,18:55:00,20032.75,BUY,3,0.02h,Stop Loss,$53.25,$861.75,$283541.75,217,$861.75
2024-10-31,19:33:00,20064.25,SELL,3,0.02h,Stop Loss,$-18.00,$843.75,$283523.75,217,$843.75
2024-10-31,19:43:00,20085.5,BUY,3,0.02h,Stop Loss,$34.50,$878.25,$283558.25,217,$878.25
2024-10-31,19:55:00,20042.25,SELL,3,0.02h,Stop Loss,$27.00,$905.25,$283585.25,217,$905.25
2024-10-31,20:25:00,20070.75,BUY,3,0.02h,Stop Loss,$45.75,$951.00,$283631.00,217,$951.00
2024-10-31,20:34:00,20028.75,SELL,3,0.02h,Stop Loss,$53.25,$1004.25,$283684.25,217,$1004.25
2024-10-31,22:01:00,20083.75,BUY,3,0.02h,Stop Loss,$-18.00,$986.25,$283666.25,217,$986.25
2024-10-31,22:52:00,20084.75,SELL,3,0.02h,Stop Loss,$19.50,$1005.75,$283685.75,217,$1005.75
,,,,,,,,,,,
2024-11-01,12:00:00,20109.0,BUY,3,0.02h,Stop Loss,$57.00,$57.00,$283742.75,218,$57.00
2024-11-01,12:29:00,20101.75,SELL,3,0.02h,Stop Loss,$27.00,$84.00,$283769.75,218,$84.00
2024-11-01,12:33:00,20133.75,BUY,3,0.02h,Stop Loss,$120.75,$204.75,$283890.50,218,$204.75
2024-11-01,12:50:00,20113.75,SELL,3,0.02h,Stop Loss,$57.00,$261.75,$283947.50,218,$261.75
2024-11-01,12:54:00,20123.5,BUY,3,0.02h,Stop Loss,$38.25,$300.00,$283985.75,218,$300.00
2024-11-01,12:59:00,20113.5,SELL,3,0.02h,Break Even,$0.75,$300.75,$283986.50,218,$300.75
2024-11-01,13:35:00,20111.75,BUY,3,0.02h,Break Even,$0.75,$301.50,$283987.25,218,$301.50
2024-11-01,14:42:00,20220.25,SELL,3,0.02h,Stop Loss,$139.50,$441.00,$284126.75,218,$441.00
2024-11-01,15:00:00,20235.25,BUY,3,0.02h,Break Even,$0.75,$441.75,$284127.50,218,$441.75
2024-11-01,15:42:00,20256.0,SELL,3,0.02h,Stop Loss,$30.75,$472.50,$284158.25,218,$472.50
2024-11-01,16:10:00,20248.25,BUY,3,0.02h,Stop Loss,$15.75,$488.25,$284174.00,218,$488.25
2024-11-01,16:19:00,20232.0,SELL,3,0.02h,Break Even,$0.75,$489.00,$284174.75,218,$489.00
2024-11-01,16:20:00,20244.5,BUY,3,0.02h,Stop Loss,$-18.00,$471.00,$284156.75,218,$471.00
2024-11-01,16:21:00,20232.0,SELL,3,0.02h,Stop Loss,$79.50,$550.50,$284236.25,218,$550.50
2024-11-01,16:35:00,20250.75,BUY,3,0.02h,Break Even,$0.75,$551.25,$284237.00,218,$551.25
2024-11-01,16:44:00,20198.25,SELL,3,0.02h,Stop Loss,$12.00,$563.25,$284249.00,218,$563.25
2024-11-01,17:17:00,20219.75,BUY,3,0.02h,Break Even,$0.75,$564.00,$284249.75,218,$564.00
2024-11-01,17:34:00,20195.25,SELL,3,0.02h,Stop Loss,$102.00,$666.00,$284351.75,218,$666.00
2024-11-01,18:26:00,20165.0,BUY,3,0.02h,Stop Loss,$42.00,$708.00,$284393.75,218,$708.00
2024-11-01,18:43:00,20151.5,SELL,3,0.02h,Break Even,$0.75,$708.75,$284394.50,218,$708.75
2024-11-01,18:45:00,20165.0,BUY,3,0.02h,Stop Loss,$165.75,$874.50,$284560.25,218,$874.50
2024-11-01,19:04:00,20158.0,SELL,3,0.02h,Stop Loss,$-18.00,$856.50,$284542.25,218,$856.50
2024-11-01,19:05:00,20166.75,BUY,3,0.02h,Break Even,$0.75,$857.25,$284543.00,218,$857.25
2024-11-01,19:29:00,20170.5,SELL,3,0.02h,Stop Loss,$165.75,$1023.00,$284708.75,218,$1023.00
2024-11-01,19:44:00,20180.75,BUY,3,0.02h,Stop Loss,$-18.00,$1005.00,$284690.75,218,$1005.00
2024-11-01,19:45:00,20169.25,SELL,3,0.02h,Stop Loss,$34.50,$1039.50,$284725.25,218,$1039.50
2024-11-01,19:47:00,20175.75,BUY,3,0.02h,Break Even,$0.75,$1040.25,$284726.00,218,$1040.25
2024-11-01,19:49:00,20161.0,SELL,3,0.02h,Stop Loss,$42.00,$1082.25,$284768.00,218,$1082.25
2024-11-01,20:08:00,20161.5,BUY,3,0.02h,Stop Loss,$-18.00,$1064.25,$284750.00,218,$1064.25
2024-11-01,20:49:00,20163.0,SELL,3,0.02h,Stop Loss,$-18.00,$1046.25,$284732.00,218,$1046.25
2024-11-01,21:00:00,20169.5,BUY,3,63.00h,Stop Loss,$150.75,$1197.00,$284882.75,218,$1197.00
,,,,,,,,,,,
2024-11-04,12:16:00,20165.5,SELL,3,0.02h,Break Even,$0.75,$0.75,$284883.50,219,$0.75
2024-11-04,12:52:00,20148.0,BUY,3,0.02h,Stop Loss,$-18.00,$-17.25,$284865.50,219,$-17.25
2024-11-04,13:16:00,20143.5,SELL,3,0.02h,Stop Loss,$-18.00,$-35.25,$284847.50,219,$-35.25
2024-11-04,13:21:00,20165.0,BUY,3,0.02h,Stop Loss,$-18.00,$-53.25,$284829.50,219,$-53.25
2024-11-04,13:25:00,20157.0,SELL,3,0.02h,Stop Loss,$42.00,$-11.25,$284871.50,219,$-11.25
2024-11-04,13:30:00,20161.25,BUY,3,0.02h,Stop Loss,$-18.00,$-29.25,$284853.50,219,$-29.25
2024-11-04,13:46:00,20156.5,SELL,3,0.02h,Stop Loss,$-18.00,$-47.25,$284835.50,219,$-47.25
2024-11-04,14:46:00,20125.5,BUY,3,0.02h,Stop Loss,$49.50,$2.25,$284885.00,219,$2.25
2024-11-04,16:21:00,20193.25,SELL,3,0.02h,Stop Loss,$120.75,$123.00,$285005.75,219,$123.00
2024-11-04,17:22:00,20083.0,BUY,3,0.02h,Stop Loss,$53.25,$176.25,$285059.00,219,$176.25
2024-11-04,18:06:00,20119.25,SELL,3,0.02h,Stop Loss,$139.50,$315.75,$285198.50,219,$315.75
2024-11-04,18:15:00,20137.75,BUY,3,0.02h,Stop Loss,$75.75,$391.50,$285274.25,219,$391.50
2024-11-04,19:00:00,20148.75,SELL,3,0.02h,Stop Loss,$-18.00,$373.50,$285256.25,219,$373.50
2024-11-04,19:08:00,20163.5,BUY,3,0.02h,Stop Loss,$30.75,$404.25,$285287.00,219,$404.25
2024-11-04,19:11:00,20149.75,SELL,3,0.02h,Stop Loss,$-18.00,$386.25,$285269.00,219,$386.25
2024-11-04,19:15:00,20159.5,BUY,3,0.02h,Break Even,$0.75,$387.00,$285269.75,219,$387.00
2024-11-04,19:18:00,20151.5,SELL,3,0.02h,Break Even,$0.75,$387.75,$285270.50,219,$387.75
2024-11-04,19:38:00,20151.75,BUY,3,0.02h,Break Even,$0.75,$388.50,$285271.25,219,$388.50
2024-11-04,19:46:00,20145.5,SELL,3,0.02h,Stop Loss,$34.50,$423.00,$285305.75,219,$423.00
2024-11-04,20:26:00,20134.75,BUY,3,0.02h,Break Even,$0.75,$423.75,$285306.50,219,$423.75
2024-11-04,20:29:00,20118.0,SELL,3,0.02h,Break Even,$0.75,$424.50,$285307.25,219,$424.50
2024-11-04,21:09:00,20107.25,BUY,3,0.02h,Stop Loss,$27.00,$451.50,$285334.25,219,$451.50
2024-11-04,21:38:00,20104.0,SELL,3,0.02h,Break Even,$0.75,$452.25,$285335.00,219,$452.25
2024-11-04,21:50:00,20110.25,BUY,3,0.02h,Stop Loss,$-18.00,$434.25,$285317.00,219,$434.25
2024-11-04,21:57:00,20105.5,SELL,3,0.02h,Break Even,$0.75,$435.00,$285317.75,219,$435.00
2024-11-04,22:00:00,20115.0,BUY,3,14.00h,Stop Loss,$668.25,$1103.25,$285986.00,219,$1103.25
,,,,,,,,,,,
2024-11-05,12:25:00,20142.25,SELL,3,0.02h,Stop Loss,$15.75,$15.75,$286001.75,220,$15.75
2024-11-05,12:51:00,20148.0,BUY,3,0.02h,Stop Loss,$-18.00,$-2.25,$285983.75,220,$-2.25
2024-11-05,13:13:00,20136.5,SELL,3,0.02h,Break Even,$0.75,$-1.50,$285984.50,220,$-1.50
2024-11-05,13:23:00,20149.25,BUY,3,0.02h,Stop Loss,$-18.00,$-19.50,$285966.50,220,$-19.50
2024-11-05,13:52:00,20152.75,SELL,3,0.02h,Break Even,$0.75,$-18.75,$285967.25,220,$-18.75
2024-11-05,14:17:00,20142.25,BUY,3,0.02h,Break Even,$0.75,$-18.00,$285968.00,220,$-18.00
2024-11-05,15:31:00,20275.0,SELL,3,0.02h,Break Even,$0.75,$-17.25,$285968.75,220,$-17.25
2024-11-05,15:41:00,20286.75,BUY,3,0.02h,Stop Loss,$27.00,$9.75,$285995.75,220,$9.75
2024-11-05,15:53:00,20264.25,SELL,3,0.02h,Stop Loss,$60.75,$70.50,$286056.50,220,$70.50
2024-11-05,16:09:00,20293.25,BUY,3,0.02h,Stop Loss,$34.50,$105.00,$286091.00,220,$105.00
2024-11-05,17:40:00,20349.25,SELL,3,0.02h,Break Even,$0.75,$105.75,$286091.75,220,$105.75
2024-11-05,17:47:00,20363.75,BUY,3,0.02h,Stop Loss,$30.75,$136.50,$286122.50,220,$136.50
2024-11-05,17:59:00,20344.5,SELL,3,0.02h,Stop Loss,$-18.00,$118.50,$286104.50,220,$118.50
2024-11-05,18:07:00,20365.5,BUY,3,0.02h,Break Even,$0.75,$119.25,$286105.25,220,$119.25
2024-11-05,18:12:00,20347.0,SELL,3,0.02h,Stop Loss,$30.75,$150.00,$286136.00,220,$150.00
2024-11-05,19:03:00,20321.0,BUY,3,0.02h,Break Even,$0.75,$150.75,$286136.75,220,$150.75
2024-11-05,19:19:00,20312.75,SELL,3,0.02h,Break Even,$0.75,$151.50,$286137.50,220,$151.50
2024-11-05,19:28:00,20323.25,BUY,3,0.02h,Break Even,$0.75,$152.25,$286138.25,220,$152.25
2024-11-05,19:51:00,20313.0,SELL,3,0.02h,Stop Loss,$105.75,$258.00,$286244.00,220,$258.00
2024-11-05,20:09:00,20316.25,BUY,3,0.02h,Stop Loss,$64.50,$322.50,$286308.50,220,$322.50
2024-11-05,20:44:00,20311.0,SELL,3,0.02h,Stop Loss,$-18.00,$304.50,$286290.50,220,$304.50
2024-11-05,20:59:00,20331.25,BUY,3,0.02h,Stop Loss,$199.50,$504.00,$286490.00,220,$504.00
2024-11-05,21:42:00,20362.25,SELL,3,0.02h,Stop Loss,$-18.00,$486.00,$286472.00,220,$486.00
,,,,,,,,,,,
2024-11-06,12:00:00,20607.0,BUY,3,0.02h,Stop Loss,$79.50,$79.50,$286551.50,221,$79.50
2024-11-06,13:03:00,20665.75,SELL,3,0.02h,Stop Loss,$-18.00,$61.50,$286533.50,221,$61.50
2024-11-06,13:17:00,20683.5,BUY,3,0.02h,Stop Loss,$-18.00,$43.50,$286515.50,221,$43.50
2024-11-06,13:46:00,20687.25,SELL,3,0.02h,Stop Loss,$117.00,$160.50,$286632.50,221,$160.50
2024-11-06,14:28:00,20688.5,BUY,3,0.02h,Stop Loss,$-18.00,$142.50,$286614.50,221,$142.50
2024-11-06,14:49:00,20680.5,SELL,3,0.02h,Stop Loss,$229.50,$372.00,$286844.00,221,$372.00
2024-11-06,15:03:00,20725.5,BUY,3,0.02h,Break Even,$0.75,$372.75,$286844.75,221,$372.75
2024-11-06,15:06:00,20686.5,SELL,3,0.02h,Break Even,$0.75,$373.50,$286845.50,221,$373.50
2024-11-06,15:11:00,20735.25,BUY,3,0.02h,Stop Loss,$98.25,$471.75,$286943.75,221,$471.75
2024-11-06,15:42:00,20772.25,SELL,3,0.02h,Stop Loss,$334.50,$806.25,$287278.25,221,$806.25
2024-11-06,16:13:00,20747.0,BUY,3,0.02h,Stop Loss,$135.75,$942.00,$287414.00,221,$942.00
2024-11-06,17:22:00,20794.0,SELL,3,0.02h,Break Even,$0.75,$942.75,$287414.75,221,$942.75
2024-11-06,17:33:00,20801.75,BUY,3,0.02h,Break Even,$0.75,$943.50,$287415.50,221,$943.50
2024-11-06,17:40:00,20792.0,SELL,3,0.02h,Break Even,$0.75,$944.25,$287416.25,221,$944.25
2024-11-06,17:43:00,20803.0,BUY,3,0.02h,Break Even,$0.75,$945.00,$287417.00,221,$945.00
2024-11-06,18:59:00,20853.25,SELL,3,0.02h,Stop Loss,$-18.00,$927.00,$287399.00,221,$927.00
2024-11-06,19:02:00,20873.25,BUY,3,0.02h,Break Even,$0.75,$927.75,$287399.75,221,$927.75
2024-11-06,19:07:00,20854.0,SELL,3,0.02h,Stop Loss,$34.50,$962.25,$287434.25,221,$962.25
2024-11-06,19:09:00,20869.0,BUY,3,0.02h,Break Even,$0.75,$963.00,$287435.00,221,$963.00
2024-11-06,19:11:00,20858.25,SELL,3,0.02h,Break Even,$0.75,$963.75,$287435.75,221,$963.75
2024-11-06,19:14:00,20872.25,BUY,3,0.02h,Stop Loss,$109.50,$1073.25,$287545.25,221,$1073.25
2024-11-06,19:43:00,20869.0,SELL,3,0.02h,Break Even,$0.75,$1074.00,$287546.00,221,$1074.00
2024-11-06,19:48:00,20885.5,BUY,3,0.02h,Stop Loss,$27.00,$1101.00,$287573.00,221,$1101.00
2024-11-06,19:56:00,20876.5,SELL,3,0.02h,Break Even,$0.75,$1101.75,$287573.75,221,$1101.75
2024-11-06,19:58:00,20883.25,BUY,3,0.02h,Break Even,$0.75,$1102.50,$287574.50,221,$1102.50
2024-11-06,20:38:00,20897.75,SELL,3,0.02h,Stop Loss,$19.50,$1122.00,$287594.00,221,$1122.00
2024-11-06,20:45:00,20912.75,BUY,3,0.02h,Break Even,$0.75,$1122.75,$287594.75,221,$1122.75
2024-11-06,20:53:00,20881.0,SELL,3,0.02h,Break Even,$0.75,$1123.50,$287595.50,221,$1123.50
2024-11-06,21:02:00,20917.75,BUY,3,0.02h,Stop Loss,$75.75,$1199.25,$287671.25,221,$1199.25
2024-11-06,21:08:00,20897.5,SELL,3,0.02h,Break Even,$0.75,$1200.00,$287672.00,221,$1200.00
2024-11-06,21:23:00,20902.25,BUY,3,0.02h,Stop Loss,$132.00,$1332.00,$287804.00,221,$1332.00
2024-11-06,21:41:00,20901.25,SELL,3,0.02h,Break Even,$0.75,$1332.75,$287804.75,221,$1332.75
2024-11-06,21:43:00,20908.0,BUY,3,0.02h,Stop Loss,$60.75,$1393.50,$287865.50,221,$1393.50
,,,,,,,,,,,
2024-11-07,12:44:00,20960.75,SELL,3,0.02h,Stop Loss,$-18.00,$-18.00,$287847.50,222,$-18.00
2024-11-07,13:00:00,20967.0,BUY,3,0.02h,Stop Loss,$15.75,$-2.25,$287863.25,222,$-2.25
2024-11-07,13:25:00,20978.25,SELL,3,0.02h,Break Even,$0.75,$-1.50,$287864.00,222,$-1.50
2024-11-07,13:46:00,20989.5,BUY,3,0.02h,Break Even,$0.75,$-0.75,$287864.75,222,$-0.75
2024-11-07,15:34:00,21092.25,SELL,3,0.02h,Stop Loss,$38.25,$37.50,$287903.00,222,$37.50
2024-11-07,15:37:00,21123.5,BUY,3,0.02h,Break Even,$0.75,$38.25,$287903.75,222,$38.25
2024-11-07,15:42:00,21106.0,SELL,3,0.02h,Stop Loss,$-18.00,$20.25,$287885.75,222,$20.25
2024-11-07,15:43:00,21111.5,BUY,3,0.02h,Break Even,$0.75,$21.00,$287886.50,222,$21.00
2024-11-07,15:44:00,21106.75,SELL,3,0.02h,Stop Loss,$-18.00,$3.00,$287868.50,222,$3.00
2024-11-07,15:45:00,21118.75,BUY,3,0.02h,Stop Loss,$147.00,$150.00,$288015.50,222,$150.00
2024-11-07,16:11:00,21132.75,SELL,3,0.02h,Stop Loss,$-18.00,$132.00,$287997.50,222,$132.00
2024-11-07,16:12:00,21145.75,BUY,3,0.02h,Break Even,$0.75,$132.75,$287998.25,222,$132.75
2024-11-07,17:05:00,21171.5,SELL,3,0.02h,Stop Loss,$42.00,$174.75,$288040.25,222,$174.75
2024-11-07,17:16:00,21179.25,BUY,3,0.02h,Break Even,$0.75,$175.50,$288041.00,222,$175.50
2024-11-07,17:17:00,21173.75,SELL,3,0.02h,Break Even,$0.75,$176.25,$288041.75,222,$176.25
2024-11-07,17:18:00,21177.75,BUY,3,0.02h,Stop Loss,$19.50,$195.75,$288061.25,222,$195.75
2024-11-07,17:21:00,21172.0,SELL,3,0.02h,Stop Loss,$-18.00,$177.75,$288043.25,222,$177.75
2024-11-07,17:22:00,21183.5,BUY,3,0.02h,Break Even,$0.75,$178.50,$288044.00,222,$178.50
2024-11-07,17:26:00,21172.25,SELL,3,0.02h,Break Even,$0.75,$179.25,$288044.75,222,$179.25
2024-11-07,17:31:00,21184.0,BUY,3,0.02h,Stop Loss,$53.25,$232.50,$288098.00,222,$232.50
2024-11-07,17:34:00,21166.5,SELL,3,0.02h,Break Even,$0.75,$233.25,$288098.75,222,$233.25
2024-11-07,17:38:00,21185.0,BUY,3,0.02h,Stop Loss,$15.75,$249.00,$288114.50,222,$249.00
2024-11-07,18:08:00,21179.25,SELL,3,0.02h,Stop Loss,$90.75,$339.75,$288205.25,222,$339.75
2024-11-07,18:52:00,21179.25,BUY,3,0.02h,Stop Loss,$34.50,$374.25,$288239.75,222,$374.25
2024-11-07,19:24:00,21179.25,SELL,3,0.02h,Break Even,$0.75,$375.00,$288240.50,222,$375.00
2024-11-07,19:28:00,21192.0,BUY,3,0.02h,Stop Loss,$-18.00,$357.00,$288222.50,222,$357.00
2024-11-07,19:43:00,21173.75,SELL,3,0.02h,Stop Loss,$34.50,$391.50,$288257.00,222,$391.50
2024-11-07,19:48:00,21199.0,BUY,3,0.02h,Stop Loss,$173.25,$564.75,$288430.25,222,$564.75
2024-11-07,20:35:00,21229.5,SELL,3,0.02h,Break Even,$0.75,$565.50,$288431.00,222,$565.50
2024-11-07,20:48:00,21243.0,BUY,3,0.02h,Stop Loss,$42.00,$607.50,$288473.00,222,$607.50
2024-11-07,20:52:00,21218.0,SELL,3,0.02h,Stop Loss,$102.00,$709.50,$288575.00,222,$709.50
2024-11-07,21:07:00,21232.5,BUY,3,0.02h,Stop Loss,$42.00,$751.50,$288617.00,222,$751.50
2024-11-07,21:28:00,21232.0,SELL,3,0.02h,Break Even,$0.75,$752.25,$288617.75,222,$752.25
2024-11-07,21:59:00,21226.75,BUY,3,0.02h,Break Even,$0.75,$753.00,$288618.50,222,$753.00
,,,,,,,,,,,
2024-11-08,12:00:00,21161.75,SELL,3,0.02h,Stop Loss,$-18.00,$-18.00,$288600.50,223,$-18.00
2024-11-08,12:32:00,21178.0,BUY,3,0.02h,Stop Loss,$-18.00,$-36.00,$288582.50,223,$-36.00
2024-11-08,13:13:00,21174.5,SELL,3,0.02h,Stop Loss,$-18.00,$-54.00,$288564.50,223,$-54.00
2024-11-08,13:24:00,21185.25,BUY,3,0.02h,Stop Loss,$-18.00,$-72.00,$288546.50,223,$-72.00
2024-11-08,13:31:00,21174.75,SELL,3,0.02h,Stop Loss,$15.75,$-56.25,$288562.25,223,$-56.25
2024-11-08,14:10:00,21172.75,BUY,3,0.02h,Stop Loss,$30.75,$-25.50,$288593.00,223,$-25.50
2024-11-08,14:47:00,21194.5,SELL,3,0.02h,Stop Loss,$-18.00,$-43.50,$288575.00,223,$-43.50
2024-11-08,14:48:00,21211.75,BUY,3,0.02h,Stop Loss,$19.50,$-24.00,$288594.50,223,$-24.00
2024-11-08,15:05:00,21190.5,SELL,3,0.02h,Stop Loss,$102.00,$78.00,$288696.50,223,$78.00
2024-11-08,15:22:00,21199.75,BUY,3,0.02h,Break Even,$0.75,$78.75,$288697.25,223,$78.75
2024-11-08,15:25:00,21181.5,SELL,3,0.02h,Break Even,$0.75,$79.50,$288698.00,223,$79.50
2024-11-08,15:27:00,21193.25,BUY,3,0.02h,Stop Loss,$19.50,$99.00,$288717.50,223,$99.00
2024-11-08,15:39:00,21188.0,SELL,3,0.02h,Stop Loss,$15.75,$114.75,$288733.25,223,$114.75
2024-11-08,15:51:00,21193.5,BUY,3,0.02h,Stop Loss,$98.25,$213.00,$288831.50,223,$213.00
2024-11-08,16:03:00,21173.25,SELL,3,0.02h,Break Even,$0.75,$213.75,$288832.25,223,$213.75
2024-11-08,16:12:00,21197.25,BUY,3,0.02h,Stop Loss,$60.75,$274.50,$288893.00,223,$274.50
2024-11-08,16:44:00,21197.5,SELL,3,0.02h,Break Even,$0.75,$275.25,$288893.75,223,$275.25
2024-11-08,16:51:00,21221.75,BUY,3,0.02h,Break Even,$0.75,$276.00,$288894.50,223,$276.00
2024-11-08,17:06:00,21207.5,SELL,3,0.02h,Stop Loss,$-18.00,$258.00,$288876.50,223,$258.00
2024-11-08,17:33:00,21217.25,BUY,3,0.02h,Break Even,$0.75,$258.75,$288877.25,223,$258.75
2024-11-08,18:54:00,21243.5,SELL,3,0.02h,Stop Loss,$68.25,$327.00,$288945.50,223,$327.00
2024-11-08,19:08:00,21253.75,BUY,3,0.02h,Break Even,$0.75,$327.75,$288946.25,223,$327.75
2024-11-08,19:21:00,21244.5,SELL,3,0.02h,Stop Loss,$-18.00,$309.75,$288928.25,223,$309.75
2024-11-08,19:26:00,21253.0,BUY,3,0.02h,Break Even,$0.75,$310.50,$288929.00,223,$310.50
2024-11-08,19:49:00,21248.75,SELL,3,0.02h,Break Even,$0.75,$311.25,$288929.75,223,$311.25
2024-11-08,20:54:00,21223.75,BUY,3,0.02h,Stop Loss,$79.50,$390.75,$289009.25,223,$390.75
2024-11-08,20:57:00,21220.5,SELL,3,0.02h,Stop Loss,$-18.00,$372.75,$288991.25,223,$372.75
2024-11-08,20:58:00,21230.5,BUY,3,0.02h,Break Even,$0.75,$373.50,$288992.00,223,$373.50
2024-11-08,21:32:00,21228.25,SELL,3,0.02h,Break Even,$0.75,$374.25,$288992.75,223,$374.25
2024-11-08,21:56:00,21235.5,BUY,3,0.02h,Stop Loss,$-18.00,$356.25,$288974.75,223,$356.25
,,,,,,,,,,,
2024-11-11,13:16:00,21317.75,SELL,3,0.02h,Stop Loss,$15.75,$15.75,$288990.50,224,$15.75
2024-11-11,14:06:00,21299.75,BUY,3,0.02h,Break Even,$0.75,$16.50,$288991.25,224,$16.50
2024-11-11,14:12:00,21293.25,SELL,3,0.02h,Stop Loss,$23.25,$39.75,$289014.50,224,$39.75
2024-11-11,15:16:00,21197.5,BUY,3,0.02h,Break Even,$0.75,$40.50,$289015.25,224,$40.50
2024-11-11,15:17:00,21183.5,SELL,3,0.02h,Stop Loss,$23.25,$63.75,$289038.50,224,$63.75
2024-11-11,15:25:00,21197.0,BUY,3,0.02h,Stop Loss,$30.75,$94.50,$289069.25,224,$94.50
2024-11-11,15:49:00,21200.0,SELL,3,0.02h,Stop Loss,$-18.00,$76.50,$289051.25,224,$76.50
2024-11-11,15:54:00,21221.5,BUY,3,0.02h,Break Even,$0.75,$77.25,$289052.00,224,$77.25
2024-11-11,16:13:00,21211.0,SELL,3,0.02h,Break Even,$0.75,$78.00,$289052.75,224,$78.00
2024-11-11,16:15:00,21222.5,BUY,3,0.02h,Stop Loss,$-18.00,$60.00,$289034.75,224,$60.00
2024-11-11,16:16:00,21217.5,SELL,3,0.02h,Stop Loss,$12.00,$72.00,$289046.75,224,$72.00
2024-11-11,16:20:00,21228.75,BUY,3,0.02h,Break Even,$0.75,$72.75,$289047.50,224,$72.75
2024-11-11,16:27:00,21209.75,SELL,3,0.02h,Break Even,$0.75,$73.50,$289048.25,224,$73.50
2024-11-11,17:38:00,21181.0,BUY,3,0.02h,Break Even,$0.75,$74.25,$289049.00,224,$74.25
2024-11-11,17:39:00,21176.75,SELL,3,0.02h,Stop Loss,$68.25,$142.50,$289117.25,224,$142.50
2024-11-11,18:30:00,21141.5,BUY,3,0.02h,Stop Loss,$-18.00,$124.50,$289099.25,224,$124.50
2024-11-11,19:12:00,21164.0,SELL,3,0.02h,Stop Loss,$-18.00,$106.50,$289081.25,224,$106.50
2024-11-11,19:35:00,21177.0,BUY,3,0.02h,Stop Loss,$-18.00,$88.50,$289063.25,224,$88.50
2024-11-11,19:48:00,21165.75,SELL,3,0.02h,Stop Loss,$-18.00,$70.50,$289045.25,224,$70.50
2024-11-11,19:49:00,21173.0,BUY,3,0.02h,Stop Loss,$12.00,$82.50,$289057.25,224,$82.50
2024-11-11,19:53:00,21165.25,SELL,3,0.02h,Break Even,$0.75,$83.25,$289058.00,224,$83.25
2024-11-11,20:00:00,21175.0,BUY,3,0.02h,Stop Loss,$-18.00,$65.25,$289040.00,224,$65.25
2024-11-11,20:50:00,21192.5,SELL,3,0.02h,Break Even,$0.75,$66.00,$289040.75,224,$66.00
2024-11-11,20:51:00,21207.0,BUY,3,0.02h,Stop Loss,$12.00,$78.00,$289052.75,224,$78.00
2024-11-11,21:33:00,21217.5,SELL,3,0.02h,Stop Loss,$-18.00,$60.00,$289034.75,224,$60.00
2024-11-11,21:41:00,21223.25,BUY,3,0.02h,Stop Loss,$-18.00,$42.00,$289016.75,224,$42.00
2024-11-11,21:51:00,21220.0,SELL,3,0.02h,Stop Loss,$-18.00,$24.00,$288998.75,224,$24.00
2024-11-11,21:52:00,21223.5,BUY,3,0.02h,Stop Loss,$-18.00,$6.00,$288980.75,224,$6.00
2024-11-11,21:55:00,21219.25,SELL,3,0.02h,Break Even,$0.75,$6.75,$288981.50,224,$6.75
,,,,,,,,,,,
2024-11-12,12:42:00,21204.5,BUY,3,0.02h,Break Even,$0.75,$0.75,$288982.25,225,$0.75
2024-11-12,12:58:00,21193.0,SELL,3,0.02h,Break Even,$0.75,$1.50,$288983.00,225,$1.50
2024-11-12,13:14:00,21200.75,BUY,3,0.02h,Stop Loss,$-18.00,$-16.50,$288965.00,225,$-16.50
2024-11-12,14:04:00,21213.5,SELL,3,0.02h,Break Even,$0.75,$-15.75,$288965.75,225,$-15.75
2024-11-12,14:30:00,21214.25,BUY,3,0.02h,Stop Loss,$64.50,$48.75,$289030.25,225,$48.75
2024-11-12,14:31:00,21204.5,SELL,3,0.02h,Stop Loss,$124.50,$173.25,$289154.75,225,$173.25
2024-11-12,14:36:00,21229.25,BUY,3,0.02h,Stop Loss,$132.00,$305.25,$289286.75,225,$305.25
2024-11-12,14:48:00,21212.0,SELL,3,0.02h,Break Even,$0.75,$306.00,$289287.50,225,$306.00
2024-11-12,14:50:00,21220.5,BUY,3,0.02h,Break Even,$0.75,$306.75,$289288.25,225,$306.75
2024-11-12,15:05:00,21191.75,SELL,3,0.02h,Break Even,$0.75,$307.50,$289289.00,225,$307.50
2024-11-12,15:16:00,21219.75,BUY,3,0.02h,Stop Loss,$42.00,$349.50,$289331.00,225,$349.50
2024-11-12,15:19:00,21208.0,SELL,3,0.02h,Stop Loss,$12.00,$361.50,$289343.00,225,$361.50
2024-11-12,15:27:00,21224.0,BUY,3,0.02h,Stop Loss,$34.50,$396.00,$289377.50,225,$396.00
2024-11-12,15:45:00,21204.0,SELL,3,0.02h,Stop Loss,$12.00,$408.00,$289389.50,225,$408.00
2024-11-12,16:54:00,21189.75,BUY,3,0.02h,Stop Loss,$23.25,$431.25,$289412.75,225,$431.25
2024-11-12,17:00:00,21154.5,SELL,3,0.02h,Stop Loss,$90.75,$522.00,$289503.50,225,$522.00
2024-11-12,17:30:00,21159.0,BUY,3,0.02h,Break Even,$0.75,$522.75,$289504.25,225,$522.75
2024-11-12,17:44:00,21140.5,SELL,3,0.02h,Break Even,$0.75,$523.50,$289505.00,225,$523.50
2024-11-12,18:16:00,21110.0,BUY,3,0.02h,Stop Loss,$68.25,$591.75,$289573.25,225,$591.75
2024-11-12,19:54:00,21195.75,SELL,3,0.02h,Stop Loss,$34.50,$626.25,$289607.75,225,$626.25
2024-11-12,20:38:00,21190.25,BUY,3,0.02h,Stop Loss,$23.25,$649.50,$289631.00,225,$649.50
2024-11-12,20:53:00,21180.5,SELL,3,0.02h,Stop Loss,$23.25,$672.75,$289654.25,225,$672.75
2024-11-12,21:03:00,21194.25,BUY,3,0.02h,Stop Loss,$-18.00,$654.75,$289636.25,225,$654.75
2024-11-12,21:20:00,21190.5,SELL,3,0.02h,Break Even,$0.75,$655.50,$289637.00,225,$655.50
2024-11-12,21:26:00,21192.5,BUY,3,0.02h,Break Even,$0.75,$656.25,$289637.75,225,$656.25
2024-11-12,21:38:00,21189.75,SELL,3,0.02h,Break Even,$0.75,$657.00,$289638.50,225,$657.00
,,,,,,,,,,,
2024-11-13,12:24:00,21155.5,BUY,3,0.02h,Stop Loss,$-18.00,$-18.00,$289620.50,226,$-18.00
2024-11-13,12:37:00,21143.25,SELL,3,0.02h,Stop Loss,$34.50,$16.50,$289655.00,226,$16.50
2024-11-13,13:11:00,21133.75,BUY,3,0.02h,Break Even,$0.75,$17.25,$289655.75,226,$17.25
2024-11-13,13:56:00,21180.5,SELL,3,0.02h,Stop Loss,$75.75,$93.00,$289731.50,226,$93.00
2024-11-13,14:23:00,21188.5,BUY,3,0.02h,Stop Loss,$-18.00,$75.00,$289713.50,226,$75.00
2024-11-13,14:28:00,21173.5,SELL,3,0.02h,Stop Loss,$173.25,$248.25,$289886.75,226,$248.25
2024-11-13,15:33:00,21123.75,BUY,3,0.02h,Stop Loss,$98.25,$346.50,$289985.00,226,$346.50
2024-11-13,15:52:00,21101.75,SELL,3,0.02h,Stop Loss,$15.75,$362.25,$290000.75,226,$362.25
2024-11-13,15:56:00,21126.0,BUY,3,0.02h,Break Even,$0.75,$363.00,$290001.50,226,$363.00
2024-11-13,16:04:00,21109.75,SELL,3,0.02h,Break Even,$0.75,$363.75,$290002.25,226,$363.75
2024-11-13,16:11:00,21117.25,BUY,3,0.02h,Stop Loss,$98.25,$462.00,$290100.50,226,$462.00
2024-11-13,16:42:00,21125.5,SELL,3,0.02h,Stop Loss,$282.00,$744.00,$290382.50,226,$744.00
2024-11-13,16:49:00,21153.25,BUY,3,0.02h,Stop Loss,$64.50,$808.50,$290447.00,226,$808.50
2024-11-13,17:45:00,21173.0,SELL,3,0.02h,Stop Loss,$-18.00,$790.50,$290429.00,226,$790.50
2024-11-13,17:48:00,21202.5,BUY,3,0.02h,Stop Loss,$42.00,$832.50,$290471.00,226,$832.50
2024-11-13,18:18:00,21213.5,SELL,3,0.02h,Stop Loss,$23.25,$855.75,$290494.25,226,$855.75
2024-11-13,18:24:00,21229.5,BUY,3,0.02h,Break Even,$0.75,$856.50,$290495.00,226,$856.50
2024-11-13,19:06:00,21231.5,SELL,3,0.02h,Break Even,$0.75,$857.25,$290495.75,226,$857.25
2024-11-13,20:15:00,21189.0,BUY,3,0.02h,Stop Loss,$68.25,$925.50,$290564.00,226,$925.50
2024-11-13,20:29:00,21180.25,SELL,3,0.02h,Break Even,$0.75,$926.25,$290564.75,226,$926.25
2024-11-13,20:35:00,21202.5,BUY,3,0.02h,Stop Loss,$214.50,$1140.75,$290779.25,226,$1140.75
2024-11-13,20:50:00,21192.5,SELL,3,0.02h,Stop Loss,$342.00,$1482.75,$291121.25,226,$1482.75
2024-11-13,21:13:00,21169.25,BUY,3,0.02h,Stop Loss,$42.00,$1524.75,$291163.25,226,$1524.75
2024-11-13,21:49:00,21168.75,SELL,3,0.02h,Break Even,$0.75,$1525.50,$291164.00,226,$1525.50
,,,,,,,,,,,
2024-11-14,12:02:00,21175.25,BUY,3,0.02h,Break Even,$0.75,$0.75,$291164.75,227,$0.75
2024-11-14,12:07:00,21168.5,SELL,3,0.02h,Break Even,$0.75,$1.50,$291165.50,227,$1.50
2024-11-14,12:19:00,21171.5,BUY,3,0.02h,Stop Loss,$-18.00,$-16.50,$291147.50,227,$-16.50
2024-11-14,12:22:00,21167.75,SELL,3,0.02h,Break Even,$0.75,$-15.75,$291148.25,227,$-15.75
2024-11-14,12:33:00,21172.25,BUY,3,0.02h,Break Even,$0.75,$-15.00,$291149.00,227,$-15.00
2024-11-14,12:49:00,21164.75,SELL,3,0.02h,Break Even,$0.75,$-14.25,$291149.75,227,$-14.25
2024-11-14,13:15:00,21169.5,BUY,3,0.02h,Break Even,$0.75,$-13.50,$291150.50,227,$-13.50
2024-11-14,13:32:00,21135.0,SELL,3,0.02h,Stop Loss,$-18.00,$-31.50,$291132.50,227,$-31.50
2024-11-14,14:14:00,21139.75,BUY,3,0.02h,Break Even,$0.75,$-30.75,$291133.25,227,$-30.75
2024-11-14,14:19:00,21133.25,SELL,3,0.02h,Break Even,$0.75,$-30.00,$291134.00,227,$-30.00
2024-11-14,14:31:00,21161.0,BUY,3,0.02h,Stop Loss,$23.25,$-6.75,$291157.25,227,$-6.75
2024-11-14,14:42:00,21098.75,SELL,3,0.02h,Break Even,$0.75,$-6.00,$291158.00,227,$-6.00
2024-11-14,15:15:00,21107.0,BUY,3,0.02h,Break Even,$0.75,$-5.25,$291158.75,227,$-5.25
2024-11-14,15:18:00,21091.5,SELL,3,0.02h,Stop Loss,$330.75,$325.50,$291489.50,227,$325.50
2024-11-14,15:31:00,21097.0,BUY,3,0.02h,Break Even,$0.75,$326.25,$291490.25,227,$326.25
2024-11-14,15:59:00,21094.5,SELL,3,0.02h,Stop Loss,$139.50,$465.75,$291629.75,227,$465.75
2024-11-14,16:25:00,21112.5,BUY,3,0.02h,Stop Loss,$34.50,$500.25,$291664.25,227,$500.25
2024-11-14,16:54:00,21110.5,SELL,3,0.02h,Stop Loss,$75.75,$576.00,$291740.00,227,$576.00
2024-11-14,17:42:00,21074.25,BUY,3,0.02h,Break Even,$0.75,$576.75,$291740.75,227,$576.75
2024-11-14,17:49:00,21054.5,SELL,3,0.02h,Stop Loss,$499.50,$1076.25,$292240.25,227,$1076.25
2024-11-14,17:56:00,21077.5,BUY,3,0.02h,Stop Loss,$12.00,$1088.25,$292252.25,227,$1088.25
2024-11-14,18:33:00,21089.5,SELL,3,0.02h,Stop Loss,$57.00,$1145.25,$292309.25,227,$1145.25
2024-11-14,19:06:00,21078.75,BUY,3,0.02h,Stop Loss,$42.00,$1187.25,$292351.25,227,$1187.25
2024-11-14,19:14:00,21055.75,SELL,3,0.02h,Stop Loss,$38.25,$1225.50,$292389.50,227,$1225.50
2024-11-14,19:30:00,21066.0,BUY,3,0.02h,Break Even,$0.75,$1226.25,$292390.25,227,$1226.25
2024-11-14,19:48:00,21057.25,SELL,3,0.02h,Stop Loss,$45.75,$1272.00,$292436.00,227,$1272.00
2024-11-14,19:53:00,21077.25,BUY,3,0.02h,Stop Loss,$150.75,$1422.75,$292586.75,227,$1422.75
2024-11-14,20:01:00,21042.25,SELL,3,0.02h,Stop Loss,$75.75,$1498.50,$292662.50,227,$1498.50
2024-11-14,20:29:00,21032.25,BUY,3,0.02h,Stop Loss,$64.50,$1563.00,$292727.00,227,$1563.00
2024-11-14,20:31:00,21016.0,SELL,3,0.02h,Stop Loss,$109.50,$1672.50,$292836.50,227,$1672.50
2024-11-14,21:00:00,21008.75,BUY,3,0.02h,Stop Loss,$12.00,$1684.50,$292848.50,227,$1684.50
2024-11-14,21:05:00,20994.75,SELL,3,0.02h,Break Even,$0.75,$1685.25,$292849.25,227,$1685.25
2024-11-14,21:36:00,20982.0,BUY,3,0.02h,Stop Loss,$-18.00,$1667.25,$292831.25,227,$1667.25
,,,,,,,,,,,
2024-11-15,12:00:00,20844.0,SELL,3,0.02h,Stop Loss,$27.00,$27.00,$292858.25,228,$27.00
2024-11-15,12:50:00,20854.75,BUY,3,0.02h,Break Even,$0.75,$27.75,$292859.00,228,$27.75
2024-11-15,13:07:00,20851.0,SELL,3,0.02h,Break Even,$0.75,$28.50,$292859.75,228,$28.50
2024-11-15,16:19:00,20566.75,BUY,3,0.02h,Stop Loss,$68.25,$96.75,$292928.00,228,$96.75
2024-11-15,16:38:00,20550.5,SELL,3,0.02h,Stop Loss,$60.75,$157.50,$292988.75,228,$157.50
2024-11-15,17:45:00,20502.75,BUY,3,0.02h,Stop Loss,$90.75,$248.25,$293079.50,228,$248.25
2024-11-15,17:51:00,20467.25,SELL,3,0.02h,Stop Loss,$-18.00,$230.25,$293061.50,228,$230.25
2024-11-15,19:08:00,20440.25,BUY,3,0.02h,Stop Loss,$180.75,$411.00,$293242.25,228,$411.00
2024-11-15,19:21:00,20434.75,SELL,3,0.02h,Stop Loss,$12.00,$423.00,$293254.25,228,$423.00
2024-11-15,19:41:00,20444.5,BUY,3,0.02h,Stop Loss,$79.50,$502.50,$293333.75,228,$502.50
2024-11-15,20:42:00,20468.75,SELL,3,0.02h,Stop Loss,$57.00,$559.50,$293390.75,228,$559.50
2024-11-15,20:55:00,20500.75,BUY,3,0.02h,Stop Loss,$147.00,$706.50,$293537.75,228,$706.50
2024-11-15,21:24:00,20497.25,SELL,3,0.02h,Break Even,$0.75,$707.25,$293538.50,228,$707.25
2024-11-15,21:41:00,20499.0,BUY,3,0.02h,Stop Loss,$-18.00,$689.25,$293520.50,228,$689.25
2024-11-15,21:46:00,20495.5,SELL,3,0.02h,Stop Loss,$-18.00,$671.25,$293502.50,228,$671.25
2024-11-15,21:47:00,20498.0,BUY,3,0.02h,Stop Loss,$12.00,$683.25,$293514.50,228,$683.25
,,,,,,,,,,,
2024-11-18,12:34:00,20551.0,SELL,3,0.02h,Stop Loss,$-18.00,$-18.00,$293496.50,229,$-18.00
2024-11-18,12:37:00,20567.25,BUY,3,0.02h,Break Even,$0.75,$-17.25,$293497.25,229,$-17.25
2024-11-18,12:54:00,20562.25,SELL,3,0.02h,Stop Loss,$-18.00,$-35.25,$293479.25,229,$-35.25
2024-11-18,13:36:00,20531.25,BUY,3,0.02h,Stop Loss,$27.00,$-8.25,$293506.25,229,$-8.25
2024-11-18,14:30:00,20557.25,SELL,3,0.02h,Stop Loss,$312.00,$303.75,$293818.25,229,$303.75
2024-11-18,15:03:00,20565.75,BUY,3,0.02h,Break Even,$0.75,$304.50,$293819.00,229,$304.50
2024-11-18,16:49:00,20684.0,SELL,3,0.02h,Stop Loss,$120.75,$425.25,$293939.75,229,$425.25
2024-11-18,17:28:00,20663.25,BUY,3,0.02h,Stop Loss,$-18.00,$407.25,$293921.75,229,$407.25
2024-11-18,17:31:00,20651.0,SELL,3,0.02h,Break Even,$0.75,$408.00,$293922.50,229,$408.00
2024-11-18,17:59:00,20656.75,BUY,3,0.02h,Stop Loss,$34.50,$442.50,$293957.00,229,$442.50
2024-11-18,18:27:00,20653.25,SELL,3,0.02h,Break Even,$0.75,$443.25,$293957.75,229,$443.25
2024-11-18,18:58:00,20646.25,BUY,3,0.02h,Stop Loss,$83.25,$526.50,$294041.00,229,$526.50
2024-11-18,19:11:00,20628.75,SELL,3,0.02h,Stop Loss,$23.25,$549.75,$294064.25,229,$549.75
2024-11-18,19:42:00,20616.75,BUY,3,0.02h,Stop Loss,$27.00,$576.75,$294091.25,229,$576.75
2024-11-18,20:34:00,20632.5,SELL,3,0.02h,Break Even,$0.75,$577.50,$294092.00,229,$577.50
2024-11-18,20:50:00,20645.25,BUY,3,0.02h,Stop Loss,$-18.00,$559.50,$294074.00,229,$559.50
2024-11-18,20:51:00,20630.5,SELL,3,0.02h,Stop Loss,$15.75,$575.25,$294089.75,229,$575.25
2024-11-18,21:03:00,20645.5,BUY,3,0.02h,Break Even,$0.75,$576.00,$294090.50,229,$576.00
2024-11-18,21:10:00,20626.25,SELL,3,0.02h,Break Even,$0.75,$576.75,$294091.25,229,$576.75
2024-11-18,21:44:00,20632.75,BUY,3,0.02h,Stop Loss,$-18.00,$558.75,$294073.25,229,$558.75
,,,,,,,,,,,
2024-11-19,12:00:00,20580.0,SELL,3,0.02h,Break Even,$0.75,$0.75,$294074.00,230,$0.75
2024-11-19,12:15:00,20616.75,BUY,3,0.02h,Break Even,$0.75,$1.50,$294074.75,230,$1.50
2024-11-19,12:17:00,20608.5,SELL,3,0.02h,Stop Loss,$19.50,$21.00,$294094.25,230,$21.00
2024-11-19,12:55:00,20609.25,BUY,3,0.02h,Break Even,$0.75,$21.75,$294095.00,230,$21.75
2024-11-19,13:10:00,20602.0,SELL,3,0.02h,Break Even,$0.75,$22.50,$294095.75,230,$22.50
2024-11-19,14:12:00,20481.75,BUY,3,0.02h,Stop Loss,$27.00,$49.50,$294122.75,230,$49.50
2024-11-19,15:01:00,20526.5,SELL,3,0.02h,Stop Loss,$-18.00,$31.50,$294104.75,230,$31.50
2024-11-19,15:02:00,20552.5,BUY,3,0.02h,Break Even,$0.75,$32.25,$294105.50,230,$32.25
2024-11-19,15:03:00,20524.75,SELL,3,0.02h,Stop Loss,$-18.00,$14.25,$294087.50,230,$14.25
2024-11-19,15:07:00,20560.75,BUY,3,0.02h,Stop Loss,$15.75,$30.00,$294103.25,230,$30.00
2024-11-19,16:54:00,20671.0,SELL,3,0.02h,Stop Loss,$72.00,$102.00,$294175.25,230,$102.00
2024-11-19,17:14:00,20675.75,BUY,3,0.02h,Break Even,$0.75,$102.75,$294176.00,230,$102.75
2024-11-19,17:22:00,20660.75,SELL,3,0.02h,Stop Loss,$222.00,$324.75,$294398.00,230,$324.75
2024-11-19,17:30:00,20685.0,BUY,3,0.02h,Stop Loss,$-18.00,$306.75,$294380.00,230,$306.75
2024-11-19,17:54:00,20684.5,SELL,3,0.02h,Stop Loss,$-18.00,$288.75,$294362.00,230,$288.75
2024-11-19,17:56:00,20693.75,BUY,3,0.02h,Stop Loss,$-18.00,$270.75,$294344.00,230,$270.75
2024-11-19,18:02:00,20683.75,SELL,3,0.02h,Break Even,$0.75,$271.50,$294344.75,230,$271.50
2024-11-19,18:04:00,20691.75,BUY,3,0.02h,Stop Loss,$27.00,$298.50,$294371.75,230,$298.50
2024-11-19,19:18:00,20765.25,SELL,3,0.02h,Stop Loss,$27.00,$325.50,$294398.75,230,$325.50
2024-11-19,19:54:00,20744.75,BUY,3,0.02h,Stop Loss,$42.00,$367.50,$294440.75,230,$367.50
2024-11-19,20:04:00,20729.0,SELL,3,0.02h,Break Even,$0.75,$368.25,$294441.50,230,$368.25
2024-11-19,20:07:00,20743.5,BUY,3,0.02h,Break Even,$0.75,$369.00,$294442.25,230,$369.00
2024-11-19,21:22:00,20768.0,SELL,3,0.02h,Break Even,$0.75,$369.75,$294443.00,230,$369.75
,,,,,,,,,,,
2024-11-20,12:00:00,20793.25,BUY,3,0.02h,Break Even,$0.75,$0.75,$294443.75,231,$0.75
2024-11-20,12:36:00,20807.5,SELL,3,0.02h,Stop Loss,$-18.00,$-17.25,$294425.75,231,$-17.25
2024-11-20,12:45:00,20814.0,BUY,3,0.02h,Break Even,$0.75,$-16.50,$294426.50,231,$-16.50
2024-11-20,13:14:00,20814.25,SELL,3,0.02h,Break Even,$0.75,$-15.75,$294427.25,231,$-15.75
2024-11-20,13:20:00,20823.25,BUY,3,0.02h,Stop Loss,$15.75,$0.00,$294443.00,231,$0.00
2024-11-20,13:28:00,20817.5,SELL,3,0.02h,Break Even,$0.75,$0.75,$294443.75,231,$0.75
2024-11-20,15:34:00,20561.25,BUY,3,0.02h,Stop Loss,$124.50,$125.25,$294568.25,231,$125.25
2024-11-20,16:12:00,20586.75,SELL,3,0.02h,Stop Loss,$19.50,$144.75,$294587.75,231,$144.75
2024-11-20,16:41:00,20610.0,BUY,3,0.02h,Stop Loss,$75.75,$220.50,$294663.50,231,$220.50
2024-11-20,17:11:00,20660.25,SELL,3,0.02h,Stop Loss,$90.75,$311.25,$294754.25,231,$311.25
2024-11-20,17:35:00,20637.75,BUY,3,0.02h,Stop Loss,$53.25,$364.50,$294807.50,231,$364.50
2024-11-20,17:55:00,20609.0,SELL,3,0.02h,Stop Loss,$-18.00,$346.50,$294789.50,231,$346.50
2024-11-20,18:28:00,20625.0,BUY,3,0.02h,Stop Loss,$57.00,$403.50,$294846.50,231,$403.50
2024-11-20,18:35:00,20605.75,SELL,3,0.02h,Stop Loss,$19.50,$423.00,$294866.00,231,$423.00
2024-11-20,19:03:00,20589.75,BUY,3,0.02h,Stop Loss,$38.25,$461.25,$294904.25,231,$461.25
2024-11-20,19:07:00,20570.75,SELL,3,0.02h,Stop Loss,$45.75,$507.00,$294950.00,231,$507.00
2024-11-20,19:35:00,20583.75,BUY,3,0.02h,Stop Loss,$19.50,$526.50,$294969.50,231,$526.50
2024-11-20,20:08:00,20598.25,SELL,3,0.02h,Break Even,$0.75,$527.25,$294970.25,231,$527.25
2024-11-20,20:10:00,20610.5,BUY,3,0.02h,Stop Loss,$38.25,$565.50,$295008.50,231,$565.50
2024-11-20,21:21:00,20644.25,SELL,3,0.02h,Stop Loss,$499.50,$1065.00,$295508.00,231,$1065.00
2024-11-20,21:45:00,20711.75,BUY,3,0.02h,Stop Loss,$270.75,$1335.75,$295778.75,231,$1335.75
,,,,,,,,,,,
2024-11-21,12:37:00,20773.25,SELL,3,0.02h,Break Even,$0.75,$0.75,$295779.50,232,$0.75
2024-11-21,12:43:00,20799.0,BUY,3,0.02h,Stop Loss,$98.25,$99.00,$295877.75,232,$99.00
2024-11-21,12:50:00,20774.25,SELL,3,0.02h,Stop Loss,$12.00,$111.00,$295889.75,232,$111.00
2024-11-21,13:13:00,20777.5,BUY,3,0.02h,Stop Loss,$109.50,$220.50,$295999.25,232,$220.50
2024-11-21,14:34:00,20837.0,SELL,3,0.02h,Stop Loss,$807.00,$1027.50,$296806.25,232,$1027.50
2024-11-21,15:17:00,20706.25,BUY,3,0.02h,Stop Loss,$-18.00,$1009.50,$296788.25,232,$1009.50
2024-11-21,15:24:00,20618.0,SELL,3,0.02h,Stop Loss,$379.50,$1389.00,$297167.75,232,$1389.00
2024-11-21,15:47:00,20615.75,BUY,3,0.02h,Stop Loss,$278.25,$1667.25,$297446.00,232,$1667.25
2024-11-21,16:47:00,20728.0,SELL,3,0.02h,Stop Loss,$233.25,$1900.50,$297679.25,232,$1900.50
2024-11-21,17:10:00,20741.5,BUY,3,0.02h,Stop Loss,$83.25,$1983.75,$297762.50,232,$1983.75
2024-11-21,18:19:00,20822.0,SELL,3,0.02h,Break Even,$0.75,$1984.50,$297763.25,232,$1984.50
2024-11-21,18:24:00,20834.25,BUY,3,0.02h,Stop Loss,$79.50,$2064.00,$297842.75,232,$2064.00
2024-11-21,18:42:00,20831.0,SELL,3,0.02h,Stop Loss,$-18.00,$2046.00,$297824.75,232,$2046.00
2024-11-21,18:45:00,20849.75,BUY,3,0.02h,Stop Loss,$23.25,$2069.25,$297848.00,232,$2069.25
2024-11-21,18:53:00,20837.75,SELL,3,0.02h,Stop Loss,$34.50,$2103.75,$297882.50,232,$2103.75
2024-11-21,18:55:00,20852.5,BUY,3,0.02h,Stop Loss,$135.75,$2239.50,$298018.25,232,$2239.50
2024-11-21,19:07:00,20845.0,SELL,3,0.02h,Stop Loss,$203.25,$2442.75,$298221.50,232,$2442.75
2024-11-21,19:27:00,20844.5,BUY,3,0.02h,Stop Loss,$-18.00,$2424.75,$298203.50,232,$2424.75
2024-11-21,19:51:00,20826.5,SELL,3,0.02h,Stop Loss,$42.00,$2466.75,$298245.50,232,$2466.75
2024-11-21,19:59:00,20844.0,BUY,3,0.02h,Stop Loss,$45.75,$2512.50,$298291.25,232,$2512.50
2024-11-21,20:35:00,20852.0,SELL,3,0.02h,Stop Loss,$203.25,$2715.75,$298494.50,232,$2715.75
2024-11-21,21:52:00,20808.5,BUY,3,0.02h,Stop Loss,$-18.00,$2697.75,$298476.50,232,$2697.75
2024-11-21,21:54:00,20798.5,SELL,3,0.02h,Stop Loss,$-18.00,$2679.75,$298458.50,232,$2679.75
2024-11-21,21:55:00,20801.0,BUY,3,0.02h,Stop Loss,$-18.00,$2661.75,$298440.50,232,$2661.75
2024-11-21,21:59:00,20795.5,SELL,3,0.02h,Break Even,$0.75,$2662.50,$298441.25,232,$2662.50
,,,,,,,,,,,
2024-11-22,12:26:00,20786.75,BUY,3,0.02h,Stop Loss,$-18.00,$-18.00,$298423.25,233,$-18.00
2024-11-22,12:28:00,20782.25,SELL,3,0.02h,Break Even,$0.75,$-17.25,$298424.00,233,$-17.25
2024-11-22,12:30:00,20789.5,BUY,3,0.02h,Break Even,$0.75,$-16.50,$298424.75,233,$-16.50
2024-11-22,12:32:00,20777.5,SELL,3,0.02h,Stop Loss,$-18.00,$-34.50,$298406.75,233,$-34.50
2024-11-22,12:36:00,20795.0,BUY,3,0.02h,Break Even,$0.75,$-33.75,$298407.50,233,$-33.75
2024-11-22,12:43:00,20780.0,SELL,3,0.02h,Break Even,$0.75,$-33.00,$298408.25,233,$-33.00
2024-11-22,12:48:00,20786.25,BUY,3,0.02h,Stop Loss,$-18.00,$-51.00,$298390.25,233,$-51.00
2024-11-22,12:49:00,20782.0,SELL,3,0.02h,Break Even,$0.75,$-50.25,$298391.00,233,$-50.25
2024-11-22,12:51:00,20791.0,BUY,3,0.02h,Stop Loss,$-18.00,$-68.25,$298373.00,233,$-68.25
2024-11-22,13:16:00,20785.25,SELL,3,0.02h,Stop Loss,$-18.00,$-86.25,$298355.00,233,$-86.25
2024-11-22,13:21:00,20800.25,BUY,3,0.02h,Stop Loss,$188.25,$102.00,$298543.25,233,$102.00
2024-11-22,13:33:00,20790.5,SELL,3,0.02h,Break Even,$0.75,$102.75,$298544.00,233,$102.75
2024-11-22,14:08:00,20790.5,BUY,3,0.02h,Stop Loss,$-18.00,$84.75,$298526.00,233,$84.75
2024-11-22,14:23:00,20785.75,SELL,3,0.02h,Stop Loss,$68.25,$153.00,$298594.25,233,$153.00
2024-11-22,14:33:00,20811.25,BUY,3,0.02h,Stop Loss,$113.25,$266.25,$298707.50,233,$266.25
2024-11-22,14:54:00,20798.25,SELL,3,0.02h,Stop Loss,$-18.00,$248.25,$298689.50,233,$248.25
2024-11-22,14:57:00,20835.75,BUY,3,0.02h,Stop Loss,$57.00,$305.25,$298746.50,233,$305.25
2024-11-22,15:06:00,20805.5,SELL,3,0.02h,Stop Loss,$-18.00,$287.25,$298728.50,233,$287.25
2024-11-22,15:40:00,20815.5,BUY,3,0.02h,Stop Loss,$68.25,$355.50,$298796.75,233,$355.50
2024-11-22,16:10:00,20808.5,SELL,3,0.02h,Stop Loss,$102.00,$457.50,$298898.75,233,$457.50
2024-11-22,16:40:00,20804.0,BUY,3,0.02h,Break Even,$0.75,$458.25,$298899.50,233,$458.25
2024-11-22,16:44:00,20763.75,SELL,3,0.02h,Stop Loss,$42.00,$500.25,$298941.50,233,$500.25
2024-11-22,16:50:00,20794.25,BUY,3,0.02h,Stop Loss,$34.50,$534.75,$298976.00,233,$534.75
2024-11-22,17:36:00,20823.0,SELL,3,0.02h,Stop Loss,$68.25,$603.00,$299044.25,233,$603.00
2024-11-22,17:48:00,20827.5,BUY,3,0.02h,Stop Loss,$87.00,$690.00,$299131.25,233,$690.00
2024-11-22,18:30:00,20851.5,SELL,3,0.02h,Break Even,$0.75,$690.75,$299132.00,233,$690.75
2024-11-22,18:32:00,20868.0,BUY,3,0.02h,Stop Loss,$34.50,$725.25,$299166.50,233,$725.25
2024-11-22,18:35:00,20857.5,SELL,3,0.02h,Break Even,$0.75,$726.00,$299167.25,233,$726.00
2024-11-22,19:29:00,20830.5,BUY,3,0.02h,Stop Loss,$-18.00,$708.00,$299149.25,233,$708.00
2024-11-22,20:04:00,20819.25,SELL,3,0.02h,Stop Loss,$218.25,$926.25,$299367.50,233,$926.25
2024-11-22,20:26:00,20827.25,BUY,3,0.02h,Break Even,$0.75,$927.00,$299368.25,233,$927.00
2024-11-22,20:40:00,20823.0,SELL,3,0.02h,Stop Loss,$27.00,$954.00,$299395.25,233,$954.00
2024-11-22,20:48:00,20833.0,BUY,3,0.02h,Break Even,$0.75,$954.75,$299396.00,233,$954.75
,,,,,,,,,,,
2024-11-25,12:33:00,20946.75,SELL,3,0.02h,Stop Loss,$-18.00,$-18.00,$299378.00,234,$-18.00
2024-11-25,12:35:00,20958.0,BUY,3,0.02h,Break Even,$0.75,$-17.25,$299378.75,234,$-17.25
2024-11-25,13:02:00,20956.25,SELL,3,0.02h,Break Even,$0.75,$-16.50,$299379.50,234,$-16.50
2024-11-25,13:27:00,20955.75,BUY,3,0.02h,Break Even,$0.75,$-15.75,$299380.25,234,$-15.75
2024-11-25,13:32:00,20949.0,SELL,3,0.02h,Stop Loss,$-18.00,$-33.75,$299362.25,234,$-33.75
2024-11-25,13:35:00,20953.5,BUY,3,0.02h,Break Even,$0.75,$-33.00,$299363.00,234,$-33.00
2024-11-25,14:30:00,21016.25,SELL,3,0.02h,Stop Loss,$563.25,$530.25,$299926.25,234,$530.25
2024-11-25,14:40:00,21054.75,BUY,3,0.02h,Stop Loss,$105.75,$636.00,$300032.00,234,$636.00
2024-11-25,14:52:00,20973.25,SELL,3,0.02h,Stop Loss,$390.75,$1026.75,$300422.75,234,$1026.75
2024-11-25,15:31:00,20940.25,BUY,3,0.02h,Stop Loss,$-18.00,$1008.75,$300404.75,234,$1008.75
2024-11-25,15:34:00,20890.75,SELL,3,0.02h,Stop Loss,$128.25,$1137.00,$300533.00,234,$1137.00
2024-11-25,15:44:00,20936.0,BUY,3,0.02h,Stop Loss,$87.00,$1224.00,$300620.00,234,$1224.00
2024-11-25,15:56:00,20911.25,SELL,3,0.02h,Stop Loss,$195.75,$1419.75,$300815.75,234,$1419.75
2024-11-25,16:13:00,20917.5,BUY,3,0.02h,Stop Loss,$23.25,$1443.00,$300839.00,234,$1443.00
2024-11-25,16:37:00,20907.0,SELL,3,0.02h,Stop Loss,$105.75,$1548.75,$300944.75,234,$1548.75
2024-11-25,17:54:00,20845.0,BUY,3,0.02h,Stop Loss,$38.25,$1587.00,$300983.00,234,$1587.00
2024-11-25,18:32:00,20864.5,SELL,3,0.02h,Stop Loss,$-18.00,$1569.00,$300965.00,234,$1569.00
2024-11-25,18:33:00,20874.75,BUY,3,0.02h,Stop Loss,$109.50,$1678.50,$301074.50,234,$1678.50
2024-11-25,18:44:00,20866.25,SELL,3,0.02h,Stop Loss,$117.00,$1795.50,$301191.50,234,$1795.50
2024-11-25,19:11:00,20864.25,BUY,3,0.02h,Break Even,$0.75,$1796.25,$301192.25,234,$1796.25
2024-11-25,19:23:00,20844.25,SELL,3,0.02h,Stop Loss,$233.25,$2029.50,$301425.50,234,$2029.50
2024-11-25,19:44:00,20857.25,BUY,3,0.02h,Break Even,$0.75,$2030.25,$301426.25,234,$2030.25
2024-11-25,20:03:00,20848.75,SELL,3,0.02h,Stop Loss,$83.25,$2113.50,$301509.50,234,$2113.50
2024-11-25,20:26:00,20856.5,BUY,3,0.02h,Break Even,$0.75,$2114.25,$301510.25,234,$2114.25
2024-11-25,21:42:00,20897.5,SELL,3,0.02h,Stop Loss,$-18.00,$2096.25,$301492.25,234,$2096.25
2024-11-25,21:58:00,20902.5,BUY,3,0.02h,Stop Loss,$-18.00,$2078.25,$301474.25,234,$2078.25
,,,,,,,,,,,
2024-11-26,12:58:00,20938.25,SELL,3,0.02h,Stop Loss,$-18.00,$-18.00,$301456.25,235,$-18.00
2024-11-26,12:59:00,20947.25,BUY,3,0.02h,Break Even,$0.75,$-17.25,$301457.00,235,$-17.25
2024-11-26,13:02:00,20941.75,SELL,3,0.02h,Stop Loss,$49.50,$32.25,$301506.50,235,$32.25
2024-11-26,13:34:00,20936.5,BUY,3,0.02h,Stop Loss,$-18.00,$14.25,$301488.50,235,$14.25
2024-11-26,14:24:00,20947.0,SELL,3,0.02h,Break Even,$0.75,$15.00,$301489.25,235,$15.00
2024-11-26,14:33:00,20981.0,BUY,3,0.02h,Stop Loss,$83.25,$98.25,$301572.50,235,$98.25
2024-11-26,14:57:00,20957.0,SELL,3,0.02h,Break Even,$0.75,$99.00,$301573.25,235,$99.00
2024-11-26,15:32:00,20966.0,BUY,3,0.02h,Stop Loss,$75.75,$174.75,$301649.00,235,$174.75
2024-11-26,15:54:00,20957.5,SELL,3,0.02h,Stop Loss,$-18.00,$156.75,$301631.00,235,$156.75
2024-11-26,15:58:00,20971.0,BUY,3,0.02h,Stop Loss,$60.75,$217.50,$301691.75,235,$217.50
2024-11-26,16:00:00,20950.0,SELL,3,0.02h,Stop Loss,$-18.00,$199.50,$301673.75,235,$199.50
2024-11-26,16:03:00,20977.5,BUY,3,0.02h,Stop Loss,$45.75,$245.25,$301719.50,235,$245.25
2024-11-26,16:12:00,20957.5,SELL,3,0.02h,Stop Loss,$34.50,$279.75,$301754.00,235,$279.75
2024-11-26,16:33:00,20960.5,BUY,3,0.02h,Stop Loss,$-18.00,$261.75,$301736.00,235,$261.75
2024-11-26,16:34:00,20953.75,SELL,3,0.02h,Break Even,$0.75,$262.50,$301736.75,235,$262.50
2024-11-26,16:35:00,20959.25,BUY,3,0.02h,Stop Loss,$-18.00,$244.50,$301718.75,235,$244.50
2024-11-26,16:36:00,20956.0,SELL,3,0.02h,Stop Loss,$135.75,$380.25,$301854.50,235,$380.25
2024-11-26,16:40:00,20963.75,BUY,3,0.02h,Stop Loss,$-18.00,$362.25,$301836.50,235,$362.25
2024-11-26,16:42:00,20948.5,SELL,3,0.02h,Break Even,$0.75,$363.00,$301837.25,235,$363.00
2024-11-26,16:55:00,20961.0,BUY,3,0.02h,Stop Loss,$27.00,$390.00,$301864.25,235,$390.00
2024-11-26,17:07:00,20945.75,SELL,3,0.02h,Break Even,$0.75,$390.75,$301865.00,235,$390.75
2024-11-26,17:11:00,20958.25,BUY,3,0.02h,Stop Loss,$-18.00,$372.75,$301847.00,235,$372.75
2024-11-26,17:13:00,20943.5,SELL,3,0.02h,Stop Loss,$23.25,$396.00,$301870.25,235,$396.00
2024-11-26,17:33:00,20947.0,BUY,3,0.02h,Stop Loss,$60.75,$456.75,$301931.00,235,$456.75
2024-11-26,18:11:00,20965.5,SELL,3,0.02h,Break Even,$0.75,$457.50,$301931.75,235,$457.50
2024-11-26,18:34:00,20966.25,BUY,3,0.02h,Break Even,$0.75,$458.25,$301932.50,235,$458.25
2024-11-26,18:37:00,20954.75,SELL,3,0.02h,Stop Loss,$12.00,$470.25,$301944.50,235,$470.25
2024-11-26,18:41:00,20966.75,BUY,3,0.02h,Stop Loss,$64.50,$534.75,$302009.00,235,$534.75
2024-11-26,18:58:00,20963.0,SELL,3,0.02h,Stop Loss,$-18.00,$516.75,$301991.00,235,$516.75
2024-11-26,18:59:00,20968.25,BUY,3,0.02h,Break Even,$0.75,$517.50,$301991.75,235,$517.50
2024-11-26,19:08:00,20958.75,SELL,3,0.02h,Break Even,$0.75,$518.25,$301992.50,235,$518.25
2024-11-26,19:41:00,20933.25,BUY,3,0.02h,Stop Loss,$79.50,$597.75,$302072.00,235,$597.75
2024-11-26,19:44:00,20925.75,SELL,3,0.02h,Stop Loss,$-18.00,$579.75,$302054.00,235,$579.75
2024-11-26,19:49:00,20935.0,BUY,3,0.02h,Break Even,$0.75,$580.50,$302054.75,235,$580.50
2024-11-26,19:55:00,20925.75,SELL,3,0.02h,Break Even,$0.75,$581.25,$302055.50,235,$581.25
2024-11-26,20:02:00,20936.75,BUY,3,0.02h,Break Even,$0.75,$582.00,$302056.25,235,$582.00
2024-11-26,20:23:00,20938.5,SELL,3,0.02h,Break Even,$0.75,$582.75,$302057.00,235,$582.75
2024-11-26,20:25:00,20945.0,BUY,3,0.02h,Stop Loss,$57.00,$639.75,$302114.00,235,$639.75
2024-11-26,21:33:00,20993.5,SELL,3,0.02h,Break Even,$0.75,$640.50,$302114.75,235,$640.50
2024-11-26,21:38:00,21001.0,BUY,3,0.02h,Break Even,$0.75,$641.25,$302115.50,235,$641.25
,,,,,,,,,,,
2024-11-27,12:00:00,20930.25,SELL,3,0.02h,Stop Loss,$-18.00,$-18.00,$302097.50,236,$-18.00
2024-11-27,12:39:00,20941.5,BUY,3,0.02h,Stop Loss,$-18.00,$-36.00,$302079.50,236,$-36.00
2024-11-27,13:35:00,20947.0,SELL,3,0.02h,Stop Loss,$23.25,$-12.75,$302102.75,236,$-12.75
2024-11-27,13:44:00,20962.25,BUY,3,0.02h,Stop Loss,$-18.00,$-30.75,$302084.75,236,$-30.75
2024-11-27,13:48:00,20949.5,SELL,3,0.02h,Break Even,$0.75,$-30.00,$302085.50,236,$-30.00
2024-11-27,13:55:00,20959.25,BUY,3,0.02h,Break Even,$0.75,$-29.25,$302086.25,236,$-29.25
2024-11-27,13:59:00,20951.25,SELL,3,0.02h,Stop Loss,$-18.00,$-47.25,$302068.25,236,$-47.25
2024-11-27,14:18:00,20950.75,BUY,3,0.02h,Stop Loss,$-18.00,$-65.25,$302050.25,236,$-65.25
2024-11-27,14:25:00,20945.0,SELL,3,0.02h,Stop Loss,$-18.00,$-83.25,$302032.25,236,$-83.25
2024-11-27,14:27:00,20953.0,BUY,3,0.02h,Stop Loss,$-18.00,$-101.25,$302014.25,236,$-101.25
2024-11-27,14:28:00,20941.5,SELL,3,0.02h,Stop Loss,$83.25,$-18.00,$302097.50,236,$-18.00
2024-11-27,16:33:00,20736.75,BUY,3,0.02h,Break Even,$0.75,$-17.25,$302098.25,236,$-17.25
2024-11-27,16:47:00,20714.25,SELL,3,0.02h,Stop Loss,$30.75,$13.50,$302129.00,236,$13.50
2024-11-27,17:20:00,20717.0,BUY,3,0.02h,Stop Loss,$79.50,$93.00,$302208.50,236,$93.00
2024-11-27,19:30:00,20801.5,SELL,3,0.02h,Break Even,$0.75,$93.75,$302209.25,236,$93.75
2024-11-27,19:43:00,20810.25,BUY,3,0.02h,Stop Loss,$72.00,$165.75,$302281.25,236,$165.75
2024-11-27,20:00:00,20804.25,SELL,3,0.02h,Break Even,$0.75,$166.50,$302282.00,236,$166.50
2024-11-27,20:05:00,20823.25,BUY,3,0.02h,Stop Loss,$53.25,$219.75,$302335.25,236,$219.75
2024-11-27,20:19:00,20808.5,SELL,3,0.02h,Stop Loss,$60.75,$280.50,$302396.00,236,$280.50
2024-11-27,20:50:00,20803.5,BUY,3,0.02h,Stop Loss,$102.00,$382.50,$302498.00,236,$382.50
2024-11-27,21:17:00,20803.0,SELL,3,0.02h,Stop Loss,$-18.00,$364.50,$302480.00,236,$364.50
2024-11-27,21:23:00,20811.0,BUY,3,0.02h,Break Even,$0.75,$365.25,$302480.75,236,$365.25
2024-11-27,21:28:00,20806.5,SELL,3,0.02h,Stop Loss,$-18.00,$347.25,$302462.75,236,$347.25
2024-11-27,21:50:00,20806.25,BUY,3,0.02h,Stop Loss,$-18.00,$329.25,$302444.75,236,$329.25
,,,,,,,,,,,
2024-11-28,13:19:00,20869.75,SELL,3,0.02h,Break Even,$0.75,$0.75,$302445.50,237,$0.75
2024-11-28,13:41:00,20872.25,BUY,3,0.03h,Break Even,$0.75,$1.50,$302446.25,237,$1.50
2024-11-28,14:02:00,20871.5,SELL,3,0.02h,Stop Loss,$12.00,$13.50,$302458.25,237,$13.50
2024-11-28,14:16:00,20874.0,BUY,3,0.02h,Break Even,$0.75,$14.25,$302459.00,237,$14.25
2024-11-28,15:11:00,20885.5,SELL,3,0.02h,Stop Loss,$-18.00,$-3.75,$302441.00,237,$-3.75
2024-11-28,15:19:00,20894.75,BUY,3,0.02h,Break Even,$0.75,$-3.00,$302441.75,237,$-3.00
2024-11-28,15:38:00,20889.25,SELL,3,0.02h,Break Even,$0.75,$-2.25,$302442.50,237,$-2.25
2024-11-28,15:46:00,20898.25,BUY,3,0.02h,Break Even,$0.75,$-1.50,$302443.25,237,$-1.50
2024-11-28,16:25:00,20901.0,SELL,3,0.02h,Break Even,$0.75,$-0.75,$302444.00,237,$-0.75
2024-11-28,17:03:00,20888.25,BUY,3,0.02h,Break Even,$0.75,$0.00,$302444.75,237,$0.00
2024-11-28,17:47:00,20888.25,SELL,3,0.02h,Stop Loss,$30.75,$30.75,$302475.50,237,$30.75
,,,,,,,,,,,
2024-11-29,13:10:00,20860.0,BUY,3,0.02h,Break Even,$0.75,$0.75,$302476.25,238,$0.75
2024-11-29,13:17:00,20845.75,SELL,3,0.02h,Break Even,$0.75,$1.50,$302477.00,238,$1.50
2024-11-29,14:02:00,20842.0,BUY,3,0.02h,Stop Loss,$19.50,$21.00,$302496.50,238,$21.00
2024-11-29,14:29:00,20828.0,SELL,3,0.02h,Stop Loss,$42.00,$63.00,$302538.50,238,$63.00
2024-11-29,14:40:00,20865.25,BUY,3,0.02h,Stop Loss,$-18.00,$45.00,$302520.50,238,$45.00
2024-11-29,15:50:00,20943.5,SELL,3,0.02h,Stop Loss,$57.00,$102.00,$302577.50,238,$102.00
2024-11-29,16:02:00,20965.5,BUY,3,0.02h,Stop Loss,$49.50,$151.50,$302627.00,238,$151.50
2024-11-29,16:36:00,20976.0,SELL,3,0.02h,Stop Loss,$68.25,$219.75,$302695.25,238,$219.75
2024-11-29,16:45:00,20986.0,BUY,3,0.02h,Break Even,$0.75,$220.50,$302696.00,238,$220.50
2024-11-29,17:03:00,20983.0,SELL,3,0.02h,Stop Loss,$-18.00,$202.50,$302678.00,238,$202.50
2024-11-29,17:09:00,20996.0,BUY,3,0.02h,Stop Loss,$34.50,$237.00,$302712.50,238,$237.00
2024-11-29,17:15:00,20991.0,SELL,3,0.02h,Break Even,$0.75,$237.75,$302713.25,238,$237.75
2024-11-29,17:16:00,20996.75,BUY,3,0.02h,Break Even,$0.75,$238.50,$302714.00,238,$238.50
2024-11-29,17:28:00,20984.25,SELL,3,0.02h,Stop Loss,$15.75,$254.25,$302729.75,238,$254.25
2024-11-29,17:34:00,21000.75,BUY,3,0.02h,Stop Loss,$15.75,$270.00,$302745.50,238,$270.00
2024-11-29,17:47:00,20993.25,SELL,3,0.02h,Stop Loss,$23.25,$293.25,$302768.75,238,$293.25
2024-11-29,17:51:00,21015.25,BUY,3,0.02h,Break Even,$0.75,$294.00,$302769.50,238,$294.00
2024-11-29,18:00:00,20991.25,SELL,3,0.02h,Stop Loss,$23.25,$317.25,$302792.75,238,$317.25
,,,,,,,,,,,
2024-12-02,12:11:00,20995.25,BUY,3,0.02h,Break Even,$0.75,$0.75,$302793.50,239,$0.75
2024-12-02,13:41:00,21021.0,SELL,3,0.02h,Stop Loss,$109.50,$110.25,$302903.00,239,$110.25
2024-12-02,13:59:00,21024.75,BUY,3,0.02h,Break Even,$0.75,$111.00,$302903.75,239,$111.00
2024-12-02,14:27:00,21027.75,SELL,3,0.02h,Stop Loss,$-18.00,$93.00,$302885.75,239,$93.00
2024-12-02,14:30:00,21043.0,BUY,3,0.02h,Stop Loss,$255.75,$348.75,$303141.50,239,$348.75
2024-12-02,15:49:00,21181.0,SELL,3,0.02h,Stop Loss,$34.50,$383.25,$303176.00,239,$383.25
2024-12-02,16:08:00,21181.5,BUY,3,0.02h,Break Even,$0.75,$384.00,$303176.75,239,$384.00
2024-12-02,16:26:00,21177.25,SELL,3,0.02h,Stop Loss,$-18.00,$366.00,$303158.75,239,$366.00
2024-12-02,16:27:00,21183.75,BUY,3,0.02h,Break Even,$0.75,$366.75,$303159.50,239,$366.75
2024-12-02,17:30:00,21233.5,SELL,3,0.02h,Stop Loss,$72.00,$438.75,$303231.50,239,$438.75
2024-12-02,17:47:00,21244.5,BUY,3,0.02h,Stop Loss,$-18.00,$420.75,$303213.50,239,$420.75
2024-12-02,17:55:00,21235.5,SELL,3,0.02h,Break Even,$0.75,$421.50,$303214.25,239,$421.50
2024-12-02,18:25:00,21232.75,BUY,3,0.02h,Stop Loss,$-18.00,$403.50,$303196.25,239,$403.50
2024-12-02,18:30:00,21212.25,SELL,3,0.02h,Stop Loss,$188.25,$591.75,$303384.50,239,$591.75
2024-12-02,18:43:00,21221.5,BUY,3,0.02h,Break Even,$0.75,$592.50,$303385.25,239,$592.50
2024-12-02,18:54:00,21211.25,SELL,3,0.02h,Break Even,$0.75,$593.25,$303386.00,239,$593.25
2024-12-02,19:33:00,21198.75,BUY,3,0.02h,Stop Loss,$-18.00,$575.25,$303368.00,239,$575.25
2024-12-02,20:45:00,21224.0,SELL,3,0.02h,Break Even,$0.75,$576.00,$303368.75,239,$576.00
2024-12-02,21:07:00,21225.5,BUY,3,0.02h,Break Even,$0.75,$576.75,$303369.50,239,$576.75
2024-12-02,21:30:00,21225.0,SELL,3,0.02h,Break Even,$0.75,$577.50,$303370.25,239,$577.50
2024-12-02,21:40:00,21229.0,BUY,3,0.02h,Stop Loss,$-18.00,$559.50,$303352.25,239,$559.50
2024-12-02,21:43:00,21218.0,SELL,3,0.02h,Stop Loss,$53.25,$612.75,$303405.50,239,$612.75
,,,,,,,,,,,
2024-12-03,12:26:00,21208.75,BUY,3,0.02h,Break Even,$0.75,$0.75,$303406.25,240,$0.75
2024-12-03,12:49:00,21208.5,SELL,3,0.02h,Break Even,$0.75,$1.50,$303407.00,240,$1.50
2024-12-03,13:09:00,21213.25,BUY,3,0.02h,Stop Loss,$-18.00,$-16.50,$303389.00,240,$-16.50
2024-12-03,13:10:00,21207.75,SELL,3,0.02h,Stop Loss,$-18.00,$-34.50,$303371.00,240,$-34.50
2024-12-03,13:11:00,21211.0,BUY,3,0.02h,Break Even,$0.75,$-33.75,$303371.75,240,$-33.75
2024-12-03,13:19:00,21204.75,SELL,3,0.02h,Stop Loss,$-18.00,$-51.75,$303353.75,240,$-51.75
2024-12-03,13:26:00,21213.0,BUY,3,0.02h,Stop Loss,$-18.00,$-69.75,$303335.75,240,$-69.75
2024-12-03,13:28:00,21208.5,SELL,3,0.02h,Stop Loss,$-18.00,$-87.75,$303317.75,240,$-87.75
2024-12-03,13:29:00,21209.75,BUY,3,0.02h,Break Even,$0.75,$-87.00,$303318.50,240,$-87.00
2024-12-03,13:30:00,21207.0,SELL,3,0.02h,Break Even,$0.75,$-86.25,$303319.25,240,$-86.25
2024-12-03,13:36:00,21211.25,BUY,3,0.02h,Stop Loss,$-18.00,$-104.25,$303301.25,240,$-104.25
2024-12-03,13:57:00,21209.0,SELL,3,0.02h,Stop Loss,$53.25,$-51.00,$303354.50,240,$-51.00
2024-12-03,14:36:00,21186.0,BUY,3,0.02h,Stop Loss,$94.50,$43.50,$303449.00,240,$43.50
2024-12-03,15:21:00,21188.5,SELL,3,0.02h,Stop Loss,$72.00,$115.50,$303521.00,240,$115.50
2024-12-03,15:37:00,21207.0,BUY,3,0.02h,Stop Loss,$-18.00,$97.50,$303503.00,240,$97.50
2024-12-03,15:43:00,21192.75,SELL,3,0.02h,Stop Loss,$75.75,$173.25,$303578.75,240,$173.25
2024-12-03,16:00:00,21207.5,BUY,3,0.02h,Stop Loss,$30.75,$204.00,$303609.50,240,$204.00
2024-12-03,16:38:00,21216.5,SELL,3,0.02h,Stop Loss,$12.00,$216.00,$303621.50,240,$216.00
2024-12-03,16:55:00,21223.75,BUY,3,0.02h,Break Even,$0.75,$216.75,$303622.25,240,$216.75
2024-12-03,16:58:00,21217.0,SELL,3,0.02h,Stop Loss,$49.50,$266.25,$303671.75,240,$266.25
2024-12-03,17:23:00,21215.0,BUY,3,0.02h,Stop Loss,$-18.00,$248.25,$303653.75,240,$248.25
2024-12-03,17:25:00,21206.25,SELL,3,0.02h,Break Even,$0.75,$249.00,$303654.50,240,$249.00
2024-12-03,17:45:00,21208.75,BUY,3,0.02h,Stop Loss,$30.75,$279.75,$303685.25,240,$279.75
2024-12-03,18:30:00,21227.5,SELL,3,0.02h,Stop Loss,$15.75,$295.50,$303701.00,240,$295.50
2024-12-03,18:54:00,21235.25,BUY,3,0.02h,Break Even,$0.75,$296.25,$303701.75,240,$296.25
2024-12-03,19:05:00,21226.75,SELL,3,0.02h,Break Even,$0.75,$297.00,$303702.50,240,$297.00
2024-12-03,19:10:00,21233.75,BUY,3,0.02h,Stop Loss,$-18.00,$279.00,$303684.50,240,$279.00
2024-12-03,19:17:00,21226.25,SELL,3,0.02h,Break Even,$0.75,$279.75,$303685.25,240,$279.75
2024-12-03,19:19:00,21232.75,BUY,3,0.02h,Break Even,$0.75,$280.50,$303686.00,240,$280.50
2024-12-03,20:19:00,21250.75,SELL,3,0.02h,Stop Loss,$-18.00,$262.50,$303668.00,240,$262.50
2024-12-03,20:21:00,21257.0,BUY,3,0.02h,Break Even,$0.75,$263.25,$303668.75,240,$263.25
2024-12-03,20:33:00,21251.0,SELL,3,0.02h,Stop Loss,$-18.00,$245.25,$303650.75,240,$245.25
2024-12-03,20:50:00,21256.0,BUY,3,0.02h,Stop Loss,$109.50,$354.75,$303760.25,240,$354.75
,,,,,,,,,,,
2024-12-04,12:56:00,21414.75,SELL,3,0.02h,Break Even,$0.75,$0.75,$303761.00,241,$0.75
2024-12-04,13:09:00,21420.75,BUY,3,0.02h,Break Even,$0.75,$1.50,$303761.75,241,$1.50
2024-12-04,14:21:00,21437.75,SELL,3,0.02h,Stop Loss,$38.25,$39.75,$303800.00,241,$39.75
2024-12-04,14:51:00,21430.5,BUY,3,0.02h,Stop Loss,$-18.00,$21.75,$303782.00,241,$21.75
2024-12-04,15:01:00,21397.75,SELL,3,0.02h,Break Even,$0.75,$22.50,$303782.75,241,$22.50
2024-12-04,15:06:00,21434.0,BUY,3,0.02h,Break Even,$0.75,$23.25,$303783.50,241,$23.25
2024-12-04,16:17:00,21474.5,SELL,3,0.02h,Break Even,$0.75,$24.00,$303784.25,241,$24.00
2024-12-04,16:53:00,21464.25,BUY,3,0.02h,Break Even,$0.75,$24.75,$303785.00,241,$24.75
2024-12-04,17:33:00,21470.25,SELL,3,0.02h,Stop Loss,$23.25,$48.00,$303808.25,241,$48.00
2024-12-04,17:51:00,21480.5,BUY,3,0.02h,Break Even,$0.75,$48.75,$303809.00,241,$48.75
2024-12-04,18:18:00,21479.0,SELL,3,0.02h,Break Even,$0.75,$49.50,$303809.75,241,$49.50
2024-12-04,18:49:00,21468.5,BUY,3,0.02h,Break Even,$0.75,$50.25,$303810.50,241,$50.25
2024-12-04,21:03:00,21525.25,SELL,3,0.02h,Stop Loss,$38.25,$88.50,$303848.75,241,$88.50
2024-12-04,21:43:00,21519.5,BUY,3,0.02h,Break Even,$0.75,$89.25,$303849.50,241,$89.25
2024-12-04,21:45:00,21516.0,SELL,3,0.02h,Stop Loss,$57.00,$146.25,$303906.50,241,$146.25
2024-12-04,21:59:00,21516.5,BUY,3,0.02h,Break Even,$0.75,$147.00,$303907.25,241,$147.00
,,,,,,,,,,,
2024-12-05,12:29:00,21521.25,SELL,3,0.02h,Stop Loss,$-18.00,$-18.00,$303889.25,242,$-18.00
2024-12-05,12:36:00,21526.5,BUY,3,0.02h,Stop Loss,$-18.00,$-36.00,$303871.25,242,$-36.00
2024-12-05,13:07:00,21526.75,SELL,3,0.02h,Break Even,$0.75,$-35.25,$303872.00,242,$-35.25
2024-12-05,13:31:00,21530.5,BUY,3,0.02h,Break Even,$0.75,$-34.50,$303872.75,242,$-34.50
2024-12-05,13:44:00,21523.5,SELL,3,0.02h,Stop Loss,$42.00,$7.50,$303914.75,242,$7.50
2024-12-05,13:58:00,21529.25,BUY,3,0.02h,Stop Loss,$-18.00,$-10.50,$303896.75,242,$-10.50
2024-12-05,14:42:00,21520.75,SELL,3,0.02h,Stop Loss,$-18.00,$-28.50,$303878.75,242,$-28.50
2024-12-05,14:46:00,21537.25,BUY,3,0.02h,Stop Loss,$42.00,$13.50,$303920.75,242,$13.50
2024-12-05,14:50:00,21517.5,SELL,3,0.02h,Stop Loss,$94.50,$108.00,$304015.25,242,$108.00
2024-12-05,15:10:00,21530.75,BUY,3,0.02h,Break Even,$0.75,$108.75,$304016.00,242,$108.75
2024-12-05,15:23:00,21512.75,SELL,3,0.02h,Break Even,$0.75,$109.50,$304016.75,242,$109.50
2024-12-05,15:34:00,21523.25,BUY,3,0.02h,Stop Loss,$-18.00,$91.50,$303998.75,242,$91.50
2024-12-05,15:42:00,21513.25,SELL,3,0.02h,Break Even,$0.75,$92.25,$303999.50,242,$92.25
2024-12-05,15:45:00,21527.75,BUY,3,0.02h,Break Even,$0.75,$93.00,$304000.25,242,$93.00
2024-12-05,15:49:00,21508.25,SELL,3,0.02h,Stop Loss,$90.75,$183.75,$304091.00,242,$183.75
2024-12-05,16:13:00,21513.75,BUY,3,0.02h,Stop Loss,$-18.00,$165.75,$304073.00,242,$165.75
2024-12-05,16:40:00,21518.5,SELL,3,0.02h,Break Even,$0.75,$166.50,$304073.75,242,$166.50
2024-12-05,16:52:00,21525.75,BUY,3,0.02h,Stop Loss,$-18.00,$148.50,$304055.75,242,$148.50
2024-12-05,16:54:00,21521.75,SELL,3,0.02h,Break Even,$0.75,$149.25,$304056.50,242,$149.25
2024-12-05,17:00:00,21530.0,BUY,3,0.02h,Break Even,$0.75,$150.00,$304057.25,242,$150.00
2024-12-05,18:03:00,21549.0,SELL,3,0.02h,Stop Loss,$15.75,$165.75,$304073.00,242,$165.75
2024-12-05,18:42:00,21523.25,BUY,3,0.02h,Stop Loss,$-18.00,$147.75,$304055.00,242,$147.75
2024-12-05,18:50:00,21510.5,SELL,3,0.02h,Stop Loss,$75.75,$223.50,$304130.75,242,$223.50
2024-12-05,19:14:00,21503.0,BUY,3,0.02h,Stop Loss,$19.50,$243.00,$304150.25,242,$243.00
2024-12-05,19:31:00,21495.5,SELL,3,0.02h,Stop Loss,$-18.00,$225.00,$304132.25,242,$225.00
2024-12-05,20:05:00,21497.0,BUY,3,0.02h,Stop Loss,$98.25,$323.25,$304230.50,242,$323.25
2024-12-05,20:16:00,21491.0,SELL,3,0.02h,Stop Loss,$30.75,$354.00,$304261.25,242,$354.00
2024-12-05,20:42:00,21486.25,BUY,3,0.02h,Break Even,$0.75,$354.75,$304262.00,242,$354.75
2024-12-05,20:55:00,21469.75,SELL,3,0.02h,Stop Loss,$57.00,$411.75,$304319.00,242,$411.75
2024-12-05,21:32:00,21456.25,BUY,3,0.02h,Break Even,$0.75,$412.50,$304319.75,242,$412.50
2024-12-05,21:57:00,21455.25,SELL,3,0.03h,Break Even,$0.75,$413.25,$304320.50,242,$413.25
,,,,,,,,,,,
2024-12-06,12:01:00,21459.0,BUY,3,0.02h,Stop Loss,$-18.00,$-18.00,$304302.50,243,$-18.00
2024-12-06,12:41:00,21471.75,SELL,3,0.02h,Stop Loss,$-18.00,$-36.00,$304284.50,243,$-36.00
2024-12-06,12:47:00,21477.75,BUY,3,0.02h,Break Even,$0.75,$-35.25,$304285.25,243,$-35.25
2024-12-06,12:51:00,21472.5,SELL,3,0.02h,Stop Loss,$-18.00,$-53.25,$304267.25,243,$-53.25
2024-12-06,12:54:00,21477.25,BUY,3,0.02h,Break Even,$0.75,$-52.50,$304268.00,243,$-52.50
2024-12-06,13:15:00,21478.0,SELL,3,0.02h,Stop Loss,$-18.00,$-70.50,$304250.00,243,$-70.50
2024-12-06,13:16:00,21479.0,BUY,3,0.02h,Break Even,$0.75,$-69.75,$304250.75,243,$-69.75
2024-12-06,13:18:00,21478.0,SELL,3,0.02h,Stop Loss,$-18.00,$-87.75,$304232.75,243,$-87.75
2024-12-06,13:31:00,21508.0,BUY,3,0.02h,Stop Loss,$72.00,$-15.75,$304304.75,243,$-15.75
2024-12-06,13:51:00,21490.75,SELL,3,0.02h,Break Even,$0.75,$-15.00,$304305.50,243,$-15.00
2024-12-06,14:03:00,21505.5,BUY,3,0.02h,Break Even,$0.75,$-14.25,$304306.25,243,$-14.25
2024-12-06,14:07:00,21496.25,SELL,3,0.02h,Stop Loss,$-18.00,$-32.25,$304288.25,243,$-32.25
2024-12-06,14:09:00,21504.0,BUY,3,0.02h,Stop Loss,$15.75,$-16.50,$304304.00,243,$-16.50
2024-12-06,14:30:00,21491.75,SELL,3,0.02h,Stop Loss,$53.25,$36.75,$304357.25,243,$36.75
2024-12-06,14:32:00,21513.25,BUY,3,0.02h,Stop Loss,$83.25,$120.00,$304440.50,243,$120.00
2024-12-06,15:45:00,21619.75,SELL,3,0.02h,Stop Loss,$38.25,$158.25,$304478.75,243,$158.25
2024-12-06,16:03:00,21625.75,BUY,3,0.02h,Stop Loss,$-18.00,$140.25,$304460.75,243,$140.25
2024-12-06,16:11:00,21612.0,SELL,3,0.02h,Stop Loss,$94.50,$234.75,$304555.25,243,$234.75
2024-12-06,16:30:00,21620.25,BUY,3,0.02h,Stop Loss,$19.50,$254.25,$304574.75,243,$254.25
2024-12-06,16:48:00,21605.25,SELL,3,0.02h,Stop Loss,$-18.00,$236.25,$304556.75,243,$236.25
2024-12-06,17:10:00,21624.25,BUY,3,0.02h,Break Even,$0.75,$237.00,$304557.50,243,$237.00
2024-12-06,17:38:00,21622.5,SELL,3,0.02h,Break Even,$0.75,$237.75,$304558.25,243,$237.75
2024-12-06,17:55:00,21630.25,BUY,3,0.02h,Stop Loss,$-18.00,$219.75,$304540.25,243,$219.75
2024-12-06,18:34:00,21647.0,SELL,3,0.02h,Break Even,$0.75,$220.50,$304541.00,243,$220.50
2024-12-06,18:53:00,21653.5,BUY,3,0.02h,Break Even,$0.75,$221.25,$304541.75,243,$221.25
2024-12-06,19:04:00,21642.0,SELL,3,0.02h,Stop Loss,$-18.00,$203.25,$304523.75,243,$203.25
2024-12-06,19:41:00,21629.0,BUY,3,0.02h,Stop Loss,$-18.00,$185.25,$304505.75,243,$185.25
2024-12-06,19:43:00,21626.25,SELL,3,0.02h,Stop Loss,$-18.00,$167.25,$304487.75,243,$167.25
2024-12-06,19:44:00,21632.5,BUY,3,0.02h,Break Even,$0.75,$168.00,$304488.50,243,$168.00
2024-12-06,20:02:00,21631.5,SELL,3,0.02h,Break Even,$0.75,$168.75,$304489.25,243,$168.75
2024-12-06,20:08:00,21640.25,BUY,3,0.02h,Stop Loss,$-18.00,$150.75,$304471.25,243,$150.75
2024-12-06,20:50:00,21643.25,SELL,3,0.02h,Stop Loss,$49.50,$200.25,$304520.75,243,$200.25
2024-12-06,20:51:00,21653.25,BUY,3,0.02h,Stop Loss,$12.00,$212.25,$304532.75,243,$212.25
2024-12-06,21:03:00,21645.5,SELL,3,0.02h,Break Even,$0.75,$213.00,$304533.50,243,$213.00
2024-12-06,21:55:00,21635.5,BUY,3,0.02h,Stop Loss,$-18.00,$195.00,$304515.50,243,$195.00
2024-12-06,21:56:00,21633.0,SELL,3,0.02h,Stop Loss,$-18.00,$177.00,$304497.50,243,$177.00
2024-12-06,22:58:00,21634.0,BUY,3,61.03h,Stop Loss,$-18.00,$159.00,$304479.50,243,$159.00
,,,,,,,,,,,
2024-12-09,12:00:00,21615.75,SELL,3,0.02h,Stop Loss,$-18.00,$-18.00,$304461.50,244,$-18.00
2024-12-09,12:29:00,21622.25,BUY,3,0.02h,Stop Loss,$-18.00,$-36.00,$304443.50,244,$-36.00
2024-12-09,12:41:00,21617.75,SELL,3,0.02h,Break Even,$0.75,$-35.25,$304444.25,244,$-35.25
2024-12-09,12:57:00,21622.0,BUY,3,0.02h,Stop Loss,$15.75,$-19.50,$304460.00,244,$-19.50
2024-12-09,13:11:00,21614.5,SELL,3,0.02h,Break Even,$0.75,$-18.75,$304460.75,244,$-18.75
2024-12-09,13:23:00,21620.75,BUY,3,0.02h,Stop Loss,$-18.00,$-36.75,$304442.75,244,$-36.75
2024-12-09,13:34:00,21616.0,SELL,3,0.02h,Stop Loss,$-18.00,$-54.75,$304424.75,244,$-54.75
2024-12-09,13:40:00,21623.0,BUY,3,0.02h,Break Even,$0.75,$-54.00,$304425.50,244,$-54.00
2024-12-09,14:01:00,21617.0,SELL,3,0.02h,Stop Loss,$-18.00,$-72.00,$304407.50,244,$-72.00
2024-12-09,14:19:00,21621.25,BUY,3,0.02h,Stop Loss,$30.75,$-41.25,$304438.25,244,$-41.25
2024-12-09,14:31:00,21592.0,SELL,3,0.02h,Break Even,$0.75,$-40.50,$304439.00,244,$-40.50
2024-12-09,14:44:00,21620.25,BUY,3,0.02h,Stop Loss,$83.25,$42.75,$304522.25,244,$42.75
2024-12-09,15:00:00,21623.5,SELL,3,0.02h,Break Even,$0.75,$43.50,$304523.00,244,$43.50
2024-12-09,15:01:00,21628.5,BUY,3,0.02h,Break Even,$0.75,$44.25,$304523.75,244,$44.25
2024-12-09,15:03:00,21618.0,SELL,3,0.02h,Break Even,$0.75,$45.00,$304524.50,244,$45.00
2024-12-09,16:23:00,21498.0,BUY,3,0.02h,Stop Loss,$42.00,$87.00,$304566.50,244,$87.00
2024-12-09,16:43:00,21491.5,SELL,3,0.02h,Stop Loss,$57.00,$144.00,$304623.50,244,$144.00
2024-12-09,16:53:00,21509.75,BUY,3,0.02h,Break Even,$0.75,$144.75,$304624.25,244,$144.75
2024-12-09,17:07:00,21498.25,SELL,3,0.02h,Break Even,$0.75,$145.50,$304625.00,244,$145.50
2024-12-09,17:09:00,21510.25,BUY,3,0.02h,Stop Loss,$64.50,$210.00,$304689.50,244,$210.00
2024-12-09,17:17:00,21493.75,SELL,3,0.02h,Stop Loss,$12.00,$222.00,$304701.50,244,$222.00
2024-12-09,17:40:00,21502.75,BUY,3,0.02h,Stop Loss,$120.75,$342.75,$304822.25,244,$342.75
2024-12-09,17:58:00,21492.0,SELL,3,0.02h,Break Even,$0.75,$343.50,$304823.00,244,$343.50
2024-12-09,18:18:00,21495.25,BUY,3,0.02h,Stop Loss,$49.50,$393.00,$304872.50,244,$393.00
2024-12-09,19:00:00,21529.75,SELL,3,0.02h,Stop Loss,$79.50,$472.50,$304952.00,244,$472.50
2024-12-09,20:00:00,21476.75,BUY,3,0.02h,Break Even,$0.75,$473.25,$304952.75,244,$473.25
2024-12-09,20:02:00,21462.5,SELL,3,0.02h,Break Even,$0.75,$474.00,$304953.50,244,$474.00
2024-12-09,20:34:00,21459.75,BUY,3,0.02h,Stop Loss,$-18.00,$456.00,$304935.50,244,$456.00
2024-12-09,20:35:00,21450.5,SELL,3,0.02h,Stop Loss,$-18.00,$438.00,$304917.50,244,$438.00
2024-12-09,20:36:00,21454.0,BUY,3,0.02h,Break Even,$0.75,$438.75,$304918.25,244,$438.75
2024-12-09,20:46:00,21449.0,SELL,3,0.02h,Stop Loss,$-18.00,$420.75,$304900.25,244,$420.75
2024-12-09,20:51:00,21471.0,BUY,3,0.02h,Stop Loss,$-18.00,$402.75,$304882.25,244,$402.75
2024-12-09,21:48:00,21473.25,SELL,3,0.02h,Break Even,$0.75,$403.50,$304883.00,244,$403.50
2024-12-09,21:55:00,21477.0,BUY,3,0.02h,Stop Loss,$57.00,$460.50,$304940.00,244,$460.50
,,,,,,,,,,,
2024-12-10,12:57:00,21523.25,SELL,3,0.02h,Break Even,$0.75,$0.75,$304940.75,245,$0.75
2024-12-10,13:00:00,21529.0,BUY,3,0.02h,Stop Loss,$-18.00,$-17.25,$304922.75,245,$-17.25
2024-12-10,13:21:00,21523.5,SELL,3,0.02h,Stop Loss,$-18.00,$-35.25,$304904.75,245,$-35.25
2024-12-10,14:08:00,21512.75,BUY,3,0.02h,Break Even,$0.75,$-34.50,$304905.50,245,$-34.50
2024-12-10,14:34:00,21517.0,SELL,3,0.02h,Break Even,$0.75,$-33.75,$304906.25,245,$-33.75
2024-12-10,14:35:00,21526.25,BUY,3,0.02h,Break Even,$0.75,$-33.00,$304907.00,245,$-33.00
2024-12-10,14:56:00,21524.0,SELL,3,0.02h,Stop Loss,$83.25,$50.25,$304990.25,245,$50.25
2024-12-10,15:03:00,21569.25,BUY,3,0.02h,Break Even,$0.75,$51.00,$304991.00,245,$51.00
2024-12-10,15:28:00,21575.0,SELL,3,0.02h,Stop Loss,$45.75,$96.75,$305036.75,245,$96.75
2024-12-10,16:57:00,21481.5,BUY,3,0.02h,Stop Loss,$-18.00,$78.75,$305018.75,245,$78.75
2024-12-10,17:14:00,21463.0,SELL,3,0.02h,Stop Loss,$105.75,$184.50,$305124.50,245,$184.50
2024-12-10,17:24:00,21485.0,BUY,3,0.02h,Stop Loss,$27.00,$211.50,$305151.50,245,$211.50
2024-12-10,17:52:00,21478.0,SELL,3,0.02h,Stop Loss,$45.75,$257.25,$305197.25,245,$257.25
2024-12-10,18:22:00,21474.0,BUY,3,0.02h,Stop Loss,$-18.00,$239.25,$305179.25,245,$239.25
2024-12-10,18:45:00,21467.0,SELL,3,0.02h,Break Even,$0.75,$240.00,$305180.00,245,$240.00
2024-12-10,19:24:00,21452.75,BUY,3,0.02h,Stop Loss,$12.00,$252.00,$305192.00,245,$252.00
2024-12-10,19:33:00,21445.75,SELL,3,0.02h,Stop Loss,$19.50,$271.50,$305211.50,245,$271.50
2024-12-10,20:42:00,21397.25,BUY,3,0.02h,Stop Loss,$-18.00,$253.50,$305193.50,245,$253.50
,,,,,,,,,,,
2024-12-11,12:36:00,21432.5,SELL,3,0.02h,Stop Loss,$-18.00,$-18.00,$305175.50,246,$-18.00
2024-12-11,12:48:00,21443.5,BUY,3,0.02h,Stop Loss,$-18.00,$-36.00,$305157.50,246,$-36.00
2024-12-11,12:59:00,21438.75,SELL,3,0.02h,Stop Loss,$-18.00,$-54.00,$305139.50,246,$-54.00
2024-12-11,13:04:00,21445.0,BUY,3,0.02h,Break Even,$0.75,$-53.25,$305140.25,246,$-53.25
2024-12-11,15:30:00,21691.75,SELL,3,0.02h,Break Even,$0.75,$-52.50,$305141.00,246,$-52.50
2024-12-11,15:34:00,21716.25,BUY,3,0.02h,Stop Loss,$120.75,$68.25,$305261.75,246,$68.25
2024-12-11,15:50:00,21706.25,SELL,3,0.02h,Stop Loss,$-18.00,$50.25,$305243.75,246,$50.25
2024-12-11,16:06:00,21717.0,BUY,3,0.02h,Stop Loss,$105.75,$156.00,$305349.50,246,$156.00
2024-12-11,16:53:00,21744.0,SELL,3,0.02h,Break Even,$0.75,$156.75,$305350.25,246,$156.75
2024-12-11,17:00:00,21760.0,BUY,3,0.02h,Stop Loss,$83.25,$240.00,$305433.50,246,$240.00
2024-12-11,17:32:00,21764.5,SELL,3,0.02h,Stop Loss,$-18.00,$222.00,$305415.50,246,$222.00
2024-12-11,17:41:00,21784.0,BUY,3,0.02h,Stop Loss,$30.75,$252.75,$305446.25,246,$252.75
2024-12-11,17:53:00,21772.0,SELL,3,0.02h,Break Even,$0.75,$253.50,$305447.00,246,$253.50
2024-12-11,18:03:00,21790.25,BUY,3,0.02h,Stop Loss,$23.25,$276.75,$305470.25,246,$276.75
2024-12-11,18:55:00,21794.25,SELL,3,0.02h,Stop Loss,$23.25,$300.00,$305493.50,246,$300.00
2024-12-11,19:21:00,21795.25,BUY,3,0.02h,Break Even,$0.75,$300.75,$305494.25,246,$300.75
2024-12-11,19:48:00,21795.5,SELL,3,0.02h,Break Even,$0.75,$301.50,$305495.00,246,$301.50
2024-12-11,20:03:00,21805.0,BUY,3,0.02h,Break Even,$0.75,$302.25,$305495.75,246,$302.25
2024-12-11,20:36:00,21807.5,SELL,3,0.02h,Break Even,$0.75,$303.00,$305496.50,246,$303.00
,,,,,,,,,,,
2024-12-12,12:00:00,21996.5,BUY,3,0.02h,Break Even,$0.75,$0.75,$305497.25,247,$0.75
2024-12-12,12:05:00,21719.0,SELL,3,0.02h,Stop Loss,$-18.00,$-17.25,$305479.25,247,$-17.25
2024-12-12,12:11:00,21998.25,BUY,3,0.02h,Stop Loss,$-18.00,$-35.25,$305461.25,247,$-35.25
2024-12-12,12:16:00,21721.5,SELL,3,0.02h,Stop Loss,$-18.00,$-53.25,$305443.25,247,$-53.25
2024-12-12,12:17:00,21994.0,BUY,3,0.02h,Stop Loss,$-18.00,$-71.25,$305425.25,247,$-71.25
2024-12-12,12:29:00,21723.5,SELL,3,0.02h,Stop Loss,$-18.00,$-89.25,$305407.25,247,$-89.25
2024-12-12,12:30:00,21994.0,BUY,3,0.02h,Stop Loss,$-18.00,$-107.25,$305389.25,247,$-107.25
2024-12-12,12:38:00,21707.5,SELL,3,0.02h,Stop Loss,$-18.00,$-125.25,$305371.25,247,$-125.25
2024-12-12,12:51:00,21976.0,BUY,3,0.02h,Stop Loss,$-18.00,$-143.25,$305353.25,247,$-143.25
2024-12-12,12:55:00,21697.0,SELL,3,0.02h,Break Even,$0.75,$-142.50,$305354.00,247,$-142.50
2024-12-12,12:59:00,21969.0,BUY,3,0.03h,Stop Loss,$-18.00,$-160.50,$305336.00,247,$-160.50
2024-12-12,13:12:00,21705.0,SELL,3,0.02h,Stop Loss,$-18.00,$-178.50,$305318.00,247,$-178.50
2024-12-12,13:25:00,21986.5,BUY,3,0.02h,Break Even,$0.75,$-177.75,$305318.75,247,$-177.75
2024-12-12,13:30:00,21710.75,SELL,3,0.02h,Stop Loss,$-18.00,$-195.75,$305300.75,247,$-195.75
2024-12-12,13:31:00,21972.25,BUY,3,0.02h,Stop Loss,$-18.00,$-213.75,$305282.75,247,$-213.75
2024-12-12,13:33:00,21688.5,SELL,3,0.02h,Stop Loss,$-18.00,$-231.75,$305264.75,247,$-231.75
2024-12-12,13:34:00,21951.25,BUY,3,0.02h,Stop Loss,$15.75,$-216.00,$305280.50,247,$-216.00
2024-12-12,13:36:00,21668.5,SELL,3,0.02h,Stop Loss,$259.50,$43.50,$305540.00,247,$43.50
2024-12-12,13:44:00,21952.75,BUY,3,0.02h,Stop Loss,$83.25,$126.75,$305623.25,247,$126.75
2024-12-12,13:54:00,21681.25,SELL,3,0.02h,Break Even,$0.75,$127.50,$305624.00,247,$127.50
2024-12-12,14:08:00,21959.75,BUY,3,0.02h,Stop Loss,$-18.00,$109.50,$305606.00,247,$109.50
2024-12-12,14:09:00,21695.75,SELL,3,0.02h,Break Even,$0.75,$110.25,$305606.75,247,$110.25
2024-12-12,14:12:00,21953.0,BUY,3,0.02h,Stop Loss,$-18.00,$92.25,$305588.75,247,$92.25
2024-12-12,14:13:00,21676.75,SELL,3,0.02h,Stop Loss,$-18.00,$74.25,$305570.75,247,$74.25
2024-12-12,14:14:00,21949.75,BUY,3,0.02h,Stop Loss,$-18.00,$56.25,$305552.75,247,$56.25
2024-12-12,14:29:00,21695.0,SELL,3,0.02h,Break Even,$0.75,$57.00,$305553.50,247,$57.00
2024-12-12,14:32:00,21940.75,BUY,3,0.02h,Stop Loss,$72.00,$129.00,$305625.50,247,$129.00
2024-12-12,14:38:00,21665.75,SELL,3,0.02h,Break Even,$0.75,$129.75,$305626.25,247,$129.75
2024-12-12,14:49:00,21946.75,BUY,3,0.02h,Stop Loss,$-18.00,$111.75,$305608.25,247,$111.75
2024-12-12,15:07:00,21674.0,SELL,3,0.02h,Break Even,$0.75,$112.50,$305609.00,247,$112.50
2024-12-12,15:26:00,21972.75,BUY,3,0.02h,Stop Loss,$184.50,$297.00,$305793.50,247,$297.00
2024-12-12,15:37:00,21709.25,SELL,3,0.02h,Stop Loss,$-18.00,$279.00,$305775.50,247,$279.00
2024-12-12,15:38:00,21991.0,BUY,3,0.02h,Stop Loss,$-18.00,$261.00,$305757.50,247,$261.00
2024-12-12,15:46:00,21699.75,SELL,3,0.02h,Break Even,$0.75,$261.75,$305758.25,247,$261.75
2024-12-12,15:53:00,21982.0,BUY,3,0.02h,Stop Loss,$42.00,$303.75,$305800.25,247,$303.75
2024-12-12,15:57:00,21725.25,SELL,3,0.02h,Stop Loss,$-18.00,$285.75,$305782.25,247,$285.75
2024-12-12,15:58:00,21984.25,BUY,3,0.02h,Stop Loss,$-18.00,$267.75,$305764.25,247,$267.75
2024-12-12,15:59:00,21712.0,SELL,3,0.02h,Stop Loss,$-18.00,$249.75,$305746.25,247,$249.75
2024-12-12,16:00:00,21990.5,BUY,3,0.02h,Stop Loss,$45.75,$295.50,$305792.00,247,$295.50
2024-12-12,16:07:00,21734.75,SELL,3,0.02h,Stop Loss,$-18.00,$277.50,$305774.00,247,$277.50
2024-12-12,16:08:00,22002.0,BUY,3,0.02h,Stop Loss,$-18.00,$259.50,$305756.00,247,$259.50
2024-12-12,16:09:00,21731.5,SELL,3,0.02h,Stop Loss,$30.75,$290.25,$305786.75,247,$290.25
2024-12-12,16:21:00,21990.75,BUY,3,0.02h,Stop Loss,$-18.00,$272.25,$305768.75,247,$272.25
2024-12-12,16:22:00,21722.0,SELL,3,0.02h,Stop Loss,$57.00,$329.25,$305825.75,247,$329.25
2024-12-12,16:25:00,21991.5,BUY,3,0.02h,Stop Loss,$-18.00,$311.25,$305807.75,247,$311.25
2024-12-12,16:26:00,21719.5,SELL,3,0.02h,Stop Loss,$-18.00,$293.25,$305789.75,247,$293.25
2024-12-12,16:27:00,21989.5,BUY,3,0.02h,Stop Loss,$-18.00,$275.25,$305771.75,247,$275.25
2024-12-12,16:35:00,21710.25,SELL,3,0.02h,Break Even,$0.75,$276.00,$305772.50,247,$276.00
2024-12-12,16:37:00,21972.75,BUY,3,0.02h,Stop Loss,$-18.00,$258.00,$305754.50,247,$258.00
2024-12-12,16:38:00,21709.25,SELL,3,0.02h,Break Even,$0.75,$258.75,$305755.25,247,$258.75
2024-12-12,16:42:00,21967.25,BUY,3,0.02h,Stop Loss,$-18.00,$240.75,$305737.25,247,$240.75
2024-12-12,16:43:00,21696.75,SELL,3,0.02h,Stop Loss,$30.75,$271.50,$305768.00,247,$271.50
2024-12-12,16:53:00,21952.25,BUY,3,0.02h,Stop Loss,$-18.00,$253.50,$305750.00,247,$253.50
2024-12-12,16:54:00,21684.25,SELL,3,0.02h,Stop Loss,$-18.00,$235.50,$305732.00,247,$235.50
2024-12-12,16:55:00,21955.5,BUY,3,0.02h,Stop Loss,$19.50,$255.00,$305751.50,247,$255.00
2024-12-12,17:12:00,21722.5,SELL,3,0.02h,Break Even,$0.75,$255.75,$305752.25,247,$255.75
2024-12-12,17:20:00,21982.5,BUY,3,0.02h,Stop Loss,$19.50,$275.25,$305771.75,247,$275.25
2024-12-12,17:29:00,21717.25,SELL,3,0.02h,Break Even,$0.75,$276.00,$305772.50,247,$276.00
2024-12-12,17:33:00,21972.5,BUY,3,0.02h,Stop Loss,$-18.00,$258.00,$305754.50,247,$258.00
2024-12-12,17:34:00,21700.25,SELL,3,0.02h,Stop Loss,$30.75,$288.75,$305785.25,247,$288.75
2024-12-12,17:37:00,21959.5,BUY,3,0.02h,Stop Loss,$-18.00,$270.75,$305767.25,247,$270.75
2024-12-12,17:38:00,21699.5,SELL,3,0.02h,Break Even,$0.75,$271.50,$305768.00,247,$271.50
2024-12-12,17:45:00,21972.5,BUY,3,0.02h,Stop Loss,$-18.00,$253.50,$305750.00,247,$253.50
2024-12-12,17:46:00,21713.25,SELL,3,0.02h,Break Even,$0.75,$254.25,$305750.75,247,$254.25
2024-12-12,17:51:00,21988.25,BUY,3,0.02h,Break Even,$0.75,$255.00,$305751.50,247,$255.00
2024-12-12,17:55:00,21723.25,SELL,3,0.02h,Stop Loss,$-18.00,$237.00,$305733.50,247,$237.00
2024-12-12,17:56:00,21997.5,BUY,3,0.02h,Break Even,$0.75,$237.75,$305734.25,247,$237.75
2024-12-12,17:59:00,21737.75,SELL,3,0.02h,Stop Loss,$-18.00,$219.75,$305716.25,247,$219.75
2024-12-12,18:00:00,22009.5,BUY,3,0.02h,Stop Loss,$-18.00,$201.75,$305698.25,247,$201.75
2024-12-12,18:01:00,21741.25,SELL,3,0.02h,Stop Loss,$-18.00,$183.75,$305680.25,247,$183.75
2024-12-12,18:02:00,22006.0,BUY,3,0.02h,Stop Loss,$-18.00,$165.75,$305662.25,247,$165.75
2024-12-12,18:07:00,21733.25,SELL,3,0.02h,Stop Loss,$45.75,$211.50,$305708.00,247,$211.50
2024-12-12,18:10:00,21993.5,BUY,3,0.02h,Stop Loss,$-18.00,$193.50,$305690.00,247,$193.50
2024-12-12,18:11:00,21730.5,SELL,3,0.02h,Stop Loss,$143.25,$336.75,$305833.25,247,$336.75
2024-12-12,18:21:00,22006.0,BUY,3,0.02h,Stop Loss,$-18.00,$318.75,$305815.25,247,$318.75
2024-12-12,18:22:00,21732.25,SELL,3,0.02h,Break Even,$0.75,$319.50,$305816.00,247,$319.50
2024-12-12,18:24:00,22006.75,BUY,3,0.02h,Stop Loss,$-18.00,$301.50,$305798.00,247,$301.50
2024-12-12,18:26:00,21736.75,SELL,3,0.02h,Break Even,$0.75,$302.25,$305798.75,247,$302.25
2024-12-12,18:28:00,22011.5,BUY,3,0.02h,Stop Loss,$-18.00,$284.25,$305780.75,247,$284.25
2024-12-12,18:29:00,21739.0,SELL,3,0.02h,Stop Loss,$-18.00,$266.25,$305762.75,247,$266.25
2024-12-12,18:30:00,21997.0,BUY,3,0.02h,Stop Loss,$-18.00,$248.25,$305744.75,247,$248.25
2024-12-12,18:41:00,21719.75,SELL,3,0.02h,Stop Loss,$-18.00,$230.25,$305726.75,247,$230.25
2024-12-12,18:42:00,21974.0,BUY,3,0.02h,Stop Loss,$-18.00,$212.25,$305708.75,247,$212.25
2024-12-12,18:43:00,21706.5,SELL,3,0.02h,Stop Loss,$-18.00,$194.25,$305690.75,247,$194.25
2024-12-12,18:47:00,21980.25,BUY,3,0.02h,Stop Loss,$-18.00,$176.25,$305672.75,247,$176.25
2024-12-12,18:48:00,21712.0,SELL,3,0.02h,Stop Loss,$-18.00,$158.25,$305654.75,247,$158.25
2024-12-12,18:49:00,21977.0,BUY,3,0.02h,Stop Loss,$-18.00,$140.25,$305636.75,247,$140.25
2024-12-12,18:50:00,21714.25,SELL,3,0.02h,Stop Loss,$-18.00,$122.25,$305618.75,247,$122.25
2024-12-12,18:51:00,21980.25,BUY,3,0.02h,Stop Loss,$-18.00,$104.25,$305600.75,247,$104.25
2024-12-12,18:53:00,21705.25,SELL,3,0.02h,Stop Loss,$-18.00,$86.25,$305582.75,247,$86.25
2024-12-12,18:54:00,21971.5,BUY,3,0.02h,Break Even,$0.75,$87.00,$305583.50,247,$87.00
2024-12-12,19:03:00,21699.0,SELL,3,0.02h,Stop Loss,$-18.00,$69.00,$305565.50,247,$69.00
2024-12-12,19:04:00,21967.25,BUY,3,0.03h,Stop Loss,$30.75,$99.75,$305596.25,247,$99.75
2024-12-12,19:06:00,21711.0,SELL,3,0.02h,Stop Loss,$38.25,$138.00,$305634.50,247,$138.00
2024-12-12,19:20:00,21958.75,BUY,3,0.02h,Stop Loss,$-18.00,$120.00,$305616.50,247,$120.00
2024-12-12,19:21:00,21686.0,SELL,3,0.02h,Stop Loss,$-18.00,$102.00,$305598.50,247,$102.00
2024-12-12,19:22:00,21941.75,BUY,3,0.02h,Break Even,$0.75,$102.75,$305599.25,247,$102.75
2024-12-12,19:26:00,21674.75,SELL,3,0.02h,Stop Loss,$-18.00,$84.75,$305581.25,247,$84.75
2024-12-12,19:40:00,21957.75,BUY,3,0.02h,Stop Loss,$-18.00,$66.75,$305563.25,247,$66.75
2024-12-12,19:54:00,21684.5,SELL,3,0.02h,Stop Loss,$-18.00,$48.75,$305545.25,247,$48.75
2024-12-12,20:05:00,21947.75,BUY,3,0.02h,Stop Loss,$-18.00,$30.75,$305527.25,247,$30.75
2024-12-12,20:06:00,21683.5,SELL,3,0.02h,Break Even,$0.75,$31.50,$305528.00,247,$31.50
2024-12-12,20:09:00,21943.25,BUY,3,0.02h,Break Even,$0.75,$32.25,$305528.75,247,$32.25
2024-12-12,20:14:00,21663.0,SELL,3,0.02h,Stop Loss,$12.00,$44.25,$305540.75,247,$44.25
2024-12-12,20:17:00,21930.75,BUY,3,0.02h,Stop Loss,$-18.00,$26.25,$305522.75,247,$26.25
2024-12-12,20:20:00,21665.0,SELL,3,0.02h,Break Even,$0.75,$27.00,$305523.50,247,$27.00
2024-12-12,20:23:00,21924.75,BUY,3,0.02h,Stop Loss,$-18.00,$9.00,$305505.50,247,$9.00
2024-12-12,20:24:00,21659.75,SELL,3,0.02h,Stop Loss,$-18.00,$-9.00,$305487.50,247,$-9.00
2024-12-12,20:25:00,21924.25,BUY,3,0.02h,Stop Loss,$38.25,$29.25,$305525.75,247,$29.25
2024-12-12,20:28:00,21651.5,SELL,3,0.02h,Stop Loss,$-18.00,$11.25,$305507.75,247,$11.25
2024-12-12,20:30:00,21922.25,BUY,3,0.02h,Stop Loss,$68.25,$79.50,$305576.00,247,$79.50
2024-12-12,20:33:00,21664.0,SELL,3,0.02h,Stop Loss,$-18.00,$61.50,$305558.00,247,$61.50
2024-12-12,20:35:00,21938.75,BUY,3,0.02h,Stop Loss,$-18.00,$43.50,$305540.00,247,$43.50
2024-12-12,20:39:00,21664.0,SELL,3,0.02h,Stop Loss,$-18.00,$25.50,$305522.00,247,$25.50
2024-12-12,20:42:00,21925.0,BUY,3,0.02h,Stop Loss,$-18.00,$7.50,$305504.00,247,$7.50
2024-12-12,20:43:00,21661.25,SELL,3,0.02h,Stop Loss,$-18.00,$-10.50,$305486.00,247,$-10.50
2024-12-12,20:44:00,21929.75,BUY,3,0.02h,Stop Loss,$-18.00,$-28.50,$305468.00,247,$-28.50
2024-12-12,20:45:00,21664.25,SELL,3,0.02h,Stop Loss,$-18.00,$-46.50,$305450.00,247,$-46.50
2024-12-12,20:47:00,21939.75,BUY,3,0.03h,Break Even,$0.75,$-45.75,$305450.75,247,$-45.75
2024-12-12,21:00:00,21644.0,SELL,3,0.02h,Stop Loss,$102.00,$56.25,$305552.75,247,$56.25
2024-12-12,21:07:00,21885.25,BUY,3,0.02h,Break Even,$0.75,$57.00,$305553.50,247,$57.00
2024-12-12,21:10:00,21623.25,SELL,3,0.02h,Stop Loss,$-18.00,$39.00,$305535.50,247,$39.00
2024-12-12,21:11:00,21882.25,BUY,3,0.02h,Stop Loss,$-18.00,$21.00,$305517.50,247,$21.00
2024-12-12,21:12:00,21617.0,SELL,3,0.02h,Stop Loss,$23.25,$44.25,$305540.75,247,$44.25
2024-12-12,21:18:00,21926.5,BUY,3,0.02h,Stop Loss,$240.75,$285.00,$305781.50,247,$285.00
2024-12-12,21:33:00,21677.75,SELL,3,0.02h,Stop Loss,$53.25,$338.25,$305834.75,247,$338.25
2024-12-12,21:42:00,21914.0,BUY,3,0.02h,Stop Loss,$19.50,$357.75,$305854.25,247,$357.75
2024-12-12,21:44:00,21649.75,SELL,3,0.02h,Stop Loss,$-18.00,$339.75,$305836.25,247,$339.75
2024-12-12,21:45:00,21917.5,BUY,3,0.02h,Stop Loss,$-18.00,$321.75,$305818.25,247,$321.75
2024-12-12,21:52:00,21641.5,SELL,3,0.02h,Stop Loss,$-18.00,$303.75,$305800.25,247,$303.75
,,,,,,,,,,,
2024-12-13,12:00:00,22059.5,BUY,3,0.02h,Break Even,$0.75,$0.75,$305801.00,248,$0.75
2024-12-13,12:19:00,21810.75,SELL,3,0.02h,Break Even,$0.75,$1.50,$305801.75,248,$1.50
2024-12-13,12:23:00,22090.75,BUY,3,0.02h,Stop Loss,$19.50,$21.00,$305821.25,248,$21.00
2024-12-13,12:26:00,21824.0,SELL,3,0.02h,Stop Loss,$15.75,$36.75,$305837.00,248,$36.75
2024-12-13,12:31:00,22090.0,BUY,3,0.02h,Stop Loss,$-18.00,$18.75,$305819.00,248,$18.75
2024-12-13,12:37:00,21817.25,SELL,3,0.02h,Stop Loss,$-18.00,$0.75,$305801.00,248,$0.75
2024-12-13,12:38:00,22088.75,BUY,3,0.02h,Stop Loss,$-18.00,$-17.25,$305783.00,248,$-17.25
2024-12-13,12:39:00,21818.0,SELL,3,0.02h,Stop Loss,$-18.00,$-35.25,$305765.00,248,$-35.25
2024-12-13,12:40:00,22088.25,BUY,3,0.02h,Break Even,$0.75,$-34.50,$305765.75,248,$-34.50
2024-12-13,12:48:00,21825.75,SELL,3,0.02h,Stop Loss,$-18.00,$-52.50,$305747.75,248,$-52.50
2024-12-13,12:49:00,22095.25,BUY,3,0.02h,Stop Loss,$-18.00,$-70.50,$305729.75,248,$-70.50
2024-12-13,12:50:00,21823.75,SELL,3,0.02h,Stop Loss,$-18.00,$-88.50,$305711.75,248,$-88.50
2024-12-13,12:52:00,22095.5,BUY,3,0.03h,Break Even,$0.75,$-87.75,$305712.50,248,$-87.75
2024-12-13,12:54:00,21828.25,SELL,3,0.02h,Stop Loss,$-18.00,$-105.75,$305694.50,248,$-105.75
2024-12-13,13:07:00,22108.75,BUY,3,0.02h,Stop Loss,$-18.00,$-123.75,$305676.50,248,$-123.75
2024-12-13,13:20:00,21836.0,SELL,3,0.02h,Stop Loss,$-18.00,$-141.75,$305658.50,248,$-141.75
2024-12-13,13:28:00,22110.75,BUY,3,0.02h,Stop Loss,$-18.00,$-159.75,$305640.50,248,$-159.75
2024-12-13,13:52:00,21817.75,SELL,3,0.02h,Stop Loss,$-18.00,$-177.75,$305622.50,248,$-177.75
2024-12-13,13:53:00,22086.75,BUY,3,0.02h,Stop Loss,$64.50,$-113.25,$305687.00,248,$-113.25
2024-12-13,13:56:00,21822.5,SELL,3,0.02h,Break Even,$0.75,$-112.50,$305687.75,248,$-112.50
2024-12-13,14:06:00,22078.25,BUY,3,0.02h,Stop Loss,$-18.00,$-130.50,$305669.75,248,$-130.50
2024-12-13,14:07:00,21804.5,SELL,3,0.02h,Break Even,$0.75,$-129.75,$305670.50,248,$-129.75
2024-12-13,14:12:00,22069.0,BUY,3,0.02h,Stop Loss,$192.00,$62.25,$305862.50,248,$62.25
2024-12-13,14:14:00,21810.5,SELL,3,0.02h,Stop Loss,$-18.00,$44.25,$305844.50,248,$44.25
2024-12-13,14:15:00,22076.0,BUY,3,0.02h,Stop Loss,$-18.00,$26.25,$305826.50,248,$26.25
2024-12-13,14:16:00,21796.5,SELL,3,0.02h,Stop Loss,$-18.00,$8.25,$305808.50,248,$8.25
2024-12-13,14:18:00,22065.0,BUY,3,0.02h,Stop Loss,$-18.00,$-9.75,$305790.50,248,$-9.75
2024-12-13,14:19:00,21794.5,SELL,3,0.02h,Stop Loss,$-18.00,$-27.75,$305772.50,248,$-27.75
2024-12-13,14:30:00,22068.5,BUY,3,0.02h,Stop Loss,$237.00,$209.25,$306009.50,248,$209.25
2024-12-13,14:34:00,21814.25,SELL,3,0.02h,Break Even,$0.75,$210.00,$306010.25,248,$210.00
2024-12-13,14:36:00,22088.0,BUY,3,0.02h,Stop Loss,$-18.00,$192.00,$305992.25,248,$192.00
2024-12-13,14:37:00,21835.25,SELL,3,0.02h,Stop Loss,$72.00,$264.00,$306064.25,248,$264.00
2024-12-13,14:41:00,22107.5,BUY,3,0.02h,Stop Loss,$-18.00,$246.00,$306046.25,248,$246.00
2024-12-13,14:42:00,21842.5,SELL,3,0.02h,Break Even,$0.75,$246.75,$306047.00,248,$246.75
2024-12-13,14:45:00,22163.25,BUY,3,0.02h,Stop Loss,$210.75,$457.50,$306257.75,248,$457.50
2024-12-13,14:59:00,21886.5,SELL,3,0.02h,Stop Loss,$-18.00,$439.50,$306239.75,248,$439.50
2024-12-13,15:00:00,22156.0,BUY,3,0.02h,Stop Loss,$-18.00,$421.50,$306221.75,248,$421.50
2024-12-13,15:01:00,21877.5,SELL,3,0.02h,Stop Loss,$169.50,$591.00,$306391.25,248,$591.00
2024-12-13,15:04:00,22149.0,BUY,3,0.02h,Stop Loss,$-18.00,$573.00,$306373.25,248,$573.00
2024-12-13,15:05:00,21863.0,SELL,3,0.02h,Stop Loss,$34.50,$607.50,$306407.75,248,$607.50
2024-12-13,15:15:00,22137.25,BUY,3,0.02h,Break Even,$0.75,$608.25,$306408.50,248,$608.25
2024-12-13,15:30:00,21803.0,SELL,3,0.02h,Stop Loss,$-18.00,$590.25,$306390.50,248,$590.25
2024-12-13,15:49:00,22045.0,BUY,3,0.02h,Stop Loss,$-18.00,$572.25,$306372.50,248,$572.25
2024-12-13,15:50:00,21772.5,SELL,3,0.02h,Stop Loss,$330.75,$903.00,$306703.25,248,$903.00
2024-12-13,15:58:00,21983.0,BUY,3,0.02h,Stop Loss,$30.75,$933.75,$306734.00,248,$933.75
2024-12-13,16:00:00,21687.75,SELL,3,0.02h,Stop Loss,$60.75,$994.50,$306794.75,248,$994.50
2024-12-13,16:11:00,21965.0,BUY,3,0.02h,Stop Loss,$105.75,$1100.25,$306900.50,248,$1100.25
2024-12-13,16:15:00,21677.5,SELL,3,0.02h,Stop Loss,$-18.00,$1082.25,$306882.50,248,$1082.25
2024-12-13,16:16:00,21969.75,BUY,3,0.02h,Stop Loss,$312.00,$1394.25,$307194.50,248,$1394.25
2024-12-13,16:30:00,21699.0,SELL,3,0.02h,Stop Loss,$-18.00,$1376.25,$307176.50,248,$1376.25
2024-12-13,16:33:00,22020.75,BUY,3,0.02h,Stop Loss,$-18.00,$1358.25,$307158.50,248,$1358.25
2024-12-13,16:34:00,21747.25,SELL,3,0.02h,Break Even,$0.75,$1359.00,$307159.25,248,$1359.00
2024-12-13,16:44:00,22012.5,BUY,3,0.02h,Break Even,$0.75,$1359.75,$307160.00,248,$1359.75
2024-12-13,16:47:00,21703.25,SELL,3,0.02h,Break Even,$0.75,$1360.50,$307160.75,248,$1360.50
2024-12-13,16:52:00,21982.5,BUY,3,0.02h,Stop Loss,$15.75,$1376.25,$307176.50,248,$1376.25
2024-12-13,16:56:00,21686.5,SELL,3,0.02h,Stop Loss,$139.50,$1515.75,$307316.00,248,$1515.75
2024-12-13,16:59:00,21963.0,BUY,3,0.02h,Stop Loss,$229.50,$1745.25,$307545.50,248,$1745.25
2024-12-13,17:04:00,21710.25,SELL,3,0.02h,Break Even,$0.75,$1746.00,$307546.25,248,$1746.00
2024-12-13,17:12:00,22017.75,BUY,3,0.02h,Stop Loss,$-18.00,$1728.00,$307528.25,248,$1728.00
2024-12-13,17:13:00,21733.0,SELL,3,0.02h,Stop Loss,$180.75,$1908.75,$307709.00,248,$1908.75
2024-12-13,17:15:00,21996.75,BUY,3,0.02h,Stop Loss,$-18.00,$1890.75,$307691.00,248,$1890.75
2024-12-13,17:16:00,21714.5,SELL,3,0.02h,Stop Loss,$-18.00,$1872.75,$307673.00,248,$1872.75
2024-12-13,17:17:00,21995.0,BUY,3,0.02h,Stop Loss,$79.50,$1952.25,$307752.50,248,$1952.25
2024-12-13,17:20:00,21728.25,SELL,3,0.02h,Break Even,$0.75,$1953.00,$307753.25,248,$1953.00
2024-12-13,17:33:00,21970.75,BUY,3,0.02h,Stop Loss,$-18.00,$1935.00,$307735.25,248,$1935.00
2024-12-13,17:34:00,21687.0,SELL,3,0.02h,Stop Loss,$-18.00,$1917.00,$307717.25,248,$1917.00
2024-12-13,17:36:00,21972.5,BUY,3,0.02h,Stop Loss,$-18.00,$1899.00,$307699.25,248,$1899.00
2024-12-13,17:50:00,21701.0,SELL,3,0.02h,Stop Loss,$-18.00,$1881.00,$307681.25,248,$1881.00
2024-12-13,17:51:00,21970.0,BUY,3,0.02h,Stop Loss,$-18.00,$1863.00,$307663.25,248,$1863.00
2024-12-13,17:52:00,21698.75,SELL,3,0.02h,Stop Loss,$-18.00,$1845.00,$307645.25,248,$1845.00
2024-12-13,17:53:00,21994.5,BUY,3,0.02h,Stop Loss,$45.75,$1890.75,$307691.00,248,$1890.75
2024-12-13,18:00:00,21684.5,SELL,3,0.02h,Break Even,$0.75,$1891.50,$307691.75,248,$1891.50
2024-12-13,18:08:00,21998.25,BUY,3,0.02h,Stop Loss,$-18.00,$1873.50,$307673.75,248,$1873.50
2024-12-13,18:09:00,21715.0,SELL,3,0.02h,Stop Loss,$79.50,$1953.00,$307753.25,248,$1953.00
2024-12-13,18:11:00,21996.25,BUY,3,0.02h,Stop Loss,$-18.00,$1935.00,$307735.25,248,$1935.00
2024-12-13,18:14:00,21722.5,SELL,3,0.02h,Stop Loss,$45.75,$1980.75,$307781.00,248,$1980.75
2024-12-13,18:16:00,21998.5,BUY,3,0.02h,Break Even,$0.75,$1981.50,$307781.75,248,$1981.50
2024-12-13,18:21:00,21724.5,SELL,3,0.02h,Stop Loss,$147.00,$2128.50,$307928.75,248,$2128.50
2024-12-13,18:29:00,22022.25,BUY,3,0.02h,Stop Loss,$-18.00,$2110.50,$307910.75,248,$2110.50
2024-12-13,18:38:00,21741.75,SELL,3,0.02h,Stop Loss,$-18.00,$2092.50,$307892.75,248,$2092.50
2024-12-13,18:39:00,22030.25,BUY,3,0.02h,Stop Loss,$-18.00,$2074.50,$307874.75,248,$2074.50
2024-12-13,18:40:00,21745.25,SELL,3,0.02h,Break Even,$0.75,$2075.25,$307875.50,248,$2075.25
2024-12-13,18:42:00,22031.25,BUY,3,0.02h,Stop Loss,$-18.00,$2057.25,$307857.50,248,$2057.25
2024-12-13,18:43:00,21744.5,SELL,3,0.02h,Stop Loss,$-18.00,$2039.25,$307839.50,248,$2039.25
2024-12-13,18:44:00,22030.0,BUY,3,0.02h,Stop Loss,$-18.00,$2021.25,$307821.50,248,$2021.25
2024-12-13,18:45:00,21749.25,SELL,3,0.02h,Break Even,$0.75,$2022.00,$307822.25,248,$2022.00
2024-12-13,18:49:00,22049.5,BUY,3,0.02h,Stop Loss,$42.00,$2064.00,$307864.25,248,$2064.00
2024-12-13,18:52:00,21767.75,SELL,3,0.02h,Stop Loss,$27.00,$2091.00,$307891.25,248,$2091.00
2024-12-13,18:54:00,22050.0,BUY,3,0.02h,Stop Loss,$53.25,$2144.25,$307944.50,248,$2144.25
2024-12-13,19:03:00,21762.25,SELL,3,0.02h,Break Even,$0.75,$2145.00,$307945.25,248,$2145.00
2024-12-13,19:11:00,22064.0,BUY,3,0.02h,Stop Loss,$-18.00,$2127.00,$307927.25,248,$2127.00
2024-12-13,19:20:00,21785.5,SELL,3,0.02h,Stop Loss,$60.75,$2187.75,$307988.00,248,$2187.75
2024-12-13,19:30:00,22089.5,BUY,3,0.02h,Stop Loss,$75.75,$2263.50,$308063.75,248,$2263.50
2024-12-13,19:35:00,21810.25,SELL,3,0.02h,Stop Loss,$-18.00,$2245.50,$308045.75,248,$2245.50
2024-12-13,19:36:00,22088.25,BUY,3,0.02h,Break Even,$0.75,$2246.25,$308046.50,248,$2246.25
2024-12-13,19:40:00,21805.0,SELL,3,0.02h,Stop Loss,$19.50,$2265.75,$308066.00,248,$2265.75
2024-12-13,19:43:00,22090.5,BUY,3,0.02h,Stop Loss,$-18.00,$2247.75,$308048.00,248,$2247.75
2024-12-13,19:50:00,21805.25,SELL,3,0.02h,Stop Loss,$-18.00,$2229.75,$308030.00,248,$2229.75
2024-12-13,19:51:00,22087.25,BUY,3,0.02h,Stop Loss,$-18.00,$2211.75,$308012.00,248,$2211.75
2024-12-13,20:03:00,21805.0,SELL,3,0.02h,Stop Loss,$-18.00,$2193.75,$307994.00,248,$2193.75
2024-12-13,20:04:00,22089.0,BUY,3,0.02h,Stop Loss,$-18.00,$2175.75,$307976.00,248,$2175.75
2024-12-13,20:07:00,21801.25,SELL,3,0.02h,Break Even,$0.75,$2176.50,$307976.75,248,$2176.50
2024-12-13,20:24:00,22069.25,BUY,3,0.02h,Stop Loss,$12.00,$2188.50,$307988.75,248,$2188.50
2024-12-13,20:27:00,21799.0,SELL,3,0.02h,Stop Loss,$-18.00,$2170.50,$307970.75,248,$2170.50
2024-12-13,20:28:00,22085.25,BUY,3,0.02h,Stop Loss,$94.50,$2265.00,$308065.25,248,$2265.00
2024-12-13,20:32:00,21813.75,SELL,3,0.02h,Stop Loss,$-18.00,$2247.00,$308047.25,248,$2247.00
2024-12-13,20:33:00,22095.5,BUY,3,0.02h,Stop Loss,$-18.00,$2229.00,$308029.25,248,$2229.00
2024-12-13,20:34:00,21822.0,SELL,3,0.02h,Break Even,$0.75,$2229.75,$308030.00,248,$2229.75
2024-12-13,20:37:00,22104.5,BUY,3,0.02h,Stop Loss,$-18.00,$2211.75,$308012.00,248,$2211.75
2024-12-13,20:44:00,21798.0,SELL,3,0.02h,Stop Loss,$-18.00,$2193.75,$307994.00,248,$2193.75
2024-12-13,20:45:00,22081.25,BUY,3,0.02h,Stop Loss,$-18.00,$2175.75,$307976.00,248,$2175.75
2024-12-13,20:46:00,21803.5,SELL,3,0.02h,Stop Loss,$-18.00,$2157.75,$307958.00,248,$2157.75
2024-12-13,20:50:00,22093.25,BUY,3,0.02h,Stop Loss,$-18.00,$2139.75,$307940.00,248,$2139.75
2024-12-13,20:53:00,21794.25,SELL,3,0.02h,Break Even,$0.75,$2140.50,$307940.75,248,$2140.50
2024-12-13,20:56:00,22082.75,BUY,3,0.02h,Stop Loss,$-18.00,$2122.50,$307922.75,248,$2122.50
2024-12-13,20:58:00,21797.0,SELL,3,0.02h,Break Even,$0.75,$2123.25,$307923.50,248,$2123.25
2024-12-13,21:12:00,22063.5,BUY,3,0.02h,Break Even,$0.75,$2124.00,$307924.25,248,$2124.00
2024-12-13,21:18:00,21773.5,SELL,3,0.02h,Stop Loss,$53.25,$2177.25,$307977.50,248,$2177.25
2024-12-13,21:24:00,22052.25,BUY,3,0.02h,Stop Loss,$-18.00,$2159.25,$307959.50,248,$2159.25
2024-12-13,21:26:00,21764.25,SELL,3,0.02h,Stop Loss,$72.00,$2231.25,$308031.50,248,$2231.25
2024-12-13,21:28:00,22045.5,BUY,3,0.02h,Stop Loss,$-18.00,$2213.25,$308013.50,248,$2213.25
2024-12-13,21:29:00,21759.5,SELL,3,0.02h,Stop Loss,$-18.00,$2195.25,$307995.50,248,$2195.25
2024-12-13,21:30:00,22044.25,BUY,3,0.02h,Stop Loss,$-18.00,$2177.25,$307977.50,248,$2177.25
2024-12-13,21:34:00,21757.75,SELL,3,0.02h,Stop Loss,$-18.00,$2159.25,$307959.50,248,$2159.25
2024-12-13,21:35:00,22044.0,BUY,3,0.02h,Stop Loss,$-18.00,$2141.25,$307941.50,248,$2141.25
2024-12-13,21:37:00,21756.25,SELL,3,0.02h,Stop Loss,$-18.00,$2123.25,$307923.50,248,$2123.25
2024-12-13,21:38:00,22048.75,BUY,3,0.02h,Stop Loss,$-18.00,$2105.25,$307905.50,248,$2105.25
2024-12-13,21:45:00,21761.5,SELL,3,0.02h,Stop Loss,$-18.00,$2087.25,$307887.50,248,$2087.25
2024-12-13,21:46:00,22050.5,BUY,3,0.02h,Break Even,$0.75,$2088.00,$307888.25,248,$2088.00
2024-12-13,21:48:00,21763.75,SELL,3,0.02h,Break Even,$0.75,$2088.75,$307889.00,248,$2088.75
2024-12-13,21:54:00,22051.5,BUY,3,0.02h,Stop Loss,$-18.00,$2070.75,$307871.00,248,$2070.75
2024-12-13,21:55:00,21763.5,SELL,3,0.02h,Stop Loss,$-18.00,$2052.75,$307853.00,248,$2052.75
,,,,,,,,,,,
2024-12-16,12:00:00,22160.5,BUY,3,0.02h,Stop Loss,$-18.00,$-18.00,$307835.00,249,$-18.00
2024-12-16,12:51:00,22172.0,SELL,3,0.02h,Stop Loss,$-18.00,$-36.00,$307817.00,249,$-36.00
2024-12-16,12:52:00,22174.0,BUY,3,0.02h,Stop Loss,$-18.00,$-54.00,$307799.00,249,$-54.00
2024-12-16,12:53:00,22170.75,SELL,3,0.02h,Stop Loss,$27.00,$-27.00,$307826.00,249,$-27.00
2024-12-16,13:01:00,22174.75,BUY,3,0.02h,Stop Loss,$-18.00,$-45.00,$307808.00,249,$-45.00
2024-12-16,13:02:00,22172.25,SELL,3,0.03h,Stop Loss,$-18.00,$-63.00,$307790.00,249,$-63.00
2024-12-16,13:13:00,22178.25,BUY,3,0.02h,Stop Loss,$49.50,$-13.50,$307839.50,249,$-13.50
2024-12-16,13:56:00,22199.75,SELL,3,0.02h,Break Even,$0.75,$-12.75,$307840.25,249,$-12.75
2024-12-16,13:59:00,22207.25,BUY,3,0.02h,Stop Loss,$-18.00,$-30.75,$307822.25,249,$-30.75
2024-12-16,14:06:00,22196.0,SELL,3,0.02h,Stop Loss,$49.50,$18.75,$307871.75,249,$18.75
2024-12-16,14:31:00,22218.5,BUY,3,0.02h,Stop Loss,$154.50,$173.25,$308026.25,249,$173.25
2024-12-16,15:19:00,22256.5,SELL,3,0.02h,Stop Loss,$184.50,$357.75,$308210.75,249,$357.75
2024-12-16,15:26:00,22275.25,BUY,3,0.02h,Break Even,$0.75,$358.50,$308211.50,249,$358.50
2024-12-16,15:54:00,22281.25,SELL,3,0.02h,Break Even,$0.75,$359.25,$308212.25,249,$359.25
2024-12-16,15:57:00,22301.75,BUY,3,0.02h,Break Even,$0.75,$360.00,$308213.00,249,$360.00
2024-12-16,16:00:00,22287.25,SELL,3,0.02h,Break Even,$0.75,$360.75,$308213.75,249,$360.75
2024-12-16,16:01:00,22307.0,BUY,3,0.02h,Break Even,$0.75,$361.50,$308214.50,249,$361.50
2024-12-16,16:35:00,22314.0,SELL,3,0.02h,Stop Loss,$19.50,$381.00,$308234.00,249,$381.00
2024-12-16,16:52:00,22326.25,BUY,3,0.02h,Break Even,$0.75,$381.75,$308234.75,249,$381.75
2024-12-16,18:55:00,22412.5,SELL,3,0.02h,Break Even,$0.75,$382.50,$308235.50,249,$382.50
2024-12-16,18:56:00,22415.75,BUY,3,0.02h,Break Even,$0.75,$383.25,$308236.25,249,$383.25
2024-12-16,19:01:00,22404.0,SELL,3,0.02h,Break Even,$0.75,$384.00,$308237.00,249,$384.00
2024-12-16,19:11:00,22417.5,BUY,3,0.02h,Stop Loss,$-18.00,$366.00,$308219.00,249,$366.00
2024-12-16,19:32:00,22422.75,SELL,3,0.02h,Break Even,$0.75,$366.75,$308219.75,249,$366.75
2024-12-16,19:38:00,22430.5,BUY,3,0.02h,Stop Loss,$15.75,$382.50,$308235.50,249,$382.50
2024-12-16,20:00:00,22421.0,SELL,3,0.02h,Stop Loss,$-18.00,$364.50,$308217.50,249,$364.50
2024-12-16,20:06:00,22439.5,BUY,3,0.02h,Break Even,$0.75,$365.25,$308218.25,249,$365.25
2024-12-16,20:34:00,22429.25,SELL,3,0.02h,Break Even,$0.75,$366.00,$308219.00,249,$366.00
2024-12-16,21:37:00,22402.75,BUY,3,0.02h,Break Even,$0.75,$366.75,$308219.75,249,$366.75
,,,,,,,,,,,
2024-12-17,12:00:00,22389.25,SELL,3,0.02h,Stop Loss,$4489.50,$4489.50,$312709.25,250,$4489.50
2024-12-17,12:28:00,22368.25,BUY,3,0.02h,Stop Loss,$-18.00,$4471.50,$312691.25,250,$4471.50
2024-12-17,12:41:00,22056.25,SELL,3,0.02h,Stop Loss,$-18.00,$4453.50,$312673.25,250,$4453.50
2024-12-17,12:42:00,22358.75,BUY,3,0.02h,Stop Loss,$-18.00,$4435.50,$312655.25,250,$4435.50
2024-12-17,12:43:00,22064.5,SELL,3,0.02h,Stop Loss,$23.25,$4458.75,$312678.50,250,$4458.75
2024-12-17,12:46:00,22363.75,BUY,3,0.02h,Stop Loss,$-18.00,$4440.75,$312660.50,250,$4440.75
2024-12-17,12:47:00,22061.0,SELL,3,0.02h,Break Even,$0.75,$4441.50,$312661.25,250,$4441.50
2024-12-17,12:50:00,22360.75,BUY,3,0.02h,Stop Loss,$-18.00,$4423.50,$312643.25,250,$4423.50
2024-12-17,12:54:00,22060.25,SELL,3,0.02h,Stop Loss,$-18.00,$4405.50,$312625.25,250,$4405.50
2024-12-17,12:55:00,22360.25,BUY,3,0.02h,Stop Loss,$-18.00,$4387.50,$312607.25,250,$4387.50
2024-12-17,12:56:00,22055.0,SELL,3,0.02h,Stop Loss,$27.00,$4414.50,$312634.25,250,$4414.50
2024-12-17,13:11:00,22330.0,BUY,3,0.02h,Stop Loss,$-18.00,$4396.50,$312616.25,250,$4396.50
2024-12-17,13:12:00,22027.25,SELL,3,0.02h,Stop Loss,$-18.00,$4378.50,$312598.25,250,$4378.50
2024-12-17,13:13:00,22335.75,BUY,3,0.02h,Stop Loss,$-18.00,$4360.50,$312580.25,250,$4360.50
2024-12-17,13:14:00,22036.75,SELL,3,0.02h,Stop Loss,$19.50,$4380.00,$312599.75,250,$4380.00
2024-12-17,13:16:00,22340.25,BUY,3,0.02h,Stop Loss,$42.00,$4422.00,$312641.75,250,$4422.00
2024-12-17,13:19:00,22041.0,SELL,3,0.02h,Stop Loss,$-18.00,$4404.00,$312623.75,250,$4404.00
2024-12-17,13:20:00,22343.75,BUY,3,0.02h,Stop Loss,$-18.00,$4386.00,$312605.75,250,$4386.00
2024-12-17,13:21:00,22041.0,SELL,3,0.02h,Break Even,$0.75,$4386.75,$312606.50,250,$4386.75
2024-12-17,13:24:00,22354.0,BUY,3,0.02h,Stop Loss,$-18.00,$4368.75,$312588.50,250,$4368.75
2024-12-17,13:27:00,22043.25,SELL,3,0.02h,Stop Loss,$-18.00,$4350.75,$312570.50,250,$4350.75
2024-12-17,13:28:00,22346.75,BUY,3,0.02h,Stop Loss,$-18.00,$4332.75,$312552.50,250,$4332.75
2024-12-17,13:36:00,22044.25,SELL,3,0.02h,Stop Loss,$184.50,$4517.25,$312737.00,250,$4517.25
2024-12-17,13:52:00,22344.5,BUY,3,0.02h,Break Even,$0.75,$4518.00,$312737.75,250,$4518.00
2024-12-17,14:05:00,22062.75,SELL,3,0.02h,Stop Loss,$-18.00,$4500.00,$312719.75,250,$4500.00
2024-12-17,14:07:00,22365.5,BUY,3,0.02h,Stop Loss,$-18.00,$4482.00,$312701.75,250,$4482.00
2024-12-17,14:08:00,22061.5,SELL,3,0.02h,Stop Loss,$-18.00,$4464.00,$312683.75,250,$4464.00
2024-12-17,14:09:00,22364.0,BUY,3,0.02h,Stop Loss,$-18.00,$4446.00,$312665.75,250,$4446.00
2024-12-17,14:15:00,22052.25,SELL,3,0.02h,Stop Loss,$-18.00,$4428.00,$312647.75,250,$4428.00
2024-12-17,14:20:00,22354.75,BUY,3,0.02h,Stop Loss,$-18.00,$4410.00,$312629.75,250,$4410.00
2024-12-17,14:21:00,22047.5,SELL,3,0.02h,Stop Loss,$-18.00,$4392.00,$312611.75,250,$4392.00
2024-12-17,14:33:00,22324.75,BUY,3,0.02h,Stop Loss,$-18.00,$4374.00,$312593.75,250,$4374.00
2024-12-17,14:35:00,21994.75,SELL,3,0.02h,Stop Loss,$64.50,$4438.50,$312658.25,250,$4438.50
2024-12-17,14:45:00,22360.0,BUY,3,0.02h,Stop Loss,$60.75,$4499.25,$312719.00,250,$4499.25
2024-12-17,14:52:00,22042.25,SELL,3,0.02h,Stop Loss,$139.50,$4638.75,$312858.50,250,$4638.75
2024-12-17,14:55:00,22329.75,BUY,3,0.02h,Stop Loss,$-18.00,$4620.75,$312840.50,250,$4620.75
2024-12-17,14:56:00,22021.75,SELL,3,0.02h,Break Even,$0.75,$4621.50,$312841.25,250,$4621.50
2024-12-17,14:59:00,22334.5,BUY,3,0.02h,Stop Loss,$-18.00,$4603.50,$312823.25,250,$4603.50
2024-12-17,15:03:00,21991.0,SELL,3,0.02h,Stop Loss,$-18.00,$4585.50,$312805.25,250,$4585.50
2024-12-17,15:04:00,22272.75,BUY,3,0.02h,Stop Loss,$117.00,$4702.50,$312922.25,250,$4702.50
2024-12-17,15:09:00,22002.5,SELL,3,0.02h,Stop Loss,$-18.00,$4684.50,$312904.25,250,$4684.50
2024-12-17,15:10:00,22308.75,BUY,3,0.02h,Stop Loss,$98.25,$4782.75,$313002.50,250,$4782.75
2024-12-17,15:15:00,21976.0,SELL,3,0.02h,Stop Loss,$-18.00,$4764.75,$312984.50,250,$4764.75
2024-12-17,15:17:00,22274.0,BUY,3,0.02h,Stop Loss,$109.50,$4874.25,$313094.00,250,$4874.25
2024-12-17,15:20:00,21956.0,SELL,3,0.02h,Stop Loss,$135.75,$5010.00,$313229.75,250,$5010.00
2024-12-17,15:23:00,22251.25,BUY,3,0.02h,Stop Loss,$-18.00,$4992.00,$313211.75,250,$4992.00
2024-12-17,15:24:00,21954.25,SELL,3,0.02h,Stop Loss,$-18.00,$4974.00,$313193.75,250,$4974.00
2024-12-17,15:26:00,22254.5,BUY,3,0.02h,Stop Loss,$-18.00,$4956.00,$313175.75,250,$4956.00
2024-12-17,15:27:00,21957.25,SELL,3,0.02h,Stop Loss,$53.25,$5009.25,$313229.00,250,$5009.25
2024-12-17,15:34:00,22257.0,BUY,3,0.02h,Stop Loss,$113.25,$5122.50,$313342.25,250,$5122.50
2024-12-17,15:36:00,21953.25,SELL,3,0.02h,Stop Loss,$-18.00,$5104.50,$313324.25,250,$5104.50
2024-12-17,15:37:00,22253.0,BUY,3,0.02h,Stop Loss,$-18.00,$5086.50,$313306.25,250,$5086.50
2024-12-17,15:38:00,21968.0,SELL,3,0.02h,Stop Loss,$-18.00,$5068.50,$313288.25,250,$5068.50
2024-12-17,15:43:00,22268.0,BUY,3,0.02h,Stop Loss,$98.25,$5166.75,$313386.50,250,$5166.75
2024-12-17,15:57:00,21994.0,SELL,3,0.02h,Stop Loss,$-18.00,$5148.75,$313368.50,250,$5148.75
2024-12-17,15:58:00,22307.25,BUY,3,0.02h,Stop Loss,$57.00,$5205.75,$313425.50,250,$5205.75
2024-12-17,16:05:00,22005.5,SELL,3,0.02h,Stop Loss,$132.00,$5337.75,$313557.50,250,$5337.75
2024-12-17,16:16:00,22347.5,BUY,3,0.02h,Stop Loss,$-18.00,$5319.75,$313539.50,250,$5319.75
2024-12-17,16:18:00,22029.25,SELL,3,0.02h,Stop Loss,$23.25,$5343.00,$313562.75,250,$5343.00
2024-12-17,16:20:00,22336.0,BUY,3,0.02h,Stop Loss,$-18.00,$5325.00,$313544.75,250,$5325.00
2024-12-17,16:21:00,22023.5,SELL,3,0.02h,Stop Loss,$-18.00,$5307.00,$313526.75,250,$5307.00
2024-12-17,16:22:00,22337.0,BUY,3,0.02h,Stop Loss,$-18.00,$5289.00,$313508.75,250,$5289.00
2024-12-17,16:24:00,22029.25,SELL,3,0.02h,Break Even,$0.75,$5289.75,$313509.50,250,$5289.75
2024-12-17,16:27:00,22346.25,BUY,3,0.02h,Stop Loss,$87.00,$5376.75,$313596.50,250,$5376.75
2024-12-17,16:37:00,22073.0,SELL,3,0.02h,Stop Loss,$-18.00,$5358.75,$313578.50,250,$5358.75
2024-12-17,16:38:00,22382.0,BUY,3,0.02h,Stop Loss,$-18.00,$5340.75,$313560.50,250,$5340.75
2024-12-17,16:43:00,22079.25,SELL,3,0.02h,Stop Loss,$42.00,$5382.75,$313602.50,250,$5382.75
2024-12-17,16:46:00,22374.75,BUY,3,0.02h,Stop Loss,$79.50,$5462.25,$313682.00,250,$5462.25
2024-12-17,16:53:00,22050.5,SELL,3,0.02h,Stop Loss,$-18.00,$5444.25,$313664.00,250,$5444.25
2024-12-17,16:54:00,22341.75,BUY,3,0.02h,Stop Loss,$27.00,$5471.25,$313691.00,250,$5471.25
2024-12-17,17:03:00,22006.0,SELL,3,0.02h,Stop Loss,$120.75,$5592.00,$313811.75,250,$5592.00
2024-12-17,17:15:00,22327.75,BUY,3,0.02h,Stop Loss,$-18.00,$5574.00,$313793.75,250,$5574.00
2024-12-17,17:16:00,22029.25,SELL,3,0.02h,Stop Loss,$-18.00,$5556.00,$313775.75,250,$5556.00
2024-12-17,17:17:00,22322.0,BUY,3,0.02h,Stop Loss,$-18.00,$5538.00,$313757.75,250,$5538.00
2024-12-17,17:18:00,22024.5,SELL,3,0.02h,Stop Loss,$-18.00,$5520.00,$313739.75,250,$5520.00
2024-12-17,17:19:00,22324.0,BUY,3,0.02h,Stop Loss,$-18.00,$5502.00,$313721.75,250,$5502.00
2024-12-17,17:20:00,22012.0,SELL,3,0.02h,Stop Loss,$-18.00,$5484.00,$313703.75,250,$5484.00
2024-12-17,17:21:00,22318.5,BUY,3,0.02h,Stop Loss,$72.00,$5556.00,$313775.75,250,$5556.00
2024-12-17,17:24:00,22014.0,SELL,3,0.02h,Stop Loss,$72.00,$5628.00,$313847.75,250,$5628.00
2024-12-17,17:27:00,22319.25,BUY,3,0.02h,Stop Loss,$-18.00,$5610.00,$313829.75,250,$5610.00
2024-12-17,17:28:00,22028.0,SELL,3,0.02h,Stop Loss,$-18.00,$5592.00,$313811.75,250,$5592.00
2024-12-17,17:29:00,22334.25,BUY,3,0.02h,Stop Loss,$-18.00,$5574.00,$313793.75,250,$5574.00
2024-12-17,17:30:00,22036.75,SELL,3,0.02h,Stop Loss,$139.50,$5713.50,$313933.25,250,$5713.50
2024-12-17,17:32:00,22325.5,BUY,3,0.02h,Stop Loss,$102.00,$5815.50,$314035.25,250,$5815.50
2024-12-17,17:35:00,22040.5,SELL,3,0.02h,Stop Loss,$113.25,$5928.75,$314148.50,250,$5928.75
2024-12-17,17:40:00,22348.75,BUY,3,0.02h,Stop Loss,$-18.00,$5910.75,$314130.50,250,$5910.75
2024-12-17,17:51:00,22035.75,SELL,3,0.02h,Break Even,$0.75,$5911.50,$314131.25,250,$5911.50
2024-12-17,17:56:00,22341.25,BUY,3,0.02h,Stop Loss,$-18.00,$5893.50,$314113.25,250,$5893.50
2024-12-17,17:57:00,22029.25,SELL,3,0.02h,Stop Loss,$-18.00,$5875.50,$314095.25,250,$5875.50
2024-12-17,17:58:00,22338.5,BUY,3,0.02h,Stop Loss,$15.75,$5891.25,$314111.00,250,$5891.25
2024-12-17,18:02:00,22027.75,SELL,3,0.02h,Stop Loss,$-18.00,$5873.25,$314093.00,250,$5873.25
2024-12-17,18:03:00,22331.5,BUY,3,0.02h,Stop Loss,$-18.00,$5855.25,$314075.00,250,$5855.25
2024-12-17,18:04:00,22033.25,SELL,3,0.02h,Stop Loss,$-18.00,$5837.25,$314057.00,250,$5837.25
2024-12-17,18:05:00,22335.5,BUY,3,0.02h,Stop Loss,$19.50,$5856.75,$314076.50,250,$5856.75
2024-12-17,18:14:00,22038.75,SELL,3,0.02h,Stop Loss,$-18.00,$5838.75,$314058.50,250,$5838.75
2024-12-17,18:15:00,22341.75,BUY,3,0.02h,Stop Loss,$-18.00,$5820.75,$314040.50,250,$5820.75
2024-12-17,18:16:00,22033.75,SELL,3,0.02h,Stop Loss,$-18.00,$5802.75,$314022.50,250,$5802.75
2024-12-17,18:27:00,22326.0,BUY,3,0.02h,Stop Loss,$-18.00,$5784.75,$314004.50,250,$5784.75
2024-12-17,18:28:00,22025.25,SELL,3,0.02h,Stop Loss,$117.00,$5901.75,$314121.50,250,$5901.75
2024-12-17,18:31:00,22323.75,BUY,3,0.02h,Stop Loss,$-18.00,$5883.75,$314103.50,250,$5883.75
2024-12-17,18:32:00,22012.75,SELL,3,0.02h,Break Even,$0.75,$5884.50,$314104.25,250,$5884.50
2024-12-17,18:35:00,22329.25,BUY,3,0.02h,Break Even,$0.75,$5885.25,$314105.00,250,$5885.25
2024-12-17,18:43:00,22026.25,SELL,3,0.02h,Stop Loss,$-18.00,$5867.25,$314087.00,250,$5867.25
2024-12-17,18:44:00,22330.0,BUY,3,0.02h,Break Even,$0.75,$5868.00,$314087.75,250,$5868.00
2024-12-17,18:50:00,22000.75,SELL,3,0.02h,Stop Loss,$-18.00,$5850.00,$314069.75,250,$5850.00
2024-12-17,19:04:00,22294.75,BUY,3,0.02h,Stop Loss,$135.75,$5985.75,$314205.50,250,$5985.75
2024-12-17,19:06:00,21990.0,SELL,3,0.02h,Stop Loss,$-18.00,$5967.75,$314187.50,250,$5967.75
2024-12-17,19:07:00,22292.0,BUY,3,0.02h,Break Even,$0.75,$5968.50,$314188.25,250,$5968.50
2024-12-17,19:09:00,21993.0,SELL,3,0.02h,Stop Loss,$-18.00,$5950.50,$314170.25,250,$5950.50
2024-12-17,19:10:00,22295.0,BUY,3,0.02h,Stop Loss,$-18.00,$5932.50,$314152.25,250,$5932.50
2024-12-17,19:11:00,21999.75,SELL,3,0.02h,Break Even,$0.75,$5933.25,$314153.00,250,$5933.25
2024-12-17,19:21:00,22285.75,BUY,3,0.02h,Stop Loss,$38.25,$5971.50,$314191.25,250,$5971.50
2024-12-17,19:25:00,21984.0,SELL,3,0.02h,Stop Loss,$-18.00,$5953.50,$314173.25,250,$5953.50
2024-12-17,19:26:00,22283.0,BUY,3,0.02h,Stop Loss,$53.25,$6006.75,$314226.50,250,$6006.75
2024-12-17,19:28:00,21988.75,SELL,3,0.02h,Stop Loss,$45.75,$6052.50,$314272.25,250,$6052.50
2024-12-17,19:32:00,22282.25,BUY,3,0.02h,Stop Loss,$-18.00,$6034.50,$314254.25,250,$6034.50
2024-12-17,19:36:00,21981.0,SELL,3,0.02h,Stop Loss,$-18.00,$6016.50,$314236.25,250,$6016.50
2024-12-17,19:37:00,22274.5,BUY,3,0.02h,Stop Loss,$-18.00,$5998.50,$314218.25,250,$5998.50
2024-12-17,19:38:00,21968.0,SELL,3,0.02h,Break Even,$0.75,$5999.25,$314219.00,250,$5999.25
2024-12-17,19:48:00,22271.75,BUY,3,0.02h,Stop Loss,$12.00,$6011.25,$314231.00,250,$6011.25
2024-12-17,19:54:00,21974.5,SELL,3,0.02h,Stop Loss,$-18.00,$5993.25,$314213.00,250,$5993.25
2024-12-17,19:56:00,22283.25,BUY,3,0.02h,Stop Loss,$-18.00,$5975.25,$314195.00,250,$5975.25
2024-12-17,19:57:00,21986.75,SELL,3,0.02h,Stop Loss,$-18.00,$5957.25,$314177.00,250,$5957.25
2024-12-17,20:00:00,22281.25,BUY,3,0.02h,Stop Loss,$-18.00,$5939.25,$314159.00,250,$5939.25
2024-12-17,20:01:00,21979.75,SELL,3,0.02h,Stop Loss,$-18.00,$5921.25,$314141.00,250,$5921.25
2024-12-17,20:02:00,22287.5,BUY,3,0.02h,Stop Loss,$-18.00,$5903.25,$314123.00,250,$5903.25
2024-12-17,20:03:00,21984.0,SELL,3,0.02h,Stop Loss,$23.25,$5926.50,$314146.25,250,$5926.50
2024-12-17,20:10:00,22283.0,BUY,3,0.02h,Stop Loss,$42.00,$5968.50,$314188.25,250,$5968.50
2024-12-17,20:22:00,21966.75,SELL,3,0.02h,Break Even,$0.75,$5969.25,$314189.00,250,$5969.25
2024-12-17,20:29:00,22262.5,BUY,3,0.02h,Stop Loss,$83.25,$6052.50,$314272.25,250,$6052.50
2024-12-17,20:45:00,22007.75,SELL,3,0.02h,Stop Loss,$-18.00,$6034.50,$314254.25,250,$6034.50
2024-12-17,20:46:00,22310.0,BUY,3,0.02h,Stop Loss,$49.50,$6084.00,$314303.75,250,$6084.00
2024-12-17,20:48:00,21995.25,SELL,3,0.02h,Stop Loss,$-18.00,$6066.00,$314285.75,250,$6066.00
2024-12-17,20:49:00,22301.25,BUY,3,0.02h,Stop Loss,$-18.00,$6048.00,$314267.75,250,$6048.00
2024-12-17,20:50:00,21998.5,SELL,3,0.02h,Stop Loss,$-18.00,$6030.00,$314249.75,250,$6030.00
2024-12-17,20:55:00,22322.75,BUY,3,0.02h,Stop Loss,$45.75,$6075.75,$314295.50,250,$6075.75
2024-12-17,20:59:00,22026.5,SELL,3,0.02h,Stop Loss,$218.25,$6294.00,$314513.75,250,$6294.00
2024-12-17,21:03:00,22304.25,BUY,3,0.02h,Stop Loss,$-18.00,$6276.00,$314495.75,250,$6276.00
2024-12-17,21:04:00,21994.75,SELL,3,0.02h,Stop Loss,$-18.00,$6258.00,$314477.75,250,$6258.00
2024-12-17,21:05:00,22288.0,BUY,3,0.02h,Stop Loss,$-18.00,$6240.00,$314459.75,250,$6240.00
2024-12-17,21:06:00,21991.25,SELL,3,0.02h,Stop Loss,$-18.00,$6222.00,$314441.75,250,$6222.00
2024-12-17,21:12:00,22295.25,BUY,3,0.02h,Break Even,$0.75,$6222.75,$314442.50,250,$6222.75
2024-12-17,21:19:00,21994.0,SELL,3,0.02h,Stop Loss,$-18.00,$6204.75,$314424.50,250,$6204.75
2024-12-17,21:29:00,22314.25,BUY,3,0.02h,Stop Loss,$-18.00,$6186.75,$314406.50,250,$6186.75
2024-12-17,21:30:00,22011.5,SELL,3,0.02h,Stop Loss,$-18.00,$6168.75,$314388.50,250,$6168.75
2024-12-17,21:34:00,22312.75,BUY,3,0.02h,Stop Loss,$-18.00,$6150.75,$314370.50,250,$6150.75
2024-12-17,21:48:00,21997.75,SELL,3,0.02h,Stop Loss,$-18.00,$6132.75,$314352.50,250,$6132.75
2024-12-17,21:53:00,22305.5,BUY,3,0.02h,Stop Loss,$-18.00,$6114.75,$314334.50,250,$6114.75
2024-12-17,21:57:00,22005.0,SELL,3,0.03h,Break Even,$0.75,$6115.50,$314335.25,250,$6115.50
,,,,,,,,,,,
2024-12-18,12:09:00,22375.75,BUY,3,0.02h,Stop Loss,$-18.00,$-18.00,$314317.25,251,$-18.00
2024-12-18,12:11:00,22076.5,SELL,3,0.02h,Break Even,$0.75,$-17.25,$314318.00,251,$-17.25
2024-12-18,12:18:00,22384.25,BUY,3,0.02h,Stop Loss,$-18.00,$-35.25,$314300.00,251,$-35.25
2024-12-18,12:25:00,22083.25,SELL,3,0.03h,Stop Loss,$12.00,$-23.25,$314312.00,251,$-23.25
2024-12-18,12:27:00,22378.75,BUY,3,0.02h,Stop Loss,$-18.00,$-41.25,$314294.00,251,$-41.25
2024-12-18,12:30:00,22070.75,SELL,3,0.02h,Stop Loss,$-18.00,$-59.25,$314276.00,251,$-59.25
2024-12-18,12:31:00,22378.25,BUY,3,0.02h,Stop Loss,$-18.00,$-77.25,$314258.00,251,$-77.25
2024-12-18,12:34:00,22071.75,SELL,3,0.03h,Stop Loss,$-18.00,$-95.25,$314240.00,251,$-95.25
2024-12-18,12:36:00,22377.75,BUY,3,0.02h,Stop Loss,$-18.00,$-113.25,$314222.00,251,$-113.25
2024-12-18,12:43:00,22069.75,SELL,3,0.02h,Break Even,$0.75,$-112.50,$314222.75,251,$-112.50
2024-12-18,12:49:00,22373.75,BUY,3,0.02h,Break Even,$0.75,$-111.75,$314223.50,251,$-111.75
2024-12-18,13:01:00,22070.5,SELL,3,0.02h,Stop Loss,$38.25,$-73.50,$314261.75,251,$-73.50
2024-12-18,13:03:00,22370.25,BUY,3,0.02h,Break Even,$0.75,$-72.75,$314262.50,251,$-72.75
2024-12-18,13:08:00,22067.0,SELL,3,0.02h,Break Even,$0.75,$-72.00,$314263.25,251,$-72.00
2024-12-18,13:10:00,22367.75,BUY,3,0.02h,Stop Loss,$-18.00,$-90.00,$314245.25,251,$-90.00
2024-12-18,13:11:00,22066.25,SELL,3,0.02h,Stop Loss,$-18.00,$-108.00,$314227.25,251,$-108.00
2024-12-18,13:13:00,22364.75,BUY,3,0.02h,Stop Loss,$-18.00,$-126.00,$314209.25,251,$-126.00
2024-12-18,13:14:00,22063.75,SELL,3,0.02h,Break Even,$0.75,$-125.25,$314210.00,251,$-125.25
2024-12-18,13:20:00,22358.5,BUY,3,0.02h,Stop Loss,$-18.00,$-143.25,$314192.00,251,$-143.25
2024-12-18,13:23:00,22054.5,SELL,3,0.02h,Stop Loss,$-18.00,$-161.25,$314174.00,251,$-161.25
2024-12-18,13:27:00,22368.5,BUY,3,0.02h,Stop Loss,$-18.00,$-179.25,$314156.00,251,$-179.25
2024-12-18,13:38:00,22050.25,SELL,3,0.02h,Stop Loss,$75.75,$-103.50,$314231.75,251,$-103.50
2024-12-18,13:41:00,22341.25,BUY,3,0.02h,Stop Loss,$-18.00,$-121.50,$314213.75,251,$-121.50
2024-12-18,13:42:00,22036.0,SELL,3,0.02h,Stop Loss,$135.75,$14.25,$314349.50,251,$14.25
2024-12-18,14:02:00,22297.0,BUY,3,0.02h,Stop Loss,$60.75,$75.00,$314410.25,251,$75.00
2024-12-18,14:05:00,21986.75,SELL,3,0.02h,Stop Loss,$-18.00,$57.00,$314392.25,251,$57.00
2024-12-18,14:08:00,22282.75,BUY,3,0.02h,Stop Loss,$-18.00,$39.00,$314374.25,251,$39.00
2024-12-18,14:09:00,21979.25,SELL,3,0.02h,Stop Loss,$15.75,$54.75,$314390.00,251,$54.75
2024-12-18,14:25:00,22281.5,BUY,3,0.02h,Stop Loss,$60.75,$115.50,$314450.75,251,$115.50
2024-12-18,14:34:00,21956.25,SELL,3,0.02h,Stop Loss,$420.75,$536.25,$314871.50,251,$536.25
2024-12-18,14:37:00,22233.0,BUY,3,0.02h,Stop Loss,$-18.00,$518.25,$314853.50,251,$518.25
2024-12-18,14:38:00,21935.75,SELL,3,0.02h,Stop Loss,$-18.00,$500.25,$314835.50,251,$500.25
2024-12-18,14:39:00,22232.75,BUY,3,0.02h,Stop Loss,$-18.00,$482.25,$314817.50,251,$482.25
2024-12-18,14:40:00,21954.25,SELL,3,0.02h,Stop Loss,$19.50,$501.75,$314837.00,251,$501.75
2024-12-18,14:42:00,22250.5,BUY,3,0.02h,Stop Loss,$308.25,$810.00,$315145.25,251,$810.00
2024-12-18,14:47:00,21955.5,SELL,3,0.02h,Break Even,$0.75,$810.75,$315146.00,251,$810.75
2024-12-18,14:57:00,22289.25,BUY,3,0.02h,Stop Loss,$83.25,$894.00,$315229.25,251,$894.00
2024-12-18,15:13:00,22007.5,SELL,3,0.02h,Stop Loss,$75.75,$969.75,$315305.00,251,$969.75
2024-12-18,15:15:00,22310.0,BUY,3,0.02h,Stop Loss,$-18.00,$951.75,$315287.00,251,$951.75
2024-12-18,15:35:00,22007.75,SELL,3,0.02h,Stop Loss,$-18.00,$933.75,$315269.00,251,$933.75
2024-12-18,15:37:00,22298.0,BUY,3,0.02h,Stop Loss,$83.25,$1017.00,$315352.25,251,$1017.00
2024-12-18,15:39:00,22016.0,SELL,3,0.02h,Stop Loss,$12.00,$1029.00,$315364.25,251,$1029.00
2024-12-18,15:49:00,22346.0,BUY,3,0.02h,Stop Loss,$-18.00,$1011.00,$315346.25,251,$1011.00
2024-12-18,15:50:00,22050.0,SELL,3,0.02h,Stop Loss,$45.75,$1056.75,$315392.00,251,$1056.75
2024-12-18,15:52:00,22337.0,BUY,3,0.02h,Break Even,$0.75,$1057.50,$315392.75,251,$1057.50
2024-12-18,15:54:00,22032.75,SELL,3,0.02h,Stop Loss,$-18.00,$1039.50,$315374.75,251,$1039.50
2024-12-18,15:55:00,22326.25,BUY,3,0.02h,Stop Loss,$102.00,$1141.50,$315476.75,251,$1141.50
2024-12-18,15:59:00,22031.75,SELL,3,0.02h,Stop Loss,$102.00,$1243.50,$315578.75,251,$1243.50
2024-12-18,16:10:00,22321.25,BUY,3,0.02h,Stop Loss,$-18.00,$1225.50,$315560.75,251,$1225.50
2024-12-18,16:11:00,22024.75,SELL,3,0.02h,Stop Loss,$124.50,$1350.00,$315685.25,251,$1350.00
2024-12-18,16:17:00,22288.25,BUY,3,0.02h,Stop Loss,$-18.00,$1332.00,$315667.25,251,$1332.00
2024-12-18,16:21:00,21964.5,SELL,3,0.02h,Stop Loss,$-18.00,$1314.00,$315649.25,251,$1314.00
2024-12-18,16:22:00,22252.5,BUY,3,0.02h,Stop Loss,$-18.00,$1296.00,$315631.25,251,$1296.00
2024-12-18,16:23:00,21961.5,SELL,3,0.02h,Stop Loss,$-18.00,$1278.00,$315613.25,251,$1278.00
2024-12-18,16:24:00,22261.25,BUY,3,0.02h,Stop Loss,$45.75,$1323.75,$315659.00,251,$1323.75
2024-12-18,16:31:00,22013.75,SELL,3,0.02h,Stop Loss,$-18.00,$1305.75,$315641.00,251,$1305.75
2024-12-18,16:32:00,22308.5,BUY,3,0.02h,Stop Loss,$72.00,$1377.75,$315713.00,251,$1377.75
2024-12-18,16:38:00,22012.5,SELL,3,0.02h,Break Even,$0.75,$1378.50,$315713.75,251,$1378.50
2024-12-18,16:41:00,22315.0,BUY,3,0.02h,Stop Loss,$23.25,$1401.75,$315737.00,251,$1401.75
2024-12-18,16:44:00,22020.5,SELL,3,0.02h,Break Even,$0.75,$1402.50,$315737.75,251,$1402.50
2024-12-18,16:49:00,22313.5,BUY,3,0.02h,Stop Loss,$-18.00,$1384.50,$315719.75,251,$1384.50
2024-12-18,16:52:00,22021.0,SELL,3,0.02h,Stop Loss,$-18.00,$1366.50,$315701.75,251,$1366.50
2024-12-18,16:53:00,22323.25,BUY,3,0.02h,Stop Loss,$15.75,$1382.25,$315717.50,251,$1382.25
2024-12-18,16:56:00,22018.0,SELL,3,0.02h,Stop Loss,$-18.00,$1364.25,$315699.50,251,$1364.25
2024-12-18,16:57:00,22309.5,BUY,3,0.02h,Stop Loss,$-18.00,$1346.25,$315681.50,251,$1346.25
2024-12-18,16:59:00,22011.5,SELL,3,0.02h,Stop Loss,$-18.00,$1328.25,$315663.50,251,$1328.25
2024-12-18,17:00:00,22305.0,BUY,3,0.02h,Stop Loss,$-18.00,$1310.25,$315645.50,251,$1310.25
2024-12-18,17:03:00,22003.75,SELL,3,0.02h,Break Even,$0.75,$1311.00,$315646.25,251,$1311.00
2024-12-18,17:07:00,22305.5,BUY,3,0.02h,Stop Loss,$45.75,$1356.75,$315692.00,251,$1356.75
2024-12-18,17:13:00,22005.0,SELL,3,0.02h,Stop Loss,$60.75,$1417.50,$315752.75,251,$1417.50
2024-12-18,17:17:00,22296.25,BUY,3,0.02h,Stop Loss,$124.50,$1542.00,$315877.25,251,$1542.00
2024-12-18,17:21:00,22016.25,SELL,3,0.02h,Break Even,$0.75,$1542.75,$315878.00,251,$1542.75
2024-12-18,17:30:00,22299.5,BUY,3,0.02h,Stop Loss,$-18.00,$1524.75,$315860.00,251,$1524.75
2024-12-18,17:31:00,22001.0,SELL,3,0.02h,Stop Loss,$-18.00,$1506.75,$315842.00,251,$1506.75
2024-12-18,17:32:00,22290.75,BUY,3,0.02h,Break Even,$0.75,$1507.50,$315842.75,251,$1507.50
2024-12-18,17:34:00,21996.5,SELL,3,0.02h,Stop Loss,$-18.00,$1489.50,$315824.75,251,$1489.50
2024-12-18,17:35:00,22296.5,BUY,3,0.02h,Stop Loss,$-18.00,$1471.50,$315806.75,251,$1471.50
2024-12-18,17:36:00,22010.0,SELL,3,0.02h,Stop Loss,$-18.00,$1453.50,$315788.75,251,$1453.50
2024-12-18,17:38:00,22305.25,BUY,3,0.02h,Stop Loss,$-18.00,$1435.50,$315770.75,251,$1435.50
2024-12-18,17:39:00,21997.75,SELL,3,0.02h,Stop Loss,$87.00,$1522.50,$315857.75,251,$1522.50
2024-12-18,17:54:00,22293.5,BUY,3,0.02h,Stop Loss,$-18.00,$1504.50,$315839.75,251,$1504.50
2024-12-18,17:55:00,22004.25,SELL,3,0.02h,Break Even,$0.75,$1505.25,$315840.50,251,$1505.25
2024-12-18,17:57:00,22301.0,BUY,3,0.02h,Break Even,$0.75,$1506.00,$315841.25,251,$1506.00
2024-12-18,18:03:00,21999.75,SELL,3,0.02h,Stop Loss,$-18.00,$1488.00,$315823.25,251,$1488.00
2024-12-18,18:04:00,22300.0,BUY,3,0.02h,Break Even,$0.75,$1488.75,$315824.00,251,$1488.75
2024-12-18,18:10:00,22012.25,SELL,3,0.02h,Stop Loss,$-18.00,$1470.75,$315806.00,251,$1470.75
2024-12-18,18:11:00,22306.25,BUY,3,0.02h,Stop Loss,$-18.00,$1452.75,$315788.00,251,$1452.75
2024-12-18,18:18:00,22006.25,SELL,3,0.02h,Break Even,$0.75,$1453.50,$315788.75,251,$1453.50
2024-12-18,18:24:00,22307.5,BUY,3,0.02h,Stop Loss,$-18.00,$1435.50,$315770.75,251,$1435.50
2024-12-18,18:25:00,22012.0,SELL,3,0.02h,Stop Loss,$-18.00,$1417.50,$315752.75,251,$1417.50
2024-12-18,18:26:00,22301.0,BUY,3,0.02h,Stop Loss,$-18.00,$1399.50,$315734.75,251,$1399.50
2024-12-18,18:27:00,22005.0,SELL,3,0.02h,Break Even,$0.75,$1400.25,$315735.50,251,$1400.25
2024-12-18,18:31:00,22290.5,BUY,3,0.02h,Stop Loss,$72.00,$1472.25,$315807.50,251,$1472.25
2024-12-18,18:41:00,21988.5,SELL,3,0.02h,Stop Loss,$-18.00,$1454.25,$315789.50,251,$1454.25
2024-12-18,18:42:00,22279.75,BUY,3,0.02h,Stop Loss,$-18.00,$1436.25,$315771.50,251,$1436.25
2024-12-18,18:43:00,21983.0,SELL,3,0.02h,Stop Loss,$-18.00,$1418.25,$315753.50,251,$1418.25
2024-12-18,18:44:00,22277.0,BUY,3,0.02h,Break Even,$0.75,$1419.00,$315754.25,251,$1419.00
2024-12-18,18:46:00,21980.75,SELL,3,0.02h,Stop Loss,$-18.00,$1401.00,$315736.25,251,$1401.00
2024-12-18,18:47:00,22278.25,BUY,3,0.02h,Stop Loss,$49.50,$1450.50,$315785.75,251,$1450.50
2024-12-18,18:49:00,21993.75,SELL,3,0.02h,Stop Loss,$-18.00,$1432.50,$315767.75,251,$1432.50
2024-12-18,18:50:00,22285.5,BUY,3,0.02h,Stop Loss,$-18.00,$1414.50,$315749.75,251,$1414.50
2024-12-18,18:51:00,21991.0,SELL,3,0.02h,Break Even,$0.75,$1415.25,$315750.50,251,$1415.25
2024-12-18,19:02:00,22229.75,BUY,3,0.02h,Stop Loss,$-18.00,$1397.25,$315732.50,251,$1397.25
2024-12-18,19:03:00,21963.25,SELL,3,0.02h,Stop Loss,$390.75,$1788.00,$316123.25,251,$1788.00
2024-12-18,19:15:00,22119.0,BUY,3,0.02h,Stop Loss,$132.00,$1920.00,$316255.25,251,$1920.00
2024-12-18,19:20:00,21807.75,SELL,3,0.02h,Stop Loss,$-18.00,$1902.00,$316237.25,251,$1902.00
2024-12-18,19:22:00,22136.25,BUY,3,0.02h,Stop Loss,$308.25,$2210.25,$316545.50,251,$2210.25
2024-12-18,19:26:00,21860.25,SELL,3,0.02h,Stop Loss,$-18.00,$2192.25,$316527.50,251,$2192.25
2024-12-18,19:27:00,22137.75,BUY,3,0.02h,Stop Loss,$-18.00,$2174.25,$316509.50,251,$2174.25
2024-12-18,19:28:00,21842.75,SELL,3,0.02h,Stop Loss,$-18.00,$2156.25,$316491.50,251,$2156.25
2024-12-18,19:44:00,22050.5,BUY,3,0.02h,Stop Loss,$-18.00,$2138.25,$316473.50,251,$2138.25
2024-12-18,19:45:00,21758.0,SELL,3,0.02h,Stop Loss,$-18.00,$2120.25,$316455.50,251,$2120.25
2024-12-18,20:15:00,21832.5,BUY,3,0.02h,Stop Loss,$-18.00,$2102.25,$316437.50,251,$2102.25
2024-12-18,20:16:00,21512.0,SELL,3,0.02h,Stop Loss,$57.00,$2159.25,$316494.50,251,$2159.25
2024-12-18,20:54:00,21647.0,BUY,3,0.02h,Stop Loss,$589.50,$2748.75,$317084.00,251,$2748.75
2024-12-18,20:59:00,21276.75,SELL,3,0.02h,Stop Loss,$1238.25,$3987.00,$318322.25,251,$3987.00
2024-12-18,21:17:00,21453.5,BUY,3,0.02h,Break Even,$0.75,$3987.75,$318323.00,251,$3987.75
2024-12-18,21:20:00,21142.5,SELL,3,0.02h,Stop Loss,$-18.00,$3969.75,$318305.00,251,$3969.75
2024-12-18,21:21:00,21437.5,BUY,3,0.02h,Stop Loss,$-18.00,$3951.75,$318287.00,251,$3951.75
2024-12-18,21:22:00,21179.5,SELL,3,0.02h,Stop Loss,$-18.00,$3933.75,$318269.00,251,$3933.75
2024-12-18,21:25:00,21479.25,BUY,3,0.02h,Break Even,$0.75,$3934.50,$318269.75,251,$3934.50
2024-12-18,21:29:00,21168.75,SELL,3,0.02h,Stop Loss,$-18.00,$3916.50,$318251.75,251,$3916.50
2024-12-18,21:30:00,21456.0,BUY,3,0.02h,Stop Loss,$-18.00,$3898.50,$318233.75,251,$3898.50
2024-12-18,21:31:00,21181.5,SELL,3,0.02h,Stop Loss,$255.75,$4154.25,$318489.50,251,$4154.25
2024-12-18,21:43:00,21422.5,BUY,3,0.02h,Stop Loss,$-18.00,$4136.25,$318471.50,251,$4136.25
2024-12-18,21:44:00,21152.5,SELL,3,0.02h,Stop Loss,$-18.00,$4118.25,$318453.50,251,$4118.25
2024-12-18,21:49:00,21448.0,BUY,3,0.02h,Stop Loss,$237.00,$4355.25,$318690.50,251,$4355.25
2024-12-18,21:56:00,21184.0,SELL,3,0.02h,Stop Loss,$-18.00,$4337.25,$318672.50,251,$4337.25
2024-12-18,21:57:00,21466.5,BUY,3,0.02h,Stop Loss,$34.50,$4371.75,$318707.00,251,$4371.75
2024-12-18,22:00:00,21186.0,SELL,3,14.00h,Stop Loss,$-18.00,$4353.75,$318689.00,251,$4353.75
,,,,,,,,,,,
2024-12-19,12:00:00,21575.25,BUY,3,0.02h,Stop Loss,$113.25,$113.25,$318802.25,252,$113.25
2024-12-19,12:19:00,21358.25,SELL,3,0.02h,Stop Loss,$34.50,$147.75,$318836.75,252,$147.75
2024-12-19,12:24:00,21656.25,BUY,3,0.02h,Stop Loss,$12.00,$159.75,$318848.75,252,$159.75
2024-12-19,12:37:00,21375.0,SELL,3,0.02h,Stop Loss,$83.25,$243.00,$318932.00,252,$243.00
2024-12-19,12:46:00,21665.0,BUY,3,0.02h,Stop Loss,$-18.00,$225.00,$318914.00,252,$225.00
2024-12-19,12:58:00,21397.5,SELL,3,0.02h,Break Even,$0.75,$225.75,$318914.75,252,$225.75
2024-12-19,13:03:00,21678.0,BUY,3,0.02h,Break Even,$0.75,$226.50,$318915.50,252,$226.50
2024-12-19,13:12:00,21392.0,SELL,3,0.02h,Stop Loss,$-18.00,$208.50,$318897.50,252,$208.50
2024-12-19,13:13:00,21671.5,BUY,3,0.02h,Break Even,$0.75,$209.25,$318898.25,252,$209.25
2024-12-19,13:15:00,21399.0,SELL,3,0.02h,Break Even,$0.75,$210.00,$318899.00,252,$210.00
2024-12-19,13:23:00,21671.5,BUY,3,0.02h,Stop Loss,$-18.00,$192.00,$318881.00,252,$192.00
2024-12-19,13:24:00,21397.0,SELL,3,0.02h,Break Even,$0.75,$192.75,$318881.75,252,$192.75
2024-12-19,13:35:00,21659.0,BUY,3,0.02h,Stop Loss,$-18.00,$174.75,$318863.75,252,$174.75
2024-12-19,13:41:00,21391.75,SELL,3,0.02h,Stop Loss,$210.75,$385.50,$319074.50,252,$385.50
2024-12-19,13:44:00,21649.25,BUY,3,0.02h,Stop Loss,$-18.00,$367.50,$319056.50,252,$367.50
2024-12-19,13:45:00,21362.5,SELL,3,0.02h,Stop Loss,$-18.00,$349.50,$319038.50,252,$349.50
2024-12-19,13:46:00,21638.0,BUY,3,0.02h,Stop Loss,$-18.00,$331.50,$319020.50,252,$331.50
2024-12-19,13:47:00,21367.25,SELL,3,0.02h,Break Even,$0.75,$332.25,$319021.25,252,$332.25
2024-12-19,13:50:00,21649.0,BUY,3,0.02h,Stop Loss,$-18.00,$314.25,$319003.25,252,$314.25
2024-12-19,14:03:00,21341.5,SELL,3,0.02h,Stop Loss,$30.75,$345.00,$319034.00,252,$345.00
2024-12-19,14:09:00,21651.0,BUY,3,0.02h,Stop Loss,$19.50,$364.50,$319053.50,252,$364.50
2024-12-19,14:17:00,21374.0,SELL,3,0.02h,Stop Loss,$-18.00,$346.50,$319035.50,252,$346.50
2024-12-19,14:23:00,21661.25,BUY,3,0.02h,Stop Loss,$-18.00,$328.50,$319017.50,252,$328.50
2024-12-19,14:25:00,21379.5,SELL,3,0.02h,Break Even,$0.75,$329.25,$319018.25,252,$329.25
2024-12-19,14:33:00,21647.25,BUY,3,0.02h,Stop Loss,$567.00,$896.25,$319585.25,252,$896.25
2024-12-19,14:41:00,21334.75,SELL,3,0.02h,Stop Loss,$319.50,$1215.75,$319904.75,252,$1215.75
2024-12-19,14:50:00,21603.75,BUY,3,0.02h,Stop Loss,$188.25,$1404.00,$320093.00,252,$1404.00
2024-12-19,14:54:00,21325.5,SELL,3,0.02h,Stop Loss,$-18.00,$1386.00,$320075.00,252,$1386.00
2024-12-19,14:58:00,21592.0,BUY,3,0.02h,Break Even,$0.75,$1386.75,$320075.75,252,$1386.75
2024-12-19,15:03:00,21304.5,SELL,3,0.02h,Stop Loss,$75.75,$1462.50,$320151.50,252,$1462.50
2024-12-19,15:12:00,21593.25,BUY,3,0.02h,Stop Loss,$-18.00,$1444.50,$320133.50,252,$1444.50
2024-12-19,15:13:00,21323.5,SELL,3,0.02h,Stop Loss,$-18.00,$1426.50,$320115.50,252,$1426.50
2024-12-19,15:15:00,21629.75,BUY,3,0.02h,Stop Loss,$-18.00,$1408.50,$320097.50,252,$1408.50
2024-12-19,15:16:00,21335.5,SELL,3,0.02h,Stop Loss,$117.00,$1525.50,$320214.50,252,$1525.50
2024-12-19,15:22:00,21587.75,BUY,3,0.02h,Break Even,$0.75,$1526.25,$320215.25,252,$1526.25
2024-12-19,15:24:00,21273.25,SELL,3,0.02h,Stop Loss,$72.00,$1598.25,$320287.25,252,$1598.25
2024-12-19,15:33:00,21507.75,BUY,3,0.02h,Stop Loss,$90.75,$1689.00,$320378.00,252,$1689.00
2024-12-19,15:35:00,21217.0,SELL,3,0.02h,Stop Loss,$42.00,$1731.00,$320420.00,252,$1731.00
2024-12-19,15:38:00,21515.5,BUY,3,0.02h,Stop Loss,$244.50,$1975.50,$320664.50,252,$1975.50
2024-12-19,15:44:00,21274.0,SELL,3,0.02h,Stop Loss,$57.00,$2032.50,$320721.50,252,$2032.50
2024-12-19,15:51:00,21576.5,BUY,3,0.02h,Stop Loss,$-18.00,$2014.50,$320703.50,252,$2014.50
2024-12-19,15:52:00,21280.75,SELL,3,0.02h,Stop Loss,$278.25,$2292.75,$320981.75,252,$2292.75
2024-12-19,15:57:00,21513.5,BUY,3,0.02h,Stop Loss,$210.75,$2503.50,$321192.50,252,$2503.50
2024-12-19,16:03:00,21233.0,SELL,3,0.02h,Break Even,$0.75,$2504.25,$321193.25,252,$2504.25
2024-12-19,16:08:00,21478.5,BUY,3,0.02h,Stop Loss,$-18.00,$2486.25,$321175.25,252,$2486.25
2024-12-19,16:09:00,21204.5,SELL,3,0.02h,Stop Loss,$-18.00,$2468.25,$321157.25,252,$2468.25
2024-12-19,16:10:00,21473.75,BUY,3,0.02h,Stop Loss,$-18.00,$2450.25,$321139.25,252,$2450.25
2024-12-19,16:11:00,21206.75,SELL,3,0.02h,Stop Loss,$109.50,$2559.75,$321248.75,252,$2559.75
2024-12-19,16:14:00,21480.0,BUY,3,0.02h,Stop Loss,$-18.00,$2541.75,$321230.75,252,$2541.75
2024-12-19,16:15:00,21211.0,SELL,3,0.02h,Stop Loss,$-18.00,$2523.75,$321212.75,252,$2523.75
2024-12-19,16:16:00,21508.25,BUY,3,0.02h,Stop Loss,$-18.00,$2505.75,$321194.75,252,$2505.75
2024-12-19,16:17:00,21234.0,SELL,3,0.02h,Break Even,$0.75,$2506.50,$321195.50,252,$2506.50
2024-12-19,16:22:00,21547.25,BUY,3,0.02h,Stop Loss,$-18.00,$2488.50,$321177.50,252,$2488.50
2024-12-19,16:24:00,21324.5,SELL,3,0.02h,Stop Loss,$64.50,$2553.00,$321242.00,252,$2553.00
2024-12-19,16:30:00,21602.0,BUY,3,0.02h,Stop Loss,$-18.00,$2535.00,$321224.00,252,$2535.00
2024-12-19,16:46:00,21303.25,SELL,3,0.02h,Break Even,$0.75,$2535.75,$321224.75,252,$2535.75
2024-12-19,16:48:00,21596.5,BUY,3,0.02h,Stop Loss,$-18.00,$2517.75,$321206.75,252,$2517.75
2024-12-19,16:49:00,21320.0,SELL,3,0.02h,Break Even,$0.75,$2518.50,$321207.50,252,$2518.50
2024-12-19,16:54:00,21552.5,BUY,3,0.02h,Stop Loss,$27.00,$2545.50,$321234.50,252,$2545.50
2024-12-19,17:01:00,21287.25,SELL,3,0.02h,Stop Loss,$-18.00,$2527.50,$321216.50,252,$2527.50
2024-12-19,17:02:00,21550.25,BUY,3,0.02h,Stop Loss,$195.75,$2723.25,$321412.25,252,$2723.25
2024-12-19,17:12:00,21262.5,SELL,3,0.02h,Break Even,$0.75,$2724.00,$321413.00,252,$2724.00
2024-12-19,17:21:00,21502.0,BUY,3,0.02h,Break Even,$0.75,$2724.75,$321413.75,252,$2724.75
2024-12-19,17:23:00,21207.75,SELL,3,0.02h,Stop Loss,$-18.00,$2706.75,$321395.75,252,$2706.75
2024-12-19,17:25:00,21485.5,BUY,3,0.02h,Break Even,$0.75,$2707.50,$321396.50,252,$2707.50
2024-12-19,17:27:00,21205.75,SELL,3,0.02h,Stop Loss,$-18.00,$2689.50,$321378.50,252,$2689.50
2024-12-19,17:30:00,21457.5,BUY,3,0.02h,Stop Loss,$225.75,$2915.25,$321604.25,252,$2915.25
2024-12-19,17:32:00,21177.75,SELL,3,0.02h,Stop Loss,$-18.00,$2897.25,$321586.25,252,$2897.25
2024-12-19,17:35:00,21455.0,BUY,3,0.02h,Stop Loss,$117.00,$3014.25,$321703.25,252,$3014.25
2024-12-19,17:38:00,21182.75,SELL,3,0.02h,Break Even,$0.75,$3015.00,$321704.00,252,$3015.00
2024-12-19,17:58:00,21508.0,BUY,3,0.02h,Stop Loss,$98.25,$3113.25,$321802.25,252,$3113.25
2024-12-19,18:05:00,21182.75,SELL,3,0.02h,Stop Loss,$-18.00,$3095.25,$321784.25,252,$3095.25
2024-12-19,18:06:00,21453.5,BUY,3,0.02h,Break Even,$0.75,$3096.00,$321785.00,252,$3096.00
2024-12-19,18:08:00,21212.75,SELL,3,0.02h,Stop Loss,$-18.00,$3078.00,$321767.00,252,$3078.00
2024-12-19,18:09:00,21482.0,BUY,3,0.02h,Stop Loss,$192.00,$3270.00,$321959.00,252,$3270.00
2024-12-19,18:15:00,21249.25,SELL,3,0.02h,Stop Loss,$244.50,$3514.50,$322203.50,252,$3514.50
2024-12-19,18:17:00,21513.0,BUY,3,0.02h,Break Even,$0.75,$3515.25,$322204.25,252,$3515.25
2024-12-19,18:22:00,21229.75,SELL,3,0.02h,Stop Loss,$-18.00,$3497.25,$322186.25,252,$3497.25
2024-12-19,18:23:00,21482.5,BUY,3,0.02h,Stop Loss,$-18.00,$3479.25,$322168.25,252,$3479.25
2024-12-19,18:24:00,21239.25,SELL,3,0.02h,Stop Loss,$-18.00,$3461.25,$322150.25,252,$3461.25
2024-12-19,18:25:00,21514.5,BUY,3,0.02h,Stop Loss,$-18.00,$3443.25,$322132.25,252,$3443.25
2024-12-19,18:26:00,21245.75,SELL,3,0.02h,Stop Loss,$-18.00,$3425.25,$322114.25,252,$3425.25
2024-12-19,18:28:00,21525.0,BUY,3,0.02h,Stop Loss,$-18.00,$3407.25,$322096.25,252,$3407.25
2024-12-19,18:29:00,21260.25,SELL,3,0.02h,Stop Loss,$-18.00,$3389.25,$322078.25,252,$3389.25
2024-12-19,18:30:00,21530.0,BUY,3,0.02h,Stop Loss,$-18.00,$3371.25,$322060.25,252,$3371.25
2024-12-19,18:32:00,21247.5,SELL,3,0.02h,Stop Loss,$-18.00,$3353.25,$322042.25,252,$3353.25
2024-12-19,18:33:00,21527.5,BUY,3,0.02h,Stop Loss,$34.50,$3387.75,$322076.75,252,$3387.75
2024-12-19,18:36:00,21259.5,SELL,3,0.02h,Stop Loss,$-18.00,$3369.75,$322058.75,252,$3369.75
2024-12-19,18:37:00,21522.75,BUY,3,0.02h,Stop Loss,$72.00,$3441.75,$322130.75,252,$3441.75
2024-12-19,18:44:00,21264.5,SELL,3,0.02h,Stop Loss,$-18.00,$3423.75,$322112.75,252,$3423.75
2024-12-19,18:45:00,21526.0,BUY,3,0.02h,Stop Loss,$-18.00,$3405.75,$322094.75,252,$3405.75
2024-12-19,18:46:00,21264.0,SELL,3,0.02h,Break Even,$0.75,$3406.50,$322095.50,252,$3406.50
2024-12-19,18:53:00,21549.0,BUY,3,0.02h,Stop Loss,$-18.00,$3388.50,$322077.50,252,$3388.50
2024-12-19,18:54:00,21275.5,SELL,3,0.02h,Stop Loss,$154.50,$3543.00,$322232.00,252,$3543.00
2024-12-19,18:59:00,21584.5,BUY,3,0.02h,Stop Loss,$180.75,$3723.75,$322412.75,252,$3723.75
2024-12-19,19:17:00,21247.0,SELL,3,0.02h,Stop Loss,$-18.00,$3705.75,$322394.75,252,$3705.75
2024-12-19,19:18:00,21508.0,BUY,3,0.02h,Stop Loss,$-18.00,$3687.75,$322376.75,252,$3687.75
2024-12-19,19:19:00,21243.0,SELL,3,0.02h,Stop Loss,$-18.00,$3669.75,$322358.75,252,$3669.75
2024-12-19,19:21:00,21501.75,BUY,3,0.02h,Stop Loss,$-18.00,$3651.75,$322340.75,252,$3651.75
2024-12-19,19:22:00,21229.0,SELL,3,0.02h,Stop Loss,$53.25,$3705.00,$322394.00,252,$3705.00
2024-12-19,19:34:00,21487.5,BUY,3,0.02h,Break Even,$0.75,$3705.75,$322394.75,252,$3705.75
2024-12-19,19:38:00,21207.75,SELL,3,0.02h,Stop Loss,$45.75,$3751.50,$322440.50,252,$3751.50
2024-12-19,19:50:00,21478.0,BUY,3,0.02h,Stop Loss,$-18.00,$3733.50,$322422.50,252,$3733.50
2024-12-19,19:51:00,21218.25,SELL,3,0.02h,Stop Loss,$-18.00,$3715.50,$322404.50,252,$3715.50
2024-12-19,19:52:00,21498.0,BUY,3,0.02h,Stop Loss,$-18.00,$3697.50,$322386.50,252,$3697.50
2024-12-19,19:53:00,21223.25,SELL,3,0.02h,Stop Loss,$19.50,$3717.00,$322406.00,252,$3717.00
2024-12-19,19:55:00,21485.5,BUY,3,0.02h,Stop Loss,$165.75,$3882.75,$322571.75,252,$3882.75
2024-12-19,19:59:00,21205.25,SELL,3,0.02h,Stop Loss,$-18.00,$3864.75,$322553.75,252,$3864.75
2024-12-19,20:00:00,21462.25,BUY,3,0.02h,Stop Loss,$184.50,$4049.25,$322738.25,252,$4049.25
2024-12-19,20:03:00,21192.25,SELL,3,0.02h,Stop Loss,$15.75,$4065.00,$322754.00,252,$4065.00
2024-12-19,20:11:00,21446.0,BUY,3,0.02h,Break Even,$0.75,$4065.75,$322754.75,252,$4065.75
2024-12-19,20:13:00,21180.75,SELL,3,0.02h,Stop Loss,$-18.00,$4047.75,$322736.75,252,$4047.75
2024-12-19,20:14:00,21454.75,BUY,3,0.02h,Stop Loss,$-18.00,$4029.75,$322718.75,252,$4029.75
2024-12-19,20:15:00,21198.0,SELL,3,0.02h,Stop Loss,$-18.00,$4011.75,$322700.75,252,$4011.75
2024-12-19,20:16:00,21479.0,BUY,3,0.02h,Stop Loss,$-18.00,$3993.75,$322682.75,252,$3993.75
2024-12-19,20:17:00,21206.5,SELL,3,0.02h,Stop Loss,$-18.00,$3975.75,$322664.75,252,$3975.75
2024-12-19,20:24:00,21516.5,BUY,3,0.02h,Stop Loss,$173.25,$4149.00,$322838.00,252,$4149.00
2024-12-19,20:28:00,21227.0,SELL,3,0.02h,Stop Loss,$-18.00,$4131.00,$322820.00,252,$4131.00
2024-12-19,20:29:00,21499.5,BUY,3,0.02h,Stop Loss,$-18.00,$4113.00,$322802.00,252,$4113.00
2024-12-19,20:30:00,21222.25,SELL,3,0.02h,Stop Loss,$-18.00,$4095.00,$322784.00,252,$4095.00
2024-12-19,20:31:00,21505.5,BUY,3,0.02h,Break Even,$0.75,$4095.75,$322784.75,252,$4095.75
2024-12-19,20:35:00,21173.75,SELL,3,0.02h,Stop Loss,$390.75,$4486.50,$323175.50,252,$4486.50
2024-12-19,20:39:00,21461.75,BUY,3,0.02h,Stop Loss,$-18.00,$4468.50,$323157.50,252,$4468.50
2024-12-19,20:40:00,21211.75,SELL,3,0.02h,Stop Loss,$-18.00,$4450.50,$323139.50,252,$4450.50
2024-12-19,20:41:00,21464.5,BUY,3,0.02h,Stop Loss,$-18.00,$4432.50,$323121.50,252,$4432.50
2024-12-19,20:42:00,21221.25,SELL,3,0.02h,Break Even,$0.75,$4433.25,$323122.25,252,$4433.25
2024-12-19,20:46:00,21438.75,BUY,3,0.02h,Stop Loss,$383.25,$4816.50,$323505.50,252,$4816.50
2024-12-19,20:52:00,21115.25,SELL,3,0.02h,Stop Loss,$-18.00,$4798.50,$323487.50,252,$4798.50
2024-12-19,21:04:00,21391.25,BUY,3,0.02h,Stop Loss,$27.00,$4825.50,$323514.50,252,$4825.50
2024-12-19,21:06:00,21113.5,SELL,3,0.02h,Stop Loss,$-18.00,$4807.50,$323496.50,252,$4807.50
2024-12-19,21:07:00,21382.0,BUY,3,0.02h,Stop Loss,$-18.00,$4789.50,$323478.50,252,$4789.50
2024-12-19,21:08:00,21117.5,SELL,3,0.02h,Break Even,$0.75,$4790.25,$323479.25,252,$4790.25
2024-12-19,21:13:00,21373.25,BUY,3,0.02h,Stop Loss,$-18.00,$4772.25,$323461.25,252,$4772.25
2024-12-19,21:14:00,21095.0,SELL,3,0.02h,Stop Loss,$-18.00,$4754.25,$323443.25,252,$4754.25
2024-12-19,21:16:00,21356.0,BUY,3,0.02h,Break Even,$0.75,$4755.00,$323444.00,252,$4755.00
2024-12-19,21:18:00,21088.25,SELL,3,0.02h,Stop Loss,$-18.00,$4737.00,$323426.00,252,$4737.00
2024-12-19,21:19:00,21377.25,BUY,3,0.02h,Stop Loss,$-18.00,$4719.00,$323408.00,252,$4719.00
2024-12-19,21:20:00,21095.75,SELL,3,0.02h,Break Even,$0.75,$4719.75,$323408.75,252,$4719.75
2024-12-19,21:24:00,21386.25,BUY,3,0.02h,Stop Loss,$-18.00,$4701.75,$323390.75,252,$4701.75
2024-12-19,21:25:00,21110.25,SELL,3,0.02h,Stop Loss,$-18.00,$4683.75,$323372.75,252,$4683.75
2024-12-19,21:26:00,21376.5,BUY,3,0.02h,Stop Loss,$-18.00,$4665.75,$323354.75,252,$4665.75
2024-12-19,21:27:00,21114.25,SELL,3,0.02h,Break Even,$0.75,$4666.50,$323355.50,252,$4666.50
2024-12-19,21:29:00,21385.75,BUY,3,0.02h,Stop Loss,$-18.00,$4648.50,$323337.50,252,$4648.50
2024-12-19,21:30:00,21115.75,SELL,3,0.02h,Stop Loss,$-18.00,$4630.50,$323319.50,252,$4630.50
2024-12-19,21:31:00,21392.5,BUY,3,0.02h,Stop Loss,$-18.00,$4612.50,$323301.50,252,$4612.50
2024-12-19,21:32:00,21126.75,SELL,3,0.02h,Stop Loss,$-18.00,$4594.50,$323283.50,252,$4594.50
2024-12-19,21:33:00,21395.25,BUY,3,0.02h,Stop Loss,$-18.00,$4576.50,$323265.50,252,$4576.50
2024-12-19,21:34:00,21131.25,SELL,3,0.02h,Stop Loss,$-18.00,$4558.50,$323247.50,252,$4558.50
2024-12-19,21:36:00,21400.75,BUY,3,0.02h,Stop Loss,$-18.00,$4540.50,$323229.50,252,$4540.50
2024-12-19,21:57:00,21140.0,SELL,3,0.02h,Stop Loss,$60.75,$4601.25,$323290.25,252,$4601.25
,,,,,,,,,,,
2024-12-20,12:31:00,21019.25,BUY,3,0.02h,Stop Loss,$23.25,$23.25,$323313.50,253,$23.25
2024-12-20,12:34:00,20781.75,SELL,3,0.02h,Stop Loss,$-18.00,$5.25,$323295.50,253,$5.25
2024-12-20,12:35:00,21037.75,BUY,3,0.02h,Stop Loss,$165.75,$171.00,$323461.25,253,$171.00
2024-12-20,12:37:00,20780.0,SELL,3,0.02h,Stop Loss,$42.00,$213.00,$323503.25,253,$213.00
2024-12-20,12:41:00,21049.25,BUY,3,0.02h,Stop Loss,$150.75,$363.75,$323654.00,253,$363.75
2024-12-20,12:43:00,20803.5,SELL,3,0.02h,Stop Loss,$-18.00,$345.75,$323636.00,253,$345.75
2024-12-20,12:44:00,21066.75,BUY,3,0.02h,Stop Loss,$169.50,$515.25,$323805.50,253,$515.25
2024-12-20,12:47:00,20829.75,SELL,3,0.02h,Stop Loss,$233.25,$748.50,$324038.75,253,$748.50
2024-12-20,12:50:00,21073.75,BUY,3,0.02h,Break Even,$0.75,$749.25,$324039.50,253,$749.25
2024-12-20,12:59:00,20837.25,SELL,3,0.02h,Stop Loss,$19.50,$768.75,$324059.00,253,$768.75
2024-12-20,13:07:00,21091.0,BUY,3,0.02h,Stop Loss,$-18.00,$750.75,$324041.00,253,$750.75
2024-12-20,13:08:00,20829.0,SELL,3,0.02h,Stop Loss,$-18.00,$732.75,$324023.00,253,$732.75
2024-12-20,13:09:00,21086.75,BUY,3,0.02h,Stop Loss,$105.75,$838.50,$324128.75,253,$838.50
2024-12-20,13:28:00,20834.0,SELL,3,0.02h,Stop Loss,$-18.00,$820.50,$324110.75,253,$820.50
2024-12-20,13:35:00,21188.5,BUY,3,0.02h,Stop Loss,$225.75,$1046.25,$324336.50,253,$1046.25
2024-12-20,13:46:00,20922.0,SELL,3,0.02h,Stop Loss,$-18.00,$1028.25,$324318.50,253,$1028.25
2024-12-20,13:49:00,21218.5,BUY,3,0.02h,Break Even,$0.75,$1029.00,$324319.25,253,$1029.00
2024-12-20,14:00:00,20956.5,SELL,3,0.02h,Stop Loss,$390.75,$1419.75,$324710.00,253,$1419.75
2024-12-20,14:05:00,21202.25,BUY,3,0.02h,Stop Loss,$94.50,$1514.25,$324804.50,253,$1514.25
2024-12-20,14:14:00,20946.0,SELL,3,0.02h,Stop Loss,$-18.00,$1496.25,$324786.50,253,$1496.25
2024-12-20,14:21:00,21228.0,BUY,3,0.02h,Stop Loss,$109.50,$1605.75,$324896.00,253,$1605.75
2024-12-20,14:24:00,20937.5,SELL,3,0.02h,Stop Loss,$23.25,$1629.00,$324919.25,253,$1629.00
2024-12-20,14:30:00,21212.0,BUY,3,0.02h,Stop Loss,$165.75,$1794.75,$325085.00,253,$1794.75
2024-12-20,17:35:00,21756.5,SELL,3,0.02h,Stop Loss,$30.75,$1825.50,$325115.75,253,$1825.50
2024-12-20,17:39:00,21782.0,BUY,3,0.02h,Stop Loss,$147.00,$1972.50,$325262.75,253,$1972.50
2024-12-20,17:59:00,21768.25,SELL,3,0.02h,Stop Loss,$117.00,$2089.50,$325379.75,253,$2089.50
2024-12-20,18:56:00,21708.0,BUY,3,0.02h,Stop Loss,$27.00,$2116.50,$325406.75,253,$2116.50
2024-12-20,19:01:00,21665.75,SELL,3,0.02h,Stop Loss,$30.75,$2147.25,$325437.50,253,$2147.25
2024-12-20,19:19:00,21687.0,BUY,3,0.02h,Break Even,$0.75,$2148.00,$325438.25,253,$2148.00
2024-12-20,19:52:00,21702.0,SELL,3,0.02h,Stop Loss,$30.75,$2178.75,$325469.00,253,$2178.75
2024-12-20,21:05:00,21609.25,BUY,3,0.02h,Break Even,$0.75,$2179.50,$325469.75,253,$2179.50
2024-12-20,21:08:00,21569.5,SELL,3,0.02h,Break Even,$0.75,$2180.25,$325470.50,253,$2180.25
2024-12-20,21:54:00,21547.5,BUY,3,0.02h,Break Even,$0.75,$2181.00,$325471.25,253,$2181.00
,,,,,,,,,,,
2024-12-23,13:05:00,21646.25,SELL,3,0.02h,Stop Loss,$-18.00,$-18.00,$325453.25,254,$-18.00
2024-12-23,13:08:00,21666.25,BUY,3,0.02h,Stop Loss,$-18.00,$-36.00,$325435.25,254,$-36.00
2024-12-23,13:10:00,21656.0,SELL,3,0.02h,Stop Loss,$-18.00,$-54.00,$325417.25,254,$-54.00
2024-12-23,13:11:00,21660.0,BUY,3,0.02h,Break Even,$0.75,$-53.25,$325418.00,254,$-53.25
2024-12-23,13:12:00,21658.25,SELL,3,0.02h,Stop Loss,$15.75,$-37.50,$325433.75,254,$-37.50
2024-12-23,13:26:00,21661.0,BUY,3,0.02h,Stop Loss,$30.75,$-6.75,$325464.50,254,$-6.75
2024-12-23,13:32:00,21638.0,SELL,3,0.02h,Stop Loss,$105.75,$99.00,$325570.25,254,$99.00
2024-12-23,14:06:00,21591.25,BUY,3,0.02h,Break Even,$0.75,$99.75,$325571.00,254,$99.75
2024-12-23,14:18:00,21583.0,SELL,3,0.02h,Stop Loss,$94.50,$194.25,$325665.50,254,$194.25
2024-12-23,14:22:00,21593.25,BUY,3,0.02h,Stop Loss,$38.25,$232.50,$325703.75,254,$232.50
2024-12-23,14:47:00,21592.25,SELL,3,0.02h,Stop Loss,$-18.00,$214.50,$325685.75,254,$214.50
2024-12-23,15:00:00,21629.75,BUY,3,0.02h,Stop Loss,$165.75,$380.25,$325851.50,254,$380.25
2024-12-23,15:03:00,21583.75,SELL,3,0.02h,Stop Loss,$-18.00,$362.25,$325833.50,254,$362.25
2024-12-23,15:39:00,21584.75,BUY,3,0.02h,Stop Loss,$64.50,$426.75,$325898.00,254,$426.75
2024-12-23,15:49:00,21551.75,SELL,3,0.02h,Stop Loss,$75.75,$502.50,$325973.75,254,$502.50
2024-12-23,15:56:00,21575.75,BUY,3,0.02h,Stop Loss,$150.75,$653.25,$326124.50,254,$653.25
2024-12-23,17:15:00,21671.5,SELL,3,0.02h,Stop Loss,$124.50,$777.75,$326249.00,254,$777.75
2024-12-23,17:29:00,21687.0,BUY,3,0.02h,Break Even,$0.75,$778.50,$326249.75,254,$778.50
2024-12-23,17:30:00,21671.75,SELL,3,0.02h,Break Even,$0.75,$779.25,$326250.50,254,$779.25
2024-12-23,17:33:00,21685.75,BUY,3,0.02h,Stop Loss,$34.50,$813.75,$326285.00,254,$813.75
2024-12-23,17:37:00,21661.5,SELL,3,0.02h,Stop Loss,$-18.00,$795.75,$326267.00,254,$795.75
2024-12-23,17:38:00,21676.75,BUY,3,0.02h,Stop Loss,$150.75,$946.50,$326417.75,254,$946.50
2024-12-23,19:34:00,21752.25,SELL,3,0.02h,Break Even,$0.75,$947.25,$326418.50,254,$947.25
2024-12-23,20:29:00,21707.25,BUY,3,0.02h,Break Even,$0.75,$948.00,$326419.25,254,$948.00
2024-12-23,21:05:00,21723.25,SELL,3,0.02h,Stop Loss,$-18.00,$930.00,$326401.25,254,$930.00
2024-12-23,21:12:00,21749.5,BUY,3,0.02h,Stop Loss,$-18.00,$912.00,$326383.25,254,$912.00
2024-12-23,21:19:00,21741.75,SELL,3,0.02h,Stop Loss,$12.00,$924.00,$326395.25,254,$924.00
2024-12-23,21:20:00,21744.5,BUY,3,0.02h,Stop Loss,$-18.00,$906.00,$326377.25,254,$906.00
2024-12-23,21:22:00,21740.75,SELL,3,0.02h,Stop Loss,$87.00,$993.00,$326464.25,254,$993.00
2024-12-23,21:47:00,21741.5,BUY,3,0.02h,Break Even,$0.75,$993.75,$326465.00,254,$993.75
2024-12-23,21:53:00,21731.0,SELL,3,0.02h,Stop Loss,$-18.00,$975.75,$326447.00,254,$975.75
2024-12-23,21:58:00,21739.5,BUY,3,0.02h,Stop Loss,$-18.00,$957.75,$326429.00,254,$957.75
,,,,,,,,,,,
2024-12-24,12:41:00,21790.5,SELL,3,0.02h,Break Even,$0.75,$0.75,$326429.75,255,$0.75
2024-12-24,12:49:00,21797.0,BUY,3,0.02h,Break Even,$0.75,$1.50,$326430.50,255,$1.50
2024-12-24,13:03:00,21793.75,SELL,3,0.02h,Stop Loss,$-18.00,$-16.50,$326412.50,255,$-16.50
2024-12-24,13:05:00,21794.5,BUY,3,0.02h,Break Even,$0.75,$-15.75,$326413.25,255,$-15.75
2024-12-24,13:19:00,21795.0,SELL,3,0.02h,Break Even,$0.75,$-15.00,$326414.00,255,$-15.00
2024-12-24,13:20:00,21798.0,BUY,3,0.02h,Stop Loss,$-18.00,$-33.00,$326396.00,255,$-33.00
2024-12-24,14:25:00,21824.5,SELL,3,0.02h,Stop Loss,$19.50,$-13.50,$326415.50,255,$-13.50
2024-12-24,14:38:00,21843.5,BUY,3,0.02h,Stop Loss,$64.50,$51.00,$326480.00,255,$51.00
2024-12-24,16:54:00,21964.5,SELL,3,0.02h,Stop Loss,$124.50,$175.50,$326604.50,255,$175.50
2024-12-24,17:13:00,21983.75,BUY,3,0.02h,Break Even,$0.75,$176.25,$326605.25,255,$176.25
2024-12-24,17:35:00,21964.25,SELL,3,0.02h,Stop Loss,$98.25,$274.50,$326703.50,255,$274.50
2024-12-24,17:51:00,21988.25,BUY,3,0.02h,Break Even,$0.75,$275.25,$326704.25,255,$275.25
,,,,,,,,,,,
2024-12-26,12:01:00,21968.75,SELL,3,0.02h,Break Even,$0.75,$0.75,$326705.00,256,$0.75
2024-12-26,12:55:00,21956.75,BUY,3,0.02h,Stop Loss,$-18.00,$-17.25,$326687.00,256,$-17.25
2024-12-26,13:03:00,21945.5,SELL,3,0.02h,Stop Loss,$23.25,$6.00,$326710.25,256,$6.00
2024-12-26,13:08:00,21954.75,BUY,3,0.02h,Stop Loss,$-18.00,$-12.00,$326692.25,256,$-12.00
2024-12-26,13:25:00,21947.0,SELL,3,0.02h,Stop Loss,$49.50,$37.50,$326741.75,256,$37.50
2024-12-26,13:39:00,21955.0,BUY,3,0.02h,Stop Loss,$-18.00,$19.50,$326723.75,256,$19.50
2024-12-26,13:43:00,21935.25,SELL,3,0.02h,Break Even,$0.75,$20.25,$326724.50,256,$20.25
2024-12-26,13:50:00,21953.25,BUY,3,0.02h,Stop Loss,$-18.00,$2.25,$326706.50,256,$2.25
2024-12-26,13:52:00,21946.5,SELL,3,0.02h,Stop Loss,$12.00,$14.25,$326718.50,256,$14.25
2024-12-26,13:54:00,21957.25,BUY,3,0.02h,Break Even,$0.75,$15.00,$326719.25,256,$15.00
2024-12-26,14:21:00,21946.25,SELL,3,0.02h,Stop Loss,$45.75,$60.75,$326765.00,256,$60.75
2024-12-26,14:30:00,21960.75,BUY,3,0.02h,Stop Loss,$330.75,$391.50,$327095.75,256,$391.50
2024-12-26,14:50:00,21953.25,SELL,3,0.02h,Stop Loss,$300.75,$692.25,$327396.50,256,$692.25
2024-12-26,15:04:00,21965.25,BUY,3,0.02h,Stop Loss,$109.50,$801.75,$327506.00,256,$801.75
2024-12-26,15:10:00,21929.5,SELL,3,0.02h,Break Even,$0.75,$802.50,$327506.75,256,$802.50
2024-12-26,15:23:00,21974.25,BUY,3,0.02h,Stop Loss,$19.50,$822.00,$327526.25,256,$822.00
2024-12-26,16:25:00,21989.5,SELL,3,0.02h,Stop Loss,$113.25,$935.25,$327639.50,256,$935.25
2024-12-26,16:35:00,22006.25,BUY,3,0.02h,Stop Loss,$42.00,$977.25,$327681.50,256,$977.25
2024-12-26,17:28:00,22033.0,SELL,3,0.02h,Stop Loss,$87.00,$1064.25,$327768.50,256,$1064.25
2024-12-26,18:07:00,22020.25,BUY,3,0.02h,Stop Loss,$49.50,$1113.75,$327818.00,256,$1113.75
2024-12-26,18:15:00,22010.0,SELL,3,0.02h,Break Even,$0.75,$1114.50,$327818.75,256,$1114.50
2024-12-26,18:16:00,22018.5,BUY,3,0.02h,Stop Loss,$64.50,$1179.00,$327883.25,256,$1179.00
2024-12-26,18:36:00,22025.25,SELL,3,0.02h,Stop Loss,$64.50,$1243.50,$327947.75,256,$1243.50
2024-12-26,18:55:00,22027.25,BUY,3,0.02h,Stop Loss,$30.75,$1274.25,$327978.50,256,$1274.25
2024-12-26,18:58:00,22009.0,SELL,3,0.02h,Break Even,$0.75,$1275.00,$327979.25,256,$1275.00
2024-12-26,19:28:00,22014.25,BUY,3,0.02h,Stop Loss,$-18.00,$1257.00,$327961.25,256,$1257.00
2024-12-26,19:37:00,22004.25,SELL,3,0.02h,Break Even,$0.75,$1257.75,$327962.00,256,$1257.75
2024-12-26,19:39:00,22011.75,BUY,3,0.02h,Stop Loss,$57.00,$1314.75,$328019.00,256,$1314.75
2024-12-26,20:17:00,22034.5,SELL,3,0.02h,Break Even,$0.75,$1315.50,$328019.75,256,$1315.50
2024-12-26,20:23:00,22044.5,BUY,3,0.02h,Break Even,$0.75,$1316.25,$328020.50,256,$1316.25
2024-12-26,20:51:00,22039.75,SELL,3,0.02h,Stop Loss,$60.75,$1377.00,$328081.25,256,$1377.00
,,,,,,,,,,,
2024-12-27,13:55:00,21914.0,BUY,3,0.02h,Break Even,$0.75,$0.75,$328082.00,257,$0.75
2024-12-27,13:59:00,21904.25,SELL,3,0.02h,Stop Loss,$117.00,$117.75,$328199.00,257,$117.75
2024-12-27,15:43:00,21567.5,BUY,3,0.02h,Stop Loss,$308.25,$426.00,$328507.25,257,$426.00
2024-12-27,16:05:00,21555.75,SELL,3,0.02h,Stop Loss,$79.50,$505.50,$328586.75,257,$505.50
2024-12-27,16:25:00,21573.0,BUY,3,0.02h,Stop Loss,$330.75,$836.25,$328917.50,257,$836.25
2024-12-27,16:45:00,21581.75,SELL,3,0.02h,Break Even,$0.75,$837.00,$328918.25,257,$837.00
2024-12-27,17:31:00,21547.25,BUY,3,0.02h,Stop Loss,$364.50,$1201.50,$329282.75,257,$1201.50
2024-12-27,17:39:00,21511.5,SELL,3,0.02h,Stop Loss,$-18.00,$1183.50,$329264.75,257,$1183.50
2024-12-27,17:43:00,21545.75,BUY,3,0.02h,Stop Loss,$83.25,$1266.75,$329348.00,257,$1266.75
2024-12-27,19:24:00,21639.75,SELL,3,0.02h,Stop Loss,$-18.00,$1248.75,$329330.00,257,$1248.75
2024-12-27,19:35:00,21665.75,BUY,3,0.02h,Stop Loss,$165.75,$1414.50,$329495.75,257,$1414.50
2024-12-27,20:06:00,21678.25,SELL,3,0.02h,Stop Loss,$180.75,$1595.25,$329676.50,257,$1595.25
2024-12-27,20:51:00,21678.25,BUY,3,0.02h,Stop Loss,$379.50,$1974.75,$330056.00,257,$1974.75
2024-12-27,21:42:00,21716.75,SELL,3,0.02h,Break Even,$0.75,$1975.50,$330056.75,257,$1975.50
2024-12-27,21:57:00,21722.0,BUY,3,0.02h,Stop Loss,$-18.00,$1957.50,$330038.75,257,$1957.50
,,,,,,,,,,,
2024-12-30,12:00:00,21646.5,SELL,3,0.02h,Stop Loss,$15.75,$15.75,$330054.50,258,$15.75
2024-12-30,14:07:00,21410.25,BUY,3,0.02h,Break Even,$0.75,$16.50,$330055.25,258,$16.50
2024-12-30,14:25:00,21388.25,SELL,3,0.02h,Stop Loss,$27.00,$43.50,$330082.25,258,$43.50
2024-12-30,14:28:00,21405.25,BUY,3,0.02h,Stop Loss,$109.50,$153.00,$330191.75,258,$153.00
2024-12-30,14:32:00,21392.0,SELL,3,0.02h,Stop Loss,$154.50,$307.50,$330346.25,258,$307.50
2024-12-30,15:14:00,21325.75,BUY,3,0.02h,Stop Loss,$383.25,$690.75,$330729.50,258,$690.75
2024-12-30,15:19:00,21301.0,SELL,3,0.02h,Break Even,$0.75,$691.50,$330730.25,258,$691.50
2024-12-30,15:39:00,21324.0,BUY,3,0.02h,Stop Loss,$634.50,$1326.00,$331364.75,258,$1326.00
2024-12-30,17:58:00,21508.75,SELL,3,0.02h,Stop Loss,$34.50,$1360.50,$331399.25,258,$1360.50
2024-12-30,18:00:00,21552.75,BUY,3,0.02h,Break Even,$0.75,$1361.25,$331400.00,258,$1361.25
2024-12-30,18:01:00,21522.0,SELL,3,0.02h,Break Even,$0.75,$1362.00,$331400.75,258,$1362.00
2024-12-30,18:02:00,21534.25,BUY,3,0.02h,Break Even,$0.75,$1362.75,$331401.50,258,$1362.75
2024-12-30,18:03:00,21516.25,SELL,3,0.02h,Stop Loss,$-18.00,$1344.75,$331383.50,258,$1344.75
2024-12-30,18:11:00,21536.75,BUY,3,0.02h,Stop Loss,$150.75,$1495.50,$331534.25,258,$1495.50
2024-12-30,18:25:00,21511.0,SELL,3,0.02h,Break Even,$0.75,$1496.25,$331535.00,258,$1496.25
2024-12-30,18:35:00,21547.0,BUY,3,0.02h,Stop Loss,$109.50,$1605.75,$331644.50,258,$1605.75
2024-12-30,19:02:00,21536.25,SELL,3,0.02h,Stop Loss,$15.75,$1621.50,$331660.25,258,$1621.50
2024-12-30,19:32:00,21535.25,BUY,3,0.02h,Stop Loss,$-18.00,$1603.50,$331642.25,258,$1603.50
2024-12-30,20:06:00,21515.5,SELL,3,0.02h,Stop Loss,$173.25,$1776.75,$331815.50,258,$1776.75
2024-12-30,20:15:00,21527.25,BUY,3,0.02h,Break Even,$0.75,$1777.50,$331816.25,258,$1777.50
2024-12-30,20:26:00,21506.75,SELL,3,0.02h,Stop Loss,$98.25,$1875.75,$331914.50,258,$1875.75
2024-12-30,20:53:00,21493.25,BUY,3,0.02h,Stop Loss,$-18.00,$1857.75,$331896.50,258,$1857.75
2024-12-30,20:55:00,21466.0,SELL,3,0.02h,Stop Loss,$72.00,$1929.75,$331968.50,258,$1929.75
2024-12-30,21:46:00,21388.0,BUY,3,0.02h,Stop Loss,$15.75,$1945.50,$331984.25,258,$1945.50
2024-12-30,22:00:00,21389.0,SELL,3,14.00h,Stop Loss,$-18.00,$1927.50,$331966.25,258,$1927.50
,,,,,,,,,,,
2024-12-31,12:00:00,21501.75,BUY,3,0.02h,Stop Loss,$60.75,$60.75,$332027.00,259,$60.75
2024-12-31,12:39:00,21500.25,SELL,3,0.02h,Break Even,$0.75,$61.50,$332027.75,259,$61.50
2024-12-31,12:45:00,21507.5,BUY,3,0.02h,Stop Loss,$-18.00,$43.50,$332009.75,259,$43.50
2024-12-31,12:46:00,21502.25,SELL,3,0.02h,Stop Loss,$60.75,$104.25,$332070.50,259,$104.25
2024-12-31,13:16:00,21482.0,BUY,3,0.02h,Stop Loss,$-18.00,$86.25,$332052.50,259,$86.25
2024-12-31,13:22:00,21459.0,SELL,3,0.02h,Stop Loss,$12.00,$98.25,$332064.50,259,$98.25
2024-12-31,13:25:00,21475.0,BUY,3,0.02h,Stop Loss,$23.25,$121.50,$332087.75,259,$121.50
2024-12-31,13:27:00,21467.0,SELL,3,0.02h,Stop Loss,$-18.00,$103.50,$332069.75,259,$103.50
2024-12-31,13:28:00,21471.75,BUY,3,0.02h,Stop Loss,$34.50,$138.00,$332104.25,259,$138.00
2024-12-31,13:49:00,21469.5,SELL,3,0.02h,Stop Loss,$45.75,$183.75,$332150.00,259,$183.75
2024-12-31,14:12:00,21471.25,BUY,3,0.02h,Stop Loss,$38.25,$222.00,$332188.25,259,$222.00
2024-12-31,14:29:00,21464.25,SELL,3,0.02h,Stop Loss,$102.00,$324.00,$332290.25,259,$324.00
2024-12-31,15:01:00,21432.25,BUY,3,0.02h,Stop Loss,$72.00,$396.00,$332362.25,259,$396.00
2024-12-31,15:07:00,21402.0,SELL,3,0.02h,Stop Loss,$608.25,$1004.25,$332970.50,259,$1004.25
2024-12-31,15:21:00,21409.25,BUY,3,0.02h,Stop Loss,$199.50,$1203.75,$333170.00,259,$1203.75
2024-12-31,15:35:00,21386.5,SELL,3,0.02h,Stop Loss,$49.50,$1253.25,$333219.50,259,$1253.25
2024-12-31,16:44:00,21330.25,BUY,3,0.02h,Stop Loss,$15.75,$1269.00,$333235.25,259,$1269.00
2024-12-31,17:02:00,21314.25,SELL,3,0.02h,Stop Loss,$162.00,$1431.00,$333397.25,259,$1431.00
2024-12-31,17:09:00,21338.75,BUY,3,0.02h,Stop Loss,$34.50,$1465.50,$333431.75,259,$1465.50
2024-12-31,17:13:00,21308.5,SELL,3,0.02h,Stop Loss,$34.50,$1500.00,$333466.25,259,$1500.00
2024-12-31,17:21:00,21329.0,BUY,3,0.02h,Stop Loss,$-18.00,$1482.00,$333448.25,259,$1482.00
2024-12-31,17:22:00,21301.0,SELL,3,0.02h,Stop Loss,$15.75,$1497.75,$333464.00,259,$1497.75
2024-12-31,17:56:00,21271.5,BUY,3,0.02h,Stop Loss,$195.75,$1693.50,$333659.75,259,$1693.50
2024-12-31,18:20:00,21269.0,SELL,3,0.02h,Stop Loss,$42.00,$1735.50,$333701.75,259,$1735.50
2024-12-31,18:50:00,21242.25,BUY,3,0.02h,Stop Loss,$312.00,$2047.50,$334013.75,259,$2047.50
2024-12-31,18:55:00,21233.0,SELL,3,0.02h,Break Even,$0.75,$2048.25,$334014.50,259,$2048.25
2024-12-31,19:09:00,21249.5,BUY,3,0.02h,Stop Loss,$64.50,$2112.75,$334079.00,259,$2112.75
2024-12-31,19:21:00,21215.0,SELL,3,0.02h,Stop Loss,$135.75,$2248.50,$334214.75,259,$2248.50
2024-12-31,19:51:00,21213.25,BUY,3,0.02h,Stop Loss,$147.00,$2395.50,$334361.75,259,$2395.50
2024-12-31,20:14:00,21215.0,SELL,3,0.02h,Stop Loss,$-18.00,$2377.50,$334343.75,259,$2377.50
2024-12-31,20:22:00,21271.25,BUY,3,0.02h,Stop Loss,$210.75,$2588.25,$334554.50,259,$2588.25
2024-12-31,20:45:00,21267.0,SELL,3,0.02h,Stop Loss,$252.00,$2840.25,$334806.50,259,$2840.25
2024-12-31,21:14:00,21241.25,BUY,3,0.02h,Break Even,$0.75,$2841.00,$334807.25,259,$2841.00
2024-12-31,21:16:00,21231.5,SELL,3,0.02h,Stop Loss,$-18.00,$2823.00,$334789.25,259,$2823.00
2024-12-31,21:19:00,21245.75,BUY,3,0.02h,Stop Loss,$-18.00,$2805.00,$334771.25,259,$2805.00
2024-12-31,21:25:00,21236.25,SELL,3,0.02h,Break Even,$0.75,$2805.75,$334772.00,259,$2805.75
2024-12-31,21:38:00,21244.0,BUY,3,0.02h,Stop Loss,$19.50,$2825.25,$334791.50,259,$2825.25
2024-12-31,21:53:00,21237.5,SELL,3,0.02h,Break Even,$0.75,$2826.00,$334792.25,259,$2826.00
2024-12-31,21:54:00,21239.5,BUY,3,0.02h,Break Even,$0.75,$2826.75,$334793.00,259,$2826.75
2024-12-31,21:56:00,21233.0,SELL,3,0.02h,Stop Loss,$-18.00,$2808.75,$334775.00,259,$2808.75
,,,,,,,,,,,
2025-01-02,12:00:00,21467.5,BUY,3,0.02h,Break Even,$0.75,$0.75,$334775.75,260,$0.75
2025-01-02,12:43:00,21452.5,SELL,3,0.02h,Stop Loss,$60.75,$61.50,$334836.50,260,$61.50
2025-01-02,13:35:00,21442.5,BUY,3,0.02h,Break Even,$0.75,$62.25,$334837.25,260,$62.25
2025-01-02,13:51:00,21420.0,SELL,3,0.02h,Stop Loss,$34.50,$96.75,$334871.75,260,$96.75
2025-01-02,14:52:00,21309.5,BUY,3,0.02h,Stop Loss,$330.75,$427.50,$335202.50,260,$427.50
2025-01-02,15:21:00,21324.0,SELL,3,0.02h,Stop Loss,$484.50,$912.00,$335687.00,260,$912.00
2025-01-02,15:52:00,21312.0,BUY,3,0.02h,Stop Loss,$233.25,$1145.25,$335920.25,260,$1145.25
2025-01-02,16:03:00,21240.0,SELL,3,0.02h,Stop Loss,$327.00,$1472.25,$336247.25,260,$1472.25
2025-01-02,16:20:00,21271.0,BUY,3,0.02h,Stop Loss,$42.00,$1514.25,$336289.25,260,$1514.25
2025-01-02,16:23:00,21231.25,SELL,3,0.02h,Break Even,$0.75,$1515.00,$336290.00,260,$1515.00
2025-01-02,16:24:00,21264.25,BUY,3,0.02h,Stop Loss,$510.75,$2025.75,$336800.75,260,$2025.75
2025-01-02,17:08:00,21298.25,SELL,3,0.02h,Stop Loss,$237.00,$2262.75,$337037.75,260,$2262.75
2025-01-02,17:14:00,21339.0,BUY,3,0.02h,Break Even,$0.75,$2263.50,$337038.50,260,$2263.50
2025-01-02,17:18:00,21303.5,SELL,3,0.02h,Stop Loss,$117.00,$2380.50,$337155.50,260,$2380.50
2025-01-02,18:24:00,21052.25,BUY,3,0.02h,Break Even,$0.75,$2381.25,$337156.25,260,$2381.25
2025-01-02,18:27:00,21031.5,SELL,3,0.02h,Break Even,$0.75,$2382.00,$337157.00,260,$2382.00
2025-01-02,18:28:00,21052.25,BUY,3,0.02h,Stop Loss,$34.50,$2416.50,$337191.50,260,$2416.50
2025-01-02,18:32:00,20999.75,SELL,3,0.02h,Stop Loss,$87.00,$2503.50,$337278.50,260,$2503.50
2025-01-02,18:45:00,21064.25,BUY,3,0.02h,Stop Loss,$-18.00,$2485.50,$337260.50,260,$2485.50
2025-01-02,18:51:00,21013.0,SELL,3,0.02h,Stop Loss,$27.00,$2512.50,$337287.50,260,$2512.50
2025-01-02,19:00:00,21048.0,BUY,3,0.02h,Stop Loss,$49.50,$2562.00,$337337.00,260,$2562.00
2025-01-02,19:47:00,21068.75,SELL,3,0.02h,Stop Loss,$19.50,$2581.50,$337356.50,260,$2581.50
2025-01-02,19:49:00,21130.25,BUY,3,0.02h,Stop Loss,$124.50,$2706.00,$337481.00,260,$2706.00
2025-01-02,20:00:00,21063.25,SELL,3,0.02h,Stop Loss,$-18.00,$2688.00,$337463.00,260,$2688.00
2025-01-02,20:05:00,21128.5,BUY,3,0.02h,Stop Loss,$-18.00,$2670.00,$337445.00,260,$2670.00
2025-01-02,20:38:00,21134.5,SELL,3,0.02h,Stop Loss,$38.25,$2708.25,$337483.25,260,$2708.25
2025-01-02,20:48:00,21161.25,BUY,3,0.02h,Stop Loss,$75.75,$2784.00,$337559.00,260,$2784.00
2025-01-02,21:40:00,21187.5,SELL,3,0.02h,Break Even,$0.75,$2784.75,$337559.75,260,$2784.75
,,,,,,,,,,,
2025-01-03,12:00:00,21247.5,BUY,3,0.02h,Stop Loss,$-18.00,$-18.00,$337541.75,261,$-18.00
2025-01-03,12:21:00,21212.25,SELL,3,0.02h,Break Even,$0.75,$-17.25,$337542.50,261,$-17.25
2025-01-03,12:23:00,21223.25,BUY,3,0.02h,Break Even,$0.75,$-16.50,$337543.25,261,$-16.50
2025-01-03,13:22:00,21249.5,SELL,3,0.02h,Stop Loss,$-18.00,$-34.50,$337525.25,261,$-34.50
2025-01-03,13:25:00,21258.5,BUY,3,0.02h,Stop Loss,$-18.00,$-52.50,$337507.25,261,$-52.50
2025-01-03,13:47:00,21256.5,SELL,3,0.02h,Stop Loss,$124.50,$72.00,$337631.75,261,$72.00
2025-01-03,14:09:00,21256.75,BUY,3,0.02h,Stop Loss,$-18.00,$54.00,$337613.75,261,$54.00
2025-01-03,15:15:00,21349.0,SELL,3,0.02h,Stop Loss,$177.00,$231.00,$337790.75,261,$231.00
2025-01-03,15:36:00,21366.0,BUY,3,0.02h,Stop Loss,$233.25,$464.25,$338024.00,261,$464.25
2025-01-03,16:09:00,21351.0,SELL,3,0.02h,Stop Loss,$42.00,$506.25,$338066.00,261,$506.25
2025-01-03,16:20:00,21380.0,BUY,3,0.02h,Stop Loss,$165.75,$672.00,$338231.75,261,$672.00
2025-01-03,17:14:00,21469.75,SELL,3,0.02h,Stop Loss,$218.25,$890.25,$338450.00,261,$890.25
2025-01-03,17:52:00,21464.75,BUY,3,0.02h,Break Even,$0.75,$891.00,$338450.75,261,$891.00
2025-01-03,19:52:00,21537.5,SELL,3,0.02h,Stop Loss,$49.50,$940.50,$338500.25,261,$940.50
2025-01-03,20:59:00,21511.0,BUY,3,0.02h,Stop Loss,$195.75,$1136.25,$338696.00,261,$1136.25
2025-01-03,21:03:00,21493.5,SELL,3,0.02h,Break Even,$0.75,$1137.00,$338696.75,261,$1137.00
2025-01-03,21:39:00,21489.75,BUY,3,0.02h,Stop Loss,$-18.00,$1119.00,$338678.75,261,$1119.00
2025-01-03,21:46:00,21485.25,SELL,3,0.02h,Break Even,$0.75,$1119.75,$338679.50,261,$1119.75
2025-01-03,21:59:00,21489.25,BUY,3,0.02h,Break Even,$0.75,$1120.50,$338680.25,261,$1120.50
,,,,,,,,,,,
2025-01-06,13:02:00,21729.75,SELL,3,0.02h,Stop Loss,$-18.00,$-18.00,$338662.25,262,$-18.00
2025-01-06,13:29:00,21735.75,BUY,3,0.02h,Stop Loss,$49.50,$31.50,$338711.75,262,$31.50
2025-01-06,13:41:00,21724.25,SELL,3,0.02h,Stop Loss,$124.50,$156.00,$338836.25,262,$156.00
2025-01-06,13:50:00,21734.25,BUY,3,0.02h,Stop Loss,$-18.00,$138.00,$338818.25,262,$138.00
2025-01-06,14:08:00,21734.0,SELL,3,0.02h,Break Even,$0.75,$138.75,$338819.00,262,$138.75
2025-01-06,14:30:00,21732.0,BUY,3,0.02h,Stop Loss,$514.50,$653.25,$339333.50,262,$653.25
2025-01-06,16:19:00,21867.75,SELL,3,0.02h,Stop Loss,$-18.00,$635.25,$339315.50,262,$635.25
2025-01-06,16:21:00,21888.75,BUY,3,0.02h,Break Even,$0.75,$636.00,$339316.25,262,$636.00
2025-01-06,16:22:00,21874.5,SELL,3,0.02h,Break Even,$0.75,$636.75,$339317.00,262,$636.75
2025-01-06,16:29:00,21889.25,BUY,3,0.02h,Break Even,$0.75,$637.50,$339317.75,262,$637.50
2025-01-06,16:36:00,21870.5,SELL,3,0.02h,Stop Loss,$57.00,$694.50,$339374.75,262,$694.50
2025-01-06,18:26:00,21783.5,BUY,3,0.02h,Break Even,$0.75,$695.25,$339375.50,262,$695.25
2025-01-06,18:33:00,21765.0,SELL,3,0.02h,Stop Loss,$12.00,$707.25,$339387.50,262,$707.25
2025-01-06,19:26:00,21715.25,BUY,3,0.02h,Stop Loss,$75.75,$783.00,$339463.25,262,$783.00
2025-01-06,19:32:00,21702.0,SELL,3,0.02h,Stop Loss,$94.50,$877.50,$339557.75,262,$877.50
2025-01-06,19:49:00,21716.25,BUY,3,0.02h,Break Even,$0.75,$878.25,$339558.50,262,$878.25
2025-01-06,19:52:00,21699.0,SELL,3,0.02h,Stop Loss,$105.75,$984.00,$339664.25,262,$984.00
2025-01-06,20:14:00,21698.5,BUY,3,0.02h,Stop Loss,$-18.00,$966.00,$339646.25,262,$966.00
2025-01-06,20:47:00,21716.5,SELL,3,0.02h,Stop Loss,$225.75,$1191.75,$339872.00,262,$1191.75
2025-01-06,20:54:00,21733.5,BUY,3,0.02h,Stop Loss,$109.50,$1301.25,$339981.50,262,$1301.25
,,,,,,,,,,,
2025-01-07,12:00:00,21736.0,SELL,3,0.02h,Stop Loss,$158.25,$158.25,$340139.75,263,$158.25
2025-01-07,12:35:00,21745.25,BUY,3,0.02h,Stop Loss,$12.00,$170.25,$340151.75,263,$170.25
2025-01-07,12:59:00,21740.75,SELL,3,0.02h,Break Even,$0.75,$171.00,$340152.50,263,$171.00
2025-01-07,13:16:00,21752.75,BUY,3,0.02h,Break Even,$0.75,$171.75,$340153.25,263,$171.75
2025-01-07,13:27:00,21738.5,SELL,3,0.02h,Stop Loss,$-18.00,$153.75,$340135.25,263,$153.75
2025-01-07,13:35:00,21750.75,BUY,3,0.02h,Stop Loss,$-18.00,$135.75,$340117.25,263,$135.75
2025-01-07,14:23:00,21776.5,SELL,3,0.02h,Stop Loss,$-18.00,$117.75,$340099.25,263,$117.75
2025-01-07,14:28:00,21785.0,BUY,3,0.02h,Stop Loss,$68.25,$186.00,$340167.50,263,$186.00
2025-01-07,14:34:00,21764.25,SELL,3,0.02h,Stop Loss,$214.50,$400.50,$340382.00,263,$400.50
2025-01-07,14:49:00,21775.5,BUY,3,0.02h,Break Even,$0.75,$401.25,$340382.75,263,$401.25
2025-01-07,14:57:00,21734.5,SELL,3,0.02h,Stop Loss,$274.50,$675.75,$340657.25,263,$675.75
2025-01-07,15:29:00,21611.0,BUY,3,0.02h,Stop Loss,$27.00,$702.75,$340684.25,263,$702.75
2025-01-07,15:30:00,21577.5,SELL,3,0.02h,Stop Loss,$439.50,$1142.25,$341123.75,263,$1142.25
2025-01-07,15:58:00,21521.75,BUY,3,0.02h,Stop Loss,$229.50,$1371.75,$341353.25,263,$1371.75
2025-01-07,16:36:00,21499.75,SELL,3,0.02h,Stop Loss,$319.50,$1691.25,$341672.75,263,$1691.25
2025-01-07,16:41:00,21550.75,BUY,3,0.02h,Stop Loss,$12.00,$1703.25,$341684.75,263,$1703.25
2025-01-07,16:42:00,21516.75,SELL,3,0.02h,Stop Loss,$124.50,$1827.75,$341809.25,263,$1827.75
2025-01-07,17:20:00,21462.5,BUY,3,0.02h,Break Even,$0.75,$1828.50,$341810.00,263,$1828.50
2025-01-07,17:23:00,21437.25,SELL,3,0.02h,Stop Loss,$53.25,$1881.75,$341863.25,263,$1881.75
2025-01-07,17:35:00,21454.0,BUY,3,0.02h,Break Even,$0.75,$1882.50,$341864.00,263,$1882.50
2025-01-07,17:36:00,21442.5,SELL,3,0.02h,Stop Loss,$23.25,$1905.75,$341887.25,263,$1905.75
2025-01-07,17:37:00,21445.0,BUY,3,0.02h,Stop Loss,$38.25,$1944.00,$341925.50,263,$1944.00
2025-01-07,17:38:00,21431.5,SELL,3,0.02h,Stop Loss,$154.50,$2098.50,$342080.00,263,$2098.50
2025-01-07,18:00:00,21445.0,BUY,3,0.02h,Stop Loss,$87.00,$2185.50,$342167.00,263,$2185.50
2025-01-07,18:37:00,21475.25,SELL,3,0.02h,Stop Loss,$162.00,$2347.50,$342329.00,263,$2347.50
2025-01-07,19:09:00,21464.5,BUY,3,0.02h,Break Even,$0.75,$2348.25,$342329.75,263,$2348.25
2025-01-07,19:20:00,21449.5,SELL,3,0.02h,Stop Loss,$72.00,$2420.25,$342401.75,263,$2420.25
2025-01-07,20:49:00,21340.0,BUY,3,0.02h,Stop Loss,$135.75,$2556.00,$342537.50,263,$2556.00
2025-01-07,21:38:00,21379.0,SELL,3,0.02h,Break Even,$0.75,$2556.75,$342538.25,263,$2556.75
2025-01-07,21:50:00,21380.5,BUY,3,0.02h,Stop Loss,$-18.00,$2538.75,$342520.25,263,$2538.75
2025-01-07,21:53:00,21371.75,SELL,3,0.02h,Break Even,$0.75,$2539.50,$342521.00,263,$2539.50
,,,,,,,,,,,
2025-01-08,12:43:00,21281.0,BUY,3,0.02h,Break Even,$0.75,$0.75,$342521.75,264,$0.75
2025-01-08,12:50:00,21263.75,SELL,3,0.02h,Stop Loss,$87.00,$87.75,$342608.75,264,$87.75
2025-01-08,13:01:00,21311.25,BUY,3,0.02h,Stop Loss,$608.25,$696.00,$343217.00,264,$696.00
2025-01-08,13:39:00,21327.75,SELL,3,0.02h,Stop Loss,$49.50,$745.50,$343266.50,264,$745.50
2025-01-08,13:51:00,21349.5,BUY,3,0.02h,Stop Loss,$-18.00,$727.50,$343248.50,264,$727.50
2025-01-08,14:14:00,21349.5,SELL,3,0.02h,Stop Loss,$135.75,$863.25,$343384.25,264,$863.25
2025-01-08,14:29:00,21361.25,BUY,3,0.02h,Stop Loss,$42.00,$905.25,$343426.25,264,$905.25
2025-01-08,14:31:00,21334.0,SELL,3,0.02h,Stop Loss,$210.75,$1116.00,$343637.00,264,$1116.00
2025-01-08,14:32:00,21363.25,BUY,3,0.02h,Stop Loss,$68.25,$1184.25,$343705.25,264,$1184.25
2025-01-08,14:34:00,21326.0,SELL,3,0.02h,Stop Loss,$83.25,$1267.50,$343788.50,264,$1267.50
2025-01-08,14:35:00,21371.75,BUY,3,0.02h,Stop Loss,$147.00,$1414.50,$343935.50,264,$1414.50
2025-01-08,14:39:00,21324.25,SELL,3,0.02h,Stop Loss,$375.75,$1790.25,$344311.25,264,$1790.25
2025-01-08,14:50:00,21368.25,BUY,3,0.02h,Stop Loss,$154.50,$1944.75,$344465.75,264,$1944.75
2025-01-08,14:54:00,21295.5,SELL,3,0.02h,Stop Loss,$109.50,$2054.25,$344575.25,264,$2054.25
2025-01-08,15:01:00,21369.0,BUY,3,0.02h,Stop Loss,$105.75,$2160.00,$344681.00,264,$2160.00
2025-01-08,15:11:00,21308.5,SELL,3,0.02h,Stop Loss,$124.50,$2284.50,$344805.50,264,$2284.50
2025-01-08,15:36:00,21332.75,BUY,3,0.02h,Stop Loss,$289.50,$2574.00,$345095.00,264,$2574.00
2025-01-08,15:48:00,21299.25,SELL,3,0.02h,Break Even,$0.75,$2574.75,$345095.75,264,$2574.75
2025-01-08,15:50:00,21317.25,BUY,3,0.02h,Stop Loss,$214.50,$2789.25,$345310.25,264,$2789.25
2025-01-08,16:06:00,21315.25,SELL,3,0.02h,Stop Loss,$308.25,$3097.50,$345618.50,264,$3097.50
2025-01-08,16:15:00,21335.5,BUY,3,0.02h,Stop Loss,$30.75,$3128.25,$345649.25,264,$3128.25
2025-01-08,17:02:00,21382.0,SELL,3,0.02h,Stop Loss,$342.00,$3470.25,$345991.25,264,$3470.25
2025-01-08,17:53:00,21261.0,BUY,3,0.02h,Stop Loss,$-18.00,$3452.25,$345973.25,264,$3452.25
2025-01-08,18:48:00,21346.5,SELL,3,0.02h,Break Even,$0.75,$3453.00,$345974.00,264,$3453.00
2025-01-08,19:09:00,21380.75,BUY,3,0.02h,Stop Loss,$147.00,$3600.00,$346121.00,264,$3600.00
2025-01-08,19:37:00,21346.0,SELL,3,0.02h,Break Even,$0.75,$3600.75,$346121.75,264,$3600.75
2025-01-08,20:05:00,21353.0,BUY,3,0.02h,Break Even,$0.75,$3601.50,$346122.50,264,$3601.50
2025-01-08,20:07:00,21337.25,SELL,3,0.02h,Stop Loss,$109.50,$3711.00,$346232.00,264,$3711.00
2025-01-08,20:21:00,21343.25,BUY,3,0.02h,Break Even,$0.75,$3711.75,$346232.75,264,$3711.75
2025-01-08,20:37:00,21332.75,SELL,3,0.02h,Stop Loss,$57.00,$3768.75,$346289.75,264,$3768.75
2025-01-08,20:46:00,21346.25,BUY,3,0.02h,Break Even,$0.75,$3769.50,$346290.50,264,$3769.50
2025-01-08,21:14:00,21347.0,SELL,3,0.02h,Stop Loss,$-18.00,$3751.50,$346272.50,264,$3751.50
2025-01-08,21:28:00,21360.75,BUY,3,0.02h,Break Even,$0.75,$3752.25,$346273.25,264,$3752.25
2025-01-08,21:35:00,21336.5,SELL,3,0.02h,Stop Loss,$364.50,$4116.75,$346637.75,264,$4116.75
,,,,,,,,,,,
2025-01-09,12:50:00,21305.25,BUY,3,0.02h,Stop Loss,$19.50,$19.50,$346657.25,265,$19.50
2025-01-09,13:25:00,21309.0,SELL,3,0.02h,Break Even,$0.75,$20.25,$346658.00,265,$20.25
2025-01-09,13:28:00,21322.0,BUY,3,0.02h,Break Even,$0.75,$21.00,$346658.75,265,$21.00
2025-01-09,13:31:00,21311.5,SELL,3,0.02h,Break Even,$0.75,$21.75,$346659.50,265,$21.75
2025-01-09,13:36:00,21327.5,BUY,3,0.02h,Stop Loss,$34.50,$56.25,$346694.00,265,$56.25
2025-01-09,13:50:00,21319.5,SELL,3,0.02h,Stop Loss,$-18.00,$38.25,$346676.00,265,$38.25
2025-01-09,14:22:00,21294.5,BUY,3,0.02h,Break Even,$0.75,$39.00,$346676.75,265,$39.00
,,,,,,,,,,,
2025-01-10,12:07:00,21282.5,SELL,3,0.02h,Break Even,$0.75,$0.75,$346677.50,266,$0.75
2025-01-10,12:26:00,21291.75,BUY,3,0.02h,Break Even,$0.75,$1.50,$346678.25,266,$1.50
2025-01-10,12:29:00,21281.5,SELL,3,0.02h,Stop Loss,$60.75,$62.25,$346739.00,266,$62.25
2025-01-10,12:33:00,21293.25,BUY,3,0.02h,Stop Loss,$83.25,$145.50,$346822.25,266,$145.50
2025-01-10,13:12:00,21300.0,SELL,3,0.02h,Stop Loss,$53.25,$198.75,$346875.50,266,$198.75
2025-01-10,14:06:00,21146.25,BUY,3,0.02h,Stop Loss,$263.25,$462.00,$347138.75,266,$462.00
2025-01-10,14:32:00,21141.75,SELL,3,0.02h,Stop Loss,$117.00,$579.00,$347255.75,266,$579.00
2025-01-10,15:24:00,20987.0,BUY,3,0.02h,Stop Loss,$203.25,$782.25,$347459.00,266,$782.25
2025-01-10,15:56:00,21014.0,SELL,3,0.02h,Stop Loss,$225.75,$1008.00,$347684.75,266,$1008.00
2025-01-10,16:45:00,20968.75,BUY,3,0.02h,Stop Loss,$158.25,$1166.25,$347843.00,266,$1166.25
2025-01-10,16:57:00,20924.25,SELL,3,0.02h,Stop Loss,$72.00,$1238.25,$347915.00,266,$1238.25
2025-01-10,17:20:00,20929.25,BUY,3,0.02h,Stop Loss,$68.25,$1306.50,$347983.25,266,$1306.50
2025-01-10,17:24:00,20903.5,SELL,3,0.02h,Break Even,$0.75,$1307.25,$347984.00,266,$1307.25
2025-01-10,17:25:00,20918.5,BUY,3,0.02h,Stop Loss,$222.00,$1529.25,$348206.00,266,$1529.25
2025-01-10,19:06:00,21091.75,SELL,3,0.02h,Stop Loss,$79.50,$1608.75,$348285.50,266,$1608.75
2025-01-10,19:30:00,21096.0,BUY,3,0.02h,Break Even,$0.75,$1609.50,$348286.25,266,$1609.50
2025-01-10,19:31:00,21078.5,SELL,3,0.02h,Stop Loss,$207.00,$1816.50,$348493.25,266,$1816.50
2025-01-10,19:56:00,21092.25,BUY,3,0.02h,Break Even,$0.75,$1817.25,$348494.00,266,$1817.25
2025-01-10,20:12:00,21070.5,SELL,3,0.02h,Stop Loss,$203.25,$2020.50,$348697.25,266,$2020.50
2025-01-10,20:53:00,21029.75,BUY,3,0.02h,Break Even,$0.75,$2021.25,$348698.00,266,$2021.25
2025-01-10,21:07:00,21007.75,SELL,3,0.02h,Stop Loss,$45.75,$2067.00,$348743.75,266,$2067.00
,,,,,,,,,,,
2025-01-13,12:34:00,20791.0,BUY,3,0.02h,Stop Loss,$64.50,$64.50,$348808.25,267,$64.50
2025-01-13,13:03:00,20810.25,SELL,3,0.02h,Break Even,$0.75,$65.25,$348809.00,267,$65.25
2025-01-13,13:19:00,20820.5,BUY,3,0.02h,Break Even,$0.75,$66.00,$348809.75,267,$66.00
2025-01-13,13:51:00,20818.25,SELL,3,0.02h,Break Even,$0.75,$66.75,$348810.50,267,$66.75
2025-01-13,14:52:00,20774.25,BUY,3,0.02h,Stop Loss,$27.00,$93.75,$348837.50,267,$93.75
2025-01-13,15:15:00,20772.75,SELL,3,0.02h,Stop Loss,$218.25,$312.00,$349055.75,267,$312.00
2025-01-13,15:38:00,20800.25,BUY,3,0.02h,Stop Loss,$207.00,$519.00,$349262.75,267,$519.00
2025-01-13,15:59:00,20799.5,SELL,3,0.02h,Stop Loss,$30.75,$549.75,$349293.50,267,$549.75
2025-01-13,16:36:00,20802.5,BUY,3,0.02h,Stop Loss,$45.75,$595.50,$349339.25,267,$595.50
2025-01-13,16:56:00,20757.25,SELL,3,0.02h,Stop Loss,$124.50,$720.00,$349463.75,267,$720.00
2025-01-13,17:11:00,20788.0,BUY,3,0.02h,Stop Loss,$147.00,$867.00,$349610.75,267,$867.00
2025-01-13,17:44:00,20823.5,SELL,3,0.02h,Stop Loss,$42.00,$909.00,$349652.75,267,$909.00
2025-01-13,17:48:00,20842.5,BUY,3,0.02h,Stop Loss,$72.00,$981.00,$349724.75,267,$981.00
2025-01-13,18:21:00,20866.0,SELL,3,0.02h,Stop Loss,$42.00,$1023.00,$349766.75,267,$1023.00
2025-01-13,18:30:00,20892.25,BUY,3,0.02h,Stop Loss,$188.25,$1211.25,$349955.00,267,$1211.25
2025-01-13,18:45:00,20868.25,SELL,3,0.02h,Break Even,$0.75,$1212.00,$349955.75,267,$1212.00
2025-01-13,18:48:00,20895.0,BUY,3,0.02h,Stop Loss,$19.50,$1231.50,$349975.25,267,$1231.50
2025-01-13,18:57:00,20882.25,SELL,3,0.02h,Stop Loss,$-18.00,$1213.50,$349957.25,267,$1213.50
2025-01-13,19:00:00,20892.25,BUY,3,0.02h,Stop Loss,$19.50,$1233.00,$349976.75,267,$1233.00
2025-01-13,19:04:00,20877.25,SELL,3,0.02h,Break Even,$0.75,$1233.75,$349977.50,267,$1233.75
2025-01-13,19:29:00,20886.25,BUY,3,0.02h,Stop Loss,$83.25,$1317.00,$350060.75,267,$1317.00
2025-01-13,19:52:00,20881.25,SELL,3,0.02h,Stop Loss,$135.75,$1452.75,$350196.50,267,$1452.75
2025-01-13,19:57:00,20909.75,BUY,3,0.02h,Stop Loss,$-18.00,$1434.75,$350178.50,267,$1434.75
2025-01-13,20:05:00,20888.25,SELL,3,0.02h,Break Even,$0.75,$1435.50,$350179.25,267,$1435.50
2025-01-13,20:06:00,20898.75,BUY,3,0.02h,Stop Loss,$34.50,$1470.00,$350213.75,267,$1470.00
2025-01-13,20:15:00,20893.0,SELL,3,0.02h,Stop Loss,$30.75,$1500.75,$350244.50,267,$1500.75
2025-01-13,20:16:00,20905.0,BUY,3,0.02h,Stop Loss,$23.25,$1524.00,$350267.75,267,$1524.00
2025-01-13,20:25:00,20879.5,SELL,3,0.02h,Stop Loss,$19.50,$1543.50,$350287.25,267,$1543.50
2025-01-13,20:38:00,20902.5,BUY,3,0.02h,Stop Loss,$15.75,$1559.25,$350303.00,267,$1559.25
2025-01-13,20:40:00,20883.5,SELL,3,0.02h,Stop Loss,$-18.00,$1541.25,$350285.00,267,$1541.25
2025-01-13,20:43:00,20897.75,BUY,3,0.02h,Break Even,$0.75,$1542.00,$350285.75,267,$1542.00
2025-01-13,21:56:00,20979.25,SELL,3,0.02h,Stop Loss,$-18.00,$1524.00,$350267.75,267,$1524.00
2025-01-13,21:57:00,20983.0,BUY,3,0.02h,Break Even,$0.75,$1524.75,$350268.50,267,$1524.75
,,,,,,,,,,,
2025-01-14,12:18:00,21011.5,SELL,3,0.02h,Stop Loss,$12.00,$12.00,$350280.50,268,$12.00
2025-01-14,12:33:00,21006.75,BUY,3,0.02h,Stop Loss,$83.25,$95.25,$350363.75,268,$95.25
2025-01-14,12:53:00,21002.5,SELL,3,0.02h,Break Even,$0.75,$96.00,$350364.50,268,$96.00
2025-01-14,13:31:00,21116.75,BUY,3,0.02h,Stop Loss,$285.75,$381.75,$350650.25,268,$381.75
2025-01-14,14:00:00,21057.0,SELL,3,0.02h,Stop Loss,$27.00,$408.75,$350677.25,268,$408.75
2025-01-14,14:19:00,21071.0,BUY,3,0.02h,Stop Loss,$90.75,$499.50,$350768.00,268,$499.50
2025-01-14,14:32:00,21023.25,SELL,3,0.02h,Stop Loss,$30.75,$530.25,$350798.75,268,$530.25
2025-01-14,14:36:00,21087.25,BUY,3,0.02h,Stop Loss,$165.75,$696.00,$350964.50,268,$696.00
2025-01-14,14:50:00,21075.25,SELL,3,0.02h,Stop Loss,$360.75,$1056.75,$351325.25,268,$1056.75
2025-01-14,15:10:00,21065.75,BUY,3,0.02h,Break Even,$0.75,$1057.50,$351326.00,268,$1057.50
2025-01-14,15:25:00,21040.5,SELL,3,0.02h,Stop Loss,$-18.00,$1039.50,$351308.00,268,$1039.50
2025-01-14,16:26:00,20933.0,BUY,3,0.02h,Stop Loss,$154.50,$1194.00,$351462.50,268,$1194.00
2025-01-14,16:33:00,20916.75,SELL,3,0.02h,Stop Loss,$38.25,$1232.25,$351500.75,268,$1232.25
2025-01-14,17:12:00,20869.0,BUY,3,0.02h,Break Even,$0.75,$1233.00,$351501.50,268,$1233.00
2025-01-14,17:23:00,20833.25,SELL,3,0.02h,Break Even,$0.75,$1233.75,$351502.25,268,$1233.75
2025-01-14,17:44:00,20871.25,BUY,3,0.02h,Stop Loss,$23.25,$1257.00,$351525.50,268,$1257.00
2025-01-14,19:30:00,20981.75,SELL,3,0.02h,Stop Loss,$49.50,$1306.50,$351575.00,268,$1306.50
2025-01-14,19:37:00,21001.75,BUY,3,0.02h,Stop Loss,$-18.00,$1288.50,$351557.00,268,$1288.50
2025-01-14,19:45:00,20983.0,SELL,3,0.02h,Stop Loss,$75.75,$1364.25,$351632.75,268,$1364.25
2025-01-14,20:30:00,20834.75,BUY,3,0.02h,Stop Loss,$255.75,$1620.00,$351888.50,268,$1620.00
2025-01-14,20:40:00,20801.75,SELL,3,0.02h,Break Even,$0.75,$1620.75,$351889.25,268,$1620.75
2025-01-14,20:46:00,20836.75,BUY,3,0.02h,Stop Loss,$180.75,$1801.50,$352070.00,268,$1801.50
2025-01-14,21:49:00,20973.5,SELL,3,0.02h,Break Even,$0.75,$1802.25,$352070.75,268,$1802.25
,,,,,,,,,,,
2025-01-15,12:00:00,20997.25,BUY,3,0.02h,Stop Loss,$57.00,$57.00,$352127.75,269,$57.00
2025-01-15,12:24:00,20990.0,SELL,3,0.02h,Break Even,$0.75,$57.75,$352128.50,269,$57.75
2025-01-15,12:40:00,21000.75,BUY,3,0.02h,Break Even,$0.75,$58.50,$352129.25,269,$58.50
2025-01-15,12:56:00,20986.0,SELL,3,0.02h,Break Even,$0.75,$59.25,$352130.00,269,$59.25
2025-01-15,13:03:00,20999.5,BUY,3,0.02h,Stop Loss,$-18.00,$41.25,$352112.00,269,$41.25
2025-01-15,13:12:00,20991.5,SELL,3,0.02h,Break Even,$0.75,$42.00,$352112.75,269,$42.00
2025-01-15,13:25:00,20999.5,BUY,3,0.02h,Break Even,$0.75,$42.75,$352113.50,269,$42.75
2025-01-15,14:12:00,21250.75,SELL,3,0.02h,Stop Loss,$-18.00,$24.75,$352095.50,269,$24.75
2025-01-15,14:42:00,21282.5,BUY,3,0.02h,Stop Loss,$94.50,$119.25,$352190.00,269,$119.25
2025-01-15,15:36:00,21365.5,SELL,3,0.02h,Stop Loss,$203.25,$322.50,$352393.25,269,$322.50
2025-01-15,15:42:00,21385.75,BUY,3,0.02h,Stop Loss,$42.00,$364.50,$352435.25,269,$364.50
2025-01-15,15:44:00,21375.5,SELL,3,0.02h,Stop Loss,$132.00,$496.50,$352567.25,269,$496.50
2025-01-15,17:06:00,21291.0,BUY,3,0.02h,Stop Loss,$237.00,$733.50,$352804.25,269,$733.50
2025-01-15,17:56:00,21330.25,SELL,3,0.02h,Stop Loss,$-18.00,$715.50,$352786.25,269,$715.50
2025-01-15,18:04:00,21354.5,BUY,3,0.02h,Stop Loss,$-18.00,$697.50,$352768.25,269,$697.50
2025-01-15,19:51:00,21407.0,SELL,3,0.02h,Break Even,$0.75,$698.25,$352769.00,269,$698.25
2025-01-15,19:53:00,21419.75,BUY,3,0.02h,Stop Loss,$-18.00,$680.25,$352751.00,269,$680.25
2025-01-15,20:38:00,21426.25,SELL,3,0.02h,Stop Loss,$27.00,$707.25,$352778.00,269,$707.25
,,,,,,,,,,,
2025-01-16,12:00:00,21506.75,BUY,3,0.02h,Break Even,$0.75,$0.75,$352778.75,270,$0.75
2025-01-16,12:30:00,21463.0,SELL,3,0.02h,Stop Loss,$12.00,$12.75,$352790.75,270,$12.75
2025-01-16,12:32:00,21473.0,BUY,3,0.02h,Break Even,$0.75,$13.50,$352791.50,270,$13.50
2025-01-16,12:48:00,21462.25,SELL,3,0.02h,Stop Loss,$49.50,$63.00,$352841.00,270,$63.00
2025-01-16,13:18:00,21444.25,BUY,3,0.02h,Stop Loss,$-18.00,$45.00,$352823.00,270,$45.00
2025-01-16,13:20:00,21429.25,SELL,3,0.02h,Stop Loss,$42.00,$87.00,$352865.00,270,$87.00
2025-01-16,13:24:00,21449.0,BUY,3,0.02h,Stop Loss,$12.00,$99.00,$352877.00,270,$99.00
2025-01-16,14:08:00,21458.5,SELL,3,0.02h,Stop Loss,$34.50,$133.50,$352911.50,270,$133.50
2025-01-16,14:14:00,21479.0,BUY,3,0.02h,Stop Loss,$42.00,$175.50,$352953.50,270,$175.50
2025-01-16,14:32:00,21450.75,SELL,3,0.02h,Stop Loss,$195.75,$371.25,$353149.25,270,$371.25
2025-01-16,15:21:00,21399.25,BUY,3,0.02h,Stop Loss,$184.50,$555.75,$353333.75,270,$555.75
2025-01-16,15:28:00,21371.75,SELL,3,0.02h,Break Even,$0.75,$556.50,$353334.50,270,$556.50
2025-01-16,15:56:00,21385.0,BUY,3,0.02h,Stop Loss,$184.50,$741.00,$353519.00,270,$741.00
2025-01-16,16:21:00,21395.5,SELL,3,0.02h,Stop Loss,$87.00,$828.00,$353606.00,270,$828.00
2025-01-16,16:59:00,21399.75,BUY,3,0.02h,Stop Loss,$27.00,$855.00,$353633.00,270,$855.00
2025-01-16,17:18:00,21383.0,SELL,3,0.02h,Stop Loss,$113.25,$968.25,$353746.25,270,$968.25
2025-01-16,17:19:00,21397.0,BUY,3,0.02h,Break Even,$0.75,$969.00,$353747.00,270,$969.00
2025-01-16,17:20:00,21383.75,SELL,3,0.02h,Break Even,$0.75,$969.75,$353747.75,270,$969.75
2025-01-16,17:25:00,21404.75,BUY,3,0.02h,Stop Loss,$42.00,$1011.75,$353789.75,270,$1011.75
2025-01-16,17:39:00,21392.0,SELL,3,0.02h,Stop Loss,$42.00,$1053.75,$353831.75,270,$1053.75
2025-01-16,17:59:00,21399.0,BUY,3,0.02h,Stop Loss,$-18.00,$1035.75,$353813.75,270,$1035.75
2025-01-16,18:00:00,21385.5,SELL,3,0.02h,Break Even,$0.75,$1036.50,$353814.50,270,$1036.50
2025-01-16,18:04:00,21399.75,BUY,3,0.02h,Stop Loss,$49.50,$1086.00,$353864.00,270,$1086.00
2025-01-16,18:16:00,21388.0,SELL,3,0.02h,Stop Loss,$72.00,$1158.00,$353936.00,270,$1158.00
2025-01-16,19:06:00,21320.75,BUY,3,0.02h,Stop Loss,$124.50,$1282.50,$354060.50,270,$1282.50
2025-01-16,20:18:00,21355.75,SELL,3,0.02h,Stop Loss,$128.25,$1410.75,$354188.75,270,$1410.75
2025-01-16,21:41:00,21208.25,BUY,3,0.02h,Break Even,$0.75,$1411.50,$354189.50,270,$1411.50
2025-01-16,21:45:00,21201.5,SELL,3,0.02h,Stop Loss,$-18.00,$1393.50,$354171.50,270,$1393.50
2025-01-16,21:46:00,21211.0,BUY,3,0.02h,Stop Loss,$-18.00,$1375.50,$354153.50,270,$1375.50
2025-01-16,21:53:00,21203.0,SELL,3,0.02h,Break Even,$0.75,$1376.25,$354154.25,270,$1376.25
2025-01-16,21:56:00,21210.5,BUY,3,0.02h,Stop Loss,$12.00,$1388.25,$354166.25,270,$1388.25
,,,,,,,,,,,
2025-01-17,14:34:00,21566.75,SELL,3,0.02h,Stop Loss,$229.50,$229.50,$354395.75,271,$229.50
2025-01-17,15:06:00,21563.75,BUY,3,0.02h,Stop Loss,$222.00,$451.50,$354617.75,271,$451.50
2025-01-17,15:23:00,21501.25,SELL,3,0.02h,Break Even,$0.75,$452.25,$354618.50,271,$452.25
2025-01-17,15:35:00,21549.5,BUY,3,0.02h,Stop Loss,$282.00,$734.25,$354900.50,271,$734.25
2025-01-17,16:44:00,21594.75,SELL,3,0.02h,Stop Loss,$-18.00,$716.25,$354882.50,271,$716.25
2025-01-17,17:11:00,21596.5,BUY,3,0.02h,Stop Loss,$-18.00,$698.25,$354864.50,271,$698.25
2025-01-17,18:34:00,21643.25,SELL,3,0.02h,Break Even,$0.75,$699.00,$354865.25,271,$699.00
2025-01-17,19:23:00,21639.0,BUY,3,0.02h,Stop Loss,$38.25,$737.25,$354903.50,271,$737.25
2025-01-17,19:34:00,21626.25,SELL,3,0.02h,Break Even,$0.75,$738.00,$354904.25,271,$738.00
2025-01-17,19:36:00,21636.5,BUY,3,0.02h,Stop Loss,$-18.00,$720.00,$354886.25,271,$720.00
2025-01-17,19:51:00,21629.25,SELL,3,0.02h,Stop Loss,$-18.00,$702.00,$354868.25,271,$702.00
2025-01-17,20:22:00,21616.5,BUY,3,0.02h,Stop Loss,$27.00,$729.00,$354895.25,271,$729.00
2025-01-17,20:29:00,21602.0,SELL,3,0.02h,Break Even,$0.75,$729.75,$354896.00,271,$729.75
2025-01-17,20:35:00,21618.25,BUY,3,0.02h,Stop Loss,$68.25,$798.00,$354964.25,271,$798.00
2025-01-17,20:52:00,21605.0,SELL,3,0.02h,Stop Loss,$-18.00,$780.00,$354946.25,271,$780.00
2025-01-17,20:54:00,21622.5,BUY,3,0.02h,Stop Loss,$195.75,$975.75,$355142.00,271,$975.75
2025-01-17,20:56:00,21603.25,SELL,3,0.02h,Stop Loss,$218.25,$1194.00,$355360.25,271,$1194.00
2025-01-17,21:27:00,21592.5,BUY,3,0.02h,Stop Loss,$-18.00,$1176.00,$355342.25,271,$1176.00
2025-01-17,21:36:00,21585.5,SELL,3,0.02h,Stop Loss,$38.25,$1214.25,$355380.50,271,$1214.25
2025-01-17,21:45:00,21589.0,BUY,3,0.02h,Stop Loss,$-18.00,$1196.25,$355362.50,271,$1196.25
2025-01-17,21:46:00,21583.0,SELL,3,0.02h,Break Even,$0.75,$1197.00,$355363.25,271,$1197.00
2025-01-17,22:00:00,21590.25,BUY,3,62.00h,Stop Loss,$499.50,$1696.50,$355862.75,271,$1696.50
,,,,,,,,,,,
2025-01-20,12:19:00,21596.5,SELL,3,0.02h,Stop Loss,$64.50,$64.50,$355927.25,272,$64.50
2025-01-20,13:32:00,21625.25,BUY,3,0.02h,Stop Loss,$135.75,$200.25,$356063.00,272,$200.25
2025-01-20,14:17:00,21661.25,SELL,3,0.02h,Break Even,$0.75,$201.00,$356063.75,272,$201.00
2025-01-20,14:22:00,21700.0,BUY,3,0.02h,Stop Loss,$72.00,$273.00,$356135.75,272,$273.00
2025-01-20,14:59:00,21736.75,SELL,3,0.02h,Stop Loss,$-18.00,$255.00,$356117.75,272,$255.00
2025-01-20,15:58:00,21683.5,BUY,3,0.02h,Break Even,$0.75,$255.75,$356118.50,272,$255.75
2025-01-20,15:59:00,21678.25,SELL,3,0.02h,Break Even,$0.75,$256.50,$356119.25,272,$256.50
2025-01-20,16:00:00,21682.75,BUY,3,0.02h,Stop Loss,$53.25,$309.75,$356172.50,272,$309.75
2025-01-20,16:59:00,21700.0,SELL,3,0.02h,Stop Loss,$147.00,$456.75,$356319.50,272,$456.75
2025-01-20,17:38:00,21693.75,BUY,3,0.02h,Stop Loss,$68.25,$525.00,$356387.75,272,$525.00
2025-01-20,17:44:00,21680.0,SELL,3,0.02h,Break Even,$0.75,$525.75,$356388.50,272,$525.75
2025-01-20,17:47:00,21692.75,BUY,3,0.02h,Stop Loss,$38.25,$564.00,$356426.75,272,$564.00
2025-01-20,17:53:00,21683.5,SELL,3,0.02h,Break Even,$0.75,$564.75,$356427.50,272,$564.75
2025-01-20,17:55:00,21702.5,BUY,3,0.02h,Stop Loss,$15.75,$580.50,$356443.25,272,$580.50
2025-01-20,18:00:00,21680.5,SELL,3,18.00h,Stop Loss,$102.00,$682.50,$356545.25,272,$682.50
,,,,,,,,,,,
2025-01-21,12:17:00,21682.5,BUY,3,0.02h,Stop Loss,$-18.00,$-18.00,$356527.25,273,$-18.00
2025-01-21,12:50:00,21687.0,SELL,3,0.02h,Stop Loss,$15.75,$-2.25,$356543.00,273,$-2.25
2025-01-21,13:00:00,21694.5,BUY,3,0.02h,Stop Loss,$-18.00,$-20.25,$356525.00,273,$-20.25
2025-01-21,13:01:00,21685.0,SELL,3,0.02h,Break Even,$0.75,$-19.50,$356525.75,273,$-19.50
2025-01-21,13:04:00,21694.5,BUY,3,0.02h,Stop Loss,$57.00,$37.50,$356582.75,273,$37.50
2025-01-21,13:29:00,21694.75,SELL,3,0.02h,Stop Loss,$27.00,$64.50,$356609.75,273,$64.50
2025-01-21,13:33:00,21705.0,BUY,3,0.02h,Stop Loss,$42.00,$106.50,$356651.75,273,$106.50
2025-01-21,14:13:00,21718.75,SELL,3,0.02h,Break Even,$0.75,$107.25,$356652.50,273,$107.25
2025-01-21,14:15:00,21724.5,BUY,3,0.02h,Break Even,$0.75,$108.00,$356653.25,273,$108.00
2025-01-21,14:19:00,21713.75,SELL,3,0.02h,Stop Loss,$45.75,$153.75,$356699.00,273,$153.75
2025-01-21,15:24:00,21605.75,BUY,3,0.02h,Stop Loss,$132.00,$285.75,$356831.00,273,$285.75
2025-01-21,15:52:00,21604.0,SELL,3,0.02h,Stop Loss,$233.25,$519.00,$357064.25,273,$519.00
2025-01-21,15:58:00,21623.5,BUY,3,0.02h,Stop Loss,$135.75,$654.75,$357200.00,273,$654.75
2025-01-21,16:02:00,21611.25,SELL,3,0.02h,Stop Loss,$49.50,$704.25,$357249.50,273,$704.25
2025-01-21,16:07:00,21638.75,BUY,3,0.02h,Break Even,$0.75,$705.00,$357250.25,273,$705.00
2025-01-21,16:26:00,21626.0,SELL,3,0.02h,Stop Loss,$15.75,$720.75,$357266.00,273,$720.75
2025-01-21,16:34:00,21638.0,BUY,3,0.02h,Break Even,$0.75,$721.50,$357266.75,273,$721.50
2025-01-21,16:37:00,21620.75,SELL,3,0.02h,Stop Loss,$128.25,$849.75,$357395.00,273,$849.75
2025-01-21,16:50:00,21637.5,BUY,3,0.02h,Stop Loss,$23.25,$873.00,$357418.25,273,$873.00
2025-01-21,17:20:00,21658.75,SELL,3,0.02h,Break Even,$0.75,$873.75,$357419.00,273,$873.75
2025-01-21,17:23:00,21673.75,BUY,3,0.02h,Break Even,$0.75,$874.50,$357419.75,273,$874.50
2025-01-21,18:43:00,21744.25,SELL,3,0.02h,Stop Loss,$-18.00,$856.50,$357401.75,273,$856.50
2025-01-21,18:56:00,21753.0,BUY,3,0.02h,Stop Loss,$42.00,$898.50,$357443.75,273,$898.50
2025-01-21,19:15:00,21745.25,SELL,3,0.02h,Stop Loss,$143.25,$1041.75,$357587.00,273,$1041.75
2025-01-21,19:59:00,21723.75,BUY,3,0.02h,Break Even,$0.75,$1042.50,$357587.75,273,$1042.50
2025-01-21,20:38:00,21718.75,SELL,3,0.02h,Stop Loss,$-18.00,$1024.50,$357569.75,273,$1024.50
2025-01-21,20:40:00,21735.5,BUY,3,0.02h,Break Even,$0.75,$1025.25,$357570.50,273,$1025.25
2025-01-21,20:42:00,21720.5,SELL,3,0.02h,Stop Loss,$-18.00,$1007.25,$357552.50,273,$1007.25
2025-01-21,21:01:00,21752.75,BUY,3,0.02h,Stop Loss,$285.75,$1293.00,$357838.25,273,$1293.00
,,,,,,,,,,,
2025-01-22,13:06:00,21907.5,SELL,3,0.02h,Stop Loss,$-18.00,$-18.00,$357820.25,274,$-18.00
2025-01-22,13:07:00,21910.75,BUY,3,0.02h,Break Even,$0.75,$-17.25,$357821.00,274,$-17.25
2025-01-22,14:04:00,21922.5,SELL,3,0.02h,Break Even,$0.75,$-16.50,$357821.75,274,$-16.50
2025-01-22,14:32:00,21953.0,BUY,3,0.02h,Stop Loss,$387.00,$370.50,$358208.75,274,$370.50
2025-01-22,15:27:00,22009.5,SELL,3,0.02h,Stop Loss,$60.75,$431.25,$358269.50,274,$431.25
2025-01-22,15:29:00,22018.25,BUY,3,0.02h,Stop Loss,$23.25,$454.50,$358292.75,274,$454.50
2025-01-22,15:30:00,22012.75,SELL,3,0.02h,Stop Loss,$60.75,$515.25,$358353.50,274,$515.25
2025-01-22,15:31:00,22017.5,BUY,3,0.02h,Stop Loss,$98.25,$613.50,$358451.75,274,$613.50
2025-01-22,15:52:00,22014.25,SELL,3,0.02h,Stop Loss,$68.25,$681.75,$358520.00,274,$681.75
2025-01-22,16:09:00,22028.25,BUY,3,0.02h,Stop Loss,$-18.00,$663.75,$358502.00,274,$663.75
2025-01-22,16:11:00,22003.5,SELL,3,0.02h,Break Even,$0.75,$664.50,$358502.75,274,$664.50
2025-01-22,16:18:00,22020.25,BUY,3,0.02h,Stop Loss,$60.75,$725.25,$358563.50,274,$725.25
2025-01-22,17:16:00,22067.75,SELL,3,0.02h,Break Even,$0.75,$726.00,$358564.25,274,$726.00
2025-01-22,17:55:00,22067.0,BUY,3,0.02h,Stop Loss,$-18.00,$708.00,$358546.25,274,$708.00
2025-01-22,17:56:00,22061.0,SELL,3,0.02h,Stop Loss,$79.50,$787.50,$358625.75,274,$787.50
2025-01-22,18:41:00,22032.0,BUY,3,0.02h,Stop Loss,$12.00,$799.50,$358637.75,274,$799.50
2025-01-22,18:58:00,22022.5,SELL,3,0.02h,Stop Loss,$-18.00,$781.50,$358619.75,274,$781.50
2025-01-22,19:16:00,22033.0,BUY,3,0.02h,Break Even,$0.75,$782.25,$358620.50,274,$782.25
2025-01-22,19:27:00,22023.5,SELL,3,0.02h,Break Even,$0.75,$783.00,$358621.25,274,$783.00
2025-01-22,19:50:00,22029.5,BUY,3,0.02h,Break Even,$0.75,$783.75,$358622.00,274,$783.75
2025-01-22,20:08:00,22026.5,SELL,3,0.02h,Break Even,$0.75,$784.50,$358622.75,274,$784.50
2025-01-22,20:36:00,22026.0,BUY,3,0.02h,Stop Loss,$-18.00,$766.50,$358604.75,274,$766.50
2025-01-22,20:37:00,22014.5,SELL,3,0.02h,Stop Loss,$15.75,$782.25,$358620.50,274,$782.25
2025-01-22,21:56:00,21975.25,BUY,3,0.02h,Break Even,$0.75,$783.00,$358621.25,274,$783.00
,,,,,,,,,,,
2025-01-23,12:00:00,21898.0,SELL,3,0.02h,Stop Loss,$38.25,$38.25,$358659.50,275,$38.25
2025-01-23,12:32:00,21895.5,BUY,3,0.02h,Break Even,$0.75,$39.00,$358660.25,275,$39.00
2025-01-23,12:50:00,21888.75,SELL,3,0.02h,Stop Loss,$-18.00,$21.00,$358642.25,275,$21.00
2025-01-23,12:52:00,21900.75,BUY,3,0.02h,Stop Loss,$-18.00,$3.00,$358624.25,275,$3.00
2025-01-23,13:11:00,21882.5,SELL,3,0.02h,Stop Loss,$-18.00,$-15.00,$358606.25,275,$-15.00
2025-01-23,13:27:00,21898.5,BUY,3,0.02h,Break Even,$0.75,$-14.25,$358607.00,275,$-14.25
2025-01-23,13:37:00,21890.5,SELL,3,0.02h,Stop Loss,$75.75,$61.50,$358682.75,275,$61.50
2025-01-23,13:47:00,21897.0,BUY,3,0.02h,Break Even,$0.75,$62.25,$358683.50,275,$62.25
2025-01-23,14:06:00,21892.75,SELL,3,0.02h,Break Even,$0.75,$63.00,$358684.25,275,$63.00
2025-01-23,14:35:00,21897.75,BUY,3,0.02h,Stop Loss,$90.75,$153.75,$358775.00,275,$153.75
2025-01-23,14:57:00,21881.25,SELL,3,0.02h,Stop Loss,$-18.00,$135.75,$358757.00,275,$135.75
2025-01-23,15:14:00,21898.5,BUY,3,0.02h,Stop Loss,$27.00,$162.75,$358784.00,275,$162.75
2025-01-23,15:20:00,21882.25,SELL,3,0.02h,Break Even,$0.75,$163.50,$358784.75,275,$163.50
2025-01-23,15:24:00,21907.75,BUY,3,0.02h,Stop Loss,$-18.00,$145.50,$358766.75,275,$145.50
2025-01-23,16:10:00,21919.25,SELL,3,0.02h,Stop Loss,$-18.00,$127.50,$358748.75,275,$127.50
2025-01-23,16:15:00,21939.5,BUY,3,0.02h,Stop Loss,$57.00,$184.50,$358805.75,275,$184.50
2025-01-23,16:18:00,21922.5,SELL,3,0.02h,Stop Loss,$60.75,$245.25,$358866.50,275,$245.25
2025-01-23,16:28:00,21937.75,BUY,3,0.02h,Stop Loss,$60.75,$306.00,$358927.25,275,$306.00
2025-01-23,17:01:00,21935.5,SELL,3,0.02h,Break Even,$0.75,$306.75,$358928.00,275,$306.75
2025-01-23,17:19:00,21944.75,BUY,3,0.02h,Stop Loss,$-18.00,$288.75,$358910.00,275,$288.75
2025-01-23,17:24:00,21934.5,SELL,3,0.02h,Break Even,$0.75,$289.50,$358910.75,275,$289.50
2025-01-23,17:49:00,21925.25,BUY,3,0.02h,Break Even,$0.75,$290.25,$358911.50,275,$290.25
2025-01-23,18:48:00,21960.25,SELL,3,0.02h,Break Even,$0.75,$291.00,$358912.25,275,$291.00
2025-01-23,19:27:00,21947.5,BUY,3,0.02h,Break Even,$0.75,$291.75,$358913.00,275,$291.75
2025-01-23,19:55:00,21948.75,SELL,3,0.02h,Stop Loss,$12.00,$303.75,$358925.00,275,$303.75
2025-01-23,19:57:00,21955.75,BUY,3,0.02h,Stop Loss,$49.50,$353.25,$358974.50,275,$353.25
2025-01-23,20:02:00,21945.5,SELL,3,0.02h,Stop Loss,$-18.00,$335.25,$358956.50,275,$335.25
2025-01-23,20:08:00,21958.25,BUY,3,0.02h,Stop Loss,$15.75,$351.00,$358972.25,275,$351.00
2025-01-23,20:36:00,21962.0,SELL,3,0.02h,Break Even,$0.75,$351.75,$358973.00,275,$351.75
2025-01-23,20:37:00,21970.5,BUY,3,0.02h,Stop Loss,$45.75,$397.50,$359018.75,275,$397.50
2025-01-23,20:42:00,21962.0,SELL,3,0.02h,Break Even,$0.75,$398.25,$359019.50,275,$398.25
2025-01-23,20:48:00,21976.75,BUY,3,0.02h,Break Even,$0.75,$399.00,$359020.25,275,$399.00
2025-01-23,21:22:00,22011.25,SELL,3,0.02h,Stop Loss,$-18.00,$381.00,$359002.25,275,$381.00
2025-01-23,21:38:00,22019.0,BUY,3,0.02h,Stop Loss,$-18.00,$363.00,$358984.25,275,$363.00
2025-01-23,21:49:00,22013.75,SELL,3,0.02h,Stop Loss,$-18.00,$345.00,$358966.25,275,$345.00
2025-01-23,21:53:00,22016.75,BUY,3,0.02h,Break Even,$0.75,$345.75,$358967.00,275,$345.75
,,,,,,,,,,,
2025-01-24,12:02:00,22010.75,SELL,3,0.02h,Stop Loss,$-18.00,$-18.00,$358949.00,276,$-18.00
2025-01-24,12:06:00,22019.0,BUY,3,0.02h,Stop Loss,$34.50,$16.50,$358983.50,276,$16.50
2025-01-24,12:10:00,22015.75,SELL,3,0.02h,Stop Loss,$-18.00,$-1.50,$358965.50,276,$-1.50
2025-01-24,12:12:00,22018.0,BUY,3,0.02h,Break Even,$0.75,$-0.75,$358966.25,276,$-0.75
2025-01-24,12:40:00,22026.25,SELL,3,0.02h,Stop Loss,$-18.00,$-18.75,$358948.25,276,$-18.75
2025-01-24,13:01:00,22029.0,BUY,3,0.02h,Stop Loss,$-18.00,$-36.75,$358930.25,276,$-36.75
2025-01-24,13:05:00,22023.75,SELL,3,0.02h,Stop Loss,$-18.00,$-54.75,$358912.25,276,$-54.75
2025-01-24,13:07:00,22027.5,BUY,3,0.02h,Stop Loss,$-18.00,$-72.75,$358894.25,276,$-72.75
2025-01-24,13:08:00,22024.25,SELL,3,0.02h,Stop Loss,$34.50,$-38.25,$358928.75,276,$-38.25
2025-01-24,13:57:00,22007.75,BUY,3,0.02h,Break Even,$0.75,$-37.50,$358929.50,276,$-37.50
2025-01-24,14:33:00,22017.75,SELL,3,0.02h,Stop Loss,$42.00,$4.50,$358971.50,276,$4.50
2025-01-24,14:46:00,22048.75,BUY,3,0.02h,Stop Loss,$45.75,$50.25,$359017.25,276,$50.25
2025-01-24,15:04:00,22030.25,SELL,3,0.02h,Stop Loss,$150.75,$201.00,$359168.00,276,$201.00
2025-01-24,16:11:00,22000.25,BUY,3,0.02h,Stop Loss,$38.25,$239.25,$359206.25,276,$239.25
2025-01-24,16:18:00,21988.0,SELL,3,0.02h,Break Even,$0.75,$240.00,$359207.00,276,$240.00
2025-01-24,16:21:00,22003.5,BUY,3,0.02h,Stop Loss,$19.50,$259.50,$359226.50,276,$259.50
2025-01-24,16:57:00,21995.0,SELL,3,0.02h,Break Even,$0.75,$260.25,$359227.25,276,$260.25
2025-01-24,17:23:00,22001.0,BUY,3,0.02h,Stop Loss,$64.50,$324.75,$359291.75,276,$324.75
2025-01-24,17:29:00,21979.75,SELL,3,0.02h,Stop Loss,$169.50,$494.25,$359461.25,276,$494.25
2025-01-24,18:24:00,21947.75,BUY,3,0.02h,Stop Loss,$-18.00,$476.25,$359443.25,276,$476.25
2025-01-24,18:30:00,21935.0,SELL,3,0.02h,Stop Loss,$38.25,$514.50,$359481.50,276,$514.50
2025-01-24,18:32:00,21943.5,BUY,3,0.02h,Stop Loss,$-18.00,$496.50,$359463.50,276,$496.50
2025-01-24,18:33:00,21937.0,SELL,3,0.02h,Stop Loss,$117.00,$613.50,$359580.50,276,$613.50
2025-01-24,19:27:00,21875.0,BUY,3,0.02h,Stop Loss,$12.00,$625.50,$359592.50,276,$625.50
2025-01-24,20:01:00,21866.5,SELL,3,0.02h,Break Even,$0.75,$626.25,$359593.25,276,$626.25
2025-01-24,20:04:00,21885.75,BUY,3,0.02h,Break Even,$0.75,$627.00,$359594.00,276,$627.00
2025-01-24,20:11:00,21874.75,SELL,3,0.02h,Stop Loss,$-18.00,$609.00,$359576.00,276,$609.00
2025-01-24,20:12:00,21885.0,BUY,3,0.02h,Stop Loss,$42.00,$651.00,$359618.00,276,$651.00
2025-01-24,20:20:00,21871.75,SELL,3,0.02h,Break Even,$0.75,$651.75,$359618.75,276,$651.75
2025-01-24,20:37:00,21875.75,BUY,3,0.02h,Stop Loss,$19.50,$671.25,$359638.25,276,$671.25
2025-01-24,20:40:00,21874.25,SELL,3,0.02h,Stop Loss,$64.50,$735.75,$359702.75,276,$735.75
2025-01-24,20:49:00,21876.5,BUY,3,0.02h,Stop Loss,$23.25,$759.00,$359726.00,276,$759.00
2025-01-24,21:16:00,21897.0,SELL,3,0.02h,Break Even,$0.75,$759.75,$359726.75,276,$759.75
2025-01-24,21:27:00,21900.75,BUY,3,0.05h,Break Even,$0.75,$760.50,$359727.50,276,$760.50
2025-01-24,21:42:00,21898.25,SELL,3,0.02h,Stop Loss,$-18.00,$742.50,$359709.50,276,$742.50
2025-01-24,21:47:00,21904.75,BUY,3,0.02h,Stop Loss,$-18.00,$724.50,$359691.50,276,$724.50
,,,,,,,,,,,
2025-01-27,12:00:00,20999.75,SELL,3,0.02h,Break Even,$0.75,$0.75,$359692.25,277,$0.75
2025-01-27,12:47:00,21099.25,BUY,3,0.02h,Stop Loss,$42.00,$42.75,$359734.25,277,$42.75
2025-01-27,12:59:00,21078.75,SELL,3,0.02h,Stop Loss,$79.50,$122.25,$359813.75,277,$122.25
2025-01-27,13:08:00,21105.75,BUY,3,0.02h,Stop Loss,$177.00,$299.25,$359990.75,277,$299.25
2025-01-27,13:44:00,21130.5,SELL,3,0.02h,Break Even,$0.75,$300.00,$359991.50,277,$300.00
2025-01-27,13:47:00,21144.5,BUY,3,0.02h,Stop Loss,$64.50,$364.50,$360056.00,277,$364.50
2025-01-27,14:08:00,21140.5,SELL,3,0.02h,Stop Loss,$60.75,$425.25,$360116.75,277,$425.25
2025-01-27,14:31:00,21172.5,BUY,3,0.02h,Stop Loss,$1200.75,$1626.00,$361317.50,277,$1626.00
2025-01-27,15:16:00,21282.25,SELL,3,0.02h,Stop Loss,$327.00,$1953.00,$361644.50,277,$1953.00
2025-01-27,15:26:00,21318.5,BUY,3,0.02h,Stop Loss,$203.25,$2156.25,$361847.75,277,$2156.25
2025-01-27,15:53:00,21351.5,SELL,3,0.02h,Stop Loss,$229.50,$2385.75,$362077.25,277,$2385.75
2025-01-27,16:48:00,21268.5,BUY,3,0.02h,Stop Loss,$68.25,$2454.00,$362145.50,277,$2454.00
2025-01-27,16:55:00,21193.25,SELL,3,0.02h,Stop Loss,$90.75,$2544.75,$362236.25,277,$2544.75
2025-01-27,17:03:00,21250.25,BUY,3,0.02h,Stop Loss,$210.75,$2755.50,$362447.00,277,$2755.50
2025-01-27,17:10:00,21204.25,SELL,3,0.02h,Stop Loss,$68.25,$2823.75,$362515.25,277,$2823.75
2025-01-27,17:30:00,21227.0,BUY,3,0.02h,Stop Loss,$-18.00,$2805.75,$362497.25,277,$2805.75
2025-01-27,17:46:00,21206.25,SELL,3,0.02h,Stop Loss,$147.00,$2952.75,$362644.25,277,$2952.75
2025-01-27,18:17:00,21186.0,BUY,3,0.02h,Stop Loss,$30.75,$2983.50,$362675.00,277,$2983.50
2025-01-27,18:19:00,21161.25,SELL,3,0.02h,Stop Loss,$53.25,$3036.75,$362728.25,277,$3036.75
2025-01-27,18:21:00,21178.5,BUY,3,0.02h,Break Even,$0.75,$3037.50,$362729.00,277,$3037.50
2025-01-27,18:22:00,21166.5,SELL,3,0.02h,Stop Loss,$12.00,$3049.50,$362741.00,277,$3049.50
2025-01-27,18:34:00,21194.25,BUY,3,0.02h,Stop Loss,$72.00,$3121.50,$362813.00,277,$3121.50
2025-01-27,18:55:00,21180.25,SELL,3,0.02h,Stop Loss,$147.00,$3268.50,$362960.00,277,$3268.50
2025-01-27,19:14:00,21180.0,BUY,3,0.02h,Stop Loss,$49.50,$3318.00,$363009.50,277,$3318.00
2025-01-27,19:15:00,21171.5,SELL,3,0.02h,Stop Loss,$12.00,$3330.00,$363021.50,277,$3330.00
2025-01-27,19:16:00,21187.75,BUY,3,0.02h,Stop Loss,$45.75,$3375.75,$363067.25,277,$3375.75
2025-01-27,19:41:00,21205.0,SELL,3,0.02h,Stop Loss,$192.00,$3567.75,$363259.25,277,$3567.75
2025-01-27,20:09:00,21172.25,BUY,3,0.02h,Stop Loss,$147.00,$3714.75,$363406.25,277,$3714.75
2025-01-27,21:44:00,21305.0,SELL,3,0.02h,Break Even,$0.75,$3715.50,$363407.00,277,$3715.50
,,,,,,,,,,,
2025-01-28,12:00:00,21341.5,BUY,3,0.02h,Stop Loss,$53.25,$53.25,$363460.25,278,$53.25
2025-01-28,12:11:00,21291.5,SELL,3,0.02h,Break Even,$0.75,$54.00,$363461.00,278,$54.00
2025-01-28,12:47:00,21287.75,BUY,3,0.02h,Break Even,$0.75,$54.75,$363461.75,278,$54.75
2025-01-28,13:36:00,21299.5,SELL,3,0.02h,Stop Loss,$27.00,$81.75,$363488.75,278,$81.75
2025-01-28,14:26:00,21307.25,BUY,3,0.02h,Break Even,$0.75,$82.50,$363489.50,278,$82.50
2025-01-28,14:32:00,21251.75,SELL,3,0.02h,Stop Loss,$117.00,$199.50,$363606.50,278,$199.50
2025-01-28,14:55:00,21265.0,BUY,3,0.02h,Stop Loss,$72.00,$271.50,$363678.50,278,$271.50
2025-01-28,15:54:00,21415.75,SELL,3,0.02h,Stop Loss,$79.50,$351.00,$363758.00,278,$351.00
2025-01-28,15:59:00,21451.0,BUY,3,0.02h,Stop Loss,$68.25,$419.25,$363826.25,278,$419.25
2025-01-28,16:21:00,21444.25,SELL,3,0.02h,Stop Loss,$83.25,$502.50,$363909.50,278,$502.50
2025-01-28,16:48:00,21436.0,BUY,3,0.02h,Stop Loss,$120.75,$623.25,$364030.25,278,$623.25
2025-01-28,17:44:00,21531.0,SELL,3,0.02h,Break Even,$0.75,$624.00,$364031.00,278,$624.00
2025-01-28,17:56:00,21552.25,BUY,3,0.02h,Stop Loss,$-18.00,$606.00,$364013.00,278,$606.00
2025-01-28,18:27:00,21551.75,SELL,3,0.02h,Stop Loss,$30.75,$636.75,$364043.75,278,$636.75
2025-01-28,19:19:00,21545.75,BUY,3,0.02h,Stop Loss,$94.50,$731.25,$364138.25,278,$731.25
2025-01-28,20:06:00,21594.75,SELL,3,0.02h,Stop Loss,$49.50,$780.75,$364187.75,278,$780.75
2025-01-28,20:16:00,21608.5,BUY,3,0.02h,Stop Loss,$83.25,$864.00,$364271.00,278,$864.00
2025-01-28,20:38:00,21600.75,SELL,3,0.02h,Stop Loss,$12.00,$876.00,$364283.00,278,$876.00
2025-01-28,21:49:00,21562.25,BUY,3,0.02h,Break Even,$0.75,$876.75,$364283.75,278,$876.75
2025-01-28,21:57:00,21558.0,SELL,3,0.02h,Break Even,$0.75,$877.50,$364284.50,278,$877.50
,,,,,,,,,,,
2025-01-29,12:00:00,21681.25,BUY,3,0.02h,Break Even,$0.75,$0.75,$364285.25,279,$0.75
2025-01-29,12:44:00,21655.75,SELL,3,0.02h,Stop Loss,$-18.00,$-17.25,$364267.25,279,$-17.25
2025-01-29,13:58:00,21588.0,BUY,3,0.02h,Stop Loss,$117.00,$99.75,$364384.25,279,$99.75
2025-01-29,14:31:00,21583.5,SELL,3,0.02h,Stop Loss,$237.00,$336.75,$364621.25,279,$336.75
2025-01-29,15:03:00,21556.5,BUY,3,0.02h,Stop Loss,$19.50,$356.25,$364640.75,279,$356.25
2025-01-29,15:05:00,21529.5,SELL,3,0.02h,Break Even,$0.75,$357.00,$364641.50,279,$357.00
2025-01-29,15:07:00,21547.75,BUY,3,0.02h,Stop Loss,$124.50,$481.50,$364766.00,279,$481.50
2025-01-29,15:14:00,21522.25,SELL,3,0.02h,Stop Loss,$-18.00,$463.50,$364748.00,279,$463.50
2025-01-29,15:23:00,21547.25,BUY,3,0.02h,Break Even,$0.75,$464.25,$364748.75,279,$464.25
2025-01-29,15:26:00,21507.0,SELL,3,0.02h,Stop Loss,$222.00,$686.25,$364970.75,279,$686.25
2025-01-29,15:54:00,21518.25,BUY,3,0.02h,Stop Loss,$124.50,$810.75,$365095.25,279,$810.75
2025-01-29,16:08:00,21492.25,SELL,3,0.02h,Stop Loss,$75.75,$886.50,$365171.00,279,$886.50
2025-01-29,16:26:00,21509.25,BUY,3,0.02h,Stop Loss,$-18.00,$868.50,$365153.00,279,$868.50
2025-01-29,16:31:00,21488.0,SELL,3,0.02h,Stop Loss,$45.75,$914.25,$365198.75,279,$914.25
2025-01-29,16:36:00,21502.5,BUY,3,0.02h,Stop Loss,$60.75,$975.00,$365259.50,279,$975.00
2025-01-29,16:39:00,21486.75,SELL,3,0.02h,Stop Loss,$199.50,$1174.50,$365459.00,279,$1174.50
2025-01-29,16:50:00,21505.25,BUY,3,0.02h,Stop Loss,$15.75,$1190.25,$365474.75,279,$1190.25
2025-01-29,16:57:00,21472.75,SELL,3,0.02h,Stop Loss,$19.50,$1209.75,$365494.25,279,$1209.75
2025-01-29,17:02:00,21514.0,BUY,3,0.02h,Break Even,$0.75,$1210.50,$365495.00,279,$1210.50
2025-01-29,17:46:00,21515.5,SELL,3,0.02h,Stop Loss,$94.50,$1305.00,$365589.50,279,$1305.00
2025-01-29,18:27:00,21468.5,BUY,3,0.02h,Stop Loss,$49.50,$1354.50,$365639.00,279,$1354.50
2025-01-29,18:43:00,21458.5,SELL,3,0.02h,Break Even,$0.75,$1355.25,$365639.75,279,$1355.25
2025-01-29,18:49:00,21487.75,BUY,3,0.02h,Stop Loss,$49.50,$1404.75,$365689.25,279,$1404.75
2025-01-29,19:01:00,21416.5,SELL,3,0.02h,Stop Loss,$83.25,$1488.00,$365772.50,279,$1488.00
2025-01-29,19:33:00,21469.0,BUY,3,0.02h,Stop Loss,$83.25,$1571.25,$365855.75,279,$1571.25
2025-01-29,19:37:00,21400.0,SELL,3,0.02h,Stop Loss,$27.00,$1598.25,$365882.75,279,$1598.25
2025-01-29,19:38:00,21445.75,BUY,3,0.02h,Stop Loss,$627.00,$2225.25,$366509.75,279,$2225.25
2025-01-29,20:05:00,21496.25,SELL,3,0.02h,Stop Loss,$79.50,$2304.75,$366589.25,279,$2304.75
2025-01-29,20:12:00,21527.25,BUY,3,0.02h,Stop Loss,$45.75,$2350.50,$366635.00,279,$2350.50
2025-01-29,20:14:00,21499.5,SELL,3,0.02h,Stop Loss,$255.75,$2606.25,$366890.75,279,$2606.25
2025-01-29,20:23:00,21551.5,BUY,3,0.02h,Stop Loss,$79.50,$2685.75,$366970.25,279,$2685.75
2025-01-29,20:40:00,21521.5,SELL,3,0.02h,Stop Loss,$34.50,$2720.25,$367004.75,279,$2720.25
2025-01-29,21:17:00,21511.25,BUY,3,0.02h,Stop Loss,$15.75,$2736.00,$367020.50,279,$2736.00
2025-01-29,21:19:00,21484.25,SELL,3,0.02h,Break Even,$0.75,$2736.75,$367021.25,279,$2736.75
2025-01-29,21:20:00,21507.75,BUY,3,0.02h,Stop Loss,$180.75,$2917.50,$367202.00,279,$2917.50
,,,,,,,,,,,
2025-01-30,12:18:00,21586.75,SELL,3,0.02h,Break Even,$0.75,$0.75,$367202.75,280,$0.75
2025-01-30,12:37:00,21605.75,BUY,3,0.02h,Stop Loss,$117.00,$117.75,$367319.75,280,$117.75
2025-01-30,13:25:00,21630.5,SELL,3,0.02h,Stop Loss,$-18.00,$99.75,$367301.75,280,$99.75
2025-01-30,13:31:00,21639.25,BUY,3,0.02h,Stop Loss,$338.25,$438.00,$367640.00,280,$438.00
2025-01-30,13:38:00,21620.5,SELL,3,0.02h,Stop Loss,$72.00,$510.00,$367712.00,280,$510.00
2025-01-30,13:53:00,21636.5,BUY,3,0.02h,Stop Loss,$90.75,$600.75,$367802.75,280,$600.75
2025-01-30,14:17:00,21640.25,SELL,3,0.02h,Stop Loss,$98.25,$699.00,$367901.00,280,$699.00
2025-01-30,14:32:00,21661.75,BUY,3,0.02h,Stop Loss,$57.00,$756.00,$367958.00,280,$756.00
2025-01-30,14:35:00,21619.75,SELL,3,0.02h,Stop Loss,$289.50,$1045.50,$368247.50,280,$1045.50
2025-01-30,14:41:00,21654.25,BUY,3,0.02h,Break Even,$0.75,$1046.25,$368248.25,280,$1046.25
2025-01-30,14:43:00,21627.25,SELL,3,0.02h,Stop Loss,$75.75,$1122.00,$368324.00,280,$1122.00
2025-01-30,14:44:00,21647.25,BUY,3,0.02h,Stop Loss,$42.00,$1164.00,$368366.00,280,$1164.00
2025-01-30,15:02:00,21648.0,SELL,3,0.02h,Stop Loss,$818.25,$1982.25,$369184.25,280,$1982.25
2025-01-30,15:49:00,21579.25,BUY,3,0.02h,Stop Loss,$-18.00,$1964.25,$369166.25,280,$1964.25
2025-01-30,15:51:00,21557.0,SELL,3,0.02h,Stop Loss,$132.00,$2096.25,$369298.25,280,$2096.25
2025-01-30,16:23:00,21500.5,BUY,3,0.02h,Stop Loss,$214.50,$2310.75,$369512.75,280,$2310.75
2025-01-30,17:13:00,21571.25,SELL,3,0.02h,Stop Loss,$267.00,$2577.75,$369779.75,280,$2577.75
2025-01-30,17:49:00,21540.5,BUY,3,0.02h,Stop Loss,$-18.00,$2559.75,$369761.75,280,$2559.75
2025-01-30,19:32:00,21602.5,SELL,3,0.02h,Stop Loss,$19.50,$2579.25,$369781.25,280,$2579.25
2025-01-30,19:39:00,21611.75,BUY,3,0.02h,Stop Loss,$27.00,$2606.25,$369808.25,280,$2606.25
2025-01-30,20:37:00,21653.0,SELL,3,0.02h,Stop Loss,$495.75,$3102.00,$370304.00,280,$3102.00
2025-01-30,20:57:00,21648.25,BUY,3,0.02h,Stop Loss,$83.25,$3185.25,$370387.25,280,$3185.25
2025-01-30,21:20:00,21628.75,SELL,3,0.02h,Break Even,$0.75,$3186.00,$370388.00,280,$3186.00
2025-01-30,21:31:00,21643.75,BUY,3,0.02h,Stop Loss,$210.75,$3396.75,$370598.75,280,$3396.75
2025-01-30,21:34:00,21619.5,SELL,3,0.02h,Stop Loss,$94.50,$3491.25,$370693.25,280,$3491.25
,,,,,,,,,,,
2025-01-31,12:00:00,21804.5,BUY,3,0.02h,Stop Loss,$90.75,$90.75,$370784.00,281,$90.75
2025-01-31,12:57:00,21787.25,SELL,3,0.02h,Stop Loss,$30.75,$121.50,$370814.75,281,$121.50
2025-01-31,13:19:00,21789.0,BUY,3,0.02h,Stop Loss,$12.00,$133.50,$370826.75,281,$133.50
2025-01-31,13:33:00,21780.75,SELL,3,0.02h,Break Even,$0.75,$134.25,$370827.50,281,$134.25
2025-01-31,13:49:00,21797.75,BUY,3,0.02h,Stop Loss,$12.00,$146.25,$370839.50,281,$146.25
2025-01-31,14:02:00,21780.5,SELL,3,0.02h,Stop Loss,$75.75,$222.00,$370915.25,281,$222.00
2025-01-31,14:30:00,21775.0,BUY,3,0.02h,Stop Loss,$214.50,$436.50,$371129.75,281,$436.50
2025-01-31,16:21:00,21935.5,SELL,3,0.02h,Stop Loss,$124.50,$561.00,$371254.25,281,$561.00
2025-01-31,17:15:00,21912.0,BUY,3,0.02h,Stop Loss,$-18.00,$543.00,$371236.25,281,$543.00
2025-01-31,17:44:00,21917.0,SELL,3,0.02h,Stop Loss,$34.50,$577.50,$371270.75,281,$577.50
2025-01-31,17:51:00,21927.25,BUY,3,0.02h,Stop Loss,$19.50,$597.00,$371290.25,281,$597.00
2025-01-31,17:59:00,21914.0,SELL,3,0.02h,Break Even,$0.75,$597.75,$371291.00,281,$597.75
2025-01-31,18:07:00,21923.0,BUY,3,0.02h,Break Even,$0.75,$598.50,$371291.75,281,$598.50
2025-01-31,18:10:00,21911.75,SELL,3,0.02h,Break Even,$0.75,$599.25,$371292.50,281,$599.25
2025-01-31,20:00:00,21661.75,BUY,3,0.02h,Stop Loss,$-18.00,$581.25,$371274.50,281,$581.25
2025-01-31,20:01:00,21631.0,SELL,3,0.02h,Stop Loss,$154.50,$735.75,$371429.00,281,$735.75
2025-01-31,20:48:00,21593.25,BUY,3,0.02h,Stop Loss,$282.00,$1017.75,$371711.00,281,$1017.75
2025-01-31,21:03:00,21565.25,SELL,3,0.02h,Stop Loss,$379.50,$1397.25,$372090.50,281,$1397.25
2025-01-31,21:22:00,21578.75,BUY,3,0.02h,Break Even,$0.75,$1398.00,$372091.25,281,$1398.00
2025-01-31,21:31:00,21562.5,SELL,3,0.02h,Stop Loss,$45.75,$1443.75,$372137.00,281,$1443.75
2025-01-31,21:51:00,21575.5,BUY,3,0.02h,Break Even,$0.75,$1444.50,$372137.75,281,$1444.50
2025-01-31,21:56:00,21557.75,SELL,3,0.02h,Stop Loss,$12.00,$1456.50,$372149.75,281,$1456.50
,,,,,,,,,,,
2025-02-03,13:04:00,21206.75,BUY,3,0.02h,Stop Loss,$12.00,$12.00,$372161.75,282,$12.00
2025-02-03,13:35:00,21203.5,SELL,3,0.02h,Stop Loss,$184.50,$196.50,$372346.25,282,$196.50
2025-02-03,14:00:00,21202.25,BUY,3,0.02h,Stop Loss,$53.25,$249.75,$372399.50,282,$249.75
2025-02-03,14:11:00,21190.0,SELL,3,0.02h,Stop Loss,$45.75,$295.50,$372445.25,282,$295.50
2025-02-03,14:12:00,21206.5,BUY,3,0.02h,Stop Loss,$330.75,$626.25,$372776.00,282,$626.25
2025-02-03,14:27:00,21188.75,SELL,3,0.02h,Stop Loss,$57.00,$683.25,$372833.00,282,$683.25
2025-02-03,14:32:00,21228.75,BUY,3,0.02h,Stop Loss,$349.50,$1032.75,$373182.50,282,$1032.75
2025-02-03,14:49:00,21214.0,SELL,3,0.02h,Stop Loss,$57.00,$1089.75,$373239.50,282,$1089.75
2025-02-03,15:24:00,21229.75,BUY,3,0.02h,Stop Loss,$1410.75,$2500.50,$374650.25,282,$2500.50
2025-02-03,16:06:00,21346.25,SELL,3,0.02h,Stop Loss,$27.00,$2527.50,$374677.25,282,$2527.50
2025-02-03,16:07:00,21411.5,BUY,3,0.02h,Break Even,$0.75,$2528.25,$374678.00,282,$2528.25
2025-02-03,16:29:00,21409.25,SELL,3,0.02h,Stop Loss,$218.25,$2746.50,$374896.25,282,$2746.50
2025-02-03,16:40:00,21433.25,BUY,3,0.02h,Stop Loss,$113.25,$2859.75,$375009.50,282,$2859.75
2025-02-03,16:43:00,21408.5,SELL,3,0.02h,Stop Loss,$105.75,$2965.50,$375115.25,282,$2965.50
2025-02-03,16:46:00,21433.5,BUY,3,0.02h,Stop Loss,$195.75,$3161.25,$375311.00,282,$3161.25
2025-02-03,16:58:00,21383.5,SELL,3,0.02h,Stop Loss,$199.50,$3360.75,$375510.50,282,$3360.75
2025-02-03,17:22:00,21414.5,BUY,3,0.02h,Stop Loss,$79.50,$3440.25,$375590.00,282,$3440.25
2025-02-03,17:32:00,21383.0,SELL,3,0.02h,Stop Loss,$90.75,$3531.00,$375680.75,282,$3531.00
2025-02-03,17:52:00,21401.5,BUY,3,0.02h,Stop Loss,$34.50,$3565.50,$375715.25,282,$3565.50
2025-02-03,18:02:00,21371.25,SELL,3,0.02h,Stop Loss,$259.50,$3825.00,$375974.75,282,$3825.00
2025-02-03,18:05:00,21407.0,BUY,3,0.02h,Break Even,$0.75,$3825.75,$375975.50,282,$3825.75
2025-02-03,18:11:00,21369.0,SELL,3,0.02h,Stop Loss,$117.00,$3942.75,$376092.50,282,$3942.75
2025-02-03,18:14:00,21417.75,BUY,3,0.02h,Stop Loss,$38.25,$3981.00,$376130.75,282,$3981.00
2025-02-03,19:37:00,21486.75,SELL,3,0.02h,Stop Loss,$87.00,$4068.00,$376217.75,282,$4068.00
2025-02-03,19:42:00,21504.75,BUY,3,0.02h,Break Even,$0.75,$4068.75,$376218.50,282,$4068.75
2025-02-03,19:58:00,21486.0,SELL,3,0.02h,Stop Loss,$87.00,$4155.75,$376305.50,282,$4155.75
2025-02-03,20:22:00,21491.75,BUY,3,0.02h,Break Even,$0.75,$4156.50,$376306.25,282,$4156.50
2025-02-03,20:27:00,21471.75,SELL,3,0.02h,Stop Loss,$45.75,$4202.25,$376352.00,282,$4202.25
2025-02-03,21:13:00,21434.0,BUY,3,0.02h,Stop Loss,$-18.00,$4184.25,$376334.00,282,$4184.25
,,,,,,,,,,,
2025-02-04,12:00:00,21400.0,SELL,3,0.02h,Stop Loss,$-18.00,$-18.00,$376316.00,283,$-18.00
2025-02-04,12:33:00,21450.5,BUY,3,0.02h,Break Even,$0.75,$-17.25,$376316.75,283,$-17.25
2025-02-04,12:50:00,21445.0,SELL,3,0.02h,Stop Loss,$57.00,$39.75,$376373.75,283,$39.75
2025-02-04,12:59:00,21477.25,BUY,3,0.02h,Stop Loss,$34.50,$74.25,$376408.25,283,$74.25
2025-02-04,13:01:00,21436.5,SELL,3,0.02h,Stop Loss,$94.50,$168.75,$376502.75,283,$168.75
2025-02-04,13:09:00,21456.75,BUY,3,0.02h,Stop Loss,$143.25,$312.00,$376646.00,283,$312.00
2025-02-04,13:30:00,21459.0,SELL,3,0.02h,Stop Loss,$105.75,$417.75,$376751.75,283,$417.75
2025-02-04,14:08:00,21443.0,BUY,3,0.02h,Stop Loss,$15.75,$433.50,$376767.50,283,$433.50
2025-02-04,14:16:00,21422.25,SELL,3,0.02h,Break Even,$0.75,$434.25,$376768.25,283,$434.25
2025-02-04,14:34:00,21449.0,BUY,3,0.02h,Stop Loss,$188.25,$622.50,$376956.50,283,$622.50
2025-02-04,15:52:00,21645.75,SELL,3,0.02h,Stop Loss,$27.00,$649.50,$376983.50,283,$649.50
2025-02-04,16:04:00,21657.0,BUY,3,0.02h,Stop Loss,$117.00,$766.50,$377100.50,283,$766.50
2025-02-04,16:24:00,21642.5,SELL,3,0.02h,Stop Loss,$-18.00,$748.50,$377082.50,283,$748.50
2025-02-04,16:28:00,21659.5,BUY,3,0.02h,Stop Loss,$210.75,$959.25,$377293.25,283,$959.25
2025-02-04,16:49:00,21663.5,SELL,3,0.02h,Stop Loss,$229.50,$1188.75,$377522.75,283,$1188.75
2025-02-04,17:47:00,21595.25,BUY,3,0.02h,Break Even,$0.75,$1189.50,$377523.50,283,$1189.50
2025-02-04,17:49:00,21584.0,SELL,3,0.02h,Break Even,$0.75,$1190.25,$377524.25,283,$1190.25
2025-02-04,17:51:00,21597.5,BUY,3,0.02h,Stop Loss,$-18.00,$1172.25,$377506.25,283,$1172.25
2025-02-04,18:06:00,21571.5,SELL,3,0.02h,Stop Loss,$-18.00,$1154.25,$377488.25,283,$1154.25
2025-02-04,18:14:00,21605.75,BUY,3,0.02h,Break Even,$0.75,$1155.00,$377489.00,283,$1155.00
2025-02-04,18:59:00,21626.25,SELL,3,0.02h,Stop Loss,$15.75,$1170.75,$377504.75,283,$1170.75
2025-02-04,19:06:00,21645.5,BUY,3,0.02h,Stop Loss,$60.75,$1231.50,$377565.50,283,$1231.50
2025-02-04,19:48:00,21652.5,SELL,3,0.02h,Stop Loss,$19.50,$1251.00,$377585.00,283,$1251.00
2025-02-04,20:13:00,21651.25,BUY,3,0.02h,Break Even,$0.75,$1251.75,$377585.75,283,$1251.75
2025-02-04,20:21:00,21637.0,SELL,3,0.02h,Stop Loss,$12.00,$1263.75,$377597.75,283,$1263.75
2025-02-04,20:38:00,21650.5,BUY,3,0.02h,Break Even,$0.75,$1264.50,$377598.50,283,$1264.50
2025-02-04,21:03:00,21613.5,SELL,3,0.02h,Stop Loss,$282.00,$1546.50,$377880.50,283,$1546.50
,,,,,,,,,,,
2025-02-05,12:43:00,21497.75,BUY,3,0.02h,Break Even,$0.75,$0.75,$377881.25,284,$0.75
2025-02-05,13:17:00,21497.5,SELL,3,0.02h,Break Even,$0.75,$1.50,$377882.00,284,$1.50
2025-02-05,13:21:00,21511.5,BUY,3,0.02h,Stop Loss,$113.25,$114.75,$377995.25,284,$114.75
2025-02-05,13:57:00,21518.75,SELL,3,0.02h,Stop Loss,$-18.00,$96.75,$377977.25,284,$96.75
2025-02-05,13:59:00,21531.5,BUY,3,0.02h,Stop Loss,$-18.00,$78.75,$377959.25,284,$78.75
2025-02-05,14:03:00,21513.5,SELL,3,0.02h,Break Even,$0.75,$79.50,$377960.00,284,$79.50
2025-02-05,14:07:00,21531.5,BUY,3,0.02h,Stop Loss,$-18.00,$61.50,$377942.00,284,$61.50
2025-02-05,14:56:00,21554.75,SELL,3,0.02h,Break Even,$0.75,$62.25,$377942.75,284,$62.25
2025-02-05,15:01:00,21589.25,BUY,3,0.02h,Stop Loss,$15.75,$78.00,$377958.50,284,$78.00
2025-02-05,15:04:00,21520.0,SELL,3,0.02h,Stop Loss,$237.00,$315.00,$378195.50,284,$315.00
2025-02-05,15:26:00,21554.75,BUY,3,0.02h,Stop Loss,$177.00,$492.00,$378372.50,284,$492.00
2025-02-05,16:18:00,21571.75,SELL,3,0.02h,Break Even,$0.75,$492.75,$378373.25,284,$492.75
2025-02-05,16:29:00,21605.0,BUY,3,0.02h,Stop Loss,$214.50,$707.25,$378587.75,284,$707.25
2025-02-05,17:22:00,21708.0,SELL,3,0.02h,Break Even,$0.75,$708.00,$378588.50,284,$708.00
2025-02-05,17:49:00,21710.25,BUY,3,0.02h,Break Even,$0.75,$708.75,$378589.25,284,$708.75
2025-02-05,17:52:00,21689.25,SELL,3,0.02h,Stop Loss,$-18.00,$690.75,$378571.25,284,$690.75
2025-02-05,18:02:00,21713.0,BUY,3,0.02h,Break Even,$0.75,$691.50,$378572.00,284,$691.50
2025-02-05,18:09:00,21699.75,SELL,3,0.02h,Stop Loss,$15.75,$707.25,$378587.75,284,$707.25
2025-02-05,18:22:00,21705.75,BUY,3,0.02h,Stop Loss,$-18.00,$689.25,$378569.75,284,$689.25
2025-02-05,18:23:00,21701.0,SELL,3,0.02h,Stop Loss,$23.25,$712.50,$378593.00,284,$712.50
2025-02-05,18:37:00,21704.5,BUY,3,0.02h,Stop Loss,$30.75,$743.25,$378623.75,284,$743.25
2025-02-05,18:53:00,21695.0,SELL,3,0.02h,Stop Loss,$87.00,$830.25,$378710.75,284,$830.25
2025-02-05,18:59:00,21709.75,BUY,3,0.02h,Break Even,$0.75,$831.00,$378711.50,284,$831.00
2025-02-05,19:29:00,21718.75,SELL,3,0.02h,Break Even,$0.75,$831.75,$378712.25,284,$831.75
2025-02-05,20:02:00,21720.25,BUY,3,0.02h,Stop Loss,$15.75,$847.50,$378728.00,284,$847.50
2025-02-05,20:38:00,21729.25,SELL,3,0.02h,Stop Loss,$53.25,$900.75,$378781.25,284,$900.75
2025-02-05,20:56:00,21743.0,BUY,3,0.02h,Stop Loss,$113.25,$1014.00,$378894.50,284,$1014.00
2025-02-05,21:31:00,21764.75,SELL,3,0.02h,Stop Loss,$19.50,$1033.50,$378914.00,284,$1033.50
2025-02-05,21:56:00,21770.25,BUY,3,0.02h,Stop Loss,$-18.00,$1015.50,$378896.00,284,$1015.50
,,,,,,,,,,,
2025-02-06,12:00:00,21725.75,SELL,3,0.02h,Stop Loss,$143.25,$143.25,$379039.25,285,$143.25
2025-02-06,12:24:00,21734.25,BUY,3,0.02h,Break Even,$0.75,$144.00,$379040.00,285,$144.00
2025-02-06,13:32:00,21761.0,SELL,3,0.02h,Stop Loss,$12.00,$156.00,$379052.00,285,$156.00
2025-02-06,13:56:00,21771.25,BUY,3,0.02h,Stop Loss,$45.75,$201.75,$379097.75,285,$201.75
2025-02-06,14:16:00,21766.0,SELL,3,0.02h,Break Even,$0.75,$202.50,$379098.50,285,$202.50
2025-02-06,14:19:00,21772.5,BUY,3,0.02h,Stop Loss,$12.00,$214.50,$379110.50,285,$214.50
2025-02-06,14:32:00,21742.25,SELL,3,0.02h,Stop Loss,$15.75,$230.25,$379126.25,285,$230.25
2025-02-06,14:45:00,21788.75,BUY,3,0.02h,Stop Loss,$244.50,$474.75,$379370.75,285,$474.75
2025-02-06,15:03:00,21779.5,SELL,3,0.02h,Break Even,$0.75,$475.50,$379371.50,285,$475.50
2025-02-06,15:09:00,21800.75,BUY,3,0.02h,Stop Loss,$259.50,$735.00,$379631.00,285,$735.00
2025-02-06,15:27:00,21791.25,SELL,3,0.02h,Stop Loss,$42.00,$777.00,$379673.00,285,$777.00
2025-02-06,15:39:00,21832.0,BUY,3,0.02h,Break Even,$0.75,$777.75,$379673.75,285,$777.75
2025-02-06,15:40:00,21763.25,SELL,3,0.02h,Stop Loss,$15.75,$793.50,$379689.50,285,$793.50
2025-02-06,16:04:00,21785.0,BUY,3,0.02h,Break Even,$0.75,$794.25,$379690.25,285,$794.25
2025-02-06,16:06:00,21775.0,SELL,3,0.02h,Stop Loss,$-18.00,$776.25,$379672.25,285,$776.25
2025-02-06,16:07:00,21777.0,BUY,3,0.02h,Stop Loss,$53.25,$829.50,$379725.50,285,$829.50
2025-02-06,16:08:00,21772.75,SELL,3,0.02h,Stop Loss,$12.00,$841.50,$379737.50,285,$841.50
2025-02-06,16:09:00,21782.0,BUY,3,0.02h,Stop Loss,$79.50,$921.00,$379817.00,285,$921.00
2025-02-06,16:33:00,21793.75,SELL,3,0.02h,Stop Loss,$72.00,$993.00,$379889.00,285,$993.00
2025-02-06,17:10:00,21776.0,BUY,3,0.02h,Stop Loss,$-18.00,$975.00,$379871.00,285,$975.00
2025-02-06,17:11:00,21772.25,SELL,3,0.02h,Stop Loss,$42.00,$1017.00,$379913.00,285,$1017.00
2025-02-06,17:18:00,21786.0,BUY,3,0.02h,Stop Loss,$23.25,$1040.25,$379936.25,285,$1040.25
2025-02-06,17:34:00,21784.75,SELL,3,0.02h,Break Even,$0.75,$1041.00,$379937.00,285,$1041.00
2025-02-06,17:36:00,21788.75,BUY,3,0.02h,Break Even,$0.75,$1041.75,$379937.75,285,$1041.75
2025-02-06,18:17:00,21813.75,SELL,3,0.02h,Stop Loss,$124.50,$1166.25,$380062.25,285,$1166.25
2025-02-06,18:19:00,21822.5,BUY,3,0.02h,Break Even,$0.75,$1167.00,$380063.00,285,$1167.00
2025-02-06,18:39:00,21817.25,SELL,3,0.02h,Break Even,$0.75,$1167.75,$380063.75,285,$1167.75
2025-02-06,18:50:00,21828.75,BUY,3,0.02h,Break Even,$0.75,$1168.50,$380064.50,285,$1168.50
2025-02-06,18:51:00,21822.5,SELL,3,0.02h,Stop Loss,$12.00,$1180.50,$380076.50,285,$1180.50
2025-02-06,19:10:00,21823.5,BUY,3,0.02h,Stop Loss,$38.25,$1218.75,$380114.75,285,$1218.75
2025-02-06,19:23:00,21816.75,SELL,3,0.02h,Stop Loss,$-18.00,$1200.75,$380096.75,285,$1200.75
2025-02-06,19:54:00,21768.5,BUY,3,0.02h,Break Even,$0.75,$1201.50,$380097.50,285,$1201.50
2025-02-06,19:59:00,21750.5,SELL,3,0.02h,Stop Loss,$113.25,$1314.75,$380210.75,285,$1314.75
2025-02-06,20:14:00,21759.75,BUY,3,0.02h,Break Even,$0.75,$1315.50,$380211.50,285,$1315.50
2025-02-06,21:06:00,21819.75,SELL,3,0.02h,Stop Loss,$165.75,$1481.25,$380377.25,285,$1481.25
2025-02-06,21:20:00,21844.0,BUY,3,0.02h,Stop Loss,$42.00,$1523.25,$380419.25,285,$1523.25
2025-02-06,21:47:00,21840.25,SELL,3,0.02h,Stop Loss,$42.00,$1565.25,$380461.25,285,$1565.25
2025-02-06,22:01:00,21844.25,BUY,3,13.98h,Stop Loss,$379.50,$1944.75,$380840.75,285,$1944.75
,,,,,,,,,,,
2025-02-07,12:31:00,21859.75,SELL,3,0.02h,Break Even,$0.75,$0.75,$380841.50,286,$0.75
2025-02-07,12:46:00,21870.5,BUY,3,0.02h,Stop Loss,$-18.00,$-17.25,$380823.50,286,$-17.25
2025-02-07,13:00:00,21865.0,SELL,3,0.02h,Break Even,$0.75,$-16.50,$380824.25,286,$-16.50
2025-02-07,13:18:00,21869.5,BUY,3,0.02h,Stop Loss,$-18.00,$-34.50,$380806.25,286,$-34.50
2025-02-07,13:21:00,21853.25,SELL,3,0.02h,Break Even,$0.75,$-33.75,$380807.00,286,$-33.75
2025-02-07,13:41:00,21878.25,BUY,3,0.02h,Stop Loss,$102.00,$68.25,$380909.00,286,$68.25
2025-02-07,14:58:00,21905.25,SELL,3,0.02h,Stop Loss,$87.00,$155.25,$380996.00,286,$155.25
2025-02-07,15:38:00,21792.0,BUY,3,0.02h,Stop Loss,$45.75,$201.00,$381041.75,286,$201.00
2025-02-07,15:45:00,21751.0,SELL,3,0.02h,Stop Loss,$117.00,$318.00,$381158.75,286,$318.00
2025-02-07,15:48:00,21775.5,BUY,3,0.02h,Stop Loss,$23.25,$341.25,$381182.00,286,$341.25
2025-02-07,15:54:00,21654.5,SELL,3,0.02h,Stop Loss,$537.00,$878.25,$381719.00,286,$878.25
2025-02-07,16:21:00,21730.5,BUY,3,0.02h,Stop Loss,$64.50,$942.75,$381783.50,286,$942.75
2025-02-07,16:27:00,21679.25,SELL,3,0.02h,Stop Loss,$214.50,$1157.25,$381998.00,286,$1157.25
2025-02-07,17:10:00,21658.25,BUY,3,0.02h,Break Even,$0.75,$1158.00,$381998.75,286,$1158.00
2025-02-07,17:19:00,21613.5,SELL,3,0.02h,Stop Loss,$244.50,$1402.50,$382243.25,286,$1402.50
2025-02-07,17:38:00,21644.75,BUY,3,0.02h,Stop Loss,$210.75,$1613.25,$382454.00,286,$1613.25
2025-02-07,18:42:00,21688.75,SELL,3,0.02h,Stop Loss,$105.75,$1719.00,$382559.75,286,$1719.00
2025-02-07,19:41:00,21604.5,BUY,3,0.02h,Stop Loss,$-18.00,$1701.00,$382541.75,286,$1701.00
2025-02-07,20:02:00,21583.5,SELL,3,0.02h,Stop Loss,$34.50,$1735.50,$382576.25,286,$1735.50
2025-02-07,20:35:00,21596.0,BUY,3,0.02h,Break Even,$0.75,$1736.25,$382577.00,286,$1736.25
2025-02-07,21:06:00,21588.25,SELL,3,0.02h,Stop Loss,$-18.00,$1718.25,$382559.00,286,$1718.25
,,,,,,,,,,,
2025-02-10,12:00:00,21742.25,BUY,3,0.02h,Stop Loss,$15.75,$15.75,$382574.75,287,$15.75
2025-02-10,14:12:00,21773.0,SELL,3,0.02h,Stop Loss,$19.50,$35.25,$382594.25,287,$35.25
2025-02-10,14:39:00,21777.5,BUY,3,0.02h,Stop Loss,$94.50,$129.75,$382688.75,287,$129.75
2025-02-10,15:58:00,21866.75,SELL,3,0.02h,Stop Loss,$-18.00,$111.75,$382670.75,287,$111.75
2025-02-10,16:01:00,21879.0,BUY,3,0.02h,Stop Loss,$60.75,$172.50,$382731.50,287,$172.50
2025-02-10,16:08:00,21866.0,SELL,3,0.02h,Stop Loss,$94.50,$267.00,$382826.00,287,$267.00
2025-02-10,16:55:00,21855.5,BUY,3,0.02h,Stop Loss,$102.00,$369.00,$382928.00,287,$369.00
2025-02-10,17:06:00,21846.75,SELL,3,0.02h,Break Even,$0.75,$369.75,$382928.75,287,$369.75
2025-02-10,17:35:00,21841.25,BUY,3,0.02h,Stop Loss,$45.75,$415.50,$382974.50,287,$415.50
2025-02-10,18:36:00,21867.0,SELL,3,0.02h,Break Even,$0.75,$416.25,$382975.25,287,$416.25
2025-02-10,18:37:00,21869.75,BUY,3,0.02h,Break Even,$0.75,$417.00,$382976.00,287,$417.00
2025-02-10,18:41:00,21863.5,SELL,3,0.02h,Stop Loss,$12.00,$429.00,$382988.00,287,$429.00
2025-02-10,18:50:00,21870.75,BUY,3,0.02h,Stop Loss,$23.25,$452.25,$383011.25,287,$452.25
2025-02-10,19:03:00,21865.5,SELL,3,0.02h,Stop Loss,$-18.00,$434.25,$382993.25,287,$434.25
2025-02-10,19:13:00,21874.5,BUY,3,0.02h,Stop Loss,$34.50,$468.75,$383027.75,287,$468.75
2025-02-10,19:28:00,21866.0,SELL,3,0.02h,Stop Loss,$27.00,$495.75,$383054.75,287,$495.75
2025-02-10,20:07:00,21864.75,BUY,3,0.02h,Stop Loss,$57.00,$552.75,$383111.75,287,$552.75
2025-02-10,20:25:00,21860.5,SELL,3,0.02h,Stop Loss,$-18.00,$534.75,$383093.75,287,$534.75
2025-02-10,21:32:00,21835.25,BUY,3,0.03h,Break Even,$0.75,$535.50,$383094.50,287,$535.50
2025-02-10,21:57:00,21834.75,SELL,3,0.02h,Stop Loss,$-18.00,$517.50,$383076.50,287,$517.50
2025-02-10,21:59:00,21837.0,BUY,3,0.02h,Stop Loss,$-18.00,$499.50,$383058.50,287,$499.50
,,,,,,,,,,,
2025-02-11,12:00:00,21763.75,SELL,3,0.02h,Stop Loss,$128.25,$128.25,$383186.75,288,$128.25
2025-02-11,12:46:00,21749.5,BUY,3,0.02h,Stop Loss,$-18.00,$110.25,$383168.75,288,$110.25
2025-02-11,12:56:00,21743.25,SELL,3,0.02h,Break Even,$0.75,$111.00,$383169.50,288,$111.00
2025-02-11,13:02:00,21750.0,BUY,3,0.02h,Break Even,$0.75,$111.75,$383170.25,288,$111.75
2025-02-11,13:09:00,21743.75,SELL,3,0.02h,Stop Loss,$-18.00,$93.75,$383152.25,288,$93.75
2025-02-11,14:17:00,21702.25,BUY,3,0.02h,Stop Loss,$-18.00,$75.75,$383134.25,288,$75.75
2025-02-11,14:18:00,21694.75,SELL,3,0.02h,Break Even,$0.75,$76.50,$383135.00,288,$76.50
2025-02-11,14:19:00,21700.75,BUY,3,0.02h,Break Even,$0.75,$77.25,$383135.75,288,$77.25
2025-02-11,14:24:00,21695.75,SELL,3,0.02h,Stop Loss,$30.75,$108.00,$383166.50,288,$108.00
2025-02-11,14:28:00,21706.5,BUY,3,0.02h,Break Even,$0.75,$108.75,$383167.25,288,$108.75
2025-02-11,16:03:00,21837.0,SELL,3,0.02h,Stop Loss,$-18.00,$90.75,$383149.25,288,$90.75
2025-02-11,16:40:00,21836.75,BUY,3,0.02h,Break Even,$0.75,$91.50,$383150.00,288,$91.50
2025-02-11,16:49:00,21827.75,SELL,3,0.02h,Break Even,$0.75,$92.25,$383150.75,288,$92.25
2025-02-11,17:24:00,21783.5,BUY,3,0.02h,Stop Loss,$38.25,$130.50,$383189.00,288,$130.50
2025-02-11,17:45:00,21768.25,SELL,3,0.02h,Break Even,$0.75,$131.25,$383189.75,288,$131.25
2025-02-11,18:19:00,21772.5,BUY,3,0.02h,Break Even,$0.75,$132.00,$383190.50,288,$132.00
2025-02-11,18:57:00,21802.25,SELL,3,0.02h,Break Even,$0.75,$132.75,$383191.25,288,$132.75
2025-02-11,19:05:00,21814.25,BUY,3,0.02h,Break Even,$0.75,$133.50,$383192.00,288,$133.50
2025-02-11,19:12:00,21797.75,SELL,3,0.02h,Stop Loss,$23.25,$156.75,$383215.25,288,$156.75
2025-02-11,19:39:00,21805.0,BUY,3,0.02h,Stop Loss,$64.50,$221.25,$383279.75,288,$221.25
2025-02-11,20:11:00,21823.0,SELL,3,0.02h,Stop Loss,$15.75,$237.00,$383295.50,288,$237.00
2025-02-11,21:05:00,21793.25,BUY,3,0.02h,Stop Loss,$-18.00,$219.00,$383277.50,288,$219.00
2025-02-11,21:07:00,21784.5,SELL,3,0.02h,Break Even,$0.75,$219.75,$383278.25,288,$219.75
2025-02-11,21:09:00,21788.0,BUY,3,0.02h,Break Even,$0.75,$220.50,$383279.00,288,$220.50
2025-02-11,21:37:00,21790.5,SELL,3,0.02h,Stop Loss,$-18.00,$202.50,$383261.00,288,$202.50
2025-02-11,21:39:00,21794.75,BUY,3,0.02h,Stop Loss,$-18.00,$184.50,$383243.00,288,$184.50
2025-02-11,21:44:00,21789.5,SELL,3,0.02h,Stop Loss,$-18.00,$166.50,$383225.00,288,$166.50
2025-02-11,21:52:00,21793.25,BUY,3,0.02h,Stop Loss,$-18.00,$148.50,$383207.00,288,$148.50
,,,,,,,,,,,
2025-02-12,12:01:00,21789.0,SELL,3,0.02h,Stop Loss,$-18.00,$-18.00,$383189.00,289,$-18.00
2025-02-12,12:08:00,21794.5,BUY,3,0.02h,Stop Loss,$-18.00,$-36.00,$383171.00,289,$-36.00
2025-02-12,12:10:00,21790.5,SELL,3,0.02h,Stop Loss,$-18.00,$-54.00,$383153.00,289,$-54.00
2025-02-12,12:12:00,21794.75,BUY,3,0.02h,Break Even,$0.75,$-53.25,$383153.75,289,$-53.25
2025-02-12,13:22:00,21818.75,SELL,3,0.02h,Stop Loss,$34.50,$-18.75,$383188.25,289,$-18.75
2025-02-12,14:23:00,21557.5,BUY,3,0.02h,Break Even,$0.75,$-18.00,$383189.00,289,$-18.00
2025-02-12,15:05:00,21615.0,SELL,3,0.02h,Stop Loss,$57.00,$39.00,$383246.00,289,$39.00
2025-02-12,15:19:00,21663.5,BUY,3,0.02h,Stop Loss,$117.00,$156.00,$383363.00,289,$156.00
2025-02-12,15:51:00,21700.5,SELL,3,0.02h,Break Even,$0.75,$156.75,$383363.75,289,$156.75
2025-02-12,15:53:00,21716.0,BUY,3,0.02h,Break Even,$0.75,$157.50,$383364.50,289,$157.50
2025-02-12,16:08:00,21697.25,SELL,3,0.02h,Stop Loss,$105.75,$263.25,$383470.25,289,$263.25
2025-02-12,16:37:00,21695.5,BUY,3,0.02h,Stop Loss,$124.50,$387.75,$383594.75,289,$387.75
2025-02-12,17:34:00,21773.75,SELL,3,0.02h,Stop Loss,$-18.00,$369.75,$383576.75,289,$369.75
2025-02-12,17:49:00,21791.75,BUY,3,0.02h,Break Even,$0.75,$370.50,$383577.50,289,$370.50
2025-02-12,18:22:00,21799.25,SELL,3,0.02h,Break Even,$0.75,$371.25,$383578.25,289,$371.25
2025-02-12,18:34:00,21809.0,BUY,3,0.02h,Break Even,$0.75,$372.00,$383579.00,289,$372.00
2025-02-12,18:40:00,21798.5,SELL,3,0.02h,Break Even,$0.75,$372.75,$383579.75,289,$372.75
2025-02-12,18:56:00,21800.0,BUY,3,0.02h,Stop Loss,$27.00,$399.75,$383606.75,289,$399.75
2025-02-12,19:01:00,21790.25,SELL,3,0.02h,Break Even,$0.75,$400.50,$383607.50,289,$400.50
2025-02-12,19:25:00,21785.5,BUY,3,0.02h,Stop Loss,$-18.00,$382.50,$383589.50,289,$382.50
2025-02-12,20:11:00,21821.5,SELL,3,0.02h,Stop Loss,$-18.00,$364.50,$383571.50,289,$364.50
2025-02-12,20:12:00,21825.75,BUY,3,0.02h,Stop Loss,$34.50,$399.00,$383606.00,289,$399.00
2025-02-12,20:15:00,21819.75,SELL,3,0.02h,Stop Loss,$49.50,$448.50,$383655.50,289,$448.50
2025-02-12,20:22:00,21823.75,BUY,3,0.02h,Break Even,$0.75,$449.25,$383656.25,289,$449.25
2025-02-12,20:30:00,21815.5,SELL,3,0.02h,Stop Loss,$27.00,$476.25,$383683.25,289,$476.25
2025-02-12,21:01:00,21810.5,BUY,3,0.02h,Break Even,$0.75,$477.00,$383684.00,289,$477.00
2025-02-12,21:03:00,21792.25,SELL,3,0.02h,Break Even,$0.75,$477.75,$383684.75,289,$477.75
2025-02-12,21:06:00,21813.75,BUY,3,0.02h,Stop Loss,$57.00,$534.75,$383741.75,289,$534.75
,,,,,,,,,,,
2025-02-13,12:01:00,21815.0,SELL,3,0.02h,Stop Loss,$64.50,$64.50,$383806.25,290,$64.50
2025-02-13,12:28:00,21817.5,BUY,3,0.02h,Stop Loss,$-18.00,$46.50,$383788.25,290,$46.50
2025-02-13,12:49:00,21810.75,SELL,3,0.02h,Stop Loss,$-18.00,$28.50,$383770.25,290,$28.50
2025-02-13,12:58:00,21822.5,BUY,3,0.02h,Break Even,$0.75,$29.25,$383771.00,290,$29.25
2025-02-13,13:06:00,21813.0,SELL,3,0.02h,Stop Loss,$34.50,$63.75,$383805.50,290,$63.75
2025-02-13,13:22:00,21820.5,BUY,3,0.02h,Break Even,$0.75,$64.50,$383806.25,290,$64.50
2025-02-13,14:16:00,21866.0,SELL,3,0.02h,Stop Loss,$45.75,$110.25,$383852.00,290,$110.25
2025-02-13,14:24:00,21872.5,BUY,3,0.02h,Stop Loss,$72.00,$182.25,$383924.00,290,$182.25
2025-02-13,14:41:00,21863.5,SELL,3,0.02h,Stop Loss,$199.50,$381.75,$384123.50,290,$381.75
2025-02-13,14:54:00,21889.75,BUY,3,0.02h,Stop Loss,$27.00,$408.75,$384150.50,290,$408.75
2025-02-13,16:21:00,22033.0,SELL,3,0.02h,Stop Loss,$120.75,$529.50,$384271.25,290,$529.50
2025-02-13,17:09:00,21992.25,BUY,3,0.02h,Break Even,$0.75,$530.25,$384272.00,290,$530.25
2025-02-13,17:13:00,21972.25,SELL,3,0.02h,Stop Loss,$60.75,$591.00,$384332.75,290,$591.00
2025-02-13,17:42:00,21975.5,BUY,3,0.02h,Stop Loss,$23.25,$614.25,$384356.00,290,$614.25
2025-02-13,17:58:00,21961.5,SELL,3,0.02h,Stop Loss,$147.00,$761.25,$384503.00,290,$761.25
2025-02-13,18:36:00,21955.75,BUY,3,0.02h,Stop Loss,$79.50,$840.75,$384582.50,290,$840.75
2025-02-13,18:44:00,21937.5,SELL,3,0.02h,Stop Loss,$79.50,$920.25,$384662.00,290,$920.25
2025-02-13,18:46:00,21956.75,BUY,3,0.02h,Stop Loss,$135.75,$1056.00,$384797.75,290,$1056.00
2025-02-13,20:32:00,22072.75,SELL,3,0.02h,Stop Loss,$-18.00,$1038.00,$384779.75,290,$1038.00
2025-02-13,20:47:00,22076.75,BUY,3,0.02h,Stop Loss,$12.00,$1050.00,$384791.75,290,$1050.00
2025-02-13,21:07:00,22078.5,SELL,3,0.02h,Break Even,$0.75,$1050.75,$384792.50,290,$1050.75
2025-02-13,21:42:00,22083.5,BUY,3,0.03h,Stop Loss,$12.00,$1062.75,$384804.50,290,$1062.75
2025-02-13,21:57:00,22081.0,SELL,3,0.02h,Stop Loss,$-18.00,$1044.75,$384786.50,290,$1044.75
,,,,,,,,,,,
2025-02-14,12:16:00,22083.25,BUY,3,0.02h,Break Even,$0.75,$0.75,$384787.25,291,$0.75
2025-02-14,12:44:00,22073.25,SELL,3,0.02h,Break Even,$0.75,$1.50,$384788.00,291,$1.50
2025-02-14,12:58:00,22078.5,BUY,3,0.02h,Stop Loss,$23.25,$24.75,$384811.25,291,$24.75
2025-02-14,13:30:00,22081.75,SELL,3,0.02h,Stop Loss,$27.00,$51.75,$384838.25,291,$51.75
2025-02-14,13:32:00,22097.5,BUY,3,0.02h,Stop Loss,$120.75,$172.50,$384959.00,291,$172.50
2025-02-14,14:12:00,22100.5,SELL,3,0.02h,Stop Loss,$45.75,$218.25,$385004.75,291,$218.25
2025-02-14,14:21:00,22106.75,BUY,3,0.02h,Stop Loss,$42.00,$260.25,$385046.75,291,$260.25
2025-02-14,14:36:00,22100.5,SELL,3,0.02h,Stop Loss,$90.75,$351.00,$385137.50,291,$351.00
2025-02-14,14:48:00,22122.25,BUY,3,0.02h,Stop Loss,$79.50,$430.50,$385217.00,291,$430.50
2025-02-14,15:32:00,22133.5,SELL,3,0.02h,Stop Loss,$90.75,$521.25,$385307.75,291,$521.25
2025-02-14,15:51:00,22134.0,BUY,3,0.02h,Stop Loss,$34.50,$555.75,$385342.25,291,$555.75
2025-02-14,16:18:00,22145.0,SELL,3,0.02h,Stop Loss,$113.25,$669.00,$385455.50,291,$669.00
2025-02-14,16:46:00,22138.0,BUY,3,0.02h,Break Even,$0.75,$669.75,$385456.25,291,$669.75
2025-02-14,16:48:00,22123.75,SELL,3,0.02h,Stop Loss,$45.75,$715.50,$385502.00,291,$715.50
2025-02-14,16:58:00,22134.25,BUY,3,0.02h,Stop Loss,$75.75,$791.25,$385577.75,291,$791.25
2025-02-14,17:08:00,22126.0,SELL,3,0.02h,Stop Loss,$83.25,$874.50,$385661.00,291,$874.50
2025-02-14,17:48:00,22121.5,BUY,3,0.02h,Stop Loss,$75.75,$950.25,$385736.75,291,$950.25
2025-02-14,18:25:00,22155.0,SELL,3,0.02h,Stop Loss,$53.25,$1003.50,$385790.00,291,$1003.50
2025-02-14,18:32:00,22164.75,BUY,3,0.02h,Stop Loss,$64.50,$1068.00,$385854.50,291,$1068.00
2025-02-14,19:05:00,22184.5,SELL,3,0.02h,Stop Loss,$-18.00,$1050.00,$385836.50,291,$1050.00
2025-02-14,19:08:00,22192.5,BUY,3,0.02h,Stop Loss,$-18.00,$1032.00,$385818.50,291,$1032.00
2025-02-14,19:22:00,22187.5,SELL,3,0.02h,Break Even,$0.75,$1032.75,$385819.25,291,$1032.75
2025-02-14,20:00:00,22179.0,BUY,3,0.02h,Stop Loss,$-18.00,$1014.75,$385801.25,291,$1014.75
2025-02-14,20:01:00,22166.5,SELL,3,0.02h,Break Even,$0.75,$1015.50,$385802.00,291,$1015.50
2025-02-14,20:14:00,22176.5,BUY,3,0.02h,Break Even,$0.75,$1016.25,$385802.75,291,$1016.25
2025-02-14,21:02:00,22191.25,SELL,3,0.02h,Stop Loss,$-18.00,$998.25,$385784.75,291,$998.25
2025-02-14,21:07:00,22207.5,BUY,3,0.02h,Break Even,$0.75,$999.00,$385785.50,291,$999.00
2025-02-14,21:34:00,22200.25,SELL,3,0.02h,Break Even,$0.75,$999.75,$385786.25,291,$999.75
2025-02-14,21:59:00,22206.75,BUY,3,0.02h,Break Even,$0.75,$1000.50,$385787.00,291,$1000.50
2025-02-14,22:00:00,22203.0,SELL,3,62.00h,Stop Loss,$-18.00,$982.50,$385769.00,291,$982.50
,,,,,,,,,,,
2025-02-17,12:00:00,22243.5,BUY,3,0.02h,Break Even,$0.75,$0.75,$385769.75,292,$0.75
2025-02-17,12:54:00,22251.25,SELL,3,0.02h,Stop Loss,$12.00,$12.75,$385781.75,292,$12.75
2025-02-17,13:10:00,22252.0,BUY,3,0.02h,Break Even,$0.75,$13.50,$385782.50,292,$13.50
2025-02-17,13:31:00,22250.25,SELL,3,0.02h,Stop Loss,$15.75,$29.25,$385798.25,292,$29.25
2025-02-17,13:50:00,22249.5,BUY,3,0.02h,Break Even,$0.75,$30.00,$385799.00,292,$30.00
2025-02-17,14:16:00,22250.25,SELL,3,0.02h,Stop Loss,$-18.00,$12.00,$385781.00,292,$12.00
2025-02-17,15:05:00,22216.0,BUY,3,0.02h,Break Even,$0.75,$12.75,$385781.75,292,$12.75
2025-02-17,16:35:00,22239.5,SELL,3,0.02h,Stop Loss,$-18.00,$-5.25,$385763.75,292,$-5.25
2025-02-17,16:51:00,22243.0,BUY,3,0.02h,Stop Loss,$-18.00,$-23.25,$385745.75,292,$-23.25
2025-02-17,16:55:00,22239.25,SELL,3,0.02h,Stop Loss,$15.75,$-7.50,$385761.50,292,$-7.50
2025-02-17,17:30:00,22231.0,BUY,3,0.02h,Break Even,$0.75,$-6.75,$385762.25,292,$-6.75
2025-02-17,17:48:00,22231.75,SELL,3,0.02h,Stop Loss,$-18.00,$-24.75,$385744.25,292,$-24.75
2025-02-17,17:49:00,22235.75,BUY,3,0.02h,Stop Loss,$12.00,$-12.75,$385756.25,292,$-12.75
2025-02-17,17:59:00,22233.25,SELL,3,0.02h,Break Even,$0.75,$-12.00,$385757.00,292,$-12.00
,,,,,,,,,,,
2025-02-18,12:00:00,22276.75,BUY,3,0.02h,Stop Loss,$-18.00,$-18.00,$385739.00,293,$-18.00
2025-02-18,12:50:00,22288.75,SELL,3,0.02h,Break Even,$0.75,$-17.25,$385739.75,293,$-17.25
2025-02-18,13:18:00,22288.0,BUY,3,0.02h,Break Even,$0.75,$-16.50,$385740.50,293,$-16.50
2025-02-18,14:22:00,22305.5,SELL,3,0.02h,Stop Loss,$-18.00,$-34.50,$385722.50,293,$-34.50
2025-02-18,15:44:00,22170.25,BUY,3,0.02h,Break Even,$0.75,$-33.75,$385723.25,293,$-33.75
2025-02-18,15:46:00,22154.25,SELL,3,0.02h,Stop Loss,$255.75,$222.00,$385979.00,293,$222.00
2025-02-18,15:53:00,22173.25,BUY,3,0.02h,Stop Loss,$19.50,$241.50,$385998.50,293,$241.50
2025-02-18,16:23:00,22168.75,SELL,3,0.02h,Stop Loss,$12.00,$253.50,$386010.50,293,$253.50
2025-02-18,16:29:00,22199.25,BUY,3,0.02h,Stop Loss,$45.75,$299.25,$386056.25,293,$299.25
2025-02-18,16:34:00,22181.0,SELL,3,0.02h,Break Even,$0.75,$300.00,$386057.00,293,$300.00
2025-02-18,16:48:00,22203.5,BUY,3,0.02h,Stop Loss,$42.00,$342.00,$386099.00,293,$342.00
2025-02-18,17:01:00,22181.5,SELL,3,0.02h,Break Even,$0.75,$342.75,$386099.75,293,$342.75
2025-02-18,17:33:00,22183.75,BUY,3,0.02h,Stop Loss,$-18.00,$324.75,$386081.75,293,$324.75
2025-02-18,18:10:00,22182.5,SELL,3,0.02h,Stop Loss,$27.00,$351.75,$386108.75,293,$351.75
2025-02-18,18:52:00,22162.0,BUY,3,0.02h,Stop Loss,$49.50,$401.25,$386158.25,293,$401.25
2025-02-18,19:08:00,22124.0,SELL,3,0.02h,Stop Loss,$267.00,$668.25,$386425.25,293,$668.25
2025-02-18,19:26:00,22151.0,BUY,3,0.02h,Stop Loss,$12.00,$680.25,$386437.25,293,$680.25
2025-02-18,20:17:00,22168.75,SELL,3,0.02h,Stop Loss,$-18.00,$662.25,$386419.25,293,$662.25
2025-02-18,20:26:00,22178.75,BUY,3,0.02h,Break Even,$0.75,$663.00,$386420.00,293,$663.00
2025-02-18,20:30:00,22170.0,SELL,3,0.02h,Stop Loss,$15.75,$678.75,$386435.75,293,$678.75
2025-02-18,20:33:00,22177.0,BUY,3,0.02h,Stop Loss,$-18.00,$660.75,$386417.75,293,$660.75
2025-02-18,20:35:00,22170.0,SELL,3,0.02h,Stop Loss,$49.50,$710.25,$386467.25,293,$710.25
2025-02-18,20:43:00,22174.75,BUY,3,0.02h,Break Even,$0.75,$711.00,$386468.00,293,$711.00
2025-02-18,20:44:00,22164.75,SELL,3,0.02h,Break Even,$0.75,$711.75,$386468.75,293,$711.75
2025-02-18,20:53:00,22176.5,BUY,3,0.02h,Break Even,$0.75,$712.50,$386469.50,293,$712.50
2025-02-18,21:34:00,22221.5,SELL,3,0.02h,Break Even,$0.75,$713.25,$386470.25,293,$713.25
2025-02-18,22:00:00,22225.0,BUY,3,14.00h,Stop Loss,$-18.00,$695.25,$386452.25,293,$695.25
,,,,,,,,,,,
2025-02-19,12:00:00,22212.75,SELL,3,0.02h,Break Even,$0.75,$0.75,$386453.00,294,$0.75
2025-02-19,12:02:00,22235.5,BUY,3,0.02h,Break Even,$0.75,$1.50,$386453.75,294,$1.50
2025-02-19,12:35:00,22239.25,SELL,3,0.02h,Stop Loss,$-18.00,$-16.50,$386435.75,294,$-16.50
2025-02-19,12:37:00,22244.25,BUY,3,0.02h,Stop Loss,$-18.00,$-34.50,$386417.75,294,$-34.50
2025-02-19,12:38:00,22238.0,SELL,3,0.02h,Break Even,$0.75,$-33.75,$386418.50,294,$-33.75
2025-02-19,12:44:00,22243.0,BUY,3,0.02h,Stop Loss,$-18.00,$-51.75,$386400.50,294,$-51.75
2025-02-19,12:46:00,22240.5,SELL,3,0.02h,Stop Loss,$-18.00,$-69.75,$386382.50,294,$-69.75
2025-02-19,12:47:00,22248.25,BUY,3,0.02h,Stop Loss,$45.75,$-24.00,$386428.25,294,$-24.00
2025-02-19,13:00:00,22228.5,SELL,3,0.02h,Stop Loss,$124.50,$100.50,$386552.75,294,$100.50
2025-02-19,13:50:00,22206.5,BUY,3,0.02h,Stop Loss,$-18.00,$82.50,$386534.75,294,$82.50
2025-02-19,14:02:00,22198.5,SELL,3,0.02h,Stop Loss,$-18.00,$64.50,$386516.75,294,$64.50
2025-02-19,14:03:00,22208.0,BUY,3,0.02h,Break Even,$0.75,$65.25,$386517.50,294,$65.25
2025-02-19,14:18:00,22196.25,SELL,3,0.02h,Break Even,$0.75,$66.00,$386518.25,294,$66.00
2025-02-19,14:37:00,22215.75,BUY,3,0.02h,Stop Loss,$38.25,$104.25,$386556.50,294,$104.25
2025-02-19,14:42:00,22187.0,SELL,3,0.02h,Stop Loss,$83.25,$187.50,$386639.75,294,$187.50
2025-02-19,15:31:00,22162.0,BUY,3,0.02h,Stop Loss,$357.00,$544.50,$386996.75,294,$544.50
2025-02-19,15:57:00,22157.0,SELL,3,0.02h,Stop Loss,$109.50,$654.00,$387106.25,294,$654.00
2025-02-19,16:03:00,22193.25,BUY,3,0.02h,Stop Loss,$49.50,$703.50,$387155.75,294,$703.50
2025-02-19,17:17:00,22235.25,SELL,3,0.02h,Break Even,$0.75,$704.25,$387156.50,294,$704.25
2025-02-19,17:44:00,22234.25,BUY,3,0.02h,Stop Loss,$-18.00,$686.25,$387138.50,294,$686.25
2025-02-19,18:06:00,22222.25,SELL,3,0.02h,Stop Loss,$15.75,$702.00,$387154.25,294,$702.00
2025-02-19,18:20:00,22238.75,BUY,3,0.02h,Break Even,$0.75,$702.75,$387155.00,294,$702.75
2025-02-19,18:50:00,22244.5,SELL,3,0.02h,Stop Loss,$34.50,$737.25,$387189.50,294,$737.25
2025-02-19,19:14:00,22250.25,BUY,3,0.02h,Stop Loss,$255.75,$993.00,$387445.25,294,$993.00
2025-02-19,20:05:00,22277.5,SELL,3,0.02h,Stop Loss,$30.75,$1023.75,$387476.00,294,$1023.75
2025-02-19,20:56:00,22250.25,BUY,3,0.02h,Stop Loss,$12.00,$1035.75,$387488.00,294,$1035.75
2025-02-19,21:03:00,22227.5,SELL,3,0.02h,Stop Loss,$105.75,$1141.50,$387593.75,294,$1141.50
2025-02-19,21:38:00,22226.25,BUY,3,0.02h,Stop Loss,$-18.00,$1123.50,$387575.75,294,$1123.50
2025-02-19,21:39:00,22221.0,SELL,3,0.02h,Stop Loss,$-18.00,$1105.50,$387557.75,294,$1105.50
2025-02-19,21:59:00,22223.25,BUY,3,0.02h,Stop Loss,$-18.00,$1087.50,$387539.75,294,$1087.50
,,,,,,,,,,,
2025-02-20,12:00:00,22186.75,SELL,3,0.02h,Stop Loss,$19.50,$19.50,$387559.25,295,$19.50
2025-02-20,12:35:00,22200.0,BUY,3,0.02h,Break Even,$0.75,$20.25,$387560.00,295,$20.25
2025-02-20,13:07:00,22199.0,SELL,3,0.02h,Break Even,$0.75,$21.00,$387560.75,295,$21.00
2025-02-20,13:44:00,22201.75,BUY,3,0.02h,Stop Loss,$15.75,$36.75,$387576.50,295,$36.75
2025-02-20,13:53:00,22193.0,SELL,3,0.02h,Break Even,$0.75,$37.50,$387577.25,295,$37.50
2025-02-20,13:59:00,22201.25,BUY,3,0.02h,Break Even,$0.75,$38.25,$387578.00,295,$38.25
2025-02-20,14:27:00,22209.75,SELL,3,0.02h,Stop Loss,$49.50,$87.75,$387627.50,295,$87.75
2025-02-20,15:19:00,22081.25,BUY,3,0.02h,Stop Loss,$45.75,$133.50,$387673.25,295,$133.50
2025-02-20,15:43:00,22073.25,SELL,3,0.02h,Stop Loss,$105.75,$239.25,$387779.00,295,$239.25
2025-02-20,16:10:00,22053.5,BUY,3,0.02h,Stop Loss,$105.75,$345.00,$387884.75,295,$345.00
2025-02-20,16:20:00,22029.0,SELL,3,0.02h,Stop Loss,$-18.00,$327.00,$387866.75,295,$327.00
2025-02-20,16:22:00,22050.0,BUY,3,0.02h,Stop Loss,$-18.00,$309.00,$387848.75,295,$309.00
2025-02-20,16:37:00,22033.5,SELL,3,0.02h,Stop Loss,$188.25,$497.25,$388037.00,295,$497.25
2025-02-20,16:45:00,22055.5,BUY,3,0.02h,Break Even,$0.75,$498.00,$388037.75,295,$498.00
2025-02-20,16:48:00,22033.0,SELL,3,0.02h,Stop Loss,$19.50,$517.50,$388057.25,295,$517.50
2025-02-20,16:53:00,22055.0,BUY,3,0.02h,Stop Loss,$-18.00,$499.50,$388039.25,295,$499.50
2025-02-20,16:54:00,22038.25,SELL,3,0.02h,Break Even,$0.75,$500.25,$388040.00,295,$500.25
2025-02-20,17:04:00,22061.25,BUY,3,0.02h,Stop Loss,$60.75,$561.00,$388100.75,295,$561.00
2025-02-20,17:50:00,22068.25,SELL,3,0.02h,Stop Loss,$19.50,$580.50,$388120.25,295,$580.50
2025-02-20,18:14:00,22065.75,BUY,3,0.02h,Break Even,$0.75,$581.25,$388121.00,295,$581.25
2025-02-20,18:19:00,22052.25,SELL,3,0.02h,Stop Loss,$27.00,$608.25,$388148.00,295,$608.25
2025-02-20,18:34:00,22059.0,BUY,3,0.02h,Stop Loss,$-18.00,$590.25,$388130.00,295,$590.25
2025-02-20,18:52:00,22052.0,SELL,3,0.02h,Stop Loss,$23.25,$613.50,$388153.25,295,$613.50
2025-02-20,18:58:00,22063.5,BUY,3,0.02h,Stop Loss,$124.50,$738.00,$388277.75,295,$738.00
2025-02-20,19:33:00,22083.5,SELL,3,0.02h,Stop Loss,$34.50,$772.50,$388312.25,295,$772.50
2025-02-20,19:48:00,22102.0,BUY,3,0.02h,Stop Loss,$105.75,$878.25,$388418.00,295,$878.25
2025-02-20,20:13:00,22103.25,SELL,3,0.02h,Break Even,$0.75,$879.00,$388418.75,295,$879.00
2025-02-20,20:23:00,22118.5,BUY,3,0.02h,Stop Loss,$-18.00,$861.00,$388400.75,295,$861.00
2025-02-20,20:28:00,22095.0,SELL,3,0.02h,Stop Loss,$-18.00,$843.00,$388382.75,295,$843.00
2025-02-20,20:44:00,22111.75,BUY,3,0.02h,Stop Loss,$68.25,$911.25,$388451.00,295,$911.25
2025-02-20,21:16:00,22127.5,SELL,3,0.02h,Stop Loss,$-18.00,$893.25,$388433.00,295,$893.25
2025-02-20,21:25:00,22135.0,BUY,3,0.02h,Stop Loss,$-18.00,$875.25,$388415.00,295,$875.25
2025-02-20,21:52:00,22134.0,SELL,3,0.02h,Break Even,$0.75,$876.00,$388415.75,295,$876.00
,,,,,,,,,,,
2025-02-21,12:00:00,22165.0,BUY,3,0.02h,Stop Loss,$19.50,$19.50,$388435.25,296,$19.50
2025-02-21,13:07:00,22208.25,SELL,3,0.02h,Stop Loss,$-18.00,$1.50,$388417.25,296,$1.50
2025-02-21,13:11:00,22216.75,BUY,3,0.02h,Stop Loss,$-18.00,$-16.50,$388399.25,296,$-16.50
2025-02-21,13:58:00,22225.75,SELL,3,0.02h,Break Even,$0.75,$-15.75,$388400.00,296,$-15.75
2025-02-21,14:19:00,22229.0,BUY,3,0.02h,Stop Loss,$-18.00,$-33.75,$388382.00,296,$-33.75
2025-02-21,14:21:00,22224.75,SELL,3,0.02h,Stop Loss,$-18.00,$-51.75,$388364.00,296,$-51.75
2025-02-21,14:22:00,22226.25,BUY,3,0.02h,Stop Loss,$-18.00,$-69.75,$388346.00,296,$-69.75
2025-02-21,14:23:00,22223.5,SELL,3,0.02h,Stop Loss,$60.75,$-9.00,$388406.75,296,$-9.00
2025-02-21,16:01:00,22015.25,BUY,3,0.02h,Stop Loss,$42.00,$33.00,$388448.75,296,$33.00
2025-02-21,16:07:00,21980.75,SELL,3,0.02h,Stop Loss,$83.25,$116.25,$388532.00,296,$116.25
2025-02-21,16:15:00,22015.25,BUY,3,0.02h,Stop Loss,$27.00,$143.25,$388559.00,296,$143.25
2025-02-21,16:30:00,21992.75,SELL,3,0.02h,Stop Loss,$150.75,$294.00,$388709.75,296,$294.00
2025-02-21,16:34:00,22015.0,BUY,3,0.02h,Stop Loss,$68.25,$362.25,$388778.00,296,$362.25
2025-02-21,16:44:00,21990.5,SELL,3,0.02h,Stop Loss,$30.75,$393.00,$388808.75,296,$393.00
2025-02-21,17:06:00,21991.5,BUY,3,0.02h,Break Even,$0.75,$393.75,$388809.50,296,$393.75
2025-02-21,17:09:00,21978.25,SELL,3,0.02h,Stop Loss,$162.00,$555.75,$388971.50,296,$555.75
2025-02-21,18:39:00,21832.25,BUY,3,0.02h,Stop Loss,$-18.00,$537.75,$388953.50,296,$537.75
2025-02-21,18:42:00,21794.25,SELL,3,0.02h,Stop Loss,$-18.00,$519.75,$388935.50,296,$519.75
2025-02-21,19:54:00,21706.5,BUY,3,0.02h,Stop Loss,$-18.00,$501.75,$388917.50,296,$501.75
2025-02-21,19:55:00,21690.25,SELL,3,0.02h,Stop Loss,$-18.00,$483.75,$388899.50,296,$483.75
2025-02-21,19:56:00,21706.25,BUY,3,0.02h,Break Even,$0.75,$484.50,$388900.25,296,$484.50
2025-02-21,19:59:00,21692.0,SELL,3,0.02h,Stop Loss,$98.25,$582.75,$388998.50,296,$582.75
2025-02-21,20:16:00,21699.0,BUY,3,0.02h,Break Even,$0.75,$583.50,$388999.25,296,$583.50
2025-02-21,20:19:00,21691.0,SELL,3,0.02h,Stop Loss,$-18.00,$565.50,$388981.25,296,$565.50
2025-02-21,20:20:00,21699.25,BUY,3,0.02h,Break Even,$0.75,$566.25,$388982.00,296,$566.25
2025-02-21,20:40:00,21696.5,SELL,3,0.02h,Stop Loss,$15.75,$582.00,$388997.75,296,$582.00
2025-02-21,20:56:00,21695.0,BUY,3,0.02h,Stop Loss,$-18.00,$564.00,$388979.75,296,$564.00
2025-02-21,20:57:00,21682.5,SELL,3,0.02h,Stop Loss,$64.50,$628.50,$389044.25,296,$628.50
2025-02-21,21:02:00,21688.5,BUY,3,0.02h,Stop Loss,$15.75,$644.25,$389060.00,296,$644.25
2025-02-21,21:05:00,21683.75,SELL,3,0.02h,Stop Loss,$27.00,$671.25,$389087.00,296,$671.25
2025-02-21,21:08:00,21690.75,BUY,3,0.02h,Break Even,$0.75,$672.00,$389087.75,296,$672.00
2025-02-21,21:12:00,21683.0,SELL,3,0.02h,Stop Loss,$30.75,$702.75,$389118.50,296,$702.75
,,,,,,,,,,,
2025-02-24,12:00:00,21777.5,BUY,3,0.02h,Stop Loss,$-18.00,$-18.00,$389100.50,297,$-18.00
2025-02-24,12:47:00,21750.75,SELL,3,0.02h,Stop Loss,$57.00,$39.00,$389157.50,297,$39.00
2025-02-24,13:00:00,21763.25,BUY,3,0.02h,Break Even,$0.75,$39.75,$389158.25,297,$39.75
2025-02-24,14:07:00,21774.5,SELL,3,0.02h,Stop Loss,$34.50,$74.25,$389192.75,297,$74.25
2025-02-24,16:03:00,21495.75,BUY,3,0.02h,Stop Loss,$184.50,$258.75,$389377.25,297,$258.75
2025-02-24,16:59:00,21572.25,SELL,3,0.02h,Break Even,$0.75,$259.50,$389378.00,297,$259.50
2025-02-24,17:04:00,21606.25,BUY,3,0.02h,Stop Loss,$19.50,$279.00,$389397.50,297,$279.00
2025-02-24,17:55:00,21614.75,SELL,3,0.02h,Break Even,$0.75,$279.75,$389398.25,297,$279.75
2025-02-24,18:15:00,21628.25,BUY,3,0.02h,Stop Loss,$49.50,$329.25,$389447.75,297,$329.25
2025-02-24,18:48:00,21630.5,SELL,3,0.02h,Stop Loss,$72.00,$401.25,$389519.75,297,$401.25
2025-02-24,20:16:00,21561.25,BUY,3,0.02h,Stop Loss,$30.75,$432.00,$389550.50,297,$432.00
2025-02-24,20:24:00,21542.25,SELL,3,0.02h,Stop Loss,$135.75,$567.75,$389686.25,297,$567.75
2025-02-24,20:38:00,21551.5,BUY,3,0.02h,Stop Loss,$-18.00,$549.75,$389668.25,297,$549.75
2025-02-24,20:39:00,21538.5,SELL,3,0.02h,Stop Loss,$102.00,$651.75,$389770.25,297,$651.75
2025-02-24,21:59:00,21428.25,BUY,3,0.02h,Stop Loss,$12.00,$663.75,$389782.25,297,$663.75
,,,,,,,,,,,
2025-02-25,12:00:00,21370.5,SELL,3,0.02h,Stop Loss,$60.75,$60.75,$389843.00,298,$60.75
2025-02-25,12:27:00,21397.75,BUY,3,0.02h,Stop Loss,$-18.00,$42.75,$389825.00,298,$42.75
2025-02-25,12:33:00,21378.25,SELL,3,0.02h,Break Even,$0.75,$43.50,$389825.75,298,$43.50
2025-02-25,12:53:00,21390.25,BUY,3,0.02h,Stop Loss,$19.50,$63.00,$389845.25,298,$63.00
2025-02-25,13:38:00,21414.75,SELL,3,0.02h,Stop Loss,$38.25,$101.25,$389883.50,298,$101.25
2025-02-25,15:44:00,21115.75,BUY,3,0.02h,Break Even,$0.75,$102.00,$389884.25,298,$102.00
2025-02-25,15:48:00,21088.5,SELL,3,0.02h,Stop Loss,$30.75,$132.75,$389915.00,298,$132.75
2025-02-25,15:50:00,21112.0,BUY,3,0.02h,Stop Loss,$117.00,$249.75,$390032.00,298,$249.75
2025-02-25,16:02:00,21084.0,SELL,3,0.02h,Stop Loss,$270.75,$520.50,$390302.75,298,$520.50
2025-02-25,16:43:00,21057.75,BUY,3,0.02h,Stop Loss,$-18.00,$502.50,$390284.75,298,$502.50
2025-02-25,17:22:00,21120.0,SELL,3,0.02h,Stop Loss,$102.00,$604.50,$390386.75,298,$604.50
2025-02-25,17:27:00,21154.0,BUY,3,0.02h,Stop Loss,$143.25,$747.75,$390530.00,298,$747.75
2025-02-25,18:18:00,21226.0,SELL,3,0.02h,Stop Loss,$207.00,$954.75,$390737.00,298,$954.75
2025-02-25,18:40:00,21243.0,BUY,3,0.02h,Stop Loss,$23.25,$978.00,$390760.25,298,$978.00
2025-02-25,18:56:00,21204.25,SELL,3,0.02h,Break Even,$0.75,$978.75,$390761.00,298,$978.75
2025-02-25,19:38:00,21173.25,BUY,3,0.02h,Stop Loss,$225.75,$1204.50,$390986.75,298,$1204.50
2025-02-25,20:13:00,21198.75,SELL,3,0.02h,Stop Loss,$49.50,$1254.00,$391036.25,298,$1254.00
2025-02-25,20:15:00,21203.5,BUY,3,0.02h,Stop Loss,$57.00,$1311.00,$391093.25,298,$1311.00
2025-02-25,20:18:00,21196.0,SELL,3,0.02h,Break Even,$0.75,$1311.75,$391094.00,298,$1311.75
2025-02-25,20:19:00,21208.75,BUY,3,0.02h,Stop Loss,$274.50,$1586.25,$391368.50,298,$1586.25
2025-02-25,20:36:00,21211.25,SELL,3,0.02h,Stop Loss,$345.75,$1932.00,$391714.25,298,$1932.00
2025-02-25,21:05:00,21187.75,BUY,3,0.02h,Stop Loss,$184.50,$2116.50,$391898.75,298,$2116.50
2025-02-25,21:39:00,21189.0,SELL,3,0.02h,Break Even,$0.75,$2117.25,$391899.50,298,$2117.25
2025-02-25,21:46:00,21205.0,BUY,3,0.02h,Break Even,$0.75,$2118.00,$391900.25,298,$2118.00
2025-02-25,21:58:00,21191.0,SELL,3,0.02h,Break Even,$0.75,$2118.75,$391901.00,298,$2118.75
,,,,,,,,,,,
2025-02-26,12:00:00,21288.0,BUY,3,0.02h,Stop Loss,$38.25,$38.25,$391939.25,299,$38.25
2025-02-26,12:47:00,21294.5,SELL,3,0.02h,Stop Loss,$19.50,$57.75,$391958.75,299,$57.75
2025-02-26,13:14:00,21292.0,BUY,3,0.02h,Stop Loss,$57.00,$114.75,$392015.75,299,$114.75
2025-02-26,13:44:00,21306.75,SELL,3,0.02h,Break Even,$0.75,$115.50,$392016.50,299,$115.50
2025-02-26,14:40:00,21265.0,BUY,3,0.02h,Stop Loss,$27.00,$142.50,$392043.50,299,$142.50
2025-02-26,14:43:00,21212.5,SELL,3,0.02h,Stop Loss,$203.25,$345.75,$392246.75,299,$345.75
2025-02-26,14:48:00,21256.75,BUY,3,0.02h,Stop Loss,$180.75,$526.50,$392427.50,299,$526.50
2025-02-26,15:30:00,21282.75,SELL,3,0.02h,Stop Loss,$-18.00,$508.50,$392409.50,299,$508.50
2025-02-26,15:38:00,21345.25,BUY,3,0.02h,Stop Loss,$30.75,$539.25,$392440.25,299,$539.25
2025-02-26,16:28:00,21362.0,SELL,3,0.02h,Break Even,$0.75,$540.00,$392441.00,299,$540.00
2025-02-26,16:38:00,21389.75,BUY,3,0.02h,Stop Loss,$90.75,$630.75,$392531.75,299,$630.75
2025-02-26,16:59:00,21357.75,SELL,3,0.02h,Stop Loss,$233.25,$864.00,$392765.00,299,$864.00
2025-02-26,17:08:00,21391.25,BUY,3,0.02h,Stop Loss,$98.25,$962.25,$392863.25,299,$962.25
2025-02-26,17:23:00,21366.25,SELL,3,0.02h,Stop Loss,$12.00,$974.25,$392875.25,299,$974.25
2025-02-26,19:21:00,21130.0,BUY,3,0.02h,Break Even,$0.75,$975.00,$392876.00,299,$975.00
2025-02-26,19:56:00,21139.0,SELL,3,0.02h,Stop Loss,$79.50,$1054.50,$392955.50,299,$1054.50
2025-02-26,20:14:00,21130.0,BUY,3,0.02h,Stop Loss,$-18.00,$1036.50,$392937.50,299,$1036.50
2025-02-26,20:15:00,21115.75,SELL,3,0.02h,Stop Loss,$72.00,$1108.50,$393009.50,299,$1108.50
2025-02-26,20:20:00,21131.75,BUY,3,0.02h,Break Even,$0.75,$1109.25,$393010.25,299,$1109.25
2025-02-26,21:30:00,21205.0,SELL,3,0.02h,Stop Loss,$124.50,$1233.75,$393134.75,299,$1233.75
2025-02-26,21:42:00,21224.25,BUY,3,0.02h,Stop Loss,$-18.00,$1215.75,$393116.75,299,$1215.75
,,,,,,,,,,,
2025-02-27,12:53:00,21356.75,SELL,3,0.02h,Stop Loss,$12.00,$12.00,$393128.75,300,$12.00
2025-02-27,13:18:00,21365.0,BUY,3,0.02h,Stop Loss,$15.75,$27.75,$393144.50,300,$27.75
2025-02-27,13:26:00,21352.0,SELL,3,0.02h,Stop Loss,$15.75,$43.50,$393160.25,300,$43.50
2025-02-27,13:42:00,21363.25,BUY,3,0.02h,Stop Loss,$12.00,$55.50,$393172.25,300,$55.50
2025-02-27,13:47:00,21316.0,SELL,3,0.02h,Stop Loss,$420.75,$476.25,$393593.00,300,$476.25
2025-02-27,14:04:00,21344.75,BUY,3,0.02h,Break Even,$0.75,$477.00,$393593.75,300,$477.00
2025-02-27,14:30:00,21340.5,SELL,3,0.02h,Stop Loss,$203.25,$680.25,$393797.00,300,$680.25
2025-02-27,14:31:00,21352.25,BUY,3,0.02h,Break Even,$0.75,$681.00,$393797.75,300,$681.00
2025-02-27,14:32:00,21329.75,SELL,3,0.02h,Stop Loss,$-18.00,$663.00,$393779.75,300,$663.00
2025-02-27,14:34:00,21354.0,BUY,3,0.02h,Stop Loss,$49.50,$712.50,$393829.25,300,$712.50
2025-02-27,14:40:00,21308.25,SELL,3,0.02h,Stop Loss,$495.75,$1208.25,$394325.00,300,$1208.25
2025-02-27,15:18:00,21069.75,BUY,3,0.02h,Stop Loss,$417.00,$1625.25,$394742.00,300,$1625.25
2025-02-27,15:35:00,21067.5,SELL,3,0.02h,Stop Loss,$278.25,$1903.50,$395020.25,300,$1903.50
2025-02-27,15:40:00,21113.5,BUY,3,0.02h,Stop Loss,$23.25,$1926.75,$395043.50,300,$1926.75
2025-02-27,15:53:00,21058.0,SELL,3,0.02h,Stop Loss,$154.50,$2081.25,$395198.00,300,$2081.25
2025-02-27,16:12:00,21082.5,BUY,3,0.02h,Stop Loss,$169.50,$2250.75,$395367.50,300,$2250.75
2025-02-27,16:30:00,21065.0,SELL,3,0.02h,Stop Loss,$79.50,$2330.25,$395447.00,300,$2330.25
2025-02-27,17:28:00,21039.25,BUY,3,0.02h,Stop Loss,$83.25,$2413.50,$395530.25,300,$2413.50
2025-02-27,17:44:00,21001.25,SELL,3,0.02h,Stop Loss,$38.25,$2451.75,$395568.50,300,$2451.75
2025-02-27,18:00:00,21038.25,BUY,3,0.02h,Stop Loss,$263.25,$2715.00,$395831.75,300,$2715.00
2025-02-27,18:44:00,21075.75,SELL,3,0.02h,Break Even,$0.75,$2715.75,$395832.50,300,$2715.75
2025-02-27,21:20:00,20634.5,BUY,3,0.02h,Break Even,$0.75,$2716.50,$395833.25,300,$2716.50
2025-02-27,21:54:00,20633.75,SELL,3,0.02h,Stop Loss,$53.25,$2769.75,$395886.50,300,$2769.75
,,,,,,,,,,,
2025-02-28,12:01:00,20651.5,BUY,3,0.02h,Break Even,$0.75,$0.75,$395887.25,301,$0.75
2025-02-28,12:03:00,20632.25,SELL,3,0.02h,Stop Loss,$132.00,$132.75,$396019.25,301,$132.75
2025-02-28,12:22:00,20632.0,BUY,3,0.02h,Stop Loss,$53.25,$186.00,$396072.50,301,$186.00
2025-02-28,12:32:00,20603.25,SELL,3,0.02h,Stop Loss,$-18.00,$168.00,$396054.50,301,$168.00
2025-02-28,12:51:00,20622.0,BUY,3,0.02h,Break Even,$0.75,$168.75,$396055.25,301,$168.75
2025-02-28,13:11:00,20611.25,SELL,3,0.02h,Stop Loss,$147.00,$315.75,$396202.25,301,$315.75
2025-02-28,13:32:00,20659.75,BUY,3,0.02h,Break Even,$0.75,$316.50,$396203.00,301,$316.50
2025-02-28,13:53:00,20609.5,SELL,3,0.02h,Stop Loss,$34.50,$351.00,$396237.50,301,$351.00
2025-02-28,14:10:00,20620.5,BUY,3,0.02h,Break Even,$0.75,$351.75,$396238.25,301,$351.75
2025-02-28,14:12:00,20604.0,SELL,3,0.02h,Stop Loss,$34.50,$386.25,$396272.75,301,$386.25
2025-02-28,14:17:00,20615.0,BUY,3,0.02h,Stop Loss,$-18.00,$368.25,$396254.75,301,$368.25
2025-02-28,14:18:00,20611.5,SELL,3,0.02h,Stop Loss,$-18.00,$350.25,$396236.75,301,$350.25
2025-02-28,14:19:00,20620.25,BUY,3,0.02h,Stop Loss,$79.50,$429.75,$396316.25,301,$429.75
2025-02-28,14:22:00,20603.5,SELL,3,0.02h,Stop Loss,$64.50,$494.25,$396380.75,301,$494.25
2025-02-28,14:44:00,20628.25,BUY,3,0.02h,Break Even,$0.75,$495.00,$396381.50,301,$495.00
2025-02-28,14:57:00,20550.25,SELL,3,0.02h,Stop Loss,$87.00,$582.00,$396468.50,301,$582.00
2025-02-28,15:01:00,20623.0,BUY,3,0.02h,Stop Loss,$120.75,$702.75,$396589.25,301,$702.75
2025-02-28,15:44:00,20680.25,SELL,3,0.02h,Break Even,$0.75,$703.50,$396590.00,301,$703.50
2025-02-28,15:47:00,20735.75,BUY,3,0.02h,Stop Loss,$-18.00,$685.50,$396572.00,301,$685.50
2025-02-28,15:49:00,20693.25,SELL,3,0.02h,Stop Loss,$113.25,$798.75,$396685.25,301,$798.75
2025-02-28,15:52:00,20730.75,BUY,3,0.02h,Stop Loss,$94.50,$893.25,$396779.75,301,$893.25
2025-02-28,16:13:00,20702.0,SELL,3,0.02h,Stop Loss,$98.25,$991.50,$396878.00,301,$991.50
2025-02-28,16:38:00,20705.5,BUY,3,0.02h,Stop Loss,$147.00,$1138.50,$397025.00,301,$1138.50
2025-02-28,16:59:00,20708.5,SELL,3,0.02h,Stop Loss,$244.50,$1383.00,$397269.50,301,$1383.00
2025-02-28,17:15:00,20712.75,BUY,3,0.02h,Stop Loss,$-18.00,$1365.00,$397251.50,301,$1365.00
2025-02-28,17:26:00,20695.0,SELL,3,0.02h,Stop Loss,$-18.00,$1347.00,$397233.50,301,$1347.00
2025-02-28,18:30:00,20593.0,BUY,3,0.02h,Stop Loss,$413.25,$1760.25,$397646.75,301,$1760.25
2025-02-28,18:57:00,20574.5,SELL,3,0.02h,Stop Loss,$109.50,$1869.75,$397756.25,301,$1869.75
2025-02-28,19:20:00,20613.25,BUY,3,0.02h,Break Even,$0.75,$1870.50,$397757.00,301,$1870.50
2025-02-28,20:22:00,20705.25,SELL,3,0.02h,Stop Loss,$203.25,$2073.75,$397960.25,301,$2073.75
2025-02-28,20:28:00,20749.5,BUY,3,0.02h,Stop Loss,$214.50,$2288.25,$398174.75,301,$2288.25
2025-02-28,20:36:00,20689.75,SELL,3,0.02h,Stop Loss,$-18.00,$2270.25,$398156.75,301,$2270.25
2025-02-28,20:41:00,20756.5,BUY,3,0.02h,Stop Loss,$45.75,$2316.00,$398202.50,301,$2316.00
,,,,,,,,,,,
2025-03-03,12:39:00,21069.25,SELL,3,0.02h,Stop Loss,$-18.00,$-18.00,$398184.50,302,$-18.00
2025-03-03,12:46:00,21079.5,BUY,3,0.02h,Stop Loss,$-18.00,$-36.00,$398166.50,302,$-36.00
2025-03-03,12:55:00,21068.25,SELL,3,0.02h,Stop Loss,$94.50,$58.50,$398261.00,302,$58.50
2025-03-03,13:25:00,21074.0,BUY,3,0.02h,Stop Loss,$23.25,$81.75,$398284.25,302,$81.75
2025-03-03,13:36:00,21052.75,SELL,3,0.02h,Break Even,$0.75,$82.50,$398285.00,302,$82.50
2025-03-03,13:54:00,21061.75,BUY,3,0.02h,Stop Loss,$38.25,$120.75,$398323.25,302,$120.75
2025-03-03,14:26:00,21061.75,SELL,3,0.02h,Break Even,$0.75,$121.50,$398324.00,302,$121.50
2025-03-03,14:35:00,21088.0,BUY,3,0.02h,Stop Loss,$154.50,$276.00,$398478.50,302,$276.00
2025-03-03,14:38:00,21037.75,SELL,3,0.02h,Stop Loss,$758.25,$1034.25,$399236.75,302,$1034.25
2025-03-03,15:24:00,20909.5,BUY,3,0.02h,Stop Loss,$117.00,$1151.25,$399353.75,302,$1151.25
2025-03-03,15:51:00,20906.25,SELL,3,0.02h,Break Even,$0.75,$1152.00,$399354.50,302,$1152.00
2025-03-03,15:54:00,20938.75,BUY,3,0.02h,Stop Loss,$19.50,$1171.50,$399374.00,302,$1171.50
2025-03-03,15:56:00,20910.0,SELL,3,0.02h,Stop Loss,$218.25,$1389.75,$399592.25,302,$1389.75
2025-03-03,16:15:00,20913.0,BUY,3,0.02h,Stop Loss,$68.25,$1458.00,$399660.50,302,$1458.00
2025-03-03,16:16:00,20892.75,SELL,3,0.02h,Break Even,$0.75,$1458.75,$399661.25,302,$1458.75
2025-03-03,16:17:00,20916.0,BUY,3,0.02h,Stop Loss,$282.00,$1740.75,$399943.25,302,$1740.75
2025-03-03,16:30:00,20886.5,SELL,3,0.02h,Stop Loss,$64.50,$1805.25,$400007.75,302,$1805.25
2025-03-03,16:51:00,20928.75,BUY,3,0.02h,Break Even,$0.75,$1806.00,$400008.50,302,$1806.00
2025-03-03,17:37:00,20919.5,SELL,3,0.02h,Stop Loss,$150.75,$1956.75,$400159.25,302,$1956.75
2025-03-03,17:42:00,20944.25,BUY,3,0.02h,Stop Loss,$267.00,$2223.75,$400426.25,302,$2223.75
2025-03-03,17:47:00,20905.75,SELL,3,0.02h,Stop Loss,$312.00,$2535.75,$400738.25,302,$2535.75
2025-03-03,18:51:00,20734.5,BUY,3,0.02h,Stop Loss,$68.25,$2604.00,$400806.50,302,$2604.00
2025-03-03,19:18:00,20724.0,SELL,3,0.02h,Stop Loss,$278.25,$2882.25,$401084.75,302,$2882.25
2025-03-03,19:33:00,20757.75,BUY,3,0.02h,Stop Loss,$240.75,$3123.00,$401325.50,302,$3123.00
2025-03-03,19:50:00,20721.75,SELL,3,0.02h,Break Even,$0.75,$3123.75,$401326.25,302,$3123.75
2025-03-03,20:53:00,20418.75,BUY,3,0.02h,Stop Loss,$42.00,$3165.75,$401368.25,302,$3165.75
2025-03-03,21:55:00,20520.25,SELL,3,0.02h,Break Even,$0.75,$3166.50,$401369.00,302,$3166.50
2025-03-03,21:59:00,20527.0,BUY,3,0.02h,Stop Loss,$23.25,$3189.75,$401392.25,302,$3189.75
,,,,,,,,,,,
2025-03-04,12:00:00,20475.25,SELL,3,0.02h,Stop Loss,$203.25,$203.25,$401595.50,303,$203.25
2025-03-04,13:36:00,20327.25,BUY,3,0.02h,Stop Loss,$154.50,$357.75,$401750.00,303,$357.75
2025-03-04,14:00:00,20325.0,SELL,3,0.02h,Stop Loss,$19.50,$377.25,$401769.50,303,$377.25
2025-03-04,14:01:00,20337.0,BUY,3,0.02h,Stop Loss,$87.00,$464.25,$401856.50,303,$464.25
2025-03-04,14:21:00,20343.0,SELL,3,0.02h,Stop Loss,$90.75,$555.00,$401947.25,303,$555.00
2025-03-04,14:38:00,20399.5,BUY,3,0.02h,Stop Loss,$409.50,$964.50,$402356.75,303,$964.50
2025-03-04,14:43:00,20278.25,SELL,3,0.02h,Stop Loss,$203.25,$1167.75,$402560.00,303,$1167.75
2025-03-04,14:48:00,20370.5,BUY,3,0.02h,Stop Loss,$582.00,$1749.75,$403142.00,303,$1749.75
2025-03-04,14:51:00,20305.25,SELL,3,0.02h,Stop Loss,$458.25,$2208.00,$403600.25,303,$2208.00
2025-03-04,15:33:00,20211.25,BUY,3,0.02h,Stop Loss,$432.00,$2640.00,$404032.25,303,$2640.00
2025-03-04,15:55:00,20175.0,SELL,3,0.02h,Stop Loss,$222.00,$2862.00,$404254.25,303,$2862.00
2025-03-04,16:16:00,20220.75,BUY,3,0.02h,Stop Loss,$98.25,$2960.25,$404352.50,303,$2960.25
2025-03-04,16:22:00,20176.0,SELL,3,0.02h,Stop Loss,$132.00,$3092.25,$404484.50,303,$3092.25
2025-03-04,16:23:00,20186.0,BUY,3,0.02h,Stop Loss,$-18.00,$3074.25,$404466.50,303,$3074.25
2025-03-04,16:24:00,20148.25,SELL,3,0.02h,Stop Loss,$-18.00,$3056.25,$404448.50,303,$3056.25
2025-03-04,16:34:00,20186.0,BUY,3,0.02h,Stop Loss,$117.00,$3173.25,$404565.50,303,$3173.25
2025-03-04,17:53:00,20322.0,SELL,3,0.02h,Stop Loss,$12.00,$3185.25,$404577.50,303,$3185.25
2025-03-04,18:09:00,20407.25,BUY,3,0.02h,Stop Loss,$255.75,$3441.00,$404833.25,303,$3441.00
2025-03-04,18:27:00,20390.5,SELL,3,0.02h,Stop Loss,$83.25,$3524.25,$404916.50,303,$3524.25
2025-03-04,18:38:00,20420.0,BUY,3,0.02h,Stop Loss,$68.25,$3592.50,$404984.75,303,$3592.50
2025-03-04,19:35:00,20549.5,SELL,3,0.02h,Stop Loss,$12.00,$3604.50,$404996.75,303,$3604.50
2025-03-04,19:38:00,20583.0,BUY,3,0.02h,Stop Loss,$38.25,$3642.75,$405035.00,303,$3642.75
2025-03-04,20:32:00,20610.5,SELL,3,0.02h,Stop Loss,$402.00,$4044.75,$405437.00,303,$4044.75
2025-03-04,21:11:00,20453.0,BUY,3,0.02h,Stop Loss,$424.50,$4469.25,$405861.50,303,$4469.25
2025-03-04,21:41:00,20494.5,SELL,3,0.02h,Stop Loss,$53.25,$4522.50,$405914.75,303,$4522.50
2025-03-04,21:48:00,20535.0,BUY,3,0.02h,Break Even,$0.75,$4523.25,$405915.50,303,$4523.25
,,,,,,,,,,,
2025-03-05,12:00:00,20492.5,SELL,3,0.02h,Stop Loss,$34.50,$34.50,$405950.00,304,$34.50
2025-03-05,12:33:00,20502.0,BUY,3,0.02h,Stop Loss,$49.50,$84.00,$405999.50,304,$84.00
2025-03-05,12:48:00,20488.0,SELL,3,0.02h,Stop Loss,$19.50,$103.50,$406019.00,304,$103.50
2025-03-05,13:12:00,20507.75,BUY,3,0.02h,Break Even,$0.75,$104.25,$406019.75,304,$104.25
2025-03-05,13:15:00,20485.5,SELL,3,0.02h,Stop Loss,$769.50,$873.75,$406789.25,304,$873.75
2025-03-05,14:15:00,20440.5,BUY,3,0.02h,Stop Loss,$327.00,$1200.75,$407116.25,304,$1200.75
2025-03-05,14:32:00,20418.0,SELL,3,0.02h,Stop Loss,$390.75,$1591.50,$407507.00,304,$1591.50
2025-03-05,14:44:00,20443.5,BUY,3,0.02h,Break Even,$0.75,$1592.25,$407507.75,304,$1592.25
2025-03-05,14:48:00,20376.25,SELL,3,0.02h,Stop Loss,$270.75,$1863.00,$407778.50,304,$1863.00
2025-03-05,15:03:00,20421.0,BUY,3,0.02h,Stop Loss,$319.50,$2182.50,$408098.00,304,$2182.50
2025-03-05,15:19:00,20384.0,SELL,3,0.02h,Stop Loss,$285.75,$2468.25,$408383.75,304,$2468.25
2025-03-05,15:38:00,20388.5,BUY,3,0.02h,Stop Loss,$443.25,$2911.50,$408827.00,304,$2911.50
2025-03-05,15:52:00,20359.5,SELL,3,0.02h,Stop Loss,$120.75,$3032.25,$408947.75,304,$3032.25
2025-03-05,15:54:00,20401.5,BUY,3,0.02h,Stop Loss,$229.50,$3261.75,$409177.25,304,$3261.75
2025-03-05,16:02:00,20354.75,SELL,3,0.02h,Stop Loss,$109.50,$3371.25,$409286.75,304,$3371.25
2025-03-05,16:57:00,20274.5,BUY,3,0.02h,Stop Loss,$844.50,$4215.75,$410131.25,304,$4215.75
2025-03-05,18:10:00,20469.25,SELL,3,0.02h,Stop Loss,$64.50,$4280.25,$410195.75,304,$4280.25
2025-03-05,18:48:00,20522.0,BUY,3,0.02h,Stop Loss,$398.25,$4678.50,$410594.00,304,$4678.50
2025-03-05,19:37:00,20649.75,SELL,3,0.02h,Stop Loss,$462.00,$5140.50,$411056.00,304,$5140.50
2025-03-05,19:50:00,20668.5,BUY,3,0.02h,Stop Loss,$169.50,$5310.00,$411225.50,304,$5310.00
2025-03-05,20:18:00,20623.5,SELL,3,0.02h,Break Even,$0.75,$5310.75,$411226.25,304,$5310.75
2025-03-05,20:30:00,20690.0,BUY,3,0.02h,Break Even,$0.75,$5311.50,$411227.00,304,$5311.50
2025-03-05,20:31:00,20660.0,SELL,3,0.02h,Stop Loss,$68.25,$5379.75,$411295.25,304,$5379.75
2025-03-05,20:42:00,20683.25,BUY,3,0.02h,Stop Loss,$83.25,$5463.00,$411378.50,304,$5463.00
2025-03-05,20:48:00,20662.75,SELL,3,0.02h,Stop Loss,$102.00,$5565.00,$411480.50,304,$5565.00
2025-03-05,20:55:00,20690.0,BUY,3,0.02h,Stop Loss,$-18.00,$5547.00,$411462.50,304,$5547.00
2025-03-05,21:00:00,20659.5,SELL,3,0.02h,Stop Loss,$128.25,$5675.25,$411590.75,304,$5675.25
2025-03-05,21:59:00,20616.75,BUY,3,0.02h,Break Even,$0.75,$5676.00,$411591.50,304,$5676.00
,,,,,,,,,,,
2025-03-06,12:00:00,20424.5,SELL,3,0.02h,Stop Loss,$57.00,$57.00,$411648.50,305,$57.00
2025-03-06,12:57:00,20387.5,BUY,3,0.02h,Stop Loss,$-18.00,$39.00,$411630.50,305,$39.00
2025-03-06,13:00:00,20370.75,SELL,3,0.02h,Stop Loss,$49.50,$88.50,$411680.00,305,$88.50
2025-03-06,13:34:00,20356.0,BUY,3,0.02h,Stop Loss,$75.75,$164.25,$411755.75,305,$164.25
2025-03-06,13:48:00,20334.75,SELL,3,0.02h,Stop Loss,$12.00,$176.25,$411767.75,305,$176.25
2025-03-06,14:07:00,20351.25,BUY,3,0.02h,Stop Loss,$-18.00,$158.25,$411749.75,305,$158.25
2025-03-06,14:23:00,20331.75,SELL,3,0.02h,Stop Loss,$87.00,$245.25,$411836.75,305,$245.25
2025-03-06,14:52:00,20324.5,BUY,3,0.02h,Stop Loss,$94.50,$339.75,$411931.25,305,$339.75
2025-03-06,14:59:00,20281.0,SELL,3,0.02h,Stop Loss,$19.50,$359.25,$411950.75,305,$359.25
2025-03-06,15:02:00,20304.0,BUY,3,0.02h,Stop Loss,$158.25,$517.50,$412109.00,305,$517.50
2025-03-06,15:53:00,20442.25,SELL,3,0.02h,Stop Loss,$23.25,$540.75,$412132.25,305,$540.75
2025-03-06,16:04:00,20472.5,BUY,3,0.02h,Stop Loss,$19.50,$560.25,$412151.75,305,$560.25
2025-03-06,16:08:00,20434.0,SELL,3,0.02h,Break Even,$0.75,$561.00,$412152.50,305,$561.00
2025-03-06,16:09:00,20462.0,BUY,3,0.02h,Stop Loss,$379.50,$940.50,$412532.00,305,$940.50
2025-03-06,16:21:00,20425.0,SELL,3,0.02h,Stop Loss,$390.75,$1331.25,$412922.75,305,$1331.25
2025-03-06,17:59:00,20187.0,BUY,3,0.02h,Stop Loss,$49.50,$1380.75,$412972.25,305,$1380.75
2025-03-06,18:11:00,20127.0,SELL,3,0.02h,Break Even,$0.75,$1381.50,$412973.00,305,$1381.50
2025-03-06,18:13:00,20163.5,BUY,3,0.02h,Break Even,$0.75,$1382.25,$412973.75,305,$1382.25
2025-03-06,18:30:00,20135.75,SELL,3,0.02h,Stop Loss,$195.75,$1578.00,$413169.50,305,$1578.00
2025-03-06,18:54:00,20135.25,BUY,3,0.02h,Break Even,$0.75,$1578.75,$413170.25,305,$1578.75
2025-03-06,19:02:00,20088.0,SELL,3,0.02h,Stop Loss,$323.25,$1902.00,$413493.50,305,$1902.00
2025-03-06,19:43:00,20077.5,BUY,3,0.02h,Stop Loss,$-18.00,$1884.00,$413475.50,305,$1884.00
2025-03-06,20:01:00,20065.0,SELL,3,0.02h,Stop Loss,$87.00,$1971.00,$413562.50,305,$1971.00
2025-03-06,20:11:00,20118.25,BUY,3,0.02h,Stop Loss,$162.00,$2133.00,$413724.50,305,$2133.00
2025-03-06,20:23:00,20081.0,SELL,3,0.02h,Stop Loss,$349.50,$2482.50,$414074.00,305,$2482.50
2025-03-06,20:32:00,20119.5,BUY,3,0.02h,Stop Loss,$207.00,$2689.50,$414281.00,305,$2689.50
2025-03-06,20:41:00,20090.0,SELL,3,0.02h,Stop Loss,$345.75,$3035.25,$414626.75,305,$3035.25
2025-03-06,20:54:00,20092.5,BUY,3,0.02h,Stop Loss,$297.00,$3332.25,$414923.75,305,$3332.25
2025-03-06,21:41:00,20163.75,SELL,3,0.02h,Stop Loss,$-18.00,$3314.25,$414905.75,305,$3314.25
2025-03-06,21:47:00,20185.25,BUY,3,0.02h,Stop Loss,$34.50,$3348.75,$414940.25,305,$3348.75
,,,,,,,,,,,
2025-03-07,12:01:00,20169.5,SELL,3,0.02h,Stop Loss,$49.50,$49.50,$414989.75,306,$49.50
2025-03-07,12:59:00,20130.0,BUY,3,0.02h,Stop Loss,$-18.00,$31.50,$414971.75,306,$31.50
2025-03-07,13:05:00,20116.5,SELL,3,0.02h,Stop Loss,$72.00,$103.50,$415043.75,306,$103.50
2025-03-07,13:06:00,20123.5,BUY,3,0.02h,Stop Loss,$83.25,$186.75,$415127.00,306,$186.75
2025-03-07,13:13:00,20106.0,SELL,3,0.02h,Stop Loss,$64.50,$251.25,$415191.50,306,$251.25
2025-03-07,13:31:00,20217.5,BUY,3,0.02h,Stop Loss,$750.75,$1002.00,$415942.25,306,$1002.00
2025-03-07,13:49:00,20152.75,SELL,3,0.02h,Stop Loss,$334.50,$1336.50,$416276.75,306,$1336.50
2025-03-07,14:35:00,20101.25,BUY,3,0.02h,Stop Loss,$330.75,$1667.25,$416607.50,306,$1667.25
2025-03-07,14:38:00,20048.75,SELL,3,0.02h,Stop Loss,$34.50,$1701.75,$416642.00,306,$1701.75
2025-03-07,14:39:00,20098.25,BUY,3,0.02h,Stop Loss,$143.25,$1845.00,$416785.25,306,$1845.00
2025-03-07,15:02:00,20129.25,SELL,3,0.02h,Stop Loss,$79.50,$1924.50,$416864.75,306,$1924.50
2025-03-07,15:07:00,20159.5,BUY,3,0.02h,Stop Loss,$315.75,$2240.25,$417180.50,306,$2240.25
2025-03-07,15:14:00,20118.5,SELL,3,0.02h,Stop Loss,$109.50,$2349.75,$417290.00,306,$2349.75
2025-03-07,15:52:00,19993.0,BUY,3,0.02h,Stop Loss,$443.25,$2793.00,$417733.25,306,$2793.00
2025-03-07,16:05:00,19986.0,SELL,3,0.02h,Stop Loss,$90.75,$2883.75,$417824.00,306,$2883.75
2025-03-07,16:08:00,20010.25,BUY,3,0.02h,Break Even,$0.75,$2884.50,$417824.75,306,$2884.50
2025-03-07,16:11:00,19980.75,SELL,3,0.02h,Stop Loss,$124.50,$3009.00,$417949.25,306,$3009.00
2025-03-07,17:02:00,19845.0,BUY,3,0.02h,Stop Loss,$259.50,$3268.50,$418208.75,306,$3268.50
2025-03-07,17:09:00,19808.75,SELL,3,0.02h,Stop Loss,$218.25,$3486.75,$418427.00,306,$3486.75
2025-03-07,17:25:00,19849.25,BUY,3,0.02h,Stop Loss,$195.75,$3682.50,$418622.75,306,$3682.50
2025-03-07,18:30:00,20053.75,SELL,3,0.02h,Stop Loss,$143.25,$3825.75,$418766.00,306,$3825.75
2025-03-07,18:33:00,20077.75,BUY,3,0.02h,Stop Loss,$135.75,$3961.50,$418901.75,306,$3961.50
2025-03-07,19:10:00,20122.5,SELL,3,0.02h,Stop Loss,$-18.00,$3943.50,$418883.75,306,$3943.50
2025-03-07,19:15:00,20168.5,BUY,3,0.02h,Stop Loss,$34.50,$3978.00,$418918.25,306,$3978.00
2025-03-07,19:45:00,20206.5,SELL,3,0.02h,Stop Loss,$525.75,$4503.75,$419444.00,306,$4503.75
2025-03-07,20:09:00,20235.75,BUY,3,0.02h,Stop Loss,$79.50,$4583.25,$419523.50,306,$4583.25
2025-03-07,20:24:00,20205.75,SELL,3,0.02h,Stop Loss,$139.50,$4722.75,$419663.00,306,$4722.75
2025-03-07,20:28:00,20224.25,BUY,3,0.02h,Break Even,$0.75,$4723.50,$419663.75,306,$4723.50
2025-03-07,20:33:00,20195.5,SELL,3,0.02h,Stop Loss,$-18.00,$4705.50,$419645.75,306,$4705.50
2025-03-07,20:35:00,20230.0,BUY,3,0.02h,Break Even,$0.75,$4706.25,$419646.50,306,$4706.25
2025-03-07,20:37:00,20194.25,SELL,3,0.02h,Stop Loss,$567.00,$5273.25,$420213.50,306,$5273.25
2025-03-07,20:50:00,20219.25,BUY,3,0.02h,Stop Loss,$-18.00,$5255.25,$420195.50,306,$5255.25
2025-03-07,21:04:00,20159.25,SELL,3,0.02h,Break Even,$0.75,$5256.00,$420196.25,306,$5256.00
2025-03-07,21:15:00,20208.75,BUY,3,0.02h,Break Even,$0.75,$5256.75,$420197.00,306,$5256.75
2025-03-07,21:43:00,20201.75,SELL,3,0.02h,Stop Loss,$-18.00,$5238.75,$420179.00,306,$5238.75
2025-03-07,21:50:00,20209.75,BUY,3,0.02h,Break Even,$0.75,$5239.50,$420179.75,306,$5239.50
,,,,,,,,,,,
2025-03-10,12:00:00,19951.0,SELL,3,0.02h,Stop Loss,$124.50,$124.50,$420304.25,307,$124.50
2025-03-10,12:53:00,19903.75,BUY,3,0.02h,Break Even,$0.75,$125.25,$420305.00,307,$125.25
2025-03-10,13:06:00,19888.5,SELL,3,0.02h,Stop Loss,$169.50,$294.75,$420474.50,307,$294.75
2025-03-10,13:11:00,19917.5,BUY,3,0.02h,Break Even,$0.75,$295.50,$420475.25,307,$295.50
2025-03-10,13:22:00,19893.75,SELL,3,0.02h,Break Even,$0.75,$296.25,$420476.00,307,$296.25
2025-03-10,13:46:00,19880.75,BUY,3,0.02h,Stop Loss,$222.00,$518.25,$420698.00,307,$518.25
2025-03-10,13:48:00,19850.5,SELL,3,0.02h,Stop Loss,$469.50,$987.75,$421167.50,307,$987.75
2025-03-10,15:11:00,19602.0,BUY,3,0.02h,Stop Loss,$19.50,$1007.25,$421187.00,307,$1007.25
2025-03-10,15:20:00,19569.5,SELL,3,0.02h,Stop Loss,$87.00,$1094.25,$421274.00,307,$1094.25
2025-03-10,15:24:00,19612.25,BUY,3,0.02h,Stop Loss,$285.75,$1380.00,$421559.75,307,$1380.00
2025-03-10,15:45:00,19604.25,SELL,3,0.02h,Break Even,$0.75,$1380.75,$421560.50,307,$1380.75
2025-03-10,15:50:00,19650.75,BUY,3,0.02h,Stop Loss,$15.75,$1396.50,$421576.25,307,$1396.50
2025-03-10,15:51:00,19622.25,SELL,3,0.02h,Stop Loss,$-18.00,$1378.50,$421558.25,307,$1378.50
2025-03-10,16:32:00,19605.5,BUY,3,0.02h,Stop Loss,$90.75,$1469.25,$421649.00,307,$1469.25
2025-03-10,16:40:00,19538.25,SELL,3,0.02h,Break Even,$0.75,$1470.00,$421649.75,307,$1470.00
2025-03-10,17:23:00,19547.5,BUY,3,0.02h,Stop Loss,$27.00,$1497.00,$421676.75,307,$1497.00
2025-03-10,17:31:00,19503.0,SELL,3,0.02h,Stop Loss,$282.00,$1779.00,$421958.75,307,$1779.00
2025-03-10,18:15:00,19452.5,BUY,3,0.02h,Stop Loss,$353.25,$2132.25,$422312.00,307,$2132.25
2025-03-10,18:26:00,19437.25,SELL,3,0.02h,Stop Loss,$327.00,$2459.25,$422639.00,307,$2459.25
2025-03-10,18:32:00,19467.0,BUY,3,0.02h,Break Even,$0.75,$2460.00,$422639.75,307,$2460.00
2025-03-10,18:35:00,19442.0,SELL,3,0.02h,Stop Loss,$135.75,$2595.75,$422775.50,307,$2595.75
2025-03-10,19:18:00,19364.0,BUY,3,0.02h,Stop Loss,$124.50,$2720.25,$422900.00,307,$2720.25
2025-03-10,19:45:00,19393.75,SELL,3,0.02h,Stop Loss,$-18.00,$2702.25,$422882.00,307,$2702.25
2025-03-10,19:52:00,19458.5,BUY,3,0.02h,Stop Loss,$300.75,$3003.00,$423182.75,307,$3003.00
2025-03-10,19:54:00,19427.75,SELL,3,0.02h,Stop Loss,$402.00,$3405.00,$423584.75,307,$3405.00
2025-03-10,19:56:00,19470.25,BUY,3,0.02h,Stop Loss,$75.75,$3480.75,$423660.50,307,$3480.75
2025-03-10,20:38:00,19466.75,SELL,3,0.02h,Break Even,$0.75,$3481.50,$423661.25,307,$3481.50
2025-03-10,20:46:00,19474.75,BUY,3,0.02h,Stop Loss,$30.75,$3512.25,$423692.00,307,$3512.25
2025-03-10,22:01:00,19440.0,SELL,3,0.02h,Stop Loss,$-18.00,$3494.25,$423674.00,307,$3494.25
2025-03-10,22:30:00,19418.0,BUY,3,0.02h,Stop Loss,$139.50,$3633.75,$423813.50,307,$3633.75
2025-03-10,22:50:00,19418.25,SELL,3,0.02h,Break Even,$0.75,$3634.50,$423814.25,307,$3634.50
,,,,,,,,,,,
2025-03-11,12:00:00,19577.25,BUY,3,0.02h,Stop Loss,$49.50,$49.50,$423863.75,308,$49.50
2025-03-11,12:32:00,19484.0,SELL,3,0.02h,Stop Loss,$-18.00,$31.50,$423845.75,308,$31.50
2025-03-11,13:22:00,19461.5,BUY,3,0.02h,Break Even,$0.75,$32.25,$423846.50,308,$32.25
2025-03-11,13:24:00,19450.5,SELL,3,0.02h,Stop Loss,$79.50,$111.75,$423926.00,308,$111.75
2025-03-11,13:38:00,19528.25,BUY,3,0.02h,Stop Loss,$15.75,$127.50,$423941.75,308,$127.50
2025-03-11,14:04:00,19423.5,SELL,3,0.02h,Stop Loss,$1002.00,$1129.50,$424943.75,308,$1129.50
2025-03-11,14:54:00,19388.5,BUY,3,0.02h,Stop Loss,$402.00,$1531.50,$425345.75,308,$1531.50
2025-03-11,15:01:00,19316.25,SELL,3,0.02h,Stop Loss,$75.75,$1607.25,$425421.50,308,$1607.25
2025-03-11,15:07:00,19392.75,BUY,3,0.02h,Stop Loss,$840.75,$2448.00,$426262.25,308,$2448.00
2025-03-11,15:59:00,19440.5,SELL,3,0.02h,Stop Loss,$364.50,$2812.50,$426626.75,308,$2812.50
2025-03-11,16:28:00,19403.5,BUY,3,0.02h,Stop Loss,$90.75,$2903.25,$426717.50,308,$2903.25
2025-03-11,16:30:00,19385.75,SELL,3,0.02h,Stop Loss,$-18.00,$2885.25,$426699.50,308,$2885.25
2025-03-11,16:31:00,19401.25,BUY,3,0.02h,Stop Loss,$27.00,$2912.25,$426726.50,308,$2912.25
2025-03-11,16:40:00,19375.5,SELL,3,0.02h,Stop Loss,$349.50,$3261.75,$427076.00,308,$3261.75
2025-03-11,17:43:00,19276.75,BUY,3,0.02h,Break Even,$0.75,$3262.50,$427076.75,308,$3262.50
2025-03-11,19:15:00,19577.75,SELL,3,0.02h,Stop Loss,$353.25,$3615.75,$427430.00,308,$3615.75
2025-03-11,20:49:00,19409.75,BUY,3,0.02h,Break Even,$0.75,$3616.50,$427430.75,308,$3616.50
2025-03-11,20:52:00,19394.0,SELL,3,0.02h,Stop Loss,$102.00,$3718.50,$427532.75,308,$3718.50
2025-03-11,22:01:00,19422.25,BUY,3,0.02h,Stop Loss,$143.25,$3861.75,$427676.00,308,$3861.75
2025-03-11,22:28:00,19426.0,SELL,3,0.02h,Stop Loss,$-18.00,$3843.75,$427658.00,308,$3843.75
2025-03-11,22:30:00,19434.5,BUY,3,0.02h,Break Even,$0.75,$3844.50,$427658.75,308,$3844.50
2025-03-11,22:36:00,19427.75,SELL,3,0.02h,Break Even,$0.75,$3845.25,$427659.50,308,$3845.25
2025-03-11,22:37:00,19436.5,BUY,3,0.02h,Stop Loss,$34.50,$3879.75,$427694.00,308,$3879.75
,,,,,,,,,,,
2025-03-12,13:14:00,19681.25,SELL,3,0.02h,Stop Loss,$105.75,$105.75,$427799.75,309,$105.75
2025-03-12,13:31:00,19694.25,BUY,3,0.02h,Stop Loss,$563.25,$669.00,$428363.00,309,$669.00
2025-03-12,13:48:00,19689.75,SELL,3,0.02h,Stop Loss,$754.50,$1423.50,$429117.50,309,$1423.50
2025-03-12,14:08:00,19693.0,BUY,3,0.02h,Stop Loss,$188.25,$1611.75,$429305.75,309,$1611.75
2025-03-12,14:15:00,19641.75,SELL,3,0.02h,Stop Loss,$368.25,$1980.00,$429674.00,309,$1980.00
2025-03-12,15:24:00,19493.5,BUY,3,0.02h,Stop Loss,$372.00,$2352.00,$430046.00,309,$2352.00
2025-03-12,16:42:00,19638.0,SELL,3,0.02h,Stop Loss,$323.25,$2675.25,$430369.25,309,$2675.25
2025-03-12,16:51:00,19709.0,BUY,3,0.02h,Break Even,$0.75,$2676.00,$430370.00,309,$2676.00
2025-03-12,16:58:00,19658.25,SELL,3,0.02h,Stop Loss,$210.75,$2886.75,$430580.75,309,$2886.75
2025-03-12,17:15:00,19672.75,BUY,3,0.02h,Stop Loss,$-18.00,$2868.75,$430562.75,309,$2868.75
2025-03-12,17:43:00,19680.75,SELL,3,0.02h,Break Even,$0.75,$2869.50,$430563.50,309,$2869.50
2025-03-12,18:18:00,19603.5,BUY,3,0.02h,Stop Loss,$177.00,$3046.50,$430740.50,309,$3046.50
2025-03-12,19:02:00,19630.5,SELL,3,0.02h,Break Even,$0.75,$3047.25,$430741.25,309,$3047.25
2025-03-12,19:56:00,19630.0,BUY,3,0.02h,Stop Loss,$19.50,$3066.75,$430760.75,309,$3066.75
2025-03-12,20:04:00,19595.25,SELL,3,0.02h,Stop Loss,$27.00,$3093.75,$430787.75,309,$3093.75
2025-03-12,20:31:00,19592.75,BUY,3,0.02h,Stop Loss,$-18.00,$3075.75,$430769.75,309,$3075.75
2025-03-12,20:39:00,19580.5,SELL,3,0.02h,Break Even,$0.75,$3076.50,$430770.50,309,$3076.50
2025-03-12,22:03:00,19585.25,BUY,3,0.02h,Stop Loss,$117.00,$3193.50,$430887.50,309,$3193.50
2025-03-12,22:51:00,19611.5,SELL,3,0.02h,Stop Loss,$64.50,$3258.00,$430952.00,309,$3258.00
2025-03-12,22:59:00,19622.25,BUY,3,0.02h,Stop Loss,$30.75,$3288.75,$430982.75,309,$3288.75
,,,,,,,,,,,
2025-03-13,12:00:00,19531.25,SELL,3,0.02h,Stop Loss,$57.00,$57.00,$431039.75,310,$57.00
2025-03-13,12:11:00,19706.0,BUY,3,0.02h,Stop Loss,$-18.00,$39.00,$431021.75,310,$39.00
2025-03-13,12:15:00,19479.25,SELL,3,0.02h,Stop Loss,$-18.00,$21.00,$431003.75,310,$21.00
2025-03-13,12:16:00,19698.5,BUY,3,0.02h,Round Number,$19.50,$40.50,$431023.25,310,$40.50
2025-03-13,12:30:00,19512.0,SELL,3,0.02h,Stop Loss,$-18.00,$22.50,$431005.25,310,$22.50
2025-03-13,12:31:00,19780.25,BUY,3,0.02h,Stop Loss,$-18.00,$4.50,$430987.25,310,$4.50
2025-03-13,12:39:00,19537.5,SELL,3,0.02h,Break Even,$0.75,$5.25,$430988.00,310,$5.25
2025-03-13,12:42:00,19769.0,BUY,3,0.02h,Stop Loss,$-18.00,$-12.75,$430970.00,310,$-12.75
2025-03-13,12:50:00,19519.0,SELL,3,0.02h,Stop Loss,$-18.00,$-30.75,$430952.00,310,$-30.75
2025-03-13,12:51:00,19738.25,BUY,3,0.02h,Stop Loss,$158.25,$127.50,$431110.25,310,$127.50
2025-03-13,12:53:00,19540.75,SELL,3,0.02h,Break Even,$0.75,$128.25,$431111.00,310,$128.25
2025-03-13,13:02:00,19782.25,BUY,3,0.02h,Stop Loss,$-18.00,$110.25,$431093.00,310,$110.25
2025-03-13,13:03:00,19573.5,SELL,3,0.02h,Break Even,$0.75,$111.00,$431093.75,310,$111.00
2025-03-13,13:08:00,19792.25,BUY,3,0.02h,Stop Loss,$-18.00,$93.00,$431075.75,310,$93.00
2025-03-13,13:09:00,19581.75,SELL,3,0.02h,Stop Loss,$-18.00,$75.00,$431057.75,310,$75.00
2025-03-13,13:10:00,19787.0,BUY,3,0.02h,Stop Loss,$-18.00,$57.00,$431039.75,310,$57.00
2025-03-13,13:23:00,19575.25,SELL,3,0.02h,Stop Loss,$-18.00,$39.00,$431021.75,310,$39.00
2025-03-13,13:24:00,19787.25,BUY,3,0.02h,Stop Loss,$-18.00,$21.00,$431003.75,310,$21.00
2025-03-13,13:25:00,19578.75,SELL,3,0.02h,Stop Loss,$-18.00,$3.00,$430985.75,310,$3.00
2025-03-13,13:26:00,19794.0,BUY,3,0.02h,Stop Loss,$-18.00,$-15.00,$430967.75,310,$-15.00
2025-03-13,13:27:00,19581.75,SELL,3,0.02h,Stop Loss,$120.75,$105.75,$431088.50,310,$105.75
2025-03-13,13:35:00,19769.75,BUY,3,0.02h,Stop Loss,$53.25,$159.00,$431141.75,310,$159.00
2025-03-13,13:41:00,19519.75,SELL,3,0.02h,Stop Loss,$75.75,$234.75,$431217.50,310,$234.75
2025-03-13,14:07:00,19639.25,BUY,3,0.02h,Stop Loss,$83.25,$318.00,$431300.75,310,$318.00
2025-03-13,14:12:00,19405.75,SELL,3,0.02h,Break Even,$0.75,$318.75,$431301.50,310,$318.75
2025-03-13,14:21:00,19733.25,BUY,3,0.02h,Stop Loss,$-18.00,$300.75,$431283.50,310,$300.75
2025-03-13,14:29:00,19489.25,SELL,3,0.02h,Stop Loss,$237.00,$537.75,$431520.50,310,$537.75
2025-03-13,14:31:00,19717.75,BUY,3,0.02h,Stop Loss,$184.50,$722.25,$431705.00,310,$722.25
2025-03-13,14:34:00,19484.0,SELL,3,0.02h,Stop Loss,$-18.00,$704.25,$431687.00,310,$704.25
2025-03-13,14:35:00,19692.0,BUY,3,0.02h,Stop Loss,$-18.00,$686.25,$431669.00,310,$686.25
2025-03-13,14:36:00,19471.25,SELL,3,0.02h,Stop Loss,$432.00,$1118.25,$432101.00,310,$1118.25
2025-03-13,14:48:00,19625.75,BUY,3,0.02h,Stop Loss,$15.75,$1134.00,$432116.75,310,$1134.00
2025-03-13,15:02:00,19460.75,SELL,3,0.02h,Stop Loss,$53.25,$1187.25,$432170.00,310,$1187.25
2025-03-13,15:26:00,19569.0,BUY,3,0.02h,Stop Loss,$177.00,$1364.25,$432347.00,310,$1364.25
2025-03-13,15:33:00,19367.0,SELL,3,0.02h,Stop Loss,$27.00,$1391.25,$432374.00,310,$1391.25
2025-03-13,15:47:00,19541.25,BUY,3,0.02h,Stop Loss,$-18.00,$1373.25,$432356.00,310,$1373.25
2025-03-13,15:48:00,19354.5,SELL,3,0.02h,Stop Loss,$-18.00,$1355.25,$432338.00,310,$1355.25
2025-03-13,15:49:00,19550.0,BUY,3,0.02h,Stop Loss,$379.50,$1734.75,$432717.50,310,$1734.75
2025-03-13,16:03:00,19311.5,SELL,3,0.02h,Stop Loss,$-18.00,$1716.75,$432699.50,310,$1716.75
2025-03-13,16:05:00,19529.0,BUY,3,0.02h,Stop Loss,$-18.00,$1698.75,$432681.50,310,$1698.75
2025-03-13,16:06:00,19304.25,SELL,3,0.02h,Stop Loss,$105.75,$1804.50,$432787.25,310,$1804.50
2025-03-13,16:18:00,19513.0,BUY,3,0.02h,Stop Loss,$98.25,$1902.75,$432885.50,310,$1902.75
2025-03-13,16:20:00,19312.75,SELL,3,0.02h,Stop Loss,$-18.00,$1884.75,$432867.50,310,$1884.75
2025-03-13,16:21:00,19517.5,BUY,3,0.02h,Stop Loss,$120.75,$2005.50,$432988.25,310,$2005.50
2025-03-13,16:27:00,19288.0,SELL,3,0.02h,Break Even,$0.75,$2006.25,$432989.00,310,$2006.25
2025-03-13,16:32:00,19547.5,BUY,3,0.02h,Stop Loss,$-18.00,$1988.25,$432971.00,310,$1988.25
2025-03-13,16:33:00,19329.0,SELL,3,0.02h,Break Even,$0.75,$1989.00,$432971.75,310,$1989.00
2025-03-13,16:39:00,19589.0,BUY,3,0.02h,Break Even,$0.75,$1989.75,$432972.50,310,$1989.75
2025-03-13,16:45:00,19323.5,SELL,3,0.02h,Stop Loss,$-18.00,$1971.75,$432954.50,310,$1971.75
2025-03-13,16:46:00,19507.25,BUY,3,0.02h,Stop Loss,$-18.00,$1953.75,$432936.50,310,$1953.75
2025-03-13,16:51:00,19276.0,SELL,3,0.02h,Stop Loss,$-18.00,$1935.75,$432918.50,310,$1935.75
2025-03-13,16:52:00,19475.5,BUY,3,0.02h,Stop Loss,$503.25,$2439.00,$433421.75,310,$2439.00
2025-03-13,16:54:00,19282.75,SELL,3,0.02h,Stop Loss,$-18.00,$2421.00,$433403.75,310,$2421.00
2025-03-13,16:56:00,19470.5,BUY,3,0.02h,Break Even,$0.75,$2421.75,$433404.50,310,$2421.75
2025-03-13,17:02:00,19266.0,SELL,3,0.02h,Break Even,$0.75,$2422.50,$433405.25,310,$2422.50
2025-03-13,17:07:00,19463.0,BUY,3,0.02h,Stop Loss,$-18.00,$2404.50,$433387.25,310,$2404.50
2025-03-13,17:08:00,19263.75,SELL,3,0.02h,Stop Loss,$30.75,$2435.25,$433418.00,310,$2435.25
2025-03-13,17:40:00,19392.0,BUY,3,0.02h,Stop Loss,$-18.00,$2417.25,$433400.00,310,$2417.25
2025-03-13,17:41:00,19208.75,SELL,3,0.02h,Stop Loss,$-18.00,$2399.25,$433382.00,310,$2399.25
2025-03-13,17:42:00,19396.25,BUY,3,0.02h,Stop Loss,$-18.00,$2381.25,$433364.00,310,$2381.25
2025-03-13,17:43:00,19194.0,SELL,3,0.02h,Break Even,$0.75,$2382.00,$433364.75,310,$2382.00
2025-03-13,17:46:00,19383.0,BUY,3,0.02h,Stop Loss,$-18.00,$2364.00,$433346.75,310,$2364.00
2025-03-13,17:47:00,19178.75,SELL,3,0.02h,Stop Loss,$-18.00,$2346.00,$433328.75,310,$2346.00
2025-03-13,17:49:00,19379.0,BUY,3,0.02h,Stop Loss,$72.00,$2418.00,$433400.75,310,$2418.00
2025-03-13,17:54:00,19220.5,SELL,3,0.02h,Stop Loss,$132.00,$2550.00,$433532.75,310,$2550.00
2025-03-13,18:02:00,19438.25,BUY,3,0.02h,Stop Loss,$-18.00,$2532.00,$433514.75,310,$2532.00
2025-03-13,18:03:00,19249.75,SELL,3,0.02h,Stop Loss,$-18.00,$2514.00,$433496.75,310,$2514.00
2025-03-13,18:04:00,19457.0,BUY,3,0.02h,Stop Loss,$-18.00,$2496.00,$433478.75,310,$2496.00
2025-03-13,18:09:00,19272.5,SELL,3,0.02h,Stop Loss,$162.00,$2658.00,$433640.75,310,$2658.00
2025-03-13,18:12:00,19486.0,BUY,3,0.02h,Stop Loss,$-18.00,$2640.00,$433622.75,310,$2640.00
2025-03-13,18:49:00,19375.0,SELL,3,0.02h,Stop Loss,$60.75,$2700.75,$433683.50,310,$2700.75
2025-03-13,18:52:00,19559.0,BUY,3,0.02h,Break Even,$0.75,$2701.50,$433684.25,310,$2701.50
2025-03-13,18:54:00,19317.25,SELL,3,0.02h,Stop Loss,$15.75,$2717.25,$433700.00,310,$2717.25
2025-03-13,18:56:00,19554.75,BUY,3,0.02h,Stop Loss,$30.75,$2748.00,$433730.75,310,$2748.00
2025-03-13,19:08:00,19315.75,SELL,3,0.02h,Stop Loss,$-18.00,$2730.00,$433712.75,310,$2730.00
2025-03-13,19:09:00,19515.25,BUY,3,0.02h,Stop Loss,$128.25,$2858.25,$433841.00,310,$2858.25
2025-03-13,19:11:00,19314.25,SELL,3,0.02h,Stop Loss,$-18.00,$2840.25,$433823.00,310,$2840.25
2025-03-13,19:13:00,19521.25,BUY,3,0.02h,Stop Loss,$-18.00,$2822.25,$433805.00,310,$2822.25
2025-03-13,19:14:00,19313.0,SELL,3,0.02h,Stop Loss,$15.75,$2838.00,$433820.75,310,$2838.00
2025-03-13,19:19:00,19516.5,BUY,3,0.02h,Stop Loss,$244.50,$3082.50,$434065.25,310,$3082.50
2025-03-13,19:22:00,19307.5,SELL,3,0.02h,Break Even,$0.75,$3083.25,$434066.00,310,$3083.25
2025-03-13,19:42:00,19428.5,BUY,3,0.02h,Break Even,$0.75,$3084.00,$434066.75,310,$3084.00
2025-03-13,19:45:00,19226.75,SELL,3,0.02h,Stop Loss,$-18.00,$3066.00,$434048.75,310,$3066.00
2025-03-13,19:46:00,19413.5,BUY,3,0.02h,Stop Loss,$402.00,$3468.00,$434450.75,310,$3468.00
2025-03-13,19:48:00,19231.0,SELL,3,0.02h,Stop Loss,$113.25,$3581.25,$434564.00,310,$3581.25
2025-03-13,20:01:00,19472.0,BUY,3,0.02h,Stop Loss,$-18.00,$3563.25,$434546.00,310,$3563.25
2025-03-13,20:03:00,19280.0,SELL,3,0.02h,Stop Loss,$-18.00,$3545.25,$434528.00,310,$3545.25
2025-03-13,20:04:00,19495.25,BUY,3,0.02h,Stop Loss,$-18.00,$3527.25,$434510.00,310,$3527.25
2025-03-13,20:32:00,19317.75,SELL,3,0.02h,Break Even,$0.75,$3528.00,$434510.75,310,$3528.00
2025-03-13,20:47:00,19504.75,BUY,3,0.02h,Stop Loss,$-18.00,$3510.00,$434492.75,310,$3510.00
2025-03-13,20:48:00,19299.75,SELL,3,0.02h,Stop Loss,$68.25,$3578.25,$434561.00,310,$3578.25
2025-03-13,20:53:00,19504.0,BUY,3,0.02h,Stop Loss,$-18.00,$3560.25,$434543.00,310,$3560.25
2025-03-13,20:55:00,19298.5,SELL,3,0.02h,Break Even,$0.75,$3561.00,$434543.75,310,$3561.00
2025-03-13,21:00:00,19500.0,BUY,3,1.02h,Stop Loss,$-18.00,$3543.00,$434525.75,310,$3543.00
2025-03-13,22:10:00,19337.75,SELL,3,0.02h,Stop Loss,$27.00,$3570.00,$434552.75,310,$3570.00
2025-03-13,22:14:00,19548.75,BUY,3,0.02h,Stop Loss,$23.25,$3593.25,$434576.00,310,$3593.25
2025-03-13,22:25:00,19323.5,SELL,3,0.02h,Stop Loss,$-18.00,$3575.25,$434558.00,310,$3575.25
2025-03-13,22:26:00,19534.5,BUY,3,0.02h,Stop Loss,$-18.00,$3557.25,$434540.00,310,$3557.25
2025-03-13,22:28:00,19326.25,SELL,3,0.02h,Stop Loss,$-18.00,$3539.25,$434522.00,310,$3539.25
2025-03-13,22:29:00,19540.0,BUY,3,0.02h,Stop Loss,$-18.00,$3521.25,$434504.00,310,$3521.25
2025-03-13,22:30:00,19338.0,SELL,3,0.02h,Stop Loss,$-18.00,$3503.25,$434486.00,310,$3503.25
2025-03-13,22:33:00,19543.25,BUY,3,0.02h,Stop Loss,$-18.00,$3485.25,$434468.00,310,$3485.25
2025-03-13,22:40:00,19367.25,SELL,3,0.02h,Stop Loss,$-18.00,$3467.25,$434450.00,310,$3467.25
2025-03-13,22:45:00,19567.75,BUY,3,0.02h,Stop Loss,$-18.00,$3449.25,$434432.00,310,$3449.25
2025-03-13,22:51:00,19371.0,SELL,3,0.02h,Stop Loss,$15.75,$3465.00,$434447.75,310,$3465.00
2025-03-13,22:53:00,19574.25,BUY,3,0.02h,Stop Loss,$-18.00,$3447.00,$434429.75,310,$3447.00
2025-03-13,22:54:00,19380.0,SELL,3,0.02h,Break Even,$0.75,$3447.75,$434430.50,310,$3447.75
2025-03-13,22:56:00,19581.25,BUY,3,0.02h,Stop Loss,$-18.00,$3429.75,$434412.50,310,$3429.75
2025-03-13,22:57:00,19378.75,SELL,3,0.02h,Stop Loss,$-18.00,$3411.75,$434394.50,310,$3411.75
2025-03-13,22:58:00,19568.25,BUY,3,0.02h,Break Even,$0.75,$3412.50,$434395.25,310,$3412.50
,,,,,,,,,,,
2025-03-14,12:22:00,19498.25,SELL,3,0.02h,Stop Loss,$-18.00,$-18.00,$434377.25,311,$-18.00
2025-03-14,12:29:00,19720.0,BUY,3,0.02h,Stop Loss,$-18.00,$-36.00,$434359.25,311,$-36.00
2025-03-14,12:36:00,19515.0,SELL,3,0.02h,Break Even,$0.75,$-35.25,$434360.00,311,$-35.25
2025-03-14,12:39:00,19717.5,BUY,3,0.02h,Stop Loss,$-18.00,$-53.25,$434342.00,311,$-53.25
2025-03-14,12:56:00,19501.5,SELL,3,0.02h,Stop Loss,$19.50,$-33.75,$434361.50,311,$-33.75
2025-03-14,13:15:00,19685.25,BUY,3,0.02h,Stop Loss,$-18.00,$-51.75,$434343.50,311,$-51.75
2025-03-14,13:16:00,19479.0,SELL,3,0.02h,Stop Loss,$27.00,$-24.75,$434370.50,311,$-24.75
2025-03-14,13:27:00,19679.5,BUY,3,0.02h,Stop Loss,$-18.00,$-42.75,$434352.50,311,$-42.75
2025-03-14,13:33:00,19492.75,SELL,3,0.02h,Stop Loss,$-18.00,$-60.75,$434334.50,311,$-60.75
2025-03-14,13:36:00,19565.25,BUY,3,0.02h,Stop Loss,$3233.25,$3172.50,$437567.75,311,$3172.50
2025-03-14,13:58:00,19555.0,SELL,3,0.02h,Stop Loss,$53.25,$3225.75,$437621.00,311,$3225.75
2025-03-14,14:06:00,19752.75,BUY,3,0.02h,Stop Loss,$495.75,$3721.50,$438116.75,311,$3721.50
2025-03-14,14:11:00,19516.5,SELL,3,0.02h,Stop Loss,$-18.00,$3703.50,$438098.75,311,$3703.50
2025-03-14,14:14:00,19704.5,BUY,3,0.02h,Stop Loss,$-18.00,$3685.50,$438080.75,311,$3685.50
2025-03-14,14:15:00,19478.75,SELL,3,0.02h,Stop Loss,$15.75,$3701.25,$438096.50,311,$3701.25
2025-03-14,14:25:00,19721.25,BUY,3,0.02h,Stop Loss,$-18.00,$3683.25,$438078.50,311,$3683.25
2025-03-14,14:26:00,19501.0,SELL,3,0.02h,Stop Loss,$225.75,$3909.00,$438304.25,311,$3909.00
2025-03-14,14:30:00,19681.5,BUY,3,0.02h,Stop Loss,$-18.00,$3891.00,$438286.25,311,$3891.00
2025-03-14,14:31:00,19490.25,SELL,3,0.02h,Stop Loss,$-18.00,$3873.00,$438268.25,311,$3873.00
2025-03-14,14:32:00,19706.25,BUY,3,0.02h,Stop Loss,$-18.00,$3855.00,$438250.25,311,$3855.00
2025-03-14,14:33:00,19492.25,SELL,3,0.02h,Stop Loss,$135.75,$3990.75,$438386.00,311,$3990.75
2025-03-14,14:36:00,19683.0,BUY,3,0.02h,Stop Loss,$308.25,$4299.00,$438694.25,311,$4299.00
2025-03-14,14:44:00,19539.5,SELL,3,0.02h,Stop Loss,$64.50,$4363.50,$438758.75,311,$4363.50
2025-03-14,14:46:00,19763.5,BUY,3,0.02h,Stop Loss,$83.25,$4446.75,$438842.00,311,$4446.75
2025-03-14,14:54:00,19564.5,SELL,3,0.02h,Stop Loss,$53.25,$4500.00,$438895.25,311,$4500.00
2025-03-14,15:00:00,19817.0,BUY,3,0.02h,Stop Loss,$409.50,$4909.50,$439304.75,311,$4909.50
2025-03-14,15:07:00,19632.5,SELL,3,0.02h,Stop Loss,$79.50,$4989.00,$439384.25,311,$4989.00
2025-03-14,15:09:00,19833.0,BUY,3,0.02h,Stop Loss,$-18.00,$4971.00,$439366.25,311,$4971.00
2025-03-14,15:30:00,19644.75,SELL,3,0.02h,Stop Loss,$12.00,$4983.00,$439378.25,311,$4983.00
2025-03-14,15:36:00,19870.5,BUY,3,0.02h,Stop Loss,$75.75,$5058.75,$439454.00,311,$5058.75
2025-03-14,15:40:00,19681.75,SELL,3,0.02h,Stop Loss,$-18.00,$5040.75,$439436.00,311,$5040.75
2025-03-14,15:41:00,19894.5,BUY,3,0.02h,Stop Loss,$64.50,$5105.25,$439500.50,311,$5105.25
2025-03-14,15:45:00,19696.75,SELL,3,0.02h,Stop Loss,$387.00,$5492.25,$439887.50,311,$5492.25
2025-03-14,15:47:00,19878.0,BUY,3,0.02h,Break Even,$0.75,$5493.00,$439888.25,311,$5493.00
2025-03-14,15:59:00,19667.5,SELL,3,0.02h,Stop Loss,$-18.00,$5475.00,$439870.25,311,$5475.00
2025-03-14,16:12:00,19845.25,BUY,3,0.02h,Stop Loss,$23.25,$5498.25,$439893.50,311,$5498.25
2025-03-14,16:19:00,19638.5,SELL,3,0.02h,Stop Loss,$102.00,$5600.25,$439995.50,311,$5600.25
2025-03-14,16:36:00,19857.0,BUY,3,0.02h,Stop Loss,$-18.00,$5582.25,$439977.50,311,$5582.25
2025-03-14,16:51:00,19690.5,SELL,3,0.02h,Stop Loss,$-18.00,$5564.25,$439959.50,311,$5564.25
2025-03-14,16:52:00,19900.5,BUY,3,0.02h,Stop Loss,$-18.00,$5546.25,$439941.50,311,$5546.25
2025-03-14,17:05:00,19675.0,SELL,3,0.02h,Stop Loss,$49.50,$5595.75,$439991.00,311,$5595.75
2025-03-14,17:34:00,19845.5,BUY,3,0.02h,Stop Loss,$27.00,$5622.75,$440018.00,311,$5622.75
2025-03-14,17:43:00,19634.5,SELL,3,0.02h,Break Even,$0.75,$5623.50,$440018.75,311,$5623.50
2025-03-14,17:46:00,19833.0,BUY,3,0.02h,Stop Loss,$102.00,$5725.50,$440120.75,311,$5725.50
2025-03-14,18:07:00,19669.0,SELL,3,0.02h,Stop Loss,$203.25,$5928.75,$440324.00,311,$5928.75
2025-03-14,18:23:00,19838.75,BUY,3,0.02h,Stop Loss,$-18.00,$5910.75,$440306.00,311,$5910.75
2025-03-14,18:24:00,19622.25,SELL,3,0.02h,Stop Loss,$102.00,$6012.75,$440408.00,311,$6012.75
2025-03-14,18:32:00,19867.25,BUY,3,0.02h,Break Even,$0.75,$6013.50,$440408.75,311,$6013.50
2025-03-14,18:45:00,19687.5,SELL,3,0.02h,Stop Loss,$-18.00,$5995.50,$440390.75,311,$5995.50
2025-03-14,18:46:00,19894.0,BUY,3,0.02h,Stop Loss,$124.50,$6120.00,$440515.25,311,$6120.00
2025-03-14,18:51:00,19693.25,SELL,3,0.02h,Stop Loss,$-18.00,$6102.00,$440497.25,311,$6102.00
2025-03-14,18:52:00,19885.0,BUY,3,0.02h,Stop Loss,$-18.00,$6084.00,$440479.25,311,$6084.00
2025-03-14,18:54:00,19688.25,SELL,3,0.02h,Stop Loss,$135.75,$6219.75,$440615.00,311,$6219.75
2025-03-14,18:58:00,19866.25,BUY,3,0.02h,Stop Loss,$-18.00,$6201.75,$440597.00,311,$6201.75
2025-03-14,18:59:00,19678.25,SELL,3,0.02h,Stop Loss,$75.75,$6277.50,$440672.75,311,$6277.50
2025-03-14,19:06:00,19897.5,BUY,3,0.02h,Stop Loss,$113.25,$6390.75,$440786.00,311,$6390.75
2025-03-14,19:11:00,19700.75,SELL,3,0.02h,Break Even,$0.75,$6391.50,$440786.75,311,$6391.50
2025-03-14,19:13:00,19917.0,BUY,3,0.02h,Break Even,$0.75,$6392.25,$440787.50,311,$6392.25
2025-03-14,19:24:00,19679.5,SELL,3,0.02h,Stop Loss,$-18.00,$6374.25,$440769.50,311,$6374.25
2025-03-14,19:27:00,19895.0,BUY,3,0.02h,Break Even,$0.75,$6375.00,$440770.25,311,$6375.00
2025-03-14,19:35:00,19682.25,SELL,3,0.02h,Stop Loss,$-18.00,$6357.00,$440752.25,311,$6357.00
2025-03-14,19:36:00,19881.25,BUY,3,0.02h,Stop Loss,$-18.00,$6339.00,$440734.25,311,$6339.00
2025-03-14,19:37:00,19673.25,SELL,3,0.02h,Stop Loss,$30.75,$6369.75,$440765.00,311,$6369.75
2025-03-14,19:41:00,19875.25,BUY,3,0.02h,Stop Loss,$-18.00,$6351.75,$440747.00,311,$6351.75
2025-03-14,19:43:00,19665.0,SELL,3,0.02h,Stop Loss,$-18.00,$6333.75,$440729.00,311,$6333.75
2025-03-14,19:44:00,19872.0,BUY,3,0.02h,Stop Loss,$-18.00,$6315.75,$440711.00,311,$6315.75
2025-03-14,19:45:00,19668.5,SELL,3,0.02h,Stop Loss,$83.25,$6399.00,$440794.25,311,$6399.00
2025-03-14,19:50:00,19902.0,BUY,3,0.02h,Stop Loss,$-18.00,$6381.00,$440776.25,311,$6381.00
2025-03-14,19:52:00,19696.25,SELL,3,0.02h,Break Even,$0.75,$6381.75,$440777.00,311,$6381.75
2025-03-14,19:58:00,19937.5,BUY,3,0.02h,Stop Loss,$-18.00,$6363.75,$440759.00,311,$6363.75
2025-03-14,19:59:00,19731.5,SELL,3,0.02h,Stop Loss,$-18.00,$6345.75,$440741.00,311,$6345.75
2025-03-14,20:00:00,19912.5,BUY,3,0.02h,Stop Loss,$-18.00,$6327.75,$440723.00,311,$6327.75
2025-03-14,20:03:00,19676.5,SELL,3,0.02h,Stop Loss,$98.25,$6426.00,$440821.25,311,$6426.00
2025-03-14,20:13:00,19865.75,BUY,3,0.02h,Stop Loss,$34.50,$6460.50,$440855.75,311,$6460.50
2025-03-14,20:17:00,19659.75,SELL,3,0.02h,Stop Loss,$-18.00,$6442.50,$440837.75,311,$6442.50
2025-03-14,20:22:00,19854.0,BUY,3,0.02h,Stop Loss,$-18.00,$6424.50,$440819.75,311,$6424.50
2025-03-14,20:23:00,19644.75,SELL,3,0.02h,Stop Loss,$15.75,$6440.25,$440835.50,311,$6440.25
2025-03-14,20:31:00,19870.5,BUY,3,0.02h,Stop Loss,$-18.00,$6422.25,$440817.50,311,$6422.25
2025-03-14,20:32:00,19666.5,SELL,3,0.02h,Stop Loss,$-18.00,$6404.25,$440799.50,311,$6404.25
2025-03-14,20:33:00,19865.75,BUY,3,0.02h,Stop Loss,$-18.00,$6386.25,$440781.50,311,$6386.25
2025-03-14,20:53:00,19663.5,SELL,3,0.02h,Stop Loss,$-18.00,$6368.25,$440763.50,311,$6368.25
2025-03-14,20:54:00,19874.0,BUY,3,0.02h,Stop Loss,$-18.00,$6350.25,$440745.50,311,$6350.25
2025-03-14,20:57:00,19668.25,SELL,3,0.02h,Stop Loss,$-18.00,$6332.25,$440727.50,311,$6332.25
,,,,,,,,,,,
2025-03-17,12:01:00,19892.5,BUY,3,0.02h,Break Even,$0.75,$0.75,$440728.25,312,$0.75
2025-03-17,13:02:00,19939.0,SELL,3,0.02h,Break Even,$0.75,$1.50,$440729.00,312,$1.50
2025-03-17,13:34:00,19962.25,BUY,3,0.02h,Stop Loss,$42.00,$43.50,$440771.00,312,$43.50
2025-03-17,14:02:00,19956.25,SELL,3,0.02h,Stop Loss,$128.25,$171.75,$440899.25,312,$171.75
2025-03-17,14:14:00,20010.5,BUY,3,0.02h,Stop Loss,$158.25,$330.00,$441057.50,312,$330.00
2025-03-17,14:27:00,19966.75,SELL,3,0.02h,Stop Loss,$218.25,$548.25,$441275.75,312,$548.25
2025-03-17,14:49:00,19955.0,BUY,3,0.02h,Stop Loss,$53.25,$601.50,$441329.00,312,$601.50
2025-03-17,14:52:00,19932.5,SELL,3,0.02h,Stop Loss,$98.25,$699.75,$441427.25,312,$699.75
2025-03-17,15:18:00,19923.75,BUY,3,0.02h,Stop Loss,$64.50,$764.25,$441491.75,312,$764.25
2025-03-17,15:30:00,19885.75,SELL,3,0.02h,Stop Loss,$64.50,$828.75,$441556.25,312,$828.75
2025-03-17,15:52:00,19894.25,BUY,3,0.02h,Stop Loss,$27.00,$855.75,$441583.25,312,$855.75
2025-03-17,16:02:00,19867.0,SELL,3,0.02h,Stop Loss,$45.75,$901.50,$441629.00,312,$901.50
2025-03-17,16:05:00,19896.75,BUY,3,0.02h,Stop Loss,$79.50,$981.00,$441708.50,312,$981.00
2025-03-17,16:23:00,19894.0,SELL,3,0.02h,Stop Loss,$207.00,$1188.00,$441915.50,312,$1188.00
2025-03-17,16:39:00,19905.75,BUY,3,0.02h,Break Even,$0.75,$1188.75,$441916.25,312,$1188.75
2025-03-17,16:42:00,19871.25,SELL,3,0.02h,Stop Loss,$83.25,$1272.00,$441999.50,312,$1272.00
2025-03-17,16:52:00,19906.25,BUY,3,0.02h,Stop Loss,$87.00,$1359.00,$442086.50,312,$1359.00
2025-03-17,17:04:00,19883.75,SELL,3,0.02h,Break Even,$0.75,$1359.75,$442087.25,312,$1359.75
2025-03-17,17:07:00,19910.0,BUY,3,0.02h,Stop Loss,$158.25,$1518.00,$442245.50,312,$1518.00
2025-03-17,19:03:00,20131.75,SELL,3,0.02h,Stop Loss,$42.00,$1560.00,$442287.50,312,$1560.00
2025-03-17,20:29:00,20036.0,BUY,3,0.02h,Stop Loss,$34.50,$1594.50,$442322.00,312,$1594.50
2025-03-17,20:49:00,20032.75,SELL,3,0.02h,Stop Loss,$-18.00,$1576.50,$442304.00,312,$1576.50
2025-03-17,20:52:00,20037.5,BUY,3,0.03h,Break Even,$0.75,$1577.25,$442304.75,312,$1577.25
2025-03-17,22:51:00,20058.25,SELL,3,0.02h,Stop Loss,$-18.00,$1559.25,$442286.75,312,$1559.25
,,,,,,,,,,,
2025-03-18,12:28:00,19960.5,BUY,3,0.02h,Stop Loss,$-18.00,$-18.00,$442268.75,313,$-18.00
2025-03-18,12:29:00,19755.5,SELL,3,0.02h,Break Even,$0.75,$-17.25,$442269.50,313,$-17.25
2025-03-18,12:43:00,19944.75,BUY,3,0.02h,Stop Loss,$68.25,$51.00,$442337.75,313,$51.00
2025-03-18,12:50:00,19733.75,SELL,3,0.02h,Stop Loss,$30.75,$81.75,$442368.50,313,$81.75
2025-03-18,13:01:00,19893.5,BUY,3,0.02h,Stop Loss,$-18.00,$63.75,$442350.50,313,$63.75
2025-03-18,13:02:00,19691.25,SELL,3,0.02h,Stop Loss,$-18.00,$45.75,$442332.50,313,$45.75
2025-03-18,13:03:00,19905.75,BUY,3,0.02h,Stop Loss,$90.75,$136.50,$442423.25,313,$136.50
2025-03-18,13:16:00,19714.75,SELL,3,0.02h,Stop Loss,$-18.00,$118.50,$442405.25,313,$118.50
2025-03-18,13:17:00,19922.75,BUY,3,0.02h,Stop Loss,$-18.00,$100.50,$442387.25,313,$100.50
2025-03-18,13:18:00,19711.0,SELL,3,0.02h,Stop Loss,$169.50,$270.00,$442556.75,313,$270.00
2025-03-18,13:28:00,19891.5,BUY,3,0.02h,Stop Loss,$53.25,$323.25,$442610.00,313,$323.25
2025-03-18,13:33:00,19666.75,SELL,3,0.02h,Stop Loss,$15.75,$339.00,$442625.75,313,$339.00
2025-03-18,14:08:00,19705.5,BUY,3,0.02h,Stop Loss,$57.00,$396.00,$442682.75,313,$396.00
2025-03-18,14:10:00,19508.5,SELL,3,0.02h,Stop Loss,$-18.00,$378.00,$442664.75,313,$378.00
2025-03-18,14:11:00,19697.0,BUY,3,0.02h,Stop Loss,$188.25,$566.25,$442853.00,313,$566.25
2025-03-18,14:17:00,19464.25,SELL,3,0.02h,Stop Loss,$165.75,$732.00,$443018.75,313,$732.00
2025-03-18,14:28:00,19703.0,BUY,3,0.02h,Stop Loss,$53.25,$785.25,$443072.00,313,$785.25
2025-03-18,14:39:00,19503.5,SELL,3,0.02h,Stop Loss,$15.75,$801.00,$443087.75,313,$801.00
2025-03-18,14:45:00,19689.75,BUY,3,0.02h,Stop Loss,$-18.00,$783.00,$443069.75,313,$783.00
2025-03-18,14:46:00,19473.0,SELL,3,0.02h,Stop Loss,$-18.00,$765.00,$443051.75,313,$765.00
2025-03-18,14:50:00,19660.75,BUY,3,0.02h,Stop Loss,$375.75,$1140.75,$443427.50,313,$1140.75
2025-03-18,14:56:00,19486.75,SELL,3,0.02h,Stop Loss,$27.00,$1167.75,$443454.50,313,$1167.75
2025-03-18,15:20:00,19673.75,BUY,3,0.02h,Stop Loss,$15.75,$1183.50,$443470.25,313,$1183.50
2025-03-18,15:41:00,19479.0,SELL,3,0.02h,Stop Loss,$-18.00,$1165.50,$443452.25,313,$1165.50
2025-03-18,15:42:00,19668.75,BUY,3,0.02h,Stop Loss,$-18.00,$1147.50,$443434.25,313,$1147.50
2025-03-18,15:43:00,19462.5,SELL,3,0.02h,Stop Loss,$-18.00,$1129.50,$443416.25,313,$1129.50
2025-03-18,15:54:00,19656.25,BUY,3,0.02h,Stop Loss,$-18.00,$1111.50,$443398.25,313,$1111.50
2025-03-18,15:55:00,19447.25,SELL,3,0.02h,Stop Loss,$-18.00,$1093.50,$443380.25,313,$1093.50
2025-03-18,15:56:00,19649.25,BUY,3,0.02h,Stop Loss,$-18.00,$1075.50,$443362.25,313,$1075.50
2025-03-18,16:12:00,19505.0,SELL,3,0.02h,Stop Loss,$-18.00,$1057.50,$443344.25,313,$1057.50
2025-03-18,16:13:00,19717.75,BUY,3,0.02h,Stop Loss,$-18.00,$1039.50,$443326.25,313,$1039.50
2025-03-18,16:14:00,19509.75,SELL,3,0.02h,Stop Loss,$-18.00,$1021.50,$443308.25,313,$1021.50
2025-03-18,16:15:00,19724.5,BUY,3,0.02h,Stop Loss,$-18.00,$1003.50,$443290.25,313,$1003.50
2025-03-18,16:16:00,19522.0,SELL,3,0.02h,Stop Loss,$-18.00,$985.50,$443272.25,313,$985.50
2025-03-18,16:17:00,19726.5,BUY,3,0.02h,Stop Loss,$-18.00,$967.50,$443254.25,313,$967.50
2025-03-18,16:28:00,19523.75,SELL,3,0.02h,Stop Loss,$60.75,$1028.25,$443315.00,313,$1028.25
2025-03-18,16:36:00,19745.5,BUY,3,0.02h,Stop Loss,$-18.00,$1010.25,$443297.00,313,$1010.25
2025-03-18,16:37:00,19537.25,SELL,3,0.02h,Stop Loss,$207.00,$1217.25,$443504.00,313,$1217.25
2025-03-18,16:41:00,19740.5,BUY,3,0.02h,Break Even,$0.75,$1218.00,$443504.75,313,$1218.00
2025-03-18,16:45:00,19484.75,SELL,3,0.02h,Stop Loss,$-18.00,$1200.00,$443486.75,313,$1200.00
2025-03-18,16:57:00,19693.0,BUY,3,0.02h,Stop Loss,$-18.00,$1182.00,$443468.75,313,$1182.00
2025-03-18,16:58:00,19502.5,SELL,3,0.02h,Stop Loss,$-18.00,$1164.00,$443450.75,313,$1164.00
2025-03-18,16:59:00,19727.25,BUY,3,0.02h,Stop Loss,$-18.00,$1146.00,$443432.75,313,$1146.00
2025-03-18,17:01:00,19527.0,SELL,3,0.02h,Stop Loss,$143.25,$1289.25,$443576.00,313,$1289.25
2025-03-18,17:04:00,19735.0,BUY,3,0.02h,Stop Loss,$-18.00,$1271.25,$443558.00,313,$1271.25
2025-03-18,17:05:00,19527.0,SELL,3,0.02h,Stop Loss,$173.25,$1444.50,$443731.25,313,$1444.50
2025-03-18,17:07:00,19700.25,BUY,3,0.02h,Stop Loss,$27.00,$1471.50,$443758.25,313,$1471.50
2025-03-18,17:19:00,19510.0,SELL,3,0.02h,Stop Loss,$942.00,$2413.50,$444700.25,313,$2413.50
2025-03-18,17:25:00,19706.75,BUY,3,0.02h,Stop Loss,$233.25,$2646.75,$444933.50,313,$2646.75
2025-03-18,17:29:00,19492.0,SELL,3,0.02h,Stop Loss,$-18.00,$2628.75,$444915.50,313,$2628.75
2025-03-18,17:30:00,19701.25,BUY,3,0.02h,Stop Loss,$-18.00,$2610.75,$444897.50,313,$2610.75
2025-03-18,17:31:00,19485.5,SELL,3,0.02h,Stop Loss,$-18.00,$2592.75,$444879.50,313,$2592.75
2025-03-18,17:49:00,19724.0,BUY,3,0.02h,Stop Loss,$-18.00,$2574.75,$444861.50,313,$2574.75
2025-03-18,17:52:00,19525.5,SELL,3,0.02h,Stop Loss,$-18.00,$2556.75,$444843.50,313,$2556.75
2025-03-18,17:57:00,19706.0,BUY,3,0.02h,Stop Loss,$38.25,$2595.00,$444881.75,313,$2595.00
2025-03-18,18:02:00,19491.5,SELL,3,0.02h,Stop Loss,$-18.00,$2577.00,$444863.75,313,$2577.00
2025-03-18,18:09:00,19687.75,BUY,3,0.02h,Stop Loss,$-18.00,$2559.00,$444845.75,313,$2559.00
2025-03-18,18:10:00,19488.5,SELL,3,0.02h,Stop Loss,$-18.00,$2541.00,$444827.75,313,$2541.00
2025-03-18,18:11:00,19677.0,BUY,3,0.02h,Stop Loss,$-18.00,$2523.00,$444809.75,313,$2523.00
2025-03-18,18:14:00,19466.75,SELL,3,0.02h,Stop Loss,$120.75,$2643.75,$444930.50,313,$2643.75
2025-03-18,18:18:00,19670.75,BUY,3,0.02h,Stop Loss,$-18.00,$2625.75,$444912.50,313,$2625.75
2025-03-18,18:19:00,19478.75,SELL,3,0.02h,Stop Loss,$98.25,$2724.00,$445010.75,313,$2724.00
2025-03-18,18:24:00,19721.5,BUY,3,0.02h,Stop Loss,$-18.00,$2706.00,$444992.75,313,$2706.00
2025-03-18,18:48:00,19522.0,SELL,3,0.02h,Stop Loss,$-18.00,$2688.00,$444974.75,313,$2688.00
2025-03-18,18:49:00,19730.25,BUY,3,0.02h,Stop Loss,$390.75,$3078.75,$445365.50,313,$3078.75
2025-03-18,18:58:00,19539.0,SELL,3,0.02h,Stop Loss,$102.00,$3180.75,$445467.50,313,$3180.75
2025-03-18,19:01:00,19726.75,BUY,3,0.02h,Stop Loss,$79.50,$3260.25,$445547.00,313,$3260.25
2025-03-18,19:03:00,19536.0,SELL,3,0.02h,Stop Loss,$-18.00,$3242.25,$445529.00,313,$3242.25
2025-03-18,19:04:00,19742.25,BUY,3,0.02h,Stop Loss,$38.25,$3280.50,$445567.25,313,$3280.50
2025-03-18,19:06:00,19524.5,SELL,3,0.02h,Stop Loss,$-18.00,$3262.50,$445549.25,313,$3262.50
2025-03-18,19:08:00,19721.5,BUY,3,0.02h,Stop Loss,$158.25,$3420.75,$445707.50,313,$3420.75
2025-03-18,19:12:00,19510.5,SELL,3,0.02h,Stop Loss,$-18.00,$3402.75,$445689.50,313,$3402.75
2025-03-18,19:21:00,19746.0,BUY,3,0.02h,Stop Loss,$-18.00,$3384.75,$445671.50,313,$3384.75
2025-03-18,19:22:00,19529.25,SELL,3,0.02h,Stop Loss,$135.75,$3520.50,$445807.25,313,$3520.50
2025-03-18,19:27:00,19704.25,BUY,3,0.02h,Stop Loss,$109.50,$3630.00,$445916.75,313,$3630.00
2025-03-18,19:30:00,19503.5,SELL,3,0.02h,Stop Loss,$12.00,$3642.00,$445928.75,313,$3642.00
2025-03-18,19:43:00,19702.75,BUY,3,0.02h,Stop Loss,$60.75,$3702.75,$445989.50,313,$3702.75
2025-03-18,19:52:00,19497.75,SELL,3,0.02h,Stop Loss,$72.00,$3774.75,$446061.50,313,$3774.75
2025-03-18,19:56:00,19694.0,BUY,3,0.02h,Stop Loss,$135.75,$3910.50,$446197.25,313,$3910.50
2025-03-18,20:07:00,19519.5,SELL,3,0.02h,Stop Loss,$27.00,$3937.50,$446224.25,313,$3937.50
2025-03-18,20:09:00,19727.25,BUY,3,0.02h,Break Even,$0.75,$3938.25,$446225.00,313,$3938.25
2025-03-18,20:14:00,19518.0,SELL,3,0.02h,Stop Loss,$-18.00,$3920.25,$446207.00,313,$3920.25
2025-03-18,20:27:00,19705.0,BUY,3,0.02h,Stop Loss,$-18.00,$3902.25,$446189.00,313,$3902.25
2025-03-18,20:28:00,19498.25,SELL,3,0.02h,Break Even,$0.75,$3903.00,$446189.75,313,$3903.00
2025-03-18,20:31:00,19710.75,BUY,3,0.02h,Stop Loss,$-18.00,$3885.00,$446171.75,313,$3885.00
2025-03-18,20:32:00,19509.5,SELL,3,0.02h,Break Even,$0.75,$3885.75,$446172.50,313,$3885.75
2025-03-18,20:35:00,19715.0,BUY,3,0.02h,Break Even,$0.75,$3886.50,$446173.25,313,$3886.50
2025-03-18,20:47:00,19507.0,SELL,3,0.02h,Stop Loss,$-18.00,$3868.50,$446155.25,313,$3868.50
2025-03-18,20:48:00,19714.5,BUY,3,0.02h,Stop Loss,$-18.00,$3850.50,$446137.25,313,$3850.50
2025-03-18,20:54:00,19502.5,SELL,3,0.02h,Stop Loss,$-18.00,$3832.50,$446119.25,313,$3832.50
2025-03-18,22:01:00,19698.5,BUY,3,0.02h,Stop Loss,$-18.00,$3814.50,$446101.25,313,$3814.50
2025-03-18,22:02:00,19493.0,SELL,3,0.02h,Stop Loss,$-18.00,$3796.50,$446083.25,313,$3796.50
2025-03-18,22:03:00,19698.0,BUY,3,0.02h,Stop Loss,$-18.00,$3778.50,$446065.25,313,$3778.50
2025-03-18,22:04:00,19499.25,SELL,3,0.02h,Stop Loss,$-18.00,$3760.50,$446047.25,313,$3760.50
2025-03-18,22:05:00,19705.25,BUY,3,0.02h,Stop Loss,$-18.00,$3742.50,$446029.25,313,$3742.50
2025-03-18,22:13:00,19487.75,SELL,3,0.02h,Stop Loss,$109.50,$3852.00,$446138.75,313,$3852.00
2025-03-18,22:16:00,19683.75,BUY,3,0.02h,Stop Loss,$-18.00,$3834.00,$446120.75,313,$3834.00
2025-03-18,22:19:00,19484.75,SELL,3,0.02h,Stop Loss,$98.25,$3932.25,$446219.00,313,$3932.25
2025-03-18,22:26:00,19690.0,BUY,3,0.02h,Stop Loss,$-18.00,$3914.25,$446201.00,313,$3914.25
2025-03-18,22:27:00,19485.5,SELL,3,0.02h,Stop Loss,$-18.00,$3896.25,$446183.00,313,$3896.25
2025-03-18,22:28:00,19679.75,BUY,3,0.02h,Break Even,$0.75,$3897.00,$446183.75,313,$3897.00
2025-03-18,22:31:00,19469.5,SELL,3,0.02h,Stop Loss,$-18.00,$3879.00,$446165.75,313,$3879.00
2025-03-18,22:32:00,19671.25,BUY,3,0.02h,Stop Loss,$27.00,$3906.00,$446192.75,313,$3906.00
2025-03-18,22:41:00,19482.5,SELL,3,0.02h,Stop Loss,$-18.00,$3888.00,$446174.75,313,$3888.00
2025-03-18,22:45:00,19699.5,BUY,3,0.02h,Stop Loss,$49.50,$3937.50,$446224.25,313,$3937.50
2025-03-18,22:52:00,19505.75,SELL,3,0.02h,Stop Loss,$-18.00,$3919.50,$446206.25,313,$3919.50
2025-03-18,22:53:00,19711.25,BUY,3,0.02h,Stop Loss,$79.50,$3999.00,$446285.75,313,$3999.00
2025-03-18,22:55:00,19513.0,SELL,3,0.02h,Stop Loss,$-18.00,$3981.00,$446267.75,313,$3981.00
,,,,,,,,,,,
2025-03-19,12:04:00,19765.25,BUY,3,0.02h,Break Even,$0.75,$0.75,$446268.50,314,$0.75
2025-03-19,12:20:00,19559.75,SELL,3,0.02h,Stop Loss,$45.75,$46.50,$446314.25,314,$46.50
2025-03-19,12:24:00,19758.25,BUY,3,0.02h,Stop Loss,$-18.00,$28.50,$446296.25,314,$28.50
2025-03-19,12:26:00,19550.75,SELL,3,0.02h,Break Even,$0.75,$29.25,$446297.00,314,$29.25
2025-03-19,12:29:00,19752.5,BUY,3,0.02h,Break Even,$0.75,$30.00,$446297.75,314,$30.00
2025-03-19,12:34:00,19552.75,SELL,3,0.02h,Stop Loss,$-18.00,$12.00,$446279.75,314,$12.00
2025-03-19,12:37:00,19758.0,BUY,3,0.02h,Stop Loss,$-18.00,$-6.00,$446261.75,314,$-6.00
2025-03-19,12:38:00,19551.5,SELL,3,0.02h,Stop Loss,$-18.00,$-24.00,$446243.75,314,$-24.00
2025-03-19,12:39:00,19750.0,BUY,3,0.02h,Stop Loss,$12.00,$-12.00,$446255.75,314,$-12.00
2025-03-19,12:42:00,19541.0,SELL,3,0.02h,Stop Loss,$-18.00,$-30.00,$446237.75,314,$-30.00
2025-03-19,12:43:00,19754.25,BUY,3,0.02h,Break Even,$0.75,$-29.25,$446238.50,314,$-29.25
2025-03-19,12:45:00,19557.5,SELL,3,0.02h,Break Even,$0.75,$-28.50,$446239.25,314,$-28.50
2025-03-19,12:48:00,19768.25,BUY,3,0.02h,Stop Loss,$27.00,$-1.50,$446266.25,314,$-1.50
2025-03-19,12:53:00,19562.75,SELL,3,0.02h,Break Even,$0.75,$-0.75,$446267.00,314,$-0.75
2025-03-19,13:01:00,19763.5,BUY,3,0.02h,Stop Loss,$-18.00,$-18.75,$446249.00,314,$-18.75
2025-03-19,13:02:00,19560.75,SELL,3,0.02h,Stop Loss,$-18.00,$-36.75,$446231.00,314,$-36.75
2025-03-19,13:03:00,19763.5,BUY,3,0.02h,Stop Loss,$-18.00,$-54.75,$446213.00,314,$-54.75
2025-03-19,13:09:00,19561.5,SELL,3,0.02h,Break Even,$0.75,$-54.00,$446213.75,314,$-54.00
2025-03-19,13:23:00,19758.0,BUY,3,0.02h,Stop Loss,$-18.00,$-72.00,$446195.75,314,$-72.00
2025-03-19,13:24:00,19556.25,SELL,3,0.02h,Break Even,$0.75,$-71.25,$446196.50,314,$-71.25
2025-03-19,13:29:00,19785.5,BUY,3,0.02h,Stop Loss,$45.75,$-25.50,$446242.25,314,$-25.50
2025-03-19,13:38:00,19554.5,SELL,3,0.02h,Stop Loss,$23.25,$-2.25,$446265.50,314,$-2.25
2025-03-19,13:49:00,19777.75,BUY,3,0.02h,Stop Loss,$72.00,$69.75,$446337.50,314,$69.75
2025-03-19,14:10:00,19689.5,SELL,3,0.02h,Stop Loss,$-18.00,$51.75,$446319.50,314,$51.75
2025-03-19,14:11:00,19892.25,BUY,3,0.02h,Break Even,$0.75,$52.50,$446320.25,314,$52.50
2025-03-19,14:14:00,19666.75,SELL,3,0.02h,Stop Loss,$75.75,$128.25,$446396.00,314,$128.25
2025-03-19,14:16:00,19883.75,BUY,3,0.02h,Stop Loss,$-18.00,$110.25,$446378.00,314,$110.25
2025-03-19,14:17:00,19673.0,SELL,3,0.02h,Stop Loss,$128.25,$238.50,$446506.25,314,$238.50
2025-03-19,14:24:00,19872.25,BUY,3,0.02h,Break Even,$0.75,$239.25,$446507.00,314,$239.25
2025-03-19,14:28:00,19653.0,SELL,3,0.02h,Stop Loss,$34.50,$273.75,$446541.50,314,$273.75
2025-03-19,14:32:00,19847.5,BUY,3,0.02h,Stop Loss,$-18.00,$255.75,$446523.50,314,$255.75
2025-03-19,14:33:00,19651.5,SELL,3,0.02h,Stop Loss,$83.25,$339.00,$446606.75,314,$339.00
2025-03-19,14:35:00,19852.25,BUY,3,0.02h,Stop Loss,$94.50,$433.50,$446701.25,314,$433.50
2025-03-19,14:37:00,19650.0,SELL,3,0.02h,Stop Loss,$-18.00,$415.50,$446683.25,314,$415.50
2025-03-19,14:38:00,19860.0,BUY,3,0.02h,Stop Loss,$42.00,$457.50,$446725.25,314,$457.50
2025-03-19,14:56:00,19595.25,SELL,3,0.02h,Stop Loss,$72.00,$529.50,$446797.25,314,$529.50
2025-03-19,15:04:00,19815.0,BUY,3,0.02h,Stop Loss,$45.75,$575.25,$446843.00,314,$575.25
2025-03-19,15:06:00,19619.75,SELL,3,0.02h,Break Even,$0.75,$576.00,$446843.75,314,$576.00
2025-03-19,15:16:00,19860.5,BUY,3,0.02h,Stop Loss,$-18.00,$558.00,$446825.75,314,$558.00
2025-03-19,15:17:00,19646.75,SELL,3,0.02h,Stop Loss,$-18.00,$540.00,$446807.75,314,$540.00
2025-03-19,15:18:00,19836.0,BUY,3,0.02h,Stop Loss,$-18.00,$522.00,$446789.75,314,$522.00
2025-03-19,15:34:00,19680.75,SELL,3,0.02h,Stop Loss,$-18.00,$504.00,$446771.75,314,$504.00
2025-03-19,15:35:00,19883.0,BUY,3,0.02h,Stop Loss,$-18.00,$486.00,$446753.75,314,$486.00
2025-03-19,15:36:00,19671.0,SELL,3,0.02h,Stop Loss,$-18.00,$468.00,$446735.75,314,$468.00
2025-03-19,15:37:00,19877.0,BUY,3,0.02h,Stop Loss,$12.00,$480.00,$446747.75,314,$480.00
2025-03-19,15:41:00,19685.25,SELL,3,0.02h,Stop Loss,$-18.00,$462.00,$446729.75,314,$462.00
2025-03-19,15:42:00,19891.0,BUY,3,0.02h,Stop Loss,$-18.00,$444.00,$446711.75,314,$444.00
2025-03-19,15:43:00,19690.0,SELL,3,0.02h,Stop Loss,$-18.00,$426.00,$446693.75,314,$426.00
2025-03-19,15:45:00,19900.0,BUY,3,0.02h,Stop Loss,$-18.00,$408.00,$446675.75,314,$408.00
2025-03-19,15:46:00,19696.0,SELL,3,0.02h,Stop Loss,$-18.00,$390.00,$446657.75,314,$390.00
2025-03-19,15:47:00,19894.75,BUY,3,0.02h,Stop Loss,$-18.00,$372.00,$446639.75,314,$372.00
2025-03-19,15:48:00,19686.25,SELL,3,0.02h,Break Even,$0.75,$372.75,$446640.50,314,$372.75
2025-03-19,15:50:00,19903.25,BUY,3,0.02h,Stop Loss,$-18.00,$354.75,$446622.50,314,$354.75
2025-03-19,15:51:00,19710.75,SELL,3,0.02h,Break Even,$0.75,$355.50,$446623.25,314,$355.50
2025-03-19,15:54:00,19929.25,BUY,3,0.02h,Stop Loss,$-18.00,$337.50,$446605.25,314,$337.50
2025-03-19,15:55:00,19720.0,SELL,3,0.02h,Break Even,$0.75,$338.25,$446606.00,314,$338.25
2025-03-19,16:00:00,19920.25,BUY,3,0.02h,Stop Loss,$53.25,$391.50,$446659.25,314,$391.50
2025-03-19,16:03:00,19709.75,SELL,3,0.02h,Stop Loss,$-18.00,$373.50,$446641.25,314,$373.50
2025-03-19,16:04:00,19913.25,BUY,3,0.02h,Stop Loss,$15.75,$389.25,$446657.00,314,$389.25
2025-03-19,16:11:00,19698.25,SELL,3,0.02h,Stop Loss,$-18.00,$371.25,$446639.00,314,$371.25
2025-03-19,16:12:00,19907.5,BUY,3,0.02h,Stop Loss,$-18.00,$353.25,$446621.00,314,$353.25
2025-03-19,16:19:00,19688.25,SELL,3,0.02h,Stop Loss,$-18.00,$335.25,$446603.00,314,$335.25
2025-03-19,16:20:00,19892.75,BUY,3,0.02h,Stop Loss,$-18.00,$317.25,$446585.00,314,$317.25
2025-03-19,16:22:00,19684.5,SELL,3,0.02h,Stop Loss,$-18.00,$299.25,$446567.00,314,$299.25
2025-03-19,16:27:00,19894.25,BUY,3,0.02h,Stop Loss,$-18.00,$281.25,$446549.00,314,$281.25
2025-03-19,16:28:00,19696.75,SELL,3,0.02h,Break Even,$0.75,$282.00,$446549.75,314,$282.00
2025-03-19,16:32:00,19890.5,BUY,3,0.02h,Stop Loss,$-18.00,$264.00,$446531.75,314,$264.00
2025-03-19,16:39:00,19680.25,SELL,3,0.02h,Stop Loss,$53.25,$317.25,$446585.00,314,$317.25
2025-03-19,16:42:00,19874.5,BUY,3,0.02h,Stop Loss,$12.00,$329.25,$446597.00,314,$329.25
2025-03-19,16:44:00,19664.5,SELL,3,0.02h,Stop Loss,$-18.00,$311.25,$446579.00,314,$311.25
2025-03-19,16:45:00,19875.25,BUY,3,0.02h,Stop Loss,$-18.00,$293.25,$446561.00,314,$293.25
2025-03-19,16:46:00,19666.75,SELL,3,0.02h,Stop Loss,$27.00,$320.25,$446588.00,314,$320.25
2025-03-19,16:51:00,19866.75,BUY,3,0.02h,Stop Loss,$-18.00,$302.25,$446570.00,314,$302.25
2025-03-19,16:58:00,19662.0,SELL,3,0.02h,Stop Loss,$79.50,$381.75,$446649.50,314,$381.75
2025-03-19,17:01:00,19881.5,BUY,3,0.02h,Stop Loss,$12.00,$393.75,$446661.50,314,$393.75
2025-03-19,17:03:00,19660.5,SELL,3,0.02h,Stop Loss,$-18.00,$375.75,$446643.50,314,$375.75
2025-03-19,17:04:00,19863.0,BUY,3,0.02h,Stop Loss,$60.75,$436.50,$446704.25,314,$436.50
2025-03-19,17:08:00,19647.25,SELL,3,0.02h,Stop Loss,$-18.00,$418.50,$446686.25,314,$418.50
2025-03-19,17:10:00,19839.5,BUY,3,0.02h,Stop Loss,$-18.00,$400.50,$446668.25,314,$400.50
2025-03-19,17:11:00,19640.5,SELL,3,0.02h,Stop Loss,$12.00,$412.50,$446680.25,314,$412.50
2025-03-19,17:29:00,19816.5,BUY,3,0.02h,Break Even,$0.75,$413.25,$446681.00,314,$413.25
2025-03-19,17:32:00,19594.5,SELL,3,0.02h,Stop Loss,$90.75,$504.00,$446771.75,314,$504.00
2025-03-19,17:42:00,19843.25,BUY,3,0.02h,Stop Loss,$57.00,$561.00,$446828.75,314,$561.00
2025-03-19,17:50:00,19596.0,SELL,3,0.02h,Stop Loss,$-18.00,$543.00,$446810.75,314,$543.00
2025-03-19,17:51:00,19811.25,BUY,3,0.02h,Stop Loss,$-18.00,$525.00,$446792.75,314,$525.00
2025-03-19,17:52:00,19620.75,SELL,3,0.02h,Stop Loss,$-18.00,$507.00,$446774.75,314,$507.00
2025-03-19,17:53:00,19812.75,BUY,3,0.02h,Stop Loss,$-18.00,$489.00,$446756.75,314,$489.00
2025-03-19,17:58:00,19613.0,SELL,3,0.02h,Stop Loss,$-18.00,$471.00,$446738.75,314,$471.00
2025-03-19,18:00:00,19806.0,BUY,3,0.02h,Stop Loss,$1298.25,$1769.25,$448037.00,314,$1769.25
2025-03-19,18:05:00,19656.5,SELL,3,0.02h,Stop Loss,$574.50,$2343.75,$448611.50,314,$2343.75
2025-03-19,18:09:00,19850.0,BUY,3,0.02h,Stop Loss,$225.75,$2569.50,$448837.25,314,$2569.50
2025-03-19,18:12:00,19681.5,SELL,3,0.02h,Stop Loss,$-18.00,$2551.50,$448819.25,314,$2551.50
2025-03-19,18:13:00,19899.5,BUY,3,0.02h,Stop Loss,$113.25,$2664.75,$448932.50,314,$2664.75
2025-03-19,18:19:00,19700.75,SELL,3,0.02h,Stop Loss,$34.50,$2699.25,$448967.00,314,$2699.25
2025-03-19,18:22:00,19884.5,BUY,3,0.02h,Stop Loss,$-18.00,$2681.25,$448949.00,314,$2681.25
2025-03-19,18:23:00,19700.5,SELL,3,0.02h,Stop Loss,$-18.00,$2663.25,$448931.00,314,$2663.25
2025-03-19,18:24:00,19904.25,BUY,3,0.02h,Stop Loss,$19.50,$2682.75,$448950.50,314,$2682.75
2025-03-19,18:41:00,19695.0,SELL,3,0.02h,Stop Loss,$-18.00,$2664.75,$448932.50,314,$2664.75
2025-03-19,18:42:00,19929.0,BUY,3,0.02h,Stop Loss,$334.50,$2999.25,$449267.00,314,$2999.25
2025-03-19,18:48:00,19755.0,SELL,3,0.02h,Stop Loss,$-18.00,$2981.25,$449249.00,314,$2981.25
2025-03-19,18:51:00,19959.25,BUY,3,0.02h,Stop Loss,$45.75,$3027.00,$449294.75,314,$3027.00
2025-03-19,19:20:00,19859.5,SELL,3,0.02h,Stop Loss,$398.25,$3425.25,$449693.00,314,$3425.25
2025-03-19,19:23:00,20023.0,BUY,3,0.02h,Stop Loss,$15.75,$3441.00,$449708.75,314,$3441.00
2025-03-19,19:25:00,19818.5,SELL,3,0.02h,Stop Loss,$259.50,$3700.50,$449968.25,314,$3700.50
2025-03-19,19:47:00,20026.25,BUY,3,0.02h,Break Even,$0.75,$3701.25,$449969.00,314,$3701.25
2025-03-19,19:51:00,19766.5,SELL,3,0.02h,Stop Loss,$158.25,$3859.50,$450127.25,314,$3859.50
2025-03-19,19:57:00,19948.75,BUY,3,0.02h,Stop Loss,$-18.00,$3841.50,$450109.25,314,$3841.50
2025-03-19,19:58:00,19741.25,SELL,3,0.02h,Stop Loss,$98.25,$3939.75,$450207.50,314,$3939.75
2025-03-19,20:08:00,19976.75,BUY,3,0.02h,Stop Loss,$23.25,$3963.00,$450230.75,314,$3963.00
2025-03-19,20:14:00,19760.75,SELL,3,0.02h,Stop Loss,$-18.00,$3945.00,$450212.75,314,$3945.00
2025-03-19,20:16:00,19970.25,BUY,3,0.02h,Break Even,$0.75,$3945.75,$450213.50,314,$3945.75
2025-03-19,20:18:00,19758.25,SELL,3,0.02h,Stop Loss,$-18.00,$3927.75,$450195.50,314,$3927.75
2025-03-19,20:19:00,19965.75,BUY,3,0.02h,Stop Loss,$-18.00,$3909.75,$450177.50,314,$3909.75
2025-03-19,20:23:00,19752.5,SELL,3,0.02h,Break Even,$0.75,$3910.50,$450178.25,314,$3910.50
2025-03-19,20:31:00,19946.25,BUY,3,0.02h,Stop Loss,$-18.00,$3892.50,$450160.25,314,$3892.50
2025-03-19,20:32:00,19744.75,SELL,3,0.02h,Stop Loss,$-18.00,$3874.50,$450142.25,314,$3874.50
2025-03-19,20:33:00,19949.75,BUY,3,0.02h,Stop Loss,$-18.00,$3856.50,$450124.25,314,$3856.50
2025-03-19,20:34:00,19742.0,SELL,3,0.02h,Stop Loss,$-18.00,$3838.50,$450106.25,314,$3838.50
2025-03-19,20:35:00,19951.0,BUY,3,0.02h,Stop Loss,$-18.00,$3820.50,$450088.25,314,$3820.50
2025-03-19,20:50:00,19744.0,SELL,3,0.02h,Stop Loss,$-18.00,$3802.50,$450070.25,314,$3802.50
2025-03-19,20:51:00,19947.0,BUY,3,0.02h,Stop Loss,$-18.00,$3784.50,$450052.25,314,$3784.50
2025-03-19,20:53:00,19737.0,SELL,3,0.02h,Break Even,$0.75,$3785.25,$450053.00,314,$3785.25
2025-03-19,22:08:00,19968.0,BUY,3,0.02h,Stop Loss,$30.75,$3816.00,$450083.75,314,$3816.00
2025-03-19,22:17:00,19778.75,SELL,3,0.02h,Stop Loss,$-18.00,$3798.00,$450065.75,314,$3798.00
2025-03-19,22:18:00,19982.75,BUY,3,0.02h,Stop Loss,$49.50,$3847.50,$450115.25,314,$3847.50
2025-03-19,22:29:00,19790.75,SELL,3,0.02h,Break Even,$0.75,$3848.25,$450116.00,314,$3848.25
2025-03-19,22:31:00,19989.25,BUY,3,0.02h,Stop Loss,$-18.00,$3830.25,$450098.00,314,$3830.25
2025-03-19,22:32:00,19787.75,SELL,3,0.02h,Stop Loss,$-18.00,$3812.25,$450080.00,314,$3812.25
2025-03-19,22:33:00,19997.5,BUY,3,0.02h,Stop Loss,$-18.00,$3794.25,$450062.00,314,$3794.25
2025-03-19,22:34:00,19793.0,SELL,3,0.02h,Stop Loss,$23.25,$3817.50,$450085.25,314,$3817.50
2025-03-19,22:42:00,20007.75,BUY,3,0.02h,Stop Loss,$-18.00,$3799.50,$450067.25,314,$3799.50
2025-03-19,22:43:00,19802.5,SELL,3,0.02h,Break Even,$0.75,$3800.25,$450068.00,314,$3800.25
2025-03-19,22:47:00,20013.25,BUY,3,0.02h,Stop Loss,$68.25,$3868.50,$450136.25,314,$3868.50
2025-03-19,22:51:00,19817.5,SELL,3,0.02h,Break Even,$0.75,$3869.25,$450137.00,314,$3869.25
2025-03-19,22:54:00,20022.75,BUY,3,0.02h,Stop Loss,$-18.00,$3851.25,$450119.00,314,$3851.25
,,,,,,,,,,,
2025-03-20,12:02:00,19644.5,SELL,3,0.02h,Stop Loss,$-18.00,$-18.00,$450101.00,315,$-18.00
2025-03-20,12:30:00,19836.75,BUY,3,0.02h,Stop Loss,$45.75,$27.75,$450146.75,315,$27.75
2025-03-20,12:35:00,19644.75,SELL,3,0.02h,Stop Loss,$-18.00,$9.75,$450128.75,315,$9.75
2025-03-20,12:36:00,19854.75,BUY,3,0.02h,Stop Loss,$-18.00,$-8.25,$450110.75,315,$-8.25
2025-03-20,12:37:00,19651.25,SELL,3,0.02h,Stop Loss,$-18.00,$-26.25,$450092.75,315,$-26.25
2025-03-20,12:38:00,19848.75,BUY,3,0.02h,Stop Loss,$-18.00,$-44.25,$450074.75,315,$-44.25
2025-03-20,12:53:00,19630.75,SELL,3,0.02h,Stop Loss,$-18.00,$-62.25,$450056.75,315,$-62.25
2025-03-20,13:03:00,19809.5,BUY,3,0.02h,Stop Loss,$-18.00,$-80.25,$450038.75,315,$-80.25
2025-03-20,13:04:00,19595.5,SELL,3,0.02h,Break Even,$0.75,$-79.50,$450039.50,315,$-79.50
2025-03-20,13:14:00,19819.75,BUY,3,0.02h,Break Even,$0.75,$-78.75,$450040.25,315,$-78.75
2025-03-20,13:17:00,19609.5,SELL,3,0.02h,Break Even,$0.75,$-78.00,$450041.00,315,$-78.00
2025-03-20,13:22:00,19805.0,BUY,3,0.02h,Break Even,$0.75,$-77.25,$450041.75,315,$-77.25
2025-03-20,13:38:00,19654.5,SELL,3,0.02h,Break Even,$0.75,$-76.50,$450042.50,315,$-76.50
2025-03-20,13:40:00,19894.0,BUY,3,0.02h,Stop Loss,$27.00,$-49.50,$450069.50,315,$-49.50
2025-03-20,13:48:00,19701.5,SELL,3,0.02h,Stop Loss,$90.75,$41.25,$450160.25,315,$41.25
2025-03-20,13:50:00,19908.5,BUY,3,0.02h,Stop Loss,$-18.00,$23.25,$450142.25,315,$23.25
2025-03-20,13:51:00,19712.25,SELL,3,0.02h,Stop Loss,$64.50,$87.75,$450206.75,315,$87.75
2025-03-20,13:54:00,19927.0,BUY,3,0.02h,Break Even,$0.75,$88.50,$450207.50,315,$88.50
2025-03-20,14:22:00,19819.75,SELL,3,0.02h,Stop Loss,$-18.00,$70.50,$450189.50,315,$70.50
2025-03-20,14:23:00,20032.0,BUY,3,0.02h,Stop Loss,$-18.00,$52.50,$450171.50,315,$52.50
2025-03-20,14:45:00,19884.5,SELL,3,0.02h,Stop Loss,$-18.00,$34.50,$450153.50,315,$34.50
2025-03-20,14:46:00,20090.0,BUY,3,0.02h,Stop Loss,$150.75,$185.25,$450304.25,315,$185.25
2025-03-20,14:52:00,19865.75,SELL,3,0.02h,Stop Loss,$263.25,$448.50,$450567.50,315,$448.50
2025-03-20,15:01:00,20025.25,BUY,3,0.02h,Stop Loss,$83.25,$531.75,$450650.75,315,$531.75
2025-03-20,15:05:00,19820.0,SELL,3,0.02h,Stop Loss,$-18.00,$513.75,$450632.75,315,$513.75
2025-03-20,15:07:00,20040.25,BUY,3,0.02h,Stop Loss,$-18.00,$495.75,$450614.75,315,$495.75
2025-03-20,15:08:00,19836.0,SELL,3,0.02h,Stop Loss,$-18.00,$477.75,$450596.75,315,$477.75
2025-03-20,15:12:00,20045.75,BUY,3,0.02h,Stop Loss,$-18.00,$459.75,$450578.75,315,$459.75
2025-03-20,15:13:00,19845.25,SELL,3,0.02h,Stop Loss,$-18.00,$441.75,$450560.75,315,$441.75
2025-03-20,15:18:00,20031.0,BUY,3,0.02h,Stop Loss,$-18.00,$423.75,$450542.75,315,$423.75
2025-03-20,15:19:00,19834.25,SELL,3,0.02h,Stop Loss,$-18.00,$405.75,$450524.75,315,$405.75
2025-03-20,15:20:00,20026.5,BUY,3,0.02h,Stop Loss,$87.00,$492.75,$450611.75,315,$492.75
2025-03-20,15:26:00,19826.75,SELL,3,0.02h,Stop Loss,$72.00,$564.75,$450683.75,315,$564.75
2025-03-20,15:29:00,20027.0,BUY,3,0.02h,Stop Loss,$-18.00,$546.75,$450665.75,315,$546.75
2025-03-20,15:30:00,19828.0,SELL,3,0.02h,Stop Loss,$-18.00,$528.75,$450647.75,315,$528.75
2025-03-20,15:41:00,20018.5,BUY,3,0.02h,Break Even,$0.75,$529.50,$450648.50,315,$529.50
2025-03-20,15:44:00,19821.0,SELL,3,0.02h,Stop Loss,$27.00,$556.50,$450675.50,315,$556.50
2025-03-20,15:48:00,20046.5,BUY,3,0.02h,Stop Loss,$90.75,$647.25,$450766.25,315,$647.25
2025-03-20,15:50:00,19841.75,SELL,3,0.02h,Stop Loss,$-18.00,$629.25,$450748.25,315,$629.25
2025-03-20,15:51:00,20033.5,BUY,3,0.02h,Stop Loss,$210.75,$840.00,$450959.00,315,$840.00
2025-03-20,15:57:00,19810.5,SELL,3,0.02h,Stop Loss,$-18.00,$822.00,$450941.00,315,$822.00
2025-03-20,16:12:00,19955.25,BUY,3,0.02h,Break Even,$0.75,$822.75,$450941.75,315,$822.75
2025-03-20,16:15:00,19771.0,SELL,3,0.02h,Stop Loss,$-18.00,$804.75,$450923.75,315,$804.75
2025-03-20,16:16:00,19964.25,BUY,3,0.02h,Stop Loss,$94.50,$899.25,$451018.25,315,$899.25
2025-03-20,16:19:00,19765.5,SELL,3,0.02h,Stop Loss,$-18.00,$881.25,$451000.25,315,$881.25
2025-03-20,16:20:00,19964.0,BUY,3,0.02h,Stop Loss,$-18.00,$863.25,$450982.25,315,$863.25
2025-03-20,16:29:00,19682.0,SELL,3,0.02h,Stop Loss,$169.50,$1032.75,$451151.75,315,$1032.75
2025-03-20,16:40:00,19915.25,BUY,3,0.02h,Stop Loss,$-18.00,$1014.75,$451133.75,315,$1014.75
2025-03-20,16:46:00,19676.5,SELL,3,0.02h,Stop Loss,$-18.00,$996.75,$451115.75,315,$996.75
2025-03-20,17:12:00,19917.25,BUY,3,0.02h,Stop Loss,$165.75,$1162.50,$451281.50,315,$1162.50
2025-03-20,17:29:00,19637.75,SELL,3,0.02h,Stop Loss,$45.75,$1208.25,$451327.25,315,$1208.25
2025-03-20,17:35:00,19857.75,BUY,3,0.02h,Stop Loss,$102.00,$1310.25,$451429.25,315,$1310.25
2025-03-20,17:40:00,19679.5,SELL,3,0.02h,Stop Loss,$-18.00,$1292.25,$451411.25,315,$1292.25
2025-03-20,17:41:00,19870.75,BUY,3,0.02h,Stop Loss,$-18.00,$1274.25,$451393.25,315,$1274.25
2025-03-20,17:42:00,19671.25,SELL,3,0.02h,Stop Loss,$165.75,$1440.00,$451559.00,315,$1440.00
2025-03-20,17:49:00,19876.0,BUY,3,0.02h,Stop Loss,$-18.00,$1422.00,$451541.00,315,$1422.00
2025-03-20,17:50:00,19676.0,SELL,3,0.02h,Stop Loss,$90.75,$1512.75,$451631.75,315,$1512.75
2025-03-20,18:00:00,19848.25,BUY,3,0.02h,Stop Loss,$177.00,$1689.75,$451808.75,315,$1689.75
2025-03-20,18:12:00,19690.5,SELL,3,0.02h,Break Even,$0.75,$1690.50,$451809.50,315,$1690.50
2025-03-20,18:30:00,19807.75,BUY,3,0.02h,Stop Loss,$12.00,$1702.50,$451821.50,315,$1702.50
2025-03-20,18:38:00,19636.75,SELL,3,0.02h,Stop Loss,$72.00,$1774.50,$451893.50,315,$1774.50
2025-03-20,18:40:00,19835.0,BUY,3,0.02h,Stop Loss,$-18.00,$1756.50,$451875.50,315,$1756.50
2025-03-20,18:41:00,19632.25,SELL,3,0.02h,Stop Loss,$147.00,$1903.50,$452022.50,315,$1903.50
2025-03-20,18:50:00,19842.0,BUY,3,0.02h,Stop Loss,$-18.00,$1885.50,$452004.50,315,$1885.50
2025-03-20,19:04:00,19648.75,SELL,3,0.02h,Stop Loss,$-18.00,$1867.50,$451986.50,315,$1867.50
2025-03-20,19:05:00,19848.75,BUY,3,0.02h,Stop Loss,$192.00,$2059.50,$452178.50,315,$2059.50
2025-03-20,19:12:00,19660.5,SELL,3,0.02h,Stop Loss,$-18.00,$2041.50,$452160.50,315,$2041.50
2025-03-20,19:13:00,19863.0,BUY,3,0.02h,Stop Loss,$-18.00,$2023.50,$452142.50,315,$2023.50
2025-03-20,19:14:00,19656.25,SELL,3,0.02h,Stop Loss,$15.75,$2039.25,$452158.25,315,$2039.25
2025-03-20,19:23:00,19889.75,BUY,3,0.02h,Stop Loss,$83.25,$2122.50,$452241.50,315,$2122.50
2025-03-20,19:51:00,19690.0,SELL,3,0.02h,Stop Loss,$-18.00,$2104.50,$452223.50,315,$2104.50
2025-03-20,19:56:00,19903.0,BUY,3,0.02h,Break Even,$0.75,$2105.25,$452224.25,315,$2105.25
2025-03-20,19:58:00,19696.0,SELL,3,0.02h,Stop Loss,$-18.00,$2087.25,$452206.25,315,$2087.25
2025-03-20,19:59:00,19886.75,BUY,3,0.02h,Stop Loss,$19.50,$2106.75,$452225.75,315,$2106.75
2025-03-20,20:02:00,19703.0,SELL,3,0.02h,Stop Loss,$53.25,$2160.00,$452279.00,315,$2160.00
2025-03-20,20:06:00,19905.75,BUY,3,0.02h,Break Even,$0.75,$2160.75,$452279.75,315,$2160.75
2025-03-20,20:14:00,19706.75,SELL,3,0.02h,Stop Loss,$-18.00,$2142.75,$452261.75,315,$2142.75
2025-03-20,20:15:00,19905.25,BUY,3,0.02h,Break Even,$0.75,$2143.50,$452262.50,315,$2143.50
2025-03-20,20:18:00,19708.0,SELL,3,0.02h,Stop Loss,$-18.00,$2125.50,$452244.50,315,$2125.50
2025-03-20,20:32:00,19903.5,BUY,3,0.02h,Stop Loss,$-18.00,$2107.50,$452226.50,315,$2107.50
2025-03-20,20:41:00,19692.25,SELL,3,0.02h,Stop Loss,$-18.00,$2089.50,$452208.50,315,$2089.50
2025-03-20,20:45:00,19896.25,BUY,3,0.02h,Stop Loss,$-18.00,$2071.50,$452190.50,315,$2071.50
2025-03-20,20:46:00,19695.25,SELL,3,0.02h,Stop Loss,$-18.00,$2053.50,$452172.50,315,$2053.50
2025-03-20,20:47:00,19896.25,BUY,3,0.02h,Break Even,$0.75,$2054.25,$452173.25,315,$2054.25
2025-03-20,20:53:00,19700.0,SELL,3,0.02h,Stop Loss,$-18.00,$2036.25,$452155.25,315,$2036.25
2025-03-20,20:54:00,19898.0,BUY,3,0.02h,Stop Loss,$-18.00,$2018.25,$452137.25,315,$2018.25
2025-03-20,20:55:00,19698.25,SELL,3,0.02h,Stop Loss,$-18.00,$2000.25,$452119.25,315,$2000.25
2025-03-20,20:56:00,19898.75,BUY,3,0.02h,Stop Loss,$-18.00,$1982.25,$452101.25,315,$1982.25
2025-03-20,20:57:00,19697.0,SELL,3,0.02h,Stop Loss,$-18.00,$1964.25,$452083.25,315,$1964.25
2025-03-20,20:58:00,19898.5,BUY,3,0.02h,Stop Loss,$-18.00,$1946.25,$452065.25,315,$1946.25
2025-03-20,20:59:00,19695.75,SELL,3,0.02h,Stop Loss,$-18.00,$1928.25,$452047.25,315,$1928.25
2025-03-20,21:00:00,19894.25,BUY,3,1.02h,Stop Loss,$-18.00,$1910.25,$452029.25,315,$1910.25
2025-03-20,22:01:00,19693.5,SELL,3,0.02h,Stop Loss,$-18.00,$1892.25,$452011.25,315,$1892.25
2025-03-20,22:02:00,19899.5,BUY,3,0.02h,Stop Loss,$-18.00,$1874.25,$451993.25,315,$1874.25
2025-03-20,22:03:00,19694.0,SELL,3,0.02h,Stop Loss,$-18.00,$1856.25,$451975.25,315,$1856.25
2025-03-20,22:09:00,19886.5,BUY,3,0.02h,Break Even,$0.75,$1857.00,$451976.00,315,$1857.00
2025-03-20,22:15:00,19681.0,SELL,3,0.02h,Stop Loss,$-18.00,$1839.00,$451958.00,315,$1839.00
2025-03-20,22:18:00,19899.0,BUY,3,0.02h,Stop Loss,$-18.00,$1821.00,$451940.00,315,$1821.00
2025-03-20,22:19:00,19699.25,SELL,3,0.02h,Stop Loss,$-18.00,$1803.00,$451922.00,315,$1803.00
2025-03-20,22:20:00,19902.25,BUY,3,0.02h,Stop Loss,$-18.00,$1785.00,$451904.00,315,$1785.00
2025-03-20,22:21:00,19694.75,SELL,3,0.02h,Stop Loss,$-18.00,$1767.00,$451886.00,315,$1767.00
2025-03-20,22:22:00,19891.5,BUY,3,0.02h,Break Even,$0.75,$1767.75,$451886.75,315,$1767.75
2025-03-20,22:27:00,19690.5,SELL,3,0.02h,Stop Loss,$-18.00,$1749.75,$451868.75,315,$1749.75
2025-03-20,22:31:00,19899.5,BUY,3,0.02h,Stop Loss,$-18.00,$1731.75,$451850.75,315,$1731.75
2025-03-20,22:32:00,19692.0,SELL,3,0.02h,Stop Loss,$-18.00,$1713.75,$451832.75,315,$1713.75
2025-03-20,22:37:00,19905.5,BUY,3,0.02h,Stop Loss,$-18.00,$1695.75,$451814.75,315,$1695.75
2025-03-20,22:54:00,19687.25,SELL,3,0.02h,Break Even,$0.75,$1696.50,$451815.50,315,$1696.50
2025-03-20,22:58:00,19886.25,BUY,3,0.02h,Stop Loss,$-18.00,$1678.50,$451797.50,315,$1678.50
2025-03-20,22:59:00,19685.25,SELL,3,0.02h,Break Even,$0.75,$1679.25,$451798.25,315,$1679.25
,,,,,,,,,,,
2025-03-21,12:14:00,19822.25,BUY,3,0.02h,Stop Loss,$68.25,$68.25,$451866.50,316,$68.25
2025-03-21,12:16:00,19614.5,SELL,3,0.02h,Stop Loss,$-18.00,$50.25,$451848.50,316,$50.25
2025-03-21,12:17:00,19807.5,BUY,3,0.02h,Stop Loss,$15.75,$66.00,$451864.25,316,$66.00
2025-03-21,12:21:00,19599.5,SELL,3,0.02h,Stop Loss,$-18.00,$48.00,$451846.25,316,$48.00
2025-03-21,12:22:00,19802.25,BUY,3,0.02h,Break Even,$0.75,$48.75,$451847.00,316,$48.75
2025-03-21,12:25:00,19601.5,SELL,3,0.02h,Stop Loss,$-18.00,$30.75,$451829.00,316,$30.75
2025-03-21,12:27:00,19793.0,BUY,3,0.02h,Stop Loss,$-18.00,$12.75,$451811.00,316,$12.75
2025-03-21,12:28:00,19596.25,SELL,3,0.02h,Stop Loss,$30.75,$43.50,$451841.75,316,$43.50
2025-03-21,12:35:00,19774.0,BUY,3,0.02h,Stop Loss,$57.00,$100.50,$451898.75,316,$100.50
2025-03-21,12:37:00,19560.5,SELL,3,0.02h,Stop Loss,$289.50,$390.00,$452188.25,316,$390.00
2025-03-21,12:49:00,19711.75,BUY,3,0.02h,Stop Loss,$-18.00,$372.00,$452170.25,316,$372.00
2025-03-21,12:50:00,19511.75,SELL,3,0.02h,Stop Loss,$53.25,$425.25,$452223.50,316,$425.25
2025-03-21,12:59:00,19683.75,BUY,3,0.02h,Break Even,$0.75,$426.00,$452224.25,316,$426.00
2025-03-21,13:02:00,19477.75,SELL,3,0.02h,Stop Loss,$199.50,$625.50,$452423.75,316,$625.50
2025-03-21,13:10:00,19661.25,BUY,3,0.02h,Stop Loss,$75.75,$701.25,$452499.50,316,$701.25
2025-03-21,13:12:00,19459.5,SELL,3,0.02h,Stop Loss,$49.50,$750.75,$452549.00,316,$750.75
2025-03-21,13:18:00,19669.5,BUY,3,0.02h,Stop Loss,$-18.00,$732.75,$452531.00,316,$732.75
2025-03-21,13:19:00,19469.5,SELL,3,0.02h,Break Even,$0.75,$733.50,$452531.75,316,$733.50
2025-03-21,13:24:00,19638.5,BUY,3,0.02h,Stop Loss,$-18.00,$715.50,$452513.75,316,$715.50
2025-03-21,13:26:00,19436.25,SELL,3,0.02h,Stop Loss,$68.25,$783.75,$452582.00,316,$783.75
2025-03-21,13:32:00,19654.75,BUY,3,0.02h,Stop Loss,$-18.00,$765.75,$452564.00,316,$765.75
2025-03-21,14:12:00,19669.25,SELL,3,0.02h,Stop Loss,$-18.00,$747.75,$452546.00,316,$747.75
2025-03-21,14:15:00,19717.25,BUY,3,0.02h,Stop Loss,$128.25,$876.00,$452674.25,316,$876.00
2025-03-21,14:41:00,19728.75,SELL,3,0.02h,Stop Loss,$248.25,$1124.25,$452922.50,316,$1124.25
2025-03-21,14:47:00,19741.0,BUY,3,0.02h,Stop Loss,$30.75,$1155.00,$452953.25,316,$1155.00
2025-03-21,14:54:00,19730.75,SELL,3,0.02h,Stop Loss,$60.75,$1215.75,$453014.00,316,$1215.75
2025-03-21,14:55:00,19741.25,BUY,3,0.02h,Stop Loss,$79.50,$1295.25,$453093.50,316,$1295.25
2025-03-21,15:16:00,19733.75,SELL,3,0.02h,Stop Loss,$30.75,$1326.00,$453124.25,316,$1326.00
2025-03-21,15:57:00,19736.0,BUY,3,0.02h,Break Even,$0.75,$1326.75,$453125.00,316,$1326.75
2025-03-21,16:03:00,19700.5,SELL,3,0.02h,Stop Loss,$-18.00,$1308.75,$453107.00,316,$1308.75
2025-03-21,16:05:00,19727.0,BUY,3,0.02h,Stop Loss,$79.50,$1388.25,$453186.50,316,$1388.25
2025-03-21,17:14:00,19851.75,SELL,3,0.02h,Stop Loss,$75.75,$1464.00,$453262.25,316,$1464.00
2025-03-21,17:40:00,19855.75,BUY,3,0.02h,Stop Loss,$27.00,$1491.00,$453289.25,316,$1491.00
2025-03-21,18:07:00,19849.75,SELL,3,0.02h,Stop Loss,$-18.00,$1473.00,$453271.25,316,$1473.00
2025-03-21,18:38:00,19871.5,BUY,3,0.02h,Break Even,$0.75,$1473.75,$453272.00,316,$1473.75
2025-03-21,18:52:00,19851.5,SELL,3,0.02h,Stop Loss,$27.00,$1500.75,$453299.00,316,$1500.75
2025-03-21,18:57:00,19868.25,BUY,3,0.02h,Stop Loss,$57.00,$1557.75,$453356.00,316,$1557.75
2025-03-21,19:01:00,19849.25,SELL,3,0.02h,Stop Loss,$135.75,$1693.50,$453491.75,316,$1693.50
2025-03-21,19:30:00,19840.75,BUY,3,0.02h,Stop Loss,$45.75,$1739.25,$453537.50,316,$1739.25
2025-03-21,20:52:00,19958.25,SELL,3,0.02h,Break Even,$0.75,$1740.00,$453538.25,316,$1740.00
2025-03-21,20:56:00,19966.0,BUY,3,0.02h,Stop Loss,$45.75,$1785.75,$453584.00,316,$1785.75
,,,,,,,,,,,
2025-03-24,13:23:00,20275.0,SELL,3,0.02h,Stop Loss,$98.25,$98.25,$453682.25,317,$98.25
2025-03-24,13:40:00,20282.25,BUY,3,0.02h,Stop Loss,$60.75,$159.00,$453743.00,317,$159.00
2025-03-24,13:45:00,20238.25,SELL,3,0.02h,Stop Loss,$-18.00,$141.00,$453725.00,317,$141.00
2025-03-24,13:46:00,20276.0,BUY,3,0.02h,Stop Loss,$282.00,$423.00,$454007.00,317,$423.00
2025-03-24,14:10:00,20281.5,SELL,3,0.02h,Stop Loss,$-18.00,$405.00,$453989.00,317,$405.00
2025-03-24,14:15:00,20319.0,BUY,3,0.02h,Stop Loss,$105.75,$510.75,$454094.75,317,$510.75
2025-03-24,14:41:00,20327.25,SELL,3,0.02h,Break Even,$0.75,$511.50,$454095.50,317,$511.50
2025-03-24,14:42:00,20331.25,BUY,3,0.02h,Stop Loss,$45.75,$557.25,$454141.25,317,$557.25
2025-03-24,15:28:00,20351.75,SELL,3,0.02h,Stop Loss,$60.75,$618.00,$454202.00,317,$618.00
2025-03-24,15:55:00,20351.75,BUY,3,0.02h,Stop Loss,$30.75,$648.75,$454232.75,317,$648.75
2025-03-24,16:27:00,20343.0,SELL,3,0.02h,Stop Loss,$98.25,$747.00,$454331.00,317,$747.00
2025-03-24,16:49:00,20355.75,BUY,3,0.02h,Stop Loss,$-18.00,$729.00,$454313.00,317,$729.00
2025-03-24,16:57:00,20339.5,SELL,3,0.02h,Stop Loss,$19.50,$748.50,$454332.50,317,$748.50
2025-03-24,17:30:00,20337.5,BUY,3,0.02h,Stop Loss,$34.50,$783.00,$454367.00,317,$783.00
2025-03-24,17:56:00,20332.5,SELL,3,0.02h,Stop Loss,$30.75,$813.75,$454397.75,317,$813.75
2025-03-24,18:23:00,20329.25,BUY,3,0.02h,Break Even,$0.75,$814.50,$454398.50,317,$814.50
2025-03-24,18:33:00,20320.75,SELL,3,0.02h,Break Even,$0.75,$815.25,$454399.25,317,$815.25
2025-03-24,18:40:00,20346.5,BUY,3,0.02h,Stop Loss,$109.50,$924.75,$454508.75,317,$924.75
2025-03-24,19:27:00,20369.75,SELL,3,0.02h,Break Even,$0.75,$925.50,$454509.50,317,$925.50
2025-03-24,19:47:00,20376.0,BUY,3,0.02h,Stop Loss,$154.50,$1080.00,$454664.00,317,$1080.00
2025-03-24,20:02:00,20368.75,SELL,3,0.02h,Stop Loss,$23.25,$1103.25,$454687.25,317,$1103.25
2025-03-24,20:18:00,20375.5,BUY,3,0.02h,Stop Loss,$-18.00,$1085.25,$454669.25,317,$1085.25
2025-03-24,20:28:00,20368.25,SELL,3,0.02h,Break Even,$0.75,$1086.00,$454670.00,317,$1086.00
2025-03-24,22:37:00,20352.75,BUY,3,0.02h,Stop Loss,$-18.00,$1068.00,$454652.00,317,$1068.00
2025-03-24,22:50:00,20347.0,SELL,3,0.02h,Break Even,$0.75,$1068.75,$454652.75,317,$1068.75
,,,,,,,,,,,
2025-03-25,12:00:00,20411.75,BUY,3,0.02h,Stop Loss,$64.50,$64.50,$454717.25,318,$64.50
2025-03-25,12:51:00,20421.75,SELL,3,0.02h,Stop Loss,$87.00,$151.50,$454804.25,318,$151.50
2025-03-25,13:09:00,20425.5,BUY,3,0.02h,Break Even,$0.75,$152.25,$454805.00,318,$152.25
2025-03-25,13:28:00,20421.75,SELL,3,0.02h,Stop Loss,$293.25,$445.50,$455098.25,318,$445.50
2025-03-25,13:57:00,20410.5,BUY,3,0.02h,Stop Loss,$53.25,$498.75,$455151.50,318,$498.75
2025-03-25,14:03:00,20379.75,SELL,3,0.02h,Stop Loss,$83.25,$582.00,$455234.75,318,$582.00
2025-03-25,14:08:00,20413.0,BUY,3,0.02h,Stop Loss,$57.00,$639.00,$455291.75,318,$639.00
2025-03-25,15:17:00,20472.75,SELL,3,0.02h,Break Even,$0.75,$639.75,$455292.50,318,$639.75
2025-03-25,15:26:00,20486.25,BUY,3,0.02h,Stop Loss,$-18.00,$621.75,$455274.50,318,$621.75
2025-03-25,15:31:00,20471.75,SELL,3,0.02h,Stop Loss,$42.00,$663.75,$455316.50,318,$663.75
2025-03-25,16:44:00,20438.25,BUY,3,0.02h,Stop Loss,$49.50,$713.25,$455366.00,318,$713.25
2025-03-25,17:18:00,20446.5,SELL,3,0.02h,Stop Loss,$49.50,$762.75,$455415.50,318,$762.75
2025-03-25,18:11:00,20434.25,BUY,3,0.02h,Break Even,$0.75,$763.50,$455416.25,318,$763.50
2025-03-25,18:32:00,20428.5,SELL,3,0.02h,Stop Loss,$15.75,$779.25,$455432.00,318,$779.25
2025-03-25,18:59:00,20431.5,BUY,3,0.02h,Stop Loss,$-18.00,$761.25,$455414.00,318,$761.25
2025-03-25,19:17:00,20429.5,SELL,3,0.02h,Stop Loss,$-18.00,$743.25,$455396.00,318,$743.25
2025-03-25,19:20:00,20441.5,BUY,3,0.02h,Break Even,$0.75,$744.00,$455396.75,318,$744.00
2025-03-25,20:54:00,20515.75,SELL,3,0.02h,Stop Loss,$-18.00,$726.00,$455378.75,318,$726.00
2025-03-25,22:10:00,20519.25,BUY,3,0.02h,Stop Loss,$105.75,$831.75,$455484.50,318,$831.75
2025-03-25,22:21:00,20514.5,SELL,3,0.02h,Stop Loss,$-18.00,$813.75,$455466.50,318,$813.75
2025-03-25,22:54:00,20512.25,BUY,3,0.02h,Break Even,$0.75,$814.50,$455467.25,318,$814.50
2025-03-25,22:59:00,20509.5,SELL,3,0.02h,Break Even,$0.75,$815.25,$455468.00,318,$815.25
,,,,,,,,,,,
2025-03-26,12:47:00,20468.5,BUY,3,0.02h,Stop Loss,$45.75,$45.75,$455513.75,319,$45.75
2025-03-26,13:15:00,20473.5,SELL,3,0.02h,Break Even,$0.75,$46.50,$455514.50,319,$46.50
2025-03-26,13:40:00,20458.25,BUY,3,0.02h,Stop Loss,$165.75,$212.25,$455680.25,319,$212.25
2025-03-26,13:43:00,20439.25,SELL,3,0.02h,Stop Loss,$162.00,$374.25,$455842.25,319,$374.25
2025-03-26,14:42:00,20291.75,BUY,3,0.02h,Stop Loss,$-18.00,$356.25,$455824.25,319,$356.25
2025-03-26,14:43:00,20280.75,SELL,3,0.02h,Break Even,$0.75,$357.00,$455825.00,319,$357.00
2025-03-26,14:54:00,20310.5,BUY,3,0.02h,Stop Loss,$-18.00,$339.00,$455807.00,319,$339.00
2025-03-26,15:25:00,20288.25,SELL,3,0.02h,Stop Loss,$255.75,$594.75,$456062.75,319,$594.75
2025-03-26,16:30:00,20205.0,BUY,3,0.02h,Stop Loss,$143.25,$738.00,$456206.00,319,$738.00
2025-03-26,16:43:00,20189.5,SELL,3,0.02h,Stop Loss,$120.75,$858.75,$456326.75,319,$858.75
2025-03-26,18:11:00,20109.5,BUY,3,0.02h,Stop Loss,$90.75,$949.50,$456417.50,319,$949.50
2025-03-26,18:37:00,20115.0,SELL,3,0.02h,Stop Loss,$12.00,$961.50,$456429.50,319,$961.50
2025-03-26,19:19:00,20079.0,BUY,3,0.02h,Stop Loss,$154.50,$1116.00,$456584.00,319,$1116.00
2025-03-26,19:32:00,20065.25,SELL,3,0.02h,Stop Loss,$-18.00,$1098.00,$456566.00,319,$1098.00
2025-03-26,19:36:00,20079.75,BUY,3,0.02h,Break Even,$0.75,$1098.75,$456566.75,319,$1098.75
2025-03-26,20:18:00,20105.75,SELL,3,0.02h,Stop Loss,$-18.00,$1080.75,$456548.75,319,$1080.75
2025-03-26,20:50:00,20099.5,BUY,3,0.02h,Stop Loss,$-18.00,$1062.75,$456530.75,319,$1062.75
2025-03-26,20:53:00,20093.75,SELL,3,0.02h,Stop Loss,$49.50,$1112.25,$456580.25,319,$1112.25
,,,,,,,,,,,
2025-03-27,12:00:00,20088.75,BUY,3,0.02h,Break Even,$0.75,$0.75,$456581.00,320,$0.75
2025-03-27,12:27:00,20056.0,SELL,3,0.02h,Stop Loss,$57.00,$57.75,$456638.00,320,$57.75
2025-03-27,12:31:00,20082.25,BUY,3,0.02h,Stop Loss,$203.25,$261.00,$456841.25,320,$261.00
2025-03-27,12:49:00,20065.25,SELL,3,0.02h,Stop Loss,$15.75,$276.75,$456857.00,320,$276.75
2025-03-27,13:08:00,20080.75,BUY,3,0.02h,Stop Loss,$-18.00,$258.75,$456839.00,320,$258.75
2025-03-27,13:11:00,20067.5,SELL,3,0.02h,Stop Loss,$30.75,$289.50,$456869.75,320,$289.50
2025-03-27,13:51:00,20028.25,BUY,3,0.02h,Stop Loss,$102.00,$391.50,$456971.75,320,$391.50
2025-03-27,14:24:00,20050.0,SELL,3,0.02h,Break Even,$0.75,$392.25,$456972.50,320,$392.25
2025-03-27,14:26:00,20080.25,BUY,3,0.02h,Stop Loss,$27.00,$419.25,$456999.50,320,$419.25
2025-03-27,15:14:00,20157.75,SELL,3,0.02h,Stop Loss,$-18.00,$401.25,$456981.50,320,$401.25
2025-03-27,16:08:00,20085.75,BUY,3,0.02h,Break Even,$0.75,$402.00,$456982.25,320,$402.00
2025-03-27,16:30:00,20079.5,SELL,3,0.02h,Break Even,$0.75,$402.75,$456983.00,320,$402.75
2025-03-27,17:13:00,20049.75,BUY,3,0.02h,Stop Loss,$79.50,$482.25,$457062.50,320,$482.25
2025-03-27,17:26:00,20034.25,SELL,3,0.02h,Stop Loss,$38.25,$520.50,$457100.75,320,$520.50
2025-03-27,17:48:00,20050.75,BUY,3,0.02h,Stop Loss,$-18.00,$502.50,$457082.75,320,$502.50
2025-03-27,17:55:00,20011.0,SELL,3,0.02h,Break Even,$0.75,$503.25,$457083.50,320,$503.25
2025-03-27,18:05:00,20042.5,BUY,3,0.02h,Stop Loss,$102.00,$605.25,$457185.50,320,$605.25
2025-03-27,18:34:00,20058.5,SELL,3,0.02h,Break Even,$0.75,$606.00,$457186.25,320,$606.00
2025-03-27,18:35:00,20065.0,BUY,3,0.02h,Stop Loss,$64.50,$670.50,$457250.75,320,$670.50
2025-03-27,18:58:00,20061.0,SELL,3,0.02h,Stop Loss,$49.50,$720.00,$457300.25,320,$720.00
2025-03-27,19:15:00,20096.75,BUY,3,0.02h,Stop Loss,$102.00,$822.00,$457402.25,320,$822.00
2025-03-27,19:34:00,20073.25,SELL,3,0.02h,Stop Loss,$38.25,$860.25,$457440.50,320,$860.25
2025-03-27,20:35:00,20004.25,BUY,3,0.02h,Break Even,$0.75,$861.00,$457441.25,320,$861.00
2025-03-27,20:57:00,20004.0,SELL,3,0.02h,Break Even,$0.75,$861.75,$457442.00,320,$861.75
2025-03-27,22:25:00,19997.0,BUY,3,0.02h,Stop Loss,$-18.00,$843.75,$457424.00,320,$843.75
2025-03-27,22:30:00,19993.25,SELL,3,0.02h,Stop Loss,$-18.00,$825.75,$457406.00,320,$825.75
2025-03-27,22:31:00,19997.5,BUY,3,0.02h,Stop Loss,$-18.00,$807.75,$457388.00,320,$807.75
2025-03-27,22:32:00,19995.0,SELL,3,0.02h,Stop Loss,$-18.00,$789.75,$457370.00,320,$789.75
2025-03-27,22:33:00,19998.5,BUY,3,0.02h,Break Even,$0.75,$790.50,$457370.75,320,$790.50
2025-03-27,22:35:00,19992.75,SELL,3,0.02h,Stop Loss,$-18.00,$772.50,$457352.75,320,$772.50
2025-03-27,22:36:00,19997.75,BUY,3,0.02h,Stop Loss,$38.25,$810.75,$457391.00,320,$810.75
2025-03-27,22:52:00,19997.5,SELL,3,0.02h,Stop Loss,$19.50,$830.25,$457410.50,320,$830.25
,,,,,,,,,,,
2025-03-28,13:11:00,19893.75,BUY,3,0.02h,Stop Loss,$240.75,$240.75,$457651.25,321,$240.75
2025-03-28,13:31:00,19889.0,SELL,3,0.02h,Stop Loss,$417.00,$657.75,$458068.25,321,$657.75
2025-03-28,13:43:00,19934.5,BUY,3,0.02h,Stop Loss,$53.25,$711.00,$458121.50,321,$711.00
2025-03-28,13:45:00,19881.75,SELL,3,0.02h,Stop Loss,$68.25,$779.25,$458189.75,321,$779.25
2025-03-28,13:50:00,19909.0,BUY,3,0.02h,Stop Loss,$162.00,$941.25,$458351.75,321,$941.25
2025-03-28,13:52:00,19883.5,SELL,3,0.02h,Stop Loss,$327.00,$1268.25,$458678.75,321,$1268.25
2025-03-28,15:15:00,19608.5,BUY,3,0.02h,Stop Loss,$53.25,$1321.50,$458732.00,321,$1321.50
2025-03-28,15:20:00,19587.75,SELL,3,0.02h,Stop Loss,$34.50,$1356.00,$458766.50,321,$1356.00
2025-03-28,15:31:00,19594.5,BUY,3,0.02h,Stop Loss,$248.25,$1604.25,$459014.75,321,$1604.25
2025-03-28,15:46:00,19598.75,SELL,3,0.02h,Stop Loss,$34.50,$1638.75,$459049.25,321,$1638.75
2025-03-28,16:52:00,19525.75,BUY,3,0.02h,Stop Loss,$60.75,$1699.50,$459110.00,321,$1699.50
2025-03-28,16:57:00,19501.0,SELL,3,0.02h,Stop Loss,$34.50,$1734.00,$459144.50,321,$1734.00
2025-03-28,17:44:00,19472.75,BUY,3,0.02h,Stop Loss,$-18.00,$1716.00,$459126.50,321,$1716.00
2025-03-28,17:45:00,19456.5,SELL,3,0.02h,Stop Loss,$15.75,$1731.75,$459142.25,321,$1731.75
2025-03-28,17:47:00,19464.75,BUY,3,0.02h,Stop Loss,$124.50,$1856.25,$459266.75,321,$1856.25
2025-03-28,17:52:00,19449.5,SELL,3,0.02h,Stop Loss,$-18.00,$1838.25,$459248.75,321,$1838.25
2025-03-28,17:58:00,19478.0,BUY,3,0.02h,Stop Loss,$-18.00,$1820.25,$459230.75,321,$1820.25
2025-03-28,18:24:00,19473.5,SELL,3,0.02h,Stop Loss,$49.50,$1869.75,$459280.25,321,$1869.75
2025-03-28,18:35:00,19485.75,BUY,3,0.02h,Stop Loss,$23.25,$1893.00,$459303.50,321,$1893.00
2025-03-28,18:36:00,19477.75,SELL,3,0.02h,Stop Loss,$79.50,$1972.50,$459383.00,321,$1972.50
2025-03-28,18:58:00,19477.0,BUY,3,0.02h,Break Even,$0.75,$1973.25,$459383.75,321,$1973.25
2025-03-28,19:17:00,19471.75,SELL,3,0.02h,Stop Loss,$102.00,$2075.25,$459485.75,321,$2075.25
2025-03-28,19:55:00,19470.5,BUY,3,0.02h,Stop Loss,$98.25,$2173.50,$459584.00,321,$2173.50
2025-03-28,20:06:00,19438.75,SELL,3,0.02h,Break Even,$0.75,$2174.25,$459584.75,321,$2174.25
,,,,,,,,,,,
2025-03-31,12:35:00,19197.5,BUY,3,0.02h,Stop Loss,$12.00,$12.00,$459596.75,322,$12.00
2025-03-31,13:15:00,19208.5,SELL,3,0.02h,Stop Loss,$45.75,$57.75,$459642.50,322,$57.75
2025-03-31,13:57:00,19099.25,BUY,3,0.02h,Stop Loss,$375.75,$433.50,$460018.25,322,$433.50
2025-03-31,14:20:00,19095.75,SELL,3,0.02h,Stop Loss,$-18.00,$415.50,$460000.25,322,$415.50
2025-03-31,14:35:00,19157.25,BUY,3,0.02h,Stop Loss,$75.75,$491.25,$460076.00,322,$491.25
2025-03-31,15:15:00,19121.0,SELL,3,0.02h,Stop Loss,$60.75,$552.00,$460136.75,322,$552.00
2025-03-31,15:18:00,19150.25,BUY,3,0.02h,Stop Loss,$83.25,$635.25,$460220.00,322,$635.25
2025-03-31,16:07:00,19214.75,SELL,3,0.02h,Stop Loss,$117.00,$752.25,$460337.00,322,$752.25
2025-03-31,16:23:00,19229.75,BUY,3,0.02h,Break Even,$0.75,$753.00,$460337.75,322,$753.00
2025-03-31,16:49:00,19246.0,SELL,3,0.02h,Break Even,$0.75,$753.75,$460338.50,322,$753.75
2025-03-31,16:55:00,19264.5,BUY,3,0.02h,Stop Loss,$-18.00,$735.75,$460320.50,322,$735.75
2025-03-31,16:56:00,19249.25,SELL,3,0.02h,Stop Loss,$259.50,$995.25,$460580.00,322,$995.25
2025-03-31,17:07:00,19261.5,BUY,3,0.02h,Stop Loss,$165.75,$1161.00,$460745.75,322,$1161.00
2025-03-31,17:21:00,19241.0,SELL,3,0.02h,Stop Loss,$177.00,$1338.00,$460922.75,322,$1338.00
2025-03-31,17:39:00,19266.0,BUY,3,0.02h,Stop Loss,$30.75,$1368.75,$460953.50,322,$1368.75
2025-03-31,17:44:00,19225.75,SELL,3,0.02h,Stop Loss,$60.75,$1429.50,$461014.25,322,$1429.50
2025-03-31,17:54:00,19259.25,BUY,3,0.02h,Stop Loss,$83.25,$1512.75,$461097.50,322,$1512.75
2025-03-31,17:59:00,19227.0,SELL,3,0.02h,Stop Loss,$64.50,$1577.25,$461162.00,322,$1577.25
2025-03-31,18:02:00,19262.5,BUY,3,0.02h,Stop Loss,$139.50,$1716.75,$461301.50,322,$1716.75
2025-03-31,18:49:00,19361.25,SELL,3,0.02h,Stop Loss,$15.75,$1732.50,$461317.25,322,$1732.50
2025-03-31,18:51:00,19396.75,BUY,3,0.02h,Break Even,$0.75,$1733.25,$461318.00,322,$1733.25
2025-03-31,19:00:00,19348.25,SELL,3,0.02h,Break Even,$0.75,$1734.00,$461318.75,322,$1734.00
2025-03-31,19:06:00,19387.0,BUY,3,0.02h,Stop Loss,$218.25,$1952.25,$461537.00,322,$1952.25
2025-03-31,19:29:00,19371.0,SELL,3,0.02h,Stop Loss,$169.50,$2121.75,$461706.50,322,$2121.75
2025-03-31,19:36:00,19422.5,BUY,3,0.02h,Break Even,$0.75,$2122.50,$461707.25,322,$2122.50
2025-03-31,20:03:00,19409.5,SELL,3,0.02h,Stop Loss,$23.25,$2145.75,$461730.50,322,$2145.75
2025-03-31,20:18:00,19429.5,BUY,3,0.02h,Stop Loss,$-18.00,$2127.75,$461712.50,322,$2127.75
2025-03-31,20:24:00,19421.0,SELL,3,0.02h,Break Even,$0.75,$2128.50,$461713.25,322,$2128.50
2025-03-31,20:45:00,19424.0,BUY,3,0.02h,Stop Loss,$-18.00,$2110.50,$461695.25,322,$2110.50
2025-03-31,20:51:00,19413.75,SELL,3,0.03h,Stop Loss,$-18.00,$2092.50,$461677.25,322,$2092.50
2025-03-31,22:37:00,19370.0,BUY,3,0.02h,Break Even,$0.75,$2093.25,$461678.00,322,$2093.25
,,,,,,,,,,,
2025-04-01,12:00:00,19354.5,SELL,3,0.02h,Stop Loss,$64.50,$64.50,$461742.50,323,$64.50
2025-04-01,12:12:00,19371.5,BUY,3,0.02h,Break Even,$0.75,$65.25,$461743.25,323,$65.25
2025-04-01,12:13:00,19356.0,SELL,3,0.02h,Stop Loss,$12.00,$77.25,$461755.25,323,$77.25
2025-04-01,12:17:00,19379.0,BUY,3,0.02h,Stop Loss,$-18.00,$59.25,$461737.25,323,$59.25
2025-04-01,12:20:00,19362.25,SELL,3,0.02h,Stop Loss,$45.75,$105.00,$461783.00,323,$105.00
2025-04-01,12:33:00,19372.5,BUY,3,0.02h,Stop Loss,$23.25,$128.25,$461806.25,323,$128.25
2025-04-01,13:29:00,19383.25,SELL,3,0.02h,Stop Loss,$128.25,$256.50,$461934.50,323,$256.50
2025-04-01,13:45:00,19400.75,BUY,3,0.02h,Stop Loss,$207.00,$463.50,$462141.50,323,$463.50
2025-04-01,14:00:00,19367.5,SELL,3,0.02h,Stop Loss,$-18.00,$445.50,$462123.50,323,$445.50
2025-04-01,14:31:00,19352.5,BUY,3,0.02h,Stop Loss,$199.50,$645.00,$462323.00,323,$645.00
2025-04-01,15:37:00,19558.0,SELL,3,0.02h,Stop Loss,$244.50,$889.50,$462567.50,323,$889.50
2025-04-01,15:46:00,19585.0,BUY,3,0.02h,Stop Loss,$143.25,$1032.75,$462710.75,323,$1032.75
2025-04-01,16:27:00,19570.75,SELL,3,0.02h,Stop Loss,$105.75,$1138.50,$462816.50,323,$1138.50
2025-04-01,16:53:00,19576.75,BUY,3,0.02h,Stop Loss,$214.50,$1353.00,$463031.00,323,$1353.00
2025-04-01,17:07:00,19535.0,SELL,3,0.02h,Stop Loss,$19.50,$1372.50,$463050.50,323,$1372.50
2025-04-01,17:41:00,19560.25,BUY,3,0.02h,Stop Loss,$117.00,$1489.50,$463167.50,323,$1489.50
2025-04-01,17:56:00,19517.75,SELL,3,0.02h,Break Even,$0.75,$1490.25,$463168.25,323,$1490.25
2025-04-01,18:45:00,19432.5,BUY,3,0.02h,Stop Loss,$-18.00,$1472.25,$463150.25,323,$1472.25
2025-04-01,18:48:00,19408.75,SELL,3,0.02h,Stop Loss,$45.75,$1518.00,$463196.00,323,$1518.00
2025-04-01,18:56:00,19440.25,BUY,3,0.02h,Stop Loss,$83.25,$1601.25,$463279.25,323,$1601.25
2025-04-01,20:26:00,19594.0,SELL,3,0.02h,Stop Loss,$15.75,$1617.00,$463295.00,323,$1617.00
2025-04-01,20:47:00,19597.5,BUY,3,0.02h,Stop Loss,$435.75,$2052.75,$463730.75,323,$2052.75
2025-04-01,22:35:00,19645.25,SELL,3,0.02h,Stop Loss,$15.75,$2068.50,$463746.50,323,$2068.50
2025-04-01,22:41:00,19660.5,BUY,3,0.02h,Stop Loss,$-18.00,$2050.50,$463728.50,323,$2050.50
2025-04-01,22:50:00,19652.25,SELL,3,0.02h,Stop Loss,$-18.00,$2032.50,$463710.50,323,$2032.50
2025-04-01,22:51:00,19656.0,BUY,3,0.02h,Stop Loss,$-18.00,$2014.50,$463692.50,323,$2014.50
2025-04-01,22:52:00,19650.5,SELL,3,0.02h,Stop Loss,$23.25,$2037.75,$463715.75,323,$2037.75
,,,,,,,,,,,
2025-04-02,12:49:00,19393.5,BUY,3,0.02h,Stop Loss,$-18.00,$-18.00,$463697.75,324,$-18.00
2025-04-02,13:03:00,19367.25,SELL,3,0.02h,Stop Loss,$169.50,$151.50,$463867.25,324,$151.50
2025-04-02,13:34:00,19394.5,BUY,3,0.02h,Stop Loss,$323.25,$474.75,$464190.50,324,$474.75
2025-04-02,14:12:00,19517.75,SELL,3,0.02h,Stop Loss,$79.50,$554.25,$464270.00,324,$554.25
2025-04-02,14:19:00,19568.75,BUY,3,0.02h,Stop Loss,$-18.00,$536.25,$464252.00,324,$536.25
2025-04-02,15:15:00,19584.5,SELL,3,0.02h,Stop Loss,$19.50,$555.75,$464271.50,324,$555.75
2025-04-02,15:21:00,19650.25,BUY,3,0.02h,Stop Loss,$203.25,$759.00,$464474.75,324,$759.00
2025-04-02,15:47:00,19655.0,SELL,3,0.02h,Stop Loss,$240.75,$999.75,$464715.50,324,$999.75
2025-04-02,16:02:00,19673.25,BUY,3,0.02h,Stop Loss,$154.50,$1154.25,$464870.00,324,$1154.25
2025-04-02,17:30:00,19832.25,SELL,3,0.02h,Stop Loss,$128.25,$1282.50,$464998.25,324,$1282.50
2025-04-02,18:39:00,19693.0,BUY,3,0.02h,Stop Loss,$53.25,$1335.75,$465051.50,324,$1335.75
2025-04-02,18:55:00,19674.75,SELL,3,0.02h,Stop Loss,$132.00,$1467.75,$465183.50,324,$1467.75
2025-04-02,19:10:00,19665.5,BUY,3,0.02h,Break Even,$0.75,$1468.50,$465184.25,324,$1468.50
2025-04-02,19:11:00,19661.5,SELL,3,0.02h,Stop Loss,$210.75,$1679.25,$465395.00,324,$1679.25
2025-04-02,19:27:00,19670.25,BUY,3,0.02h,Stop Loss,$154.50,$1833.75,$465549.50,324,$1833.75
2025-04-02,20:08:00,19740.25,SELL,3,0.02h,Stop Loss,$255.75,$2089.50,$465805.25,324,$2089.50
2025-04-02,20:14:00,19925.25,BUY,3,0.02h,Stop Loss,$814.50,$2904.00,$466619.75,324,$2904.00
2025-04-02,20:28:00,19606.0,SELL,3,0.02h,Stop Loss,$2292.00,$5196.00,$468911.75,324,$5196.00
2025-04-02,22:37:00,18940.0,BUY,3,0.02h,Stop Loss,$424.50,$5620.50,$469336.25,324,$5620.50
2025-04-02,22:45:00,18907.0,SELL,3,0.02h,Stop Loss,$75.75,$5696.25,$469412.00,324,$5696.25
2025-04-02,22:49:00,18929.0,BUY,3,0.02h,Stop Loss,$42.00,$5738.25,$469454.00,324,$5738.25
,,,,,,,,,,,
2025-04-03,12:26:00,18994.5,SELL,3,0.02h,Stop Loss,$12.00,$12.00,$469466.00,325,$12.00
2025-04-03,13:15:00,18882.0,BUY,3,0.02h,Stop Loss,$83.25,$95.25,$469549.25,325,$95.25
2025-04-03,13:22:00,18864.75,SELL,3,0.02h,Stop Loss,$-18.00,$77.25,$469531.25,325,$77.25
2025-04-03,13:26:00,18905.5,BUY,3,0.02h,Stop Loss,$113.25,$190.50,$469644.50,325,$190.50
2025-04-03,14:02:00,18978.25,SELL,3,0.02h,Stop Loss,$192.00,$382.50,$469836.50,325,$382.50
2025-04-03,14:31:00,18929.25,BUY,3,0.02h,Stop Loss,$30.75,$413.25,$469867.25,325,$413.25
2025-04-03,14:35:00,18893.0,SELL,3,0.02h,Stop Loss,$124.50,$537.75,$469991.75,325,$537.75
2025-04-03,15:15:00,18797.75,BUY,3,0.02h,Stop Loss,$477.00,$1014.75,$470468.75,325,$1014.75
2025-04-03,15:53:00,18844.0,SELL,3,0.02h,Stop Loss,$38.25,$1053.00,$470507.00,325,$1053.00
2025-04-03,15:55:00,18893.25,BUY,3,0.02h,Stop Loss,$132.00,$1185.00,$470639.00,325,$1185.00
2025-04-03,16:35:00,18902.25,SELL,3,0.02h,Stop Loss,$30.75,$1215.75,$470669.75,325,$1215.75
2025-04-03,16:44:00,18958.5,BUY,3,0.02h,Stop Loss,$30.75,$1246.50,$470700.50,325,$1246.50
2025-04-03,16:45:00,18916.0,SELL,3,0.02h,Stop Loss,$87.00,$1333.50,$470787.50,325,$1333.50
2025-04-03,17:38:00,18876.5,BUY,3,0.02h,Stop Loss,$244.50,$1578.00,$471032.00,325,$1578.00
2025-04-03,17:52:00,18846.5,SELL,3,0.02h,Break Even,$0.75,$1578.75,$471032.75,325,$1578.75
2025-04-03,18:38:00,18803.25,BUY,3,0.02h,Stop Loss,$102.00,$1680.75,$471134.75,325,$1680.75
2025-04-03,19:12:00,18817.0,SELL,3,0.02h,Break Even,$0.75,$1681.50,$471135.50,325,$1681.50
2025-04-03,20:56:00,18650.0,BUY,3,0.02h,Break Even,$0.75,$1682.25,$471136.25,325,$1682.25
2025-04-03,22:15:00,18652.75,SELL,3,0.02h,Break Even,$0.75,$1683.00,$471137.00,325,$1683.00
2025-04-03,22:16:00,18669.5,BUY,3,0.02h,Stop Loss,$-18.00,$1665.00,$471119.00,325,$1665.00
2025-04-03,22:18:00,18651.25,SELL,3,0.02h,Stop Loss,$90.75,$1755.75,$471209.75,325,$1755.75
2025-04-03,22:42:00,18642.5,BUY,3,0.02h,Break Even,$0.75,$1756.50,$471210.50,325,$1756.50
,,,,,,,,,,,
2025-04-04,12:00:00,18127.75,SELL,3,0.02h,Stop Loss,$503.25,$503.25,$471713.75,326,$503.25
2025-04-04,12:34:00,18226.25,BUY,3,0.02h,Break Even,$0.75,$504.00,$471714.50,326,$504.00
2025-04-04,12:39:00,18072.0,SELL,3,0.02h,Stop Loss,$154.50,$658.50,$471869.00,326,$658.50
2025-04-04,12:45:00,18200.0,BUY,3,0.02h,Stop Loss,$90.75,$749.25,$471959.75,326,$749.25
2025-04-04,13:16:00,18189.75,SELL,3,0.02h,Stop Loss,$537.00,$1286.25,$472496.75,326,$1286.25
2025-04-04,13:53:00,18144.5,BUY,3,0.02h,Stop Loss,$724.50,$2010.75,$473221.25,326,$2010.75
2025-04-04,13:56:00,18080.0,SELL,3,0.02h,Stop Loss,$147.00,$2157.75,$473368.25,326,$2157.75
2025-04-04,13:57:00,18143.5,BUY,3,0.02h,Stop Loss,$784.50,$2942.25,$474152.75,326,$2942.25
2025-04-04,14:08:00,18099.0,SELL,3,0.02h,Stop Loss,$450.75,$3393.00,$474603.50,326,$3393.00
2025-04-04,15:01:00,17876.25,BUY,3,0.02h,Stop Loss,$1729.50,$5122.50,$476333.00,326,$5122.50
2025-04-04,15:29:00,17994.0,SELL,3,0.02h,Stop Loss,$882.00,$6004.50,$477215.00,326,$6004.50
2025-04-04,15:50:00,18001.0,BUY,3,0.02h,Break Even,$0.75,$6005.25,$477215.75,326,$6005.25
2025-04-04,15:59:00,17889.75,SELL,3,0.02h,Stop Loss,$188.25,$6193.50,$477404.00,326,$6193.50
2025-04-04,16:42:00,17823.25,BUY,3,0.02h,Stop Loss,$165.75,$6359.25,$477569.75,326,$6359.25
2025-04-04,16:45:00,17755.75,SELL,3,0.02h,Stop Loss,$203.25,$6562.50,$477773.00,326,$6562.50
2025-04-04,17:03:00,17803.25,BUY,3,0.02h,Stop Loss,$42.00,$6604.50,$477815.00,326,$6604.50
2025-04-04,17:07:00,17732.75,SELL,3,0.02h,Break Even,$0.75,$6605.25,$477815.75,326,$6605.25
2025-04-04,17:27:00,17735.25,BUY,3,0.02h,Stop Loss,$139.50,$6744.75,$477955.25,326,$6744.75
2025-04-04,17:32:00,17675.25,SELL,3,0.02h,Stop Loss,$60.75,$6805.50,$478016.00,326,$6805.50
2025-04-04,17:34:00,17725.75,BUY,3,0.02h,Stop Loss,$477.00,$7282.50,$478493.00,326,$7282.50
2025-04-04,18:11:00,17797.25,SELL,3,0.02h,Stop Loss,$342.00,$7624.50,$478835.00,326,$7624.50
2025-04-04,18:53:00,17665.0,BUY,3,0.02h,Stop Loss,$158.25,$7782.75,$478993.25,326,$7782.75
2025-04-04,19:01:00,17617.75,SELL,3,0.02h,Stop Loss,$473.25,$8256.00,$479466.50,326,$8256.00
2025-04-04,19:12:00,17661.75,BUY,3,0.02h,Stop Loss,$480.75,$8736.75,$479947.25,326,$8736.75
2025-04-04,19:49:00,17720.75,SELL,3,0.02h,Stop Loss,$225.75,$8962.50,$480173.00,326,$8962.50
2025-04-04,20:40:00,17484.0,BUY,3,0.02h,Stop Loss,$64.50,$9027.00,$480237.50,326,$9027.00
,,,,,,,,,,,
2025-04-07,12:00:00,17063.75,SELL,3,0.02h,Break Even,$0.75,$0.75,$480238.25,327,$0.75
2025-04-07,12:30:00,17179.5,BUY,3,0.02h,Stop Loss,$743.25,$744.00,$480981.50,327,$744.00
2025-04-07,12:46:00,17013.75,SELL,3,0.02h,Stop Loss,$30.75,$774.75,$481012.25,327,$774.75
2025-04-07,12:53:00,17150.5,BUY,3,0.02h,Stop Loss,$443.25,$1218.00,$481455.50,327,$1218.00
2025-04-07,13:06:00,17114.25,SELL,3,0.02h,Stop Loss,$874.50,$2092.50,$482330.00,327,$2092.50
2025-04-07,13:51:00,16978.25,BUY,3,0.02h,Stop Loss,$705.75,$2798.25,$483035.75,327,$2798.25
2025-04-07,14:29:00,17392.5,SELL,3,0.02h,Stop Loss,$739.50,$3537.75,$483775.25,327,$3537.75
2025-04-07,14:51:00,17598.75,BUY,3,0.02h,Stop Loss,$113.25,$3651.00,$483888.50,327,$3651.00
2025-04-07,15:11:00,17551.25,SELL,3,0.02h,Stop Loss,$372.00,$4023.00,$484260.50,327,$4023.00
2025-04-07,15:39:00,17426.5,BUY,3,0.02h,Stop Loss,$27.00,$4050.00,$484287.50,327,$4050.00
2025-04-07,16:00:00,17390.75,SELL,3,0.02h,Stop Loss,$904.50,$4954.50,$485192.00,327,$4954.50
2025-04-07,16:27:00,17427.5,BUY,3,0.02h,Stop Loss,$42.00,$4996.50,$485234.00,327,$4996.50
2025-04-07,16:44:00,17327.75,SELL,3,0.02h,Stop Loss,$285.75,$5282.25,$485519.75,327,$5282.25
2025-04-07,17:02:00,17453.5,BUY,3,0.02h,Stop Loss,$12.00,$5294.25,$485531.75,327,$5294.25
2025-04-07,17:07:00,17297.25,SELL,3,0.02h,Stop Loss,$720.75,$6015.00,$486252.50,327,$6015.00
2025-04-07,17:13:00,17386.0,BUY,3,0.02h,Stop Loss,$454.50,$6469.50,$486707.00,327,$6469.50
2025-04-07,18:12:00,17680.0,SELL,3,0.02h,Stop Loss,$953.25,$7422.75,$487660.25,327,$7422.75
2025-04-07,18:19:00,17795.25,BUY,3,0.02h,Stop Loss,$105.75,$7528.50,$487766.00,327,$7528.50
2025-04-07,18:28:00,17652.5,SELL,3,0.02h,Stop Loss,$698.25,$8226.75,$488464.25,327,$8226.75
2025-04-07,18:40:00,17713.25,BUY,3,0.02h,Stop Loss,$435.75,$8662.50,$488900.00,327,$8662.50
2025-04-07,18:46:00,17653.5,SELL,3,0.02h,Stop Loss,$87.00,$8749.50,$488987.00,327,$8749.50
2025-04-07,19:34:00,17608.5,BUY,3,0.02h,Stop Loss,$428.25,$9177.75,$489415.25,327,$9177.75
2025-04-07,19:45:00,17461.5,SELL,3,0.02h,Stop Loss,$64.50,$9242.25,$489479.75,327,$9242.25
2025-04-07,19:58:00,17539.5,BUY,3,0.02h,Stop Loss,$353.25,$9595.50,$489833.00,327,$9595.50
2025-04-07,20:28:00,17652.25,SELL,3,0.02h,Stop Loss,$-18.00,$9577.50,$489815.00,327,$9577.50
2025-04-07,22:02:00,17682.0,BUY,3,0.02h,Stop Loss,$30.75,$9608.25,$489845.75,327,$9608.25
,,,,,,,,,,,
2025-04-08,12:37:00,17967.25,SELL,3,0.02h,Stop Loss,$-18.00,$-18.00,$489827.75,328,$-18.00
2025-04-08,12:59:00,17989.75,BUY,3,0.02h,Stop Loss,$49.50,$31.50,$489877.25,328,$31.50
2025-04-08,13:40:00,18103.25,SELL,3,0.02h,Stop Loss,$402.00,$433.50,$490279.25,328,$433.50
2025-04-08,13:44:00,18145.75,BUY,3,0.02h,Stop Loss,$147.00,$580.50,$490426.25,328,$580.50
2025-04-08,14:33:00,18287.25,SELL,3,0.02h,Stop Loss,$285.75,$866.25,$490712.00,328,$866.25
2025-04-08,14:35:00,18310.75,BUY,3,0.02h,Stop Loss,$173.25,$1039.50,$490885.25,328,$1039.50
2025-04-08,14:43:00,18274.75,SELL,3,0.02h,Stop Loss,$525.75,$1565.25,$491411.00,328,$1565.25
2025-04-08,15:39:00,18091.0,BUY,3,0.02h,Stop Loss,$169.50,$1734.75,$491580.50,328,$1734.75
2025-04-08,15:51:00,17998.25,SELL,3,0.02h,Stop Loss,$173.25,$1908.00,$491753.75,328,$1908.00
2025-04-08,16:13:00,18052.75,BUY,3,0.02h,Stop Loss,$177.00,$2085.00,$491930.75,328,$2085.00
2025-04-08,16:15:00,17999.75,SELL,3,0.02h,Stop Loss,$248.25,$2333.25,$492179.00,328,$2333.25
2025-04-08,17:41:00,17651.25,BUY,3,0.02h,Stop Loss,$420.75,$2754.00,$492599.75,328,$2754.00
2025-04-08,18:07:00,17595.5,SELL,3,0.02h,Stop Loss,$522.00,$3276.00,$493121.75,328,$3276.00
2025-04-08,18:21:00,17626.0,BUY,3,0.02h,Break Even,$0.75,$3276.75,$493122.50,328,$3276.75
2025-04-08,18:22:00,17592.25,SELL,3,0.02h,Stop Loss,$240.75,$3517.50,$493363.25,328,$3517.50
2025-04-08,19:55:00,17227.5,BUY,3,0.02h,Stop Loss,$-18.00,$3499.50,$493345.25,328,$3499.50
2025-04-08,20:22:00,17214.75,SELL,3,0.02h,Stop Loss,$312.00,$3811.50,$493657.25,328,$3811.50
2025-04-08,20:47:00,17205.5,BUY,3,0.02h,Stop Loss,$162.00,$3973.50,$493819.25,328,$3973.50
2025-04-08,22:02:00,17167.25,SELL,3,0.02h,Stop Loss,$803.25,$4776.75,$494622.50,328,$4776.75
2025-04-08,22:47:00,17054.0,BUY,3,0.02h,Stop Loss,$27.00,$4803.75,$494649.50,328,$4803.75
,,,,,,,,,,,
2025-04-09,12:00:00,16958.0,SELL,3,0.02h,Stop Loss,$173.25,$173.25,$494822.75,329,$173.25
2025-04-09,12:43:00,16997.75,BUY,3,0.02h,Stop Loss,$402.00,$575.25,$495224.75,329,$575.25
2025-04-09,13:28:00,17191.5,SELL,3,0.02h,Stop Loss,$49.50,$624.75,$495274.25,329,$624.75
2025-04-09,13:31:00,17245.25,BUY,3,0.02h,Stop Loss,$1208.25,$1833.00,$496482.50,329,$1833.00
2025-04-09,14:10:00,17399.5,SELL,3,0.02h,Stop Loss,$169.50,$2002.50,$496652.00,329,$2002.50
2025-04-09,14:25:00,17446.5,BUY,3,0.02h,Stop Loss,$304.50,$2307.00,$496956.50,329,$2307.00
2025-04-09,14:28:00,17404.75,SELL,3,0.02h,Stop Loss,$477.00,$2784.00,$497433.50,329,$2784.00
2025-04-09,14:31:00,17460.25,BUY,3,0.02h,Stop Loss,$788.25,$3572.25,$498221.75,329,$3572.25
2025-04-09,14:42:00,17431.75,SELL,3,0.02h,Stop Loss,$94.50,$3666.75,$498316.25,329,$3666.75
2025-04-09,15:10:00,17374.0,BUY,3,0.02h,Stop Loss,$162.00,$3828.75,$498478.25,329,$3828.75
2025-04-09,15:35:00,17353.75,SELL,3,0.02h,Stop Loss,$368.25,$4197.00,$498846.50,329,$4197.00
2025-04-09,15:51:00,17395.75,BUY,3,0.02h,Stop Loss,$75.75,$4272.75,$498922.25,329,$4272.75
2025-04-09,15:56:00,17324.75,SELL,3,0.02h,Stop Loss,$428.25,$4701.00,$499350.50,329,$4701.00
2025-04-09,16:09:00,17362.75,BUY,3,0.02h,Stop Loss,$383.25,$5084.25,$499733.75,329,$5084.25
2025-04-09,18:44:00,18914.75,SELL,3,0.02h,Stop Loss,$1062.00,$6146.25,$500795.75,329,$6146.25
2025-04-09,19:11:00,18949.0,BUY,3,0.02h,Stop Loss,$394.50,$6540.75,$501190.25,329,$6540.75
2025-04-09,20:15:00,19244.5,SELL,3,0.02h,Break Even,$0.75,$6541.50,$501191.00,329,$6541.50
2025-04-09,20:19:00,19298.0,BUY,3,0.02h,Break Even,$0.75,$6542.25,$501191.75,329,$6542.25
2025-04-09,20:34:00,19285.75,SELL,3,0.02h,Stop Loss,$188.25,$6730.50,$501380.00,329,$6730.50
2025-04-09,20:35:00,19300.5,BUY,3,0.02h,Break Even,$0.75,$6731.25,$501380.75,329,$6731.25
2025-04-09,20:36:00,19287.75,SELL,3,0.02h,Stop Loss,$-18.00,$6713.25,$501362.75,329,$6713.25
2025-04-09,20:37:00,19296.5,BUY,3,0.02h,Break Even,$0.75,$6714.00,$501363.50,329,$6714.00
2025-04-09,22:02:00,19279.75,SELL,3,0.02h,Stop Loss,$165.75,$6879.75,$501529.25,329,$6879.75
2025-04-09,22:16:00,19316.5,BUY,3,0.02h,Stop Loss,$57.00,$6936.75,$501586.25,329,$6936.75
,,,,,,,,,,,
2025-04-10,12:00:00,18926.75,SELL,3,0.02h,Stop Loss,$353.25,$353.25,$501939.50,330,$353.25
2025-04-10,12:33:00,18926.75,BUY,3,0.02h,Stop Loss,$567.00,$920.25,$502506.50,330,$920.25
2025-04-10,12:38:00,18835.5,SELL,3,0.02h,Stop Loss,$327.00,$1247.25,$502833.50,330,$1247.25
2025-04-10,13:02:00,18825.25,BUY,3,0.02h,Stop Loss,$244.50,$1491.75,$503078.00,330,$1491.75
2025-04-10,13:29:00,18785.5,SELL,3,0.02h,Break Even,$0.75,$1492.50,$503078.75,330,$1492.50
2025-04-10,13:51:00,18844.25,BUY,3,0.02h,Stop Loss,$42.00,$1534.50,$503120.75,330,$1534.50
2025-04-10,13:52:00,18767.0,SELL,3,0.02h,Stop Loss,$357.00,$1891.50,$503477.75,330,$1891.50
2025-04-10,14:25:00,18705.25,BUY,3,0.02h,Stop Loss,$300.75,$2192.25,$503778.50,330,$2192.25
2025-04-10,14:49:00,18665.5,SELL,3,0.02h,Stop Loss,$349.50,$2541.75,$504128.00,330,$2541.75
2025-04-10,16:36:00,18137.5,BUY,3,0.02h,Stop Loss,$645.75,$3187.50,$504773.75,330,$3187.50
2025-04-10,17:11:00,18168.5,SELL,3,0.02h,Stop Loss,$488.25,$3675.75,$505262.00,330,$3675.75
2025-04-10,17:28:00,18256.5,BUY,3,0.02h,Stop Loss,$375.75,$4051.50,$505637.75,330,$4051.50
2025-04-10,18:12:00,18373.0,SELL,3,0.02h,Stop Loss,$188.25,$4239.75,$505826.00,330,$4239.75
2025-04-10,18:23:00,18544.0,BUY,3,0.02h,Stop Loss,$214.50,$4454.25,$506040.50,330,$4454.25
2025-04-10,18:52:00,18552.25,SELL,3,0.02h,Stop Loss,$829.50,$5283.75,$506870.00,330,$5283.75
2025-04-10,19:02:00,18616.75,BUY,3,0.02h,Stop Loss,$555.75,$5839.50,$507425.75,330,$5839.50
2025-04-10,19:09:00,18489.25,SELL,3,0.02h,Stop Loss,$454.50,$6294.00,$507880.25,330,$6294.00
2025-04-10,19:22:00,18595.5,BUY,3,0.02h,Stop Loss,$102.00,$6396.00,$507982.25,330,$6396.00
2025-04-10,19:26:00,18507.5,SELL,3,0.02h,Stop Loss,$428.25,$6824.25,$508410.50,330,$6824.25
2025-04-10,19:54:00,18468.5,BUY,3,0.02h,Stop Loss,$870.75,$7695.00,$509281.25,330,$7695.00
2025-04-10,20:23:00,18489.75,SELL,3,0.02h,Break Even,$0.75,$7695.75,$509282.00,330,$7695.75
2025-04-10,20:53:00,18488.5,BUY,3,0.02h,Stop Loss,$-18.00,$7677.75,$509264.00,330,$7677.75
2025-04-10,22:27:00,18512.75,SELL,3,0.02h,Break Even,$0.75,$7678.50,$509264.75,330,$7678.50
2025-04-10,22:28:00,18530.5,BUY,3,0.02h,Break Even,$0.75,$7679.25,$509265.50,330,$7679.25
2025-04-10,22:54:00,18547.75,SELL,3,0.02h,Break Even,$0.75,$7680.00,$509266.25,330,$7680.00
,,,,,,,,,,,
2025-04-11,12:01:00,18576.75,BUY,3,0.02h,Stop Loss,$105.75,$105.75,$509372.00,331,$105.75
2025-04-11,12:22:00,18558.25,SELL,3,0.02h,Stop Loss,$447.00,$552.75,$509819.00,331,$552.75
2025-04-11,12:31:00,18591.75,BUY,3,0.02h,Stop Loss,$233.25,$786.00,$510052.25,331,$786.00
2025-04-11,12:47:00,18572.25,SELL,3,0.02h,Stop Loss,$537.00,$1323.00,$510589.25,331,$1323.00
2025-04-11,13:40:00,18506.5,BUY,3,0.02h,Stop Loss,$98.25,$1421.25,$510687.50,331,$1421.25
2025-04-11,14:03:00,18484.5,SELL,3,0.02h,Stop Loss,$735.75,$2157.00,$511423.25,331,$2157.00
2025-04-11,14:09:00,18568.0,BUY,3,0.02h,Stop Loss,$420.75,$2577.75,$511844.00,331,$2577.75
2025-04-11,14:13:00,18482.75,SELL,3,0.02h,Stop Loss,$109.50,$2687.25,$511953.50,331,$2687.25
2025-04-11,14:16:00,18573.0,BUY,3,0.02h,Stop Loss,$147.00,$2834.25,$512100.50,331,$2834.25
2025-04-11,14:18:00,18475.0,SELL,3,0.02h,Stop Loss,$327.00,$3161.25,$512427.50,331,$3161.25
2025-04-11,14:39:00,18442.0,BUY,3,0.02h,Stop Loss,$450.75,$3612.00,$512878.25,331,$3612.00
2025-04-11,15:00:00,18413.5,SELL,3,0.02h,Stop Loss,$203.25,$3815.25,$513081.50,331,$3815.25
2025-04-11,15:30:00,18414.25,BUY,3,0.02h,Stop Loss,$274.50,$4089.75,$513356.00,331,$4089.75
2025-04-11,16:27:00,18551.75,SELL,3,0.02h,Stop Loss,$34.50,$4124.25,$513390.50,331,$4124.25
2025-04-11,16:32:00,18632.0,BUY,3,0.02h,Stop Loss,$267.00,$4391.25,$513657.50,331,$4391.25
2025-04-11,17:11:00,18715.0,SELL,3,0.02h,Stop Loss,$334.50,$4725.75,$513992.00,331,$4725.75
2025-04-11,17:40:00,18737.5,BUY,3,0.02h,Stop Loss,$784.50,$5510.25,$514776.50,331,$5510.25
2025-04-11,18:10:00,18780.0,SELL,3,0.02h,Stop Loss,$379.50,$5889.75,$515156.00,331,$5889.75
2025-04-11,18:14:00,18804.75,BUY,3,0.02h,Stop Loss,$49.50,$5939.25,$515205.50,331,$5939.25
2025-04-11,18:15:00,18793.0,SELL,3,0.02h,Stop Loss,$19.50,$5958.75,$515225.00,331,$5958.75
2025-04-11,18:16:00,18809.75,BUY,3,0.02h,Stop Loss,$27.00,$5985.75,$515252.00,331,$5985.75
2025-04-11,18:17:00,18791.0,SELL,3,0.02h,Stop Loss,$458.25,$6444.00,$515710.25,331,$6444.00
2025-04-11,18:37:00,18794.75,BUY,3,0.02h,Stop Loss,$162.00,$6606.00,$515872.25,331,$6606.00
2025-04-11,18:54:00,18780.75,SELL,3,0.02h,Break Even,$0.75,$6606.75,$515873.00,331,$6606.75
2025-04-11,18:55:00,18787.0,BUY,3,0.02h,Stop Loss,$158.25,$6765.00,$516031.25,331,$6765.00
2025-04-11,18:56:00,18773.0,SELL,3,0.02h,Stop Loss,$312.00,$7077.00,$516343.25,331,$7077.00
2025-04-11,19:04:00,18802.5,BUY,3,0.02h,Stop Loss,$154.50,$7231.50,$516497.75,331,$7231.50
2025-04-11,19:36:00,18810.0,SELL,3,0.02h,Break Even,$0.75,$7232.25,$516498.50,331,$7232.25
2025-04-11,19:45:00,18841.0,BUY,3,0.02h,Stop Loss,$34.50,$7266.75,$516533.00,331,$7266.75
2025-04-11,19:46:00,18815.0,SELL,3,0.02h,Stop Loss,$38.25,$7305.00,$516571.25,331,$7305.00
2025-04-11,19:48:00,18831.25,BUY,3,0.02h,Break Even,$0.75,$7305.75,$516572.00,331,$7305.75
2025-04-11,19:49:00,18812.0,SELL,3,0.02h,Stop Loss,$120.75,$7426.50,$516692.75,331,$7426.50
2025-04-11,19:56:00,18833.25,BUY,3,0.02h,Stop Loss,$173.25,$7599.75,$516866.00,331,$7599.75
2025-04-11,20:00:00,18808.75,SELL,3,0.02h,Stop Loss,$184.50,$7784.25,$517050.50,331,$7784.25
2025-04-11,20:18:00,18826.25,BUY,3,0.02h,Break Even,$0.75,$7785.00,$517051.25,331,$7785.00
2025-04-11,20:58:00,18810.75,SELL,3,0.02h,Stop Loss,$-18.00,$7767.00,$517033.25,331,$7767.00
,,,,,,,,,,,
2025-04-14,12:00:00,19072.0,BUY,3,0.02h,Stop Loss,$353.25,$353.25,$517386.50,332,$353.25
2025-04-14,13:34:00,19183.5,SELL,3,0.02h,Stop Loss,$124.50,$477.75,$517511.00,332,$477.75
2025-04-14,14:04:00,19135.0,BUY,3,0.02h,Stop Loss,$327.00,$804.75,$517838.00,332,$804.75
2025-04-14,14:16:00,19068.25,SELL,3,0.02h,Stop Loss,$267.00,$1071.75,$518105.00,332,$1071.75
2025-04-14,14:26:00,19105.75,BUY,3,0.02h,Stop Loss,$285.75,$1357.50,$518390.75,332,$1357.50
2025-04-14,14:59:00,19125.75,SELL,3,0.02h,Break Even,$0.75,$1358.25,$518391.50,332,$1358.25
2025-04-14,16:21:00,18858.0,BUY,3,0.02h,Stop Loss,$582.00,$1940.25,$518973.50,332,$1940.25
2025-04-14,16:28:00,18793.0,SELL,3,0.02h,Break Even,$0.75,$1941.00,$518974.25,332,$1941.00
2025-04-14,16:34:00,18869.75,BUY,3,0.02h,Stop Loss,$158.25,$2099.25,$519132.50,332,$2099.25
2025-04-14,16:52:00,18826.25,SELL,3,0.02h,Stop Loss,$139.50,$2238.75,$519272.00,332,$2238.75
2025-04-14,17:14:00,18852.5,BUY,3,0.02h,Stop Loss,$-18.00,$2220.75,$519254.00,332,$2220.75
2025-04-14,17:17:00,18815.25,SELL,3,0.02h,Break Even,$0.75,$2221.50,$519254.75,332,$2221.50
2025-04-14,17:19:00,18869.75,BUY,3,0.02h,Stop Loss,$45.75,$2267.25,$519300.50,332,$2267.25
2025-04-14,17:41:00,18856.5,SELL,3,0.02h,Stop Loss,$27.00,$2294.25,$519327.50,332,$2294.25
2025-04-14,17:43:00,18893.25,BUY,3,0.02h,Stop Loss,$45.75,$2340.00,$519373.25,332,$2340.00
2025-04-14,17:47:00,18857.75,SELL,3,0.02h,Stop Loss,$233.25,$2573.25,$519606.50,332,$2573.25
2025-04-14,17:51:00,18880.5,BUY,3,0.02h,Stop Loss,$244.50,$2817.75,$519851.00,332,$2817.75
2025-04-14,19:27:00,19034.75,SELL,3,0.02h,Stop Loss,$12.00,$2829.75,$519863.00,332,$2829.75
2025-04-14,19:41:00,19066.5,BUY,3,0.02h,Break Even,$0.75,$2830.50,$519863.75,332,$2830.50
2025-04-14,19:49:00,19022.5,SELL,3,0.02h,Stop Loss,$210.75,$3041.25,$520074.50,332,$3041.25
2025-04-14,20:39:00,18887.75,BUY,3,0.02h,Stop Loss,$139.50,$3180.75,$520214.00,332,$3180.75
2025-04-14,22:06:00,18881.75,SELL,3,0.02h,Stop Loss,$-18.00,$3162.75,$520196.00,332,$3162.75
2025-04-14,22:27:00,18885.5,BUY,3,0.02h,Stop Loss,$-18.00,$3144.75,$520178.00,332,$3144.75
2025-04-14,22:28:00,18877.25,SELL,3,0.02h,Stop Loss,$42.00,$3186.75,$520220.00,332,$3186.75
,,,,,,,,,,,
2025-04-15,12:01:00,18885.75,BUY,3,0.02h,Stop Loss,$132.00,$132.00,$520352.00,333,$132.00
2025-04-15,12:22:00,18863.5,SELL,3,0.02h,Stop Loss,$30.75,$162.75,$520382.75,333,$162.75
2025-04-15,12:38:00,18890.0,BUY,3,0.02h,Stop Loss,$79.50,$242.25,$520462.25,333,$242.25
2025-04-15,14:18:00,19049.75,SELL,3,0.02h,Stop Loss,$540.75,$783.00,$521003.00,333,$783.00
2025-04-15,14:44:00,19070.0,BUY,3,0.02h,Stop Loss,$68.25,$851.25,$521071.25,333,$851.25
2025-04-15,14:52:00,19023.25,SELL,3,0.02h,Stop Loss,$154.50,$1005.75,$521225.75,333,$1005.75
2025-04-15,14:55:00,19034.75,BUY,3,0.02h,Stop Loss,$162.00,$1167.75,$521387.75,333,$1167.75
2025-04-15,15:10:00,19030.75,SELL,3,0.02h,Stop Loss,$240.75,$1408.50,$521628.50,333,$1408.50
2025-04-15,15:11:00,19042.25,BUY,3,0.02h,Stop Loss,$83.25,$1491.75,$521711.75,333,$1491.75
2025-04-15,15:12:00,19016.5,SELL,3,0.02h,Break Even,$0.75,$1492.50,$521712.50,333,$1492.50
2025-04-15,15:13:00,19054.5,BUY,3,0.02h,Break Even,$0.75,$1493.25,$521713.25,333,$1493.25
2025-04-15,15:28:00,19029.75,SELL,3,0.02h,Stop Loss,$150.75,$1644.00,$521864.00,333,$1644.00
2025-04-15,15:55:00,19048.5,BUY,3,0.02h,Stop Loss,$-18.00,$1626.00,$521846.00,333,$1626.00
2025-04-15,16:38:00,19053.0,SELL,3,0.02h,Stop Loss,$113.25,$1739.25,$521959.25,333,$1739.25
2025-04-15,16:48:00,19069.0,BUY,3,0.02h,Stop Loss,$-18.00,$1721.25,$521941.25,333,$1721.25
2025-04-15,16:49:00,19052.25,SELL,3,0.02h,Stop Loss,$83.25,$1804.50,$522024.50,333,$1804.50
2025-04-15,17:40:00,18968.0,BUY,3,0.02h,Stop Loss,$248.25,$2052.75,$522272.75,333,$2052.75
2025-04-15,17:54:00,18920.25,SELL,3,0.02h,Stop Loss,$27.00,$2079.75,$522299.75,333,$2079.75
2025-04-15,18:32:00,18934.0,BUY,3,0.02h,Stop Loss,$132.00,$2211.75,$522431.75,333,$2211.75
2025-04-15,19:26:00,18955.0,SELL,3,0.02h,Stop Loss,$83.25,$2295.00,$522515.00,333,$2295.00
2025-04-15,19:53:00,18979.25,BUY,3,0.02h,Break Even,$0.75,$2295.75,$522515.75,333,$2295.75
2025-04-15,20:15:00,18960.25,SELL,3,0.02h,Stop Loss,$27.00,$2322.75,$522542.75,333,$2322.75
2025-04-15,22:33:00,18776.25,BUY,3,0.02h,Stop Loss,$-18.00,$2304.75,$522524.75,333,$2304.75
2025-04-15,22:51:00,18752.75,SELL,3,0.02h,Stop Loss,$53.25,$2358.00,$522578.00,333,$2358.00
,,,,,,,,,,,
2025-04-16,13:33:00,18644.5,BUY,3,0.02h,Stop Loss,$184.50,$184.50,$522762.50,334,$184.50
2025-04-16,13:47:00,18599.25,SELL,3,0.02h,Stop Loss,$83.25,$267.75,$522845.75,334,$267.75
2025-04-16,14:11:00,18596.75,BUY,3,0.02h,Stop Loss,$12.00,$279.75,$522857.75,334,$279.75
2025-04-16,14:15:00,18552.0,SELL,3,0.02h,Stop Loss,$38.25,$318.00,$522896.00,334,$318.00
2025-04-16,14:23:00,18592.0,BUY,3,0.02h,Stop Loss,$12.00,$330.00,$522908.00,334,$330.00
2025-04-16,14:57:00,18601.25,SELL,3,0.02h,Stop Loss,$-18.00,$312.00,$522890.00,334,$312.00
2025-04-16,15:01:00,18639.75,BUY,3,0.02h,Stop Loss,$23.25,$335.25,$522913.25,334,$335.25
2025-04-16,15:03:00,18614.25,SELL,3,0.02h,Stop Loss,$72.00,$407.25,$522985.25,334,$407.25
2025-04-16,15:11:00,18626.25,BUY,3,0.02h,Stop Loss,$120.75,$528.00,$523106.00,334,$528.00
2025-04-16,15:17:00,18613.5,SELL,3,0.02h,Break Even,$0.75,$528.75,$523106.75,334,$528.75
2025-04-16,15:23:00,18663.75,BUY,3,0.02h,Stop Loss,$128.25,$657.00,$523235.00,334,$657.00
2025-04-16,15:43:00,18654.75,SELL,3,0.02h,Stop Loss,$128.25,$785.25,$523363.25,334,$785.25
2025-04-16,16:27:00,18602.5,BUY,3,0.02h,Break Even,$0.75,$786.00,$523364.00,334,$786.00
2025-04-16,16:38:00,18573.5,SELL,3,0.02h,Stop Loss,$72.00,$858.00,$523436.00,334,$858.00
2025-04-16,17:19:00,18576.75,BUY,3,0.02h,Stop Loss,$102.00,$960.00,$523538.00,334,$960.00
2025-04-16,17:32:00,18485.5,SELL,3,0.02h,Stop Loss,$214.50,$1174.50,$523752.50,334,$1174.50
2025-04-16,18:25:00,18363.5,BUY,3,0.02h,Stop Loss,$15.75,$1190.25,$523768.25,334,$1190.25
2025-04-16,18:33:00,18339.25,SELL,3,0.02h,Stop Loss,$147.00,$1337.25,$523915.25,334,$1337.25
2025-04-16,19:35:00,18192.5,BUY,3,0.02h,Stop Loss,$162.00,$1499.25,$524077.25,334,$1499.25
2025-04-16,20:43:00,18401.75,SELL,3,0.02h,Stop Loss,$45.75,$1545.00,$524123.00,334,$1545.00
2025-04-16,22:03:00,18418.5,BUY,3,0.02h,Stop Loss,$49.50,$1594.50,$524172.50,334,$1594.50
2025-04-16,22:17:00,18374.0,SELL,3,0.02h,Break Even,$0.75,$1595.25,$524173.25,334,$1595.25
2025-04-16,22:30:00,18400.5,BUY,3,0.02h,Stop Loss,$34.50,$1629.75,$524207.75,334,$1629.75
,,,,,,,,,,,
2025-04-17,12:47:00,18537.75,SELL,3,0.02h,Stop Loss,$49.50,$49.50,$524257.25,335,$49.50
2025-04-17,12:50:00,18553.25,BUY,3,0.02h,Stop Loss,$102.00,$151.50,$524359.25,335,$151.50
2025-04-17,12:57:00,18535.25,SELL,3,0.02h,Stop Loss,$90.75,$242.25,$524450.00,335,$242.25
2025-04-17,13:22:00,18528.25,BUY,3,0.02h,Stop Loss,$158.25,$400.50,$524608.25,335,$400.50
2025-04-17,13:28:00,18486.25,SELL,3,0.02h,Stop Loss,$-18.00,$382.50,$524590.25,335,$382.50
2025-04-17,13:53:00,18485.75,BUY,3,0.02h,Stop Loss,$102.00,$484.50,$524692.25,335,$484.50
2025-04-17,14:07:00,18424.5,SELL,3,0.02h,Stop Loss,$567.00,$1051.50,$525259.25,335,$1051.50
2025-04-17,14:47:00,18355.0,BUY,3,0.02h,Stop Loss,$60.75,$1112.25,$525320.00,335,$1112.25
2025-04-17,14:53:00,18315.0,SELL,3,0.02h,Stop Loss,$19.50,$1131.75,$525339.50,335,$1131.75
2025-04-17,15:07:00,18389.0,BUY,3,0.02h,Stop Loss,$402.00,$1533.75,$525741.50,335,$1533.75
2025-04-17,15:29:00,18341.75,SELL,3,0.02h,Stop Loss,$154.50,$1688.25,$525896.00,335,$1688.25
2025-04-17,15:38:00,18416.75,BUY,3,0.02h,Stop Loss,$30.75,$1719.00,$525926.75,335,$1719.00
2025-04-17,15:44:00,18371.0,SELL,3,0.02h,Stop Loss,$199.50,$1918.50,$526126.25,335,$1918.50
2025-04-17,16:08:00,18398.75,BUY,3,0.02h,Stop Loss,$443.25,$2361.75,$526569.50,335,$2361.75
2025-04-17,16:43:00,18412.75,SELL,3,0.02h,Stop Loss,$432.00,$2793.75,$527001.50,335,$2793.75
2025-04-17,16:53:00,18452.25,BUY,3,0.02h,Stop Loss,$68.25,$2862.00,$527069.75,335,$2862.00
2025-04-17,17:12:00,18427.0,SELL,3,0.02h,Stop Loss,$68.25,$2930.25,$527138.00,335,$2930.25
2025-04-17,17:37:00,18421.25,BUY,3,0.02h,Break Even,$0.75,$2931.00,$527138.75,335,$2931.00
2025-04-17,17:44:00,18398.5,SELL,3,0.02h,Break Even,$0.75,$2931.75,$527139.50,335,$2931.75
2025-04-17,17:45:00,18410.25,BUY,3,0.02h,Stop Loss,$180.75,$3112.50,$527320.25,335,$3112.50
2025-04-17,18:43:00,18484.75,SELL,3,0.02h,Break Even,$0.75,$3113.25,$527321.00,335,$3113.25
2025-04-17,19:36:00,18398.5,BUY,3,0.02h,Stop Loss,$147.00,$3260.25,$527468.00,335,$3260.25
2025-04-17,19:47:00,18380.0,SELL,3,0.02h,Stop Loss,$173.25,$3433.50,$527641.25,335,$3433.50
2025-04-17,20:02:00,18408.25,BUY,3,0.02h,Break Even,$0.75,$3434.25,$527642.00,335,$3434.25
2025-04-17,20:32:00,18404.5,SELL,3,0.02h,Stop Loss,$30.75,$3465.00,$527672.75,335,$3465.00
2025-04-17,20:37:00,18410.5,BUY,3,0.02h,Stop Loss,$30.75,$3495.75,$527703.50,335,$3495.75
,,,,,,,,,,,
2025-04-21,12:00:00,18106.0,SELL,3,0.02h,Stop Loss,$75.75,$75.75,$527779.25,336,$75.75
2025-04-21,12:41:00,18138.0,BUY,3,0.02h,Break Even,$0.75,$76.50,$527780.00,336,$76.50
2025-04-21,12:48:00,18122.5,SELL,3,0.02h,Break Even,$0.75,$77.25,$527780.75,336,$77.25
2025-04-21,12:51:00,18131.75,BUY,3,0.02h,Stop Loss,$-18.00,$59.25,$527762.75,336,$59.25
2025-04-21,12:52:00,18123.25,SELL,3,0.02h,Stop Loss,$57.00,$116.25,$527819.75,336,$116.25
2025-04-21,13:29:00,18118.75,BUY,3,0.02h,Stop Loss,$113.25,$229.50,$527933.00,336,$229.50
2025-04-21,13:39:00,18090.0,SELL,3,0.02h,Stop Loss,$109.50,$339.00,$528042.50,336,$339.00
2025-04-21,14:38:00,17963.5,BUY,3,0.02h,Break Even,$0.75,$339.75,$528043.25,336,$339.75
2025-04-21,14:48:00,17925.25,SELL,3,0.02h,Stop Loss,$94.50,$434.25,$528137.75,336,$434.25
2025-04-21,16:07:00,17826.0,BUY,3,0.02h,Stop Loss,$-18.00,$416.25,$528119.75,336,$416.25
2025-04-21,16:28:00,17812.5,SELL,3,0.02h,Stop Loss,$79.50,$495.75,$528199.25,336,$495.75
2025-04-21,16:32:00,17836.25,BUY,3,0.02h,Stop Loss,$162.00,$657.75,$528361.25,336,$657.75
2025-04-21,16:51:00,17829.0,SELL,3,0.02h,Stop Loss,$87.00,$744.75,$528448.25,336,$744.75
2025-04-21,18:14:00,17725.0,BUY,3,0.02h,Stop Loss,$87.00,$831.75,$528535.25,336,$831.75
2025-04-21,18:43:00,17733.5,SELL,3,0.02h,Stop Loss,$34.50,$866.25,$528569.75,336,$866.25
2025-04-21,19:03:00,17745.25,BUY,3,0.02h,Stop Loss,$19.50,$885.75,$528589.25,336,$885.75
2025-04-21,22:02:00,17903.25,SELL,3,0.02h,Stop Loss,$75.75,$961.50,$528665.00,336,$961.50
2025-04-21,22:36:00,17898.75,BUY,3,0.02h,Stop Loss,$128.25,$1089.75,$528793.25,336,$1089.75
2025-04-21,22:57:00,17896.5,SELL,3,0.02h,Break Even,$0.75,$1090.50,$528794.00,336,$1090.50
,,,,,,,,,,,
2025-04-22,12:00:00,18055.25,BUY,3,0.02h,Stop Loss,$124.50,$124.50,$528918.50,337,$124.50
2025-04-22,13:35:00,18111.25,SELL,3,0.02h,Stop Loss,$117.00,$241.50,$529035.50,337,$241.50
2025-04-22,13:40:00,18153.0,BUY,3,0.02h,Stop Loss,$177.00,$418.50,$529212.50,337,$418.50
2025-04-22,15:30:00,18352.0,SELL,3,0.02h,Stop Loss,$158.25,$576.75,$529370.75,337,$576.75
2025-04-22,16:00:00,18379.0,BUY,3,0.02h,Stop Loss,$818.25,$1395.00,$530189.00,337,$1395.00
2025-04-22,16:42:00,18451.25,SELL,3,0.02h,Break Even,$0.75,$1395.75,$530189.75,337,$1395.75
2025-04-22,17:09:00,18480.75,BUY,3,0.02h,Stop Loss,$135.75,$1531.50,$530325.50,337,$1531.50
2025-04-22,17:11:00,18415.0,SELL,3,0.02h,Stop Loss,$484.50,$2016.00,$530810.00,337,$2016.00
2025-04-22,18:06:00,18295.25,BUY,3,0.02h,Stop Loss,$132.00,$2148.00,$530942.00,337,$2148.00
2025-04-22,19:09:00,18365.0,SELL,3,0.02h,Stop Loss,$42.00,$2190.00,$530984.00,337,$2190.00
2025-04-22,19:45:00,18324.25,BUY,3,0.02h,Stop Loss,$304.50,$2494.50,$531288.50,337,$2494.50
2025-04-22,20:19:00,18359.25,SELL,3,0.02h,Stop Loss,$79.50,$2574.00,$531368.00,337,$2574.00
2025-04-22,20:28:00,18367.25,BUY,3,0.02h,Break Even,$0.75,$2574.75,$531368.75,337,$2574.75
2025-04-22,20:47:00,18361.75,SELL,3,0.02h,Break Even,$0.75,$2575.50,$531369.50,337,$2575.50
2025-04-22,22:01:00,18684.0,BUY,3,0.02h,Stop Loss,$334.50,$2910.00,$531704.00,337,$2910.00
,,,,,,,,,,,
2025-04-23,13:07:00,18926.5,SELL,3,0.02h,Stop Loss,$19.50,$19.50,$531723.50,338,$19.50
2025-04-23,13:22:00,18945.0,BUY,3,0.02h,Stop Loss,$38.25,$57.75,$531761.75,338,$57.75
2025-04-23,14:18:00,18996.0,SELL,3,0.02h,Stop Loss,$210.75,$268.50,$531972.50,338,$268.50
2025-04-23,14:26:00,19076.25,BUY,3,0.02h,Stop Loss,$405.75,$674.25,$532378.25,338,$674.25
2025-04-23,14:51:00,19076.5,SELL,3,0.02h,Stop Loss,$23.25,$697.50,$532401.50,338,$697.50
2025-04-23,16:32:00,18842.0,BUY,3,0.02h,Stop Loss,$-18.00,$679.50,$532383.50,338,$679.50
2025-04-23,17:33:00,18925.25,SELL,3,0.02h,Stop Loss,$267.00,$946.50,$532650.50,338,$946.50
2025-04-23,17:55:00,18925.5,BUY,3,0.02h,Stop Loss,$94.50,$1041.00,$532745.00,338,$1041.00
2025-04-23,18:26:00,18893.75,SELL,3,0.02h,Stop Loss,$162.00,$1203.00,$532907.00,338,$1203.00
2025-04-23,18:59:00,18896.75,BUY,3,0.02h,Break Even,$0.75,$1203.75,$532907.75,338,$1203.75
2025-04-23,19:00:00,18869.75,SELL,3,0.02h,Stop Loss,$98.25,$1302.00,$533006.00,338,$1302.00
2025-04-23,19:51:00,18824.25,BUY,3,0.02h,Break Even,$0.75,$1302.75,$533006.75,338,$1302.75
2025-04-23,20:04:00,18779.0,SELL,3,0.02h,Stop Loss,$-18.00,$1284.75,$532988.75,338,$1284.75
2025-04-23,20:11:00,18812.0,BUY,3,0.02h,Stop Loss,$60.75,$1345.50,$533049.50,338,$1345.50
2025-04-23,20:45:00,18850.75,SELL,3,0.02h,Break Even,$0.75,$1346.25,$533050.25,338,$1346.25
2025-04-23,22:32:00,18781.0,BUY,3,0.02h,Stop Loss,$87.00,$1433.25,$533137.25,338,$1433.25
,,,,,,,,,,,
2025-04-24,12:00:00,18770.0,SELL,3,0.02h,Break Even,$0.75,$0.75,$533138.00,339,$0.75
2025-04-24,12:16:00,18813.25,BUY,3,0.02h,Break Even,$0.75,$1.50,$533138.75,339,$1.50
2025-04-24,12:29:00,18796.25,SELL,3,0.02h,Stop Loss,$75.75,$77.25,$533214.50,339,$77.25
2025-04-24,12:32:00,18823.0,BUY,3,0.02h,Stop Loss,$53.25,$130.50,$533267.75,339,$130.50
2025-04-24,12:34:00,18799.0,SELL,3,0.02h,Stop Loss,$-18.00,$112.50,$533249.75,339,$112.50
2025-04-24,12:35:00,18816.0,BUY,3,0.02h,Stop Loss,$49.50,$162.00,$533299.25,339,$162.00
2025-04-24,13:07:00,18829.0,SELL,3,0.02h,Stop Loss,$38.25,$200.25,$533337.50,339,$200.25
2025-04-24,13:20:00,18840.0,BUY,3,0.02h,Stop Loss,$-18.00,$182.25,$533319.50,339,$182.25
2025-04-24,14:48:00,19097.5,SELL,3,0.02h,Stop Loss,$102.00,$284.25,$533421.50,339,$284.25
2025-04-24,14:57:00,19143.25,BUY,3,0.02h,Stop Loss,$27.00,$311.25,$533448.50,339,$311.25
2025-04-24,15:26:00,19154.0,SELL,3,0.02h,Stop Loss,$-18.00,$293.25,$533430.50,339,$293.25
2025-04-24,15:39:00,19176.0,BUY,3,0.02h,Break Even,$0.75,$294.00,$533431.25,339,$294.00
2025-04-24,15:45:00,19153.0,SELL,3,0.02h,Stop Loss,$83.25,$377.25,$533514.50,339,$377.25
2025-04-24,15:50:00,19173.75,BUY,3,0.02h,Break Even,$0.75,$378.00,$533515.25,339,$378.00
2025-04-24,16:02:00,19158.75,SELL,3,0.02h,Stop Loss,$132.00,$510.00,$533647.25,339,$510.00
2025-04-24,16:14:00,19185.25,BUY,3,0.02h,Stop Loss,$68.25,$578.25,$533715.50,339,$578.25
2025-04-24,17:17:00,19226.75,SELL,3,0.02h,Stop Loss,$158.25,$736.50,$533873.75,339,$736.50
2025-04-24,17:27:00,19255.0,BUY,3,0.02h,Stop Loss,$57.00,$793.50,$533930.75,339,$793.50
2025-04-24,17:38:00,19242.0,SELL,3,0.02h,Stop Loss,$-18.00,$775.50,$533912.75,339,$775.50
2025-04-24,17:39:00,19249.25,BUY,3,0.02h,Stop Loss,$-18.00,$757.50,$533894.75,339,$757.50
2025-04-24,17:41:00,19237.25,SELL,3,0.02h,Stop Loss,$169.50,$927.00,$534064.25,339,$927.00
2025-04-24,17:51:00,19247.25,BUY,3,0.02h,Stop Loss,$19.50,$946.50,$534083.75,339,$946.50
2025-04-24,19:00:00,19292.5,SELL,3,0.02h,Stop Loss,$143.25,$1089.75,$534227.00,339,$1089.75
2025-04-24,19:38:00,19274.25,BUY,3,0.02h,Stop Loss,$60.75,$1150.50,$534287.75,339,$1150.50
2025-04-24,20:20:00,19333.25,SELL,3,0.02h,Stop Loss,$30.75,$1181.25,$534318.50,339,$1181.25
2025-04-24,20:27:00,19344.75,BUY,3,0.02h,Stop Loss,$57.00,$1238.25,$534375.50,339,$1238.25
2025-04-24,20:31:00,19327.0,SELL,3,0.02h,Stop Loss,$-18.00,$1220.25,$534357.50,339,$1220.25
2025-04-24,20:36:00,19346.0,BUY,3,0.02h,Stop Loss,$12.00,$1232.25,$534369.50,339,$1232.25
2025-04-24,20:58:00,19349.0,SELL,3,0.02h,Break Even,$0.75,$1233.00,$534370.25,339,$1233.00
2025-04-24,22:01:00,19379.0,BUY,3,0.02h,Stop Loss,$30.75,$1263.75,$534401.00,339,$1263.75
2025-04-24,22:58:00,19402.75,SELL,3,0.02h,Stop Loss,$57.00,$1320.75,$534458.00,339,$1320.75
,,,,,,,,,,,
2025-04-25,12:38:00,19278.75,BUY,3,0.02h,Stop Loss,$90.75,$90.75,$534548.75,340,$90.75
2025-04-25,12:46:00,19270.25,SELL,3,0.02h,Stop Loss,$128.25,$219.00,$534677.00,340,$219.00
2025-04-25,13:10:00,19258.5,BUY,3,0.02h,Stop Loss,$15.75,$234.75,$534692.75,340,$234.75
2025-04-25,13:48:00,19275.5,SELL,3,0.02h,Stop Loss,$15.75,$250.50,$534708.50,340,$250.50
2025-04-25,14:02:00,19321.25,BUY,3,0.02h,Stop Loss,$274.50,$525.00,$534983.00,340,$525.00
2025-04-25,14:23:00,19271.5,SELL,3,0.02h,Stop Loss,$233.25,$758.25,$535216.25,340,$758.25
2025-04-25,14:40:00,19331.5,BUY,3,0.02h,Stop Loss,$334.50,$1092.75,$535550.75,340,$1092.75
2025-04-25,14:59:00,19308.5,SELL,3,0.02h,Break Even,$0.75,$1093.50,$535551.50,340,$1093.50
2025-04-25,15:05:00,19347.0,BUY,3,0.02h,Stop Loss,$113.25,$1206.75,$535664.75,340,$1206.75
2025-04-25,15:33:00,19356.5,SELL,3,0.02h,Stop Loss,$57.00,$1263.75,$535721.75,340,$1263.75
2025-04-25,15:53:00,19360.0,BUY,3,0.02h,Stop Loss,$-18.00,$1245.75,$535703.75,340,$1245.75
2025-04-25,17:39:00,19472.0,SELL,3,0.02h,Stop Loss,$390.75,$1636.50,$536094.50,340,$1636.50
2025-04-25,18:07:00,19458.5,BUY,3,0.02h,Stop Loss,$15.75,$1652.25,$536110.25,340,$1652.25
2025-04-25,19:00:00,19499.75,SELL,3,0.02h,Stop Loss,$49.50,$1701.75,$536159.75,340,$1701.75
2025-04-25,19:03:00,19512.5,BUY,3,0.02h,Stop Loss,$109.50,$1811.25,$536269.25,340,$1811.25
2025-04-25,19:12:00,19493.25,SELL,3,0.02h,Break Even,$0.75,$1812.00,$536270.00,340,$1812.00
2025-04-25,19:24:00,19509.25,BUY,3,0.02h,Stop Loss,$30.75,$1842.75,$536300.75,340,$1842.75
2025-04-25,19:29:00,19488.75,SELL,3,0.02h,Stop Loss,$45.75,$1888.50,$536346.50,340,$1888.50
2025-04-25,19:51:00,19511.75,BUY,3,0.02h,Stop Loss,$-18.00,$1870.50,$536328.50,340,$1870.50
2025-04-25,20:45:00,19542.75,SELL,3,0.02h,Break Even,$0.75,$1871.25,$536329.25,340,$1871.25
2025-04-25,21:00:00,19554.75,BUY,3,63.00h,Stop Loss,$-18.00,$1853.25,$536311.25,340,$1853.25
,,,,,,,,,,,
2025-04-28,12:00:00,19514.0,SELL,3,0.02h,Stop Loss,$15.75,$15.75,$536327.00,341,$15.75
2025-04-28,12:27:00,19509.25,BUY,3,0.02h,Stop Loss,$-18.00,$-2.25,$536309.00,341,$-2.25
2025-04-28,13:32:00,19541.25,SELL,3,0.02h,Stop Loss,$19.50,$17.25,$536328.50,341,$17.25
2025-04-28,13:44:00,19580.5,BUY,3,0.02h,Stop Loss,$229.50,$246.75,$536558.00,341,$246.75
2025-04-28,13:56:00,19518.5,SELL,3,0.02h,Stop Loss,$124.50,$371.25,$536682.50,341,$371.25
2025-04-28,14:25:00,19536.0,BUY,3,0.02h,Break Even,$0.75,$372.00,$536683.25,341,$372.00
2025-04-28,14:28:00,19503.75,SELL,3,0.02h,Stop Loss,$150.75,$522.75,$536834.00,341,$522.75
2025-04-28,14:39:00,19521.75,BUY,3,0.02h,Stop Loss,$15.75,$538.50,$536849.75,341,$538.50
2025-04-28,14:54:00,19485.5,SELL,3,0.02h,Break Even,$0.75,$539.25,$536850.50,341,$539.25
2025-04-28,15:43:00,19384.75,BUY,3,0.02h,Break Even,$0.75,$540.00,$536851.25,341,$540.00
2025-04-28,15:45:00,19352.25,SELL,3,0.02h,Stop Loss,$53.25,$593.25,$536904.50,341,$593.25
2025-04-28,16:36:00,19321.5,BUY,3,0.02h,Stop Loss,$72.00,$665.25,$536976.50,341,$665.25
2025-04-28,16:56:00,19303.25,SELL,3,0.02h,Stop Loss,$117.00,$782.25,$537093.50,341,$782.25
2025-04-28,17:02:00,19331.25,BUY,3,0.02h,Stop Loss,$-18.00,$764.25,$537075.50,341,$764.25
2025-04-28,17:03:00,19313.5,SELL,3,0.02h,Break Even,$0.75,$765.00,$537076.25,341,$765.00
2025-04-28,17:04:00,19325.5,BUY,3,0.02h,Stop Loss,$68.25,$833.25,$537144.50,341,$833.25
2025-04-28,17:05:00,19316.0,SELL,3,0.02h,Stop Loss,$79.50,$912.75,$537224.00,341,$912.75
2025-04-28,17:40:00,19305.25,BUY,3,0.02h,Stop Loss,$105.75,$1018.50,$537329.75,341,$1018.50
2025-04-28,20:02:00,19501.75,SELL,3,0.02h,Stop Loss,$38.25,$1056.75,$537368.00,341,$1056.75
2025-04-28,22:10:00,19487.5,BUY,3,0.02h,Break Even,$0.75,$1057.50,$537368.75,341,$1057.50
2025-04-28,22:14:00,19467.25,SELL,3,0.02h,Stop Loss,$-18.00,$1039.50,$537350.75,341,$1039.50
2025-04-28,22:32:00,19478.75,BUY,3,0.02h,Stop Loss,$113.25,$1152.75,$537464.00,341,$1152.75
2025-04-28,22:43:00,19464.5,SELL,3,0.02h,Stop Loss,$-18.00,$1134.75,$537446.00,341,$1134.75
2025-04-28,22:51:00,19482.0,BUY,3,0.02h,Break Even,$0.75,$1135.50,$537446.75,341,$1135.50
,,,,,,,,,,,
2025-04-29,12:19:00,19488.5,SELL,3,0.02h,Stop Loss,$132.00,$132.00,$537578.75,342,$132.00
2025-04-29,12:32:00,19490.25,BUY,3,0.02h,Break Even,$0.75,$132.75,$537579.50,342,$132.75
2025-04-29,12:55:00,19497.5,SELL,3,0.02h,Stop Loss,$113.25,$246.00,$537692.75,342,$246.00
2025-04-29,13:30:00,19427.25,BUY,3,0.02h,Stop Loss,$195.75,$441.75,$537888.50,342,$441.75
2025-04-29,14:22:00,19500.5,SELL,3,0.02h,Stop Loss,$57.00,$498.75,$537945.50,342,$498.75
2025-04-29,14:36:00,19556.0,BUY,3,0.02h,Stop Loss,$124.50,$623.25,$538070.00,342,$623.25
2025-04-29,15:13:00,19565.0,SELL,3,0.02h,Stop Loss,$244.50,$867.75,$538314.50,342,$867.75
2025-04-29,15:42:00,19555.0,BUY,3,0.02h,Stop Loss,$207.00,$1074.75,$538521.50,342,$1074.75
2025-04-29,15:58:00,19539.25,SELL,3,0.02h,Break Even,$0.75,$1075.50,$538522.25,342,$1075.50
2025-04-29,16:04:00,19579.5,BUY,3,0.02h,Break Even,$0.75,$1076.25,$538523.00,342,$1076.25
2025-04-29,16:20:00,19556.5,SELL,3,0.02h,Stop Loss,$90.75,$1167.00,$538613.75,342,$1167.00
2025-04-29,16:37:00,19581.25,BUY,3,0.02h,Stop Loss,$-18.00,$1149.00,$538595.75,342,$1149.00
2025-04-29,16:39:00,19550.0,SELL,3,0.02h,Stop Loss,$27.00,$1176.00,$538622.75,342,$1176.00
2025-04-29,16:43:00,19577.0,BUY,3,0.02h,Stop Loss,$34.50,$1210.50,$538657.25,342,$1210.50
2025-04-29,16:47:00,19547.5,SELL,3,0.02h,Stop Loss,$214.50,$1425.00,$538871.75,342,$1425.00
2025-04-29,17:18:00,19542.25,BUY,3,0.02h,Stop Loss,$105.75,$1530.75,$538977.50,342,$1530.75
2025-04-29,18:23:00,19644.0,SELL,3,0.02h,Stop Loss,$-18.00,$1512.75,$538959.50,342,$1512.75
2025-04-29,18:26:00,19663.5,BUY,3,0.02h,Stop Loss,$15.75,$1528.50,$538975.25,342,$1528.50
2025-04-29,18:27:00,19656.0,SELL,3,0.02h,Stop Loss,$-18.00,$1510.50,$538957.25,342,$1510.50
2025-04-29,18:28:00,19670.25,BUY,3,0.02h,Stop Loss,$203.25,$1713.75,$539160.50,342,$1713.75
2025-04-29,18:49:00,19665.25,SELL,3,0.02h,Stop Loss,$23.25,$1737.00,$539183.75,342,$1737.00
2025-04-29,19:12:00,19671.0,BUY,3,0.02h,Stop Loss,$-18.00,$1719.00,$539165.75,342,$1719.00
2025-04-29,19:16:00,19643.25,SELL,3,0.02h,Break Even,$0.75,$1719.75,$539166.50,342,$1719.75
2025-04-29,19:34:00,19657.25,BUY,3,0.02h,Break Even,$0.75,$1720.50,$539167.25,342,$1720.50
2025-04-29,19:37:00,19641.75,SELL,3,0.02h,Stop Loss,$64.50,$1785.00,$539231.75,342,$1785.00
2025-04-29,19:50:00,19663.0,BUY,3,0.02h,Stop Loss,$237.00,$2022.00,$539468.75,342,$2022.00
2025-04-29,20:04:00,19645.0,SELL,3,0.02h,Stop Loss,$53.25,$2075.25,$539522.00,342,$2075.25
2025-04-29,20:27:00,19639.25,BUY,3,0.02h,Stop Loss,$-18.00,$2057.25,$539504.00,342,$2057.25
2025-04-29,20:29:00,19620.0,SELL,3,0.02h,Stop Loss,$75.75,$2133.00,$539579.75,342,$2133.00
2025-04-29,20:57:00,19617.25,BUY,3,0.02h,Stop Loss,$53.25,$2186.25,$539633.00,342,$2186.25
2025-04-29,22:02:00,19580.5,SELL,3,0.02h,Stop Loss,$-18.00,$2168.25,$539615.00,342,$2168.25
2025-04-29,22:15:00,19603.5,BUY,3,0.02h,Break Even,$0.75,$2169.00,$539615.75,342,$2169.00
2025-04-29,22:23:00,19585.0,SELL,3,0.02h,Break Even,$0.75,$2169.75,$539616.50,342,$2169.75
,,,,,,,,,,,
2025-04-30,13:24:00,19280.25,BUY,3,0.02h,Break Even,$0.75,$0.75,$539617.25,343,$0.75
2025-04-30,13:32:00,19242.0,SELL,3,0.02h,Stop Loss,$45.75,$46.50,$539663.00,343,$46.50
2025-04-30,13:35:00,19295.5,BUY,3,0.02h,Stop Loss,$72.00,$118.50,$539735.00,343,$118.50
2025-04-30,13:37:00,19256.75,SELL,3,0.02h,Stop Loss,$585.75,$704.25,$540320.75,343,$704.25
2025-04-30,14:09:00,19200.0,BUY,3,0.02h,Stop Loss,$327.00,$1031.25,$540647.75,343,$1031.25
2025-04-30,16:14:00,19421.0,SELL,3,0.02h,Break Even,$0.75,$1032.00,$540648.50,343,$1032.00
2025-04-30,16:40:00,19426.75,BUY,3,0.02h,Stop Loss,$105.75,$1137.75,$540754.25,343,$1137.75
2025-04-30,17:07:00,19403.25,SELL,3,0.02h,Stop Loss,$23.25,$1161.00,$540777.50,343,$1161.00
2025-04-30,17:25:00,19405.0,BUY,3,0.02h,Stop Loss,$165.75,$1326.75,$540943.25,343,$1326.75
2025-04-30,18:02:00,19465.75,SELL,3,0.02h,Stop Loss,$98.25,$1425.00,$541041.50,343,$1425.00
2025-04-30,18:08:00,19528.75,BUY,3,0.02h,Stop Loss,$68.25,$1493.25,$541109.75,343,$1493.25
2025-04-30,18:30:00,19494.75,SELL,3,0.02h,Stop Loss,$68.25,$1561.50,$541178.00,343,$1561.50
2025-04-30,18:50:00,19515.25,BUY,3,0.02h,Stop Loss,$150.75,$1712.25,$541328.75,343,$1712.25
2025-04-30,18:59:00,19482.5,SELL,3,0.02h,Stop Loss,$124.50,$1836.75,$541453.25,343,$1836.75
2025-04-30,19:04:00,19504.0,BUY,3,0.02h,Break Even,$0.75,$1837.50,$541454.00,343,$1837.50
2025-04-30,19:26:00,19481.75,SELL,3,0.02h,Stop Loss,$79.50,$1917.00,$541533.50,343,$1917.00
2025-04-30,19:39:00,19513.75,BUY,3,0.02h,Break Even,$0.75,$1917.75,$541534.25,343,$1917.75
2025-04-30,22:29:00,19890.0,SELL,3,0.02h,Stop Loss,$27.00,$1944.75,$541561.25,343,$1944.75
2025-04-30,22:32:00,19913.0,BUY,3,0.02h,Stop Loss,$-18.00,$1926.75,$541543.25,343,$1926.75
2025-04-30,22:40:00,19894.25,SELL,3,0.02h,Stop Loss,$60.75,$1987.50,$541604.00,343,$1987.50
2025-04-30,22:58:00,19899.5,BUY,3,0.02h,Stop Loss,$15.75,$2003.25,$541619.75,343,$2003.25
,,,,,,,,,,,
2025-05-01,12:29:00,19990.0,SELL,3,0.02h,Break Even,$0.75,$0.75,$541620.50,344,$0.75
2025-05-01,13:12:00,19981.0,BUY,3,0.02h,Break Even,$0.75,$1.50,$541621.25,344,$1.50
2025-05-01,13:32:00,19921.75,SELL,3,0.02h,Stop Loss,$83.25,$84.75,$541704.50,344,$84.75
2025-05-01,13:49:00,19979.75,BUY,3,0.02h,Break Even,$0.75,$85.50,$541705.25,344,$85.50
2025-05-01,13:57:00,19932.75,SELL,3,0.02h,Stop Loss,$244.50,$330.00,$541949.75,344,$330.00
2025-05-01,14:18:00,19956.0,BUY,3,0.02h,Break Even,$0.75,$330.75,$541950.50,344,$330.75
2025-05-01,15:30:00,20077.5,SELL,3,0.02h,Stop Loss,$177.00,$507.75,$542127.50,344,$507.75
2025-05-01,16:32:00,19974.0,BUY,3,0.02h,Break Even,$0.75,$508.50,$542128.25,344,$508.50
2025-05-01,16:44:00,19961.25,SELL,3,0.02h,Break Even,$0.75,$509.25,$542129.00,344,$509.25
2025-05-01,17:03:00,19984.25,BUY,3,0.02h,Stop Loss,$75.75,$585.00,$542204.75,344,$585.00
2025-05-01,17:31:00,19999.25,SELL,3,0.02h,Stop Loss,$19.50,$604.50,$542224.25,344,$604.50
2025-05-01,17:37:00,20012.25,BUY,3,0.02h,Stop Loss,$-18.00,$586.50,$542206.25,344,$586.50
2025-05-01,17:39:00,19998.75,SELL,3,0.02h,Stop Loss,$94.50,$681.00,$542300.75,344,$681.00
2025-05-01,18:01:00,19982.75,BUY,3,0.02h,Stop Loss,$143.25,$824.25,$542444.00,344,$824.25
2025-05-01,18:27:00,19993.5,SELL,3,0.02h,Stop Loss,$30.75,$855.00,$542474.75,344,$855.00
2025-05-01,18:32:00,20028.75,BUY,3,0.02h,Stop Loss,$-18.00,$837.00,$542456.75,344,$837.00
2025-05-01,18:55:00,20012.25,SELL,3,0.02h,Stop Loss,$12.00,$849.00,$542468.75,344,$849.00
2025-05-01,19:20:00,20013.5,BUY,3,0.02h,Stop Loss,$79.50,$928.50,$542548.25,344,$928.50
2025-05-01,19:37:00,19997.0,SELL,3,0.02h,Stop Loss,$-18.00,$910.50,$542530.25,344,$910.50
2025-05-01,19:50:00,20008.75,BUY,3,0.02h,Stop Loss,$207.00,$1117.50,$542737.25,344,$1117.50
2025-05-01,19:51:00,19966.5,SELL,3,0.02h,Stop Loss,$327.00,$1444.50,$543064.25,344,$1444.50
2025-05-01,20:24:00,19852.25,BUY,3,0.02h,Break Even,$0.75,$1445.25,$543065.00,344,$1445.25
2025-05-01,20:28:00,19834.25,SELL,3,0.02h,Stop Loss,$90.75,$1536.00,$543155.75,344,$1536.00
2025-05-01,22:17:00,19794.75,BUY,3,0.02h,Break Even,$0.75,$1536.75,$543156.50,344,$1536.75
2025-05-01,22:32:00,19776.25,SELL,3,0.02h,Stop Loss,$-18.00,$1518.75,$543138.50,344,$1518.75
2025-05-01,22:36:00,19788.0,BUY,3,0.02h,Break Even,$0.75,$1519.50,$543139.25,344,$1519.50
2025-05-01,22:49:00,19784.5,SELL,3,0.02h,Stop Loss,$-18.00,$1501.50,$543121.25,344,$1501.50
2025-05-01,22:51:00,19790.0,BUY,3,0.02h,Break Even,$0.75,$1502.25,$543122.00,344,$1502.25
,,,,,,,,,,,
2025-05-02,13:26:00,20093.0,SELL,3,0.02h,Stop Loss,$68.25,$68.25,$543190.25,345,$68.25
2025-05-02,13:45:00,20100.25,BUY,3,0.02h,Stop Loss,$180.75,$249.00,$543371.00,345,$249.00
2025-05-02,13:48:00,20071.5,SELL,3,0.02h,Stop Loss,$330.75,$579.75,$543701.75,345,$579.75
2025-05-02,14:03:00,20104.0,BUY,3,0.02h,Stop Loss,$462.00,$1041.75,$544163.75,345,$1041.75
2025-05-02,14:44:00,20142.75,SELL,3,0.02h,Stop Loss,$30.75,$1072.50,$544194.50,345,$1072.50
2025-05-02,14:47:00,20159.25,BUY,3,0.02h,Stop Loss,$-18.00,$1054.50,$544176.50,345,$1054.50
2025-05-02,14:53:00,20141.5,SELL,3,0.02h,Stop Loss,$233.25,$1287.75,$544409.75,345,$1287.75
2025-05-02,14:57:00,20150.25,BUY,3,0.02h,Stop Loss,$-18.00,$1269.75,$544391.75,345,$1269.75
2025-05-02,14:58:00,20143.0,SELL,3,0.02h,Stop Loss,$12.00,$1281.75,$544403.75,345,$1281.75
2025-05-02,15:00:00,20166.0,BUY,3,0.02h,Stop Loss,$139.50,$1421.25,$544543.25,345,$1421.25
2025-05-02,15:25:00,20161.75,SELL,3,0.02h,Stop Loss,$143.25,$1564.50,$544686.50,345,$1564.50
2025-05-02,15:39:00,20173.25,BUY,3,0.02h,Break Even,$0.75,$1565.25,$544687.25,345,$1565.25
2025-05-02,16:30:00,20224.0,SELL,3,0.02h,Break Even,$0.75,$1566.00,$544688.00,345,$1566.00
2025-05-02,16:37:00,20246.0,BUY,3,0.02h,Stop Loss,$252.00,$1818.00,$544940.00,345,$1818.00
2025-05-02,16:58:00,20243.75,SELL,3,0.02h,Break Even,$0.75,$1818.75,$544940.75,345,$1818.75
2025-05-02,17:40:00,20219.0,BUY,3,0.02h,Stop Loss,$-18.00,$1800.75,$544922.75,345,$1800.75
2025-05-02,17:41:00,20204.25,SELL,3,0.02h,Stop Loss,$-18.00,$1782.75,$544904.75,345,$1782.75
2025-05-02,17:43:00,20217.25,BUY,3,0.02h,Break Even,$0.75,$1783.50,$544905.50,345,$1783.50
2025-05-02,17:52:00,20212.25,SELL,3,0.02h,Stop Loss,$-18.00,$1765.50,$544887.50,345,$1765.50
2025-05-02,17:54:00,20225.0,BUY,3,0.02h,Break Even,$0.75,$1766.25,$544888.25,345,$1766.25
2025-05-02,18:48:00,20242.75,SELL,3,0.02h,Stop Loss,$184.50,$1950.75,$545072.75,345,$1950.75
2025-05-02,19:22:00,20229.25,BUY,3,0.02h,Stop Loss,$49.50,$2000.25,$545122.25,345,$2000.25
2025-05-02,19:35:00,20211.5,SELL,3,0.02h,Stop Loss,$252.00,$2252.25,$545374.25,345,$2252.25
2025-05-02,20:06:00,20211.25,BUY,3,0.02h,Stop Loss,$64.50,$2316.75,$545438.75,345,$2316.75
2025-05-02,20:18:00,20193.25,SELL,3,0.02h,Stop Loss,$-18.00,$2298.75,$545420.75,345,$2298.75
2025-05-02,20:56:00,20202.25,BUY,3,0.02h,Break Even,$0.75,$2299.50,$545421.50,345,$2299.50
,,,,,,,,,,,
2025-05-05,12:00:00,19980.75,SELL,3,0.02h,Stop Loss,$-18.00,$-18.00,$545403.50,346,$-18.00
2025-05-05,12:54:00,20000.5,BUY,3,0.02h,Stop Loss,$42.00,$24.00,$545445.50,346,$24.00
2025-05-05,13:16:00,19995.25,SELL,3,0.02h,Stop Loss,$-18.00,$6.00,$545427.50,346,$6.00
2025-05-05,13:22:00,20005.0,BUY,3,0.02h,Stop Loss,$15.75,$21.75,$545443.25,346,$21.75
2025-05-05,13:28:00,19999.0,SELL,3,0.02h,Stop Loss,$-18.00,$3.75,$545425.25,346,$3.75
2025-05-05,13:29:00,20015.75,BUY,3,0.02h,Stop Loss,$-18.00,$-14.25,$545407.25,346,$-14.25
2025-05-05,14:25:00,20050.5,SELL,3,0.02h,Break Even,$0.75,$-13.50,$545408.00,346,$-13.50
2025-05-05,14:41:00,20073.0,BUY,3,0.02h,Stop Loss,$165.75,$152.25,$545573.75,346,$152.25
2025-05-05,15:16:00,20090.5,SELL,3,0.02h,Stop Loss,$79.50,$231.75,$545653.25,346,$231.75
2025-05-05,15:21:00,20103.0,BUY,3,0.02h,Stop Loss,$169.50,$401.25,$545822.75,346,$401.25
2025-05-05,15:29:00,20095.75,SELL,3,0.02h,Break Even,$0.75,$402.00,$545823.50,346,$402.00
2025-05-05,15:31:00,20105.75,BUY,3,0.02h,Stop Loss,$-18.00,$384.00,$545805.50,346,$384.00
2025-05-05,15:32:00,20096.5,SELL,3,0.02h,Stop Loss,$154.50,$538.50,$545960.00,346,$538.50
2025-05-05,15:53:00,20100.5,BUY,3,0.02h,Stop Loss,$53.25,$591.75,$546013.25,346,$591.75
2025-05-05,17:01:00,20124.0,SELL,3,0.02h,Break Even,$0.75,$592.50,$546014.00,346,$592.50
2025-05-05,17:28:00,20129.0,BUY,3,0.02h,Stop Loss,$19.50,$612.00,$546033.50,346,$612.00
2025-05-05,18:55:00,20169.5,SELL,3,0.02h,Stop Loss,$87.00,$699.00,$546120.50,346,$699.00
2025-05-05,19:39:00,20133.5,BUY,3,0.02h,Stop Loss,$-18.00,$681.00,$546102.50,346,$681.00
2025-05-05,19:44:00,20114.0,SELL,3,0.02h,Stop Loss,$180.75,$861.75,$546283.25,346,$861.75
2025-05-05,20:45:00,20028.0,BUY,3,0.02h,Stop Loss,$83.25,$945.00,$546366.50,346,$945.00
2025-05-05,22:03:00,20030.25,SELL,3,0.02h,Stop Loss,$79.50,$1024.50,$546446.00,346,$1024.50
2025-05-05,22:17:00,20033.75,BUY,3,0.02h,Break Even,$0.75,$1025.25,$546446.75,346,$1025.25
2025-05-05,22:29:00,20027.0,SELL,3,0.02h,Stop Loss,$-18.00,$1007.25,$546428.75,346,$1007.25
2025-05-05,22:37:00,20030.75,BUY,3,0.02h,Stop Loss,$12.00,$1019.25,$546440.75,346,$1019.25
2025-05-05,22:45:00,20024.0,SELL,3,0.02h,Stop Loss,$-18.00,$1001.25,$546422.75,346,$1001.25
,,,,,,,,,,,
2025-05-06,12:52:00,19831.75,BUY,3,0.02h,Break Even,$0.75,$0.75,$546423.50,347,$0.75
2025-05-06,13:07:00,19824.0,SELL,3,0.02h,Stop Loss,$94.50,$95.25,$546518.00,347,$95.25
2025-05-06,13:34:00,19828.75,BUY,3,0.02h,Stop Loss,$158.25,$253.50,$546676.25,347,$253.50
2025-05-06,13:50:00,19799.5,SELL,3,0.02h,Stop Loss,$180.75,$434.25,$546857.00,347,$434.25
2025-05-06,14:09:00,19813.5,BUY,3,0.02h,Stop Loss,$147.00,$581.25,$547004.00,347,$581.25
2025-05-06,15:11:00,19896.75,SELL,3,0.02h,Stop Loss,$-18.00,$563.25,$546986.00,347,$563.25
2025-05-06,15:16:00,19915.0,BUY,3,0.02h,Stop Loss,$-18.00,$545.25,$546968.00,347,$545.25
2025-05-06,15:17:00,19905.0,SELL,3,0.02h,Break Even,$0.75,$546.00,$546968.75,347,$546.00
2025-05-06,15:18:00,19916.75,BUY,3,0.02h,Stop Loss,$83.25,$629.25,$547052.00,347,$629.25
2025-05-06,15:43:00,19911.25,SELL,3,0.02h,Stop Loss,$64.50,$693.75,$547116.50,347,$693.75
2025-05-06,16:13:00,19946.25,BUY,3,0.02h,Stop Loss,$713.25,$1407.00,$547829.75,347,$1407.00
2025-05-06,16:25:00,19903.25,SELL,3,0.02h,Stop Loss,$15.75,$1422.75,$547845.50,347,$1422.75
2025-05-06,16:41:00,19932.5,BUY,3,0.02h,Stop Loss,$19.50,$1442.25,$547865.00,347,$1442.25
2025-05-06,16:44:00,19915.5,SELL,3,0.02h,Stop Loss,$304.50,$1746.75,$548169.50,347,$1746.75
2025-05-06,17:09:00,19907.5,BUY,3,0.02h,Stop Loss,$135.75,$1882.50,$548305.25,347,$1882.50
2025-05-06,17:22:00,19876.5,SELL,3,0.02h,Stop Loss,$72.00,$1954.50,$548377.25,347,$1954.50
2025-05-06,17:34:00,19897.75,BUY,3,0.02h,Stop Loss,$53.25,$2007.75,$548430.50,347,$2007.75
2025-05-06,17:39:00,19881.0,SELL,3,0.02h,Stop Loss,$199.50,$2207.25,$548630.00,347,$2207.25
2025-05-06,18:03:00,19884.5,BUY,3,0.02h,Stop Loss,$15.75,$2223.00,$548645.75,347,$2223.00
2025-05-06,19:09:00,19925.75,SELL,3,0.02h,Break Even,$0.75,$2223.75,$548646.50,347,$2223.75
2025-05-06,19:16:00,19940.75,BUY,3,0.02h,Stop Loss,$53.25,$2277.00,$548699.75,347,$2277.00
2025-05-06,19:21:00,19926.75,SELL,3,0.02h,Break Even,$0.75,$2277.75,$548700.50,347,$2277.75
2025-05-06,19:27:00,19938.0,BUY,3,0.02h,Stop Loss,$53.25,$2331.00,$548753.75,347,$2331.00
2025-05-06,19:52:00,19922.75,SELL,3,0.02h,Stop Loss,$169.50,$2500.50,$548923.25,347,$2500.50
2025-05-06,20:53:00,19856.75,BUY,3,0.02h,Break Even,$0.75,$2501.25,$548924.00,347,$2501.25
2025-05-06,21:00:00,19846.25,SELL,3,1.02h,Stop Loss,$627.00,$3128.25,$549551.00,347,$3128.25
2025-05-06,22:01:00,19953.0,BUY,3,0.02h,Stop Loss,$2037.00,$5165.25,$551588.00,347,$5165.25
2025-05-06,22:38:00,20008.5,SELL,3,0.02h,Break Even,$0.75,$5166.00,$551588.75,347,$5166.00
2025-05-06,22:50:00,20052.75,BUY,3,0.02h,Stop Loss,$237.00,$5403.00,$551825.75,347,$5403.00
,,,,,,,,,,,
2025-05-07,12:00:00,19996.25,SELL,3,0.02h,Break Even,$0.75,$0.75,$551826.50,348,$0.75
2025-05-07,12:45:00,19944.0,BUY,3,0.02h,Stop Loss,$34.50,$35.25,$551861.00,348,$35.25
2025-05-07,12:59:00,19930.25,SELL,3,0.02h,Stop Loss,$-18.00,$17.25,$551843.00,348,$17.25
2025-05-07,13:42:00,19915.0,BUY,3,0.02h,Stop Loss,$90.75,$108.00,$551933.75,348,$108.00
2025-05-07,13:51:00,19877.25,SELL,3,0.02h,Stop Loss,$-18.00,$90.00,$551915.75,348,$90.00
2025-05-07,13:56:00,19921.75,BUY,3,0.02h,Stop Loss,$83.25,$173.25,$551999.00,348,$173.25
2025-05-07,14:47:00,19952.75,SELL,3,0.02h,Stop Loss,$173.25,$346.50,$552172.25,348,$346.50
2025-05-07,15:41:00,19830.5,BUY,3,0.02h,Stop Loss,$135.75,$482.25,$552308.00,348,$482.25
2025-05-07,15:50:00,19796.75,SELL,3,0.02h,Stop Loss,$132.00,$614.25,$552440.00,348,$614.25
2025-05-07,15:54:00,19840.75,BUY,3,0.02h,Stop Loss,$38.25,$652.50,$552478.25,348,$652.50
2025-05-07,16:22:00,19823.0,SELL,3,0.02h,Stop Loss,$135.75,$788.25,$552614.00,348,$788.25
2025-05-07,16:40:00,19841.25,BUY,3,0.02h,Stop Loss,$210.75,$999.00,$552824.75,348,$999.00
2025-05-07,17:22:00,19886.25,SELL,3,0.02h,Break Even,$0.75,$999.75,$552825.50,348,$999.75
2025-05-07,17:25:00,19908.0,BUY,3,0.02h,Stop Loss,$27.00,$1026.75,$552852.50,348,$1026.75
2025-05-07,17:34:00,19889.0,SELL,3,0.02h,Break Even,$0.75,$1027.50,$552853.25,348,$1027.50
2025-05-07,18:28:00,19781.75,BUY,3,0.02h,Stop Loss,$34.50,$1062.00,$552887.75,348,$1062.00
2025-05-07,18:50:00,19777.25,SELL,3,0.02h,Stop Loss,$192.00,$1254.00,$553079.75,348,$1254.00
2025-05-07,18:57:00,19860.25,BUY,3,0.02h,Stop Loss,$604.50,$1858.50,$553684.25,348,$1858.50
2025-05-07,19:25:00,19832.0,SELL,3,0.02h,Stop Loss,$383.25,$2241.75,$554067.50,348,$2241.75
2025-05-07,19:42:00,19911.0,BUY,3,0.02h,Stop Loss,$1575.75,$3817.50,$555643.25,348,$3817.50
2025-05-07,20:29:00,19943.25,SELL,3,0.02h,Break Even,$0.75,$3818.25,$555644.00,348,$3818.25
2025-05-07,20:40:00,19958.0,BUY,3,0.02h,Break Even,$0.75,$3819.00,$555644.75,348,$3819.00
2025-05-07,22:01:00,19933.0,SELL,3,0.02h,Stop Loss,$132.00,$3951.00,$555776.75,348,$3951.00
2025-05-07,22:26:00,19940.0,BUY,3,0.02h,Stop Loss,$12.00,$3963.00,$555788.75,348,$3963.00
2025-05-07,22:50:00,19942.75,SELL,3,0.02h,Break Even,$0.75,$3963.75,$555789.50,348,$3963.75
,,,,,,,,,,,
2025-05-08,12:00:00,20198.0,BUY,3,0.02h,Stop Loss,$30.75,$30.75,$555820.25,349,$30.75
2025-05-08,12:38:00,20164.25,SELL,3,0.02h,Break Even,$0.75,$31.50,$555821.00,349,$31.50
2025-05-08,12:51:00,20200.75,BUY,3,0.02h,Stop Loss,$-18.00,$13.50,$555803.00,349,$13.50
2025-05-08,12:59:00,20176.5,SELL,3,0.02h,Break Even,$0.75,$14.25,$555803.75,349,$14.25
2025-05-08,13:22:00,20177.25,BUY,3,0.02h,Break Even,$0.75,$15.00,$555804.50,349,$15.00
2025-05-08,13:25:00,20169.5,SELL,3,0.02h,Stop Loss,$-18.00,$-3.00,$555786.50,349,$-3.00
2025-05-08,14:28:00,20091.0,BUY,3,0.02h,Stop Loss,$27.00,$24.00,$555813.50,349,$24.00
2025-05-08,14:40:00,20062.0,SELL,3,0.02h,Stop Loss,$53.25,$77.25,$555866.75,349,$77.25
2025-05-08,15:10:00,20059.25,BUY,3,0.02h,Stop Loss,$143.25,$220.50,$556010.00,349,$220.50
2025-05-08,16:29:00,20288.5,SELL,3,0.02h,Stop Loss,$53.25,$273.75,$556063.25,349,$273.75
2025-05-08,16:39:00,20306.0,BUY,3,0.02h,Stop Loss,$19.50,$293.25,$556082.75,349,$293.25
2025-05-08,17:06:00,20313.0,SELL,3,0.02h,Stop Loss,$102.00,$395.25,$556184.75,349,$395.25
2025-05-08,18:16:00,20276.5,BUY,3,0.02h,Stop Loss,$57.00,$452.25,$556241.75,349,$452.25
2025-05-08,18:56:00,20293.75,SELL,3,0.02h,Stop Loss,$64.50,$516.75,$556306.25,349,$516.75
2025-05-08,19:21:00,20298.5,BUY,3,0.02h,Stop Loss,$417.00,$933.75,$556723.25,349,$933.75
2025-05-08,19:37:00,20280.0,SELL,3,0.02h,Break Even,$0.75,$934.50,$556724.00,349,$934.50
2025-05-08,20:43:00,20163.0,BUY,3,0.02h,Break Even,$0.75,$935.25,$556724.75,349,$935.25
2025-05-08,21:00:00,20155.75,SELL,3,1.02h,Stop Loss,$-18.00,$917.25,$556706.75,349,$917.25
2025-05-08,22:01:00,20172.0,BUY,3,0.02h,Break Even,$0.75,$918.00,$556707.50,349,$918.00
2025-05-08,22:05:00,20150.75,SELL,3,0.02h,Stop Loss,$27.00,$945.00,$556734.50,349,$945.00
2025-05-08,22:17:00,20165.25,BUY,3,0.02h,Break Even,$0.75,$945.75,$556735.25,349,$945.75
2025-05-08,22:21:00,20153.0,SELL,3,0.02h,Stop Loss,$-18.00,$927.75,$556717.25,349,$927.75
2025-05-08,22:43:00,20158.0,BUY,3,0.02h,Stop Loss,$-18.00,$909.75,$556699.25,349,$909.75
,,,,,,,,,,,
2025-05-09,12:29:00,20197.75,SELL,3,0.02h,Stop Loss,$-18.00,$-18.00,$556681.25,350,$-18.00
2025-05-09,12:32:00,20216.0,BUY,3,0.02h,Stop Loss,$23.25,$5.25,$556704.50,350,$5.25
2025-05-09,13:26:00,20237.75,SELL,3,0.02h,Stop Loss,$53.25,$58.50,$556757.75,350,$58.50
2025-05-09,13:35:00,20260.5,BUY,3,0.02h,Stop Loss,$75.75,$134.25,$556833.50,350,$134.25
2025-05-09,13:45:00,20227.0,SELL,3,0.02h,Stop Loss,$57.00,$191.25,$556890.50,350,$191.25
2025-05-09,14:00:00,20254.25,BUY,3,0.02h,Break Even,$0.75,$192.00,$556891.25,350,$192.00
2025-05-09,14:16:00,20237.25,SELL,3,0.02h,Break Even,$0.75,$192.75,$556892.00,350,$192.75
2025-05-09,14:58:00,20139.0,BUY,3,0.02h,Stop Loss,$68.25,$261.00,$556960.25,350,$261.00
2025-05-09,15:23:00,20133.5,SELL,3,0.02h,Stop Loss,$154.50,$415.50,$557114.75,350,$415.50
2025-05-09,15:46:00,20144.25,BUY,3,0.02h,Stop Loss,$23.25,$438.75,$557138.00,350,$438.75
2025-05-09,16:05:00,20108.25,SELL,3,0.02h,Break Even,$0.75,$439.50,$557138.75,350,$439.50
2025-05-09,16:38:00,20131.25,BUY,3,0.02h,Stop Loss,$-18.00,$421.50,$557120.75,350,$421.50
2025-05-09,16:45:00,20107.25,SELL,3,0.02h,Stop Loss,$139.50,$561.00,$557260.25,350,$561.00
2025-05-09,17:11:00,20114.75,BUY,3,0.02h,Stop Loss,$-18.00,$543.00,$557242.25,350,$543.00
2025-05-09,17:32:00,20096.0,SELL,3,0.02h,Break Even,$0.75,$543.75,$557243.00,350,$543.75
2025-05-09,17:37:00,20113.5,BUY,3,0.02h,Stop Loss,$-18.00,$525.75,$557225.00,350,$525.75
2025-05-09,18:13:00,20139.5,SELL,3,0.02h,Stop Loss,$23.25,$549.00,$557248.25,350,$549.00
2025-05-09,18:34:00,20138.5,BUY,3,0.02h,Break Even,$0.75,$549.75,$557249.00,350,$549.75
2025-05-09,18:38:00,20130.75,SELL,3,0.02h,Stop Loss,$23.25,$573.00,$557272.25,350,$573.00
2025-05-09,18:41:00,20137.5,BUY,3,0.02h,Break Even,$0.75,$573.75,$557273.00,350,$573.75
2025-05-09,18:42:00,20128.25,SELL,3,0.02h,Break Even,$0.75,$574.50,$557273.75,350,$574.50
2025-05-09,18:48:00,20142.75,BUY,3,0.02h,Break Even,$0.75,$575.25,$557274.50,350,$575.25
2025-05-09,19:24:00,20156.75,SELL,3,0.02h,Stop Loss,$19.50,$594.75,$557294.00,350,$594.75
2025-05-09,19:44:00,20162.75,BUY,3,0.02h,Stop Loss,$-18.00,$576.75,$557276.00,350,$576.75
2025-05-09,19:46:00,20139.5,SELL,3,0.02h,Stop Loss,$19.50,$596.25,$557295.50,350,$596.25
2025-05-09,19:55:00,20164.75,BUY,3,0.02h,Stop Loss,$-18.00,$578.25,$557277.50,350,$578.25
2025-05-09,19:56:00,20138.5,SELL,3,0.02h,Stop Loss,$68.25,$646.50,$557345.75,350,$646.50
2025-05-09,20:42:00,20133.5,BUY,3,0.02h,Stop Loss,$-18.00,$628.50,$557327.75,350,$628.50
,,,,,,,,,,,
2025-05-12,12:47:00,20910.75,SELL,3,0.02h,Stop Loss,$-18.00,$-18.00,$557309.75,351,$-18.00
2025-05-12,12:52:00,20930.5,BUY,3,0.02h,Stop Loss,$-18.00,$-36.00,$557291.75,351,$-36.00
2025-05-12,13:00:00,20916.25,SELL,3,0.02h,Stop Loss,$-18.00,$-54.00,$557273.75,351,$-54.00
2025-05-12,13:01:00,20938.0,BUY,3,0.02h,Break Even,$0.75,$-53.25,$557274.50,351,$-53.25
2025-05-12,13:06:00,20910.75,SELL,3,0.02h,Stop Loss,$79.50,$26.25,$557354.00,351,$26.25
2025-05-12,13:20:00,20918.75,BUY,3,0.02h,Stop Loss,$49.50,$75.75,$557403.50,351,$75.75
2025-05-12,13:31:00,20865.5,SELL,3,0.02h,Stop Loss,$623.25,$699.00,$558026.75,351,$699.00
2025-05-12,14:08:00,20815.25,BUY,3,0.02h,Break Even,$0.75,$699.75,$558027.50,351,$699.75
2025-05-12,14:26:00,20799.0,SELL,3,0.02h,Stop Loss,$435.75,$1135.50,$558463.25,351,$1135.50
2025-05-12,14:45:00,20794.75,BUY,3,0.02h,Stop Loss,$60.75,$1196.25,$558524.00,351,$1196.25
2025-05-12,15:08:00,20775.25,SELL,3,0.02h,Stop Loss,$27.00,$1223.25,$558551.00,351,$1223.25
2025-05-12,15:13:00,20790.25,BUY,3,0.02h,Stop Loss,$79.50,$1302.75,$558630.50,351,$1302.75
2025-05-12,15:23:00,20769.0,SELL,3,0.02h,Stop Loss,$169.50,$1472.25,$558800.00,351,$1472.25
2025-05-12,15:31:00,20785.0,BUY,3,0.02h,Stop Loss,$135.75,$1608.00,$558935.75,351,$1608.00
2025-05-12,15:42:00,20765.25,SELL,3,0.02h,Break Even,$0.75,$1608.75,$558936.50,351,$1608.75
2025-05-12,15:49:00,20790.5,BUY,3,0.02h,Stop Loss,$-18.00,$1590.75,$558918.50,351,$1590.75
2025-05-12,15:51:00,20781.5,SELL,3,0.02h,Stop Loss,$300.75,$1891.50,$559219.25,351,$1891.50
2025-05-12,16:06:00,20785.5,BUY,3,0.02h,Stop Loss,$154.50,$2046.00,$559373.75,351,$2046.00
2025-05-12,17:25:00,20894.25,SELL,3,0.02h,Stop Loss,$30.75,$2076.75,$559404.50,351,$2076.75
2025-05-12,17:31:00,20906.75,BUY,3,0.02h,Stop Loss,$105.75,$2182.50,$559510.25,351,$2182.50
2025-05-12,18:11:00,20905.25,SELL,3,0.02h,Stop Loss,$117.00,$2299.50,$559627.25,351,$2299.50
2025-05-12,18:19:00,20924.25,BUY,3,0.02h,Stop Loss,$15.75,$2315.25,$559643.00,351,$2315.25
2025-05-12,18:49:00,20922.75,SELL,3,0.02h,Stop Loss,$60.75,$2376.00,$559703.75,351,$2376.00
2025-05-12,19:08:00,20921.75,BUY,3,0.02h,Break Even,$0.75,$2376.75,$559704.50,351,$2376.75
2025-05-12,19:15:00,20902.75,SELL,3,0.02h,Stop Loss,$120.75,$2497.50,$559825.25,351,$2497.50
2025-05-12,19:51:00,20908.75,BUY,3,0.02h,Stop Loss,$-18.00,$2479.50,$559807.25,351,$2479.50
2025-05-12,22:01:00,20934.5,SELL,3,0.02h,Stop Loss,$-18.00,$2461.50,$559789.25,351,$2461.50
,,,,,,,,,,,
2025-05-13,12:00:00,20941.5,BUY,3,0.02h,Stop Loss,$75.75,$75.75,$559865.00,352,$75.75
2025-05-13,12:48:00,20991.75,SELL,3,0.02h,Break Even,$0.75,$76.50,$559865.75,352,$76.50
2025-05-13,12:50:00,21006.0,BUY,3,0.02h,Break Even,$0.75,$77.25,$559866.50,352,$77.25
2025-05-13,13:27:00,20996.75,SELL,3,0.02h,Stop Loss,$30.75,$108.00,$559897.25,352,$108.00
2025-05-13,13:34:00,21033.5,BUY,3,0.02h,Stop Loss,$42.00,$150.00,$559939.25,352,$150.00
2025-05-13,14:45:00,21191.75,SELL,3,0.02h,Stop Loss,$30.75,$180.75,$559970.00,352,$180.75
2025-05-13,14:51:00,21228.0,BUY,3,0.02h,Break Even,$0.75,$181.50,$559970.75,352,$181.50
2025-05-13,15:54:00,21278.5,SELL,3,0.02h,Break Even,$0.75,$182.25,$559971.50,352,$182.25
2025-05-13,15:57:00,21290.0,BUY,3,0.02h,Stop Loss,$38.25,$220.50,$560009.75,352,$220.50
2025-05-13,16:01:00,21271.25,SELL,3,0.02h,Stop Loss,$19.50,$240.00,$560029.25,352,$240.00
2025-05-13,16:15:00,21288.5,BUY,3,0.02h,Stop Loss,$-18.00,$222.00,$560011.25,352,$222.00
2025-05-13,17:04:00,21316.0,SELL,3,0.02h,Stop Loss,$-18.00,$204.00,$559993.25,352,$204.00
2025-05-13,17:19:00,21326.25,BUY,3,0.02h,Break Even,$0.75,$204.75,$559994.00,352,$204.75
2025-05-13,17:22:00,21310.0,SELL,3,0.02h,Stop Loss,$-18.00,$186.75,$559976.00,352,$186.75
2025-05-13,17:28:00,21318.75,BUY,3,0.02h,Stop Loss,$-18.00,$168.75,$559958.00,352,$168.75
2025-05-13,17:29:00,21313.25,SELL,3,0.02h,Stop Loss,$-18.00,$150.75,$559940.00,352,$150.75
2025-05-13,17:31:00,21323.0,BUY,3,0.02h,Stop Loss,$105.75,$256.50,$560045.75,352,$256.50
2025-05-13,17:54:00,21319.5,SELL,3,0.02h,Stop Loss,$117.00,$373.50,$560162.75,352,$373.50
2025-05-13,18:21:00,21313.5,BUY,3,0.02h,Stop Loss,$-18.00,$355.50,$560144.75,352,$355.50
2025-05-13,18:32:00,21299.0,SELL,3,0.02h,Break Even,$0.75,$356.25,$560145.50,352,$356.25
2025-05-13,18:57:00,21315.25,BUY,3,0.02h,Stop Loss,$120.75,$477.00,$560266.25,352,$477.00
2025-05-13,19:28:00,21323.5,SELL,3,0.02h,Stop Loss,$-18.00,$459.00,$560248.25,352,$459.00
2025-05-13,19:29:00,21328.0,BUY,3,0.02h,Break Even,$0.75,$459.75,$560249.00,352,$459.75
2025-05-13,19:30:00,21321.0,SELL,3,0.02h,Stop Loss,$12.00,$471.75,$560261.00,352,$471.75
2025-05-13,19:31:00,21327.75,BUY,3,0.02h,Break Even,$0.75,$472.50,$560261.75,352,$472.50
2025-05-13,19:36:00,21318.75,SELL,3,0.02h,Stop Loss,$-18.00,$454.50,$560243.75,352,$454.50
2025-05-13,19:38:00,21337.75,BUY,3,0.02h,Stop Loss,$30.75,$485.25,$560274.50,352,$485.25
2025-05-13,19:44:00,21323.0,SELL,3,0.02h,Break Even,$0.75,$486.00,$560275.25,352,$486.00
2025-05-13,20:37:00,21260.5,BUY,3,0.02h,Break Even,$0.75,$486.75,$560276.00,352,$486.75
2025-05-13,20:56:00,21259.25,SELL,3,0.02h,Break Even,$0.75,$487.50,$560276.75,352,$487.50
2025-05-13,22:12:00,21260.75,BUY,3,0.02h,Stop Loss,$-18.00,$469.50,$560258.75,352,$469.50
2025-05-13,22:35:00,21259.75,SELL,3,0.02h,Break Even,$0.75,$470.25,$560259.50,352,$470.25
2025-05-13,22:46:00,21267.25,BUY,3,0.02h,Break Even,$0.75,$471.00,$560260.25,352,$471.00
2025-05-13,22:55:00,21261.25,SELL,3,0.02h,Stop Loss,$-18.00,$453.00,$560242.25,352,$453.00
2025-05-13,22:58:00,21264.0,BUY,3,0.02h,Stop Loss,$-18.00,$435.00,$560224.25,352,$435.00
2025-05-13,22:59:00,21260.75,SELL,3,0.02h,Break Even,$0.75,$435.75,$560225.00,352,$435.75
,,,,,,,,,,,
2025-05-14,12:00:00,21344.0,BUY,3,0.02h,Stop Loss,$27.00,$27.00,$560252.00,353,$27.00
2025-05-14,12:39:00,21338.25,SELL,3,0.02h,Stop Loss,$-18.00,$9.00,$560234.00,353,$9.00
2025-05-14,13:14:00,21335.25,BUY,3,0.02h,Stop Loss,$19.50,$28.50,$560253.50,353,$28.50
2025-05-14,13:29:00,21320.5,SELL,3,0.02h,Stop Loss,$94.50,$123.00,$560348.00,353,$123.00
2025-05-14,13:33:00,21361.25,BUY,3,0.02h,Stop Loss,$128.25,$251.25,$560476.25,353,$251.25
2025-05-14,13:47:00,21320.5,SELL,3,0.02h,Stop Loss,$222.00,$473.25,$560698.25,353,$473.25
2025-05-14,14:07:00,21340.25,BUY,3,0.02h,Break Even,$0.75,$474.00,$560699.00,353,$474.00
2025-05-14,14:21:00,21317.0,SELL,3,0.02h,Stop Loss,$90.75,$564.75,$560789.75,353,$564.75
2025-05-14,14:24:00,21332.5,BUY,3,0.02h,Stop Loss,$53.25,$618.00,$560843.00,353,$618.00
2025-05-14,14:42:00,21323.5,SELL,3,0.02h,Stop Loss,$27.00,$645.00,$560870.00,353,$645.00
2025-05-14,14:50:00,21344.25,BUY,3,0.02h,Stop Loss,$154.50,$799.50,$561024.50,353,$799.50
2025-05-14,15:04:00,21327.0,SELL,3,0.02h,Stop Loss,$450.75,$1250.25,$561475.25,353,$1250.25
2025-05-14,15:16:00,21344.5,BUY,3,0.02h,Stop Loss,$45.75,$1296.00,$561521.00,353,$1296.00
2025-05-14,15:52:00,21368.75,SELL,3,0.02h,Stop Loss,$-18.00,$1278.00,$561503.00,353,$1278.00
2025-05-14,15:54:00,21380.0,BUY,3,0.02h,Break Even,$0.75,$1278.75,$561503.75,353,$1278.75
2025-05-14,15:55:00,21368.5,SELL,3,0.02h,Stop Loss,$79.50,$1358.25,$561583.25,353,$1358.25
2025-05-14,15:57:00,21377.25,BUY,3,0.02h,Break Even,$0.75,$1359.00,$561584.00,353,$1359.00
2025-05-14,16:20:00,21370.5,SELL,3,0.02h,Stop Loss,$-18.00,$1341.00,$561566.00,353,$1341.00
2025-05-14,16:30:00,21384.75,BUY,3,0.02h,Stop Loss,$23.25,$1364.25,$561589.25,353,$1364.25
2025-05-14,16:42:00,21370.25,SELL,3,0.02h,Stop Loss,$-18.00,$1346.25,$561571.25,353,$1346.25
2025-05-14,17:39:00,21333.25,BUY,3,0.02h,Stop Loss,$45.75,$1392.00,$561617.00,353,$1392.00
2025-05-14,18:28:00,21349.25,SELL,3,0.02h,Stop Loss,$162.00,$1554.00,$561779.00,353,$1554.00
2025-05-14,18:35:00,21390.75,BUY,3,0.02h,Stop Loss,$15.75,$1569.75,$561794.75,353,$1569.75
2025-05-14,19:01:00,21361.75,SELL,3,0.02h,Stop Loss,$68.25,$1638.00,$561863.00,353,$1638.00
2025-05-14,19:15:00,21369.0,BUY,3,0.02h,Stop Loss,$64.50,$1702.50,$561927.50,353,$1702.50
2025-05-14,19:23:00,21354.0,SELL,3,0.02h,Stop Loss,$199.50,$1902.00,$562127.00,353,$1902.00
2025-05-14,19:51:00,21377.75,BUY,3,0.02h,Stop Loss,$128.25,$2030.25,$562255.25,353,$2030.25
2025-05-14,20:54:00,21398.5,SELL,3,0.02h,Stop Loss,$-18.00,$2012.25,$562237.25,353,$2012.25
2025-05-14,22:30:00,21378.25,BUY,3,0.02h,Break Even,$0.75,$2013.00,$562238.00,353,$2013.00
2025-05-14,22:46:00,21374.5,SELL,3,0.02h,Break Even,$0.75,$2013.75,$562238.75,353,$2013.75
2025-05-14,22:49:00,21380.25,BUY,3,0.02h,Stop Loss,$19.50,$2033.25,$562258.25,353,$2033.25
,,,,,,,,,,,
2025-05-15,12:00:00,21274.75,SELL,3,0.02h,Break Even,$0.75,$0.75,$562259.00,354,$0.75
2025-05-15,12:33:00,21309.0,BUY,3,0.02h,Stop Loss,$210.75,$211.50,$562469.75,354,$211.50
2025-05-15,12:50:00,21278.25,SELL,3,0.02h,Stop Loss,$128.25,$339.75,$562598.00,354,$339.75
2025-05-15,13:04:00,21301.25,BUY,3,0.02h,Stop Loss,$-18.00,$321.75,$562580.00,354,$321.75
2025-05-15,13:22:00,21294.75,SELL,3,0.02h,Stop Loss,$15.75,$337.50,$562595.75,354,$337.50
2025-05-15,13:30:00,21303.5,BUY,3,0.02h,Stop Loss,$19.50,$357.00,$562615.25,354,$357.00
2025-05-15,13:31:00,21287.25,SELL,3,0.02h,Stop Loss,$23.25,$380.25,$562638.50,354,$380.25
2025-05-15,13:32:00,21313.75,BUY,3,0.02h,Stop Loss,$270.75,$651.00,$562909.25,354,$651.00
2025-05-15,13:42:00,21294.75,SELL,3,0.02h,Stop Loss,$34.50,$685.50,$562943.75,354,$685.50
2025-05-15,13:45:00,21316.75,BUY,3,0.02h,Stop Loss,$19.50,$705.00,$562963.25,354,$705.00
2025-05-15,13:47:00,21269.0,SELL,3,0.02h,Stop Loss,$120.75,$825.75,$563084.00,354,$825.75
2025-05-15,14:01:00,21314.0,BUY,3,0.02h,Stop Loss,$447.00,$1272.75,$563531.00,354,$1272.75
2025-05-15,14:13:00,21297.5,SELL,3,0.02h,Stop Loss,$75.75,$1348.50,$563606.75,354,$1348.50
2025-05-15,14:21:00,21324.0,BUY,3,0.02h,Stop Loss,$27.00,$1375.50,$563633.75,354,$1375.50
2025-05-15,14:30:00,21288.5,SELL,3,0.02h,Stop Loss,$42.00,$1417.50,$563675.75,354,$1417.50
2025-05-15,14:46:00,21301.5,BUY,3,0.02h,Stop Loss,$45.75,$1463.25,$563721.50,354,$1463.25
2025-05-15,16:26:00,21432.75,SELL,3,0.02h,Stop Loss,$-18.00,$1445.25,$563703.50,354,$1445.25
2025-05-15,16:31:00,21441.25,BUY,3,0.02h,Stop Loss,$23.25,$1468.50,$563726.75,354,$1468.50
2025-05-15,16:33:00,21428.75,SELL,3,0.02h,Stop Loss,$-18.00,$1450.50,$563708.75,354,$1450.50
2025-05-15,16:37:00,21455.25,BUY,3,0.02h,Stop Loss,$49.50,$1500.00,$563758.25,354,$1500.00
2025-05-15,17:35:00,21491.5,SELL,3,0.02h,Stop Loss,$105.75,$1605.75,$563864.00,354,$1605.75
2025-05-15,18:33:00,21435.0,BUY,3,0.02h,Stop Loss,$27.00,$1632.75,$563891.00,354,$1632.75
2025-05-15,18:48:00,21411.5,SELL,3,0.02h,Stop Loss,$83.25,$1716.00,$563974.25,354,$1716.00
2025-05-15,19:42:00,21375.5,BUY,3,0.02h,Stop Loss,$49.50,$1765.50,$564023.75,354,$1765.50
2025-05-15,20:28:00,21403.75,SELL,3,0.02h,Stop Loss,$-18.00,$1747.50,$564005.75,354,$1747.50
2025-05-15,22:29:00,21398.25,BUY,3,0.02h,Stop Loss,$-18.00,$1729.50,$563987.75,354,$1729.50
2025-05-15,22:43:00,21394.25,SELL,3,0.02h,Break Even,$0.75,$1730.25,$563988.50,354,$1730.25
2025-05-15,22:46:00,21399.5,BUY,3,0.02h,Stop Loss,$-18.00,$1712.25,$563970.50,354,$1712.25
2025-05-15,22:47:00,21393.0,SELL,3,0.02h,Break Even,$0.75,$1713.00,$563971.25,354,$1713.00
,,,,,,,,,,,
2025-05-16,12:00:00,21481.0,BUY,3,0.02h,Stop Loss,$38.25,$38.25,$564009.50,355,$38.25
2025-05-16,12:35:00,21470.0,SELL,3,0.02h,Break Even,$0.75,$39.00,$564010.25,355,$39.00
2025-05-16,13:09:00,21453.5,BUY,3,0.02h,Stop Loss,$45.75,$84.75,$564056.00,355,$84.75
2025-05-16,13:28:00,21446.5,SELL,3,0.02h,Stop Loss,$-18.00,$66.75,$564038.00,355,$66.75
2025-05-16,13:29:00,21479.5,BUY,3,0.02h,Stop Loss,$15.75,$82.50,$564053.75,355,$82.50
2025-05-16,13:31:00,21435.25,SELL,3,0.02h,Stop Loss,$210.75,$293.25,$564264.50,355,$293.25
2025-05-16,13:57:00,21443.75,BUY,3,0.02h,Stop Loss,$-18.00,$275.25,$564246.50,355,$275.25
2025-05-16,14:01:00,21408.5,SELL,3,0.02h,Stop Loss,$34.50,$309.75,$564281.00,355,$309.75
2025-05-16,14:18:00,21438.0,BUY,3,0.02h,Stop Loss,$207.00,$516.75,$564488.00,355,$516.75
2025-05-16,14:30:00,21412.75,SELL,3,0.02h,Stop Loss,$229.50,$746.25,$564717.50,355,$746.25
2025-05-16,14:56:00,21402.75,BUY,3,0.02h,Stop Loss,$-18.00,$728.25,$564699.50,355,$728.25
2025-05-16,15:22:00,21387.0,SELL,3,0.02h,Stop Loss,$105.75,$834.00,$564805.25,355,$834.00
2025-05-16,15:29:00,21398.25,BUY,3,0.02h,Break Even,$0.75,$834.75,$564806.00,355,$834.75
2025-05-16,15:58:00,21415.75,SELL,3,0.02h,Stop Loss,$72.00,$906.75,$564878.00,355,$906.75
2025-05-16,16:02:00,21427.5,BUY,3,0.02h,Stop Loss,$45.75,$952.50,$564923.75,355,$952.50
2025-05-16,16:35:00,21425.25,SELL,3,0.02h,Stop Loss,$-18.00,$934.50,$564905.75,355,$934.50
2025-05-16,16:55:00,21438.0,BUY,3,0.02h,Stop Loss,$79.50,$1014.00,$564985.25,355,$1014.00
2025-05-16,17:01:00,21423.75,SELL,3,0.02h,Stop Loss,$-18.00,$996.00,$564967.25,355,$996.00
2025-05-16,17:05:00,21437.5,BUY,3,0.02h,Stop Loss,$-18.00,$978.00,$564949.25,355,$978.00
2025-05-16,17:46:00,21457.75,SELL,3,0.02h,Stop Loss,$57.00,$1035.00,$565006.25,355,$1035.00
2025-05-16,18:14:00,21457.5,BUY,3,0.02h,Break Even,$0.75,$1035.75,$565007.00,355,$1035.75
2025-05-16,19:32:00,21488.75,SELL,3,0.02h,Break Even,$0.75,$1036.50,$565007.75,355,$1036.50
2025-05-16,19:50:00,21493.5,BUY,3,0.02h,Stop Loss,$135.75,$1172.25,$565143.50,355,$1172.25
2025-05-16,20:17:00,21493.0,SELL,3,0.02h,Break Even,$0.75,$1173.00,$565144.25,355,$1173.00
2025-05-16,20:22:00,21501.0,BUY,3,0.02h,Break Even,$0.75,$1173.75,$565145.00,355,$1173.75
2025-05-16,20:43:00,21489.25,SELL,3,0.02h,Break Even,$0.75,$1174.50,$565145.75,355,$1174.50
,,,,,,,,,,,
2025-05-19,12:43:00,21194.5,BUY,3,0.02h,Stop Loss,$53.25,$53.25,$565199.00,356,$53.25
2025-05-19,13:08:00,21196.25,SELL,3,0.02h,Break Even,$0.75,$54.00,$565199.75,356,$54.00
2025-05-19,13:12:00,21207.5,BUY,3,0.02h,Stop Loss,$49.50,$103.50,$565249.25,356,$103.50
2025-05-19,13:14:00,21181.0,SELL,3,0.02h,Stop Loss,$327.00,$430.50,$565576.25,356,$430.50
2025-05-19,13:29:00,21196.25,BUY,3,0.02h,Stop Loss,$68.25,$498.75,$565644.50,356,$498.75
2025-05-19,14:29:00,21394.75,SELL,3,0.02h,Stop Loss,$-18.00,$480.75,$565626.50,356,$480.75
2025-05-19,14:41:00,21427.0,BUY,3,0.02h,Break Even,$0.75,$481.50,$565627.25,356,$481.50
2025-05-19,14:49:00,21396.0,SELL,3,0.02h,Stop Loss,$150.75,$632.25,$565778.00,356,$632.25
2025-05-19,15:12:00,21422.0,BUY,3,0.02h,Stop Loss,$38.25,$670.50,$565816.25,356,$670.50
2025-05-19,15:27:00,21405.0,SELL,3,0.02h,Break Even,$0.75,$671.25,$565817.00,356,$671.25
2025-05-19,15:33:00,21426.0,BUY,3,0.02h,Stop Loss,$-18.00,$653.25,$565799.00,356,$653.25
2025-05-19,15:52:00,21424.5,SELL,3,0.02h,Stop Loss,$-18.00,$635.25,$565781.00,356,$635.25
2025-05-19,16:04:00,21440.25,BUY,3,0.02h,Stop Loss,$68.25,$703.50,$565849.25,356,$703.50
2025-05-19,16:43:00,21450.5,SELL,3,0.02h,Break Even,$0.75,$704.25,$565850.00,356,$704.25
2025-05-19,16:48:00,21461.75,BUY,3,0.02h,Stop Loss,$12.00,$716.25,$565862.00,356,$716.25
2025-05-19,17:33:00,21519.25,SELL,3,0.02h,Stop Loss,$19.50,$735.75,$565881.50,356,$735.75
2025-05-19,17:34:00,21530.75,BUY,3,0.02h,Stop Loss,$132.00,$867.75,$566013.50,356,$867.75
2025-05-19,17:41:00,21518.25,SELL,3,0.02h,Break Even,$0.75,$868.50,$566014.25,356,$868.50
2025-05-19,18:36:00,21483.5,BUY,3,0.02h,Stop Loss,$57.00,$925.50,$566071.25,356,$925.50
2025-05-19,18:48:00,21472.5,SELL,3,0.02h,Stop Loss,$23.25,$948.75,$566094.50,356,$948.75
2025-05-19,18:51:00,21483.0,BUY,3,0.02h,Stop Loss,$53.25,$1002.00,$566147.75,356,$1002.00
2025-05-19,19:11:00,21474.25,SELL,3,0.02h,Stop Loss,$-18.00,$984.00,$566129.75,356,$984.00
2025-05-19,19:39:00,21475.25,BUY,3,0.02h,Stop Loss,$30.75,$1014.75,$566160.50,356,$1014.75
2025-05-19,19:45:00,21462.5,SELL,3,0.02h,Break Even,$0.75,$1015.50,$566161.25,356,$1015.50
2025-05-19,19:46:00,21473.25,BUY,3,0.02h,Break Even,$0.75,$1016.25,$566162.00,356,$1016.25
2025-05-19,20:09:00,21486.75,SELL,3,0.02h,Stop Loss,$-18.00,$998.25,$566144.00,356,$998.25
2025-05-19,20:25:00,21492.25,BUY,3,0.02h,Stop Loss,$15.75,$1014.00,$566159.75,356,$1014.00
2025-05-19,22:03:00,21499.75,SELL,3,0.02h,Stop Loss,$-18.00,$996.00,$566141.75,356,$996.00
2025-05-19,22:10:00,21509.0,BUY,3,0.02h,Break Even,$0.75,$996.75,$566142.50,356,$996.75
2025-05-19,22:20:00,21506.25,SELL,3,0.02h,Break Even,$0.75,$997.50,$566143.25,356,$997.50
2025-05-19,22:22:00,21510.5,BUY,3,0.02h,Break Even,$0.75,$998.25,$566144.00,356,$998.25
2025-05-19,22:28:00,21505.0,SELL,3,0.02h,Break Even,$0.75,$999.00,$566144.75,356,$999.00
,,,,,,,,,,,
2025-05-20,13:02:00,21442.5,BUY,3,0.02h,Break Even,$0.75,$0.75,$566145.50,357,$0.75
2025-05-20,13:25:00,21431.0,SELL,3,0.02h,Stop Loss,$27.00,$27.75,$566172.50,357,$27.75
2025-05-20,14:19:00,21407.25,BUY,3,0.02h,Stop Loss,$53.25,$81.00,$566225.75,357,$81.00
2025-05-20,14:33:00,21388.0,SELL,3,0.02h,Stop Loss,$49.50,$130.50,$566275.25,357,$130.50
2025-05-20,14:36:00,21407.5,BUY,3,0.02h,Break Even,$0.75,$131.25,$566276.00,357,$131.25
2025-05-20,14:59:00,21410.25,SELL,3,0.02h,Stop Loss,$68.25,$199.50,$566344.25,357,$199.50
2025-05-20,15:18:00,21424.5,BUY,3,0.02h,Break Even,$0.75,$200.25,$566345.00,357,$200.25
2025-05-20,15:25:00,21408.5,SELL,3,0.02h,Stop Loss,$27.00,$227.25,$566372.00,357,$227.25
2025-05-20,15:28:00,21423.25,BUY,3,0.02h,Break Even,$0.75,$228.00,$566372.75,357,$228.00
2025-05-20,15:36:00,21414.5,SELL,3,0.02h,Stop Loss,$15.75,$243.75,$566388.50,357,$243.75
2025-05-20,15:51:00,21420.75,BUY,3,0.02h,Stop Loss,$-18.00,$225.75,$566370.50,357,$225.75
2025-05-20,16:11:00,21411.75,SELL,3,0.02h,Stop Loss,$83.25,$309.00,$566453.75,357,$309.00
2025-05-20,16:21:00,21430.25,BUY,3,0.02h,Break Even,$0.75,$309.75,$566454.50,357,$309.75
2025-05-20,16:25:00,21413.5,SELL,3,0.02h,Stop Loss,$75.75,$385.50,$566530.25,357,$385.50
2025-05-20,16:28:00,21434.75,BUY,3,0.02h,Stop Loss,$27.00,$412.50,$566557.25,357,$412.50
2025-05-20,17:18:00,21460.25,SELL,3,0.02h,Stop Loss,$34.50,$447.00,$566591.75,357,$447.00
2025-05-20,18:05:00,21435.5,BUY,3,0.02h,Break Even,$0.75,$447.75,$566592.50,357,$447.75
2025-05-20,18:17:00,21419.5,SELL,3,0.02h,Stop Loss,$49.50,$497.25,$566642.00,357,$497.25
2025-05-20,19:15:00,21354.5,BUY,3,0.02h,Stop Loss,$-18.00,$479.25,$566624.00,357,$479.25
2025-05-20,20:11:00,21407.0,SELL,3,0.02h,Stop Loss,$-18.00,$461.25,$566606.00,357,$461.25
2025-05-20,20:21:00,21423.75,BUY,3,0.02h,Break Even,$0.75,$462.00,$566606.75,357,$462.00
2025-05-20,20:41:00,21424.25,SELL,3,0.02h,Break Even,$0.75,$462.75,$566607.50,357,$462.75
2025-05-20,22:31:00,21385.25,BUY,3,0.02h,Stop Loss,$-18.00,$444.75,$566589.50,357,$444.75
,,,,,,,,,,,
2025-05-21,12:00:00,21339.5,SELL,3,0.02h,Stop Loss,$42.00,$42.00,$566631.50,358,$42.00
2025-05-21,12:28:00,21335.25,BUY,3,0.02h,Break Even,$0.75,$42.75,$566632.25,358,$42.75
2025-05-21,12:31:00,21303.75,SELL,3,0.02h,Stop Loss,$19.50,$62.25,$566651.75,358,$62.25
2025-05-21,12:58:00,21309.25,BUY,3,0.02h,Stop Loss,$45.75,$108.00,$566697.50,358,$108.00
2025-05-21,13:07:00,21300.25,SELL,3,0.02h,Stop Loss,$72.00,$180.00,$566769.50,358,$180.00
2025-05-21,13:32:00,21324.25,BUY,3,0.02h,Stop Loss,$162.00,$342.00,$566931.50,358,$342.00
2025-05-21,14:30:00,21383.25,SELL,3,0.02h,Stop Loss,$-18.00,$324.00,$566913.50,358,$324.00
2025-05-21,14:31:00,21404.0,BUY,3,0.02h,Stop Loss,$53.25,$377.25,$566966.75,358,$377.25
2025-05-21,14:34:00,21381.25,SELL,3,0.02h,Stop Loss,$75.75,$453.00,$567042.50,358,$453.00
2025-05-21,14:40:00,21403.75,BUY,3,0.02h,Stop Loss,$154.50,$607.50,$567197.00,358,$607.50
2025-05-21,14:47:00,21390.5,SELL,3,0.02h,Stop Loss,$102.00,$709.50,$567299.00,358,$709.50
2025-05-21,14:50:00,21403.75,BUY,3,0.02h,Stop Loss,$132.00,$841.50,$567431.00,358,$841.50
2025-05-21,15:39:00,21505.25,SELL,3,0.02h,Break Even,$0.75,$842.25,$567431.75,358,$842.25
2025-05-21,15:40:00,21512.0,BUY,3,0.02h,Stop Loss,$90.75,$933.00,$567522.50,358,$933.00
2025-05-21,16:22:00,21520.5,SELL,3,0.02h,Stop Loss,$38.25,$971.25,$567560.75,358,$971.25
2025-05-21,16:31:00,21538.25,BUY,3,0.02h,Break Even,$0.75,$972.00,$567561.50,358,$972.00
2025-05-21,16:57:00,21521.0,SELL,3,0.02h,Stop Loss,$-18.00,$954.00,$567543.50,358,$954.00
2025-05-21,18:31:00,21244.25,BUY,3,0.02h,Stop Loss,$214.50,$1168.50,$567758.00,358,$1168.50
2025-05-21,18:49:00,21233.0,SELL,3,0.02h,Stop Loss,$353.25,$1521.75,$568111.25,358,$1521.75
2025-05-21,19:34:00,21155.25,BUY,3,0.02h,Break Even,$0.75,$1522.50,$568112.00,358,$1522.50
2025-05-21,20:00:00,21150.25,SELL,3,0.02h,Stop Loss,$158.25,$1680.75,$568270.25,358,$1680.75
2025-05-21,20:34:00,21142.25,BUY,3,0.02h,Stop Loss,$30.75,$1711.50,$568301.00,358,$1711.50
2025-05-21,22:09:00,21122.5,SELL,3,0.02h,Stop Loss,$12.00,$1723.50,$568313.00,358,$1723.50
2025-05-21,22:25:00,21142.0,BUY,3,0.02h,Stop Loss,$-18.00,$1705.50,$568295.00,358,$1705.50
2025-05-21,22:46:00,21139.5,SELL,3,0.02h,Stop Loss,$45.75,$1751.25,$568340.75,358,$1751.25
2025-05-21,22:59:00,21148.0,BUY,3,0.02h,Break Even,$0.75,$1752.00,$568341.50,358,$1752.00
,,,,,,,,,,,
2025-05-22,12:00:00,21082.25,SELL,3,0.02h,Break Even,$0.75,$0.75,$568342.25,359,$0.75
2025-05-22,12:36:00,21092.5,BUY,3,0.02h,Stop Loss,$98.25,$99.00,$568440.50,359,$99.00
2025-05-22,13:20:00,21170.0,SELL,3,0.02h,Stop Loss,$19.50,$118.50,$568460.00,359,$118.50
2025-05-22,13:51:00,21199.75,BUY,3,0.02h,Stop Loss,$147.00,$265.50,$568607.00,359,$265.50
2025-05-22,14:20:00,21261.5,SELL,3,0.02h,Stop Loss,$150.75,$416.25,$568757.75,359,$416.25
2025-05-22,15:03:00,21240.5,BUY,3,0.02h,Stop Loss,$19.50,$435.75,$568777.25,359,$435.75
2025-05-22,15:17:00,21215.0,SELL,3,0.02h,Stop Loss,$64.50,$500.25,$568841.75,359,$500.25
2025-05-22,15:22:00,21256.25,BUY,3,0.02h,Break Even,$0.75,$501.00,$568842.50,359,$501.00
2025-05-22,15:30:00,21207.0,SELL,3,0.02h,Stop Loss,$98.25,$599.25,$568940.75,359,$599.25
2025-05-22,15:36:00,21249.75,BUY,3,0.02h,Break Even,$0.75,$600.00,$568941.50,359,$600.00
2025-05-22,15:37:00,21233.0,SELL,3,0.02h,Break Even,$0.75,$600.75,$568942.25,359,$600.75
2025-05-22,15:38:00,21242.0,BUY,3,0.02h,Stop Loss,$192.00,$792.75,$569134.25,359,$792.75
2025-05-22,16:26:00,21278.5,SELL,3,0.02h,Stop Loss,$184.50,$977.25,$569318.75,359,$977.25
2025-05-22,17:19:00,21240.75,BUY,3,0.02h,Break Even,$0.75,$978.00,$569319.50,359,$978.00
2025-05-22,18:31:00,21286.75,SELL,3,0.02h,Stop Loss,$-18.00,$960.00,$569301.50,359,$960.00
2025-05-22,18:34:00,21298.25,BUY,3,0.02h,Break Even,$0.75,$960.75,$569302.25,359,$960.75
2025-05-22,18:39:00,21286.25,SELL,3,0.02h,Stop Loss,$57.00,$1017.75,$569359.25,359,$1017.75
2025-05-22,18:53:00,21305.5,BUY,3,0.02h,Stop Loss,$-18.00,$999.75,$569341.25,359,$999.75
2025-05-22,19:22:00,21307.25,SELL,3,0.02h,Break Even,$0.75,$1000.50,$569342.00,359,$1000.50
2025-05-22,19:28:00,21326.0,BUY,3,0.02h,Break Even,$0.75,$1001.25,$569342.75,359,$1001.25
2025-05-22,19:34:00,21296.25,SELL,3,0.02h,Break Even,$0.75,$1002.00,$569343.50,359,$1002.00
2025-05-22,20:38:00,21191.0,BUY,3,0.02h,Break Even,$0.75,$1002.75,$569344.25,359,$1002.75
2025-05-22,22:14:00,21200.5,SELL,3,0.02h,Stop Loss,$-18.00,$984.75,$569326.25,359,$984.75
,,,,,,,,,,,
2025-05-23,12:36:00,20828.75,BUY,3,0.02h,Break Even,$0.75,$0.75,$569327.00,360,$0.75
2025-05-23,12:53:00,20797.25,SELL,3,0.02h,Stop Loss,$45.75,$46.50,$569372.75,360,$46.50
2025-05-23,13:12:00,20805.25,BUY,3,0.02h,Stop Loss,$-18.00,$28.50,$569354.75,360,$28.50
2025-05-23,13:14:00,20779.5,SELL,3,0.02h,Break Even,$0.75,$29.25,$569355.50,360,$29.25
2025-05-23,13:19:00,20794.0,BUY,3,0.02h,Stop Loss,$192.00,$221.25,$569547.50,360,$221.25
2025-05-23,13:22:00,20779.5,SELL,3,0.02h,Stop Loss,$12.00,$233.25,$569559.50,360,$233.25
2025-05-23,13:26:00,20816.75,BUY,3,0.02h,Stop Loss,$207.00,$440.25,$569766.50,360,$440.25
2025-05-23,13:54:00,20858.25,SELL,3,0.02h,Stop Loss,$105.75,$546.00,$569872.25,360,$546.00
2025-05-23,13:58:00,20877.0,BUY,3,0.02h,Stop Loss,$135.75,$681.75,$570008.00,360,$681.75
2025-05-23,14:52:00,20941.25,SELL,3,0.02h,Stop Loss,$135.75,$817.50,$570143.75,360,$817.50
2025-05-23,15:21:00,20942.75,BUY,3,0.02h,Stop Loss,$150.75,$968.25,$570294.50,360,$968.25
2025-05-23,15:53:00,20945.75,SELL,3,0.02h,Stop Loss,$42.00,$1010.25,$570336.50,360,$1010.25
2025-05-23,16:22:00,20962.0,BUY,3,0.02h,Stop Loss,$105.75,$1116.00,$570442.25,360,$1116.00
2025-05-23,16:34:00,20942.75,SELL,3,0.02h,Stop Loss,$45.75,$1161.75,$570488.00,360,$1161.75
2025-05-23,16:38:00,20978.75,BUY,3,0.02h,Stop Loss,$15.75,$1177.50,$570503.75,360,$1177.50
2025-05-23,17:41:00,21027.0,SELL,3,0.02h,Stop Loss,$-18.00,$1159.50,$570485.75,360,$1159.50
2025-05-23,17:52:00,21058.75,BUY,3,0.02h,Stop Loss,$162.00,$1321.50,$570647.75,360,$1321.50
2025-05-23,18:20:00,21041.75,SELL,3,0.02h,Stop Loss,$338.25,$1659.75,$570986.00,360,$1659.75
2025-05-23,18:36:00,21064.25,BUY,3,0.02h,Break Even,$0.75,$1660.50,$570986.75,360,$1660.50
2025-05-23,18:46:00,21041.75,SELL,3,0.02h,Stop Loss,$162.00,$1822.50,$571148.75,360,$1822.50
2025-05-23,18:56:00,21052.75,BUY,3,0.02h,Break Even,$0.75,$1823.25,$571149.50,360,$1823.25
2025-05-23,18:58:00,21042.0,SELL,3,0.02h,Stop Loss,$90.75,$1914.00,$571240.25,360,$1914.00
2025-05-23,19:11:00,21048.5,BUY,3,0.02h,Stop Loss,$233.25,$2147.25,$571473.50,360,$2147.25
2025-05-23,19:20:00,21028.75,SELL,3,0.02h,Stop Loss,$87.00,$2234.25,$571560.50,360,$2234.25
2025-05-23,19:38:00,21030.75,BUY,3,0.02h,Stop Loss,$150.75,$2385.00,$571711.25,360,$2385.00
2025-05-23,19:49:00,21013.75,SELL,3,0.02h,Stop Loss,$79.50,$2464.50,$571790.75,360,$2464.50
2025-05-23,20:58:00,20946.25,BUY,3,0.02h,Stop Loss,$128.25,$2592.75,$571919.00,360,$2592.75
,,,,,,,,,,,
2025-05-26,12:49:00,21267.75,SELL,3,0.02h,Break Even,$0.75,$0.75,$571919.75,361,$0.75
2025-05-26,12:53:00,21273.25,BUY,3,0.02h,Stop Loss,$-18.00,$-17.25,$571901.75,361,$-17.25
2025-05-26,12:59:00,21264.25,SELL,3,0.02h,Stop Loss,$19.50,$2.25,$571921.25,361,$2.25
2025-05-26,13:03:00,21277.25,BUY,3,0.02h,Stop Loss,$-18.00,$-15.75,$571903.25,361,$-15.75
2025-05-26,13:08:00,21268.5,SELL,3,0.02h,Stop Loss,$-18.00,$-33.75,$571885.25,361,$-33.75
2025-05-26,13:12:00,21278.0,BUY,3,0.02h,Break Even,$0.75,$-33.00,$571886.00,361,$-33.00
2025-05-26,13:21:00,21264.5,SELL,3,0.02h,Break Even,$0.75,$-32.25,$571886.75,361,$-32.25
2025-05-26,13:33:00,21288.25,BUY,3,0.02h,Stop Loss,$180.75,$148.50,$572067.50,361,$148.50
2025-05-26,13:56:00,21278.25,SELL,3,0.02h,Stop Loss,$12.00,$160.50,$572079.50,361,$160.50
2025-05-26,15:20:00,21236.75,BUY,3,0.02h,Stop Loss,$23.25,$183.75,$572102.75,361,$183.75
2025-05-26,16:26:00,21272.75,SELL,3,0.02h,Break Even,$0.75,$184.50,$572103.50,361,$184.50
2025-05-26,16:40:00,21277.5,BUY,3,0.02h,Stop Loss,$-18.00,$166.50,$572085.50,361,$166.50
2025-05-26,22:02:00,21270.5,SELL,3,0.02h,Stop Loss,$158.25,$324.75,$572243.75,361,$324.75
2025-05-26,22:17:00,21278.0,BUY,3,0.02h,Stop Loss,$-18.00,$306.75,$572225.75,361,$306.75
2025-05-26,22:20:00,21270.75,SELL,3,0.02h,Stop Loss,$105.75,$412.50,$572331.50,361,$412.50
,,,,,,,,,,,
2025-05-27,12:00:00,21297.0,BUY,3,0.02h,Break Even,$0.75,$0.75,$572332.25,362,$0.75
2025-05-27,12:41:00,21278.25,SELL,3,0.02h,Stop Loss,$45.75,$46.50,$572378.00,362,$46.50
2025-05-27,13:03:00,21281.75,BUY,3,0.02h,Break Even,$0.75,$47.25,$572378.75,362,$47.25
2025-05-27,13:28:00,21266.0,SELL,3,0.02h,Stop Loss,$90.75,$138.00,$572469.50,362,$138.00
2025-05-27,13:50:00,21265.75,BUY,3,0.02h,Stop Loss,$192.00,$330.00,$572661.50,362,$330.00
2025-05-27,14:57:00,21363.5,SELL,3,0.02h,Break Even,$0.75,$330.75,$572662.25,362,$330.75
2025-05-27,15:12:00,21373.75,BUY,3,0.02h,Break Even,$0.75,$331.50,$572663.00,362,$331.50
2025-05-27,15:42:00,21375.5,SELL,3,0.02h,Stop Loss,$-18.00,$313.50,$572645.00,362,$313.50
2025-05-27,15:46:00,21385.5,BUY,3,0.02h,Break Even,$0.75,$314.25,$572645.75,362,$314.25
2025-05-27,17:34:00,21448.5,SELL,3,0.02h,Break Even,$0.75,$315.00,$572646.50,362,$315.00
2025-05-27,17:41:00,21456.5,BUY,3,0.02h,Stop Loss,$19.50,$334.50,$572666.00,362,$334.50
2025-05-27,18:19:00,21467.25,SELL,3,0.02h,Stop Loss,$-18.00,$316.50,$572648.00,362,$316.50
2025-05-27,19:25:00,21444.25,BUY,3,0.02h,Stop Loss,$-18.00,$298.50,$572630.00,362,$298.50
2025-05-27,19:28:00,21437.75,SELL,3,0.02h,Break Even,$0.75,$299.25,$572630.75,362,$299.25
2025-05-27,19:43:00,21442.75,BUY,3,0.02h,Stop Loss,$-18.00,$281.25,$572612.75,362,$281.25
2025-05-27,19:50:00,21426.5,SELL,3,0.02h,Stop Loss,$117.00,$398.25,$572729.75,362,$398.25
2025-05-27,19:54:00,21436.0,BUY,3,0.02h,Stop Loss,$267.00,$665.25,$572996.75,362,$665.25
2025-05-27,20:34:00,21464.0,SELL,3,0.02h,Break Even,$0.75,$666.00,$572997.50,362,$666.00
2025-05-27,20:36:00,21468.25,BUY,3,0.02h,Stop Loss,$-18.00,$648.00,$572979.50,362,$648.00
2025-05-27,22:03:00,21466.5,SELL,3,0.02h,Stop Loss,$-18.00,$630.00,$572961.50,362,$630.00
2025-05-27,22:42:00,21464.0,BUY,3,0.02h,Stop Loss,$-18.00,$612.00,$572943.50,362,$612.00
,,,,,,,,,,,
2025-05-28,12:52:00,21507.75,SELL,3,0.02h,Break Even,$0.75,$0.75,$572944.25,363,$0.75
2025-05-28,13:14:00,21516.25,BUY,3,0.02h,Break Even,$0.75,$1.50,$572945.00,363,$1.50
2025-05-28,13:18:00,21503.0,SELL,3,0.02h,Stop Loss,$-18.00,$-16.50,$572927.00,363,$-16.50
2025-05-28,13:34:00,21511.75,BUY,3,0.02h,Stop Loss,$173.25,$156.75,$573100.25,363,$156.75
2025-05-28,13:49:00,21491.5,SELL,3,0.02h,Stop Loss,$143.25,$300.00,$573243.50,363,$300.00
2025-05-28,15:05:00,21467.0,BUY,3,0.02h,Break Even,$0.75,$300.75,$573244.25,363,$300.75
2025-05-28,15:15:00,21438.25,SELL,3,0.02h,Stop Loss,$-18.00,$282.75,$573226.25,363,$282.75
2025-05-28,15:18:00,21454.0,BUY,3,0.02h,Stop Loss,$57.00,$339.75,$573283.25,363,$339.75
2025-05-28,15:35:00,21451.75,SELL,3,0.02h,Stop Loss,$19.50,$359.25,$573302.75,363,$359.25
2025-05-28,15:54:00,21461.75,BUY,3,0.02h,Break Even,$0.75,$360.00,$573303.50,363,$360.00
2025-05-28,15:57:00,21447.0,SELL,3,0.02h,Break Even,$0.75,$360.75,$573304.25,363,$360.75
2025-05-28,16:04:00,21462.25,BUY,3,0.02h,Break Even,$0.75,$361.50,$573305.00,363,$361.50
2025-05-28,16:47:00,21467.75,SELL,3,0.02h,Stop Loss,$-18.00,$343.50,$573287.00,363,$343.50
2025-05-28,16:48:00,21474.0,BUY,3,0.02h,Stop Loss,$-18.00,$325.50,$573269.00,363,$325.50
2025-05-28,16:53:00,21458.0,SELL,3,0.02h,Stop Loss,$27.00,$352.50,$573296.00,363,$352.50
2025-05-28,17:04:00,21475.75,BUY,3,0.02h,Break Even,$0.75,$353.25,$573296.75,363,$353.25
2025-05-28,17:27:00,21469.5,SELL,3,0.02h,Break Even,$0.75,$354.00,$573297.50,363,$354.00
2025-05-28,17:56:00,21476.25,BUY,3,0.02h,Break Even,$0.75,$354.75,$573298.25,363,$354.75
2025-05-28,18:21:00,21473.25,SELL,3,0.02h,Break Even,$0.75,$355.50,$573299.00,363,$355.50
2025-05-28,18:34:00,21488.75,BUY,3,0.02h,Stop Loss,$-18.00,$337.50,$573281.00,363,$337.50
2025-05-28,18:50:00,21479.0,SELL,3,0.02h,Stop Loss,$12.00,$349.50,$573293.00,363,$349.50
2025-05-28,19:04:00,21480.75,BUY,3,0.02h,Stop Loss,$38.25,$387.75,$573331.25,363,$387.75
2025-05-28,19:18:00,21460.25,SELL,3,0.02h,Break Even,$0.75,$388.50,$573332.00,363,$388.50
2025-05-28,20:17:00,21393.75,BUY,3,0.02h,Break Even,$0.75,$389.25,$573332.75,363,$389.25
2025-05-28,22:32:00,21511.75,SELL,3,0.02h,Stop Loss,$-18.00,$371.25,$573314.75,363,$371.25
2025-05-28,22:33:00,21515.75,BUY,3,0.02h,Stop Loss,$-18.00,$353.25,$573296.75,363,$353.25
,,,,,,,,,,,
2025-05-29,12:42:00,21638.5,SELL,3,0.02h,Stop Loss,$105.75,$105.75,$573402.50,364,$105.75
2025-05-29,12:54:00,21660.75,BUY,3,0.02h,Stop Loss,$27.00,$132.75,$573429.50,364,$132.75
2025-05-29,12:59:00,21641.25,SELL,3,0.02h,Stop Loss,$-18.00,$114.75,$573411.50,364,$114.75
2025-05-29,13:06:00,21655.5,BUY,3,0.02h,Stop Loss,$109.50,$224.25,$573521.00,364,$224.25
2025-05-29,13:31:00,21649.5,SELL,3,0.02h,Stop Loss,$514.50,$738.75,$574035.50,364,$738.75
2025-05-29,14:31:00,21457.0,BUY,3,0.02h,Stop Loss,$192.00,$930.75,$574227.50,364,$930.75
2025-05-29,15:14:00,21477.0,SELL,3,0.02h,Stop Loss,$222.00,$1152.75,$574449.50,364,$1152.75
2025-05-29,15:27:00,21497.0,BUY,3,0.02h,Break Even,$0.75,$1153.50,$574450.25,364,$1153.50
2025-05-29,15:33:00,21447.25,SELL,3,0.02h,Stop Loss,$98.25,$1251.75,$574548.50,364,$1251.75
2025-05-29,16:16:00,21416.75,BUY,3,0.02h,Stop Loss,$90.75,$1342.50,$574639.25,364,$1342.50
2025-05-29,17:16:00,21440.75,SELL,3,0.02h,Stop Loss,$15.75,$1358.25,$574655.00,364,$1358.25
2025-05-29,18:14:00,21400.5,BUY,3,0.02h,Stop Loss,$15.75,$1374.00,$574670.75,364,$1374.00
2025-05-29,18:17:00,21380.25,SELL,3,0.02h,Stop Loss,$124.50,$1498.50,$574795.25,364,$1498.50
2025-05-29,18:37:00,21380.0,BUY,3,0.02h,Break Even,$0.75,$1499.25,$574796.00,364,$1499.25
2025-05-29,19:00:00,21362.75,SELL,3,0.02h,Stop Loss,$42.00,$1541.25,$574838.00,364,$1541.25
2025-05-29,19:05:00,21382.0,BUY,3,0.02h,Break Even,$0.75,$1542.00,$574838.75,364,$1542.00
2025-05-29,19:07:00,21356.0,SELL,3,0.02h,Stop Loss,$132.00,$1674.00,$574970.75,364,$1674.00
2025-05-29,19:21:00,21385.5,BUY,3,0.02h,Stop Loss,$87.00,$1761.00,$575057.75,364,$1761.00
2025-05-29,20:06:00,21376.5,SELL,3,0.02h,Stop Loss,$49.50,$1810.50,$575107.25,364,$1810.50
2025-05-29,20:20:00,21405.0,BUY,3,0.02h,Break Even,$0.75,$1811.25,$575108.00,364,$1811.25
2025-05-29,20:44:00,21396.0,SELL,3,0.02h,Stop Loss,$-18.00,$1793.25,$575090.00,364,$1793.25
2025-05-29,22:13:00,21389.0,BUY,3,0.02h,Stop Loss,$72.00,$1865.25,$575162.00,364,$1865.25
2025-05-29,22:18:00,21374.25,SELL,3,0.02h,Break Even,$0.75,$1866.00,$575162.75,364,$1866.00
,,,,,,,,,,,
2025-05-30,12:00:00,21388.0,BUY,3,0.02h,Break Even,$0.75,$0.75,$575163.50,365,$0.75
2025-05-30,12:12:00,21258.5,SELL,3,0.02h,Stop Loss,$98.25,$99.00,$575261.75,365,$99.00
2025-05-30,12:35:00,21351.0,BUY,3,0.02h,Stop Loss,$79.50,$178.50,$575341.25,365,$178.50
2025-05-30,12:59:00,21335.75,SELL,3,0.02h,Break Even,$0.75,$179.25,$575342.00,365,$179.25
2025-05-30,13:17:00,21360.25,BUY,3,0.02h,Break Even,$0.75,$180.00,$575342.75,365,$180.00
2025-05-30,13:34:00,21337.0,SELL,3,0.02h,Stop Loss,$87.00,$267.00,$575429.75,365,$267.00
2025-05-30,14:05:00,21322.75,BUY,3,0.02h,Stop Loss,$300.75,$567.75,$575730.50,365,$567.75
2025-05-30,14:52:00,21369.0,SELL,3,0.02h,Stop Loss,$180.75,$748.50,$575911.25,365,$748.50
2025-05-30,15:28:00,21368.0,BUY,3,0.02h,Break Even,$0.75,$749.25,$575912.00,365,$749.25
2025-05-30,15:35:00,21326.25,SELL,3,0.02h,Stop Loss,$109.50,$858.75,$576021.50,365,$858.75
2025-05-30,15:56:00,21344.0,BUY,3,0.02h,Break Even,$0.75,$859.50,$576022.25,365,$859.50
2025-05-30,16:02:00,21305.0,SELL,3,0.02h,Stop Loss,$79.50,$939.00,$576101.75,365,$939.00
2025-05-30,16:10:00,21334.25,BUY,3,0.02h,Break Even,$0.75,$939.75,$576102.50,365,$939.75
2025-05-30,16:17:00,21293.75,SELL,3,0.02h,Stop Loss,$248.25,$1188.00,$576350.75,365,$1188.00
2025-05-30,17:06:00,21143.25,BUY,3,0.02h,Stop Loss,$210.75,$1398.75,$576561.50,365,$1398.75
2025-05-30,19:46:00,21358.5,SELL,3,0.02h,Stop Loss,$147.00,$1545.75,$576708.50,365,$1545.75
2025-05-30,19:49:00,21382.25,BUY,3,0.02h,Stop Loss,$38.25,$1584.00,$576746.75,365,$1584.00
2025-05-30,20:04:00,21344.25,SELL,3,0.02h,Stop Loss,$-18.00,$1566.00,$576728.75,365,$1566.00
2025-05-30,20:21:00,21377.75,BUY,3,0.02h,Stop Loss,$34.50,$1600.50,$576763.25,365,$1600.50
2025-05-30,20:26:00,21359.25,SELL,3,0.02h,Stop Loss,$38.25,$1638.75,$576801.50,365,$1638.75
2025-05-30,20:58:00,21363.75,BUY,3,0.02h,Stop Loss,$23.25,$1662.00,$576824.75,365,$1662.00
,,,,,,,,,,,
2025-06-02,12:00:00,21256.0,SELL,3,0.02h,Break Even,$0.75,$0.75,$576825.50,366,$0.75
2025-06-02,12:41:00,21274.5,BUY,3,0.02h,Stop Loss,$34.50,$35.25,$576860.00,366,$35.25
2025-06-02,12:56:00,21267.0,SELL,3,0.02h,Break Even,$0.75,$36.00,$576860.75,366,$36.00
2025-06-02,12:59:00,21282.25,BUY,3,0.02h,Stop Loss,$12.00,$48.00,$576872.75,366,$48.00
2025-06-02,13:07:00,21266.75,SELL,3,0.02h,Stop Loss,$27.00,$75.00,$576899.75,366,$75.00
2025-06-02,13:27:00,21280.5,BUY,3,0.02h,Stop Loss,$49.50,$124.50,$576949.25,366,$124.50
2025-06-02,13:53:00,21325.0,SELL,3,0.02h,Stop Loss,$210.75,$335.25,$577160.00,366,$335.25
2025-06-02,14:19:00,21323.5,BUY,3,0.02h,Stop Loss,$195.75,$531.00,$577355.75,366,$531.00
2025-06-02,15:11:00,21369.75,SELL,3,0.02h,Stop Loss,$-18.00,$513.00,$577337.75,366,$513.00
2025-06-02,15:14:00,21404.5,BUY,3,0.02h,Stop Loss,$-18.00,$495.00,$577319.75,366,$495.00
2025-06-02,15:27:00,21368.5,SELL,3,0.02h,Stop Loss,$45.75,$540.75,$577365.50,366,$540.75
2025-06-02,15:42:00,21388.0,BUY,3,0.02h,Stop Loss,$30.75,$571.50,$577396.25,366,$571.50
2025-06-02,16:28:00,21415.25,SELL,3,0.02h,Stop Loss,$12.00,$583.50,$577408.25,366,$583.50
2025-06-02,16:35:00,21432.75,BUY,3,0.02h,Stop Loss,$49.50,$633.00,$577457.75,366,$633.00
2025-06-02,16:37:00,21420.0,SELL,3,0.02h,Break Even,$0.75,$633.75,$577458.50,366,$633.75
2025-06-02,16:39:00,21435.75,BUY,3,0.02h,Stop Loss,$-18.00,$615.75,$577440.50,366,$615.75
2025-06-02,16:42:00,21425.25,SELL,3,0.02h,Stop Loss,$68.25,$684.00,$577508.75,366,$684.00
2025-06-02,16:54:00,21439.25,BUY,3,0.02h,Stop Loss,$180.75,$864.75,$577689.50,366,$864.75
2025-06-02,17:23:00,21442.0,SELL,3,0.02h,Stop Loss,$-18.00,$846.75,$577671.50,366,$846.75
2025-06-02,18:00:00,21445.5,BUY,3,0.02h,Break Even,$0.75,$847.50,$577672.25,366,$847.50
2025-06-02,19:20:00,21512.0,SELL,3,0.02h,Stop Loss,$49.50,$897.00,$577721.75,366,$897.00
2025-06-02,19:22:00,21519.75,BUY,3,0.02h,Stop Loss,$42.00,$939.00,$577763.75,366,$939.00
2025-06-02,19:36:00,21515.25,SELL,3,0.02h,Break Even,$0.75,$939.75,$577764.50,366,$939.75
2025-06-02,19:52:00,21524.75,BUY,3,0.02h,Stop Loss,$-18.00,$921.75,$577746.50,366,$921.75
2025-06-02,19:53:00,21511.25,SELL,3,0.02h,Stop Loss,$90.75,$1012.50,$577837.25,366,$1012.50
2025-06-02,19:59:00,21525.5,BUY,3,0.02h,Stop Loss,$169.50,$1182.00,$578006.75,366,$1182.00
2025-06-02,20:35:00,21555.75,SELL,3,0.02h,Break Even,$0.75,$1182.75,$578007.50,366,$1182.75
,,,,,,,,,,,
2025-06-03,12:01:00,21530.0,BUY,3,0.02h,Stop Loss,$102.00,$102.00,$578109.50,367,$102.00
2025-06-03,12:05:00,21519.75,SELL,3,0.02h,Stop Loss,$75.75,$177.75,$578185.25,367,$177.75
2025-06-03,12:14:00,21524.75,BUY,3,0.02h,Stop Loss,$-18.00,$159.75,$578167.25,367,$159.75
2025-06-03,12:19:00,21517.0,SELL,3,0.02h,Stop Loss,$-18.00,$141.75,$578149.25,367,$141.75
2025-06-03,12:25:00,21527.25,BUY,3,0.02h,Break Even,$0.75,$142.50,$578150.00,367,$142.50
2025-06-03,12:38:00,21515.0,SELL,3,0.02h,Break Even,$0.75,$143.25,$578150.75,367,$143.25
2025-06-03,12:57:00,21528.75,BUY,3,0.02h,Break Even,$0.75,$144.00,$578151.50,367,$144.00
2025-06-03,13:37:00,21537.25,SELL,3,0.02h,Stop Loss,$75.75,$219.75,$578227.25,367,$219.75
2025-06-03,13:43:00,21569.75,BUY,3,0.02h,Break Even,$0.75,$220.50,$578228.00,367,$220.50
2025-06-03,14:35:00,21597.0,SELL,3,0.02h,Stop Loss,$147.00,$367.50,$578375.00,367,$367.50
2025-06-03,14:41:00,21609.25,BUY,3,0.02h,Break Even,$0.75,$368.25,$578375.75,367,$368.25
2025-06-03,15:39:00,21663.75,SELL,3,0.02h,Stop Loss,$-18.00,$350.25,$578357.75,367,$350.25
2025-06-03,15:40:00,21671.25,BUY,3,0.02h,Break Even,$0.75,$351.00,$578358.50,367,$351.00
2025-06-03,15:51:00,21662.5,SELL,3,0.02h,Stop Loss,$34.50,$385.50,$578393.00,367,$385.50
2025-06-03,15:56:00,21674.75,BUY,3,0.02h,Stop Loss,$53.25,$438.75,$578446.25,367,$438.75
2025-06-03,17:32:00,21743.0,SELL,3,0.02h,Break Even,$0.75,$439.50,$578447.00,367,$439.50
2025-06-03,18:27:00,21686.0,BUY,3,0.02h,Stop Loss,$154.50,$594.00,$578601.50,367,$594.00
2025-06-03,19:12:00,21696.5,SELL,3,0.02h,Stop Loss,$-18.00,$576.00,$578583.50,367,$576.00
2025-06-03,19:19:00,21710.0,BUY,3,0.02h,Break Even,$0.75,$576.75,$578584.25,367,$576.75
2025-06-03,19:41:00,21700.25,SELL,3,0.02h,Stop Loss,$23.25,$600.00,$578607.50,367,$600.00
2025-06-03,19:57:00,21714.75,BUY,3,0.02h,Stop Loss,$120.75,$720.75,$578728.25,367,$720.75
2025-06-03,20:02:00,21684.5,SELL,3,0.02h,Stop Loss,$34.50,$755.25,$578762.75,367,$755.25
2025-06-03,20:38:00,21683.0,BUY,3,0.02h,Break Even,$0.75,$756.00,$578763.50,367,$756.00
2025-06-03,22:51:00,21710.5,SELL,3,0.02h,Stop Loss,$-18.00,$738.00,$578745.50,367,$738.00
2025-06-03,22:52:00,21712.5,BUY,3,0.02h,Break Even,$0.75,$738.75,$578746.25,367,$738.75
2025-06-03,23:00:00,21709.25,SELL,3,13.00h,Stop Loss,$-18.00,$720.75,$578728.25,367,$720.75
,,,,,,,,,,,
2025-06-04,12:00:00,21747.25,BUY,3,0.02h,Stop Loss,$45.75,$45.75,$578774.00,368,$45.75
2025-06-04,12:17:00,21712.25,SELL,3,0.02h,Stop Loss,$75.75,$121.50,$578849.75,368,$121.50
2025-06-04,12:50:00,21702.0,BUY,3,0.02h,Break Even,$0.75,$122.25,$578850.50,368,$122.25
2025-06-04,13:54:00,21742.0,SELL,3,0.02h,Break Even,$0.75,$123.00,$578851.25,368,$123.00
2025-06-04,14:21:00,21728.75,BUY,3,0.02h,Stop Loss,$38.25,$161.25,$578889.50,368,$161.25
2025-06-04,14:25:00,21712.5,SELL,3,0.02h,Break Even,$0.75,$162.00,$578890.25,368,$162.00
2025-06-04,14:27:00,21731.75,BUY,3,0.02h,Stop Loss,$143.25,$305.25,$579033.50,368,$305.25
2025-06-04,14:44:00,21715.75,SELL,3,0.02h,Break Even,$0.75,$306.00,$579034.25,368,$306.00
2025-06-04,14:56:00,21738.0,BUY,3,0.02h,Stop Loss,$57.00,$363.00,$579091.25,368,$363.00
2025-06-04,15:29:00,21760.25,SELL,3,0.02h,Stop Loss,$68.25,$431.25,$579159.50,368,$431.25
2025-06-04,15:43:00,21764.75,BUY,3,0.02h,Stop Loss,$102.00,$533.25,$579261.50,368,$533.25
2025-06-04,15:45:00,21740.0,SELL,3,0.02h,Break Even,$0.75,$534.00,$579262.25,368,$534.00
2025-06-04,16:45:00,21734.5,BUY,3,0.02h,Stop Loss,$79.50,$613.50,$579341.75,368,$613.50
2025-06-04,17:40:00,21766.25,SELL,3,0.02h,Stop Loss,$147.00,$760.50,$579488.75,368,$760.50
2025-06-04,17:46:00,21776.0,BUY,3,0.02h,Break Even,$0.75,$761.25,$579489.50,368,$761.25
2025-06-04,18:27:00,21782.5,SELL,3,0.02h,Break Even,$0.75,$762.00,$579490.25,368,$762.00
2025-06-04,18:30:00,21796.0,BUY,3,0.02h,Stop Loss,$53.25,$815.25,$579543.50,368,$815.25
2025-06-04,18:50:00,21786.25,SELL,3,0.02h,Stop Loss,$173.25,$988.50,$579716.75,368,$988.50
2025-06-04,19:04:00,21792.0,BUY,3,0.02h,Break Even,$0.75,$989.25,$579717.50,368,$989.25
2025-06-04,19:10:00,21777.25,SELL,3,0.02h,Break Even,$0.75,$990.00,$579718.25,368,$990.00
2025-06-04,19:15:00,21792.5,BUY,3,0.02h,Break Even,$0.75,$990.75,$579719.00,368,$990.75
2025-06-04,19:18:00,21783.75,SELL,3,0.02h,Break Even,$0.75,$991.50,$579719.75,368,$991.50
2025-06-04,20:29:00,21761.0,BUY,3,0.02h,Stop Loss,$-18.00,$973.50,$579701.75,368,$973.50
2025-06-04,20:33:00,21758.25,SELL,3,0.02h,Stop Loss,$-18.00,$955.50,$579683.75,368,$955.50
2025-06-04,20:46:00,21763.0,BUY,3,0.02h,Stop Loss,$-18.00,$937.50,$579665.75,368,$937.50
2025-06-04,20:55:00,21751.0,SELL,3,0.02h,Stop Loss,$-18.00,$919.50,$579647.75,368,$919.50
2025-06-04,22:11:00,21754.0,BUY,3,0.02h,Break Even,$0.75,$920.25,$579648.50,368,$920.25
2025-06-04,22:46:00,21753.0,SELL,3,0.02h,Break Even,$0.75,$921.00,$579649.25,368,$921.00
,,,,,,,,,,,
2025-06-05,12:01:00,21767.25,BUY,3,0.02h,Stop Loss,$-18.00,$-18.00,$579631.25,369,$-18.00
2025-06-05,12:29:00,21767.5,SELL,3,0.02h,Stop Loss,$27.00,$9.00,$579658.25,369,$9.00
2025-06-05,12:39:00,21775.0,BUY,3,0.02h,Stop Loss,$-18.00,$-9.00,$579640.25,369,$-9.00
2025-06-05,12:49:00,21754.75,SELL,3,0.02h,Stop Loss,$-18.00,$-27.00,$579622.25,369,$-27.00
2025-06-05,12:50:00,21845.25,BUY,3,0.02h,Stop Loss,$120.75,$93.75,$579743.00,369,$93.75
2025-06-05,13:17:00,21794.0,SELL,3,0.02h,Break Even,$0.75,$94.50,$579743.75,369,$94.50
2025-06-05,13:21:00,21817.5,BUY,3,0.02h,Break Even,$0.75,$95.25,$579744.50,369,$95.25
2025-06-05,13:27:00,21806.5,SELL,3,0.02h,Stop Loss,$42.00,$137.25,$579786.50,369,$137.25
2025-06-05,13:29:00,21814.25,BUY,3,0.02h,Break Even,$0.75,$138.00,$579787.25,369,$138.00
2025-06-05,13:33:00,21792.0,SELL,3,0.02h,Stop Loss,$195.75,$333.75,$579983.00,369,$333.75
2025-06-05,14:22:00,21753.75,BUY,3,0.02h,Stop Loss,$60.75,$394.50,$580043.75,369,$394.50
2025-06-05,14:36:00,21727.25,SELL,3,0.02h,Stop Loss,$113.25,$507.75,$580157.00,369,$507.75
2025-06-05,14:38:00,21782.5,BUY,3,0.02h,Stop Loss,$357.00,$864.75,$580514.00,369,$864.75
2025-06-05,16:09:00,21901.5,SELL,3,0.02h,Stop Loss,$240.75,$1105.50,$580754.75,369,$1105.50
2025-06-05,17:13:00,21755.75,BUY,3,0.02h,Break Even,$0.75,$1106.25,$580755.50,369,$1106.25
2025-06-05,17:50:00,21767.0,SELL,3,0.02h,Stop Loss,$72.00,$1178.25,$580827.50,369,$1178.25
2025-06-05,18:28:00,21703.25,BUY,3,0.02h,Break Even,$0.75,$1179.00,$580828.25,369,$1179.00
2025-06-05,18:54:00,21699.5,SELL,3,0.02h,Break Even,$0.75,$1179.75,$580829.00,369,$1179.75
2025-06-05,19:35:00,21609.75,BUY,3,0.02h,Stop Loss,$162.00,$1341.75,$580991.00,369,$1341.75
2025-06-05,19:54:00,21597.5,SELL,3,0.02h,Stop Loss,$162.00,$1503.75,$581153.00,369,$1503.75
2025-06-05,22:19:00,21523.0,BUY,3,0.02h,Stop Loss,$15.75,$1519.50,$581168.75,369,$1519.50
,,,,,,,,,,,
2025-06-06,14:04:00,21821.5,SELL,3,0.02h,Stop Loss,$68.25,$68.25,$581237.00,370,$68.25
2025-06-06,14:08:00,21832.75,BUY,3,0.02h,Stop Loss,$120.75,$189.00,$581357.75,370,$189.00
2025-06-06,14:12:00,21817.25,SELL,3,0.02h,Stop Loss,$34.50,$223.50,$581392.25,370,$223.50
2025-06-06,14:16:00,21834.5,BUY,3,0.02h,Break Even,$0.75,$224.25,$581393.00,370,$224.25
2025-06-06,14:20:00,21818.5,SELL,3,0.02h,Break Even,$0.75,$225.00,$581393.75,370,$225.00
2025-06-06,14:41:00,21831.75,BUY,3,0.02h,Break Even,$0.75,$225.75,$581394.50,370,$225.75
2025-06-06,15:17:00,21821.75,SELL,3,0.02h,Stop Loss,$237.00,$462.75,$581631.50,370,$462.75
2025-06-06,15:45:00,21800.0,BUY,3,0.02h,Break Even,$0.75,$463.50,$581632.25,370,$463.50
2025-06-06,16:21:00,21807.0,SELL,3,0.02h,Stop Loss,$162.00,$625.50,$581794.25,370,$625.50
2025-06-06,17:17:00,21763.75,BUY,3,0.02h,Break Even,$0.75,$626.25,$581795.00,370,$626.25
2025-06-06,18:30:00,21844.0,SELL,3,0.02h,Stop Loss,$-18.00,$608.25,$581777.00,370,$608.25
2025-06-06,18:31:00,21850.25,BUY,3,0.02h,Stop Loss,$75.75,$684.00,$581852.75,370,$684.00
2025-06-06,18:42:00,21844.0,SELL,3,0.02h,Stop Loss,$94.50,$778.50,$581947.25,370,$778.50
2025-06-06,19:54:00,21809.0,BUY,3,0.02h,Stop Loss,$255.75,$1034.25,$582203.00,370,$1034.25
2025-06-06,19:57:00,21802.0,SELL,3,0.02h,Stop Loss,$-18.00,$1016.25,$582185.00,370,$1016.25
2025-06-06,20:17:00,21805.0,BUY,3,0.02h,Break Even,$0.75,$1017.00,$582185.75,370,$1017.00
2025-06-06,20:50:00,21804.75,SELL,3,0.02h,Stop Loss,$-18.00,$999.00,$582167.75,370,$999.00
2025-06-06,21:00:00,21809.75,BUY,3,63.00h,Stop Loss,$34.50,$1033.50,$582202.25,370,$1033.50
,,,,,,,,,,,
2025-06-09,12:04:00,21806.25,SELL,3,0.02h,Stop Loss,$-18.00,$-18.00,$582184.25,371,$-18.00
2025-06-09,12:22:00,21811.5,BUY,3,0.02h,Break Even,$0.75,$-17.25,$582185.00,371,$-17.25
2025-06-09,12:43:00,21807.5,SELL,3,0.02h,Break Even,$0.75,$-16.50,$582185.75,371,$-16.50
2025-06-09,12:44:00,21811.75,BUY,3,0.02h,Break Even,$0.75,$-15.75,$582186.50,371,$-15.75
2025-06-09,12:51:00,21803.75,SELL,3,0.02h,Break Even,$0.75,$-15.00,$582187.25,371,$-15.00
2025-06-09,13:07:00,21811.5,BUY,3,0.02h,Break Even,$0.75,$-14.25,$582188.00,371,$-14.25
2025-06-09,13:17:00,21798.5,SELL,3,0.02h,Break Even,$0.75,$-13.50,$582188.75,371,$-13.50
2025-06-09,13:24:00,21813.0,BUY,3,0.02h,Stop Loss,$-18.00,$-31.50,$582170.75,371,$-31.50
2025-06-09,13:30:00,21797.5,SELL,3,0.02h,Stop Loss,$53.25,$21.75,$582224.00,371,$21.75
2025-06-09,13:31:00,21808.75,BUY,3,0.02h,Stop Loss,$45.75,$67.50,$582269.75,371,$67.50
2025-06-09,13:32:00,21787.25,SELL,3,0.02h,Stop Loss,$72.00,$139.50,$582341.75,371,$139.50
2025-06-09,13:50:00,21804.0,BUY,3,0.02h,Stop Loss,$53.25,$192.75,$582395.00,371,$192.75
2025-06-09,14:47:00,21847.25,SELL,3,0.02h,Break Even,$0.75,$193.50,$582395.75,371,$193.50
2025-06-09,15:07:00,21858.0,BUY,3,0.02h,Stop Loss,$19.50,$213.00,$582415.25,371,$213.00
2025-06-09,15:17:00,21843.5,SELL,3,0.02h,Break Even,$0.75,$213.75,$582416.00,371,$213.75
2025-06-09,15:40:00,21840.75,BUY,3,0.02h,Stop Loss,$-18.00,$195.75,$582398.00,371,$195.75
2025-06-09,15:41:00,21832.75,SELL,3,0.02h,Break Even,$0.75,$196.50,$582398.75,371,$196.50
2025-06-09,15:53:00,21839.25,BUY,3,0.02h,Stop Loss,$27.00,$223.50,$582425.75,371,$223.50
2025-06-09,16:09:00,21822.25,SELL,3,0.02h,Stop Loss,$49.50,$273.00,$582475.25,371,$273.00
2025-06-09,16:24:00,21835.75,BUY,3,0.02h,Stop Loss,$38.25,$311.25,$582513.50,371,$311.25
2025-06-09,17:14:00,21862.75,SELL,3,0.02h,Break Even,$0.75,$312.00,$582514.25,371,$312.00
2025-06-09,17:38:00,21863.0,BUY,3,0.02h,Stop Loss,$12.00,$324.00,$582526.25,371,$324.00
2025-06-09,18:05:00,21862.5,SELL,3,0.02h,Stop Loss,$49.50,$373.50,$582575.75,371,$373.50
2025-06-09,18:23:00,21869.75,BUY,3,0.02h,Stop Loss,$-18.00,$355.50,$582557.75,371,$355.50
2025-06-09,18:33:00,21864.5,SELL,3,0.02h,Break Even,$0.75,$356.25,$582558.50,371,$356.25
2025-06-09,18:50:00,21863.25,BUY,3,0.02h,Break Even,$0.75,$357.00,$582559.25,371,$357.00
2025-06-09,19:15:00,21859.75,SELL,3,0.02h,Stop Loss,$12.00,$369.00,$582571.25,371,$369.00
2025-06-09,20:34:00,21809.75,BUY,3,0.02h,Stop Loss,$-18.00,$351.00,$582553.25,371,$351.00
2025-06-09,22:32:00,21829.75,SELL,3,0.02h,Stop Loss,$-18.00,$333.00,$582535.25,371,$333.00
,,,,,,,,,,,
2025-06-10,12:00:00,21857.25,BUY,3,0.02h,Stop Loss,$12.00,$12.00,$582547.25,372,$12.00
2025-06-10,12:34:00,21851.25,SELL,3,0.02h,Stop Loss,$-18.00,$-6.00,$582529.25,372,$-6.00
2025-06-10,12:42:00,21863.0,BUY,3,0.02h,Break Even,$0.75,$-5.25,$582530.00,372,$-5.25
2025-06-10,12:52:00,21850.0,SELL,3,0.02h,Break Even,$0.75,$-4.50,$582530.75,372,$-4.50
2025-06-10,13:03:00,21857.75,BUY,3,0.02h,Stop Loss,$-18.00,$-22.50,$582512.75,372,$-22.50
2025-06-10,13:04:00,21854.0,SELL,3,0.02h,Break Even,$0.75,$-21.75,$582513.50,372,$-21.75
2025-06-10,13:22:00,21854.75,BUY,3,0.02h,Break Even,$0.75,$-21.00,$582514.25,372,$-21.00
2025-06-10,13:25:00,21851.0,SELL,3,0.02h,Stop Loss,$105.75,$84.75,$582620.00,372,$84.75
2025-06-10,13:40:00,21881.25,BUY,3,0.02h,Stop Loss,$27.00,$111.75,$582647.00,372,$111.75
2025-06-10,13:59:00,21857.75,SELL,3,0.02h,Stop Loss,$45.75,$157.50,$582692.75,372,$157.50
2025-06-10,14:01:00,21865.75,BUY,3,0.02h,Stop Loss,$98.25,$255.75,$582791.00,372,$255.75
2025-06-10,14:05:00,21855.0,SELL,3,0.02h,Stop Loss,$-18.00,$237.75,$582773.00,372,$237.75
2025-06-10,14:06:00,21862.5,BUY,3,0.02h,Stop Loss,$15.75,$253.50,$582788.75,372,$253.50
2025-06-10,14:08:00,21857.75,SELL,3,0.02h,Stop Loss,$102.00,$355.50,$582890.75,372,$355.50
2025-06-10,14:12:00,21873.5,BUY,3,0.02h,Stop Loss,$72.00,$427.50,$582962.75,372,$427.50
2025-06-10,14:41:00,21862.75,SELL,3,0.02h,Break Even,$0.75,$428.25,$582963.50,372,$428.25
2025-06-10,14:45:00,21881.25,BUY,3,0.02h,Stop Loss,$-18.00,$410.25,$582945.50,372,$410.25
2025-06-10,14:56:00,21860.5,SELL,3,0.02h,Stop Loss,$27.00,$437.25,$582972.50,372,$437.25
2025-06-10,15:17:00,21874.0,BUY,3,0.02h,Stop Loss,$15.75,$453.00,$582988.25,372,$453.00
2025-06-10,15:25:00,21863.0,SELL,3,0.02h,Break Even,$0.75,$453.75,$582989.00,372,$453.75
2025-06-10,15:26:00,21871.5,BUY,3,0.02h,Break Even,$0.75,$454.50,$582989.75,372,$454.50
2025-06-10,15:27:00,21866.5,SELL,3,0.02h,Stop Loss,$87.00,$541.50,$583076.75,372,$541.50
2025-06-10,15:47:00,21845.75,BUY,3,0.02h,Stop Loss,$87.00,$628.50,$583163.75,372,$628.50
2025-06-10,16:46:00,21897.25,SELL,3,0.02h,Break Even,$0.75,$629.25,$583164.50,372,$629.25
2025-06-10,16:48:00,21901.5,BUY,3,0.02h,Stop Loss,$-18.00,$611.25,$583146.50,372,$611.25
2025-06-10,16:49:00,21898.0,SELL,3,0.02h,Stop Loss,$12.00,$623.25,$583158.50,372,$623.25
2025-06-10,16:51:00,21904.25,BUY,3,0.02h,Stop Loss,$83.25,$706.50,$583241.75,372,$706.50
2025-06-10,17:04:00,21899.75,SELL,3,0.02h,Break Even,$0.75,$707.25,$583242.50,372,$707.25
2025-06-10,17:10:00,21909.5,BUY,3,0.02h,Stop Loss,$105.75,$813.00,$583348.25,372,$813.00
2025-06-10,17:27:00,21899.75,SELL,3,0.02h,Break Even,$0.75,$813.75,$583349.00,372,$813.75
2025-06-10,18:20:00,21873.75,BUY,3,0.02h,Break Even,$0.75,$814.50,$583349.75,372,$814.50
2025-06-10,19:32:00,21952.5,SELL,3,0.02h,Stop Loss,$57.00,$871.50,$583406.75,372,$871.50
2025-06-10,19:57:00,21958.0,BUY,3,0.02h,Break Even,$0.75,$872.25,$583407.50,372,$872.25
2025-06-10,20:07:00,21940.5,SELL,3,0.02h,Break Even,$0.75,$873.00,$583408.25,372,$873.00
2025-06-10,20:19:00,21964.25,BUY,3,0.02h,Stop Loss,$34.50,$907.50,$583442.75,372,$907.50
2025-06-10,20:34:00,21948.75,SELL,3,0.02h,Stop Loss,$-18.00,$889.50,$583424.75,372,$889.50
2025-06-10,20:37:00,21954.25,BUY,3,0.02h,Stop Loss,$-18.00,$871.50,$583406.75,372,$871.50
2025-06-10,20:51:00,21949.25,SELL,3,0.02h,Break Even,$0.75,$872.25,$583407.50,372,$872.25
2025-06-10,20:58:00,21953.0,BUY,3,0.02h,Stop Loss,$-18.00,$854.25,$583389.50,372,$854.25
2025-06-10,22:05:00,21950.5,SELL,3,0.02h,Break Even,$0.75,$855.00,$583390.25,372,$855.00
2025-06-10,22:07:00,21954.75,BUY,3,0.02h,Break Even,$0.75,$855.75,$583391.00,372,$855.75
2025-06-10,22:31:00,21947.75,SELL,3,0.02h,Break Even,$0.75,$856.50,$583391.75,372,$856.50
2025-06-10,22:43:00,21954.0,BUY,3,0.02h,Stop Loss,$-18.00,$838.50,$583373.75,372,$838.50
2025-06-10,22:48:00,21951.0,SELL,3,0.02h,Break Even,$0.75,$839.25,$583374.50,372,$839.25
2025-06-10,22:54:00,21967.75,BUY,3,0.02h,Stop Loss,$188.25,$1027.50,$583562.75,372,$1027.50
,,,,,,,,,,,
2025-06-11,12:01:00,21935.0,SELL,3,0.02h,Break Even,$0.75,$0.75,$583563.50,373,$0.75
2025-06-11,12:29:00,21948.75,BUY,3,0.02h,Stop Loss,$64.50,$65.25,$583628.00,373,$65.25
2025-06-11,12:54:00,22020.75,SELL,3,0.02h,Break Even,$0.75,$66.00,$583628.75,373,$66.00
2025-06-11,13:13:00,22033.5,BUY,3,0.02h,Break Even,$0.75,$66.75,$583629.50,373,$66.75
2025-06-11,13:15:00,22024.0,SELL,3,0.02h,Stop Loss,$42.00,$108.75,$583671.50,373,$108.75
2025-06-11,13:20:00,22030.5,BUY,3,0.02h,Stop Loss,$-18.00,$90.75,$583653.50,373,$90.75
2025-06-11,13:24:00,22021.25,SELL,3,0.02h,Break Even,$0.75,$91.50,$583654.25,373,$91.50
2025-06-11,13:56:00,21993.5,BUY,3,0.02h,Break Even,$0.75,$92.25,$583655.00,373,$92.25
2025-06-11,15:10:00,21999.25,SELL,3,0.02h,Stop Loss,$154.50,$246.75,$583809.50,373,$246.75
2025-06-11,16:30:00,21978.25,BUY,3,0.02h,Stop Loss,$68.25,$315.00,$583877.75,373,$315.00
2025-06-11,16:43:00,21961.25,SELL,3,0.02h,Break Even,$0.75,$315.75,$583878.50,373,$315.75
2025-06-11,16:44:00,21973.5,BUY,3,0.02h,Stop Loss,$-18.00,$297.75,$583860.50,373,$297.75
2025-06-11,16:45:00,21964.75,SELL,3,0.02h,Stop Loss,$60.75,$358.50,$583921.25,373,$358.50
2025-06-11,16:47:00,21973.0,BUY,3,0.02h,Stop Loss,$72.00,$430.50,$583993.25,373,$430.50
2025-06-11,17:35:00,21996.0,SELL,3,0.02h,Stop Loss,$12.00,$442.50,$584005.25,373,$442.50
2025-06-11,18:34:00,21879.5,BUY,3,0.02h,Stop Loss,$60.75,$503.25,$584066.00,373,$503.25
2025-06-11,18:57:00,21855.75,SELL,3,0.02h,Stop Loss,$53.25,$556.50,$584119.25,373,$556.50
2025-06-11,19:26:00,21871.0,BUY,3,0.02h,Break Even,$0.75,$557.25,$584120.00,373,$557.25
2025-06-11,19:33:00,21844.25,SELL,3,0.02h,Stop Loss,$109.50,$666.75,$584229.50,373,$666.75
2025-06-11,19:41:00,21863.0,BUY,3,0.02h,Stop Loss,$42.00,$708.75,$584271.50,373,$708.75
2025-06-11,20:35:00,21890.5,SELL,3,0.02h,Stop Loss,$57.00,$765.75,$584328.50,373,$765.75
2025-06-11,22:23:00,21875.25,BUY,3,0.02h,Break Even,$0.75,$766.50,$584329.25,373,$766.50
2025-06-11,22:43:00,21878.0,SELL,3,0.02h,Stop Loss,$-18.00,$748.50,$584311.25,373,$748.50
,,,,,,,,,,,
2025-06-12,12:00:00,21966.5,BUY,3,0.02h,Stop Loss,$-18.00,$-18.00,$584293.25,374,$-18.00
2025-06-12,12:01:00,21744.0,SELL,3,0.02h,Break Even,$0.75,$-17.25,$584294.00,374,$-17.25
2025-06-12,12:04:00,21975.0,BUY,3,0.02h,Stop Loss,$-18.00,$-35.25,$584276.00,374,$-35.25
2025-06-12,12:05:00,21748.0,SELL,3,0.02h,Break Even,$0.75,$-34.50,$584276.75,374,$-34.50
2025-06-12,12:14:00,21996.5,BUY,3,0.02h,Stop Loss,$-18.00,$-52.50,$584258.75,374,$-52.50
2025-06-12,12:15:00,21769.75,SELL,3,0.02h,Stop Loss,$-18.00,$-70.50,$584240.75,374,$-70.50
2025-06-12,12:16:00,21989.0,BUY,3,0.02h,Stop Loss,$-18.00,$-88.50,$584222.75,374,$-88.50
2025-06-12,12:20:00,21771.5,SELL,3,0.02h,Stop Loss,$-18.00,$-106.50,$584204.75,374,$-106.50
2025-06-12,12:21:00,21988.5,BUY,3,0.02h,Stop Loss,$49.50,$-57.00,$584254.25,374,$-57.00
2025-06-12,12:30:00,21762.0,SELL,3,0.02h,Stop Loss,$-18.00,$-75.00,$584236.25,374,$-75.00
2025-06-12,12:31:00,21999.75,BUY,3,0.02h,Stop Loss,$-18.00,$-93.00,$584218.25,374,$-93.00
2025-06-12,12:32:00,21775.75,SELL,3,0.02h,Break Even,$0.75,$-92.25,$584219.00,374,$-92.25
2025-06-12,12:34:00,22008.25,BUY,3,0.02h,Stop Loss,$-18.00,$-110.25,$584201.00,374,$-110.25
2025-06-12,12:35:00,21795.25,SELL,3,0.02h,Stop Loss,$-18.00,$-128.25,$584183.00,374,$-128.25
2025-06-12,12:36:00,22022.25,BUY,3,0.02h,Stop Loss,$387.00,$258.75,$584570.00,374,$258.75
2025-06-12,12:45:00,21839.75,SELL,3,0.02h,Stop Loss,$60.75,$319.50,$584630.75,374,$319.50
2025-06-12,12:49:00,22062.0,BUY,3,0.02h,Stop Loss,$-18.00,$301.50,$584612.75,374,$301.50
2025-06-12,12:50:00,21832.25,SELL,3,0.02h,Stop Loss,$-18.00,$283.50,$584594.75,374,$283.50
2025-06-12,12:51:00,22050.75,BUY,3,0.02h,Stop Loss,$15.75,$299.25,$584610.50,374,$299.25
2025-06-12,12:54:00,21833.5,SELL,3,0.02h,Break Even,$0.75,$300.00,$584611.25,374,$300.00
2025-06-12,12:57:00,22065.0,BUY,3,0.02h,Stop Loss,$-18.00,$282.00,$584593.25,374,$282.00
2025-06-12,12:58:00,21838.25,SELL,3,0.02h,Stop Loss,$-18.00,$264.00,$584575.25,374,$264.00
2025-06-12,12:59:00,22066.75,BUY,3,0.02h,Stop Loss,$-18.00,$246.00,$584557.25,374,$246.00
2025-06-12,13:08:00,21832.5,SELL,3,0.02h,Stop Loss,$-18.00,$228.00,$584539.25,374,$228.00
2025-06-12,13:09:00,22056.5,BUY,3,0.02h,Break Even,$0.75,$228.75,$584540.00,374,$228.75
2025-06-12,13:12:00,21841.75,SELL,3,0.02h,Stop Loss,$-18.00,$210.75,$584522.00,374,$210.75
2025-06-12,13:13:00,22066.0,BUY,3,0.02h,Stop Loss,$-18.00,$192.75,$584504.00,374,$192.75
2025-06-12,13:14:00,21839.25,SELL,3,0.02h,Stop Loss,$15.75,$208.50,$584519.75,374,$208.50
2025-06-12,13:16:00,22056.75,BUY,3,0.02h,Stop Loss,$-18.00,$190.50,$584501.75,374,$190.50
2025-06-12,13:20:00,21838.0,SELL,3,0.02h,Stop Loss,$-18.00,$172.50,$584483.75,374,$172.50
2025-06-12,13:21:00,22053.5,BUY,3,0.02h,Stop Loss,$-18.00,$154.50,$584465.75,374,$154.50
2025-06-12,13:22:00,21832.75,SELL,3,0.02h,Stop Loss,$-18.00,$136.50,$584447.75,374,$136.50
2025-06-12,13:23:00,22060.0,BUY,3,0.02h,Stop Loss,$-18.00,$118.50,$584429.75,374,$118.50
2025-06-12,13:24:00,21832.5,SELL,3,0.02h,Stop Loss,$49.50,$168.00,$584479.25,374,$168.00
2025-06-12,13:29:00,22051.25,BUY,3,0.02h,Stop Loss,$-18.00,$150.00,$584461.25,374,$150.00
2025-06-12,13:30:00,21829.0,SELL,3,0.02h,Stop Loss,$-18.00,$132.00,$584443.25,374,$132.00
2025-06-12,13:31:00,22086.5,BUY,3,0.02h,Stop Loss,$105.75,$237.75,$584549.00,374,$237.75
2025-06-12,13:44:00,21876.75,SELL,3,0.02h,Stop Loss,$53.25,$291.00,$584602.25,374,$291.00
2025-06-12,13:48:00,22102.5,BUY,3,0.02h,Stop Loss,$-18.00,$273.00,$584584.25,374,$273.00
2025-06-12,13:49:00,21883.75,SELL,3,0.02h,Stop Loss,$-18.00,$255.00,$584566.25,374,$255.00
2025-06-12,13:50:00,22110.5,BUY,3,0.02h,Stop Loss,$-18.00,$237.00,$584548.25,374,$237.00
2025-06-12,13:51:00,21877.75,SELL,3,0.02h,Stop Loss,$-18.00,$219.00,$584530.25,374,$219.00
2025-06-12,13:52:00,22101.0,BUY,3,0.02h,Stop Loss,$87.00,$306.00,$584617.25,374,$306.00
2025-06-12,13:56:00,21850.25,SELL,3,0.02h,Break Even,$0.75,$306.75,$584618.00,374,$306.75
2025-06-12,14:05:00,22079.5,BUY,3,0.02h,Stop Loss,$-18.00,$288.75,$584600.00,374,$288.75
2025-06-12,14:06:00,21852.5,SELL,3,0.02h,Break Even,$0.75,$289.50,$584600.75,374,$289.50
2025-06-12,14:08:00,22116.25,BUY,3,0.02h,Stop Loss,$-18.00,$271.50,$584582.75,374,$271.50
2025-06-12,14:09:00,21898.25,SELL,3,0.02h,Stop Loss,$120.75,$392.25,$584703.50,374,$392.25
2025-06-12,14:12:00,22117.75,BUY,3,0.02h,Stop Loss,$150.75,$543.00,$584854.25,374,$543.00
2025-06-12,14:16:00,21920.75,SELL,3,0.02h,Stop Loss,$117.00,$660.00,$584971.25,374,$660.00
2025-06-12,14:21:00,22140.0,BUY,3,0.02h,Stop Loss,$-18.00,$642.00,$584953.25,374,$642.00
2025-06-12,14:35:00,21921.25,SELL,3,0.02h,Stop Loss,$-18.00,$624.00,$584935.25,374,$624.00
2025-06-12,14:36:00,22141.75,BUY,3,0.02h,Stop Loss,$-18.00,$606.00,$584917.25,374,$606.00
2025-06-12,14:46:00,21941.0,SELL,3,0.02h,Stop Loss,$-18.00,$588.00,$584899.25,374,$588.00
2025-06-12,14:47:00,22165.0,BUY,3,0.02h,Break Even,$0.75,$588.75,$584900.00,374,$588.75
2025-06-12,14:49:00,21943.5,SELL,3,0.02h,Stop Loss,$-18.00,$570.75,$584882.00,374,$570.75
2025-06-12,14:53:00,22160.5,BUY,3,0.02h,Stop Loss,$-18.00,$552.75,$584864.00,374,$552.75
2025-06-12,14:54:00,21937.25,SELL,3,0.02h,Break Even,$0.75,$553.50,$584864.75,374,$553.50
2025-06-12,15:00:00,22159.5,BUY,3,0.02h,Stop Loss,$90.75,$644.25,$584955.50,374,$644.25
2025-06-12,15:10:00,21952.75,SELL,3,0.02h,Stop Loss,$-18.00,$626.25,$584937.50,374,$626.25
2025-06-12,15:11:00,22173.0,BUY,3,0.02h,Stop Loss,$-18.00,$608.25,$584919.50,374,$608.25
2025-06-12,15:12:00,21954.5,SELL,3,0.02h,Stop Loss,$34.50,$642.75,$584954.00,374,$642.75
2025-06-12,15:19:00,22145.25,BUY,3,0.02h,Stop Loss,$109.50,$752.25,$585063.50,374,$752.25
2025-06-12,15:24:00,21919.75,SELL,3,0.02h,Stop Loss,$282.00,$1034.25,$585345.50,374,$1034.25
2025-06-12,15:35:00,22135.25,BUY,3,0.02h,Stop Loss,$117.00,$1151.25,$585462.50,374,$1151.25
2025-06-12,15:43:00,21920.0,SELL,3,0.02h,Stop Loss,$-18.00,$1133.25,$585444.50,374,$1133.25
2025-06-12,15:44:00,22150.0,BUY,3,0.02h,Stop Loss,$-18.00,$1115.25,$585426.50,374,$1115.25
2025-06-12,15:49:00,21905.0,SELL,3,0.02h,Stop Loss,$-18.00,$1097.25,$585408.50,374,$1097.25
2025-06-12,15:50:00,22130.5,BUY,3,0.02h,Break Even,$0.75,$1098.00,$585409.25,374,$1098.00
2025-06-12,15:53:00,21910.0,SELL,3,0.02h,Stop Loss,$-18.00,$1080.00,$585391.25,374,$1080.00
2025-06-12,15:54:00,22136.25,BUY,3,0.02h,Stop Loss,$-18.00,$1062.00,$585373.25,374,$1062.00
2025-06-12,15:55:00,21914.75,SELL,3,0.02h,Break Even,$0.75,$1062.75,$585374.00,374,$1062.75
2025-06-12,15:58:00,22137.0,BUY,3,0.02h,Stop Loss,$-18.00,$1044.75,$585356.00,374,$1044.75
2025-06-12,15:59:00,21924.0,SELL,3,0.02h,Stop Loss,$-18.00,$1026.75,$585338.00,374,$1026.75
2025-06-12,16:00:00,22148.5,BUY,3,0.02h,Stop Loss,$132.00,$1158.75,$585470.00,374,$1158.75
2025-06-12,16:10:00,21932.5,SELL,3,0.02h,Stop Loss,$-18.00,$1140.75,$585452.00,374,$1140.75
2025-06-12,16:11:00,22155.0,BUY,3,0.02h,Stop Loss,$128.25,$1269.00,$585580.25,374,$1269.00
2025-06-12,16:13:00,21940.75,SELL,3,0.02h,Stop Loss,$45.75,$1314.75,$585626.00,374,$1314.75
2025-06-12,16:19:00,22161.0,BUY,3,0.02h,Stop Loss,$-18.00,$1296.75,$585608.00,374,$1296.75
2025-06-12,16:20:00,21940.75,SELL,3,0.02h,Stop Loss,$-18.00,$1278.75,$585590.00,374,$1278.75
2025-06-12,16:21:00,22171.0,BUY,3,0.02h,Stop Loss,$-18.00,$1260.75,$585572.00,374,$1260.75
2025-06-12,16:33:00,21937.25,SELL,3,0.02h,Break Even,$0.75,$1261.50,$585572.75,374,$1261.50
2025-06-12,16:37:00,22175.0,BUY,3,0.02h,Stop Loss,$-18.00,$1243.50,$585554.75,374,$1243.50
2025-06-12,16:38:00,21942.75,SELL,3,0.02h,Stop Loss,$-18.00,$1225.50,$585536.75,374,$1225.50
2025-06-12,16:56:00,22153.75,BUY,3,0.03h,Stop Loss,$-18.00,$1207.50,$585518.75,374,$1207.50
2025-06-12,16:59:00,21930.0,SELL,3,0.02h,Stop Loss,$109.50,$1317.00,$585628.25,374,$1317.00
2025-06-12,17:03:00,22163.0,BUY,3,0.02h,Stop Loss,$90.75,$1407.75,$585719.00,374,$1407.75
2025-06-12,17:10:00,21948.75,SELL,3,0.02h,Break Even,$0.75,$1408.50,$585719.75,374,$1408.50
2025-06-12,17:14:00,22173.75,BUY,3,0.02h,Stop Loss,$-18.00,$1390.50,$585701.75,374,$1390.50
2025-06-12,17:18:00,21946.25,SELL,3,0.02h,Stop Loss,$-18.00,$1372.50,$585683.75,374,$1372.50
2025-06-12,17:19:00,22178.0,BUY,3,0.03h,Stop Loss,$-18.00,$1354.50,$585665.75,374,$1354.50
2025-06-12,17:28:00,21944.75,SELL,3,0.02h,Stop Loss,$105.75,$1460.25,$585771.50,374,$1460.25
2025-06-12,17:33:00,22189.0,BUY,3,0.02h,Stop Loss,$-18.00,$1442.25,$585753.50,374,$1442.25
2025-06-12,17:34:00,21960.0,SELL,3,0.02h,Stop Loss,$-18.00,$1424.25,$585735.50,374,$1424.25
2025-06-12,17:44:00,22182.5,BUY,3,0.02h,Stop Loss,$-18.00,$1406.25,$585717.50,374,$1406.25
2025-06-12,17:45:00,21953.5,SELL,3,0.02h,Stop Loss,$79.50,$1485.75,$585797.00,374,$1485.75
2025-06-12,17:48:00,22177.5,BUY,3,0.02h,Stop Loss,$-18.00,$1467.75,$585779.00,374,$1467.75
2025-06-12,17:49:00,21943.25,SELL,3,0.02h,Break Even,$0.75,$1468.50,$585779.75,374,$1468.50
2025-06-12,17:51:00,22174.25,BUY,3,0.02h,Stop Loss,$-18.00,$1450.50,$585761.75,374,$1450.50
2025-06-12,17:52:00,21946.75,SELL,3,0.02h,Stop Loss,$-18.00,$1432.50,$585743.75,374,$1432.50
2025-06-12,17:53:00,22172.0,BUY,3,0.02h,Stop Loss,$-18.00,$1414.50,$585725.75,374,$1414.50
2025-06-12,17:54:00,21944.25,SELL,3,0.02h,Stop Loss,$15.75,$1430.25,$585741.50,374,$1430.25
2025-06-12,18:00:00,22161.0,BUY,3,0.02h,Stop Loss,$-18.00,$1412.25,$585723.50,374,$1412.25
2025-06-12,18:01:00,21938.75,SELL,3,0.02h,Break Even,$0.75,$1413.00,$585724.25,374,$1413.00
2025-06-12,18:03:00,22162.0,BUY,3,0.02h,Stop Loss,$-18.00,$1395.00,$585706.25,374,$1395.00
2025-06-12,18:06:00,21942.5,SELL,3,0.02h,Break Even,$0.75,$1395.75,$585707.00,374,$1395.75
2025-06-12,18:11:00,22169.75,BUY,3,0.02h,Stop Loss,$-18.00,$1377.75,$585689.00,374,$1377.75
2025-06-12,18:12:00,21945.25,SELL,3,0.02h,Break Even,$0.75,$1378.50,$585689.75,374,$1378.50
2025-06-12,18:16:00,22166.75,BUY,3,0.02h,Stop Loss,$-18.00,$1360.50,$585671.75,374,$1360.50
2025-06-12,18:34:00,21923.25,SELL,3,0.02h,Stop Loss,$38.25,$1398.75,$585710.00,374,$1398.75
2025-06-12,18:53:00,22153.75,BUY,3,0.02h,Stop Loss,$-18.00,$1380.75,$585692.00,374,$1380.75
2025-06-12,18:54:00,21929.0,SELL,3,0.02h,Break Even,$0.75,$1381.50,$585692.75,374,$1381.50
2025-06-12,18:59:00,22157.5,BUY,3,0.03h,Stop Loss,$12.00,$1393.50,$585704.75,374,$1393.50
2025-06-12,19:02:00,21935.5,SELL,3,0.02h,Stop Loss,$-18.00,$1375.50,$585686.75,374,$1375.50
2025-06-12,19:04:00,22167.75,BUY,3,0.02h,Stop Loss,$-18.00,$1357.50,$585668.75,374,$1357.50
2025-06-12,19:09:00,21939.75,SELL,3,0.02h,Stop Loss,$-18.00,$1339.50,$585650.75,374,$1339.50
2025-06-12,19:11:00,22166.25,BUY,3,0.02h,Stop Loss,$-18.00,$1321.50,$585632.75,374,$1321.50
2025-06-12,19:12:00,21939.0,SELL,3,0.02h,Stop Loss,$-18.00,$1303.50,$585614.75,374,$1303.50
2025-06-12,19:13:00,22163.75,BUY,3,0.02h,Stop Loss,$-18.00,$1285.50,$585596.75,374,$1285.50
2025-06-12,19:21:00,21948.75,SELL,3,0.02h,Stop Loss,$-18.00,$1267.50,$585578.75,374,$1267.50
2025-06-12,19:25:00,22164.75,BUY,3,0.02h,Stop Loss,$-18.00,$1249.50,$585560.75,374,$1249.50
2025-06-12,19:26:00,21931.0,SELL,3,0.02h,Break Even,$0.75,$1250.25,$585561.50,374,$1250.25
2025-06-12,19:30:00,22162.75,BUY,3,0.02h,Stop Loss,$-18.00,$1232.25,$585543.50,374,$1232.25
2025-06-12,19:34:00,21930.0,SELL,3,0.02h,Stop Loss,$-18.00,$1214.25,$585525.50,374,$1214.25
2025-06-12,19:35:00,22153.0,BUY,3,0.02h,Stop Loss,$-18.00,$1196.25,$585507.50,374,$1196.25
2025-06-12,19:36:00,21924.5,SELL,3,0.02h,Stop Loss,$-18.00,$1178.25,$585489.50,374,$1178.25
2025-06-12,19:37:00,22149.0,BUY,3,0.02h,Stop Loss,$-18.00,$1160.25,$585471.50,374,$1160.25
2025-06-12,19:38:00,21920.25,SELL,3,0.02h,Stop Loss,$-18.00,$1142.25,$585453.50,374,$1142.25
2025-06-12,19:42:00,22145.75,BUY,3,0.02h,Stop Loss,$-18.00,$1124.25,$585435.50,374,$1124.25
2025-06-12,19:46:00,21909.25,SELL,3,0.02h,Stop Loss,$-18.00,$1106.25,$585417.50,374,$1106.25
2025-06-12,19:48:00,22133.0,BUY,3,0.02h,Break Even,$0.75,$1107.00,$585418.25,374,$1107.00
2025-06-12,19:53:00,21906.5,SELL,3,0.02h,Stop Loss,$34.50,$1141.50,$585452.75,374,$1141.50
2025-06-12,20:02:00,22163.25,BUY,3,0.02h,Stop Loss,$-18.00,$1123.50,$585434.75,374,$1123.50
2025-06-12,20:03:00,21936.75,SELL,3,0.02h,Stop Loss,$-18.00,$1105.50,$585416.75,374,$1105.50
2025-06-12,20:04:00,22162.5,BUY,3,0.02h,Stop Loss,$-18.00,$1087.50,$585398.75,374,$1087.50
2025-06-12,20:05:00,21932.5,SELL,3,0.02h,Stop Loss,$-18.00,$1069.50,$585380.75,374,$1069.50
2025-06-12,20:06:00,22170.25,BUY,3,0.02h,Stop Loss,$-18.00,$1051.50,$585362.75,374,$1051.50
2025-06-12,20:17:00,21926.5,SELL,3,0.02h,Break Even,$0.75,$1052.25,$585363.50,374,$1052.25
2025-06-12,20:23:00,22143.25,BUY,3,0.02h,Break Even,$0.75,$1053.00,$585364.25,374,$1053.00
2025-06-12,20:31:00,21911.5,SELL,3,0.02h,Stop Loss,$-18.00,$1035.00,$585346.25,374,$1035.00
2025-06-12,20:38:00,22143.75,BUY,3,0.02h,Stop Loss,$-18.00,$1017.00,$585328.25,374,$1017.00
2025-06-12,20:39:00,21919.5,SELL,3,0.02h,Stop Loss,$-18.00,$999.00,$585310.25,374,$999.00
2025-06-12,20:56:00,22138.5,BUY,3,0.02h,Stop Loss,$-18.00,$981.00,$585292.25,374,$981.00
2025-06-12,21:00:00,21908.25,SELL,3,1.02h,Stop Loss,$113.25,$1094.25,$585405.50,374,$1094.25
2025-06-12,22:09:00,22114.75,BUY,3,0.02h,Stop Loss,$-18.00,$1076.25,$585387.50,374,$1076.25
2025-06-12,22:10:00,21892.75,SELL,3,0.02h,Stop Loss,$-18.00,$1058.25,$585369.50,374,$1058.25
2025-06-12,22:11:00,22119.25,BUY,3,0.02h,Stop Loss,$-18.00,$1040.25,$585351.50,374,$1040.25
2025-06-12,22:12:00,21897.25,SELL,3,0.02h,Break Even,$0.75,$1041.00,$585352.25,374,$1041.00
2025-06-12,22:19:00,22112.75,BUY,3,0.02h,Stop Loss,$-18.00,$1023.00,$585334.25,374,$1023.00
2025-06-12,22:24:00,21886.5,SELL,3,0.02h,Stop Loss,$-18.00,$1005.00,$585316.25,374,$1005.00
2025-06-12,22:30:00,22102.0,BUY,3,0.02h,Stop Loss,$-18.00,$987.00,$585298.25,374,$987.00
2025-06-12,22:33:00,21871.5,SELL,3,0.02h,Stop Loss,$-18.00,$969.00,$585280.25,374,$969.00
2025-06-12,22:35:00,22100.5,BUY,3,0.02h,Stop Loss,$-18.00,$951.00,$585262.25,374,$951.00
2025-06-12,22:38:00,21872.25,SELL,3,0.02h,Break Even,$0.75,$951.75,$585263.00,374,$951.75
2025-06-12,22:42:00,22096.75,BUY,3,0.02h,Stop Loss,$-18.00,$933.75,$585245.00,374,$933.75
2025-06-12,22:43:00,21870.5,SELL,3,0.02h,Break Even,$0.75,$934.50,$585245.75,374,$934.50
2025-06-12,22:45:00,22095.5,BUY,3,0.02h,Break Even,$0.75,$935.25,$585246.50,374,$935.25
2025-06-12,22:59:00,21882.5,SELL,3,0.02h,Stop Loss,$-18.00,$917.25,$585228.50,374,$917.25
2025-06-12,23:00:00,22105.75,BUY,3,13.00h,Stop Loss,$-18.00,$899.25,$585210.50,374,$899.25
,,,,,,,,,,,
2025-06-13,12:00:00,21905.5,SELL,3,0.02h,Stop Loss,$3304.50,$3304.50,$588515.00,375,$3304.50
2025-06-13,12:39:00,21913.25,BUY,3,0.02h,Stop Loss,$-18.00,$3286.50,$588497.00,375,$3286.50
2025-06-13,12:40:00,21687.25,SELL,3,0.02h,Stop Loss,$-18.00,$3268.50,$588479.00,375,$3268.50
2025-06-13,12:41:00,21905.5,BUY,3,0.02h,Stop Loss,$-18.00,$3250.50,$588461.00,375,$3250.50
2025-06-13,12:42:00,21684.75,SELL,3,0.02h,Stop Loss,$-18.00,$3232.50,$588443.00,375,$3232.50
2025-06-13,12:43:00,21897.0,BUY,3,0.02h,Stop Loss,$-18.00,$3214.50,$588425.00,375,$3214.50
2025-06-13,12:44:00,21674.75,SELL,3,0.02h,Stop Loss,$120.75,$3335.25,$588545.75,375,$3335.25
2025-06-13,12:46:00,21889.25,BUY,3,0.02h,Break Even,$0.75,$3336.00,$588546.50,375,$3336.00
2025-06-13,12:52:00,21651.5,SELL,3,0.02h,Break Even,$0.75,$3336.75,$588547.25,375,$3336.75
2025-06-13,12:55:00,21870.75,BUY,3,0.02h,Stop Loss,$64.50,$3401.25,$588611.75,375,$3401.25
2025-06-13,13:03:00,21649.25,SELL,3,0.02h,Stop Loss,$-18.00,$3383.25,$588593.75,375,$3383.25
2025-06-13,13:05:00,21874.25,BUY,3,0.02h,Stop Loss,$-18.00,$3365.25,$588575.75,375,$3365.25
2025-06-13,13:06:00,21650.0,SELL,3,0.02h,Stop Loss,$23.25,$3388.50,$588599.00,375,$3388.50
2025-06-13,13:20:00,21857.0,BUY,3,0.02h,Stop Loss,$-18.00,$3370.50,$588581.00,375,$3370.50
2025-06-13,13:21:00,21637.25,SELL,3,0.02h,Stop Loss,$-18.00,$3352.50,$588563.00,375,$3352.50
2025-06-13,13:22:00,21861.0,BUY,3,0.02h,Stop Loss,$-18.00,$3334.50,$588545.00,375,$3334.50
2025-06-13,13:23:00,21646.25,SELL,3,0.02h,Break Even,$0.75,$3335.25,$588545.75,375,$3335.25
2025-06-13,13:26:00,21877.5,BUY,3,0.02h,Stop Loss,$-18.00,$3317.25,$588527.75,375,$3317.25
2025-06-13,13:27:00,21668.5,SELL,3,0.02h,Stop Loss,$102.00,$3419.25,$588629.75,375,$3419.25
2025-06-13,13:30:00,21901.25,BUY,3,0.02h,Stop Loss,$-18.00,$3401.25,$588611.75,375,$3401.25
2025-06-13,13:49:00,21755.25,SELL,3,0.02h,Stop Loss,$150.75,$3552.00,$588762.50,375,$3552.00
2025-06-13,13:53:00,21982.0,BUY,3,0.02h,Stop Loss,$49.50,$3601.50,$588812.00,375,$3601.50
2025-06-13,14:05:00,21731.75,SELL,3,0.02h,Stop Loss,$90.75,$3692.25,$588902.75,375,$3692.25
2025-06-13,14:08:00,21953.0,BUY,3,0.02h,Stop Loss,$19.50,$3711.75,$588922.25,375,$3711.75
2025-06-13,14:10:00,21724.0,SELL,3,0.02h,Stop Loss,$-18.00,$3693.75,$588904.25,375,$3693.75
2025-06-13,14:12:00,21912.25,BUY,3,0.02h,Break Even,$0.75,$3694.50,$588905.00,375,$3694.50
2025-06-13,14:14:00,21694.0,SELL,3,0.02h,Stop Loss,$19.50,$3714.00,$588924.50,375,$3714.00
2025-06-13,14:26:00,21882.75,BUY,3,0.02h,Stop Loss,$49.50,$3763.50,$588974.00,375,$3763.50
2025-06-13,14:33:00,21658.0,SELL,3,0.02h,Stop Loss,$-18.00,$3745.50,$588956.00,375,$3745.50
2025-06-13,14:35:00,21883.25,BUY,3,0.02h,Stop Loss,$-18.00,$3727.50,$588938.00,375,$3727.50
2025-06-13,14:36:00,21676.25,SELL,3,0.02h,Stop Loss,$139.50,$3867.00,$589077.50,375,$3867.00
2025-06-13,14:44:00,21938.25,BUY,3,0.02h,Stop Loss,$-18.00,$3849.00,$589059.50,375,$3849.00
2025-06-13,14:45:00,21707.25,SELL,3,0.02h,Stop Loss,$38.25,$3887.25,$589097.75,375,$3887.25
2025-06-13,14:47:00,21933.0,BUY,3,0.02h,Stop Loss,$27.00,$3914.25,$589124.75,375,$3914.25
2025-06-13,15:07:00,21750.5,SELL,3,0.02h,Stop Loss,$-18.00,$3896.25,$589106.75,375,$3896.25
2025-06-13,15:08:00,21981.25,BUY,3,0.02h,Break Even,$0.75,$3897.00,$589107.50,375,$3897.00
2025-06-13,15:11:00,21737.0,SELL,3,0.02h,Stop Loss,$-18.00,$3879.00,$589089.50,375,$3879.00
2025-06-13,15:12:00,21966.0,BUY,3,0.02h,Stop Loss,$-18.00,$3861.00,$589071.50,375,$3861.00
2025-06-13,15:13:00,21751.5,SELL,3,0.02h,Stop Loss,$-18.00,$3843.00,$589053.50,375,$3843.00
2025-06-13,15:15:00,21984.0,BUY,3,0.02h,Stop Loss,$117.00,$3960.00,$589170.50,375,$3960.00
2025-06-13,15:25:00,21780.75,SELL,3,0.02h,Stop Loss,$94.50,$4054.50,$589265.00,375,$4054.50
2025-06-13,15:28:00,22013.75,BUY,3,0.02h,Break Even,$0.75,$4055.25,$589265.75,375,$4055.25
2025-06-13,15:31:00,21796.0,SELL,3,0.02h,Break Even,$0.75,$4056.00,$589266.50,375,$4056.00
2025-06-13,15:40:00,22018.25,BUY,3,0.02h,Stop Loss,$-18.00,$4038.00,$589248.50,375,$4038.00
2025-06-13,15:41:00,21792.75,SELL,3,0.02h,Break Even,$0.75,$4038.75,$589249.25,375,$4038.75
2025-06-13,15:51:00,22053.0,BUY,3,0.02h,Stop Loss,$-18.00,$4020.75,$589231.25,375,$4020.75
2025-06-13,15:52:00,21839.75,SELL,3,0.02h,Stop Loss,$57.00,$4077.75,$589288.25,375,$4077.75
2025-06-13,15:54:00,22056.5,BUY,3,0.02h,Stop Loss,$68.25,$4146.00,$589356.50,375,$4146.00
2025-06-13,16:02:00,21820.25,SELL,3,0.02h,Stop Loss,$-18.00,$4128.00,$589338.50,375,$4128.00
2025-06-13,16:03:00,22049.75,BUY,3,0.02h,Stop Loss,$-18.00,$4110.00,$589320.50,375,$4110.00
2025-06-13,16:05:00,21821.25,SELL,3,0.02h,Stop Loss,$23.25,$4133.25,$589343.75,375,$4133.25
2025-06-13,16:07:00,22052.0,BUY,3,0.02h,Stop Loss,$19.50,$4152.75,$589363.25,375,$4152.75
2025-06-13,16:18:00,21847.5,SELL,3,0.02h,Stop Loss,$-18.00,$4134.75,$589345.25,375,$4134.75
2025-06-13,16:19:00,22071.5,BUY,3,0.02h,Stop Loss,$-18.00,$4116.75,$589327.25,375,$4116.75
2025-06-13,16:20:00,21844.25,SELL,3,0.02h,Stop Loss,$150.75,$4267.50,$589478.00,375,$4267.50
2025-06-13,16:22:00,22060.0,BUY,3,0.02h,Stop Loss,$49.50,$4317.00,$589527.50,375,$4317.00
2025-06-13,16:25:00,21841.75,SELL,3,0.02h,Break Even,$0.75,$4317.75,$589528.25,375,$4317.75
2025-06-13,16:29:00,22043.0,BUY,3,0.02h,Stop Loss,$-18.00,$4299.75,$589510.25,375,$4299.75
2025-06-13,16:30:00,21820.25,SELL,3,0.02h,Stop Loss,$12.00,$4311.75,$589522.25,375,$4311.75
2025-06-13,16:32:00,22047.75,BUY,3,0.02h,Break Even,$0.75,$4312.50,$589523.00,375,$4312.50
2025-06-13,16:39:00,21816.75,SELL,3,0.02h,Stop Loss,$-18.00,$4294.50,$589505.00,375,$4294.50
2025-06-13,16:40:00,22028.0,BUY,3,0.02h,Stop Loss,$-18.00,$4276.50,$589487.00,375,$4276.50
2025-06-13,16:41:00,21811.0,SELL,3,0.02h,Break Even,$0.75,$4277.25,$589487.75,375,$4277.25
2025-06-13,16:44:00,22030.0,BUY,3,0.02h,Stop Loss,$-18.00,$4259.25,$589469.75,375,$4259.25
2025-06-13,16:45:00,21811.25,SELL,3,0.02h,Stop Loss,$-18.00,$4241.25,$589451.75,375,$4241.25
2025-06-13,16:46:00,22029.25,BUY,3,0.02h,Break Even,$0.75,$4242.00,$589452.50,375,$4242.00
2025-06-13,16:48:00,21800.25,SELL,3,0.02h,Stop Loss,$-18.00,$4224.00,$589434.50,375,$4224.00
2025-06-13,16:51:00,22027.0,BUY,3,0.02h,Stop Loss,$27.00,$4251.00,$589461.50,375,$4251.00
2025-06-13,16:53:00,21821.5,SELL,3,0.02h,Stop Loss,$27.00,$4278.00,$589488.50,375,$4278.00
2025-06-13,17:00:00,22048.0,BUY,3,0.02h,Stop Loss,$15.75,$4293.75,$589504.25,375,$4293.75
2025-06-13,17:09:00,21808.25,SELL,3,0.02h,Stop Loss,$-18.00,$4275.75,$589486.25,375,$4275.75
2025-06-13,17:10:00,22025.75,BUY,3,0.02h,Stop Loss,$-18.00,$4257.75,$589468.25,375,$4257.75
2025-06-13,17:13:00,21792.75,SELL,3,0.02h,Stop Loss,$-18.00,$4239.75,$589450.25,375,$4239.75
2025-06-13,17:17:00,21977.5,BUY,3,0.02h,Stop Loss,$-18.00,$4221.75,$589432.25,375,$4221.75
2025-06-13,17:18:00,21774.75,SELL,3,0.02h,Stop Loss,$-18.00,$4203.75,$589414.25,375,$4203.75
2025-06-13,17:32:00,22007.0,BUY,3,0.02h,Stop Loss,$-18.00,$4185.75,$589396.25,375,$4185.75
2025-06-13,17:44:00,21762.0,SELL,3,0.02h,Stop Loss,$135.75,$4321.50,$589532.00,375,$4321.50
2025-06-13,17:53:00,22013.5,BUY,3,0.02h,Break Even,$0.75,$4322.25,$589532.75,375,$4322.25
2025-06-13,17:58:00,21785.75,SELL,3,0.02h,Stop Loss,$-18.00,$4304.25,$589514.75,375,$4304.25
2025-06-13,17:59:00,22008.5,BUY,3,0.02h,Stop Loss,$-18.00,$4286.25,$589496.75,375,$4286.25
2025-06-13,18:00:00,21788.0,SELL,3,0.02h,Stop Loss,$-18.00,$4268.25,$589478.75,375,$4268.25
2025-06-13,18:01:00,22020.25,BUY,3,0.02h,Break Even,$0.75,$4269.00,$589479.50,375,$4269.00
2025-06-13,18:07:00,21751.0,SELL,3,0.02h,Stop Loss,$113.25,$4382.25,$589592.75,375,$4382.25
2025-06-13,18:23:00,21925.5,BUY,3,0.02h,Stop Loss,$-18.00,$4364.25,$589574.75,375,$4364.25
2025-06-13,18:24:00,21722.75,SELL,3,0.02h,Stop Loss,$60.75,$4425.00,$589635.50,375,$4425.00
2025-06-13,18:46:00,21865.75,BUY,3,0.02h,Stop Loss,$-18.00,$4407.00,$589617.50,375,$4407.00
2025-06-13,18:47:00,21645.25,SELL,3,0.02h,Stop Loss,$180.75,$4587.75,$589798.25,375,$4587.75
2025-06-13,18:56:00,21876.5,BUY,3,0.02h,Stop Loss,$45.75,$4633.50,$589844.00,375,$4633.50
2025-06-13,19:04:00,21656.0,SELL,3,0.02h,Stop Loss,$42.00,$4675.50,$589886.00,375,$4675.50
2025-06-13,19:16:00,21898.5,BUY,3,0.02h,Stop Loss,$-18.00,$4657.50,$589868.00,375,$4657.50
2025-06-13,19:23:00,21648.25,SELL,3,0.02h,Stop Loss,$75.75,$4733.25,$589943.75,375,$4733.25
2025-06-13,19:30:00,21850.0,BUY,3,0.02h,Stop Loss,$-18.00,$4715.25,$589925.75,375,$4715.25
2025-06-13,19:31:00,21646.75,SELL,3,0.02h,Stop Loss,$15.75,$4731.00,$589941.50,375,$4731.00
2025-06-13,19:37:00,21872.75,BUY,3,0.02h,Stop Loss,$-18.00,$4713.00,$589923.50,375,$4713.00
2025-06-13,19:38:00,21669.25,SELL,3,0.02h,Stop Loss,$-18.00,$4695.00,$589905.50,375,$4695.00
2025-06-13,19:39:00,21882.0,BUY,3,0.02h,Stop Loss,$-18.00,$4677.00,$589887.50,375,$4677.00
2025-06-13,19:44:00,21632.25,SELL,3,0.02h,Stop Loss,$-18.00,$4659.00,$589869.50,375,$4659.00
2025-06-13,19:45:00,21846.0,BUY,3,0.02h,Stop Loss,$-18.00,$4641.00,$589851.50,375,$4641.00
2025-06-13,19:46:00,21611.5,SELL,3,0.02h,Stop Loss,$-18.00,$4623.00,$589833.50,375,$4623.00
2025-06-13,19:47:00,21834.5,BUY,3,0.02h,Stop Loss,$-18.00,$4605.00,$589815.50,375,$4605.00
2025-06-13,19:48:00,21619.5,SELL,3,0.02h,Break Even,$0.75,$4605.75,$589816.25,375,$4605.75
2025-06-13,19:50:00,21854.0,BUY,3,0.02h,Stop Loss,$-18.00,$4587.75,$589798.25,375,$4587.75
2025-06-13,19:51:00,21638.0,SELL,3,0.02h,Stop Loss,$-18.00,$4569.75,$589780.25,375,$4569.75
2025-06-13,19:52:00,21851.25,BUY,3,0.02h,Break Even,$0.75,$4570.50,$589781.00,375,$4570.50
2025-06-13,19:55:00,21624.5,SELL,3,0.02h,Stop Loss,$-18.00,$4552.50,$589763.00,375,$4552.50
2025-06-13,19:56:00,21835.25,BUY,3,0.02h,Stop Loss,$-18.00,$4534.50,$589745.00,375,$4534.50
2025-06-13,19:57:00,21623.75,SELL,3,0.02h,Stop Loss,$60.75,$4595.25,$589805.75,375,$4595.25
2025-06-13,20:00:00,21868.25,BUY,3,0.02h,Stop Loss,$192.00,$4787.25,$589997.75,375,$4787.25
2025-06-13,20:06:00,21658.75,SELL,3,0.02h,Stop Loss,$-18.00,$4769.25,$589979.75,375,$4769.25
2025-06-13,20:07:00,21865.5,BUY,3,0.02h,Stop Loss,$-18.00,$4751.25,$589961.75,375,$4751.25
2025-06-13,20:08:00,21650.5,SELL,3,0.02h,Stop Loss,$-18.00,$4733.25,$589943.75,375,$4733.25
2025-06-13,20:17:00,21879.5,BUY,3,0.02h,Stop Loss,$-18.00,$4715.25,$589925.75,375,$4715.25
2025-06-13,20:18:00,21667.75,SELL,3,0.02h,Stop Loss,$-18.00,$4697.25,$589907.75,375,$4697.25
2025-06-13,20:19:00,21887.0,BUY,3,0.02h,Stop Loss,$-18.00,$4679.25,$589889.75,375,$4679.25
2025-06-13,20:21:00,21665.75,SELL,3,0.02h,Stop Loss,$-18.00,$4661.25,$589871.75,375,$4661.25
2025-06-13,20:22:00,21877.5,BUY,3,0.02h,Stop Loss,$-18.00,$4643.25,$589853.75,375,$4643.25
2025-06-13,20:24:00,21658.5,SELL,3,0.02h,Stop Loss,$-18.00,$4625.25,$589835.75,375,$4625.25
2025-06-13,20:25:00,21875.25,BUY,3,0.02h,Stop Loss,$-18.00,$4607.25,$589817.75,375,$4607.25
2025-06-13,20:28:00,21653.75,SELL,3,0.02h,Stop Loss,$-18.00,$4589.25,$589799.75,375,$4589.25
2025-06-13,20:29:00,21867.0,BUY,3,0.02h,Stop Loss,$-18.00,$4571.25,$589781.75,375,$4571.25
2025-06-13,20:38:00,21672.25,SELL,3,0.02h,Break Even,$0.75,$4572.00,$589782.50,375,$4572.00
2025-06-13,20:40:00,21882.75,BUY,3,0.02h,Stop Loss,$-18.00,$4554.00,$589764.50,375,$4554.00
2025-06-13,20:41:00,21662.0,SELL,3,0.02h,Stop Loss,$38.25,$4592.25,$589802.75,375,$4592.25
2025-06-13,20:46:00,21875.0,BUY,3,0.02h,Stop Loss,$-18.00,$4574.25,$589784.75,375,$4574.25
2025-06-13,20:52:00,21651.75,SELL,3,0.02h,Stop Loss,$-18.00,$4556.25,$589766.75,375,$4556.25
2025-06-13,20:53:00,21866.75,BUY,3,0.02h,Stop Loss,$-18.00,$4538.25,$589748.75,375,$4538.25
2025-06-13,20:54:00,21647.25,SELL,3,0.02h,Stop Loss,$-18.00,$4520.25,$589730.75,375,$4520.25
2025-06-13,20:55:00,21864.0,BUY,3,0.02h,Stop Loss,$-18.00,$4502.25,$589712.75,375,$4502.25
2025-06-13,20:56:00,21647.75,SELL,3,0.02h,Break Even,$0.75,$4503.00,$589713.50,375,$4503.00
,,,,,,,,,,,
2025-06-16,12:00:00,22033.25,BUY,3,0.02h,Break Even,$0.75,$0.75,$589714.25,376,$0.75
2025-06-16,12:55:00,22038.75,SELL,3,0.02h,Stop Loss,$-18.00,$-17.25,$589696.25,376,$-17.25
2025-06-16,12:56:00,22041.75,BUY,3,0.02h,Break Even,$0.75,$-16.50,$589697.00,376,$-16.50
2025-06-16,12:59:00,22035.0,SELL,3,0.02h,Stop Loss,$-18.00,$-34.50,$589679.00,376,$-34.50
2025-06-16,13:02:00,22043.0,BUY,3,0.02h,Stop Loss,$27.00,$-7.50,$589706.00,376,$-7.50
2025-06-16,13:07:00,22035.5,SELL,3,0.02h,Stop Loss,$30.75,$23.25,$589736.75,376,$23.25
2025-06-16,13:14:00,22040.75,BUY,3,0.02h,Break Even,$0.75,$24.00,$589737.50,376,$24.00
2025-06-16,13:17:00,22037.5,SELL,3,0.02h,Stop Loss,$53.25,$77.25,$589790.75,376,$77.25
2025-06-16,13:32:00,22079.5,BUY,3,0.02h,Stop Loss,$240.75,$318.00,$590031.50,376,$318.00
2025-06-16,14:52:00,22187.75,SELL,3,0.02h,Stop Loss,$23.25,$341.25,$590054.75,376,$341.25
2025-06-16,15:03:00,22196.25,BUY,3,0.02h,Stop Loss,$-18.00,$323.25,$590036.75,376,$323.25
2025-06-16,15:04:00,22178.75,SELL,3,0.02h,Break Even,$0.75,$324.00,$590037.50,376,$324.00
2025-06-16,15:08:00,22191.75,BUY,3,0.02h,Break Even,$0.75,$324.75,$590038.25,376,$324.75
2025-06-16,15:29:00,22190.0,SELL,3,0.02h,Stop Loss,$38.25,$363.00,$590076.50,376,$363.00
2025-06-16,15:47:00,22203.75,BUY,3,0.02h,Stop Loss,$-18.00,$345.00,$590058.50,376,$345.00
2025-06-16,15:52:00,22187.0,SELL,3,0.02h,Stop Loss,$49.50,$394.50,$590108.00,376,$394.50
2025-06-16,16:15:00,22184.0,BUY,3,0.02h,Break Even,$0.75,$395.25,$590108.75,376,$395.25
2025-06-16,16:26:00,22169.5,SELL,3,0.02h,Stop Loss,$49.50,$444.75,$590158.25,376,$444.75
2025-06-16,16:54:00,22178.5,BUY,3,0.02h,Stop Loss,$-18.00,$426.75,$590140.25,376,$426.75
2025-06-16,17:03:00,22159.75,SELL,3,0.02h,Break Even,$0.75,$427.50,$590141.00,376,$427.50
2025-06-16,17:20:00,22169.5,BUY,3,0.02h,Stop Loss,$120.75,$548.25,$590261.75,376,$548.25
2025-06-16,17:54:00,22185.25,SELL,3,0.02h,Stop Loss,$105.75,$654.00,$590367.50,376,$654.00
2025-06-16,18:26:00,22173.75,BUY,3,0.02h,Break Even,$0.75,$654.75,$590368.25,376,$654.75
2025-06-16,18:31:00,22165.5,SELL,3,0.02h,Stop Loss,$27.00,$681.75,$590395.25,376,$681.75
2025-06-16,18:57:00,22171.0,BUY,3,0.02h,Stop Loss,$19.50,$701.25,$590414.75,376,$701.25
2025-06-16,19:08:00,22156.5,SELL,3,0.02h,Break Even,$0.75,$702.00,$590415.50,376,$702.00
2025-06-16,19:23:00,22176.5,BUY,3,0.02h,Stop Loss,$30.75,$732.75,$590446.25,376,$732.75
2025-06-16,19:34:00,22155.5,SELL,3,0.02h,Stop Loss,$-18.00,$714.75,$590428.25,376,$714.75
2025-06-16,19:46:00,22172.5,BUY,3,0.02h,Stop Loss,$-18.00,$696.75,$590410.25,376,$696.75
2025-06-16,19:52:00,22153.75,SELL,3,0.02h,Break Even,$0.75,$697.50,$590411.00,376,$697.50
2025-06-16,19:56:00,22173.25,BUY,3,0.02h,Break Even,$0.75,$698.25,$590411.75,376,$698.25
2025-06-16,19:58:00,22151.25,SELL,3,0.02h,Stop Loss,$57.00,$755.25,$590468.75,376,$755.25
2025-06-16,20:01:00,22172.5,BUY,3,0.02h,Stop Loss,$57.00,$812.25,$590525.75,376,$812.25
2025-06-16,20:22:00,22168.0,SELL,3,0.03h,Break Even,$0.75,$813.00,$590526.50,376,$813.00
2025-06-16,20:37:00,22172.0,BUY,3,0.02h,Break Even,$0.75,$813.75,$590527.25,376,$813.75
2025-06-16,20:55:00,22169.5,SELL,3,0.02h,Stop Loss,$23.25,$837.00,$590550.50,376,$837.00
,,,,,,,,,,,
2025-06-17,12:14:00,22082.75,BUY,3,0.02h,Stop Loss,$-18.00,$-18.00,$590532.50,377,$-18.00
2025-06-17,12:15:00,21858.0,SELL,3,0.02h,Stop Loss,$-18.00,$-36.00,$590514.50,377,$-36.00
2025-06-17,12:28:00,22083.75,BUY,3,0.02h,Stop Loss,$-18.00,$-54.00,$590496.50,377,$-54.00
2025-06-17,12:34:00,21848.5,SELL,3,0.02h,Stop Loss,$-18.00,$-72.00,$590478.50,377,$-72.00
2025-06-17,12:35:00,22073.75,BUY,3,0.02h,Break Even,$0.75,$-71.25,$590479.25,377,$-71.25
2025-06-17,12:38:00,21841.5,SELL,3,0.02h,Stop Loss,$-18.00,$-89.25,$590461.25,377,$-89.25
2025-06-17,12:39:00,22071.25,BUY,3,0.02h,Stop Loss,$169.50,$80.25,$590630.75,377,$80.25
2025-06-17,12:44:00,21855.75,SELL,3,0.02h,Stop Loss,$-18.00,$62.25,$590612.75,377,$62.25
2025-06-17,12:47:00,22074.0,BUY,3,0.02h,Stop Loss,$-18.00,$44.25,$590594.75,377,$44.25
2025-06-17,12:48:00,21842.5,SELL,3,0.02h,Stop Loss,$-18.00,$26.25,$590576.75,377,$26.25
2025-06-17,12:50:00,22057.5,BUY,3,0.02h,Stop Loss,$-18.00,$8.25,$590558.75,377,$8.25
2025-06-17,12:52:00,21831.0,SELL,3,0.02h,Stop Loss,$15.75,$24.00,$590574.50,377,$24.00
2025-06-17,13:02:00,22056.75,BUY,3,0.02h,Stop Loss,$15.75,$39.75,$590590.25,377,$39.75
2025-06-17,13:07:00,21825.75,SELL,3,0.02h,Stop Loss,$38.25,$78.00,$590628.50,377,$78.00
2025-06-17,13:11:00,22042.0,BUY,3,0.02h,Stop Loss,$30.75,$108.75,$590659.25,377,$108.75
2025-06-17,13:14:00,21822.5,SELL,3,0.02h,Break Even,$0.75,$109.50,$590660.00,377,$109.50
2025-06-17,13:30:00,22063.25,BUY,3,0.02h,Stop Loss,$567.00,$676.50,$591227.00,377,$676.50
2025-06-17,13:37:00,21854.75,SELL,3,0.02h,Stop Loss,$-18.00,$658.50,$591209.00,377,$658.50
2025-06-17,13:38:00,22070.25,BUY,3,0.02h,Stop Loss,$-18.00,$640.50,$591191.00,377,$640.50
2025-06-17,13:46:00,21817.5,SELL,3,0.02h,Stop Loss,$-18.00,$622.50,$591173.00,377,$622.50
2025-06-17,13:47:00,22055.0,BUY,3,0.02h,Stop Loss,$162.00,$784.50,$591335.00,377,$784.50
2025-06-17,13:59:00,21862.75,SELL,3,0.02h,Stop Loss,$-18.00,$766.50,$591317.00,377,$766.50
2025-06-17,14:06:00,22079.0,BUY,3,0.02h,Stop Loss,$113.25,$879.75,$591430.25,377,$879.75
2025-06-17,14:16:00,21899.75,SELL,3,0.02h,Break Even,$0.75,$880.50,$591431.00,377,$880.50
2025-06-17,14:32:00,22104.25,BUY,3,0.02h,Break Even,$0.75,$881.25,$591431.75,377,$881.25
2025-06-17,14:38:00,21861.5,SELL,3,0.02h,Stop Loss,$-18.00,$863.25,$591413.75,377,$863.25
2025-06-17,14:39:00,22097.75,BUY,3,0.02h,Break Even,$0.75,$864.00,$591414.50,377,$864.00
2025-06-17,14:42:00,21858.5,SELL,3,0.02h,Stop Loss,$-18.00,$846.00,$591396.50,377,$846.00
2025-06-17,14:43:00,22084.75,BUY,3,0.02h,Stop Loss,$-18.00,$828.00,$591378.50,377,$828.00
2025-06-17,14:44:00,21864.75,SELL,3,0.02h,Stop Loss,$-18.00,$810.00,$591360.50,377,$810.00
2025-06-17,14:45:00,22084.0,BUY,3,0.02h,Stop Loss,$259.50,$1069.50,$591620.00,377,$1069.50
2025-06-17,14:56:00,21867.0,SELL,3,0.02h,Stop Loss,$-18.00,$1051.50,$591602.00,377,$1051.50
2025-06-17,14:58:00,22075.75,BUY,3,0.02h,Stop Loss,$102.00,$1153.50,$591704.00,377,$1153.50
2025-06-17,15:00:00,21849.5,SELL,3,0.02h,Break Even,$0.75,$1154.25,$591704.75,377,$1154.25
2025-06-17,15:10:00,22110.25,BUY,3,0.02h,Stop Loss,$49.50,$1203.75,$591754.25,377,$1203.75
2025-06-17,15:18:00,21884.5,SELL,3,0.02h,Break Even,$0.75,$1204.50,$591755.00,377,$1204.50
2025-06-17,15:35:00,22089.0,BUY,3,0.02h,Break Even,$0.75,$1205.25,$591755.75,377,$1205.25
2025-06-17,15:42:00,21880.25,SELL,3,0.02h,Stop Loss,$-18.00,$1187.25,$591737.75,377,$1187.25
2025-06-17,15:45:00,22118.5,BUY,3,0.02h,Stop Loss,$15.75,$1203.00,$591753.50,377,$1203.00
2025-06-17,15:48:00,21885.25,SELL,3,0.02h,Stop Loss,$255.75,$1458.75,$592009.25,377,$1458.75
2025-06-17,15:51:00,22102.0,BUY,3,0.02h,Stop Loss,$-18.00,$1440.75,$591991.25,377,$1440.75
2025-06-17,15:52:00,21889.0,SELL,3,0.02h,Stop Loss,$-18.00,$1422.75,$591973.25,377,$1422.75
2025-06-17,15:59:00,22105.5,BUY,3,0.02h,Break Even,$0.75,$1423.50,$591974.00,377,$1423.50
2025-06-17,16:11:00,21894.0,SELL,3,0.02h,Stop Loss,$-18.00,$1405.50,$591956.00,377,$1405.50
2025-06-17,16:12:00,22129.5,BUY,3,0.02h,Stop Loss,$-18.00,$1387.50,$591938.00,377,$1387.50
2025-06-17,16:22:00,21895.25,SELL,3,0.02h,Stop Loss,$-18.00,$1369.50,$591920.00,377,$1369.50
2025-06-17,16:23:00,22117.0,BUY,3,0.02h,Stop Loss,$-18.00,$1351.50,$591902.00,377,$1351.50
2025-06-17,16:24:00,21888.25,SELL,3,0.02h,Stop Loss,$15.75,$1367.25,$591917.75,377,$1367.25
2025-06-17,16:27:00,22111.0,BUY,3,0.02h,Stop Loss,$-18.00,$1349.25,$591899.75,377,$1349.25
2025-06-17,16:28:00,21885.25,SELL,3,0.02h,Stop Loss,$-18.00,$1331.25,$591881.75,377,$1331.25
2025-06-17,16:29:00,22117.0,BUY,3,0.02h,Break Even,$0.75,$1332.00,$591882.50,377,$1332.00
2025-06-17,16:32:00,21886.5,SELL,3,0.02h,Break Even,$0.75,$1332.75,$591883.25,377,$1332.75
2025-06-17,16:35:00,22122.75,BUY,3,0.02h,Stop Loss,$-18.00,$1314.75,$591865.25,377,$1314.75
2025-06-17,16:36:00,21899.25,SELL,3,0.02h,Stop Loss,$-18.00,$1296.75,$591847.25,377,$1296.75
2025-06-17,16:37:00,22123.5,BUY,3,0.02h,Break Even,$0.75,$1297.50,$591848.00,377,$1297.50
2025-06-17,16:40:00,21885.75,SELL,3,0.02h,Stop Loss,$57.00,$1354.50,$591905.00,377,$1354.50
2025-06-17,16:50:00,22070.5,BUY,3,0.02h,Stop Loss,$53.25,$1407.75,$591958.25,377,$1407.75
2025-06-17,16:56:00,21820.25,SELL,3,0.02h,Break Even,$0.75,$1408.50,$591959.00,377,$1408.50
2025-06-17,17:15:00,22051.0,BUY,3,0.02h,Stop Loss,$12.00,$1420.50,$591971.00,377,$1420.50
2025-06-17,17:20:00,21815.25,SELL,3,0.02h,Stop Loss,$120.75,$1541.25,$592091.75,377,$1541.25
2025-06-17,17:24:00,22033.5,BUY,3,0.02h,Stop Loss,$180.75,$1722.00,$592272.50,377,$1722.00
2025-06-17,17:28:00,21803.5,SELL,3,0.02h,Stop Loss,$-18.00,$1704.00,$592254.50,377,$1704.00
2025-06-17,17:29:00,22020.75,BUY,3,0.02h,Stop Loss,$15.75,$1719.75,$592270.25,377,$1719.75
2025-06-17,17:36:00,21818.75,SELL,3,0.02h,Stop Loss,$-18.00,$1701.75,$592252.25,377,$1701.75
2025-06-17,17:37:00,22042.75,BUY,3,0.02h,Stop Loss,$30.75,$1732.50,$592283.00,377,$1732.50
2025-06-17,17:44:00,21793.0,SELL,3,0.02h,Stop Loss,$195.75,$1928.25,$592478.75,377,$1928.25
2025-06-17,18:08:00,21967.0,BUY,3,0.02h,Break Even,$0.75,$1929.00,$592479.50,377,$1929.00
2025-06-17,18:17:00,21721.25,SELL,3,0.02h,Stop Loss,$38.25,$1967.25,$592517.75,377,$1967.25
2025-06-17,18:24:00,21946.25,BUY,3,0.02h,Stop Loss,$-18.00,$1949.25,$592499.75,377,$1949.25
2025-06-17,18:25:00,21713.5,SELL,3,0.02h,Stop Loss,$83.25,$2032.50,$592583.00,377,$2032.50
2025-06-17,18:32:00,21955.5,BUY,3,0.02h,Break Even,$0.75,$2033.25,$592583.75,377,$2033.25
2025-06-17,18:53:00,21713.25,SELL,3,0.02h,Stop Loss,$-18.00,$2015.25,$592565.75,377,$2015.25
2025-06-17,18:57:00,21962.75,BUY,3,0.02h,Stop Loss,$-18.00,$1997.25,$592547.75,377,$1997.25
2025-06-17,18:58:00,21743.75,SELL,3,0.02h,Stop Loss,$-18.00,$1979.25,$592529.75,377,$1979.25
2025-06-17,18:59:00,21974.0,BUY,3,0.02h,Stop Loss,$-18.00,$1961.25,$592511.75,377,$1961.25
2025-06-17,19:00:00,21751.0,SELL,3,0.02h,Stop Loss,$-18.00,$1943.25,$592493.75,377,$1943.25
2025-06-17,19:01:00,21973.5,BUY,3,0.02h,Stop Loss,$-18.00,$1925.25,$592475.75,377,$1925.25
2025-06-17,19:02:00,21742.5,SELL,3,0.02h,Stop Loss,$-18.00,$1907.25,$592457.75,377,$1907.25
2025-06-17,19:03:00,21973.25,BUY,3,0.02h,Stop Loss,$-18.00,$1889.25,$592439.75,377,$1889.25
2025-06-17,19:04:00,21734.75,SELL,3,0.02h,Stop Loss,$-18.00,$1871.25,$592421.75,377,$1871.25
2025-06-17,19:05:00,21956.0,BUY,3,0.02h,Stop Loss,$-18.00,$1853.25,$592403.75,377,$1853.25
2025-06-17,19:11:00,21729.75,SELL,3,0.02h,Stop Loss,$-18.00,$1835.25,$592385.75,377,$1835.25
2025-06-17,19:12:00,21970.0,BUY,3,0.02h,Stop Loss,$-18.00,$1817.25,$592367.75,377,$1817.25
2025-06-17,19:13:00,21748.75,SELL,3,0.02h,Stop Loss,$60.75,$1878.00,$592428.50,377,$1878.00
2025-06-17,19:16:00,21974.75,BUY,3,0.02h,Break Even,$0.75,$1878.75,$592429.25,377,$1878.75
2025-06-17,19:18:00,21735.25,SELL,3,0.02h,Stop Loss,$-18.00,$1860.75,$592411.25,377,$1860.75
2025-06-17,19:21:00,21983.0,BUY,3,0.02h,Stop Loss,$-18.00,$1842.75,$592393.25,377,$1842.75
2025-06-17,19:22:00,21756.25,SELL,3,0.02h,Stop Loss,$-18.00,$1824.75,$592375.25,377,$1824.75
2025-06-17,19:23:00,21986.5,BUY,3,0.02h,Stop Loss,$-18.00,$1806.75,$592357.25,377,$1806.75
2025-06-17,19:24:00,21757.5,SELL,3,0.02h,Break Even,$0.75,$1807.50,$592358.00,377,$1807.50
2025-06-17,19:26:00,21986.25,BUY,3,0.02h,Stop Loss,$-18.00,$1789.50,$592340.00,377,$1789.50
2025-06-17,19:27:00,21760.0,SELL,3,0.02h,Stop Loss,$-18.00,$1771.50,$592322.00,377,$1771.50
2025-06-17,19:28:00,21982.25,BUY,3,0.02h,Stop Loss,$-18.00,$1753.50,$592304.00,377,$1753.50
2025-06-17,19:29:00,21757.0,SELL,3,0.02h,Stop Loss,$-18.00,$1735.50,$592286.00,377,$1735.50
2025-06-17,19:31:00,21987.0,BUY,3,0.02h,Stop Loss,$-18.00,$1717.50,$592268.00,377,$1717.50
2025-06-17,19:32:00,21751.5,SELL,3,0.02h,Stop Loss,$-18.00,$1699.50,$592250.00,377,$1699.50
2025-06-17,19:39:00,21987.25,BUY,3,0.02h,Break Even,$0.75,$1700.25,$592250.75,377,$1700.25
2025-06-17,19:44:00,21749.25,SELL,3,0.02h,Stop Loss,$34.50,$1734.75,$592285.25,377,$1734.75
2025-06-17,19:46:00,21986.5,BUY,3,0.02h,Break Even,$0.75,$1735.50,$592286.00,377,$1735.50
2025-06-17,19:53:00,21747.75,SELL,3,0.02h,Stop Loss,$42.00,$1777.50,$592328.00,377,$1777.50
2025-06-17,19:59:00,21954.0,BUY,3,0.02h,Stop Loss,$-18.00,$1759.50,$592310.00,377,$1759.50
2025-06-17,20:00:00,21730.5,SELL,3,0.02h,Stop Loss,$72.00,$1831.50,$592382.00,377,$1831.50
2025-06-17,20:03:00,21965.75,BUY,3,0.02h,Break Even,$0.75,$1832.25,$592382.75,377,$1832.25
2025-06-17,20:06:00,21735.5,SELL,3,0.02h,Stop Loss,$-18.00,$1814.25,$592364.75,377,$1814.25
2025-06-17,20:07:00,21963.0,BUY,3,0.02h,Break Even,$0.75,$1815.00,$592365.50,377,$1815.00
2025-06-17,20:21:00,21721.75,SELL,3,0.02h,Stop Loss,$-18.00,$1797.00,$592347.50,377,$1797.00
2025-06-17,20:22:00,21949.5,BUY,3,0.02h,Stop Loss,$-18.00,$1779.00,$592329.50,377,$1779.00
2025-06-17,20:25:00,21726.25,SELL,3,0.02h,Stop Loss,$-18.00,$1761.00,$592311.50,377,$1761.00
2025-06-17,20:43:00,21960.0,BUY,3,0.02h,Break Even,$0.75,$1761.75,$592312.25,377,$1761.75
2025-06-17,20:53:00,21715.0,SELL,3,0.02h,Break Even,$0.75,$1762.50,$592313.00,377,$1762.50
2025-06-17,20:57:00,21957.0,BUY,3,0.02h,Stop Loss,$-18.00,$1744.50,$592295.00,377,$1744.50
2025-06-17,20:59:00,21731.25,SELL,3,0.02h,Stop Loss,$-18.00,$1726.50,$592277.00,377,$1726.50
2025-06-17,21:00:00,21953.25,BUY,3,1.02h,Stop Loss,$-18.00,$1708.50,$592259.00,377,$1708.50
2025-06-17,22:01:00,21712.5,SELL,3,0.02h,Stop Loss,$165.75,$1874.25,$592424.75,377,$1874.25
2025-06-17,22:07:00,21911.25,BUY,3,0.02h,Break Even,$0.75,$1875.00,$592425.50,377,$1875.00
2025-06-17,22:10:00,21702.75,SELL,3,0.02h,Stop Loss,$132.00,$2007.00,$592557.50,377,$2007.00
2025-06-17,22:13:00,21920.0,BUY,3,0.02h,Stop Loss,$-18.00,$1989.00,$592539.50,377,$1989.00
2025-06-17,22:14:00,21689.75,SELL,3,0.02h,Stop Loss,$-18.00,$1971.00,$592521.50,377,$1971.00
2025-06-17,22:15:00,21919.5,BUY,3,0.02h,Break Even,$0.75,$1971.75,$592522.25,377,$1971.75
2025-06-17,22:22:00,21685.75,SELL,3,0.02h,Break Even,$0.75,$1972.50,$592523.00,377,$1972.50
2025-06-17,22:38:00,21896.5,BUY,3,0.02h,Break Even,$0.75,$1973.25,$592523.75,377,$1973.25
2025-06-17,22:43:00,21660.5,SELL,3,0.02h,Break Even,$0.75,$1974.00,$592524.50,377,$1974.00
2025-06-17,22:47:00,21887.0,BUY,3,0.02h,Stop Loss,$-18.00,$1956.00,$592506.50,377,$1956.00
2025-06-17,22:48:00,21660.25,SELL,3,0.02h,Stop Loss,$128.25,$2084.25,$592634.75,377,$2084.25
2025-06-17,22:50:00,21886.0,BUY,3,0.02h,Stop Loss,$-18.00,$2066.25,$592616.75,377,$2066.25
2025-06-17,22:51:00,21662.25,SELL,3,0.02h,Stop Loss,$-18.00,$2048.25,$592598.75,377,$2048.25
2025-06-17,22:52:00,21882.75,BUY,3,0.02h,Break Even,$0.75,$2049.00,$592599.50,377,$2049.00
2025-06-17,22:59:00,21646.25,SELL,3,0.02h,Break Even,$0.75,$2049.75,$592600.25,377,$2049.75
,,,,,,,,,,,
2025-06-18,12:02:00,22004.0,BUY,3,0.02h,Stop Loss,$-18.00,$-18.00,$592582.25,378,$-18.00
2025-06-18,12:22:00,21784.5,SELL,3,0.02h,Break Even,$0.75,$-17.25,$592583.00,378,$-17.25
2025-06-18,12:29:00,22001.0,BUY,3,0.02h,Stop Loss,$-18.00,$-35.25,$592565.00,378,$-35.25
2025-06-18,12:30:00,21779.75,SELL,3,0.02h,Stop Loss,$135.75,$100.50,$592700.75,378,$100.50
2025-06-18,12:37:00,22004.75,BUY,3,0.02h,Break Even,$0.75,$101.25,$592701.50,378,$101.25
2025-06-18,12:44:00,21765.5,SELL,3,0.02h,Break Even,$0.75,$102.00,$592702.25,378,$102.00
2025-06-18,12:47:00,21992.0,BUY,3,0.02h,Stop Loss,$-18.00,$84.00,$592684.25,378,$84.00
2025-06-18,12:58:00,21769.0,SELL,3,0.02h,Stop Loss,$-18.00,$66.00,$592666.25,378,$66.00
2025-06-18,12:59:00,21988.5,BUY,3,0.02h,Stop Loss,$-18.00,$48.00,$592648.25,378,$48.00
2025-06-18,13:00:00,21763.0,SELL,3,0.02h,Break Even,$0.75,$48.75,$592649.00,378,$48.75
2025-06-18,13:05:00,21999.25,BUY,3,0.02h,Stop Loss,$-18.00,$30.75,$592631.00,378,$30.75
2025-06-18,13:06:00,21778.0,SELL,3,0.02h,Break Even,$0.75,$31.50,$592631.75,378,$31.50
2025-06-18,13:12:00,22008.25,BUY,3,0.02h,Stop Loss,$-18.00,$13.50,$592613.75,378,$13.50
2025-06-18,13:16:00,21776.25,SELL,3,0.02h,Stop Loss,$-18.00,$-4.50,$592595.75,378,$-4.50
2025-06-18,13:21:00,22010.0,BUY,3,0.02h,Stop Loss,$-18.00,$-22.50,$592577.75,378,$-22.50
2025-06-18,13:22:00,21789.5,SELL,3,0.02h,Stop Loss,$-18.00,$-40.50,$592559.75,378,$-40.50
2025-06-18,13:23:00,22008.25,BUY,3,0.02h,Stop Loss,$-18.00,$-58.50,$592541.75,378,$-58.50
2025-06-18,13:25:00,21784.75,SELL,3,0.02h,Stop Loss,$-18.00,$-76.50,$592523.75,378,$-76.50
2025-06-18,13:26:00,22006.0,BUY,3,0.02h,Stop Loss,$-18.00,$-94.50,$592505.75,378,$-94.50
2025-06-18,13:28:00,21781.75,SELL,3,0.02h,Stop Loss,$98.25,$3.75,$592604.00,378,$3.75
2025-06-18,13:33:00,21947.5,BUY,3,0.02h,Break Even,$0.75,$4.50,$592604.75,378,$4.50
2025-06-18,13:38:00,21729.75,SELL,3,0.02h,Stop Loss,$-18.00,$-13.50,$592586.75,378,$-13.50
2025-06-18,13:39:00,21957.0,BUY,3,0.02h,Stop Loss,$-18.00,$-31.50,$592568.75,378,$-31.50
2025-06-18,13:40:00,21739.5,SELL,3,0.02h,Stop Loss,$38.25,$6.75,$592607.00,378,$6.75
2025-06-18,13:42:00,21975.25,BUY,3,0.02h,Stop Loss,$-18.00,$-11.25,$592589.00,378,$-11.25
2025-06-18,13:43:00,21745.25,SELL,3,0.02h,Break Even,$0.75,$-10.50,$592589.75,378,$-10.50
2025-06-18,13:51:00,22009.5,BUY,3,0.02h,Stop Loss,$45.75,$35.25,$592635.50,378,$35.25
2025-06-18,13:59:00,21784.25,SELL,3,0.02h,Stop Loss,$-18.00,$17.25,$592617.50,378,$17.25
2025-06-18,14:00:00,22001.25,BUY,3,0.02h,Stop Loss,$49.50,$66.75,$592667.00,378,$66.75
2025-06-18,14:26:00,21843.5,SELL,3,0.02h,Stop Loss,$-18.00,$48.75,$592649.00,378,$48.75
2025-06-18,14:27:00,22076.5,BUY,3,0.02h,Stop Loss,$30.75,$79.50,$592679.75,378,$79.50
2025-06-18,14:36:00,21867.75,SELL,3,0.02h,Stop Loss,$-18.00,$61.50,$592661.75,378,$61.50
2025-06-18,14:37:00,22085.5,BUY,3,0.02h,Break Even,$0.75,$62.25,$592662.50,378,$62.25
2025-06-18,14:41:00,21846.75,SELL,3,0.02h,Stop Loss,$45.75,$108.00,$592708.25,378,$108.00
2025-06-18,14:48:00,22086.25,BUY,3,0.02h,Stop Loss,$-18.00,$90.00,$592690.25,378,$90.00
2025-06-18,14:54:00,21836.0,SELL,3,0.02h,Stop Loss,$-18.00,$72.00,$592672.25,378,$72.00
2025-06-18,15:03:00,22076.25,BUY,3,0.02h,Stop Loss,$-18.00,$54.00,$592654.25,378,$54.00
2025-06-18,15:04:00,21852.75,SELL,3,0.02h,Stop Loss,$-18.00,$36.00,$592636.25,378,$36.00
2025-06-18,15:05:00,22082.0,BUY,3,0.02h,Stop Loss,$-18.00,$18.00,$592618.25,378,$18.00
2025-06-18,15:08:00,21842.75,SELL,3,0.02h,Stop Loss,$23.25,$41.25,$592641.50,378,$41.25
2025-06-18,15:13:00,22062.25,BUY,3,0.02h,Break Even,$0.75,$42.00,$592642.25,378,$42.00
2025-06-18,15:15:00,21834.75,SELL,3,0.02h,Stop Loss,$-18.00,$24.00,$592624.25,378,$24.00
2025-06-18,15:16:00,22055.0,BUY,3,0.02h,Stop Loss,$27.00,$51.00,$592651.25,378,$51.00
2025-06-18,15:18:00,21835.25,SELL,3,0.02h,Stop Loss,$-18.00,$33.00,$592633.25,378,$33.00
2025-06-18,15:19:00,22060.25,BUY,3,0.02h,Stop Loss,$-18.00,$15.00,$592615.25,378,$15.00
2025-06-18,15:23:00,21831.5,SELL,3,0.02h,Stop Loss,$-18.00,$-3.00,$592597.25,378,$-3.00
2025-06-18,15:24:00,22054.5,BUY,3,0.02h,Stop Loss,$-18.00,$-21.00,$592579.25,378,$-21.00
2025-06-18,15:25:00,21828.0,SELL,3,0.02h,Stop Loss,$49.50,$28.50,$592628.75,378,$28.50
2025-06-18,15:29:00,22048.5,BUY,3,0.02h,Break Even,$0.75,$29.25,$592629.50,378,$29.25
2025-06-18,15:32:00,21839.5,SELL,3,0.02h,Stop Loss,$-18.00,$11.25,$592611.50,378,$11.25
2025-06-18,15:33:00,22053.75,BUY,3,0.02h,Stop Loss,$-18.00,$-6.75,$592593.50,378,$-6.75
2025-06-18,15:34:00,21827.5,SELL,3,0.02h,Stop Loss,$-18.00,$-24.75,$592575.50,378,$-24.75
2025-06-18,15:40:00,22062.25,BUY,3,0.02h,Stop Loss,$15.75,$-9.00,$592591.25,378,$-9.00
2025-06-18,15:50:00,21833.5,SELL,3,0.02h,Stop Loss,$-18.00,$-27.00,$592573.25,378,$-27.00
2025-06-18,15:52:00,22068.5,BUY,3,0.02h,Stop Loss,$38.25,$11.25,$592611.50,378,$11.25
2025-06-18,15:55:00,21851.25,SELL,3,0.02h,Stop Loss,$-18.00,$-6.75,$592593.50,378,$-6.75
2025-06-18,15:56:00,22070.75,BUY,3,0.02h,Break Even,$0.75,$-6.00,$592594.25,378,$-6.00
2025-06-18,15:58:00,21826.75,SELL,3,0.02h,Stop Loss,$-18.00,$-24.00,$592576.25,378,$-24.00
2025-06-18,16:03:00,22048.5,BUY,3,0.02h,Stop Loss,$64.50,$40.50,$592640.75,378,$40.50
2025-06-18,16:05:00,21830.75,SELL,3,0.02h,Stop Loss,$-18.00,$22.50,$592622.75,378,$22.50
2025-06-18,16:07:00,22046.75,BUY,3,0.02h,Stop Loss,$19.50,$42.00,$592642.25,378,$42.00
2025-06-18,16:09:00,21836.75,SELL,3,0.02h,Break Even,$0.75,$42.75,$592643.00,378,$42.75
2025-06-18,16:16:00,22056.0,BUY,3,0.02h,Stop Loss,$-18.00,$24.75,$592625.00,378,$24.75
2025-06-18,16:18:00,21820.25,SELL,3,0.02h,Stop Loss,$-18.00,$6.75,$592607.00,378,$6.75
2025-06-18,16:23:00,22046.5,BUY,3,0.02h,Break Even,$0.75,$7.50,$592607.75,378,$7.50
2025-06-18,16:27:00,21818.25,SELL,3,0.02h,Stop Loss,$53.25,$60.75,$592661.00,378,$60.75
2025-06-18,16:38:00,22037.25,BUY,3,0.02h,Stop Loss,$-18.00,$42.75,$592643.00,378,$42.75
2025-06-18,16:44:00,21814.25,SELL,3,0.02h,Break Even,$0.75,$43.50,$592643.75,378,$43.50
2025-06-18,16:52:00,22047.5,BUY,3,0.02h,Stop Loss,$-18.00,$25.50,$592625.75,378,$25.50
2025-06-18,16:56:00,21809.0,SELL,3,0.02h,Stop Loss,$-18.00,$7.50,$592607.75,378,$7.50
2025-06-18,16:57:00,22033.25,BUY,3,0.02h,Break Even,$0.75,$8.25,$592608.50,378,$8.25
2025-06-18,16:59:00,21814.75,SELL,3,0.02h,Stop Loss,$128.25,$136.50,$592736.75,378,$136.50
2025-06-18,17:05:00,22030.5,BUY,3,0.02h,Stop Loss,$-18.00,$118.50,$592718.75,378,$118.50
2025-06-18,17:06:00,21804.75,SELL,3,0.02h,Stop Loss,$38.25,$156.75,$592757.00,378,$156.75
2025-06-18,17:10:00,22032.0,BUY,3,0.02h,Stop Loss,$53.25,$210.00,$592810.25,378,$210.00
2025-06-18,17:13:00,21808.75,SELL,3,0.02h,Stop Loss,$-18.00,$192.00,$592792.25,378,$192.00
2025-06-18,17:14:00,22023.5,BUY,3,0.02h,Stop Loss,$-18.00,$174.00,$592774.25,378,$174.00
2025-06-18,17:15:00,21803.75,SELL,3,0.02h,Stop Loss,$-18.00,$156.00,$592756.25,378,$156.00
2025-06-18,17:16:00,22031.75,BUY,3,0.02h,Stop Loss,$-18.00,$138.00,$592738.25,378,$138.00
2025-06-18,17:18:00,21798.75,SELL,3,0.02h,Stop Loss,$-18.00,$120.00,$592720.25,378,$120.00
2025-06-18,17:22:00,22002.5,BUY,3,0.02h,Stop Loss,$-18.00,$102.00,$592702.25,378,$102.00
2025-06-18,17:23:00,21773.75,SELL,3,0.02h,Stop Loss,$-18.00,$84.00,$592684.25,378,$84.00
2025-06-18,17:24:00,21994.0,BUY,3,0.02h,Stop Loss,$-18.00,$66.00,$592666.25,378,$66.00
2025-06-18,17:25:00,21772.25,SELL,3,0.02h,Stop Loss,$19.50,$85.50,$592685.75,378,$85.50
2025-06-18,17:36:00,21949.0,BUY,3,0.02h,Stop Loss,$165.75,$251.25,$592851.50,378,$251.25
2025-06-18,17:38:00,21745.0,SELL,3,0.02h,Stop Loss,$-18.00,$233.25,$592833.50,378,$233.25
2025-06-18,17:39:00,21976.25,BUY,3,0.02h,Stop Loss,$12.00,$245.25,$592845.50,378,$245.25
2025-06-18,17:54:00,21804.25,SELL,3,0.02h,Stop Loss,$-18.00,$227.25,$592827.50,378,$227.25
2025-06-18,17:55:00,22031.5,BUY,3,0.02h,Stop Loss,$-18.00,$209.25,$592809.50,378,$209.25
2025-06-18,17:56:00,21805.25,SELL,3,0.02h,Stop Loss,$-18.00,$191.25,$592791.50,378,$191.25
2025-06-18,18:02:00,22042.75,BUY,3,0.02h,Stop Loss,$-18.00,$173.25,$592773.50,378,$173.25
2025-06-18,18:03:00,21775.75,SELL,3,0.02h,Stop Loss,$-18.00,$155.25,$592755.50,378,$155.25
2025-06-18,18:04:00,22011.25,BUY,3,0.02h,Stop Loss,$117.00,$272.25,$592872.50,378,$272.25
2025-06-18,18:07:00,21775.0,SELL,3,0.02h,Stop Loss,$102.00,$374.25,$592974.50,378,$374.25
2025-06-18,18:12:00,22011.75,BUY,3,0.02h,Stop Loss,$38.25,$412.50,$593012.75,378,$412.50
2025-06-18,18:14:00,21780.5,SELL,3,0.02h,Stop Loss,$34.50,$447.00,$593047.25,378,$447.00
2025-06-18,18:33:00,22038.75,BUY,3,0.02h,Stop Loss,$120.75,$567.75,$593168.00,378,$567.75
2025-06-18,18:50:00,21792.75,SELL,3,0.02h,Stop Loss,$-18.00,$549.75,$593150.00,378,$549.75
2025-06-18,18:51:00,22008.5,BUY,3,0.02h,Stop Loss,$-18.00,$531.75,$593132.00,378,$531.75
2025-06-18,18:52:00,21781.25,SELL,3,0.02h,Stop Loss,$-18.00,$513.75,$593114.00,378,$513.75
2025-06-18,18:53:00,21995.25,BUY,3,0.02h,Stop Loss,$-18.00,$495.75,$593096.00,378,$495.75
2025-06-18,18:55:00,21752.5,SELL,3,0.02h,Stop Loss,$364.50,$860.25,$593460.50,378,$860.25
2025-06-18,19:06:00,21954.75,BUY,3,0.02h,Stop Loss,$158.25,$1018.50,$593618.75,378,$1018.50
2025-06-18,19:08:00,21718.5,SELL,3,0.02h,Stop Loss,$-18.00,$1000.50,$593600.75,378,$1000.50
2025-06-18,19:09:00,21932.5,BUY,3,0.02h,Stop Loss,$-18.00,$982.50,$593582.75,378,$982.50
2025-06-18,19:10:00,21709.25,SELL,3,0.02h,Stop Loss,$-18.00,$964.50,$593564.75,378,$964.50
2025-06-18,19:11:00,21939.5,BUY,3,0.02h,Stop Loss,$-18.00,$946.50,$593546.75,378,$946.50
2025-06-18,19:12:00,21723.25,SELL,3,0.02h,Stop Loss,$-18.00,$928.50,$593528.75,378,$928.50
2025-06-18,19:13:00,21927.5,BUY,3,0.02h,Stop Loss,$814.50,$1743.00,$594343.25,378,$1743.00
2025-06-18,19:22:00,21773.5,SELL,3,0.02h,Stop Loss,$-18.00,$1725.00,$594325.25,378,$1725.00
2025-06-18,19:23:00,22005.0,BUY,3,0.02h,Stop Loss,$72.00,$1797.00,$594397.25,378,$1797.00
2025-06-18,19:27:00,21750.0,SELL,3,0.02h,Stop Loss,$-18.00,$1779.00,$594379.25,378,$1779.00
2025-06-18,19:28:00,21952.5,BUY,3,0.02h,Stop Loss,$-18.00,$1761.00,$594361.25,378,$1761.00
2025-06-18,19:31:00,21713.25,SELL,3,0.02h,Stop Loss,$-18.00,$1743.00,$594343.25,378,$1743.00
2025-06-18,19:33:00,21957.0,BUY,3,0.02h,Stop Loss,$94.50,$1837.50,$594437.75,378,$1837.50
2025-06-18,19:36:00,21748.25,SELL,3,0.02h,Stop Loss,$-18.00,$1819.50,$594419.75,378,$1819.50
2025-06-18,19:37:00,21978.25,BUY,3,0.02h,Stop Loss,$-18.00,$1801.50,$594401.75,378,$1801.50
2025-06-18,19:38:00,21758.25,SELL,3,0.02h,Stop Loss,$150.75,$1952.25,$594552.50,378,$1952.25
2025-06-18,19:42:00,21991.5,BUY,3,0.02h,Stop Loss,$-18.00,$1934.25,$594534.50,378,$1934.25
2025-06-18,19:43:00,21757.25,SELL,3,0.02h,Stop Loss,$-18.00,$1916.25,$594516.50,378,$1916.25
2025-06-18,19:44:00,21999.0,BUY,3,0.02h,Stop Loss,$-18.00,$1898.25,$594498.50,378,$1898.25
2025-06-18,19:45:00,21777.25,SELL,3,0.02h,Stop Loss,$259.50,$2157.75,$594758.00,378,$2157.75
2025-06-18,19:55:00,21949.25,BUY,3,0.02h,Stop Loss,$210.75,$2368.50,$594968.75,378,$2368.50
2025-06-18,19:58:00,21721.75,SELL,3,0.02h,Stop Loss,$-18.00,$2350.50,$594950.75,378,$2350.50
2025-06-18,19:59:00,21943.75,BUY,3,0.02h,Stop Loss,$75.75,$2426.25,$595026.50,378,$2426.25
2025-06-18,20:06:00,21731.5,SELL,3,0.02h,Stop Loss,$-18.00,$2408.25,$595008.50,378,$2408.25
2025-06-18,20:07:00,21951.75,BUY,3,0.02h,Stop Loss,$75.75,$2484.00,$595084.25,378,$2484.00
2025-06-18,20:16:00,21738.75,SELL,3,0.02h,Stop Loss,$-18.00,$2466.00,$595066.25,378,$2466.00
2025-06-18,20:29:00,21954.25,BUY,3,0.02h,Stop Loss,$57.00,$2523.00,$595123.25,378,$2523.00
2025-06-18,20:45:00,21742.25,SELL,3,0.02h,Stop Loss,$-18.00,$2505.00,$595105.25,378,$2505.00
2025-06-18,20:46:00,21963.25,BUY,3,0.02h,Break Even,$0.75,$2505.75,$595106.00,378,$2505.75
2025-06-18,20:49:00,21739.25,SELL,3,0.02h,Stop Loss,$-18.00,$2487.75,$595088.00,378,$2487.75
2025-06-18,20:55:00,21974.25,BUY,3,0.02h,Stop Loss,$-18.00,$2469.75,$595070.00,378,$2469.75
2025-06-18,20:56:00,21748.0,SELL,3,0.02h,Stop Loss,$-18.00,$2451.75,$595052.00,378,$2451.75
2025-06-18,22:12:00,21932.0,BUY,3,0.02h,Break Even,$0.75,$2452.50,$595052.75,378,$2452.50
2025-06-18,22:14:00,21703.0,SELL,3,0.02h,Stop Loss,$-18.00,$2434.50,$595034.75,378,$2434.50
2025-06-18,22:15:00,21929.75,BUY,3,0.02h,Stop Loss,$-18.00,$2416.50,$595016.75,378,$2416.50
2025-06-18,22:17:00,21701.5,SELL,3,0.02h,Stop Loss,$-18.00,$2398.50,$594998.75,378,$2398.50
2025-06-18,22:18:00,21925.75,BUY,3,0.02h,Stop Loss,$-18.00,$2380.50,$594980.75,378,$2380.50
2025-06-18,22:19:00,21706.0,SELL,3,0.02h,Break Even,$0.75,$2381.25,$594981.50,378,$2381.25
2025-06-18,22:23:00,21927.5,BUY,3,0.02h,Stop Loss,$87.00,$2468.25,$595068.50,378,$2468.25
2025-06-18,22:29:00,21712.0,SELL,3,0.02h,Stop Loss,$-18.00,$2450.25,$595050.50,378,$2450.25
2025-06-18,22:30:00,21932.25,BUY,3,0.02h,Break Even,$0.75,$2451.00,$595051.25,378,$2451.00
2025-06-18,22:33:00,21695.25,SELL,3,0.02h,Stop Loss,$-18.00,$2433.00,$595033.25,378,$2433.00
2025-06-18,22:34:00,21918.25,BUY,3,0.02h,Break Even,$0.75,$2433.75,$595034.00,378,$2433.75
2025-06-18,22:36:00,21687.75,SELL,3,0.02h,Stop Loss,$-18.00,$2415.75,$595016.00,378,$2415.75
2025-06-18,22:48:00,21921.25,BUY,3,0.02h,Stop Loss,$-18.00,$2397.75,$594998.00,378,$2397.75
2025-06-18,22:52:00,21700.0,SELL,3,0.02h,Stop Loss,$-18.00,$2379.75,$594980.00,378,$2379.75
2025-06-18,22:54:00,21930.5,BUY,3,0.02h,Stop Loss,$38.25,$2418.00,$595018.25,378,$2418.00
2025-06-18,22:59:00,21707.0,SELL,3,0.02h,Stop Loss,$-18.00,$2400.00,$595000.25,378,$2400.00
,,,,,,,,,,,
2025-06-19,12:22:00,21805.5,BUY,3,0.02h,Stop Loss,$-18.00,$-18.00,$594982.25,379,$-18.00
2025-06-19,12:25:00,21595.75,SELL,3,0.02h,Stop Loss,$64.50,$46.50,$595046.75,379,$46.50
2025-06-19,12:31:00,21806.0,BUY,3,0.02h,Stop Loss,$57.00,$103.50,$595103.75,379,$103.50
2025-06-19,12:35:00,21575.25,SELL,3,0.02h,Stop Loss,$27.00,$130.50,$595130.75,379,$130.50
2025-06-19,12:37:00,21795.0,BUY,3,0.02h,Stop Loss,$-18.00,$112.50,$595112.75,379,$112.50
2025-06-19,12:38:00,21580.0,SELL,3,0.02h,Break Even,$0.75,$113.25,$595113.50,379,$113.25
2025-06-19,12:40:00,21793.75,BUY,3,0.02h,Stop Loss,$-18.00,$95.25,$595095.50,379,$95.25
2025-06-19,12:41:00,21577.5,SELL,3,0.02h,Stop Loss,$-18.00,$77.25,$595077.50,379,$77.25
2025-06-19,12:42:00,21792.25,BUY,3,0.02h,Stop Loss,$-18.00,$59.25,$595059.50,379,$59.25
2025-06-19,12:43:00,21571.75,SELL,3,0.02h,Stop Loss,$192.00,$251.25,$595251.50,379,$251.25
2025-06-19,12:56:00,21757.0,BUY,3,0.02h,Stop Loss,$-18.00,$233.25,$595233.50,379,$233.25
2025-06-19,13:08:00,21541.25,SELL,3,0.02h,Stop Loss,$60.75,$294.00,$595294.25,379,$294.00
2025-06-19,13:11:00,21762.75,BUY,3,0.02h,Stop Loss,$-18.00,$276.00,$595276.25,379,$276.00
2025-06-19,13:12:00,21547.0,SELL,3,0.02h,Stop Loss,$38.25,$314.25,$595314.50,379,$314.25
2025-06-19,13:15:00,21770.0,BUY,3,0.02h,Break Even,$0.75,$315.00,$595315.25,379,$315.00
2025-06-19,13:20:00,21555.75,SELL,3,0.02h,Stop Loss,$30.75,$345.75,$595346.00,379,$345.75
2025-06-19,13:22:00,21768.75,BUY,3,0.02h,Break Even,$0.75,$346.50,$595346.75,379,$346.50
2025-06-19,13:27:00,21563.0,SELL,3,0.02h,Stop Loss,$-18.00,$328.50,$595328.75,379,$328.50
2025-06-19,13:28:00,21781.0,BUY,3,0.02h,Break Even,$0.75,$329.25,$595329.50,379,$329.25
2025-06-19,13:31:00,21557.25,SELL,3,0.02h,Stop Loss,$53.25,$382.50,$595382.75,379,$382.50
2025-06-19,13:35:00,21755.5,BUY,3,0.02h,Stop Loss,$-18.00,$364.50,$595364.75,379,$364.50
2025-06-19,13:36:00,21532.5,SELL,3,0.02h,Stop Loss,$27.00,$391.50,$595391.75,379,$391.50
2025-06-19,13:43:00,21723.5,BUY,3,0.02h,Stop Loss,$-18.00,$373.50,$595373.75,379,$373.50
2025-06-19,13:44:00,21509.5,SELL,3,0.02h,Break Even,$0.75,$374.25,$595374.50,379,$374.25
2025-06-19,13:47:00,21708.0,BUY,3,0.02h,Stop Loss,$-18.00,$356.25,$595356.50,379,$356.25
2025-06-19,13:49:00,21438.75,SELL,3,0.02h,Stop Loss,$-18.00,$338.25,$595338.50,379,$338.25
2025-06-19,13:51:00,21685.0,BUY,3,0.02h,Stop Loss,$-18.00,$320.25,$595320.50,379,$320.25
2025-06-19,13:53:00,21465.75,SELL,3,0.02h,Stop Loss,$-18.00,$302.25,$595302.50,379,$302.25
2025-06-19,13:56:00,21695.25,BUY,3,0.02h,Stop Loss,$45.75,$348.00,$595348.25,379,$348.00
2025-06-19,14:01:00,21477.0,SELL,3,0.02h,Stop Loss,$-18.00,$330.00,$595330.25,379,$330.00
2025-06-19,14:02:00,21677.25,BUY,3,0.02h,Stop Loss,$117.00,$447.00,$595447.25,379,$447.00
2025-06-19,14:04:00,21467.25,SELL,3,0.02h,Stop Loss,$-18.00,$429.00,$595429.25,379,$429.00
2025-06-19,14:12:00,21707.75,BUY,3,0.02h,Stop Loss,$60.75,$489.75,$595490.00,379,$489.75
2025-06-19,14:16:00,21496.25,SELL,3,0.02h,Stop Loss,$-18.00,$471.75,$595472.00,379,$471.75
2025-06-19,14:17:00,21711.75,BUY,3,0.02h,Stop Loss,$-18.00,$453.75,$595454.00,379,$453.75
2025-06-19,14:18:00,21496.75,SELL,3,0.02h,Stop Loss,$-18.00,$435.75,$595436.00,379,$435.75
2025-06-19,14:19:00,21710.75,BUY,3,0.02h,Stop Loss,$-18.00,$417.75,$595418.00,379,$417.75
2025-06-19,14:23:00,21500.5,SELL,3,0.02h,Stop Loss,$-18.00,$399.75,$595400.00,379,$399.75
2025-06-19,14:24:00,21717.25,BUY,3,0.02h,Break Even,$0.75,$400.50,$595400.75,379,$400.50
2025-06-19,14:26:00,21502.5,SELL,3,0.02h,Stop Loss,$-18.00,$382.50,$595382.75,379,$382.50
2025-06-19,14:27:00,21720.5,BUY,3,0.02h,Stop Loss,$15.75,$398.25,$595398.50,379,$398.25
2025-06-19,14:31:00,21495.25,SELL,3,0.02h,Stop Loss,$-18.00,$380.25,$595380.50,379,$380.25
2025-06-19,14:32:00,21703.0,BUY,3,0.02h,Stop Loss,$-18.00,$362.25,$595362.50,379,$362.25
2025-06-19,14:33:00,21485.25,SELL,3,0.02h,Stop Loss,$-18.00,$344.25,$595344.50,379,$344.25
2025-06-19,14:34:00,21698.5,BUY,3,0.02h,Break Even,$0.75,$345.00,$595345.25,379,$345.00
2025-06-19,14:38:00,21482.25,SELL,3,0.02h,Stop Loss,$-18.00,$327.00,$595327.25,379,$327.00
2025-06-19,14:39:00,21710.5,BUY,3,0.02h,Stop Loss,$45.75,$372.75,$595373.00,379,$372.75
2025-06-19,14:42:00,21490.5,SELL,3,0.02h,Stop Loss,$109.50,$482.25,$595482.50,379,$482.25
2025-06-19,14:45:00,21682.0,BUY,3,0.02h,Stop Loss,$214.50,$696.75,$595697.00,379,$696.75
2025-06-19,14:47:00,21484.0,SELL,3,0.02h,Stop Loss,$42.00,$738.75,$595739.00,379,$738.75
2025-06-19,14:50:00,21697.0,BUY,3,0.02h,Stop Loss,$-18.00,$720.75,$595721.00,379,$720.75
2025-06-19,14:51:00,21485.75,SELL,3,0.02h,Stop Loss,$-18.00,$702.75,$595703.00,379,$702.75
2025-06-19,14:53:00,21707.75,BUY,3,0.02h,Stop Loss,$12.00,$714.75,$595715.00,379,$714.75
2025-06-19,14:55:00,21499.5,SELL,3,0.02h,Stop Loss,$-18.00,$696.75,$595697.00,379,$696.75
2025-06-19,14:59:00,21723.5,BUY,3,0.02h,Stop Loss,$34.50,$731.25,$595731.50,379,$731.25
2025-06-19,15:03:00,21505.75,SELL,3,0.02h,Stop Loss,$34.50,$765.75,$595766.00,379,$765.75
2025-06-19,15:10:00,21702.25,BUY,3,0.02h,Stop Loss,$150.75,$916.50,$595916.75,379,$916.50
2025-06-19,15:20:00,21516.75,SELL,3,0.02h,Stop Loss,$-18.00,$898.50,$595898.75,379,$898.50
2025-06-19,15:21:00,21724.5,BUY,3,0.02h,Stop Loss,$-18.00,$880.50,$595880.75,379,$880.50
2025-06-19,15:22:00,21497.5,SELL,3,0.02h,Stop Loss,$-18.00,$862.50,$595862.75,379,$862.50
2025-06-19,15:24:00,21708.5,BUY,3,0.02h,Stop Loss,$-18.00,$844.50,$595844.75,379,$844.50
2025-06-19,15:25:00,21494.5,SELL,3,0.02h,Stop Loss,$-18.00,$826.50,$595826.75,379,$826.50
2025-06-19,15:27:00,21711.0,BUY,3,0.02h,Stop Loss,$-18.00,$808.50,$595808.75,379,$808.50
2025-06-19,15:30:00,21503.75,SELL,3,0.02h,Stop Loss,$-18.00,$790.50,$595790.75,379,$790.50
2025-06-19,15:31:00,21716.75,BUY,3,0.02h,Break Even,$0.75,$791.25,$595791.50,379,$791.25
2025-06-19,15:33:00,21493.25,SELL,3,0.02h,Stop Loss,$-18.00,$773.25,$595773.50,379,$773.25
2025-06-19,15:44:00,21703.0,BUY,3,0.02h,Stop Loss,$124.50,$897.75,$595898.00,379,$897.75
2025-06-19,15:46:00,21499.75,SELL,3,0.02h,Stop Loss,$-18.00,$879.75,$595880.00,379,$879.75
2025-06-19,15:47:00,21716.75,BUY,3,0.02h,Stop Loss,$-18.00,$861.75,$595862.00,379,$861.75
2025-06-19,15:48:00,21505.5,SELL,3,0.02h,Stop Loss,$-18.00,$843.75,$595844.00,379,$843.75
2025-06-19,15:49:00,21715.75,BUY,3,0.02h,Stop Loss,$-18.00,$825.75,$595826.00,379,$825.75
2025-06-19,15:50:00,21498.75,SELL,3,0.02h,Stop Loss,$-18.00,$807.75,$595808.00,379,$807.75
2025-06-19,15:51:00,21715.25,BUY,3,0.02h,Stop Loss,$-18.00,$789.75,$595790.00,379,$789.75
2025-06-19,15:52:00,21484.75,SELL,3,0.02h,Stop Loss,$-18.00,$771.75,$595772.00,379,$771.75
2025-06-19,15:54:00,21692.25,BUY,3,0.02h,Stop Loss,$-18.00,$753.75,$595754.00,379,$753.75
2025-06-19,15:55:00,21479.0,SELL,3,0.02h,Stop Loss,$-18.00,$735.75,$595736.00,379,$735.75
2025-06-19,15:56:00,21699.5,BUY,3,0.02h,Break Even,$0.75,$736.50,$595736.75,379,$736.50
2025-06-19,15:58:00,21480.5,SELL,3,0.02h,Stop Loss,$222.00,$958.50,$595958.75,379,$958.50
2025-06-19,16:01:00,21688.75,BUY,3,0.02h,Stop Loss,$-18.00,$940.50,$595940.75,379,$940.50
2025-06-19,16:02:00,21475.25,SELL,3,0.02h,Stop Loss,$-18.00,$922.50,$595922.75,379,$922.50
2025-06-19,16:04:00,21699.75,BUY,3,0.02h,Break Even,$0.75,$923.25,$595923.50,379,$923.25
2025-06-19,16:08:00,21497.0,SELL,3,0.02h,Break Even,$0.75,$924.00,$595924.25,379,$924.00
2025-06-19,16:13:00,21714.25,BUY,3,0.02h,Stop Loss,$-18.00,$906.00,$595906.25,379,$906.00
2025-06-19,16:14:00,21496.75,SELL,3,0.02h,Stop Loss,$12.00,$918.00,$595918.25,379,$918.00
2025-06-19,16:19:00,21718.25,BUY,3,0.02h,Stop Loss,$-18.00,$900.00,$595900.25,379,$900.00
2025-06-19,16:20:00,21500.5,SELL,3,0.02h,Stop Loss,$-18.00,$882.00,$595882.25,379,$882.00
2025-06-19,16:23:00,21724.75,BUY,3,0.02h,Break Even,$0.75,$882.75,$595883.00,379,$882.75
2025-06-19,16:27:00,21512.25,SELL,3,0.02h,Stop Loss,$-18.00,$864.75,$595865.00,379,$864.75
2025-06-19,16:32:00,21735.25,BUY,3,0.02h,Stop Loss,$-18.00,$846.75,$595847.00,379,$846.75
2025-06-19,16:33:00,21514.5,SELL,3,0.02h,Stop Loss,$109.50,$956.25,$595956.50,379,$956.25
2025-06-19,16:36:00,21738.25,BUY,3,0.02h,Stop Loss,$-18.00,$938.25,$595938.50,379,$938.25
2025-06-19,16:37:00,21515.0,SELL,3,0.02h,Stop Loss,$-18.00,$920.25,$595920.50,379,$920.25
2025-06-19,16:41:00,21730.75,BUY,3,0.02h,Break Even,$0.75,$921.00,$595921.25,379,$921.00
2025-06-19,16:50:00,21510.25,SELL,3,0.02h,Stop Loss,$128.25,$1049.25,$596049.50,379,$1049.25
2025-06-19,16:54:00,21719.25,BUY,3,0.02h,Break Even,$0.75,$1050.00,$596050.25,379,$1050.00
2025-06-19,22:15:00,21607.25,SELL,3,0.02h,Stop Loss,$-18.00,$1032.00,$596032.25,379,$1032.00
2025-06-19,22:16:00,21831.5,BUY,3,0.02h,Stop Loss,$79.50,$1111.50,$596111.75,379,$1111.50
2025-06-19,22:31:00,21624.0,SELL,3,0.02h,Stop Loss,$-18.00,$1093.50,$596093.75,379,$1093.50
2025-06-19,22:34:00,21871.0,BUY,3,0.02h,Break Even,$0.75,$1094.25,$596094.50,379,$1094.25
2025-06-19,22:42:00,21672.5,SELL,3,0.02h,Break Even,$0.75,$1095.00,$596095.25,379,$1095.00
2025-06-19,22:44:00,21905.0,BUY,3,0.02h,Stop Loss,$-18.00,$1077.00,$596077.25,379,$1077.00
2025-06-19,22:45:00,21675.25,SELL,3,0.02h,Break Even,$0.75,$1077.75,$596078.00,379,$1077.75
2025-06-19,22:47:00,21909.5,BUY,3,0.02h,Stop Loss,$-18.00,$1059.75,$596060.00,379,$1059.75
2025-06-19,22:48:00,21700.75,SELL,3,0.02h,Stop Loss,$57.00,$1116.75,$596117.00,379,$1116.75
2025-06-19,22:56:00,21898.5,BUY,3,0.02h,Stop Loss,$-18.00,$1098.75,$596099.00,379,$1098.75
2025-06-19,22:57:00,21677.25,SELL,3,0.02h,Stop Loss,$-18.00,$1080.75,$596081.00,379,$1080.75
2025-06-19,22:58:00,21896.25,BUY,3,0.02h,Break Even,$0.75,$1081.50,$596081.75,379,$1081.50
,,,,,,,,,,,
2025-06-20,12:34:00,21769.25,SELL,3,0.02h,Stop Loss,$-18.00,$-18.00,$596063.75,380,$-18.00
2025-06-20,12:35:00,22015.0,BUY,3,0.02h,Stop Loss,$-18.00,$-36.00,$596045.75,380,$-36.00
2025-06-20,12:37:00,21777.0,SELL,3,0.02h,Stop Loss,$64.50,$28.50,$596110.25,380,$28.50
2025-06-20,12:42:00,22000.75,BUY,3,0.02h,Stop Loss,$105.75,$134.25,$596216.00,380,$134.25
2025-06-20,12:44:00,21789.0,SELL,3,0.02h,Stop Loss,$27.00,$161.25,$596243.00,380,$161.25
2025-06-20,12:49:00,22020.75,BUY,3,0.02h,Break Even,$0.75,$162.00,$596243.75,380,$162.00
2025-06-20,12:52:00,21804.75,SELL,3,0.02h,Stop Loss,$42.00,$204.00,$596285.75,380,$204.00
2025-06-20,12:57:00,22032.5,BUY,3,0.02h,Stop Loss,$12.00,$216.00,$596297.75,380,$216.00
2025-06-20,13:11:00,21802.5,SELL,3,0.02h,Stop Loss,$-18.00,$198.00,$596279.75,380,$198.00
2025-06-20,13:21:00,22051.25,BUY,3,0.02h,Stop Loss,$-18.00,$180.00,$596261.75,380,$180.00
2025-06-20,13:22:00,21830.25,SELL,3,0.02h,Stop Loss,$-18.00,$162.00,$596243.75,380,$162.00
2025-06-20,13:23:00,22058.75,BUY,3,0.02h,Stop Loss,$-18.00,$144.00,$596225.75,380,$144.00
2025-06-20,13:25:00,21835.5,SELL,3,0.02h,Stop Loss,$267.00,$411.00,$596492.75,380,$411.00
2025-06-20,13:31:00,22086.5,BUY,3,0.02h,Stop Loss,$117.00,$528.00,$596609.75,380,$528.00
2025-06-20,13:56:00,22036.5,SELL,3,0.02h,Stop Loss,$49.50,$577.50,$596659.25,380,$577.50
2025-06-20,15:15:00,21853.25,BUY,3,0.02h,Break Even,$0.75,$578.25,$596660.00,380,$578.25
2025-06-20,15:54:00,21868.5,SELL,3,0.02h,Stop Loss,$150.75,$729.00,$596810.75,380,$729.00
2025-06-20,16:13:00,21872.75,BUY,3,0.02h,Stop Loss,$-18.00,$711.00,$596792.75,380,$711.00
2025-06-20,16:15:00,21857.25,SELL,3,0.02h,Stop Loss,$90.75,$801.75,$596883.50,380,$801.75
2025-06-20,16:28:00,21872.25,BUY,3,0.02h,Break Even,$0.75,$802.50,$596884.25,380,$802.50
2025-06-20,17:06:00,21855.75,SELL,3,0.02h,Stop Loss,$60.75,$863.25,$596945.00,380,$863.25
2025-06-20,17:15:00,21886.25,BUY,3,0.02h,Stop Loss,$405.75,$1269.00,$597350.75,380,$1269.00
2025-06-20,17:19:00,21863.25,SELL,3,0.02h,Stop Loss,$23.25,$1292.25,$597374.00,380,$1292.25
2025-06-20,17:53:00,21818.75,BUY,3,0.02h,Stop Loss,$72.00,$1364.25,$597446.00,380,$1364.25
2025-06-20,18:44:00,21865.75,SELL,3,0.02h,Stop Loss,$-18.00,$1346.25,$597428.00,380,$1346.25
2025-06-20,19:55:00,21820.75,BUY,3,0.02h,Stop Loss,$540.75,$1887.00,$597968.75,380,$1887.00
2025-06-20,20:23:00,21849.5,SELL,3,0.02h,Stop Loss,$-18.00,$1869.00,$597950.75,380,$1869.00
2025-06-20,20:27:00,21861.5,BUY,3,0.02h,Stop Loss,$-18.00,$1851.00,$597932.75,380,$1851.00
,,,,,,,,,,,
2025-06-23,12:00:00,21824.75,SELL,3,0.02h,Stop Loss,$-18.00,$-18.00,$597914.75,381,$-18.00
2025-06-23,12:27:00,21849.5,BUY,3,0.02h,Break Even,$0.75,$-17.25,$597915.50,381,$-17.25
2025-06-23,12:30:00,21837.75,SELL,3,0.02h,Break Even,$0.75,$-16.50,$597916.25,381,$-16.50
2025-06-23,12:33:00,21848.0,BUY,3,0.02h,Stop Loss,$64.50,$48.00,$597980.75,381,$48.00
2025-06-23,13:12:00,21861.5,SELL,3,0.02h,Break Even,$0.75,$48.75,$597981.50,381,$48.75
2025-06-23,13:19:00,21883.5,BUY,3,0.02h,Stop Loss,$38.25,$87.00,$598019.75,381,$87.00
2025-06-23,13:28:00,21861.75,SELL,3,0.02h,Break Even,$0.75,$87.75,$598020.50,381,$87.75
2025-06-23,13:44:00,21874.25,BUY,3,0.02h,Stop Loss,$83.25,$171.00,$598103.75,381,$171.00
2025-06-23,14:53:00,21980.5,SELL,3,0.02h,Stop Loss,$30.75,$201.75,$598134.50,381,$201.75
2025-06-23,15:07:00,21995.25,BUY,3,0.02h,Stop Loss,$53.25,$255.00,$598187.75,381,$255.00
2025-06-23,15:23:00,21977.75,SELL,3,0.02h,Stop Loss,$-18.00,$237.00,$598169.75,381,$237.00
2025-06-23,16:46:00,21902.25,BUY,3,0.02h,Stop Loss,$72.00,$309.00,$598241.75,381,$309.00
2025-06-23,16:59:00,21851.75,SELL,3,0.02h,Stop Loss,$158.25,$467.25,$598400.00,381,$467.25
2025-06-23,17:03:00,21883.5,BUY,3,0.02h,Stop Loss,$90.75,$558.00,$598490.75,381,$558.00
2025-06-23,18:26:00,22054.25,SELL,3,0.02h,Break Even,$0.75,$558.75,$598491.50,381,$558.75
2025-06-23,19:02:00,22063.25,BUY,3,0.02h,Stop Loss,$45.75,$604.50,$598537.25,381,$604.50
2025-06-23,19:18:00,22029.0,SELL,3,0.02h,Break Even,$0.75,$605.25,$598538.00,381,$605.25
2025-06-23,19:27:00,22053.5,BUY,3,0.02h,Stop Loss,$38.25,$643.50,$598576.25,381,$643.50
2025-06-23,19:42:00,22047.0,SELL,3,0.02h,Break Even,$0.75,$644.25,$598577.00,381,$644.25
2025-06-23,19:51:00,22055.0,BUY,3,0.02h,Stop Loss,$79.50,$723.75,$598656.50,381,$723.75
2025-06-23,20:23:00,22064.25,SELL,3,0.02h,Stop Loss,$-18.00,$705.75,$598638.50,381,$705.75
2025-06-23,20:24:00,22068.75,BUY,3,0.02h,Break Even,$0.75,$706.50,$598639.25,381,$706.50
2025-06-23,20:56:00,22071.25,SELL,3,0.02h,Break Even,$0.75,$707.25,$598640.00,381,$707.25
2025-06-23,22:03:00,22090.5,BUY,3,0.02h,Stop Loss,$810.75,$1518.00,$599450.75,381,$1518.00
2025-06-23,22:46:00,22179.25,SELL,3,0.02h,Break Even,$0.75,$1518.75,$599451.50,381,$1518.75
2025-06-23,22:58:00,22192.75,BUY,3,0.02h,Stop Loss,$30.75,$1549.50,$599482.25,381,$1549.50
,,,,,,,,,,,
2025-06-24,12:51:00,22277.25,SELL,3,0.02h,Stop Loss,$19.50,$19.50,$599501.75,382,$19.50
2025-06-24,13:12:00,22287.0,BUY,3,0.02h,Stop Loss,$15.75,$35.25,$599517.50,382,$35.25
2025-06-24,13:31:00,22277.5,SELL,3,0.02h,Break Even,$0.75,$36.00,$599518.25,382,$36.00
2025-06-24,13:32:00,22303.75,BUY,3,0.02h,Stop Loss,$120.75,$156.75,$599639.00,382,$156.75
2025-06-24,13:34:00,22283.75,SELL,3,0.02h,Stop Loss,$23.25,$180.00,$599662.25,382,$180.00
2025-06-24,13:36:00,22301.5,BUY,3,0.02h,Stop Loss,$75.75,$255.75,$599738.00,382,$255.75
2025-06-24,13:54:00,22296.5,SELL,3,0.02h,Break Even,$0.75,$256.50,$599738.75,382,$256.50
2025-06-24,14:18:00,22316.75,BUY,3,0.02h,Stop Loss,$75.75,$332.25,$599814.50,382,$332.25
2025-06-24,15:00:00,22315.0,SELL,3,0.02h,Break Even,$0.75,$333.00,$599815.25,382,$333.00
2025-06-24,15:02:00,22330.0,BUY,3,0.02h,Stop Loss,$229.50,$562.50,$600044.75,382,$562.50
2025-06-24,15:57:00,22365.75,SELL,3,0.02h,Break Even,$0.75,$563.25,$600045.50,382,$563.25
2025-06-24,16:07:00,22375.5,BUY,3,0.02h,Stop Loss,$19.50,$582.75,$600065.00,382,$582.75
2025-06-24,16:56:00,22398.75,SELL,3,0.02h,Stop Loss,$49.50,$632.25,$600114.50,382,$632.25
2025-06-24,17:02:00,22407.5,BUY,3,0.02h,Break Even,$0.75,$633.00,$600115.25,382,$633.00
2025-06-24,17:22:00,22381.0,SELL,3,0.02h,Stop Loss,$-18.00,$615.00,$600097.25,382,$615.00
2025-06-24,17:34:00,22402.5,BUY,3,0.02h,Break Even,$0.75,$615.75,$600098.00,382,$615.75
2025-06-24,18:15:00,22412.75,SELL,3,0.02h,Stop Loss,$-18.00,$597.75,$600080.00,382,$597.75
2025-06-24,18:24:00,22422.0,BUY,3,0.02h,Break Even,$0.75,$598.50,$600080.75,382,$598.50
2025-06-24,18:30:00,22415.0,SELL,3,0.02h,Break Even,$0.75,$599.25,$600081.50,382,$599.25
2025-06-24,18:38:00,22426.75,BUY,3,0.02h,Stop Loss,$-18.00,$581.25,$600063.50,382,$581.25
2025-06-24,18:55:00,22417.0,SELL,3,0.02h,Break Even,$0.75,$582.00,$600064.25,382,$582.00
2025-06-24,18:58:00,22426.75,BUY,3,0.02h,Stop Loss,$-18.00,$564.00,$600046.25,382,$564.00
2025-06-24,19:22:00,22429.0,SELL,3,0.02h,Stop Loss,$-18.00,$546.00,$600028.25,382,$546.00
2025-06-24,20:25:00,22406.0,BUY,3,0.02h,Break Even,$0.75,$546.75,$600029.00,382,$546.75
2025-06-24,20:59:00,22410.5,SELL,3,0.02h,Break Even,$0.75,$547.50,$600029.75,382,$547.50
2025-06-24,22:28:00,22400.75,BUY,3,0.02h,Stop Loss,$-18.00,$529.50,$600011.75,382,$529.50
2025-06-24,22:37:00,22394.75,SELL,3,0.02h,Stop Loss,$-18.00,$511.50,$599993.75,382,$511.50
2025-06-24,22:45:00,22399.5,BUY,3,0.02h,Stop Loss,$-18.00,$493.50,$599975.75,382,$493.50
2025-06-24,22:56:00,22396.75,SELL,3,0.02h,Stop Loss,$-18.00,$475.50,$599957.75,382,$475.50
,,,,,,,,,,,
2025-06-25,12:00:00,22490.5,BUY,3,0.02h,Stop Loss,$34.50,$34.50,$599992.25,383,$34.50
2025-06-25,13:11:00,22498.5,SELL,3,0.02h,Break Even,$0.75,$35.25,$599993.00,383,$35.25
2025-06-25,13:14:00,22506.5,BUY,3,0.02h,Break Even,$0.75,$36.00,$599993.75,383,$36.00
2025-06-25,13:29:00,22498.5,SELL,3,0.02h,Stop Loss,$-18.00,$18.00,$599975.75,383,$18.00
2025-06-25,13:31:00,22517.75,BUY,3,0.02h,Stop Loss,$139.50,$157.50,$600115.25,383,$157.50
2025-06-25,13:51:00,22501.25,SELL,3,0.02h,Stop Loss,$105.75,$263.25,$600221.00,383,$263.25
2025-06-25,14:00:00,22522.5,BUY,3,0.02h,Stop Loss,$53.25,$316.50,$600274.25,383,$316.50
2025-06-25,14:02:00,22512.0,SELL,3,0.02h,Stop Loss,$154.50,$471.00,$600428.75,383,$471.00
2025-06-25,14:33:00,22494.5,BUY,3,0.02h,Stop Loss,$23.25,$494.25,$600452.00,383,$494.25
2025-06-25,14:51:00,22480.25,SELL,3,0.02h,Stop Loss,$12.00,$506.25,$600464.00,383,$506.25
2025-06-25,15:52:00,22456.75,BUY,3,0.02h,Stop Loss,$-18.00,$488.25,$600446.00,383,$488.25
2025-06-25,16:00:00,22444.25,SELL,3,0.02h,Stop Loss,$-18.00,$470.25,$600428.00,383,$470.25
2025-06-25,16:02:00,22454.25,BUY,3,0.02h,Break Even,$0.75,$471.00,$600428.75,383,$471.00
2025-06-25,16:05:00,22448.25,SELL,3,0.02h,Stop Loss,$15.75,$486.75,$600444.50,383,$486.75
2025-06-25,16:54:00,22436.75,BUY,3,0.02h,Break Even,$0.75,$487.50,$600445.25,383,$487.50
2025-06-25,17:09:00,22427.5,SELL,3,0.02h,Stop Loss,$12.00,$499.50,$600457.25,383,$499.50
2025-06-25,17:16:00,22445.5,BUY,3,0.02h,Break Even,$0.75,$500.25,$600458.00,383,$500.25
2025-06-25,17:34:00,22433.5,SELL,3,0.02h,Stop Loss,$124.50,$624.75,$600582.50,383,$624.75
2025-06-25,18:13:00,22424.75,BUY,3,0.02h,Stop Loss,$-18.00,$606.75,$600564.50,383,$606.75
2025-06-25,18:33:00,22416.75,SELL,3,0.02h,Break Even,$0.75,$607.50,$600565.25,383,$607.50
2025-06-25,18:58:00,22424.0,BUY,3,0.02h,Stop Loss,$-18.00,$589.50,$600547.25,383,$589.50
2025-06-25,19:32:00,22428.75,SELL,3,0.02h,Stop Loss,$-18.00,$571.50,$600529.25,383,$571.50
2025-06-25,19:45:00,22441.25,BUY,3,0.02h,Break Even,$0.75,$572.25,$600530.00,383,$572.25
2025-06-25,19:47:00,22434.0,SELL,3,0.02h,Break Even,$0.75,$573.00,$600530.75,383,$573.00
2025-06-25,19:51:00,22443.25,BUY,3,0.02h,Stop Loss,$30.75,$603.75,$600561.50,383,$603.75
2025-06-25,20:27:00,22461.25,SELL,3,0.02h,Stop Loss,$-18.00,$585.75,$600543.50,383,$585.75
2025-06-25,20:38:00,22464.75,BUY,3,0.02h,Stop Loss,$-18.00,$567.75,$600525.50,383,$567.75
2025-06-25,22:02:00,22460.25,SELL,3,0.02h,Break Even,$0.75,$568.50,$600526.25,383,$568.50
2025-06-25,22:05:00,22466.75,BUY,3,0.02h,Break Even,$0.75,$569.25,$600527.00,383,$569.25
2025-06-25,22:06:00,22465.0,SELL,3,0.02h,Stop Loss,$-18.00,$551.25,$600509.00,383,$551.25
2025-06-25,22:08:00,22468.25,BUY,3,0.02h,Stop Loss,$-18.00,$533.25,$600491.00,383,$533.25
2025-06-25,22:24:00,22465.5,SELL,3,0.02h,Break Even,$0.75,$534.00,$600491.75,383,$534.00
2025-06-25,22:57:00,22461.5,BUY,3,0.02h,Break Even,$0.75,$534.75,$600492.50,383,$534.75
,,,,,,,,,,,
2025-06-26,12:34:00,22538.25,SELL,3,0.02h,Stop Loss,$225.75,$225.75,$600718.25,384,$225.75
2025-06-26,13:21:00,22552.5,BUY,3,0.02h,Break Even,$0.75,$226.50,$600719.00,384,$226.50
2025-06-26,13:35:00,22535.75,SELL,3,0.02h,Stop Loss,$12.00,$238.50,$600731.00,384,$238.50
2025-06-26,13:59:00,22538.0,BUY,3,0.02h,Stop Loss,$87.00,$325.50,$600818.00,384,$325.50
2025-06-26,14:45:00,22561.75,SELL,3,0.02h,Stop Loss,$23.25,$348.75,$600841.25,384,$348.75
2025-06-26,14:48:00,22573.0,BUY,3,0.02h,Break Even,$0.75,$349.50,$600842.00,384,$349.50
2025-06-26,15:30:00,22565.0,SELL,3,0.02h,Stop Loss,$180.75,$530.25,$601022.75,384,$530.25
2025-06-26,15:40:00,22597.5,BUY,3,0.02h,Break Even,$0.75,$531.00,$601023.50,384,$531.00
2025-06-26,16:30:00,22614.0,SELL,3,0.02h,Break Even,$0.75,$531.75,$601024.25,384,$531.75
2025-06-26,17:04:00,22613.75,BUY,3,0.02h,Stop Loss,$27.00,$558.75,$601051.25,384,$558.75
2025-06-26,18:01:00,22635.5,SELL,3,0.02h,Stop Loss,$-18.00,$540.75,$601033.25,384,$540.75
2025-06-26,18:02:00,22643.75,BUY,3,0.02h,Stop Loss,$-18.00,$522.75,$601015.25,384,$522.75
2025-06-26,18:40:00,22668.5,SELL,3,0.02h,Break Even,$0.75,$523.50,$601016.00,384,$523.50
2025-06-26,19:03:00,22672.75,BUY,3,0.02h,Stop Loss,$-18.00,$505.50,$600998.00,384,$505.50
2025-06-26,19:08:00,22663.75,SELL,3,0.02h,Break Even,$0.75,$506.25,$600998.75,384,$506.25
2025-06-26,19:12:00,22670.5,BUY,3,0.02h,Stop Loss,$-18.00,$488.25,$600980.75,384,$488.25
2025-06-26,19:13:00,22665.25,SELL,3,0.02h,Break Even,$0.75,$489.00,$600981.50,384,$489.00
2025-06-26,19:21:00,22669.25,BUY,3,0.02h,Stop Loss,$-18.00,$471.00,$600963.50,384,$471.00
2025-06-26,19:38:00,22664.0,SELL,3,0.02h,Break Even,$0.75,$471.75,$600964.25,384,$471.75
2025-06-26,19:51:00,22683.75,BUY,3,0.02h,Stop Loss,$34.50,$506.25,$600998.75,384,$506.25
2025-06-26,20:02:00,22655.25,SELL,3,0.02h,Stop Loss,$64.50,$570.75,$601063.25,384,$570.75
2025-06-26,20:23:00,22664.75,BUY,3,0.02h,Stop Loss,$64.50,$635.25,$601127.75,384,$635.25
2025-06-26,20:57:00,22667.25,SELL,3,0.02h,Stop Loss,$-18.00,$617.25,$601109.75,384,$617.25
2025-06-26,22:01:00,22677.0,BUY,3,0.02h,Break Even,$0.75,$618.00,$601110.50,384,$618.00
2025-06-26,22:59:00,22694.5,SELL,3,0.02h,Stop Loss,$-18.00,$600.00,$601092.50,384,$600.00
,,,,,,,,,,,
2025-06-27,12:00:00,22779.5,BUY,3,0.02h,Stop Loss,$72.00,$72.00,$601164.50,385,$72.00
2025-06-27,12:33:00,22748.25,SELL,3,0.02h,Stop Loss,$-18.00,$54.00,$601146.50,385,$54.00
2025-06-27,13:27:00,22720.5,BUY,3,0.02h,Stop Loss,$49.50,$103.50,$601196.00,385,$103.50
2025-06-27,13:29:00,22709.5,SELL,3,0.02h,Stop Loss,$45.75,$149.25,$601241.75,385,$149.25
2025-06-27,13:38:00,22733.5,BUY,3,0.02h,Break Even,$0.75,$150.00,$601242.50,385,$150.00
2025-06-27,14:28:00,22774.5,SELL,3,0.02h,Stop Loss,$-18.00,$132.00,$601224.50,385,$132.00
2025-06-27,14:39:00,22811.25,BUY,3,0.02h,Break Even,$0.75,$132.75,$601225.25,385,$132.75
2025-06-27,14:52:00,22765.75,SELL,3,0.02h,Stop Loss,$169.50,$302.25,$601394.75,385,$302.25
2025-06-27,15:11:00,22776.25,BUY,3,0.02h,Stop Loss,$23.25,$325.50,$601418.00,385,$325.50
2025-06-27,15:18:00,22765.75,SELL,3,0.02h,Stop Loss,$57.00,$382.50,$601475.00,385,$382.50
2025-06-27,15:22:00,22781.25,BUY,3,0.02h,Stop Loss,$83.25,$465.75,$601558.25,385,$465.75
2025-06-27,16:02:00,22798.25,SELL,3,0.02h,Stop Loss,$-18.00,$447.75,$601540.25,385,$447.75
2025-06-27,16:57:00,22794.5,BUY,3,0.02h,Stop Loss,$12.00,$459.75,$601552.25,385,$459.75
2025-06-27,17:05:00,22783.0,SELL,3,0.02h,Break Even,$0.75,$460.50,$601553.00,385,$460.50
2025-06-27,17:10:00,22789.5,BUY,3,0.02h,Stop Loss,$42.00,$502.50,$601595.00,385,$502.50
2025-06-27,17:21:00,22782.5,SELL,3,0.02h,Break Even,$0.75,$503.25,$601595.75,385,$503.25
2025-06-27,19:07:00,22645.25,BUY,3,0.02h,Stop Loss,$83.25,$586.50,$601679.00,385,$586.50
2025-06-27,20:29:00,22734.75,SELL,3,0.02h,Stop Loss,$-18.00,$568.50,$601661.00,385,$568.50
2025-06-27,20:31:00,22740.0,BUY,3,0.02h,Stop Loss,$-18.00,$550.50,$601643.00,385,$550.50
2025-06-27,20:36:00,22735.75,SELL,3,0.02h,Break Even,$0.75,$551.25,$601643.75,385,$551.25
2025-06-27,20:53:00,22743.25,BUY,3,0.02h,Stop Loss,$-18.00,$533.25,$601625.75,385,$533.25
,,,,,,,,,,,
2025-06-30,12:37:00,22871.25,SELL,3,0.02h,Stop Loss,$15.75,$15.75,$601641.50,386,$15.75
2025-06-30,13:02:00,22873.5,BUY,3,0.02h,Break Even,$0.75,$16.50,$601642.25,386,$16.50
2025-06-30,13:31:00,22870.0,SELL,3,0.02h,Stop Loss,$289.50,$306.00,$601931.75,386,$306.00
2025-06-30,14:03:00,22829.0,BUY,3,0.02h,Stop Loss,$23.25,$329.25,$601955.00,386,$329.25
2025-06-30,14:21:00,22821.5,SELL,3,0.02h,Stop Loss,$158.25,$487.50,$602113.25,386,$487.50
2025-06-30,14:31:00,22838.0,BUY,3,0.02h,Break Even,$0.75,$488.25,$602114.00,386,$488.25
2025-06-30,14:37:00,22827.0,SELL,3,0.02h,Stop Loss,$128.25,$616.50,$602242.25,386,$616.50
2025-06-30,14:49:00,22832.75,BUY,3,0.02h,Break Even,$0.75,$617.25,$602243.00,386,$617.25
2025-06-30,14:53:00,22823.0,SELL,3,0.02h,Stop Loss,$53.25,$670.50,$602296.25,386,$670.50
2025-06-30,15:05:00,22829.75,BUY,3,0.02h,Stop Loss,$57.00,$727.50,$602353.25,386,$727.50
2025-06-30,15:14:00,22812.0,SELL,3,0.02h,Stop Loss,$12.00,$739.50,$602365.25,386,$739.50
2025-06-30,15:34:00,22832.5,BUY,3,0.02h,Stop Loss,$64.50,$804.00,$602429.75,386,$804.00
2025-06-30,16:19:00,22842.0,SELL,3,0.02h,Stop Loss,$120.75,$924.75,$602550.50,386,$924.75
2025-06-30,16:37:00,22850.25,BUY,3,0.02h,Stop Loss,$19.50,$944.25,$602570.00,386,$944.25
2025-06-30,16:59:00,22844.5,SELL,3,0.02h,Stop Loss,$45.75,$990.00,$602615.75,386,$990.00
2025-06-30,17:54:00,22828.25,BUY,3,0.02h,Stop Loss,$-18.00,$972.00,$602597.75,386,$972.00
2025-06-30,17:58:00,22812.75,SELL,3,0.02h,Break Even,$0.75,$972.75,$602598.50,386,$972.75
2025-06-30,18:02:00,22833.5,BUY,3,0.02h,Break Even,$0.75,$973.50,$602599.25,386,$973.50
2025-06-30,18:10:00,22817.5,SELL,3,0.02h,Stop Loss,$109.50,$1083.00,$602708.75,386,$1083.00
2025-06-30,18:18:00,22828.25,BUY,3,0.02h,Break Even,$0.75,$1083.75,$602709.50,386,$1083.75
2025-06-30,18:30:00,22819.5,SELL,3,0.02h,Stop Loss,$12.00,$1095.75,$602721.50,386,$1095.75
2025-06-30,18:52:00,22819.5,BUY,3,0.02h,Stop Loss,$15.75,$1111.50,$602737.25,386,$1111.50
2025-06-30,20:03:00,22879.5,SELL,3,0.02h,Break Even,$0.75,$1112.25,$602738.00,386,$1112.25
2025-06-30,20:34:00,22877.5,BUY,3,0.02h,Break Even,$0.75,$1113.00,$602738.75,386,$1113.00
2025-06-30,20:50:00,22874.25,SELL,3,0.02h,Stop Loss,$-18.00,$1095.00,$602720.75,386,$1095.00
2025-06-30,20:51:00,22876.5,BUY,3,0.02h,Stop Loss,$-18.00,$1077.00,$602702.75,386,$1077.00
2025-06-30,20:52:00,22874.75,SELL,3,0.02h,Stop Loss,$-18.00,$1059.00,$602684.75,386,$1059.00
2025-06-30,20:53:00,22877.25,BUY,3,0.02h,Stop Loss,$-18.00,$1041.00,$602666.75,386,$1041.00
2025-06-30,20:55:00,22872.5,SELL,3,0.02h,Break Even,$0.75,$1041.75,$602667.50,386,$1041.75
2025-06-30,22:09:00,22884.0,BUY,3,0.02h,Break Even,$0.75,$1042.50,$602668.25,386,$1042.50
2025-06-30,22:27:00,22872.0,SELL,3,0.02h,Break Even,$0.75,$1043.25,$602669.00,386,$1043.25
,,,,,,,,,,,
2025-07-01,12:49:00,22795.5,BUY,3,0.02h,Stop Loss,$-18.00,$-18.00,$602651.00,387,$-18.00
2025-07-01,13:22:00,22795.75,SELL,3,0.02h,Stop Loss,$23.25,$5.25,$602674.25,387,$5.25
2025-07-01,13:33:00,22814.5,BUY,3,0.02h,Stop Loss,$23.25,$28.50,$602697.50,387,$28.50
2025-07-01,13:44:00,22789.25,SELL,3,0.02h,Stop Loss,$94.50,$123.00,$602792.00,387,$123.00
2025-07-01,13:49:00,22813.5,BUY,3,0.02h,Stop Loss,$98.25,$221.25,$602890.25,387,$221.25
2025-07-01,14:00:00,22782.25,SELL,3,0.02h,Stop Loss,$-18.00,$203.25,$602872.25,387,$203.25
2025-07-01,14:14:00,22828.75,BUY,3,0.02h,Break Even,$0.75,$204.00,$602873.00,387,$204.00
2025-07-01,14:23:00,22790.75,SELL,3,0.02h,Stop Loss,$68.25,$272.25,$602941.25,387,$272.25
2025-07-01,15:26:00,22684.5,BUY,3,0.02h,Stop Loss,$79.50,$351.75,$603020.75,387,$351.75
2025-07-01,15:41:00,22638.5,SELL,3,0.02h,Stop Loss,$192.00,$543.75,$603212.75,387,$543.75
2025-07-01,15:54:00,22668.25,BUY,3,0.02h,Stop Loss,$15.75,$559.50,$603228.50,387,$559.50
2025-07-01,16:03:00,22652.5,SELL,3,0.02h,Break Even,$0.75,$560.25,$603229.25,387,$560.25
2025-07-01,16:12:00,22674.75,BUY,3,0.02h,Stop Loss,$132.00,$692.25,$603361.25,387,$692.25
2025-07-01,17:31:00,22718.25,SELL,3,0.02h,Stop Loss,$68.25,$760.50,$603429.50,387,$760.50
2025-07-01,17:44:00,22725.5,BUY,3,0.02h,Stop Loss,$19.50,$780.00,$603449.00,387,$780.00
2025-07-01,18:18:00,22735.5,SELL,3,0.02h,Stop Loss,$49.50,$829.50,$603498.50,387,$829.50
2025-07-01,18:35:00,22741.0,BUY,3,0.02h,Break Even,$0.75,$830.25,$603499.25,387,$830.25
2025-07-01,18:38:00,22729.25,SELL,3,0.02h,Stop Loss,$45.75,$876.00,$603545.00,387,$876.00
2025-07-01,19:20:00,22704.25,BUY,3,0.02h,Break Even,$0.75,$876.75,$603545.75,387,$876.75
2025-07-01,19:37:00,22701.25,SELL,3,0.02h,Stop Loss,$135.75,$1012.50,$603681.50,387,$1012.50
2025-07-01,19:46:00,22715.75,BUY,3,0.02h,Break Even,$0.75,$1013.25,$603682.25,387,$1013.25
2025-07-01,19:59:00,22702.5,SELL,3,0.02h,Stop Loss,$195.75,$1209.00,$603878.00,387,$1209.00
2025-07-01,20:32:00,22683.75,BUY,3,0.02h,Break Even,$0.75,$1209.75,$603878.75,387,$1209.75
2025-07-01,22:32:00,22697.5,SELL,3,0.02h,Stop Loss,$-18.00,$1191.75,$603860.75,387,$1191.75
2025-07-01,22:33:00,22704.25,BUY,3,0.02h,Stop Loss,$19.50,$1211.25,$603880.25,387,$1211.25
,,,,,,,,,,,
2025-07-02,12:00:00,22662.5,SELL,3,0.02h,Stop Loss,$162.00,$162.00,$604042.25,388,$162.00
2025-07-02,13:02:00,22629.0,BUY,3,0.02h,Break Even,$0.75,$162.75,$604043.00,388,$162.75
2025-07-02,15:21:00,22821.0,SELL,3,0.02h,Stop Loss,$72.00,$234.75,$604115.00,388,$234.75
2025-07-02,15:23:00,22827.0,BUY,3,0.02h,Break Even,$0.75,$235.50,$604115.75,388,$235.50
2025-07-02,15:25:00,22815.75,SELL,3,0.02h,Stop Loss,$19.50,$255.00,$604135.25,388,$255.00
2025-07-02,15:38:00,22824.25,BUY,3,0.02h,Stop Loss,$-18.00,$237.00,$604117.25,388,$237.00
2025-07-02,15:39:00,22814.0,SELL,3,0.02h,Stop Loss,$75.75,$312.75,$604193.00,388,$312.75
2025-07-02,15:48:00,22823.0,BUY,3,0.02h,Break Even,$0.75,$313.50,$604193.75,388,$313.50
2025-07-02,16:03:00,22810.25,SELL,3,0.02h,Stop Loss,$-18.00,$295.50,$604175.75,388,$295.50
2025-07-02,16:07:00,22825.0,BUY,3,0.02h,Stop Loss,$-18.00,$277.50,$604157.75,388,$277.50
2025-07-02,16:32:00,22822.5,SELL,3,0.02h,Stop Loss,$-18.00,$259.50,$604139.75,388,$259.50
2025-07-02,16:35:00,22833.25,BUY,3,0.02h,Stop Loss,$15.75,$275.25,$604155.50,388,$275.25
2025-07-02,16:53:00,22829.25,SELL,3,0.02h,Stop Loss,$-18.00,$257.25,$604137.50,388,$257.25
2025-07-02,16:57:00,22837.5,BUY,3,0.02h,Stop Loss,$19.50,$276.75,$604157.00,388,$276.75
2025-07-02,17:09:00,22831.75,SELL,3,0.02h,Stop Loss,$12.00,$288.75,$604169.00,388,$288.75
2025-07-02,17:51:00,22825.75,BUY,3,0.02h,Stop Loss,$53.25,$342.00,$604222.25,388,$342.00
2025-07-02,18:03:00,22815.25,SELL,3,0.02h,Break Even,$0.75,$342.75,$604223.00,388,$342.75
2025-07-02,18:06:00,22828.25,BUY,3,0.02h,Stop Loss,$-18.00,$324.75,$604205.00,388,$324.75
2025-07-02,18:18:00,22819.75,SELL,3,0.02h,Stop Loss,$-18.00,$306.75,$604187.00,388,$306.75
2025-07-02,18:19:00,22828.75,BUY,3,0.02h,Stop Loss,$60.75,$367.50,$604247.75,388,$367.50
2025-07-02,18:46:00,22825.5,SELL,3,0.02h,Stop Loss,$12.00,$379.50,$604259.75,388,$379.50
2025-07-02,18:49:00,22836.0,BUY,3,0.02h,Stop Loss,$-18.00,$361.50,$604241.75,388,$361.50
2025-07-02,18:50:00,22828.75,SELL,3,0.02h,Stop Loss,$42.00,$403.50,$604283.75,388,$403.50
2025-07-02,19:01:00,22833.5,BUY,3,0.02h,Stop Loss,$34.50,$438.00,$604318.25,388,$438.00
2025-07-02,19:14:00,22827.75,SELL,3,0.02h,Break Even,$0.75,$438.75,$604319.00,388,$438.75
2025-07-02,19:35:00,22831.0,BUY,3,0.02h,Stop Loss,$-18.00,$420.75,$604301.00,388,$420.75
2025-07-02,19:37:00,22824.75,SELL,3,0.02h,Stop Loss,$-18.00,$402.75,$604283.00,388,$402.75
2025-07-02,19:54:00,22831.25,BUY,3,0.02h,Stop Loss,$214.50,$617.25,$604497.50,388,$617.25
2025-07-02,20:17:00,22830.75,SELL,3,0.02h,Stop Loss,$-18.00,$599.25,$604479.50,388,$599.25
2025-07-02,20:30:00,22835.25,BUY,3,0.02h,Break Even,$0.75,$600.00,$604480.25,388,$600.00
2025-07-02,22:08:00,22843.25,SELL,3,0.02h,Stop Loss,$-18.00,$582.00,$604462.25,388,$582.00
2025-07-02,22:38:00,22839.25,BUY,3,0.03h,Break Even,$0.75,$582.75,$604463.00,388,$582.75
,,,,,,,,,,,
2025-07-03,12:21:00,22857.25,SELL,3,0.02h,Stop Loss,$15.75,$15.75,$604478.75,389,$15.75
2025-07-03,12:31:00,22901.25,BUY,3,0.02h,Stop Loss,$180.75,$196.50,$604659.50,389,$196.50
2025-07-03,12:49:00,22879.25,SELL,3,0.02h,Stop Loss,$-18.00,$178.50,$604641.50,389,$178.50
2025-07-03,12:56:00,22900.25,BUY,3,0.02h,Stop Loss,$-18.00,$160.50,$604623.50,389,$160.50
2025-07-03,14:45:00,23045.5,SELL,3,0.02h,Stop Loss,$-18.00,$142.50,$604605.50,389,$142.50
2025-07-03,14:59:00,23051.0,BUY,3,0.02h,Stop Loss,$-18.00,$124.50,$604587.50,389,$124.50
2025-07-03,16:00:00,23083.25,SELL,3,0.02h,Stop Loss,$-18.00,$106.50,$604569.50,389,$106.50
2025-07-03,16:01:00,23089.0,BUY,3,0.02h,Break Even,$0.75,$107.25,$604570.25,389,$107.25
2025-07-03,16:16:00,23079.25,SELL,3,0.02h,Stop Loss,$-18.00,$89.25,$604552.25,389,$89.25
2025-07-03,22:11:00,23052.5,BUY,3,0.02h,Stop Loss,$-18.00,$71.25,$604534.25,389,$71.25
2025-07-03,22:13:00,23042.75,SELL,3,0.02h,Break Even,$0.75,$72.00,$604535.00,389,$72.00
2025-07-03,22:19:00,23054.0,BUY,3,0.02h,Break Even,$0.75,$72.75,$604535.75,389,$72.75
2025-07-03,22:47:00,23049.5,SELL,3,0.03h,Break Even,$0.75,$73.50,$604536.50,389,$73.50
,,,,,,,,,,,
2025-07-04,12:44:00,22932.0,BUY,3,0.02h,Stop Loss,$-18.00,$-18.00,$604518.50,390,$-18.00
2025-07-04,12:46:00,22926.0,SELL,3,0.02h,Stop Loss,$-18.00,$-36.00,$604500.50,390,$-36.00
2025-07-04,13:31:00,22920.0,BUY,3,0.02h,Stop Loss,$12.00,$-24.00,$604512.50,390,$-24.00
2025-07-04,13:36:00,22901.0,SELL,3,0.02h,Stop Loss,$60.75,$36.75,$604573.25,390,$36.75
2025-07-04,13:43:00,22926.25,BUY,3,0.02h,Break Even,$0.75,$37.50,$604574.00,390,$37.50
2025-07-04,14:05:00,22916.75,SELL,3,0.02h,Stop Loss,$34.50,$72.00,$604608.50,390,$72.00
2025-07-04,14:20:00,22922.25,BUY,3,0.02h,Stop Loss,$-18.00,$54.00,$604590.50,390,$54.00
2025-07-04,14:57:00,22934.5,SELL,3,0.02h,Break Even,$0.75,$54.75,$604591.25,390,$54.75
2025-07-04,15:01:00,22940.5,BUY,3,0.02h,Stop Loss,$-18.00,$36.75,$604573.25,390,$36.75
2025-07-04,15:06:00,22935.5,SELL,3,0.02h,Stop Loss,$-18.00,$18.75,$604555.25,390,$18.75
2025-07-04,15:32:00,22932.0,BUY,3,0.02h,Break Even,$0.75,$19.50,$604556.00,390,$19.50
2025-07-04,16:03:00,22928.5,SELL,3,0.02h,Stop Loss,$-18.00,$1.50,$604538.00,390,$1.50
2025-07-04,16:05:00,22932.5,BUY,3,0.02h,Break Even,$0.75,$2.25,$604538.75,390,$2.25
2025-07-04,16:09:00,22928.0,SELL,3,0.02h,Break Even,$0.75,$3.00,$604539.50,390,$3.00
,,,,,,,,,,,
2025-07-07,12:00:00,22981.25,BUY,3,0.02h,Stop Loss,$-18.00,$-18.00,$604521.50,391,$-18.00
2025-07-07,12:39:00,22975.0,SELL,3,0.02h,Stop Loss,$-18.00,$-36.00,$604503.50,391,$-36.00
2025-07-07,13:31:00,22970.5,BUY,3,0.02h,Break Even,$0.75,$-35.25,$604504.25,391,$-35.25
2025-07-07,13:35:00,22926.5,SELL,3,0.02h,Stop Loss,$15.75,$-19.50,$604520.00,391,$-19.50
2025-07-07,13:43:00,22947.25,BUY,3,0.02h,Break Even,$0.75,$-18.75,$604520.75,391,$-18.75
2025-07-07,13:46:00,22926.0,SELL,3,0.02h,Stop Loss,$23.25,$4.50,$604544.00,391,$4.50
2025-07-07,13:50:00,22951.5,BUY,3,0.02h,Stop Loss,$105.75,$110.25,$604649.75,391,$110.25
2025-07-07,14:02:00,22925.25,SELL,3,0.02h,Stop Loss,$308.25,$418.50,$604958.00,391,$418.50
2025-07-07,14:24:00,22941.75,BUY,3,0.02h,Stop Loss,$64.50,$483.00,$605022.50,391,$483.00
2025-07-07,14:33:00,22926.5,SELL,3,0.02h,Break Even,$0.75,$483.75,$605023.25,391,$483.75
2025-07-07,15:16:00,22915.25,BUY,3,0.02h,Stop Loss,$-18.00,$465.75,$605005.25,391,$465.75
2025-07-07,15:20:00,22904.75,SELL,3,0.02h,Stop Loss,$19.50,$485.25,$605024.75,391,$485.25
2025-07-07,15:26:00,22907.75,BUY,3,0.02h,Stop Loss,$143.25,$628.50,$605168.00,391,$628.50
2025-07-07,15:47:00,22906.0,SELL,3,0.02h,Stop Loss,$57.00,$685.50,$605225.00,391,$685.50
2025-07-07,15:57:00,22923.25,BUY,3,0.02h,Stop Loss,$135.75,$821.25,$605360.75,391,$821.25
2025-07-07,16:21:00,22879.75,SELL,3,0.02h,Stop Loss,$514.50,$1335.75,$605875.25,391,$1335.75
2025-07-07,16:38:00,22917.5,BUY,3,0.02h,Break Even,$0.75,$1336.50,$605876.00,391,$1336.50
2025-07-07,16:39:00,22894.0,SELL,3,0.02h,Break Even,$0.75,$1337.25,$605876.75,391,$1337.25
2025-07-07,17:11:00,22890.75,BUY,3,0.02h,Stop Loss,$45.75,$1383.00,$605922.50,391,$1383.00
2025-07-07,17:28:00,22869.25,SELL,3,0.02h,Break Even,$0.75,$1383.75,$605923.25,391,$1383.75
2025-07-07,17:33:00,22891.5,BUY,3,0.02h,Stop Loss,$-18.00,$1365.75,$605905.25,391,$1365.75
2025-07-07,17:35:00,22883.0,SELL,3,0.02h,Stop Loss,$203.25,$1569.00,$606108.50,391,$1569.00
2025-07-07,18:00:00,22871.0,BUY,3,0.02h,Stop Loss,$30.75,$1599.75,$606139.25,391,$1599.75
2025-07-07,18:16:00,22859.0,SELL,3,0.02h,Stop Loss,$462.00,$2061.75,$606601.25,391,$2061.75
2025-07-07,18:42:00,22835.75,BUY,3,0.02h,Stop Loss,$162.00,$2223.75,$606763.25,391,$2223.75
2025-07-07,19:10:00,22851.5,SELL,3,0.02h,Break Even,$0.75,$2224.50,$606764.00,391,$2224.50
2025-07-07,19:14:00,22862.75,BUY,3,0.02h,Stop Loss,$23.25,$2247.75,$606787.25,391,$2247.75
2025-07-07,19:15:00,22857.0,SELL,3,0.02h,Break Even,$0.75,$2248.50,$606788.00,391,$2248.50
2025-07-07,19:34:00,22858.25,BUY,3,0.02h,Stop Loss,$27.00,$2275.50,$606815.00,391,$2275.50
2025-07-07,19:39:00,22849.5,SELL,3,0.02h,Break Even,$0.75,$2276.25,$606815.75,391,$2276.25
2025-07-07,19:51:00,22869.75,BUY,3,0.02h,Break Even,$0.75,$2277.00,$606816.50,391,$2277.00
2025-07-07,20:06:00,22856.75,SELL,3,0.02h,Break Even,$0.75,$2277.75,$606817.25,391,$2277.75
2025-07-07,20:20:00,22863.75,BUY,3,0.03h,Break Even,$0.75,$2278.50,$606818.00,391,$2278.50
2025-07-07,20:30:00,22858.5,SELL,3,0.02h,Stop Loss,$-18.00,$2260.50,$606800.00,391,$2260.50
2025-07-07,22:01:00,22848.0,BUY,3,0.02h,Stop Loss,$27.00,$2287.50,$606827.00,391,$2287.50
2025-07-07,22:05:00,22832.25,SELL,3,0.02h,Stop Loss,$-18.00,$2269.50,$606809.00,391,$2269.50
2025-07-07,22:08:00,22840.0,BUY,3,0.02h,Stop Loss,$30.75,$2300.25,$606839.75,391,$2300.25
2025-07-07,22:13:00,22834.75,SELL,3,0.02h,Break Even,$0.75,$2301.00,$606840.50,391,$2301.00
2025-07-07,22:34:00,22835.25,BUY,3,0.02h,Break Even,$0.75,$2301.75,$606841.25,391,$2301.75
,,,,,,,,,,,
2025-07-08,12:34:00,22932.0,SELL,3,0.02h,Break Even,$0.75,$0.75,$606842.00,392,$0.75
2025-07-08,12:57:00,22934.0,BUY,3,0.02h,Stop Loss,$19.50,$20.25,$606861.50,392,$20.25
2025-07-08,13:21:00,22937.25,SELL,3,0.02h,Stop Loss,$-18.00,$2.25,$606843.50,392,$2.25
2025-07-08,13:57:00,22919.0,BUY,3,0.02h,Break Even,$0.75,$3.00,$606844.25,392,$3.00
2025-07-08,13:58:00,22907.75,SELL,3,0.02h,Stop Loss,$188.25,$191.25,$607032.50,392,$191.25
2025-07-08,14:33:00,22909.25,BUY,3,0.02h,Break Even,$0.75,$192.00,$607033.25,392,$192.00
2025-07-08,14:52:00,22894.0,SELL,3,0.02h,Stop Loss,$563.25,$755.25,$607596.50,392,$755.25
2025-07-08,15:04:00,22902.0,BUY,3,0.02h,Stop Loss,$-18.00,$737.25,$607578.50,392,$737.25
2025-07-08,15:20:00,22888.0,SELL,3,0.02h,Stop Loss,$72.00,$809.25,$607650.50,392,$809.25
2025-07-08,15:39:00,22889.5,BUY,3,0.02h,Break Even,$0.75,$810.00,$607651.25,392,$810.00
2025-07-08,16:36:00,22897.75,SELL,3,0.02h,Stop Loss,$94.50,$904.50,$607745.75,392,$904.50
2025-07-08,17:29:00,22913.75,BUY,3,0.02h,Stop Loss,$-18.00,$886.50,$607727.75,392,$886.50
2025-07-08,17:36:00,22899.75,SELL,3,0.02h,Stop Loss,$12.00,$898.50,$607739.75,392,$898.50
2025-07-08,17:49:00,22907.75,BUY,3,0.02h,Stop Loss,$15.75,$914.25,$607755.50,392,$914.25
2025-07-08,18:22:00,22921.25,SELL,3,0.02h,Break Even,$0.75,$915.00,$607756.25,392,$915.00
2025-07-08,19:34:00,22890.25,BUY,3,0.02h,Break Even,$0.75,$915.75,$607757.00,392,$915.75
2025-07-08,19:40:00,22879.5,SELL,3,0.02h,Break Even,$0.75,$916.50,$607757.75,392,$916.50
2025-07-08,19:49:00,22892.75,BUY,3,0.02h,Stop Loss,$15.75,$932.25,$607773.50,392,$932.25
2025-07-08,20:36:00,22900.75,SELL,3,0.02h,Stop Loss,$-18.00,$914.25,$607755.50,392,$914.25
2025-07-08,20:44:00,22904.0,BUY,3,0.02h,Break Even,$0.75,$915.00,$607756.25,392,$915.00
2025-07-08,20:47:00,22902.25,SELL,3,0.02h,Stop Loss,$-18.00,$897.00,$607738.25,392,$897.00
2025-07-08,20:48:00,22903.0,BUY,3,0.02h,Stop Loss,$-18.00,$879.00,$607720.25,392,$879.00
2025-07-08,20:49:00,22901.5,SELL,3,0.02h,Stop Loss,$-18.00,$861.00,$607702.25,392,$861.00
2025-07-08,20:55:00,22904.0,BUY,3,0.02h,Stop Loss,$-18.00,$843.00,$607684.25,392,$843.00
2025-07-08,20:56:00,22901.25,SELL,3,0.03h,Break Even,$0.75,$843.75,$607685.00,392,$843.75
2025-07-08,22:01:00,22915.75,BUY,3,0.02h,Stop Loss,$34.50,$878.25,$607719.50,392,$878.25
2025-07-08,22:23:00,22910.0,SELL,3,0.02h,Break Even,$0.75,$879.00,$607720.25,392,$879.00
2025-07-08,22:29:00,22913.0,BUY,3,0.02h,Stop Loss,$-18.00,$861.00,$607702.25,392,$861.00
2025-07-08,22:30:00,22909.25,SELL,3,0.02h,Stop Loss,$-18.00,$843.00,$607684.25,392,$843.00
2025-07-08,22:31:00,22912.25,BUY,3,0.02h,Stop Loss,$-18.00,$825.00,$607666.25,392,$825.00
2025-07-08,22:32:00,22905.75,SELL,3,0.02h,Stop Loss,$23.25,$848.25,$607689.50,392,$848.25
2025-07-08,22:50:00,22910.0,BUY,3,0.03h,Break Even,$0.75,$849.00,$607690.25,392,$849.00
,,,,,,,,,,,
2025-07-09,12:38:00,22937.0,SELL,3,0.02h,Break Even,$0.75,$0.75,$607691.00,393,$0.75
2025-07-09,12:43:00,22941.5,BUY,3,0.02h,Break Even,$0.75,$1.50,$607691.75,393,$1.50
2025-07-09,12:58:00,22936.5,SELL,3,0.02h,Stop Loss,$102.00,$103.50,$607793.75,393,$103.50
2025-07-09,13:08:00,22951.0,BUY,3,0.02h,Break Even,$0.75,$104.25,$607794.50,393,$104.25
2025-07-09,14:20:00,23077.0,SELL,3,0.02h,Stop Loss,$45.75,$150.00,$607840.25,393,$150.00
2025-07-09,15:23:00,22970.5,BUY,3,0.02h,Break Even,$0.75,$150.75,$607841.00,393,$150.75
2025-07-09,15:53:00,22951.5,SELL,3,0.02h,Break Even,$0.75,$151.50,$607841.75,393,$151.50
2025-07-09,16:19:00,22972.25,BUY,3,0.02h,Stop Loss,$12.00,$163.50,$607853.75,393,$163.50
2025-07-09,17:01:00,22976.75,SELL,3,0.02h,Stop Loss,$169.50,$333.00,$608023.25,393,$333.00
2025-07-09,17:11:00,22991.75,BUY,3,0.02h,Stop Loss,$-18.00,$315.00,$608005.25,393,$315.00
2025-07-09,17:13:00,22980.75,SELL,3,0.02h,Stop Loss,$19.50,$334.50,$608024.75,393,$334.50
2025-07-09,17:27:00,22987.25,BUY,3,0.02h,Stop Loss,$-18.00,$316.50,$608006.75,393,$316.50
2025-07-09,17:28:00,22977.75,SELL,3,0.02h,Stop Loss,$38.25,$354.75,$608045.00,393,$354.75
2025-07-09,17:35:00,22987.75,BUY,3,0.02h,Stop Loss,$90.75,$445.50,$608135.75,393,$445.50
2025-07-09,17:46:00,22982.75,SELL,3,0.02h,Stop Loss,$188.25,$633.75,$608324.00,393,$633.75
2025-07-09,17:52:00,22992.75,BUY,3,0.02h,Stop Loss,$27.00,$660.75,$608351.00,393,$660.75
2025-07-09,17:54:00,22976.0,SELL,3,0.02h,Stop Loss,$117.00,$777.75,$608468.00,393,$777.75
2025-07-09,18:02:00,22993.5,BUY,3,0.02h,Break Even,$0.75,$778.50,$608468.75,393,$778.50
2025-07-09,18:46:00,23009.75,SELL,3,0.02h,Stop Loss,$-18.00,$760.50,$608450.75,393,$760.50
2025-07-09,18:47:00,23015.5,BUY,3,0.02h,Stop Loss,$-18.00,$742.50,$608432.75,393,$742.50
2025-07-09,18:49:00,23011.5,SELL,3,0.02h,Break Even,$0.75,$743.25,$608433.50,393,$743.25
2025-07-09,18:51:00,23016.25,BUY,3,0.02h,Stop Loss,$30.75,$774.00,$608464.25,393,$774.00
2025-07-09,19:36:00,23033.75,SELL,3,0.02h,Break Even,$0.75,$774.75,$608465.00,393,$774.75
2025-07-09,19:38:00,23040.5,BUY,3,0.02h,Break Even,$0.75,$775.50,$608465.75,393,$775.50
2025-07-09,19:52:00,23031.75,SELL,3,0.02h,Break Even,$0.75,$776.25,$608466.50,393,$776.25
2025-07-09,19:56:00,23052.5,BUY,3,0.02h,Stop Loss,$-18.00,$758.25,$608448.50,393,$758.25
2025-07-09,20:21:00,23034.25,SELL,3,0.02h,Stop Loss,$-18.00,$740.25,$608430.50,393,$740.25
2025-07-09,20:41:00,23042.75,BUY,3,0.02h,Break Even,$0.75,$741.00,$608431.25,393,$741.00
2025-07-09,20:45:00,23039.5,SELL,3,0.02h,Break Even,$0.75,$741.75,$608432.00,393,$741.75
2025-07-09,20:51:00,23042.75,BUY,3,0.02h,Stop Loss,$-18.00,$723.75,$608414.00,393,$723.75
2025-07-09,22:01:00,23035.25,SELL,3,0.02h,Stop Loss,$-18.00,$705.75,$608396.00,393,$705.75
2025-07-09,22:04:00,23045.25,BUY,3,0.02h,Stop Loss,$-18.00,$687.75,$608378.00,393,$687.75
2025-07-09,22:43:00,23056.75,SELL,3,0.02h,Stop Loss,$-18.00,$669.75,$608360.00,393,$669.75
2025-07-09,22:44:00,23059.0,BUY,3,0.02h,Stop Loss,$-18.00,$651.75,$608342.00,393,$651.75
2025-07-09,22:45:00,23057.0,SELL,3,0.02h,Stop Loss,$-18.00,$633.75,$608324.00,393,$633.75
2025-07-09,22:58:00,23058.25,BUY,3,0.03h,Stop Loss,$-18.00,$615.75,$608306.00,393,$615.75
,,,,,,,,,,,
2025-07-10,12:18:00,23057.25,SELL,3,0.02h,Stop Loss,$-18.00,$-18.00,$608288.00,394,$-18.00
2025-07-10,12:21:00,23061.25,BUY,3,0.02h,Break Even,$0.75,$-17.25,$608288.75,394,$-17.25
2025-07-10,12:22:00,23058.5,SELL,3,0.02h,Stop Loss,$-18.00,$-35.25,$608270.75,394,$-35.25
2025-07-10,13:00:00,23049.25,BUY,3,0.02h,Break Even,$0.75,$-34.50,$608271.50,394,$-34.50
2025-07-10,13:14:00,23042.25,SELL,3,0.02h,Break Even,$0.75,$-33.75,$608272.25,394,$-33.75
2025-07-10,13:16:00,23055.0,BUY,3,0.02h,Stop Loss,$-18.00,$-51.75,$608254.25,394,$-51.75
2025-07-10,13:34:00,23035.25,SELL,3,0.02h,Stop Loss,$150.75,$99.00,$608405.00,394,$99.00
2025-07-10,14:20:00,22964.0,BUY,3,0.02h,Break Even,$0.75,$99.75,$608405.75,394,$99.75
2025-07-10,14:21:00,22945.0,SELL,3,0.02h,Stop Loss,$180.75,$280.50,$608586.50,394,$280.50
2025-07-10,14:37:00,22956.0,BUY,3,0.02h,Stop Loss,$64.50,$345.00,$608651.00,394,$345.00
2025-07-10,15:01:00,22962.25,SELL,3,0.02h,Break Even,$0.75,$345.75,$608651.75,394,$345.75
2025-07-10,15:02:00,22971.25,BUY,3,0.02h,Stop Loss,$34.50,$380.25,$608686.25,394,$380.25
2025-07-10,15:10:00,22965.75,SELL,3,0.02h,Stop Loss,$218.25,$598.50,$608904.50,394,$598.50
2025-07-10,15:24:00,22971.75,BUY,3,0.02h,Stop Loss,$83.25,$681.75,$608987.75,394,$681.75
2025-07-10,16:07:00,23003.0,SELL,3,0.02h,Break Even,$0.75,$682.50,$608988.50,394,$682.50
2025-07-10,16:26:00,23005.75,BUY,3,0.02h,Stop Loss,$12.00,$694.50,$609000.50,394,$694.50
2025-07-10,16:37:00,22989.25,SELL,3,0.02h,Stop Loss,$-18.00,$676.50,$608982.50,394,$676.50
2025-07-10,16:41:00,23003.5,BUY,3,0.02h,Break Even,$0.75,$677.25,$608983.25,394,$677.25
2025-07-10,16:50:00,22990.0,SELL,3,0.02h,Stop Loss,$-18.00,$659.25,$608965.25,394,$659.25
2025-07-10,16:51:00,23002.75,BUY,3,0.02h,Stop Loss,$-18.00,$641.25,$608947.25,394,$641.25
2025-07-10,16:52:00,22997.5,SELL,3,0.02h,Break Even,$0.75,$642.00,$608948.00,394,$642.00
2025-07-10,16:58:00,23000.0,BUY,3,0.02h,Stop Loss,$-18.00,$624.00,$608930.00,394,$624.00
2025-07-10,17:00:00,22992.25,SELL,3,0.02h,Break Even,$0.75,$624.75,$608930.75,394,$624.75
2025-07-10,17:02:00,23002.0,BUY,3,0.02h,Stop Loss,$30.75,$655.50,$608961.50,394,$655.50
2025-07-10,17:03:00,22998.25,SELL,3,0.02h,Break Even,$0.75,$656.25,$608962.25,394,$656.25
2025-07-10,17:04:00,23000.75,BUY,3,0.02h,Break Even,$0.75,$657.00,$608963.00,394,$657.00
2025-07-10,17:09:00,22998.0,SELL,3,0.02h,Stop Loss,$-18.00,$639.00,$608945.00,394,$639.00
2025-07-10,17:10:00,23000.25,BUY,3,0.02h,Stop Loss,$45.75,$684.75,$608990.75,394,$684.75
2025-07-10,17:15:00,22996.75,SELL,3,0.02h,Stop Loss,$19.50,$704.25,$609010.25,394,$704.25
2025-07-10,17:21:00,23002.25,BUY,3,0.02h,Stop Loss,$12.00,$716.25,$609022.25,394,$716.25
2025-07-10,18:29:00,23033.75,SELL,3,0.02h,Break Even,$0.75,$717.00,$609023.00,394,$717.00
2025-07-10,18:59:00,23042.25,BUY,3,0.02h,Stop Loss,$-18.00,$699.00,$609005.00,394,$699.00
2025-07-10,19:16:00,23036.0,SELL,3,0.02h,Break Even,$0.75,$699.75,$609005.75,394,$699.75
2025-07-10,19:18:00,23038.75,BUY,3,0.02h,Stop Loss,$-18.00,$681.75,$608987.75,394,$681.75
2025-07-10,19:20:00,23034.25,SELL,3,0.02h,Stop Loss,$-18.00,$663.75,$608969.75,394,$663.75
2025-07-10,19:37:00,23037.25,BUY,3,0.02h,Stop Loss,$-18.00,$645.75,$608951.75,394,$645.75
2025-07-10,19:47:00,23028.5,SELL,3,0.02h,Break Even,$0.75,$646.50,$608952.50,394,$646.50
2025-07-10,20:31:00,23012.75,BUY,3,0.02h,Break Even,$0.75,$647.25,$608953.25,394,$647.25
2025-07-10,20:53:00,23011.0,SELL,3,0.02h,Stop Loss,$-18.00,$629.25,$608935.25,394,$629.25
2025-07-10,22:05:00,23022.5,BUY,3,0.02h,Break Even,$0.75,$630.00,$608936.00,394,$630.00
2025-07-10,22:35:00,23026.75,SELL,3,0.02h,Stop Loss,$-18.00,$612.00,$608918.00,394,$612.00
2025-07-10,22:45:00,23028.75,BUY,3,0.02h,Break Even,$0.75,$612.75,$608918.75,394,$612.75
,,,,,,,,,,,
2025-07-11,12:00:00,22908.75,SELL,3,0.02h,Stop Loss,$49.50,$49.50,$608968.25,395,$49.50
2025-07-11,12:49:00,22906.0,BUY,3,0.02h,Stop Loss,$45.75,$95.25,$609014.00,395,$95.25
2025-07-11,13:09:00,22901.5,SELL,3,0.02h,Break Even,$0.75,$96.00,$609014.75,395,$96.00
2025-07-11,13:29:00,22907.75,BUY,3,0.02h,Stop Loss,$139.50,$235.50,$609154.25,395,$235.50
2025-07-11,13:40:00,22892.75,SELL,3,0.02h,Stop Loss,$124.50,$360.00,$609278.75,395,$360.00
2025-07-11,13:50:00,22936.0,BUY,3,0.02h,Stop Loss,$72.00,$432.00,$609350.75,395,$432.00
2025-07-11,14:44:00,22984.25,SELL,3,0.02h,Stop Loss,$23.25,$455.25,$609374.00,395,$455.25
2025-07-11,15:31:00,22957.25,BUY,3,0.02h,Stop Loss,$27.00,$482.25,$609401.00,395,$482.25
2025-07-11,15:57:00,22964.25,SELL,3,0.02h,Stop Loss,$-18.00,$464.25,$609383.00,395,$464.25
2025-07-11,16:01:00,22994.25,BUY,3,0.02h,Stop Loss,$-18.00,$446.25,$609365.00,395,$446.25
2025-07-11,16:05:00,22972.25,SELL,3,0.02h,Stop Loss,$27.00,$473.25,$609392.00,395,$473.25
2025-07-11,16:17:00,22992.25,BUY,3,0.02h,Stop Loss,$-18.00,$455.25,$609374.00,395,$455.25
2025-07-11,16:44:00,22974.75,SELL,3,0.02h,Break Even,$0.75,$456.00,$609374.75,395,$456.00
2025-07-11,16:54:00,22989.75,BUY,3,0.02h,Stop Loss,$27.00,$483.00,$609401.75,395,$483.00
2025-07-11,17:32:00,23000.0,SELL,3,0.02h,Stop Loss,$57.00,$540.00,$609458.75,395,$540.00
2025-07-11,17:54:00,22996.0,BUY,3,0.02h,Break Even,$0.75,$540.75,$609459.50,395,$540.75
2025-07-11,18:21:00,22996.5,SELL,3,0.02h,Break Even,$0.75,$541.50,$609460.25,395,$541.50
2025-07-11,18:23:00,23001.25,BUY,3,0.02h,Break Even,$0.75,$542.25,$609461.00,395,$542.25
2025-07-11,18:24:00,22999.25,SELL,3,0.02h,Break Even,$0.75,$543.00,$609461.75,395,$543.00
2025-07-11,18:25:00,23003.0,BUY,3,0.02h,Break Even,$0.75,$543.75,$609462.50,395,$543.75
2025-07-11,18:31:00,22999.25,SELL,3,0.02h,Break Even,$0.75,$544.50,$609463.25,395,$544.50
2025-07-11,18:32:00,23004.75,BUY,3,0.02h,Break Even,$0.75,$545.25,$609464.00,395,$545.25
2025-07-11,18:50:00,23002.25,SELL,3,0.02h,Break Even,$0.75,$546.00,$609464.75,395,$546.00
2025-07-11,19:19:00,22983.75,BUY,3,0.02h,Break Even,$0.75,$546.75,$609465.50,395,$546.75
2025-07-11,19:35:00,22979.0,SELL,3,0.02h,Break Even,$0.75,$547.50,$609466.25,395,$547.50
2025-07-11,20:52:00,22941.5,BUY,3,0.02h,Break Even,$0.75,$548.25,$609467.00,395,$548.25
,,,,,,,,,,,
2025-07-14,12:00:00,22887.0,SELL,3,0.02h,Stop Loss,$53.25,$53.25,$609520.25,396,$53.25
2025-07-14,12:26:00,22907.75,BUY,3,0.02h,Break Even,$0.75,$54.00,$609521.00,396,$54.00
2025-07-14,12:34:00,22889.75,SELL,3,0.02h,Stop Loss,$-18.00,$36.00,$609503.00,396,$36.00
2025-07-14,12:42:00,22901.0,BUY,3,0.02h,Break Even,$0.75,$36.75,$609503.75,396,$36.75
2025-07-14,12:43:00,22898.75,SELL,3,0.02h,Stop Loss,$-18.00,$18.75,$609485.75,396,$18.75
2025-07-14,12:44:00,22905.25,BUY,3,0.02h,Break Even,$0.75,$19.50,$609486.50,396,$19.50
2025-07-14,12:59:00,22895.25,SELL,3,0.02h,Stop Loss,$-18.00,$1.50,$609468.50,396,$1.50
2025-07-14,13:15:00,22904.75,BUY,3,0.02h,Break Even,$0.75,$2.25,$609469.25,396,$2.25
2025-07-14,13:43:00,22878.75,SELL,3,0.02h,Stop Loss,$323.25,$325.50,$609792.50,396,$325.50
2025-07-14,13:53:00,22921.75,BUY,3,0.02h,Stop Loss,$57.00,$382.50,$609849.50,396,$382.50
2025-07-14,14:32:00,22937.75,SELL,3,0.02h,Stop Loss,$180.75,$563.25,$610030.25,396,$563.25
2025-07-14,14:44:00,22956.0,BUY,3,0.02h,Break Even,$0.75,$564.00,$610031.00,396,$564.00
2025-07-14,15:36:00,23000.25,SELL,3,0.02h,Stop Loss,$-18.00,$546.00,$610013.00,396,$546.00
2025-07-14,15:37:00,23009.75,BUY,3,0.02h,Stop Loss,$15.75,$561.75,$610028.75,396,$561.75
2025-07-14,15:47:00,22996.0,SELL,3,0.02h,Stop Loss,$-18.00,$543.75,$610010.75,396,$543.75
2025-07-14,15:52:00,23008.25,BUY,3,0.02h,Stop Loss,$-18.00,$525.75,$609992.75,396,$525.75
2025-07-14,15:56:00,22996.75,SELL,3,0.02h,Stop Loss,$-18.00,$507.75,$609974.75,396,$507.75
2025-07-14,16:00:00,23008.75,BUY,3,0.02h,Stop Loss,$-18.00,$489.75,$609956.75,396,$489.75
2025-07-14,16:03:00,23004.25,SELL,3,0.02h,Stop Loss,$19.50,$509.25,$609976.25,396,$509.25
2025-07-14,16:08:00,23016.0,BUY,3,0.02h,Break Even,$0.75,$510.00,$609977.00,396,$510.00
2025-07-14,16:30:00,23015.25,SELL,3,0.02h,Stop Loss,$12.00,$522.00,$609989.00,396,$522.00
2025-07-14,16:42:00,23027.0,BUY,3,0.02h,Stop Loss,$-18.00,$504.00,$609971.00,396,$504.00
2025-07-14,17:43:00,23047.25,SELL,3,0.02h,Stop Loss,$-18.00,$486.00,$609953.00,396,$486.00
2025-07-14,17:54:00,23054.75,BUY,3,0.02h,Stop Loss,$-18.00,$468.00,$609935.00,396,$468.00
2025-07-14,17:57:00,23047.5,SELL,3,0.02h,Break Even,$0.75,$468.75,$609935.75,396,$468.75
2025-07-14,18:28:00,23048.5,BUY,3,0.02h,Break Even,$0.75,$469.50,$609936.50,396,$469.50
2025-07-14,19:09:00,23045.25,SELL,3,0.02h,Break Even,$0.75,$470.25,$609937.25,396,$470.25
2025-07-14,19:59:00,23039.25,BUY,3,0.02h,Break Even,$0.75,$471.00,$609938.00,396,$471.00
2025-07-14,20:01:00,23023.75,SELL,3,0.02h,Break Even,$0.75,$471.75,$609938.75,396,$471.75
2025-07-14,20:02:00,23032.5,BUY,3,0.02h,Break Even,$0.75,$472.50,$609939.50,396,$472.50
2025-07-14,20:03:00,23029.75,SELL,3,0.02h,Break Even,$0.75,$473.25,$609940.25,396,$473.25
2025-07-14,20:21:00,23031.0,BUY,3,0.02h,Stop Loss,$-18.00,$455.25,$609922.25,396,$455.25
2025-07-14,20:27:00,23025.25,SELL,3,0.02h,Break Even,$0.75,$456.00,$609923.00,396,$456.00
2025-07-14,20:41:00,23028.75,BUY,3,0.03h,Break Even,$0.75,$456.75,$609923.75,396,$456.75
2025-07-14,22:02:00,23022.0,SELL,3,0.02h,Stop Loss,$-18.00,$438.75,$609905.75,396,$438.75
2025-07-14,22:53:00,23011.5,BUY,3,0.03h,Stop Loss,$-18.00,$420.75,$609887.75,396,$420.75
2025-07-14,22:58:00,23002.25,SELL,3,0.02h,Break Even,$0.75,$421.50,$609888.50,396,$421.50
,,,,,,,,,,,
2025-07-15,12:00:00,23167.0,BUY,3,0.02h,Stop Loss,$34.50,$34.50,$609923.00,397,$34.50
2025-07-15,13:33:00,23191.75,SELL,3,0.02h,Stop Loss,$267.00,$301.50,$610190.00,397,$301.50
2025-07-15,14:10:00,23162.75,BUY,3,0.02h,Stop Loss,$83.25,$384.75,$610273.25,397,$384.75
2025-07-15,14:33:00,23165.0,SELL,3,0.02h,Stop Loss,$42.00,$426.75,$610315.25,397,$426.75
2025-07-15,15:12:00,23140.75,BUY,3,0.02h,Stop Loss,$38.25,$465.00,$610353.50,397,$465.00
2025-07-15,15:57:00,23156.0,SELL,3,0.02h,Break Even,$0.75,$465.75,$610354.25,397,$465.75
2025-07-15,16:33:00,23154.0,BUY,3,0.02h,Break Even,$0.75,$466.50,$610355.00,397,$466.50
2025-07-15,16:35:00,23140.75,SELL,3,0.02h,Break Even,$0.75,$467.25,$610355.75,397,$467.25
2025-07-15,16:53:00,23144.0,BUY,3,0.02h,Stop Loss,$-18.00,$449.25,$610337.75,397,$449.25
2025-07-15,16:54:00,23138.5,SELL,3,0.02h,Stop Loss,$177.00,$626.25,$610514.75,397,$626.25
2025-07-15,17:28:00,23115.5,BUY,3,0.02h,Stop Loss,$12.00,$638.25,$610526.75,397,$638.25
2025-07-15,18:35:00,23168.75,SELL,3,0.02h,Stop Loss,$162.00,$800.25,$610688.75,397,$800.25
2025-07-15,19:42:00,23109.0,BUY,3,0.02h,Stop Loss,$12.00,$812.25,$610700.75,397,$812.25
2025-07-15,19:54:00,23094.0,SELL,3,0.02h,Stop Loss,$38.25,$850.50,$610739.00,397,$850.50
2025-07-15,22:01:00,23027.0,BUY,3,0.02h,Break Even,$0.75,$851.25,$610739.75,397,$851.25
2025-07-15,22:11:00,23011.5,SELL,3,0.02h,Stop Loss,$-18.00,$833.25,$610721.75,397,$833.25
2025-07-15,22:51:00,23002.75,BUY,3,0.02h,Stop Loss,$-18.00,$815.25,$610703.75,397,$815.25
,,,,,,,,,,,
2025-07-16,13:04:00,23060.5,SELL,3,0.02h,Stop Loss,$-18.00,$-18.00,$610685.75,398,$-18.00
2025-07-16,13:11:00,23071.25,BUY,3,0.02h,Break Even,$0.75,$-17.25,$610686.50,398,$-17.25
2025-07-16,13:17:00,23065.5,SELL,3,0.02h,Break Even,$0.75,$-16.50,$610687.25,398,$-16.50
2025-07-16,13:19:00,23069.75,BUY,3,0.02h,Break Even,$0.75,$-15.75,$610688.00,398,$-15.75
2025-07-16,13:32:00,23048.5,SELL,3,0.02h,Stop Loss,$177.00,$161.25,$610865.00,398,$161.25
2025-07-16,14:14:00,22992.25,BUY,3,0.02h,Stop Loss,$-18.00,$143.25,$610847.00,398,$143.25
2025-07-16,14:15:00,22975.5,SELL,3,0.02h,Stop Loss,$124.50,$267.75,$610971.50,398,$267.75
2025-07-16,14:20:00,22993.5,BUY,3,0.02h,Break Even,$0.75,$268.50,$610972.25,398,$268.50
2025-07-16,14:56:00,22993.25,SELL,3,0.02h,Stop Loss,$143.25,$411.75,$611115.50,398,$411.75
2025-07-16,14:57:00,23010.75,BUY,3,0.02h,Break Even,$0.75,$412.50,$611116.25,398,$412.50
2025-07-16,14:58:00,22992.0,SELL,3,0.02h,Stop Loss,$394.50,$807.00,$611510.75,398,$807.00
2025-07-16,15:05:00,23016.75,BUY,3,0.02h,Break Even,$0.75,$807.75,$611511.50,398,$807.75
2025-07-16,15:18:00,22983.0,SELL,3,0.02h,Stop Loss,$147.00,$954.75,$611658.50,398,$954.75
2025-07-16,15:48:00,22946.25,BUY,3,0.02h,Break Even,$0.75,$955.50,$611659.25,398,$955.50
2025-07-16,16:24:00,22971.0,SELL,3,0.02h,Break Even,$0.75,$956.25,$611660.00,398,$956.25
2025-07-16,16:30:00,22983.0,BUY,3,0.02h,Break Even,$0.75,$957.00,$611660.75,398,$957.00
2025-07-16,16:48:00,22978.25,SELL,3,0.02h,Stop Loss,$-18.00,$939.00,$611642.75,398,$939.00
2025-07-16,16:49:00,22996.75,BUY,3,0.02h,Stop Loss,$94.50,$1033.50,$611737.25,398,$1033.50
2025-07-16,17:30:00,23040.0,SELL,3,0.02h,Stop Loss,$15.75,$1049.25,$611753.00,398,$1049.25
2025-07-16,18:17:00,23042.0,BUY,3,0.02h,Stop Loss,$-18.00,$1031.25,$611735.00,398,$1031.25
2025-07-16,18:20:00,23026.5,SELL,3,0.02h,Stop Loss,$105.75,$1137.00,$611840.75,398,$1137.00
2025-07-16,18:23:00,23037.75,BUY,3,0.02h,Break Even,$0.75,$1137.75,$611841.50,398,$1137.75
2025-07-16,19:17:00,23062.75,SELL,3,0.02h,Break Even,$0.75,$1138.50,$611842.25,398,$1138.50
2025-07-16,19:27:00,23071.0,BUY,3,0.02h,Stop Loss,$-18.00,$1120.50,$611824.25,398,$1120.50
2025-07-16,20:00:00,23075.0,SELL,3,0.02h,Stop Loss,$120.75,$1241.25,$611945.00,398,$1241.25
2025-07-16,20:40:00,23065.0,BUY,3,0.02h,Stop Loss,$-18.00,$1223.25,$611927.00,398,$1223.25
2025-07-16,20:53:00,23060.75,SELL,3,0.02h,Stop Loss,$-18.00,$1205.25,$611909.00,398,$1205.25
2025-07-16,22:01:00,23064.5,BUY,3,0.02h,Stop Loss,$-18.00,$1187.25,$611891.00,398,$1187.25
2025-07-16,22:02:00,23061.5,SELL,3,0.02h,Stop Loss,$19.50,$1206.75,$611910.50,398,$1206.75
,,,,,,,,,,,
2025-07-17,12:00:00,23086.75,BUY,3,0.02h,Stop Loss,$83.25,$83.25,$611993.75,399,$83.25
2025-07-17,13:17:00,23129.5,SELL,3,0.02h,Stop Loss,$53.25,$136.50,$612047.00,399,$136.50
2025-07-17,13:44:00,23118.75,BUY,3,0.02h,Stop Loss,$60.75,$197.25,$612107.75,399,$197.25
2025-07-17,14:18:00,23145.0,SELL,3,0.02h,Stop Loss,$75.75,$273.00,$612183.50,399,$273.00
2025-07-17,14:31:00,23154.0,BUY,3,0.02h,Stop Loss,$-18.00,$255.00,$612165.50,399,$255.00
2025-07-17,15:35:00,23219.75,SELL,3,0.02h,Break Even,$0.75,$255.75,$612166.25,399,$255.75
2025-07-17,15:37:00,23225.75,BUY,3,0.02h,Break Even,$0.75,$256.50,$612167.00,399,$256.50
2025-07-17,16:40:00,23250.25,SELL,3,0.02h,Break Even,$0.75,$257.25,$612167.75,399,$257.25
2025-07-17,16:49:00,23259.75,BUY,3,0.02h,Break Even,$0.75,$258.00,$612168.50,399,$258.00
2025-07-17,16:57:00,23252.0,SELL,3,0.02h,Stop Loss,$-18.00,$240.00,$612150.50,399,$240.00
2025-07-17,17:15:00,23259.0,BUY,3,0.02h,Break Even,$0.75,$240.75,$612151.25,399,$240.75
2025-07-17,17:28:00,23249.0,SELL,3,0.02h,Stop Loss,$79.50,$320.25,$612230.75,399,$320.25
2025-07-17,17:32:00,23260.0,BUY,3,0.02h,Break Even,$0.75,$321.00,$612231.50,399,$321.00
2025-07-17,17:34:00,23255.0,SELL,3,0.02h,Stop Loss,$-18.00,$303.00,$612213.50,399,$303.00
2025-07-17,17:35:00,23258.0,BUY,3,0.02h,Break Even,$0.75,$303.75,$612214.25,399,$303.75
2025-07-17,18:07:00,23256.0,SELL,3,0.02h,Stop Loss,$42.00,$345.75,$612256.25,399,$345.75
2025-07-17,18:30:00,23256.0,BUY,3,0.02h,Break Even,$0.75,$346.50,$612257.00,399,$346.50
2025-07-17,18:37:00,23249.5,SELL,3,0.02h,Break Even,$0.75,$347.25,$612257.75,399,$347.25
2025-07-17,18:39:00,23256.5,BUY,3,0.02h,Break Even,$0.75,$348.00,$612258.50,399,$348.00
2025-07-17,19:00:00,23252.5,SELL,3,0.02h,Break Even,$0.75,$348.75,$612259.25,399,$348.75
2025-07-17,19:02:00,23258.5,BUY,3,0.02h,Stop Loss,$72.00,$420.75,$612331.25,399,$420.75
2025-07-17,19:19:00,23259.5,SELL,3,0.02h,Stop Loss,$-18.00,$402.75,$612313.25,399,$402.75
2025-07-17,19:20:00,23261.75,BUY,3,0.02h,Break Even,$0.75,$403.50,$612314.00,399,$403.50
2025-07-17,19:27:00,23259.75,SELL,3,0.02h,Stop Loss,$-18.00,$385.50,$612296.00,399,$385.50
2025-07-17,19:30:00,23261.75,BUY,3,0.02h,Stop Loss,$30.75,$416.25,$612326.75,399,$416.25
2025-07-17,19:44:00,23257.25,SELL,3,0.02h,Break Even,$0.75,$417.00,$612327.50,399,$417.00
2025-07-17,19:54:00,23270.25,BUY,3,0.02h,Stop Loss,$72.00,$489.00,$612399.50,399,$489.00
2025-07-17,19:56:00,23256.0,SELL,3,0.02h,Stop Loss,$79.50,$568.50,$612479.00,399,$568.50
2025-07-17,20:15:00,23255.5,BUY,3,0.02h,Break Even,$0.75,$569.25,$612479.75,399,$569.25
2025-07-17,20:52:00,23264.0,SELL,3,0.02h,Stop Loss,$-18.00,$551.25,$612461.75,399,$551.25
2025-07-17,20:57:00,23267.0,BUY,3,0.03h,Break Even,$0.75,$552.00,$612462.50,399,$552.00
2025-07-17,21:00:00,23265.5,SELL,3,1.02h,Stop Loss,$252.00,$804.00,$612714.50,399,$804.00
2025-07-17,22:22:00,23261.0,BUY,3,0.02h,Stop Loss,$-18.00,$786.00,$612696.50,399,$786.00
2025-07-17,22:23:00,23256.0,SELL,3,0.02h,Stop Loss,$-18.00,$768.00,$612678.50,399,$768.00
2025-07-17,22:24:00,23258.25,BUY,3,0.02h,Stop Loss,$-18.00,$750.00,$612660.50,399,$750.00
2025-07-17,22:32:00,23254.0,SELL,3,0.02h,Break Even,$0.75,$750.75,$612661.25,399,$750.75
2025-07-17,22:55:00,23257.0,BUY,3,0.02h,Stop Loss,$-18.00,$732.75,$612643.25,399,$732.75
,,,,,,,,,,,
2025-07-18,12:32:00,23258.5,SELL,3,0.02h,Stop Loss,$-18.00,$-18.00,$612625.25,400,$-18.00
2025-07-18,12:33:00,23263.25,BUY,3,0.02h,Break Even,$0.75,$-17.25,$612626.00,400,$-17.25
2025-07-18,12:34:00,23260.25,SELL,3,0.02h,Break Even,$0.75,$-16.50,$612626.75,400,$-16.50
2025-07-18,12:40:00,23267.0,BUY,3,0.02h,Stop Loss,$-18.00,$-34.50,$612608.75,400,$-34.50
2025-07-18,12:44:00,23260.25,SELL,3,0.02h,Stop Loss,$-18.00,$-52.50,$612590.75,400,$-52.50
2025-07-18,12:45:00,23265.25,BUY,3,0.02h,Stop Loss,$-18.00,$-70.50,$612572.75,400,$-70.50
2025-07-18,13:18:00,23264.5,SELL,3,0.02h,Stop Loss,$19.50,$-51.00,$612592.25,400,$-51.00
2025-07-18,13:27:00,23278.0,BUY,3,0.02h,Stop Loss,$229.50,$178.50,$612821.75,400,$178.50
2025-07-18,13:39:00,23261.25,SELL,3,0.02h,Stop Loss,$12.00,$190.50,$612833.75,400,$190.50
2025-07-18,13:48:00,23292.75,BUY,3,0.02h,Stop Loss,$27.00,$217.50,$612860.75,400,$217.50
2025-07-18,13:54:00,23269.25,SELL,3,0.02h,Stop Loss,$34.50,$252.00,$612895.25,400,$252.00
2025-07-18,14:45:00,23223.75,BUY,3,0.02h,Stop Loss,$60.75,$312.75,$612956.00,400,$312.75
2025-07-18,14:50:00,23209.75,SELL,3,0.02h,Break Even,$0.75,$313.50,$612956.75,400,$313.50
2025-07-18,14:51:00,23215.5,BUY,3,0.02h,Stop Loss,$19.50,$333.00,$612976.25,400,$333.00
2025-07-18,15:00:00,23205.0,SELL,3,0.02h,Stop Loss,$83.25,$416.25,$613059.50,400,$416.25
2025-07-18,15:17:00,23215.75,BUY,3,0.02h,Break Even,$0.75,$417.00,$613060.25,400,$417.00
2025-07-18,15:24:00,23202.25,SELL,3,0.02h,Stop Loss,$-18.00,$399.00,$613042.25,400,$399.00
2025-07-18,15:28:00,23213.5,BUY,3,0.02h,Stop Loss,$15.75,$414.75,$613058.00,400,$414.75
2025-07-18,16:08:00,23230.75,SELL,3,0.02h,Break Even,$0.75,$415.50,$613058.75,400,$415.50
2025-07-18,16:46:00,23212.5,BUY,3,0.02h,Break Even,$0.75,$416.25,$613059.50,400,$416.25
2025-07-18,16:49:00,23191.5,SELL,3,0.02h,Stop Loss,$-18.00,$398.25,$613041.50,400,$398.25
2025-07-18,16:52:00,23211.25,BUY,3,0.02h,Stop Loss,$-18.00,$380.25,$613023.50,400,$380.25
2025-07-18,16:54:00,23194.75,SELL,3,0.02h,Stop Loss,$-18.00,$362.25,$613005.50,400,$362.25
2025-07-18,17:15:00,23204.5,BUY,3,0.02h,Break Even,$0.75,$363.00,$613006.25,400,$363.00
2025-07-18,17:47:00,23199.25,SELL,3,0.02h,Stop Loss,$42.00,$405.00,$613048.25,400,$405.00
2025-07-18,18:03:00,23213.75,BUY,3,0.02h,Stop Loss,$-18.00,$387.00,$613030.25,400,$387.00
2025-07-18,18:13:00,23200.0,SELL,3,0.02h,Break Even,$0.75,$387.75,$613031.00,400,$387.75
2025-07-18,18:21:00,23211.0,BUY,3,0.02h,Stop Loss,$-18.00,$369.75,$613013.00,400,$369.75
2025-07-18,18:53:00,23210.5,SELL,3,0.02h,Stop Loss,$60.75,$430.50,$613073.75,400,$430.50
2025-07-18,19:13:00,23211.25,BUY,3,0.02h,Stop Loss,$-18.00,$412.50,$613055.75,400,$412.50
2025-07-18,19:31:00,23213.25,SELL,3,0.02h,Stop Loss,$64.50,$477.00,$613120.25,400,$477.00
2025-07-18,19:49:00,23213.25,BUY,3,0.02h,Break Even,$0.75,$477.75,$613121.00,400,$477.75
2025-07-18,20:26:00,23219.75,SELL,3,0.02h,Break Even,$0.75,$478.50,$613121.75,400,$478.50
2025-07-18,20:35:00,23225.25,BUY,3,0.03h,Break Even,$0.75,$479.25,$613122.50,400,$479.25
2025-07-18,20:46:00,23221.5,SELL,3,0.02h,Break Even,$0.75,$480.00,$613123.25,400,$480.00
2025-07-18,20:54:00,23224.0,BUY,3,0.02h,Stop Loss,$-18.00,$462.00,$613105.25,400,$462.00
,,,,,,,,,,,
2025-07-21,12:42:00,23267.5,SELL,3,0.02h,Break Even,$0.75,$0.75,$613106.00,401,$0.75
2025-07-21,13:23:00,23244.25,BUY,3,0.02h,Break Even,$0.75,$1.50,$613106.75,401,$1.50
2025-07-21,14:46:00,23397.75,SELL,3,0.02h,Stop Loss,$-18.00,$-16.50,$613088.75,401,$-16.50
2025-07-21,15:27:00,23396.5,BUY,3,0.02h,Break Even,$0.75,$-15.75,$613089.50,401,$-15.75
2025-07-21,15:56:00,23394.75,SELL,3,0.02h,Stop Loss,$68.25,$52.50,$613157.75,401,$52.50
2025-07-21,16:32:00,23384.5,BUY,3,0.02h,Break Even,$0.75,$53.25,$613158.50,401,$53.25
2025-07-21,17:43:00,23411.75,SELL,3,0.02h,Stop Loss,$-18.00,$35.25,$613140.50,401,$35.25
2025-07-21,17:49:00,23417.75,BUY,3,0.02h,Break Even,$0.75,$36.00,$613141.25,401,$36.00
2025-07-21,18:00:00,23411.75,SELL,3,0.02h,Stop Loss,$30.75,$66.75,$613172.00,401,$66.75
2025-07-21,18:24:00,23416.5,BUY,3,0.02h,Stop Loss,$-18.00,$48.75,$613154.00,401,$48.75
2025-07-21,18:31:00,23409.25,SELL,3,0.02h,Stop Loss,$19.50,$68.25,$613173.50,401,$68.25
2025-07-21,20:18:00,23352.25,BUY,3,0.02h,Break Even,$0.75,$69.00,$613174.25,401,$69.00
2025-07-21,20:27:00,23343.75,SELL,3,0.02h,Break Even,$0.75,$69.75,$613175.00,401,$69.75
2025-07-21,20:55:00,23346.5,BUY,3,0.02h,Stop Loss,$-18.00,$51.75,$613157.00,401,$51.75
2025-07-21,20:58:00,23345.0,SELL,3,0.03h,Stop Loss,$-18.00,$33.75,$613139.00,401,$33.75
2025-07-21,21:00:00,23346.75,BUY,3,1.02h,Stop Loss,$-18.00,$15.75,$613121.00,401,$15.75
2025-07-21,22:08:00,23345.0,SELL,3,0.02h,Stop Loss,$-18.00,$-2.25,$613103.00,401,$-2.25
2025-07-21,22:26:00,23349.0,BUY,3,0.02h,Stop Loss,$-18.00,$-20.25,$613085.00,401,$-20.25
2025-07-21,22:39:00,23344.25,SELL,3,0.02h,Stop Loss,$-18.00,$-38.25,$613067.00,401,$-38.25
2025-07-21,22:50:00,23346.5,BUY,3,0.02h,Stop Loss,$-18.00,$-56.25,$613049.00,401,$-56.25
2025-07-21,22:53:00,23343.75,SELL,3,0.02h,Stop Loss,$-18.00,$-74.25,$613031.00,401,$-74.25
,,,,,,,,,,,
2025-07-22,12:29:00,23338.0,BUY,3,0.02h,Break Even,$0.75,$0.75,$613031.75,402,$0.75
2025-07-22,12:44:00,23329.0,SELL,3,0.02h,Break Even,$0.75,$1.50,$613032.50,402,$1.50
2025-07-22,12:52:00,23333.75,BUY,3,0.02h,Break Even,$0.75,$2.25,$613033.25,402,$2.25
2025-07-22,13:23:00,23334.25,SELL,3,0.02h,Break Even,$0.75,$3.00,$613034.00,402,$3.00
2025-07-22,13:27:00,23339.5,BUY,3,0.02h,Stop Loss,$-18.00,$-15.00,$613016.00,402,$-15.00
2025-07-22,13:28:00,23333.75,SELL,3,0.02h,Stop Loss,$-18.00,$-33.00,$612998.00,402,$-33.00
2025-07-22,13:29:00,23341.5,BUY,3,0.02h,Stop Loss,$34.50,$1.50,$613032.50,402,$1.50
2025-07-22,13:31:00,23319.25,SELL,3,0.02h,Stop Loss,$353.25,$354.75,$613385.75,402,$354.75
2025-07-22,14:16:00,23195.5,BUY,3,0.02h,Break Even,$0.75,$355.50,$613386.50,402,$355.50
2025-07-22,14:25:00,23163.5,SELL,3,0.02h,Stop Loss,$-18.00,$337.50,$613368.50,402,$337.50
2025-07-22,14:32:00,23197.5,BUY,3,0.02h,Stop Loss,$-18.00,$319.50,$613350.50,402,$319.50
2025-07-22,15:16:00,23209.0,SELL,3,0.02h,Stop Loss,$124.50,$444.00,$613475.00,402,$444.00
2025-07-22,15:34:00,23223.0,BUY,3,0.02h,Stop Loss,$135.75,$579.75,$613610.75,402,$579.75
2025-07-22,15:56:00,23217.5,SELL,3,0.02h,Stop Loss,$124.50,$704.25,$613735.25,402,$704.25
2025-07-22,16:18:00,23222.75,BUY,3,0.02h,Break Even,$0.75,$705.00,$613736.00,402,$705.00
2025-07-22,16:25:00,23202.75,SELL,3,0.02h,Stop Loss,$203.25,$908.25,$613939.25,402,$908.25
2025-07-22,16:53:00,23195.25,BUY,3,0.02h,Break Even,$0.75,$909.00,$613940.00,402,$909.00
2025-07-22,17:44:00,23223.5,SELL,3,0.02h,Break Even,$0.75,$909.75,$613940.75,402,$909.75
2025-07-22,18:03:00,23226.75,BUY,3,0.02h,Break Even,$0.75,$910.50,$613941.50,402,$910.50
2025-07-22,18:07:00,23218.5,SELL,3,0.02h,Stop Loss,$-18.00,$892.50,$613923.50,402,$892.50
2025-07-22,18:08:00,23224.0,BUY,3,0.02h,Break Even,$0.75,$893.25,$613924.25,402,$893.25
2025-07-22,18:16:00,23215.0,SELL,3,0.02h,Stop Loss,$19.50,$912.75,$613943.75,402,$912.75
2025-07-22,18:28:00,23221.75,BUY,3,0.02h,Stop Loss,$-18.00,$894.75,$613925.75,402,$894.75
2025-07-22,19:10:00,23242.0,SELL,3,0.02h,Stop Loss,$-18.00,$876.75,$613907.75,402,$876.75
2025-07-22,19:27:00,23243.5,BUY,3,0.02h,Stop Loss,$-18.00,$858.75,$613889.75,402,$858.75
2025-07-22,19:31:00,23235.75,SELL,3,0.02h,Stop Loss,$-18.00,$840.75,$613871.75,402,$840.75
2025-07-22,19:34:00,23246.0,BUY,3,0.02h,Break Even,$0.75,$841.50,$613872.50,402,$841.50
2025-07-22,19:46:00,23240.0,SELL,3,0.02h,Stop Loss,$38.25,$879.75,$613910.75,402,$879.75
2025-07-22,20:49:00,23197.5,BUY,3,0.02h,Stop Loss,$-18.00,$861.75,$613892.75,402,$861.75
2025-07-22,20:50:00,23195.75,SELL,3,0.02h,Break Even,$0.75,$862.50,$613893.50,402,$862.50
2025-07-22,22:01:00,23203.0,BUY,3,0.02h,Break Even,$0.75,$863.25,$613894.25,402,$863.25
2025-07-22,22:10:00,23192.0,SELL,3,0.02h,Stop Loss,$53.25,$916.50,$613947.50,402,$916.50
2025-07-22,22:59:00,23181.0,BUY,3,0.02h,Break Even,$0.75,$917.25,$613948.25,402,$917.25
,,,,,,,,,,,
2025-07-23,12:33:00,23241.0,SELL,3,0.02h,Break Even,$0.75,$0.75,$613949.00,403,$0.75
2025-07-23,12:49:00,23247.75,BUY,3,0.02h,Break Even,$0.75,$1.50,$613949.75,403,$1.50
2025-07-23,12:51:00,23236.75,SELL,3,0.02h,Stop Loss,$45.75,$47.25,$613995.50,403,$47.25
2025-07-23,13:10:00,23242.5,BUY,3,0.02h,Stop Loss,$-18.00,$29.25,$613977.50,403,$29.25
2025-07-23,13:16:00,23237.75,SELL,3,0.02h,Break Even,$0.75,$30.00,$613978.25,403,$30.00
2025-07-23,13:19:00,23244.75,BUY,3,0.02h,Stop Loss,$-18.00,$12.00,$613960.25,403,$12.00
2025-07-23,13:32:00,23197.0,SELL,3,0.02h,Stop Loss,$162.00,$174.00,$614122.25,403,$174.00
2025-07-23,14:23:00,23181.75,BUY,3,0.02h,Break Even,$0.75,$174.75,$614123.00,403,$174.75
2025-07-23,14:35:00,23151.25,SELL,3,0.02h,Break Even,$0.75,$175.50,$614123.75,403,$175.50
2025-07-23,14:47:00,23178.0,BUY,3,0.02h,Break Even,$0.75,$176.25,$614124.50,403,$176.25
2025-07-23,15:17:00,23192.0,SELL,3,0.02h,Break Even,$0.75,$177.00,$614125.25,403,$177.00
2025-07-23,15:20:00,23196.75,BUY,3,0.02h,Stop Loss,$87.00,$264.00,$614212.25,403,$264.00
2025-07-23,16:15:00,23230.0,SELL,3,0.02h,Stop Loss,$-18.00,$246.00,$614194.25,403,$246.00
2025-07-23,16:44:00,23225.0,BUY,3,0.02h,Break Even,$0.75,$246.75,$614195.00,403,$246.75
2025-07-23,17:13:00,23222.25,SELL,3,0.02h,Break Even,$0.75,$247.50,$614195.75,403,$247.50
2025-07-23,17:24:00,23232.75,BUY,3,0.02h,Break Even,$0.75,$248.25,$614196.50,403,$248.25
2025-07-23,18:57:00,23294.5,SELL,3,0.02h,Stop Loss,$-18.00,$230.25,$614178.50,403,$230.25
2025-07-23,18:59:00,23299.25,BUY,3,0.02h,Break Even,$0.75,$231.00,$614179.25,403,$231.00
2025-07-23,19:05:00,23293.5,SELL,3,0.02h,Break Even,$0.75,$231.75,$614180.00,403,$231.75
2025-07-23,19:13:00,23298.75,BUY,3,0.02h,Break Even,$0.75,$232.50,$614180.75,403,$232.50
2025-07-23,19:14:00,23294.25,SELL,3,0.02h,Stop Loss,$23.25,$255.75,$614204.00,403,$255.75
2025-07-23,19:53:00,23295.25,BUY,3,0.02h,Stop Loss,$19.50,$275.25,$614223.50,403,$275.25
2025-07-23,22:04:00,23391.75,SELL,3,0.02h,Stop Loss,$-18.00,$257.25,$614205.50,403,$257.25
2025-07-23,22:28:00,23397.0,BUY,3,0.02h,Stop Loss,$-18.00,$239.25,$614187.50,403,$239.25
2025-07-23,22:32:00,23393.0,SELL,3,0.02h,Break Even,$0.75,$240.00,$614188.25,403,$240.00
2025-07-23,22:33:00,23396.25,BUY,3,0.02h,Break Even,$0.75,$240.75,$614189.00,403,$240.75
2025-07-23,22:37:00,23393.25,SELL,3,0.02h,Stop Loss,$15.75,$256.50,$614204.75,403,$256.50
,,,,,,,,,,,
2025-07-24,12:09:00,23391.25,BUY,3,0.02h,Stop Loss,$-18.00,$-18.00,$614186.75,404,$-18.00
2025-07-24,12:17:00,23382.75,SELL,3,0.02h,Break Even,$0.75,$-17.25,$614187.50,404,$-17.25
2025-07-24,13:00:00,23360.5,BUY,3,0.02h,Stop Loss,$-18.00,$-35.25,$614169.50,404,$-35.25
2025-07-24,13:12:00,23349.25,SELL,3,0.02h,Break Even,$0.75,$-34.50,$614170.25,404,$-34.50
2025-07-24,13:14:00,23357.75,BUY,3,0.02h,Break Even,$0.75,$-33.75,$614171.00,404,$-33.75
2025-07-24,13:17:00,23349.5,SELL,3,0.02h,Break Even,$0.75,$-33.00,$614171.75,404,$-33.00
2025-07-24,13:18:00,23357.75,BUY,3,0.02h,Stop Loss,$-18.00,$-51.00,$614153.75,404,$-51.00
2025-07-24,13:37:00,23352.0,SELL,3,0.02h,Stop Loss,$45.75,$-5.25,$614199.50,404,$-5.25
2025-07-24,13:47:00,23373.75,BUY,3,0.02h,Stop Loss,$330.75,$325.50,$614530.25,404,$325.50
2025-07-24,13:57:00,23362.25,SELL,3,0.02h,Break Even,$0.75,$326.25,$614531.00,404,$326.25
2025-07-24,13:58:00,23369.25,BUY,3,0.02h,Break Even,$0.75,$327.00,$614531.75,404,$327.00
2025-07-24,13:59:00,23359.5,SELL,3,0.02h,Break Even,$0.75,$327.75,$614532.50,404,$327.75
2025-07-24,14:32:00,23340.75,BUY,3,0.02h,Break Even,$0.75,$328.50,$614533.25,404,$328.50
2025-07-24,15:33:00,23375.75,SELL,3,0.02h,Stop Loss,$27.00,$355.50,$614560.25,404,$355.50
2025-07-24,15:47:00,23382.0,BUY,3,0.02h,Break Even,$0.75,$356.25,$614561.00,404,$356.25
2025-07-24,15:48:00,23376.5,SELL,3,0.02h,Stop Loss,$-18.00,$338.25,$614543.00,404,$338.25
2025-07-24,15:49:00,23387.25,BUY,3,0.02h,Stop Loss,$-18.00,$320.25,$614525.00,404,$320.25
2025-07-24,16:02:00,23369.75,SELL,3,0.02h,Break Even,$0.75,$321.00,$614525.75,404,$321.00
2025-07-24,16:42:00,23368.25,BUY,3,0.02h,Stop Loss,$-18.00,$303.00,$614507.75,404,$303.00
2025-07-24,17:36:00,23397.25,SELL,3,0.02h,Break Even,$0.75,$303.75,$614508.50,404,$303.75
2025-07-24,17:39:00,23398.25,BUY,3,0.02h,Stop Loss,$-18.00,$285.75,$614490.50,404,$285.75
2025-07-24,17:40:00,23397.0,SELL,3,0.02h,Stop Loss,$68.25,$354.00,$614558.75,404,$354.00
2025-07-24,17:53:00,23399.5,BUY,3,0.02h,Break Even,$0.75,$354.75,$614559.50,404,$354.75
2025-07-24,17:57:00,23390.0,SELL,3,0.02h,Stop Loss,$68.25,$423.00,$614627.75,404,$423.00
2025-07-24,18:05:00,23398.25,BUY,3,0.02h,Stop Loss,$-18.00,$405.00,$614609.75,404,$405.00
2025-07-24,18:40:00,23408.5,SELL,3,0.02h,Break Even,$0.75,$405.75,$614610.50,404,$405.75
2025-07-24,19:02:00,23404.0,BUY,3,0.02h,Break Even,$0.75,$406.50,$614611.25,404,$406.50
2025-07-24,19:41:00,23405.0,SELL,3,0.02h,Break Even,$0.75,$407.25,$614612.00,404,$407.25
2025-07-24,20:17:00,23390.25,BUY,3,0.02h,Stop Loss,$-18.00,$389.25,$614594.00,404,$389.25
2025-07-24,20:28:00,23386.75,SELL,3,0.02h,Break Even,$0.75,$390.00,$614594.75,404,$390.00
2025-07-24,20:29:00,23390.5,BUY,3,0.02h,Break Even,$0.75,$390.75,$614595.50,404,$390.75
2025-07-24,20:58:00,23393.25,SELL,3,0.02h,Stop Loss,$-18.00,$372.75,$614577.50,404,$372.75
2025-07-24,22:06:00,23398.75,BUY,3,0.02h,Stop Loss,$-18.00,$354.75,$614559.50,404,$354.75
2025-07-24,22:35:00,23403.0,SELL,3,0.02h,Stop Loss,$-18.00,$336.75,$614541.50,404,$336.75
2025-07-24,22:37:00,23406.75,BUY,3,0.03h,Break Even,$0.75,$337.50,$614542.25,404,$337.50
2025-07-24,22:51:00,23404.25,SELL,3,0.02h,Break Even,$0.75,$338.25,$614543.00,404,$338.25
,,,,,,,,,,,
2025-07-25,12:25:00,23379.0,BUY,3,0.02h,Break Even,$0.75,$0.75,$614543.75,405,$0.75
2025-07-25,12:43:00,23371.0,SELL,3,0.02h,Stop Loss,$-18.00,$-17.25,$614525.75,405,$-17.25
2025-07-25,13:21:00,23369.5,BUY,3,0.02h,Break Even,$0.75,$-16.50,$614526.50,405,$-16.50
2025-07-25,13:30:00,23360.25,SELL,3,0.02h,Stop Loss,$188.25,$171.75,$614714.75,405,$171.75
2025-07-25,13:36:00,23374.75,BUY,3,0.02h,Break Even,$0.75,$172.50,$614715.50,405,$172.50
2025-07-25,13:37:00,23362.25,SELL,3,0.02h,Stop Loss,$297.00,$469.50,$615012.50,405,$469.50
2025-07-25,13:47:00,23368.75,BUY,3,0.02h,Stop Loss,$87.00,$556.50,$615099.50,405,$556.50
2025-07-25,14:56:00,23401.0,SELL,3,0.02h,Stop Loss,$113.25,$669.75,$615212.75,405,$669.75
2025-07-25,15:13:00,23407.0,BUY,3,0.02h,Break Even,$0.75,$670.50,$615213.50,405,$670.50
2025-07-25,15:40:00,23408.25,SELL,3,0.02h,Stop Loss,$-18.00,$652.50,$615195.50,405,$652.50
2025-07-25,15:50:00,23415.75,BUY,3,0.02h,Stop Loss,$75.75,$728.25,$615271.25,405,$728.25
2025-07-25,16:47:00,23450.25,SELL,3,0.02h,Stop Loss,$-18.00,$710.25,$615253.25,405,$710.25
2025-07-25,16:55:00,23458.75,BUY,3,0.02h,Stop Loss,$-18.00,$692.25,$615235.25,405,$692.25
2025-07-25,17:00:00,23450.25,SELL,3,0.02h,Stop Loss,$19.50,$711.75,$615254.75,405,$711.75
2025-07-25,17:28:00,23449.0,BUY,3,0.02h,Stop Loss,$19.50,$731.25,$615274.25,405,$731.25
2025-07-25,17:44:00,23444.75,SELL,3,0.02h,Stop Loss,$-18.00,$713.25,$615256.25,405,$713.25
2025-07-25,18:15:00,23445.25,BUY,3,0.02h,Stop Loss,$34.50,$747.75,$615290.75,405,$747.75
2025-07-25,18:53:00,23447.0,SELL,3,0.02h,Stop Loss,$-18.00,$729.75,$615272.75,405,$729.75
2025-07-25,19:15:00,23447.25,BUY,3,0.02h,Stop Loss,$15.75,$745.50,$615288.50,405,$745.50
2025-07-25,19:27:00,23444.25,SELL,3,0.02h,Break Even,$0.75,$746.25,$615289.25,405,$746.25
2025-07-25,19:39:00,23449.0,BUY,3,0.02h,Stop Loss,$-18.00,$728.25,$615271.25,405,$728.25
2025-07-25,19:42:00,23443.75,SELL,3,0.02h,Break Even,$0.75,$729.00,$615272.00,405,$729.00
2025-07-25,20:15:00,23434.5,BUY,3,0.02h,Break Even,$0.75,$729.75,$615272.75,405,$729.75
,,,,,,,,,,,
2025-07-28,13:04:00,23502.5,SELL,3,0.02h,Stop Loss,$45.75,$45.75,$615318.50,406,$45.75
2025-07-28,13:35:00,23494.0,BUY,3,0.02h,Stop Loss,$42.00,$87.75,$615360.50,406,$87.75
2025-07-28,14:21:00,23507.5,SELL,3,0.02h,Stop Loss,$570.75,$658.50,$615931.25,406,$658.50
2025-07-28,14:42:00,23517.0,BUY,3,0.02h,Break Even,$0.75,$659.25,$615932.00,406,$659.25
2025-07-28,14:47:00,23500.5,SELL,3,0.02h,Break Even,$0.75,$660.00,$615932.75,406,$660.00
2025-07-28,15:33:00,23482.0,BUY,3,0.02h,Break Even,$0.75,$660.75,$615933.50,406,$660.75
2025-07-28,16:05:00,23488.0,SELL,3,0.02h,Break Even,$0.75,$661.50,$615934.25,406,$661.50
2025-07-28,16:18:00,23498.75,BUY,3,0.02h,Stop Loss,$12.00,$673.50,$615946.25,406,$673.50
2025-07-28,16:32:00,23485.25,SELL,3,0.02h,Break Even,$0.75,$674.25,$615947.00,406,$674.25
2025-07-28,17:15:00,23484.75,BUY,3,0.02h,Stop Loss,$-18.00,$656.25,$615929.00,406,$656.25
2025-07-28,17:16:00,23478.25,SELL,3,0.02h,Stop Loss,$-18.00,$638.25,$615911.00,406,$638.25
2025-07-28,17:33:00,23481.5,BUY,3,0.02h,Break Even,$0.75,$639.00,$615911.75,406,$639.00
2025-07-28,17:52:00,23469.5,SELL,3,0.02h,Stop Loss,$-18.00,$621.00,$615893.75,406,$621.00
2025-07-28,18:18:00,23469.5,BUY,3,0.02h,Break Even,$0.75,$621.75,$615894.50,406,$621.75
2025-07-28,18:22:00,23455.75,SELL,3,0.02h,Break Even,$0.75,$622.50,$615895.25,406,$622.50
2025-07-28,18:48:00,23459.25,BUY,3,0.02h,Break Even,$0.75,$623.25,$615896.00,406,$623.25
2025-07-28,19:06:00,23454.75,SELL,3,0.02h,Break Even,$0.75,$624.00,$615896.75,406,$624.00
2025-07-28,19:22:00,23463.0,BUY,3,0.02h,Break Even,$0.75,$624.75,$615897.50,406,$624.75
2025-07-28,22:45:00,23521.5,SELL,3,0.02h,Break Even,$0.75,$625.50,$615898.25,406,$625.50
2025-07-28,22:47:00,23523.25,BUY,3,0.02h,Break Even,$0.75,$626.25,$615899.00,406,$626.25
,,,,,,,,,,,
2025-07-29,12:43:00,23588.25,SELL,3,0.02h,Break Even,$0.75,$0.75,$615899.75,407,$0.75
2025-07-29,13:20:00,23587.0,BUY,3,0.02h,Stop Loss,$-18.00,$-17.25,$615881.75,407,$-17.25
2025-07-29,13:49:00,23606.0,SELL,3,0.02h,Stop Loss,$409.50,$392.25,$616291.25,407,$392.25
2025-07-29,14:41:00,23573.75,BUY,3,0.02h,Break Even,$0.75,$393.00,$616292.00,407,$393.00
2025-07-29,14:45:00,23554.25,SELL,3,0.02h,Break Even,$0.75,$393.75,$616292.75,407,$393.75
2025-07-29,15:50:00,23498.0,BUY,3,0.02h,Stop Loss,$90.75,$484.50,$616383.50,407,$484.50
2025-07-29,16:10:00,23489.25,SELL,3,0.02h,Break Even,$0.75,$485.25,$616384.25,407,$485.25
2025-07-29,16:48:00,23482.25,BUY,3,0.02h,Break Even,$0.75,$486.00,$616385.00,407,$486.00
2025-07-29,17:33:00,23506.0,SELL,3,0.02h,Stop Loss,$23.25,$509.25,$616408.25,407,$509.25
2025-07-29,17:59:00,23494.5,BUY,3,0.02h,Stop Loss,$-18.00,$491.25,$616390.25,407,$491.25
2025-07-29,18:21:00,23481.5,SELL,3,0.02h,Stop Loss,$-18.00,$473.25,$616372.25,407,$473.25
2025-07-29,18:34:00,23491.0,BUY,3,0.02h,Break Even,$0.75,$474.00,$616373.00,407,$474.00
2025-07-29,18:50:00,23486.25,SELL,3,0.02h,Break Even,$0.75,$474.75,$616373.75,407,$474.75
2025-07-29,19:54:00,23460.25,BUY,3,0.02h,Break Even,$0.75,$475.50,$616374.50,407,$475.50
2025-07-29,19:57:00,23439.0,SELL,3,0.02h,Stop Loss,$19.50,$495.00,$616394.00,407,$495.00
2025-07-29,20:02:00,23457.5,BUY,3,0.02h,Break Even,$0.75,$495.75,$616394.75,407,$495.75
2025-07-29,20:24:00,23447.75,SELL,3,0.02h,Stop Loss,$-18.00,$477.75,$616376.75,407,$477.75
2025-07-29,20:29:00,23455.25,BUY,3,0.02h,Stop Loss,$-18.00,$459.75,$616358.75,407,$459.75
2025-07-29,20:44:00,23450.5,SELL,3,0.02h,Break Even,$0.75,$460.50,$616359.50,407,$460.50
2025-07-29,22:01:00,23460.0,BUY,3,0.02h,Stop Loss,$38.25,$498.75,$616397.75,407,$498.75
2025-07-29,22:29:00,23460.0,SELL,3,0.02h,Break Even,$0.75,$499.50,$616398.50,407,$499.50
2025-07-29,22:31:00,23465.75,BUY,3,0.02h,Stop Loss,$-18.00,$481.50,$616380.50,407,$481.50
2025-07-29,22:38:00,23460.25,SELL,3,0.02h,Stop Loss,$-18.00,$463.50,$616362.50,407,$463.50
2025-07-29,22:40:00,23462.5,BUY,3,0.02h,Stop Loss,$-18.00,$445.50,$616344.50,407,$445.50
,,,,,,,,,,,
2025-07-30,12:21:00,23480.5,SELL,3,0.02h,Stop Loss,$19.50,$19.50,$616364.00,408,$19.50
2025-07-30,12:27:00,23487.75,BUY,3,0.02h,Stop Loss,$-18.00,$1.50,$616346.00,408,$1.50
2025-07-30,12:28:00,23483.0,SELL,3,0.02h,Stop Loss,$-18.00,$-16.50,$616328.00,408,$-16.50
2025-07-30,12:31:00,23487.25,BUY,3,0.02h,Stop Loss,$64.50,$48.00,$616392.50,408,$48.00
2025-07-30,12:32:00,23483.25,SELL,3,0.02h,Stop Loss,$23.25,$71.25,$616415.75,408,$71.25
2025-07-30,12:39:00,23496.25,BUY,3,0.02h,Break Even,$0.75,$72.00,$616416.50,408,$72.00
2025-07-30,13:01:00,23485.5,SELL,3,0.02h,Break Even,$0.75,$72.75,$616417.25,408,$72.75
2025-07-30,13:20:00,23486.75,BUY,3,0.02h,Break Even,$0.75,$73.50,$616418.00,408,$73.50
2025-07-30,13:24:00,23483.5,SELL,3,0.02h,Stop Loss,$-18.00,$55.50,$616400.00,408,$55.50
2025-07-30,13:37:00,23496.0,BUY,3,0.02h,Stop Loss,$109.50,$165.00,$616509.50,408,$165.00
2025-07-30,13:53:00,23486.5,SELL,3,0.02h,Stop Loss,$34.50,$199.50,$616544.00,408,$199.50
2025-07-30,14:09:00,23495.25,BUY,3,0.02h,Stop Loss,$-18.00,$181.50,$616526.00,408,$181.50
2025-07-30,14:11:00,23477.5,SELL,3,0.02h,Stop Loss,$90.75,$272.25,$616616.75,408,$272.25
2025-07-30,14:19:00,23490.0,BUY,3,0.02h,Stop Loss,$117.00,$389.25,$616733.75,408,$389.25
2025-07-30,15:03:00,23517.25,SELL,3,0.02h,Stop Loss,$143.25,$532.50,$616877.00,408,$532.50
2025-07-30,15:42:00,23501.0,BUY,3,0.02h,Stop Loss,$-18.00,$514.50,$616859.00,408,$514.50
2025-07-30,16:37:00,23530.0,SELL,3,0.02h,Break Even,$0.75,$515.25,$616859.75,408,$515.25
2025-07-30,16:53:00,23535.75,BUY,3,0.02h,Stop Loss,$-18.00,$497.25,$616841.75,408,$497.25
2025-07-30,17:11:00,23528.0,SELL,3,0.02h,Stop Loss,$-18.00,$479.25,$616823.75,408,$479.25
2025-07-30,17:17:00,23535.25,BUY,3,0.02h,Stop Loss,$-18.00,$461.25,$616805.75,408,$461.25
2025-07-30,17:24:00,23526.0,SELL,3,0.02h,Stop Loss,$-18.00,$443.25,$616787.75,408,$443.25
2025-07-30,17:36:00,23533.75,BUY,3,0.02h,Stop Loss,$-18.00,$425.25,$616769.75,408,$425.25
2025-07-30,17:52:00,23529.5,SELL,3,0.02h,Break Even,$0.75,$426.00,$616770.50,408,$426.00
2025-07-30,17:57:00,23543.5,BUY,3,0.02h,Break Even,$0.75,$426.75,$616771.25,408,$426.75
2025-07-30,18:03:00,23522.25,SELL,3,0.02h,Break Even,$0.75,$427.50,$616772.00,408,$427.50
2025-07-30,18:08:00,23544.75,BUY,3,0.02h,Break Even,$0.75,$428.25,$616772.75,408,$428.25
2025-07-30,18:20:00,23537.0,SELL,3,0.02h,Break Even,$0.75,$429.00,$616773.50,408,$429.00
2025-07-30,18:24:00,23545.5,BUY,3,0.02h,Break Even,$0.75,$429.75,$616774.25,408,$429.75
2025-07-30,18:41:00,23530.25,SELL,3,0.02h,Stop Loss,$199.50,$629.25,$616973.75,408,$629.25
2025-07-30,19:47:00,23427.75,BUY,3,0.02h,Break Even,$0.75,$630.00,$616974.50,408,$630.00
,,,,,,,,,,,
2025-07-31,13:11:00,23795.0,SELL,3,0.02h,Stop Loss,$-18.00,$-18.00,$616956.50,409,$-18.00
2025-07-31,13:57:00,23692.0,BUY,3,0.02h,Stop Loss,$79.50,$61.50,$617036.00,409,$61.50
2025-07-31,14:13:00,23658.75,SELL,3,0.02h,Break Even,$0.75,$62.25,$617036.75,409,$62.25
2025-07-31,15:32:00,23547.75,BUY,3,0.02h,Stop Loss,$105.75,$168.00,$617142.50,409,$168.00
2025-07-31,16:39:00,23588.25,SELL,3,0.02h,Break Even,$0.75,$168.75,$617143.25,409,$168.75
2025-07-31,18:26:00,23390.0,BUY,3,0.02h,Stop Loss,$83.25,$252.00,$617226.50,409,$252.00
2025-07-31,18:58:00,23415.75,SELL,3,0.02h,Stop Loss,$38.25,$290.25,$617264.75,409,$290.25
2025-07-31,19:07:00,23441.0,BUY,3,0.02h,Stop Loss,$-18.00,$272.25,$617246.75,409,$272.25
2025-07-31,19:08:00,23429.75,SELL,3,0.02h,Stop Loss,$83.25,$355.50,$617330.00,409,$355.50
2025-07-31,19:44:00,23402.0,BUY,3,0.02h,Stop Loss,$83.25,$438.75,$617413.25,409,$438.75
2025-07-31,19:48:00,23386.25,SELL,3,0.02h,Stop Loss,$300.75,$739.50,$617714.00,409,$739.50
2025-07-31,20:32:00,23349.5,BUY,3,0.02h,Stop Loss,$75.75,$815.25,$617789.75,409,$815.25
2025-07-31,20:56:00,23334.75,SELL,3,0.02h,Stop Loss,$64.50,$879.75,$617854.25,409,$879.75
2025-07-31,22:09:00,23344.25,BUY,3,0.02h,Stop Loss,$-18.00,$861.75,$617836.25,409,$861.75
2025-07-31,22:11:00,23329.0,SELL,3,0.02h,Stop Loss,$68.25,$930.00,$617904.50,409,$930.00
,,,,,,,,,,,
2025-08-01,12:42:00,23159.75,BUY,3,0.02h,Stop Loss,$64.50,$64.50,$617969.00,410,$64.50
2025-08-01,12:51:00,23103.0,SELL,3,0.02h,Stop Loss,$132.00,$196.50,$618101.00,410,$196.50
2025-08-01,14:13:00,22919.0,BUY,3,0.02h,Stop Loss,$83.25,$279.75,$618184.25,410,$279.75
2025-08-01,14:50:00,22955.25,SELL,3,0.02h,Stop Loss,$154.50,$434.25,$618338.75,410,$434.25
2025-08-01,15:39:00,22940.0,BUY,3,0.02h,Stop Loss,$203.25,$637.50,$618542.00,410,$637.50
2025-08-01,16:31:00,23004.25,SELL,3,0.02h,Stop Loss,$60.75,$698.25,$618602.75,410,$698.25
2025-08-01,17:51:00,22871.5,BUY,3,0.02h,Break Even,$0.75,$699.00,$618603.50,410,$699.00
2025-08-01,17:56:00,22833.0,SELL,3,0.02h,Stop Loss,$42.00,$741.00,$618645.50,410,$741.00
2025-08-01,18:24:00,22848.0,BUY,3,0.02h,Stop Loss,$139.50,$880.50,$618785.00,410,$880.50
2025-08-01,18:53:00,22864.75,SELL,3,0.02h,Stop Loss,$120.75,$1001.25,$618905.75,410,$1001.25
2025-08-01,19:18:00,22879.25,BUY,3,0.02h,Stop Loss,$173.25,$1174.50,$619079.00,410,$1174.50
2025-08-01,19:23:00,22870.0,SELL,3,0.02h,Break Even,$0.75,$1175.25,$619079.75,410,$1175.25
2025-08-01,19:24:00,22894.0,BUY,3,0.02h,Stop Loss,$-18.00,$1157.25,$619061.75,410,$1157.25
2025-08-01,19:31:00,22874.5,SELL,3,0.02h,Stop Loss,$53.25,$1210.50,$619115.00,410,$1210.50
2025-08-01,19:34:00,22885.25,BUY,3,0.02h,Break Even,$0.75,$1211.25,$619115.75,410,$1211.25
2025-08-01,19:39:00,22871.5,SELL,3,0.02h,Stop Loss,$19.50,$1230.75,$619135.25,410,$1230.75
2025-08-01,19:42:00,22887.25,BUY,3,0.02h,Break Even,$0.75,$1231.50,$619136.00,410,$1231.50
2025-08-01,20:01:00,22883.75,SELL,3,0.02h,Stop Loss,$27.00,$1258.50,$619163.00,410,$1258.50
2025-08-01,20:17:00,22891.5,BUY,3,0.02h,Break Even,$0.75,$1259.25,$619163.75,410,$1259.25
2025-08-01,20:18:00,22884.5,SELL,3,0.02h,Stop Loss,$60.75,$1320.00,$619224.50,410,$1320.00
2025-08-01,20:23:00,22889.25,BUY,3,0.02h,Stop Loss,$-18.00,$1302.00,$619206.50,410,$1302.00
2025-08-01,20:25:00,22884.75,SELL,3,0.02h,Break Even,$0.75,$1302.75,$619207.25,410,$1302.75
,,,,,,,,,,,
2025-08-04,12:00:00,23043.75,BUY,3,0.02h,Stop Loss,$79.50,$79.50,$619286.75,411,$79.50
2025-08-04,14:32:00,23230.25,SELL,3,0.02h,Stop Loss,$-18.00,$61.50,$619268.75,411,$61.50
2025-08-04,14:36:00,23250.0,BUY,3,0.02h,Stop Loss,$12.00,$73.50,$619280.75,411,$73.50
2025-08-04,14:42:00,23225.75,SELL,3,0.02h,Stop Loss,$-18.00,$55.50,$619262.75,411,$55.50
2025-08-04,15:27:00,23219.0,BUY,3,0.02h,Stop Loss,$15.75,$71.25,$619278.50,411,$71.25
2025-08-04,15:43:00,23201.5,SELL,3,0.02h,Break Even,$0.75,$72.00,$619279.25,411,$72.00
2025-08-04,15:50:00,23220.0,BUY,3,0.02h,Stop Loss,$120.75,$192.75,$619400.00,411,$192.75
2025-08-04,16:41:00,23259.5,SELL,3,0.02h,Stop Loss,$-18.00,$174.75,$619382.00,411,$174.75
2025-08-04,16:48:00,23270.0,BUY,3,0.02h,Break Even,$0.75,$175.50,$619382.75,411,$175.50
2025-08-04,17:38:00,23273.5,SELL,3,0.02h,Break Even,$0.75,$176.25,$619383.50,411,$176.25
2025-08-04,18:01:00,23274.0,BUY,3,0.02h,Stop Loss,$23.25,$199.50,$619406.75,411,$199.50
2025-08-04,18:15:00,23263.5,SELL,3,0.02h,Stop Loss,$-18.00,$181.50,$619388.75,411,$181.50
2025-08-04,18:34:00,23272.25,BUY,3,0.02h,Stop Loss,$-18.00,$163.50,$619370.75,411,$163.50
2025-08-04,18:41:00,23262.75,SELL,3,0.02h,Break Even,$0.75,$164.25,$619371.50,411,$164.25
2025-08-04,19:02:00,23266.25,BUY,3,0.02h,Stop Loss,$-18.00,$146.25,$619353.50,411,$146.25
2025-08-04,19:04:00,23261.5,SELL,3,0.02h,Break Even,$0.75,$147.00,$619354.25,411,$147.00
2025-08-04,19:10:00,23264.75,BUY,3,0.02h,Break Even,$0.75,$147.75,$619355.00,411,$147.75
2025-08-04,19:30:00,23266.5,SELL,3,0.02h,Break Even,$0.75,$148.50,$619355.75,411,$148.50
2025-08-04,19:45:00,23268.75,BUY,3,0.02h,Break Even,$0.75,$149.25,$619356.50,411,$149.25
2025-08-04,22:03:00,23340.75,SELL,3,0.02h,Break Even,$0.75,$150.00,$619357.25,411,$150.00
2025-08-04,22:53:00,23328.75,BUY,3,0.02h,Stop Loss,$-18.00,$132.00,$619339.25,411,$132.00
,,,,,,,,,,,
2025-08-05,12:24:00,23364.25,SELL,3,0.02h,Stop Loss,$15.75,$15.75,$619355.00,412,$15.75
2025-08-05,12:44:00,23369.75,BUY,3,0.02h,Stop Loss,$38.25,$54.00,$619393.25,412,$54.00
2025-08-05,12:53:00,23361.0,SELL,3,0.02h,Break Even,$0.75,$54.75,$619394.00,412,$54.75
2025-08-05,13:20:00,23365.0,BUY,3,0.02h,Stop Loss,$-18.00,$36.75,$619376.00,412,$36.75
2025-08-05,13:22:00,23354.5,SELL,3,0.02h,Break Even,$0.75,$37.50,$619376.75,412,$37.50
2025-08-05,13:41:00,23356.0,BUY,3,0.02h,Stop Loss,$23.25,$60.75,$619400.00,412,$60.75
2025-08-05,14:02:00,23337.0,SELL,3,0.02h,Stop Loss,$30.75,$91.50,$619430.75,412,$91.50
2025-08-05,15:07:00,23200.5,BUY,3,0.02h,Stop Loss,$154.50,$246.00,$619585.25,412,$246.00
2025-08-05,15:12:00,23177.5,SELL,3,0.02h,Break Even,$0.75,$246.75,$619586.00,412,$246.75
2025-08-05,15:14:00,23206.5,BUY,3,0.02h,Stop Loss,$139.50,$386.25,$619725.50,412,$386.25
2025-08-05,15:22:00,23186.0,SELL,3,0.02h,Stop Loss,$34.50,$420.75,$619760.00,412,$420.75
2025-08-05,16:00:00,23156.25,BUY,3,0.02h,Stop Loss,$120.75,$541.50,$619880.75,412,$541.50
2025-08-05,16:41:00,23168.5,SELL,3,0.02h,Stop Loss,$64.50,$606.00,$619945.25,412,$606.00
2025-08-05,16:55:00,23189.5,BUY,3,0.02h,Stop Loss,$27.00,$633.00,$619972.25,412,$633.00
2025-08-05,17:06:00,23174.25,SELL,3,0.02h,Stop Loss,$-18.00,$615.00,$619954.25,412,$615.00
2025-08-05,17:07:00,23182.75,BUY,3,0.02h,Stop Loss,$49.50,$664.50,$620003.75,412,$664.50
2025-08-05,18:13:00,23228.5,SELL,3,0.02h,Stop Loss,$45.75,$710.25,$620049.50,412,$710.25
2025-08-05,19:13:00,23157.0,BUY,3,0.02h,Break Even,$0.75,$711.00,$620050.25,412,$711.00
2025-08-05,19:38:00,23153.75,SELL,3,0.02h,Stop Loss,$38.25,$749.25,$620088.50,412,$749.25
2025-08-05,20:12:00,23148.5,BUY,3,0.02h,Stop Loss,$-18.00,$731.25,$620070.50,412,$731.25
2025-08-05,20:24:00,23127.0,SELL,3,0.02h,Stop Loss,$274.50,$1005.75,$620345.00,412,$1005.75
2025-08-05,22:32:00,23076.0,BUY,3,0.02h,Break Even,$0.75,$1006.50,$620345.75,412,$1006.50
,,,,,,,,,,,
2025-08-06,13:24:00,23170.0,SELL,3,0.02h,Break Even,$0.75,$0.75,$620346.50,413,$0.75
2025-08-06,13:33:00,23211.5,BUY,3,0.02h,Stop Loss,$72.00,$72.75,$620418.50,413,$72.75
2025-08-06,13:40:00,23159.5,SELL,3,0.02h,Stop Loss,$109.50,$182.25,$620528.00,413,$182.25
2025-08-06,13:46:00,23194.0,BUY,3,0.02h,Stop Loss,$109.50,$291.75,$620637.50,413,$291.75
2025-08-06,14:17:00,23219.75,SELL,3,0.02h,Stop Loss,$173.25,$465.00,$620810.75,413,$465.00
2025-08-06,14:37:00,23246.0,BUY,3,0.02h,Break Even,$0.75,$465.75,$620811.50,413,$465.75
2025-08-06,16:28:00,23360.75,SELL,3,0.02h,Break Even,$0.75,$466.50,$620812.25,413,$466.50
2025-08-06,16:37:00,23389.25,BUY,3,0.02h,Stop Loss,$-18.00,$448.50,$620794.25,413,$448.50
2025-08-06,16:43:00,23362.0,SELL,3,0.02h,Stop Loss,$124.50,$573.00,$620918.75,413,$573.00
2025-08-06,16:52:00,23378.5,BUY,3,0.02h,Stop Loss,$15.75,$588.75,$620934.50,413,$588.75
2025-08-06,17:08:00,23365.75,SELL,3,0.02h,Stop Loss,$-18.00,$570.75,$620916.50,413,$570.75
2025-08-06,17:12:00,23375.0,BUY,3,0.02h,Stop Loss,$-18.00,$552.75,$620898.50,413,$552.75
2025-08-06,17:13:00,23366.5,SELL,3,0.02h,Stop Loss,$19.50,$572.25,$620918.00,413,$572.25
2025-08-06,17:23:00,23373.0,BUY,3,0.02h,Stop Loss,$12.00,$584.25,$620930.00,413,$584.25
2025-08-06,17:51:00,23371.0,SELL,3,0.02h,Stop Loss,$53.25,$637.50,$620983.25,413,$637.50
2025-08-06,18:03:00,23395.25,BUY,3,0.02h,Stop Loss,$-18.00,$619.50,$620965.25,413,$619.50
2025-08-06,18:59:00,23413.0,SELL,3,0.02h,Break Even,$0.75,$620.25,$620966.00,413,$620.25
2025-08-06,19:05:00,23429.0,BUY,3,0.02h,Stop Loss,$-18.00,$602.25,$620948.00,413,$602.25
2025-08-06,19:07:00,23420.75,SELL,3,0.02h,Break Even,$0.75,$603.00,$620948.75,413,$603.00
2025-08-06,19:19:00,23427.25,BUY,3,0.02h,Stop Loss,$38.25,$641.25,$620987.00,413,$641.25
2025-08-06,19:43:00,23424.5,SELL,3,0.02h,Break Even,$0.75,$642.00,$620987.75,413,$642.00
2025-08-06,20:28:00,23415.75,BUY,3,0.02h,Break Even,$0.75,$642.75,$620988.50,413,$642.75
2025-08-06,20:37:00,23408.75,SELL,3,0.02h,Break Even,$0.75,$643.50,$620989.25,413,$643.50
2025-08-06,20:50:00,23412.75,BUY,3,0.02h,Stop Loss,$-18.00,$625.50,$620971.25,413,$625.50
2025-08-06,20:51:00,23407.0,SELL,3,0.02h,Break Even,$0.75,$626.25,$620972.00,413,$626.25
2025-08-06,21:00:00,23413.0,BUY,3,1.02h,Stop Loss,$312.00,$938.25,$621284.00,413,$938.25
2025-08-06,22:01:00,23403.25,SELL,3,0.02h,Stop Loss,$150.75,$1089.00,$621434.75,413,$1089.00
2025-08-06,22:12:00,23418.5,BUY,3,0.02h,Break Even,$0.75,$1089.75,$621435.50,413,$1089.75
,,,,,,,,,,,
2025-08-07,13:01:00,23598.75,SELL,3,0.02h,Stop Loss,$-18.00,$-18.00,$621417.50,414,$-18.00
2025-08-07,13:03:00,23604.25,BUY,3,0.02h,Stop Loss,$45.75,$27.75,$621463.25,414,$27.75
2025-08-07,13:27:00,23604.0,SELL,3,0.02h,Stop Loss,$42.00,$69.75,$621505.25,414,$69.75
2025-08-07,13:34:00,23624.75,BUY,3,0.02h,Stop Loss,$49.50,$119.25,$621554.75,414,$119.25
2025-08-07,13:46:00,23580.75,SELL,3,0.02h,Stop Loss,$120.75,$240.00,$621675.50,414,$240.00
2025-08-07,13:54:00,23615.5,BUY,3,0.02h,Stop Loss,$72.00,$312.00,$621747.50,414,$312.00
2025-08-07,14:11:00,23592.75,SELL,3,0.02h,Break Even,$0.75,$312.75,$621748.25,414,$312.75
2025-08-07,14:46:00,23589.75,BUY,3,0.02h,Stop Loss,$-18.00,$294.75,$621730.25,414,$294.75
2025-08-07,14:47:00,23560.0,SELL,3,0.02h,Stop Loss,$68.25,$363.00,$621798.50,414,$363.00
2025-08-07,15:21:00,23555.25,BUY,3,0.02h,Break Even,$0.75,$363.75,$621799.25,414,$363.75
2025-08-07,15:27:00,23512.75,SELL,3,0.02h,Stop Loss,$128.25,$492.00,$621927.50,414,$492.00
2025-08-07,15:57:00,23517.5,BUY,3,0.02h,Stop Loss,$27.00,$519.00,$621954.50,414,$519.00
2025-08-07,16:00:00,23497.75,SELL,3,0.02h,Break Even,$0.75,$519.75,$621955.25,414,$519.75
2025-08-07,16:17:00,23513.25,BUY,3,0.02h,Stop Loss,$-18.00,$501.75,$621937.25,414,$501.75
2025-08-07,16:37:00,23495.5,SELL,3,0.02h,Stop Loss,$225.75,$727.50,$622163.00,414,$727.50
2025-08-07,16:56:00,23477.5,BUY,3,0.02h,Stop Loss,$57.00,$784.50,$622220.00,414,$784.50
2025-08-07,17:05:00,23446.5,SELL,3,0.02h,Stop Loss,$87.00,$871.50,$622307.00,414,$871.50
2025-08-07,17:49:00,23422.0,BUY,3,0.02h,Break Even,$0.75,$872.25,$622307.75,414,$872.25
2025-08-07,17:51:00,23404.75,SELL,3,0.02h,Break Even,$0.75,$873.00,$622308.50,414,$873.00
2025-08-07,17:54:00,23427.25,BUY,3,0.02h,Stop Loss,$-18.00,$855.00,$622290.50,414,$855.00
2025-08-07,18:03:00,23405.25,SELL,3,0.02h,Stop Loss,$-18.00,$837.00,$622272.50,414,$837.00
2025-08-07,18:04:00,23425.0,BUY,3,0.02h,Stop Loss,$12.00,$849.00,$622284.50,414,$849.00
2025-08-07,18:05:00,23413.25,SELL,3,0.02h,Stop Loss,$23.25,$872.25,$622307.75,414,$872.25
2025-08-07,18:37:00,23367.25,BUY,3,0.02h,Stop Loss,$72.00,$944.25,$622379.75,414,$944.25
2025-08-07,18:45:00,23351.0,SELL,3,0.02h,Break Even,$0.75,$945.00,$622380.50,414,$945.00
2025-08-07,18:48:00,23378.0,BUY,3,0.02h,Stop Loss,$-18.00,$927.00,$622362.50,414,$927.00
2025-08-07,19:21:00,23395.25,SELL,3,0.02h,Break Even,$0.75,$927.75,$622363.25,414,$927.75
2025-08-07,19:22:00,23397.5,BUY,3,0.02h,Stop Loss,$19.50,$947.25,$622382.75,414,$947.25
2025-08-07,19:23:00,23394.25,SELL,3,0.02h,Stop Loss,$45.75,$993.00,$622428.50,414,$993.00
2025-08-07,19:31:00,23409.5,BUY,3,0.02h,Stop Loss,$173.25,$1166.25,$622601.75,414,$1166.25
2025-08-07,20:33:00,23505.0,SELL,3,0.02h,Stop Loss,$-18.00,$1148.25,$622583.75,414,$1148.25
2025-08-07,20:52:00,23512.0,BUY,3,0.02h,Stop Loss,$-18.00,$1130.25,$622565.75,414,$1130.25
2025-08-07,22:42:00,23546.5,SELL,3,0.02h,Stop Loss,$-18.00,$1112.25,$622547.75,414,$1112.25
2025-08-07,22:52:00,23555.5,BUY,3,0.02h,Break Even,$0.75,$1113.00,$622548.50,414,$1113.00
,,,,,,,,,,,
2025-08-08,12:11:00,23552.25,SELL,3,0.02h,Break Even,$0.75,$0.75,$622549.25,415,$0.75
2025-08-08,12:48:00,23537.75,BUY,3,0.02h,Break Even,$0.75,$1.50,$622550.00,415,$1.50
2025-08-08,12:58:00,23531.25,SELL,3,0.02h,Stop Loss,$-18.00,$-16.50,$622532.00,415,$-16.50
2025-08-08,13:01:00,23542.25,BUY,3,0.02h,Stop Loss,$30.75,$14.25,$622562.75,415,$14.25
2025-08-08,13:07:00,23530.25,SELL,3,0.02h,Break Even,$0.75,$15.00,$622563.50,415,$15.00
2025-08-08,13:25:00,23534.0,BUY,3,0.02h,Stop Loss,$49.50,$64.50,$622613.00,415,$64.50
2025-08-08,14:52:00,23670.75,SELL,3,0.02h,Stop Loss,$42.00,$106.50,$622655.00,415,$106.50
2025-08-08,15:10:00,23673.25,BUY,3,0.02h,Break Even,$0.75,$107.25,$622655.75,415,$107.25
2025-08-08,15:12:00,23656.0,SELL,3,0.02h,Stop Loss,$-18.00,$89.25,$622637.75,415,$89.25
2025-08-08,15:15:00,23679.5,BUY,3,0.02h,Break Even,$0.75,$90.00,$622638.50,415,$90.00
2025-08-08,15:30:00,23666.0,SELL,3,0.02h,Stop Loss,$210.75,$300.75,$622849.25,415,$300.75
2025-08-08,15:52:00,23651.5,BUY,3,0.02h,Stop Loss,$53.25,$354.00,$622902.50,415,$354.00
2025-08-08,16:38:00,23685.75,SELL,3,0.02h,Stop Loss,$-18.00,$336.00,$622884.50,415,$336.00
2025-08-08,16:39:00,23692.25,BUY,3,0.02h,Break Even,$0.75,$336.75,$622885.25,415,$336.75
2025-08-08,16:50:00,23687.5,SELL,3,0.02h,Stop Loss,$19.50,$356.25,$622904.75,415,$356.25
2025-08-08,17:25:00,23677.0,BUY,3,0.02h,Stop Loss,$-18.00,$338.25,$622886.75,415,$338.25
2025-08-08,17:26:00,23665.25,SELL,3,0.02h,Stop Loss,$64.50,$402.75,$622951.25,415,$402.75
2025-08-08,17:34:00,23676.75,BUY,3,0.02h,Stop Loss,$-18.00,$384.75,$622933.25,415,$384.75
2025-08-08,18:26:00,23696.25,SELL,3,0.02h,Stop Loss,$53.25,$438.00,$622986.50,415,$438.00
2025-08-08,18:33:00,23710.0,BUY,3,0.02h,Stop Loss,$12.00,$450.00,$622998.50,415,$450.00
2025-08-08,18:42:00,23707.25,SELL,3,0.02h,Break Even,$0.75,$450.75,$622999.25,415,$450.75
2025-08-08,18:49:00,23711.75,BUY,3,0.02h,Break Even,$0.75,$451.50,$623000.00,415,$451.50
2025-08-08,19:03:00,23704.5,SELL,3,0.02h,Stop Loss,$-18.00,$433.50,$622982.00,415,$433.50
2025-08-08,19:19:00,23711.5,BUY,3,0.02h,Stop Loss,$49.50,$483.00,$623031.50,415,$483.00
2025-08-08,19:28:00,23707.75,SELL,3,0.02h,Break Even,$0.75,$483.75,$623032.25,415,$483.75
2025-08-08,19:55:00,23712.0,BUY,3,0.02h,Stop Loss,$-18.00,$465.75,$623014.25,415,$465.75
2025-08-08,20:49:00,23748.5,SELL,3,0.02h,Break Even,$0.75,$466.50,$623015.00,415,$466.50
2025-08-08,20:56:00,23753.25,BUY,3,0.02h,Stop Loss,$38.25,$504.75,$623053.25,415,$504.75
,,,,,,,,,,,
2025-08-11,12:01:00,23745.5,SELL,3,0.02h,Break Even,$0.75,$0.75,$623054.00,416,$0.75
2025-08-11,13:16:00,23723.5,BUY,3,0.02h,Break Even,$0.75,$1.50,$623054.75,416,$1.50
2025-08-11,13:26:00,23714.0,SELL,3,0.02h,Break Even,$0.75,$2.25,$623055.50,416,$2.25
2025-08-11,13:43:00,23727.75,BUY,3,0.02h,Stop Loss,$105.75,$108.00,$623161.25,416,$108.00
2025-08-11,14:37:00,23748.75,SELL,3,0.02h,Break Even,$0.75,$108.75,$623162.00,416,$108.75
2025-08-11,14:38:00,23751.5,BUY,3,0.02h,Stop Loss,$79.50,$188.25,$623241.50,416,$188.25
2025-08-11,14:41:00,23743.75,SELL,3,0.02h,Break Even,$0.75,$189.00,$623242.25,416,$189.00
2025-08-11,14:42:00,23755.5,BUY,3,0.02h,Stop Loss,$-18.00,$171.00,$623224.25,416,$171.00
2025-08-11,14:43:00,23747.5,SELL,3,0.02h,Stop Loss,$-18.00,$153.00,$623206.25,416,$153.00
2025-08-11,14:46:00,23755.5,BUY,3,0.02h,Break Even,$0.75,$153.75,$623207.00,416,$153.75
2025-08-11,14:47:00,23742.25,SELL,3,0.02h,Stop Loss,$139.50,$293.25,$623346.50,416,$293.25
2025-08-11,15:15:00,23747.25,BUY,3,0.02h,Break Even,$0.75,$294.00,$623347.25,416,$294.00
2025-08-11,15:28:00,23736.5,SELL,3,0.02h,Break Even,$0.75,$294.75,$623348.00,416,$294.75
2025-08-11,15:35:00,23742.5,BUY,3,0.02h,Stop Loss,$-18.00,$276.75,$623330.00,416,$276.75
2025-08-11,15:38:00,23733.75,SELL,3,0.02h,Stop Loss,$102.00,$378.75,$623432.00,416,$378.75
2025-08-11,15:50:00,23739.75,BUY,3,0.02h,Stop Loss,$87.00,$465.75,$623519.00,416,$465.75
2025-08-11,16:37:00,23771.25,SELL,3,0.02h,Break Even,$0.75,$466.50,$623519.75,416,$466.50
2025-08-11,18:33:00,23695.5,BUY,3,0.02h,Break Even,$0.75,$467.25,$623520.50,416,$467.25
2025-08-11,18:44:00,23680.5,SELL,3,0.02h,Stop Loss,$312.00,$779.25,$623832.50,416,$779.25
2025-08-11,18:59:00,23691.75,BUY,3,0.02h,Stop Loss,$-18.00,$761.25,$623814.50,416,$761.25
2025-08-11,19:04:00,23678.5,SELL,3,0.02h,Stop Loss,$-18.00,$743.25,$623796.50,416,$743.25
2025-08-11,20:06:00,23639.5,BUY,3,0.02h,Stop Loss,$19.50,$762.75,$623816.00,416,$762.75
2025-08-11,20:16:00,23628.5,SELL,3,0.02h,Stop Loss,$34.50,$797.25,$623850.50,416,$797.25
2025-08-11,20:43:00,23626.5,BUY,3,0.02h,Stop Loss,$-18.00,$779.25,$623832.50,416,$779.25
2025-08-11,20:58:00,23624.25,SELL,3,0.02h,Stop Loss,$-18.00,$761.25,$623814.50,416,$761.25
2025-08-11,21:00:00,23630.0,BUY,3,1.02h,Stop Loss,$154.50,$915.75,$623969.00,416,$915.75
2025-08-11,22:19:00,23626.0,SELL,3,0.02h,Stop Loss,$64.50,$980.25,$624033.50,416,$980.25
2025-08-11,22:45:00,23625.5,BUY,3,0.02h,Stop Loss,$-18.00,$962.25,$624015.50,416,$962.25
2025-08-11,22:46:00,23618.25,SELL,3,0.02h,Stop Loss,$-18.00,$944.25,$623997.50,416,$944.25
2025-08-11,22:50:00,23626.25,BUY,3,0.02h,Stop Loss,$34.50,$978.75,$624032.00,416,$978.75
,,,,,,,,,,,
2025-08-12,13:03:00,23755.5,SELL,3,0.02h,Stop Loss,$102.00,$102.00,$624134.00,417,$102.00
2025-08-12,13:35:00,23780.0,BUY,3,0.02h,Stop Loss,$132.00,$234.00,$624266.00,417,$234.00
2025-08-12,13:49:00,23705.25,SELL,3,0.02h,Stop Loss,$293.25,$527.25,$624559.25,417,$527.25
2025-08-12,14:15:00,23721.75,BUY,3,0.02h,Stop Loss,$278.25,$805.50,$624837.50,417,$805.50
2025-08-12,16:08:00,23849.75,SELL,3,0.02h,Stop Loss,$-18.00,$787.50,$624819.50,417,$787.50
2025-08-12,16:15:00,23857.25,BUY,3,0.02h,Stop Loss,$64.50,$852.00,$624884.00,417,$852.00
2025-08-12,17:28:00,23892.0,SELL,3,0.02h,Stop Loss,$-18.00,$834.00,$624866.00,417,$834.00
2025-08-12,17:35:00,23906.25,BUY,3,0.02h,Stop Loss,$-18.00,$816.00,$624848.00,417,$816.00
2025-08-12,18:32:00,23911.75,SELL,3,0.02h,Stop Loss,$-18.00,$798.00,$624830.00,417,$798.00
2025-08-12,19:08:00,23916.0,BUY,3,0.02h,Stop Loss,$-18.00,$780.00,$624812.00,417,$780.00
2025-08-12,19:12:00,23903.0,SELL,3,0.02h,Stop Loss,$-18.00,$762.00,$624794.00,417,$762.00
2025-08-12,19:19:00,23916.0,BUY,3,0.02h,Break Even,$0.75,$762.75,$624794.75,417,$762.75
2025-08-12,19:47:00,23921.5,SELL,3,0.02h,Stop Loss,$-18.00,$744.75,$624776.75,417,$744.75
2025-08-12,19:51:00,23932.75,BUY,3,0.02h,Stop Loss,$38.25,$783.00,$624815.00,417,$783.00
2025-08-12,20:13:00,23929.25,SELL,3,0.02h,Stop Loss,$-18.00,$765.00,$624797.00,417,$765.00
2025-08-12,20:16:00,23933.75,BUY,3,0.02h,Stop Loss,$-18.00,$747.00,$624779.00,417,$747.00
2025-08-12,20:43:00,23934.75,SELL,3,0.02h,Stop Loss,$-18.00,$729.00,$624761.00,417,$729.00
2025-08-12,20:48:00,23938.0,BUY,3,0.02h,Break Even,$0.75,$729.75,$624761.75,417,$729.75
2025-08-12,22:03:00,23932.25,SELL,3,0.02h,Stop Loss,$-18.00,$711.75,$624743.75,417,$711.75
2025-08-12,22:46:00,23931.0,BUY,3,0.02h,Stop Loss,$-18.00,$693.75,$624725.75,417,$693.75
2025-08-12,22:47:00,23928.5,SELL,3,0.02h,Stop Loss,$-18.00,$675.75,$624707.75,417,$675.75
2025-08-12,22:48:00,23930.5,BUY,3,0.02h,Stop Loss,$-18.00,$657.75,$624689.75,417,$657.75
2025-08-12,22:49:00,23927.75,SELL,3,0.03h,Stop Loss,$-18.00,$639.75,$624671.75,417,$639.75
2025-08-12,22:58:00,23930.0,BUY,3,0.02h,Stop Loss,$-18.00,$621.75,$624653.75,417,$621.75
,,,,,,,,,,,
2025-08-13,13:46:00,24032.0,SELL,3,0.02h,Stop Loss,$12.00,$12.00,$624665.75,418,$12.00
2025-08-13,13:51:00,24057.5,BUY,3,0.02h,Break Even,$0.75,$12.75,$624666.50,418,$12.75
2025-08-13,13:56:00,24015.75,SELL,3,0.02h,Stop Loss,$113.25,$126.00,$624779.75,418,$126.00
2025-08-13,15:24:00,23945.0,BUY,3,0.02h,Stop Loss,$-18.00,$108.00,$624761.75,418,$108.00
2025-08-13,15:40:00,23930.5,SELL,3,0.02h,Stop Loss,$-18.00,$90.00,$624743.75,418,$90.00
2025-08-13,15:41:00,23939.5,BUY,3,0.02h,Stop Loss,$75.75,$165.75,$624819.50,418,$165.75
2025-08-13,15:54:00,23923.25,SELL,3,0.02h,Stop Loss,$34.50,$200.25,$624854.00,418,$200.25
2025-08-13,16:16:00,23936.75,BUY,3,0.02h,Break Even,$0.75,$201.00,$624854.75,418,$201.00
2025-08-13,16:19:00,23927.5,SELL,3,0.02h,Stop Loss,$53.25,$254.25,$624908.00,418,$254.25
2025-08-13,17:04:00,23920.0,BUY,3,0.02h,Break Even,$0.75,$255.00,$624908.75,418,$255.00
2025-08-13,17:10:00,23904.0,SELL,3,0.02h,Stop Loss,$12.00,$267.00,$624920.75,418,$267.00
2025-08-13,17:19:00,23915.25,BUY,3,0.02h,Stop Loss,$68.25,$335.25,$624989.00,418,$335.25
2025-08-13,17:35:00,23903.75,SELL,3,0.02h,Stop Loss,$-18.00,$317.25,$624971.00,418,$317.25
2025-08-13,17:54:00,23923.75,BUY,3,0.02h,Stop Loss,$-18.00,$299.25,$624953.00,418,$299.25
2025-08-13,18:27:00,23932.0,SELL,3,0.02h,Stop Loss,$27.00,$326.25,$624980.00,418,$326.25
2025-08-13,18:50:00,23928.25,BUY,3,0.02h,Break Even,$0.75,$327.00,$624980.75,418,$327.00
2025-08-13,19:08:00,23926.25,SELL,3,0.02h,Break Even,$0.75,$327.75,$624981.50,418,$327.75
2025-08-13,19:14:00,23934.0,BUY,3,0.02h,Stop Loss,$27.00,$354.75,$625008.50,418,$354.75
2025-08-13,19:31:00,23932.0,SELL,3,0.02h,Break Even,$0.75,$355.50,$625009.25,418,$355.50
2025-08-13,19:52:00,23936.5,BUY,3,0.02h,Stop Loss,$109.50,$465.00,$625118.75,418,$465.00
2025-08-13,20:10:00,23931.5,SELL,3,0.02h,Stop Loss,$-18.00,$447.00,$625100.75,418,$447.00
2025-08-13,20:51:00,23929.5,BUY,3,0.02h,Stop Loss,$-18.00,$429.00,$625082.75,418,$429.00
2025-08-13,22:02:00,23923.5,SELL,3,0.02h,Break Even,$0.75,$429.75,$625083.50,418,$429.75
2025-08-13,22:22:00,23926.25,BUY,3,0.02h,Stop Loss,$-18.00,$411.75,$625065.50,418,$411.75
,,,,,,,,,,,
2025-08-14,12:27:00,23946.5,SELL,3,0.02h,Break Even,$0.75,$0.75,$625066.25,419,$0.75
2025-08-14,13:14:00,23850.0,BUY,3,0.02h,Stop Loss,$-18.00,$-17.25,$625048.25,419,$-17.25
2025-08-14,13:20:00,23828.75,SELL,3,0.02h,Stop Loss,$19.50,$2.25,$625067.75,419,$2.25
2025-08-14,13:29:00,23853.25,BUY,3,0.02h,Stop Loss,$68.25,$70.50,$625136.00,419,$70.50
2025-08-14,14:12:00,23914.5,SELL,3,0.02h,Stop Loss,$72.00,$142.50,$625208.00,419,$142.50
2025-08-14,14:18:00,23933.75,BUY,3,0.02h,Stop Loss,$154.50,$297.00,$625362.50,419,$297.00
2025-08-14,14:58:00,23948.0,SELL,3,0.02h,Stop Loss,$60.75,$357.75,$625423.25,419,$357.75
2025-08-14,15:49:00,23919.0,BUY,3,0.02h,Stop Loss,$57.00,$414.75,$625480.25,419,$414.75
2025-08-14,16:07:00,23900.0,SELL,3,0.02h,Break Even,$0.75,$415.50,$625481.00,419,$415.50
2025-08-14,16:26:00,23903.75,BUY,3,0.02h,Stop Loss,$-18.00,$397.50,$625463.00,419,$397.50
2025-08-14,16:28:00,23887.25,SELL,3,0.02h,Stop Loss,$75.75,$473.25,$625538.75,419,$473.25
2025-08-14,16:34:00,23898.5,BUY,3,0.02h,Stop Loss,$188.25,$661.50,$625727.00,419,$661.50
2025-08-14,17:40:00,23958.0,SELL,3,0.02h,Stop Loss,$233.25,$894.75,$625960.25,419,$894.75
2025-08-14,18:00:00,23962.5,BUY,3,0.02h,Stop Loss,$-18.00,$876.75,$625942.25,419,$876.75
2025-08-14,18:02:00,23951.0,SELL,3,0.02h,Stop Loss,$98.25,$975.00,$626040.50,419,$975.00
2025-08-14,18:45:00,23917.5,BUY,3,0.02h,Stop Loss,$-18.00,$957.00,$626022.50,419,$957.00
2025-08-14,19:31:00,23922.75,SELL,3,0.02h,Stop Loss,$-18.00,$939.00,$626004.50,419,$939.00
2025-08-14,19:38:00,23936.75,BUY,3,0.02h,Stop Loss,$45.75,$984.75,$626050.25,419,$984.75
2025-08-14,20:00:00,23921.25,SELL,3,0.02h,Stop Loss,$184.50,$1169.25,$626234.75,419,$1169.25
2025-08-14,20:38:00,23892.5,BUY,3,0.02h,Break Even,$0.75,$1170.00,$626235.50,419,$1170.00
2025-08-14,20:43:00,23884.25,SELL,3,0.02h,Break Even,$0.75,$1170.75,$626236.25,419,$1170.75
2025-08-14,20:48:00,23889.75,BUY,3,0.02h,Stop Loss,$-18.00,$1152.75,$626218.25,419,$1152.75
2025-08-14,20:50:00,23885.0,SELL,3,0.02h,Stop Loss,$-18.00,$1134.75,$626200.25,419,$1134.75
2025-08-14,20:51:00,23887.5,BUY,3,0.02h,Break Even,$0.75,$1135.50,$626201.00,419,$1135.50
2025-08-14,20:53:00,23885.25,SELL,3,0.02h,Stop Loss,$-18.00,$1117.50,$626183.00,419,$1117.50
2025-08-14,21:00:00,23891.0,BUY,3,1.02h,Stop Loss,$-18.00,$1099.50,$626165.00,419,$1099.50
2025-08-14,22:01:00,23882.5,SELL,3,0.02h,Stop Loss,$90.75,$1190.25,$626255.75,419,$1190.25
2025-08-14,22:07:00,23891.25,BUY,3,0.02h,Break Even,$0.75,$1191.00,$626256.50,419,$1191.00
2025-08-14,22:20:00,23883.25,SELL,3,0.02h,Stop Loss,$-18.00,$1173.00,$626238.50,419,$1173.00
2025-08-14,22:46:00,23891.5,BUY,3,0.02h,Stop Loss,$-18.00,$1155.00,$626220.50,419,$1155.00
,,,,,,,,,,,
2025-08-15,12:25:00,23893.25,SELL,3,0.02h,Stop Loss,$19.50,$19.50,$626240.00,420,$19.50
2025-08-15,12:33:00,23908.25,BUY,3,0.02h,Stop Loss,$-18.00,$1.50,$626222.00,420,$1.50
2025-08-15,12:34:00,23902.0,SELL,3,0.02h,Stop Loss,$-18.00,$-16.50,$626204.00,420,$-16.50
2025-08-15,12:35:00,23906.5,BUY,3,0.02h,Stop Loss,$-18.00,$-34.50,$626186.00,420,$-34.50
2025-08-15,12:39:00,23894.5,SELL,3,0.02h,Break Even,$0.75,$-33.75,$626186.75,420,$-33.75
2025-08-15,12:47:00,23907.25,BUY,3,0.02h,Stop Loss,$19.50,$-14.25,$626206.25,420,$-14.25
2025-08-15,13:01:00,23901.75,SELL,3,0.02h,Stop Loss,$-18.00,$-32.25,$626188.25,420,$-32.25
2025-08-15,13:20:00,23907.75,BUY,3,0.02h,Break Even,$0.75,$-31.50,$626189.00,420,$-31.50
2025-08-15,13:26:00,23888.5,SELL,3,0.02h,Stop Loss,$-18.00,$-49.50,$626171.00,420,$-49.50
2025-08-15,13:29:00,23912.25,BUY,3,0.02h,Stop Loss,$102.00,$52.50,$626273.00,420,$52.50
2025-08-15,13:31:00,23861.25,SELL,3,0.02h,Stop Loss,$120.75,$173.25,$626393.75,420,$173.25
2025-08-15,14:05:00,23853.75,BUY,3,0.02h,Stop Loss,$87.00,$260.25,$626480.75,420,$260.25
2025-08-15,14:34:00,23837.75,SELL,3,0.02h,Break Even,$0.75,$261.00,$626481.50,420,$261.00
2025-08-15,15:17:00,23815.75,BUY,3,0.02h,Stop Loss,$30.75,$291.75,$626512.25,420,$291.75
2025-08-15,15:27:00,23806.25,SELL,3,0.02h,Break Even,$0.75,$292.50,$626513.00,420,$292.50
2025-08-15,15:54:00,23812.25,BUY,3,0.02h,Stop Loss,$19.50,$312.00,$626532.50,420,$312.00
2025-08-15,16:03:00,23773.0,SELL,3,0.02h,Stop Loss,$38.25,$350.25,$626570.75,420,$350.25
2025-08-15,16:09:00,23792.75,BUY,3,0.02h,Stop Loss,$15.75,$366.00,$626586.50,420,$366.00
2025-08-15,16:19:00,23778.5,SELL,3,0.02h,Stop Loss,$-18.00,$348.00,$626568.50,420,$348.00
2025-08-15,16:41:00,23790.75,BUY,3,0.02h,Break Even,$0.75,$348.75,$626569.25,420,$348.75
2025-08-15,17:13:00,23802.75,SELL,3,0.02h,Break Even,$0.75,$349.50,$626570.00,420,$349.50
2025-08-15,17:31:00,23815.5,BUY,3,0.02h,Stop Loss,$98.25,$447.75,$626668.25,420,$447.75
2025-08-15,17:48:00,23805.0,SELL,3,0.02h,Stop Loss,$-18.00,$429.75,$626650.25,420,$429.75
2025-08-15,17:56:00,23827.25,BUY,3,0.02h,Stop Loss,$68.25,$498.00,$626718.50,420,$498.00
2025-08-15,18:16:00,23811.25,SELL,3,0.02h,Break Even,$0.75,$498.75,$626719.25,420,$498.75
2025-08-15,18:31:00,23823.75,BUY,3,0.02h,Stop Loss,$12.00,$510.75,$626731.25,420,$510.75
2025-08-15,18:37:00,23810.5,SELL,3,0.02h,Stop Loss,$-18.00,$492.75,$626713.25,420,$492.75
2025-08-15,18:56:00,23819.25,BUY,3,0.02h,Break Even,$0.75,$493.50,$626714.00,420,$493.50
2025-08-15,18:59:00,23810.5,SELL,3,0.02h,Stop Loss,$23.25,$516.75,$626737.25,420,$516.75
2025-08-15,19:15:00,23807.75,BUY,3,0.02h,Stop Loss,$27.00,$543.75,$626764.25,420,$543.75
2025-08-15,19:19:00,23793.5,SELL,3,0.02h,Stop Loss,$-18.00,$525.75,$626746.25,420,$525.75
2025-08-15,19:23:00,23809.25,BUY,3,0.02h,Stop Loss,$27.00,$552.75,$626773.25,420,$552.75
2025-08-15,19:53:00,23805.25,SELL,3,0.02h,Break Even,$0.75,$553.50,$626774.00,420,$553.50
2025-08-15,20:15:00,23809.0,BUY,3,0.02h,Break Even,$0.75,$554.25,$626774.75,420,$554.25
2025-08-15,20:25:00,23796.5,SELL,3,0.02h,Stop Loss,$19.50,$573.75,$626794.25,420,$573.75
2025-08-15,20:55:00,23795.25,BUY,3,0.02h,Break Even,$0.75,$574.50,$626795.00,420,$574.50
,,,,,,,,,,,
2025-08-18,12:00:00,23770.75,SELL,3,0.02h,Stop Loss,$23.25,$23.25,$626818.25,421,$23.25
2025-08-18,12:30:00,23770.75,BUY,3,0.02h,Stop Loss,$-18.00,$5.25,$626800.25,421,$5.25
2025-08-18,12:32:00,23758.75,SELL,3,0.02h,Stop Loss,$-18.00,$-12.75,$626782.25,421,$-12.75
2025-08-18,12:45:00,23765.75,BUY,3,0.02h,Stop Loss,$23.25,$10.50,$626805.50,421,$10.50
2025-08-18,13:13:00,23758.0,SELL,3,0.02h,Stop Loss,$-18.00,$-7.50,$626787.50,421,$-7.50
2025-08-18,13:31:00,23801.75,BUY,3,0.02h,Stop Loss,$38.25,$30.75,$626825.75,421,$30.75
2025-08-18,13:45:00,23776.75,SELL,3,0.02h,Stop Loss,$23.25,$54.00,$626849.00,421,$54.00
2025-08-18,13:46:00,23790.75,BUY,3,0.02h,Break Even,$0.75,$54.75,$626849.75,421,$54.75
2025-08-18,13:52:00,23752.0,SELL,3,0.02h,Stop Loss,$53.25,$108.00,$626903.00,421,$108.00
2025-08-18,14:06:00,23780.0,BUY,3,0.02h,Stop Loss,$45.75,$153.75,$626948.75,421,$153.75
2025-08-18,14:16:00,23766.5,SELL,3,0.02h,Break Even,$0.75,$154.50,$626949.50,421,$154.50
2025-08-18,14:17:00,23778.25,BUY,3,0.02h,Stop Loss,$15.75,$170.25,$626965.25,421,$170.25
2025-08-18,14:35:00,23778.75,SELL,3,0.02h,Stop Loss,$27.00,$197.25,$626992.25,421,$197.25
2025-08-18,14:56:00,23775.5,BUY,3,0.02h,Stop Loss,$-18.00,$179.25,$626974.25,421,$179.25
2025-08-18,15:14:00,23764.25,SELL,3,0.02h,Stop Loss,$45.75,$225.00,$627020.00,421,$225.00
2025-08-18,15:48:00,23753.5,BUY,3,0.02h,Stop Loss,$42.00,$267.00,$627062.00,421,$267.00
2025-08-18,15:56:00,23741.25,SELL,3,0.02h,Break Even,$0.75,$267.75,$627062.75,421,$267.75
2025-08-18,16:02:00,23754.5,BUY,3,0.02h,Break Even,$0.75,$268.50,$627063.50,421,$268.50
2025-08-18,16:37:00,23748.25,SELL,3,0.02h,Stop Loss,$147.00,$415.50,$627210.50,421,$415.50
2025-08-18,17:05:00,23752.0,BUY,3,0.02h,Stop Loss,$-18.00,$397.50,$627192.50,421,$397.50
2025-08-18,17:42:00,23755.25,SELL,3,0.02h,Stop Loss,$23.25,$420.75,$627215.75,421,$420.75
2025-08-18,18:08:00,23767.0,BUY,3,0.02h,Stop Loss,$-18.00,$402.75,$627197.75,421,$402.75
2025-08-18,18:19:00,23756.25,SELL,3,0.02h,Stop Loss,$-18.00,$384.75,$627179.75,421,$384.75
2025-08-18,18:24:00,23767.5,BUY,3,0.02h,Break Even,$0.75,$385.50,$627180.50,421,$385.50
2025-08-18,19:25:00,23792.5,SELL,3,0.02h,Break Even,$0.75,$386.25,$627181.25,421,$386.25
2025-08-18,19:38:00,23803.0,BUY,3,0.02h,Stop Loss,$-18.00,$368.25,$627163.25,421,$368.25
2025-08-18,20:03:00,23793.0,SELL,3,0.02h,Stop Loss,$-18.00,$350.25,$627145.25,421,$350.25
2025-08-18,20:50:00,23792.25,BUY,3,0.07h,Break Even,$0.75,$351.00,$627146.00,421,$351.00
2025-08-18,22:27:00,23814.0,SELL,3,0.02h,Break Even,$0.75,$351.75,$627146.75,421,$351.75
2025-08-18,22:49:00,23816.5,BUY,3,0.02h,Stop Loss,$-18.00,$333.75,$627128.75,421,$333.75
,,,,,,,,,,,
2025-08-19,12:00:00,23774.75,SELL,3,0.02h,Stop Loss,$45.75,$45.75,$627174.50,422,$45.75
2025-08-19,12:28:00,23780.75,BUY,3,0.02h,Stop Loss,$-18.00,$27.75,$627156.50,422,$27.75
2025-08-19,12:43:00,23771.5,SELL,3,0.02h,Break Even,$0.75,$28.50,$627157.25,422,$28.50
2025-08-19,13:24:00,23752.0,BUY,3,0.02h,Break Even,$0.75,$29.25,$627158.00,422,$29.25
2025-08-19,13:33:00,23692.75,SELL,3,0.02h,Stop Loss,$225.75,$255.00,$627383.75,422,$255.00
2025-08-19,14:05:00,23721.5,BUY,3,0.02h,Break Even,$0.75,$255.75,$627384.50,422,$255.75
2025-08-19,14:24:00,23688.0,SELL,3,0.02h,Stop Loss,$-18.00,$237.75,$627366.50,422,$237.75
2025-08-19,15:19:00,23567.5,BUY,3,0.02h,Stop Loss,$45.75,$283.50,$627412.25,422,$283.50
2025-08-19,15:26:00,23557.25,SELL,3,0.02h,Stop Loss,$-18.00,$265.50,$627394.25,422,$265.50
2025-08-19,15:27:00,23573.0,BUY,3,0.02h,Stop Loss,$120.75,$386.25,$627515.00,422,$386.25
2025-08-19,15:51:00,23560.5,SELL,3,0.02h,Stop Loss,$60.75,$447.00,$627575.75,422,$447.00
2025-08-19,17:26:00,23475.5,BUY,3,0.02h,Break Even,$0.75,$447.75,$627576.50,422,$447.75
2025-08-19,18:03:00,23483.25,SELL,3,0.02h,Stop Loss,$128.25,$576.00,$627704.75,422,$576.00
2025-08-19,18:58:00,23466.5,BUY,3,0.02h,Stop Loss,$19.50,$595.50,$627724.25,422,$595.50
2025-08-19,19:01:00,23447.0,SELL,3,0.02h,Stop Loss,$225.75,$821.25,$627950.00,422,$821.25
2025-08-19,19:24:00,23454.0,BUY,3,0.02h,Stop Loss,$87.00,$908.25,$628037.00,422,$908.25
2025-08-19,19:52:00,23452.75,SELL,3,0.02h,Stop Loss,$-18.00,$890.25,$628019.00,422,$890.25
2025-08-19,20:01:00,23481.5,BUY,3,0.02h,Stop Loss,$42.00,$932.25,$628061.00,422,$932.25
2025-08-19,20:21:00,23470.5,SELL,3,0.02h,Stop Loss,$-18.00,$914.25,$628043.00,422,$914.25
2025-08-19,20:23:00,23472.75,BUY,3,0.02h,Stop Loss,$-18.00,$896.25,$628025.00,422,$896.25
2025-08-19,20:24:00,23471.25,SELL,3,0.02h,Stop Loss,$42.00,$938.25,$628067.00,422,$938.25
2025-08-19,20:30:00,23473.25,BUY,3,0.02h,Break Even,$0.75,$939.00,$628067.75,422,$939.00
2025-08-19,20:37:00,23468.0,SELL,3,0.02h,Break Even,$0.75,$939.75,$628068.50,422,$939.75
2025-08-19,20:51:00,23472.5,BUY,3,0.02h,Stop Loss,$-18.00,$921.75,$628050.50,422,$921.75
2025-08-19,22:14:00,23469.25,SELL,3,0.02h,Stop Loss,$53.25,$975.00,$628103.75,422,$975.00
2025-08-19,22:39:00,23466.5,BUY,3,0.02h,Stop Loss,$-18.00,$957.00,$628085.75,422,$957.00
2025-08-19,22:40:00,23465.25,SELL,3,0.02h,Break Even,$0.75,$957.75,$628086.50,422,$957.75
2025-08-19,22:52:00,23468.25,BUY,3,0.02h,Stop Loss,$-18.00,$939.75,$628068.50,422,$939.75
2025-08-19,22:59:00,23461.25,SELL,3,0.02h,Stop Loss,$27.00,$966.75,$628095.50,422,$966.75
,,,,,,,,,,,
