Date,Time,MNQ Price,Operation type,Contracts,Trade duration,Close Reason,Net P&L,Daily P&L,Balance,Day,Daily P&L Total
2024-01-01,23:02:00,17017.0,BUY,3,0.02h,Stop Loss,$-9.00,$-9.00,$49991.00,1,$-9.00
2024-01-01,23:45:00,17027.5,SELL,3,0.02h,Stop Loss,$-9.00,$-18.00,$49982.00,1,$-18.00
,,,,,,,,,,,
2024-01-02,00:39:00,17027.0,BUY,3,0.02h,Stop Loss,$-9.00,$-9.00,$49973.00,2,$-9.00
2024-01-02,01:29:00,17030.0,SELL,3,0.02h,Break Even,$-1.50,$-10.50,$49971.50,2,$-10.50
2024-01-02,02:11:00,17018.75,BUY,3,0.02h,Stop Loss,$-9.00,$-19.50,$49962.50,2,$-19.50
2024-01-02,02:12:00,17017.0,SELL,3,0.07h,Break Even,$-1.50,$-21.00,$49961.00,2,$-21.00
2024-01-02,03:08:00,17009.0,BUY,3,0.18h,Stop Loss,$3.00,$-18.00,$49964.00,2,$-18.00
2024-01-02,03:20:00,17007.0,SELL,3,0.07h,Break Even,$-1.50,$-19.50,$49962.50,2,$-19.50
2024-01-02,03:34:00,17009.25,BUY,3,0.02h,Stop Loss,$-9.00,$-28.50,$49953.50,2,$-28.50
2024-01-02,03:36:00,17007.0,SELL,3,0.02h,Break Even,$-1.50,$-30.00,$49952.00,2,$-30.00
2024-01-02,03:47:00,17008.5,BUY,3,0.05h,Stop Loss,$-9.00,$-39.00,$49943.00,2,$-39.00
2024-01-02,03:51:00,17005.0,SELL,3,0.07h,Break Even,$-1.50,$-40.50,$49941.50,2,$-40.50
2024-01-02,04:13:00,17008.0,BUY,3,0.12h,Stop Loss,$-9.00,$-49.50,$49932.50,2,$-49.50
2024-01-02,04:56:00,17010.0,SELL,3,0.02h,Break Even,$-1.50,$-51.00,$49931.00,2,$-51.00
2024-01-02,05:12:00,17012.5,BUY,3,0.02h,Break Even,$-1.50,$-52.50,$49929.50,2,$-52.50
2024-01-02,06:04:00,17016.5,SELL,3,0.03h,Break Even,$-1.50,$-54.00,$49928.00,2,$-54.00
2024-01-02,06:51:00,17011.0,BUY,3,0.02h,Stop Loss,$-9.00,$-63.00,$49919.00,2,$-63.00
2024-01-02,06:52:00,17010.25,SELL,3,0.10h,Stop Loss,$18.00,$-45.00,$49937.00,2,$-45.00
2024-01-02,07:11:00,17011.25,BUY,3,0.02h,Break Even,$-1.50,$-46.50,$49935.50,2,$-46.50
2024-01-02,07:43:00,17015.5,SELL,3,0.02h,Break Even,$-1.50,$-48.00,$49934.00,2,$-48.00
2024-01-02,07:58:00,17018.75,BUY,3,0.03h,Stop Loss,$-9.00,$-57.00,$49925.00,2,$-57.00
2024-01-02,08:47:00,17029.75,SELL,3,0.02h,Break Even,$-1.50,$-58.50,$49923.50,2,$-58.50
2024-01-02,10:41:00,16996.5,BUY,3,0.02h,Stop Loss,$-9.00,$-67.50,$49914.50,2,$-67.50
2024-01-02,10:51:00,16988.0,SELL,3,0.02h,Stop Loss,$18.00,$-49.50,$49932.50,2,$-49.50
2024-01-02,11:58:00,16875.75,BUY,3,0.02h,Break Even,$-1.50,$-51.00,$49931.00,2,$-51.00
2024-01-02,12:05:00,16868.0,SELL,3,0.02h,Stop Loss,$19.50,$-31.50,$49950.50,2,$-31.50
2024-01-02,12:28:00,16865.25,BUY,3,0.02h,Stop Loss,$-9.00,$-40.50,$49941.50,2,$-40.50
2024-01-02,12:29:00,16858.5,SELL,3,0.02h,Stop Loss,$-9.00,$-49.50,$49932.50,2,$-49.50
2024-01-02,13:30:00,16828.25,BUY,3,0.02h,Stop Loss,$-9.00,$-58.50,$49923.50,2,$-58.50
2024-01-02,14:07:00,16841.5,SELL,3,0.02h,Stop Loss,$-9.00,$-67.50,$49914.50,2,$-67.50
2024-01-02,14:08:00,16851.75,BUY,3,0.02h,Break Even,$-1.50,$-69.00,$49913.00,2,$-69.00
2024-01-02,14:35:00,16832.0,SELL,3,0.02h,Stop Loss,$13.50,$-55.50,$49926.50,2,$-55.50
2024-01-02,16:02:00,16715.5,BUY,3,0.02h,Stop Loss,$24.00,$-31.50,$49950.50,2,$-31.50
2024-01-02,17:17:00,16772.5,SELL,3,0.02h,Stop Loss,$96.00,$64.50,$50046.50,2,$64.50
2024-01-02,17:37:00,16772.25,BUY,3,0.02h,Stop Loss,$-9.00,$55.50,$50037.50,2,$55.50
2024-01-02,17:48:00,16758.25,SELL,3,0.02h,Stop Loss,$63.00,$118.50,$50100.50,2,$118.50
2024-01-02,18:22:00,16730.5,BUY,3,0.02h,Stop Loss,$-9.00,$109.50,$50091.50,2,$109.50
2024-01-02,18:49:00,16729.75,SELL,3,0.02h,Stop Loss,$15.00,$124.50,$50106.50,2,$124.50
2024-01-02,19:29:00,16695.5,BUY,3,0.02h,Stop Loss,$15.00,$139.50,$50121.50,2,$139.50
2024-01-02,19:40:00,16684.75,SELL,3,0.02h,Stop Loss,$6.00,$145.50,$50127.50,2,$145.50
2024-01-02,20:31:00,16651.25,BUY,3,0.02h,Stop Loss,$22.50,$168.00,$50150.00,2,$168.00
2024-01-02,20:40:00,16640.25,SELL,3,0.02h,Break Even,$-1.50,$166.50,$50148.50,2,$166.50
2024-01-02,20:44:00,16649.0,BUY,3,0.02h,Stop Loss,$15.00,$181.50,$50163.50,2,$181.50
2024-01-02,23:16:00,16728.75,SELL,3,0.02h,Stop Loss,$-9.00,$172.50,$50154.50,2,$172.50
2024-01-02,23:56:00,16724.25,BUY,3,0.08h,Break Even,$-1.50,$171.00,$50153.00,2,$171.00
,,,,,,,,,,,
2024-01-03,00:04:00,16722.75,SELL,3,0.02h,Stop Loss,$-9.00,$-9.00,$50144.00,3,$-9.00
2024-01-03,00:05:00,16723.75,BUY,3,0.03h,Stop Loss,$-9.00,$-18.00,$50135.00,3,$-18.00
2024-01-03,00:07:00,16722.5,SELL,3,0.05h,Stop Loss,$-9.00,$-27.00,$50126.00,3,$-27.00
2024-01-03,00:12:00,16723.75,BUY,3,0.03h,Break Even,$-1.50,$-28.50,$50124.50,3,$-28.50
2024-01-03,00:36:00,16724.0,SELL,3,0.02h,Stop Loss,$-9.00,$-37.50,$50115.50,3,$-37.50
2024-01-03,01:51:00,16712.75,BUY,3,0.02h,Stop Loss,$-9.00,$-46.50,$50106.50,3,$-46.50
2024-01-03,02:11:00,16710.75,SELL,3,0.02h,Stop Loss,$-9.00,$-55.50,$50097.50,3,$-55.50
2024-01-03,02:53:00,16706.25,BUY,3,0.03h,Stop Loss,$-9.00,$-64.50,$50088.50,3,$-64.50
2024-01-03,02:55:00,16703.0,SELL,3,0.02h,Break Even,$-1.50,$-66.00,$50087.00,3,$-66.00
2024-01-03,03:04:00,16706.0,BUY,3,0.07h,Break Even,$-1.50,$-67.50,$50085.50,3,$-67.50
2024-01-03,03:18:00,16702.75,SELL,3,0.03h,Stop Loss,$-9.00,$-76.50,$50076.50,3,$-76.50
2024-01-03,03:34:00,16707.75,BUY,3,0.03h,Stop Loss,$-9.00,$-85.50,$50067.50,3,$-85.50
2024-01-03,03:48:00,16704.75,SELL,3,0.08h,Stop Loss,$-9.00,$-94.50,$50058.50,3,$-94.50
2024-01-03,03:53:00,16705.75,BUY,3,0.03h,Stop Loss,$-9.00,$-103.50,$50049.50,3,$-103.50
2024-01-03,03:55:00,16703.75,SELL,3,0.02h,Stop Loss,$-9.00,$-112.50,$50040.50,3,$-112.50
2024-01-03,04:25:00,16702.0,BUY,3,0.08h,Stop Loss,$-9.00,$-121.50,$50031.50,3,$-121.50
2024-01-03,04:33:00,16701.0,SELL,3,0.03h,Round Number,$3.00,$-118.50,$50034.50,3,$-118.50
2024-01-03,05:16:00,16696.5,BUY,3,0.07h,Break Even,$-1.50,$-120.00,$50033.00,3,$-120.00
2024-01-03,05:25:00,16693.0,SELL,3,0.02h,Stop Loss,$-9.00,$-129.00,$50024.00,3,$-129.00
2024-01-03,05:30:00,16697.25,BUY,3,0.02h,Break Even,$-1.50,$-130.50,$50022.50,3,$-130.50
2024-01-03,06:10:00,16700.75,SELL,3,0.02h,Stop Loss,$-9.00,$-139.50,$50013.50,3,$-139.50
2024-01-03,06:15:00,16706.5,BUY,3,0.02h,Break Even,$-1.50,$-141.00,$50012.00,3,$-141.00
2024-01-03,06:59:00,16712.0,SELL,3,0.03h,Stop Loss,$-9.00,$-150.00,$50003.00,3,$-150.00
2024-01-03,07:27:00,16709.25,BUY,3,0.02h,Break Even,$-1.50,$-151.50,$50001.50,3,$-151.50
2024-01-03,07:33:00,16704.5,SELL,3,0.02h,Stop Loss,$-9.00,$-160.50,$49992.50,3,$-160.50
2024-01-03,07:37:00,16711.0,BUY,3,0.02h,Stop Loss,$-9.00,$-169.50,$49983.50,3,$-169.50
2024-01-03,07:40:00,16707.75,SELL,3,0.02h,Stop Loss,$-9.00,$-178.50,$49974.50,3,$-178.50
2024-01-03,07:43:00,16709.75,BUY,3,0.02h,Stop Loss,$-9.00,$-187.50,$49965.50,3,$-187.50
2024-01-03,08:28:00,16712.0,SELL,3,0.02h,Break Even,$-1.50,$-189.00,$49964.00,3,$-189.00
2024-01-03,09:26:00,16678.0,BUY,3,0.02h,Break Even,$-1.50,$-190.50,$49962.50,3,$-190.50
2024-01-03,09:33:00,16670.0,SELL,3,0.03h,Break Even,$-1.50,$-192.00,$49961.00,3,$-192.00
2024-01-03,10:12:00,16654.0,BUY,3,0.02h,Break Even,$-1.50,$-193.50,$49959.50,3,$-193.50
2024-01-03,10:25:00,16648.5,SELL,3,0.02h,Break Even,$-1.50,$-195.00,$49958.00,3,$-195.00
2024-01-03,10:29:00,16653.0,BUY,3,0.02h,Stop Loss,$-9.00,$-204.00,$49949.00,3,$-204.00
2024-01-03,10:56:00,16657.0,SELL,3,0.02h,Break Even,$-1.50,$-205.50,$49947.50,3,$-205.50
2024-01-03,11:50:00,16648.5,BUY,3,0.02h,Stop Loss,$-9.00,$-214.50,$49938.50,3,$-214.50
2024-01-03,11:56:00,16642.25,SELL,3,0.02h,Stop Loss,$-9.00,$-223.50,$49929.50,3,$-223.50
2024-01-03,12:00:00,16648.5,BUY,3,0.02h,Stop Loss,$-9.00,$-232.50,$49920.50,3,$-232.50
2024-01-03,12:03:00,16643.25,SELL,3,0.02h,Stop Loss,$4.50,$-228.00,$49925.00,3,$-228.00
2024-01-03,12:53:00,16617.5,BUY,3,0.02h,Stop Loss,$-9.00,$-237.00,$49916.00,3,$-237.00
2024-01-03,12:56:00,16608.0,SELL,3,0.02h,Break Even,$-1.50,$-238.50,$49914.50,3,$-238.50
2024-01-03,13:11:00,16613.25,BUY,3,0.02h,Break Even,$-1.50,$-240.00,$49913.00,3,$-240.00
2024-01-03,13:50:00,16631.5,SELL,3,0.02h,Stop Loss,$-9.00,$-249.00,$49904.00,3,$-249.00
2024-01-03,13:52:00,16640.25,BUY,3,0.02h,Stop Loss,$-9.00,$-258.00,$49895.00,3,$-258.00
2024-01-03,13:54:00,16631.5,SELL,3,0.02h,Stop Loss,$-9.00,$-267.00,$49886.00,3,$-267.00
2024-01-03,14:32:00,16617.25,BUY,3,0.02h,Break Even,$-1.50,$-268.50,$49884.50,3,$-268.50
2024-01-03,14:33:00,16593.0,SELL,3,0.02h,Stop Loss,$48.00,$-220.50,$49932.50,3,$-220.50
2024-01-03,14:36:00,16630.5,BUY,3,0.02h,Break Even,$-1.50,$-222.00,$49931.00,3,$-222.00
2024-01-03,14:57:00,16607.0,SELL,3,0.02h,Stop Loss,$60.00,$-162.00,$49991.00,3,$-162.00
2024-01-03,15:04:00,16640.0,BUY,3,0.02h,Stop Loss,$19.50,$-142.50,$50010.50,3,$-142.50
2024-01-03,15:10:00,16608.0,SELL,3,0.02h,Stop Loss,$91.50,$-51.00,$50102.00,3,$-51.00
2024-01-03,15:53:00,16577.75,BUY,3,0.02h,Break Even,$-1.50,$-52.50,$50100.50,3,$-52.50
2024-01-03,16:23:00,16585.5,SELL,3,0.02h,Stop Loss,$-9.00,$-61.50,$50091.50,3,$-61.50
2024-01-03,16:34:00,16600.25,BUY,3,0.02h,Stop Loss,$-9.00,$-70.50,$50082.50,3,$-70.50
2024-01-03,16:36:00,16589.25,SELL,3,0.02h,Stop Loss,$21.00,$-49.50,$50103.50,3,$-49.50
2024-01-03,17:28:00,16571.0,BUY,3,0.02h,Stop Loss,$15.00,$-34.50,$50118.50,3,$-34.50
2024-01-03,18:21:00,16590.5,SELL,3,0.02h,Break Even,$-1.50,$-36.00,$50117.00,3,$-36.00
2024-01-03,19:26:00,16590.75,BUY,3,0.02h,Stop Loss,$96.00,$60.00,$50213.00,3,$60.00
2024-01-03,19:53:00,16596.25,SELL,3,0.02h,Stop Loss,$-9.00,$51.00,$50204.00,3,$51.00
2024-01-03,20:34:00,16572.5,BUY,3,0.02h,Stop Loss,$24.00,$75.00,$50228.00,3,$75.00
2024-01-03,20:44:00,16555.25,SELL,3,0.02h,Stop Loss,$42.00,$117.00,$50270.00,3,$117.00
2024-01-03,21:32:00,16536.25,BUY,3,0.02h,Stop Loss,$-9.00,$108.00,$50261.00,3,$108.00
2024-01-03,21:33:00,16535.0,SELL,3,0.03h,Stop Loss,$-9.00,$99.00,$50252.00,3,$99.00
2024-01-03,21:36:00,16536.75,BUY,3,0.02h,Stop Loss,$-9.00,$90.00,$50243.00,3,$90.00
2024-01-03,21:37:00,16535.0,SELL,3,0.03h,Stop Loss,$-9.00,$81.00,$50234.00,3,$81.00
2024-01-03,21:39:00,16536.5,BUY,3,0.03h,Stop Loss,$-9.00,$72.00,$50225.00,3,$72.00
2024-01-03,23:38:00,16549.0,SELL,3,0.20h,Stop Loss,$3.00,$75.00,$50228.00,3,$75.00
2024-01-03,23:55:00,16549.5,BUY,3,0.02h,Break Even,$-1.50,$73.50,$50226.50,3,$73.50
,,,,,,,,,,,
2024-01-04,00:01:00,16542.25,SELL,3,0.02h,Break Even,$-1.50,$-1.50,$50225.00,4,$-1.50
2024-01-04,00:23:00,16548.5,BUY,3,0.03h,Break Even,$-1.50,$-3.00,$50223.50,4,$-3.00
2024-01-04,01:12:00,16556.25,SELL,3,0.02h,Stop Loss,$-9.00,$-12.00,$50214.50,4,$-12.00
2024-01-04,01:16:00,16560.5,BUY,3,0.02h,Stop Loss,$-9.00,$-21.00,$50205.50,4,$-21.00
2024-01-04,01:25:00,16556.0,SELL,3,0.02h,Break Even,$-1.50,$-22.50,$50204.00,4,$-22.50
2024-01-04,01:54:00,16556.25,BUY,3,0.03h,Break Even,$-1.50,$-24.00,$50202.50,4,$-24.00
2024-01-04,02:05:00,16552.75,SELL,3,0.05h,Stop Loss,$-9.00,$-33.00,$50193.50,4,$-33.00
2024-01-04,02:31:00,16552.0,BUY,3,0.03h,Stop Loss,$-9.00,$-42.00,$50184.50,4,$-42.00
2024-01-04,02:40:00,16548.75,SELL,3,0.03h,Stop Loss,$-9.00,$-51.00,$50175.50,4,$-51.00
2024-01-04,02:54:00,16551.0,BUY,3,0.02h,Break Even,$-1.50,$-52.50,$50174.00,4,$-52.50
2024-01-04,03:27:00,16552.75,SELL,3,0.02h,Break Even,$-1.50,$-54.00,$50172.50,4,$-54.00
2024-01-04,04:03:00,16552.5,BUY,3,0.12h,Break Even,$-1.50,$-55.50,$50171.00,4,$-55.50
2024-01-04,04:32:00,16551.5,SELL,3,0.03h,Break Even,$-1.50,$-57.00,$50169.50,4,$-57.00
2024-01-04,05:56:00,16545.75,BUY,3,0.02h,Stop Loss,$-9.00,$-66.00,$50160.50,4,$-66.00
2024-01-04,05:57:00,16544.75,SELL,3,0.03h,Break Even,$-1.50,$-67.50,$50159.00,4,$-67.50
2024-01-04,06:19:00,16544.5,BUY,3,0.02h,Break Even,$-1.50,$-69.00,$50157.50,4,$-69.00
2024-01-04,07:55:00,16575.75,SELL,3,0.02h,Break Even,$-1.50,$-70.50,$50156.00,4,$-70.50
2024-01-04,08:08:00,16578.5,BUY,3,0.02h,Stop Loss,$9.00,$-61.50,$50165.00,4,$-61.50
2024-01-04,08:16:00,16569.5,SELL,3,0.02h,Stop Loss,$-9.00,$-70.50,$50156.00,4,$-70.50
2024-01-04,08:26:00,16579.25,BUY,3,0.02h,Stop Loss,$-9.00,$-79.50,$50147.00,4,$-79.50
2024-01-04,08:30:00,16569.5,SELL,3,0.02h,Stop Loss,$9.00,$-70.50,$50156.00,4,$-70.50
2024-01-04,09:11:00,16562.0,BUY,3,0.02h,Break Even,$-1.50,$-72.00,$50154.50,4,$-72.00
2024-01-04,09:48:00,16569.25,SELL,3,0.02h,Stop Loss,$-9.00,$-81.00,$50145.50,4,$-81.00
2024-01-04,09:55:00,16573.25,BUY,3,0.02h,Break Even,$-1.50,$-82.50,$50144.00,4,$-82.50
2024-01-04,10:04:00,16567.0,SELL,3,0.02h,Stop Loss,$-9.00,$-91.50,$50135.00,4,$-91.50
2024-01-04,10:18:00,16574.5,BUY,3,0.02h,Break Even,$-1.50,$-93.00,$50133.50,4,$-93.00
2024-01-04,10:30:00,16568.75,SELL,3,0.02h,Break Even,$-1.50,$-94.50,$50132.00,4,$-94.50
2024-01-04,11:02:00,16564.5,BUY,3,0.03h,Break Even,$-1.50,$-96.00,$50130.50,4,$-96.00
2024-01-04,11:35:00,16562.75,SELL,3,0.02h,Break Even,$-1.50,$-97.50,$50129.00,4,$-97.50
2024-01-04,12:30:00,16527.5,BUY,3,0.02h,Stop Loss,$6.00,$-91.50,$50135.00,4,$-91.50
2024-01-04,12:42:00,16521.75,SELL,3,0.02h,Break Even,$-1.50,$-93.00,$50133.50,4,$-93.00
2024-01-04,12:43:00,16527.75,BUY,3,0.02h,Stop Loss,$-9.00,$-102.00,$50124.50,4,$-102.00
2024-01-04,12:54:00,16523.75,SELL,3,0.02h,Break Even,$-1.50,$-103.50,$50123.00,4,$-103.50
2024-01-04,14:14:00,16466.75,BUY,3,0.02h,Stop Loss,$4.50,$-99.00,$50127.50,4,$-99.00
2024-01-04,14:23:00,16461.25,SELL,3,0.02h,Break Even,$-1.50,$-100.50,$50126.00,4,$-100.50
2024-01-04,14:33:00,16488.25,BUY,3,0.02h,Stop Loss,$-9.00,$-109.50,$50117.00,4,$-109.50
2024-01-04,14:49:00,16460.25,SELL,3,0.02h,Stop Loss,$28.50,$-81.00,$50145.50,4,$-81.00
2024-01-04,14:53:00,16485.75,BUY,3,0.02h,Stop Loss,$4.50,$-76.50,$50150.00,4,$-76.50
2024-01-04,14:59:00,16458.5,SELL,3,0.02h,Stop Loss,$19.50,$-57.00,$50169.50,4,$-57.00
2024-01-04,15:02:00,16491.25,BUY,3,0.02h,Stop Loss,$-9.00,$-66.00,$50160.50,4,$-66.00
2024-01-04,16:33:00,16551.75,SELL,3,0.02h,Stop Loss,$-9.00,$-75.00,$50151.50,4,$-75.00
2024-01-04,16:38:00,16571.25,BUY,3,0.02h,Stop Loss,$-9.00,$-84.00,$50142.50,4,$-84.00
2024-01-04,16:40:00,16558.5,SELL,3,0.02h,Stop Loss,$3.00,$-81.00,$50145.50,4,$-81.00
2024-01-04,17:30:00,16523.75,BUY,3,0.02h,Break Even,$-1.50,$-82.50,$50144.00,4,$-82.50
2024-01-04,17:32:00,16516.5,SELL,3,0.02h,Stop Loss,$22.50,$-60.00,$50166.50,4,$-60.00
2024-01-04,17:42:00,16520.5,BUY,3,0.02h,Stop Loss,$-9.00,$-69.00,$50157.50,4,$-69.00
2024-01-04,17:44:00,16510.25,SELL,3,0.02h,Stop Loss,$61.50,$-7.50,$50219.00,4,$-7.50
2024-01-04,18:05:00,16509.5,BUY,3,0.02h,Break Even,$-1.50,$-9.00,$50217.50,4,$-9.00
2024-01-04,18:13:00,16495.75,SELL,3,0.02h,Break Even,$-1.50,$-10.50,$50216.00,4,$-10.50
2024-01-04,18:15:00,16506.75,BUY,3,0.02h,Stop Loss,$-9.00,$-19.50,$50207.00,4,$-19.50
2024-01-04,18:16:00,16501.0,SELL,3,0.02h,Stop Loss,$15.00,$-4.50,$50222.00,4,$-4.50
2024-01-04,18:18:00,16509.5,BUY,3,0.02h,Break Even,$-1.50,$-6.00,$50220.50,4,$-6.00
2024-01-04,18:54:00,16514.75,SELL,3,0.02h,Stop Loss,$21.00,$15.00,$50241.50,4,$15.00
2024-01-04,19:52:00,16492.25,BUY,3,0.02h,Stop Loss,$9.00,$24.00,$50250.50,4,$24.00
2024-01-04,20:17:00,16478.5,SELL,3,0.02h,Break Even,$-1.50,$22.50,$50249.00,4,$22.50
2024-01-04,20:33:00,16494.0,BUY,3,0.02h,Stop Loss,$12.00,$34.50,$50261.00,4,$34.50
2024-01-04,20:44:00,16482.25,SELL,3,0.02h,Stop Loss,$-9.00,$25.50,$50252.00,4,$25.50
2024-01-04,21:28:00,16450.5,BUY,3,0.02h,Break Even,$-1.50,$24.00,$50250.50,4,$24.00
2024-01-04,21:54:00,16449.25,SELL,3,0.02h,Break Even,$-1.50,$22.50,$50249.00,4,$22.50
2024-01-04,23:01:00,16458.5,BUY,3,0.02h,Stop Loss,$4.50,$27.00,$50253.50,4,$27.00
2024-01-04,23:45:00,16462.0,SELL,3,0.02h,Stop Loss,$-9.00,$18.00,$50244.50,4,$18.00
,,,,,,,,,,,
2024-01-05,00:16:00,16461.0,BUY,3,0.02h,Stop Loss,$-9.00,$-9.00,$50235.50,5,$-9.00
2024-01-05,00:55:00,16462.0,SELL,3,0.02h,Break Even,$-1.50,$-10.50,$50234.00,5,$-10.50
2024-01-05,01:11:00,16463.5,BUY,3,0.02h,Break Even,$-1.50,$-12.00,$50232.50,5,$-12.00
2024-01-05,01:24:00,16455.75,SELL,3,0.02h,Break Even,$-1.50,$-13.50,$50231.00,5,$-13.50
2024-01-05,01:44:00,16460.0,BUY,3,0.02h,Break Even,$-1.50,$-15.00,$50229.50,5,$-15.00
2024-01-05,01:57:00,16459.5,SELL,3,0.02h,Stop Loss,$-9.00,$-24.00,$50220.50,5,$-24.00
2024-01-05,02:25:00,16459.0,BUY,3,0.02h,Break Even,$-1.50,$-25.50,$50219.00,5,$-25.50
2024-01-05,02:37:00,16456.75,SELL,3,0.08h,Break Even,$-1.50,$-27.00,$50217.50,5,$-27.00
2024-01-05,03:23:00,16454.75,BUY,3,0.02h,Stop Loss,$-9.00,$-36.00,$50208.50,5,$-36.00
2024-01-05,03:26:00,16453.0,SELL,3,0.02h,Stop Loss,$-9.00,$-45.00,$50199.50,5,$-45.00
2024-01-05,03:27:00,16453.75,BUY,3,0.12h,Stop Loss,$-9.00,$-54.00,$50190.50,5,$-54.00
2024-01-05,03:35:00,16453.0,SELL,3,0.20h,Stop Loss,$19.50,$-34.50,$50210.00,5,$-34.50
2024-01-05,04:11:00,16450.75,BUY,3,0.02h,Stop Loss,$-9.00,$-43.50,$50201.00,5,$-43.50
2024-01-05,04:46:00,16451.0,SELL,3,0.05h,Break Even,$-1.50,$-45.00,$50199.50,5,$-45.00
2024-01-05,06:05:00,16433.0,BUY,3,0.02h,Stop Loss,$-9.00,$-54.00,$50190.50,5,$-54.00
2024-01-05,06:06:00,16429.75,SELL,3,0.03h,Break Even,$-1.50,$-55.50,$50189.00,5,$-55.50
2024-01-05,07:02:00,16411.0,BUY,3,0.02h,Stop Loss,$-9.00,$-64.50,$50180.00,5,$-64.50
2024-01-05,07:03:00,16409.75,SELL,3,0.02h,Break Even,$-1.50,$-66.00,$50178.50,5,$-66.00
2024-01-05,07:09:00,16413.25,BUY,3,0.02h,Stop Loss,$-9.00,$-75.00,$50169.50,5,$-75.00
2024-01-05,07:39:00,16414.5,SELL,3,0.02h,Break Even,$-1.50,$-76.50,$50168.00,5,$-76.50
2024-01-05,08:08:00,16410.5,BUY,3,0.02h,Stop Loss,$-9.00,$-85.50,$50159.00,5,$-85.50
2024-01-05,08:40:00,16421.25,SELL,3,0.02h,Stop Loss,$-9.00,$-94.50,$50150.00,5,$-94.50
2024-01-05,08:41:00,16425.0,BUY,3,0.03h,Break Even,$-1.50,$-96.00,$50148.50,5,$-96.00
2024-01-05,08:45:00,16421.0,SELL,3,0.02h,Break Even,$-1.50,$-97.50,$50147.00,5,$-97.50
2024-01-05,09:21:00,16418.25,BUY,3,0.03h,Stop Loss,$-9.00,$-106.50,$50138.00,5,$-106.50
2024-01-05,09:36:00,16407.75,SELL,3,0.02h,Stop Loss,$-9.00,$-115.50,$50129.00,5,$-115.50
2024-01-05,10:07:00,16403.5,BUY,3,0.02h,Stop Loss,$-9.00,$-124.50,$50120.00,5,$-124.50
2024-01-05,10:08:00,16399.5,SELL,3,0.02h,Stop Loss,$6.00,$-118.50,$50126.00,5,$-118.50
2024-01-05,10:13:00,16403.0,BUY,3,0.03h,Break Even,$-1.50,$-120.00,$50124.50,5,$-120.00
2024-01-05,10:17:00,16395.25,SELL,3,0.02h,Stop Loss,$-9.00,$-129.00,$50115.50,5,$-129.00
2024-01-05,10:58:00,16385.75,BUY,3,0.02h,Break Even,$-1.50,$-130.50,$50114.00,5,$-130.50
2024-01-05,11:16:00,16385.0,SELL,3,0.02h,Stop Loss,$-9.00,$-139.50,$50105.00,5,$-139.50
2024-01-05,11:49:00,16382.75,BUY,3,0.02h,Stop Loss,$-9.00,$-148.50,$50096.00,5,$-148.50
2024-01-05,12:50:00,16392.25,SELL,3,0.02h,Break Even,$-1.50,$-150.00,$50094.50,5,$-150.00
2024-01-05,13:14:00,16392.75,BUY,3,0.02h,Stop Loss,$18.00,$-132.00,$50112.50,5,$-132.00
2024-01-05,13:31:00,16362.75,SELL,3,0.02h,Stop Loss,$150.00,$18.00,$50262.50,5,$18.00
2024-01-05,13:52:00,16388.75,BUY,3,0.02h,Break Even,$-1.50,$16.50,$50261.00,5,$16.50
2024-01-05,16:19:00,16541.25,SELL,3,0.02h,Stop Loss,$10.50,$27.00,$50271.50,5,$27.00
2024-01-05,17:42:00,16476.5,BUY,3,0.02h,Break Even,$-1.50,$25.50,$50270.00,5,$25.50
2024-01-05,18:01:00,16468.0,SELL,3,0.02h,Stop Loss,$34.50,$60.00,$50304.50,5,$60.00
2024-01-05,18:28:00,16457.25,BUY,3,0.02h,Stop Loss,$39.00,$99.00,$50343.50,5,$99.00
2024-01-05,19:17:00,16486.5,SELL,3,0.02h,Stop Loss,$4.50,$103.50,$50348.00,5,$103.50
2024-01-05,20:39:00,16430.25,BUY,3,0.02h,Stop Loss,$-9.00,$94.50,$50339.00,5,$94.50
2024-01-05,21:31:00,16461.25,SELL,3,0.02h,Stop Loss,$-9.00,$85.50,$50330.00,5,$85.50
2024-01-05,21:51:00,16463.5,BUY,3,0.03h,Stop Loss,$-9.00,$76.50,$50321.00,5,$76.50
,,,,,,,,,,,
2024-01-08,00:43:00,16491.25,SELL,3,0.02h,Break Even,$-1.50,$-1.50,$50319.50,6,$-1.50
2024-01-08,00:51:00,16494.5,BUY,3,0.02h,Stop Loss,$-9.00,$-10.50,$50310.50,6,$-10.50
2024-01-08,01:02:00,16489.5,SELL,3,0.03h,Stop Loss,$-9.00,$-19.50,$50301.50,6,$-19.50
2024-01-08,01:08:00,16495.75,BUY,3,0.12h,Round Number,$22.50,$3.00,$50324.00,6,$3.00
2024-01-08,01:28:00,16495.5,SELL,3,0.02h,Break Even,$-1.50,$1.50,$50322.50,6,$1.50
2024-01-08,02:49:00,16462.75,BUY,3,0.02h,Stop Loss,$-9.00,$-7.50,$50313.50,6,$-7.50
2024-01-08,02:58:00,16461.0,SELL,3,0.07h,Break Even,$-1.50,$-9.00,$50312.00,6,$-9.00
2024-01-08,04:13:00,16445.0,BUY,3,0.02h,Stop Loss,$-9.00,$-18.00,$50303.00,6,$-18.00
2024-01-08,04:42:00,16444.75,SELL,3,0.05h,Break Even,$-1.50,$-19.50,$50301.50,6,$-19.50
2024-01-08,04:50:00,16448.75,BUY,3,0.03h,Stop Loss,$-9.00,$-28.50,$50292.50,6,$-28.50
2024-01-08,05:25:00,16446.5,SELL,3,0.02h,Stop Loss,$-9.00,$-37.50,$50283.50,6,$-37.50
2024-01-08,06:06:00,16445.5,BUY,3,0.02h,Stop Loss,$4.50,$-33.00,$50288.00,6,$-33.00
2024-01-08,06:25:00,16443.25,SELL,3,0.02h,Stop Loss,$-9.00,$-42.00,$50279.00,6,$-42.00
2024-01-08,06:27:00,16447.5,BUY,3,0.02h,Stop Loss,$-9.00,$-51.00,$50270.00,6,$-51.00
2024-01-08,06:31:00,16441.25,SELL,3,0.02h,Stop Loss,$33.00,$-18.00,$50303.00,6,$-18.00
2024-01-08,06:54:00,16441.75,BUY,3,0.02h,Stop Loss,$-9.00,$-27.00,$50294.00,6,$-27.00
2024-01-08,07:34:00,16451.25,SELL,3,0.02h,Break Even,$-1.50,$-28.50,$50292.50,6,$-28.50
2024-01-08,07:53:00,16448.5,BUY,3,0.02h,Stop Loss,$-9.00,$-37.50,$50283.50,6,$-37.50
2024-01-08,07:58:00,16444.0,SELL,3,0.02h,Stop Loss,$-9.00,$-46.50,$50274.50,6,$-46.50
2024-01-08,08:02:00,16454.75,BUY,3,0.02h,Stop Loss,$-9.00,$-55.50,$50265.50,6,$-55.50
2024-01-08,08:07:00,16442.0,SELL,3,0.02h,Stop Loss,$3.00,$-52.50,$50268.50,6,$-52.50
2024-01-08,08:20:00,16448.0,BUY,3,0.02h,Stop Loss,$6.00,$-46.50,$50274.50,6,$-46.50
2024-01-08,08:43:00,16442.0,SELL,3,0.02h,Stop Loss,$10.50,$-36.00,$50285.00,6,$-36.00
2024-01-08,09:13:00,16434.0,BUY,3,0.02h,Stop Loss,$-9.00,$-45.00,$50276.00,6,$-45.00
2024-01-08,09:14:00,16431.0,SELL,3,0.02h,Break Even,$-1.50,$-46.50,$50274.50,6,$-46.50
2024-01-08,09:48:00,16411.75,BUY,3,0.02h,Break Even,$-1.50,$-48.00,$50273.00,6,$-48.00
2024-01-08,10:50:00,16428.0,SELL,3,0.02h,Break Even,$-1.50,$-49.50,$50271.50,6,$-49.50
2024-01-08,11:13:00,16440.75,BUY,3,0.02h,Stop Loss,$10.50,$-39.00,$50282.00,6,$-39.00
2024-01-08,12:32:00,16463.75,SELL,3,0.02h,Break Even,$-1.50,$-40.50,$50280.50,6,$-40.50
2024-01-08,12:57:00,16462.0,BUY,3,0.02h,Stop Loss,$63.00,$22.50,$50343.50,6,$22.50
2024-01-08,13:48:00,16486.25,SELL,3,0.02h,Break Even,$-1.50,$21.00,$50342.00,6,$21.00
2024-01-08,14:12:00,16490.25,BUY,3,0.02h,Stop Loss,$6.00,$27.00,$50348.00,6,$27.00
2024-01-08,16:12:00,16645.5,SELL,3,0.02h,Stop Loss,$9.00,$36.00,$50357.00,6,$36.00
2024-01-08,16:22:00,16661.75,BUY,3,0.02h,Break Even,$-1.50,$34.50,$50355.50,6,$34.50
2024-01-08,16:24:00,16650.0,SELL,3,0.02h,Break Even,$-1.50,$33.00,$50354.00,6,$33.00
2024-01-08,16:34:00,16658.5,BUY,3,0.02h,Stop Loss,$12.00,$45.00,$50366.00,6,$45.00
2024-01-08,16:49:00,16655.5,SELL,3,0.02h,Break Even,$-1.50,$43.50,$50364.50,6,$43.50
2024-01-08,16:53:00,16658.75,BUY,3,0.02h,Break Even,$-1.50,$42.00,$50363.00,6,$42.00
2024-01-08,17:26:00,16682.25,SELL,3,0.02h,Break Even,$-1.50,$40.50,$50361.50,6,$40.50
2024-01-08,17:32:00,16685.75,BUY,3,0.02h,Break Even,$-1.50,$39.00,$50360.00,6,$39.00
2024-01-08,18:33:00,16714.25,SELL,3,0.02h,Break Even,$-1.50,$37.50,$50358.50,6,$37.50
2024-01-08,18:34:00,16715.75,BUY,3,0.02h,Break Even,$-1.50,$36.00,$50357.00,6,$36.00
2024-01-08,20:15:00,16776.25,SELL,3,0.02h,Break Even,$-1.50,$34.50,$50355.50,6,$34.50
2024-01-08,20:16:00,16779.75,BUY,3,0.02h,Break Even,$-1.50,$33.00,$50354.00,6,$33.00
2024-01-08,20:17:00,16777.0,SELL,3,0.02h,Stop Loss,$-9.00,$24.00,$50345.00,6,$24.00
2024-01-08,20:18:00,16784.25,BUY,3,0.02h,Stop Loss,$16.50,$40.50,$50361.50,6,$40.50
2024-01-08,20:30:00,16778.0,SELL,3,0.02h,Stop Loss,$6.00,$46.50,$50367.50,6,$46.50
2024-01-08,20:35:00,16786.0,BUY,3,0.02h,Stop Loss,$-9.00,$37.50,$50358.50,6,$37.50
2024-01-08,20:48:00,16777.0,SELL,3,0.02h,Break Even,$-1.50,$36.00,$50357.00,6,$36.00
2024-01-08,20:52:00,16801.0,BUY,3,0.02h,Stop Loss,$12.00,$48.00,$50369.00,6,$48.00
2024-01-08,21:11:00,16792.5,SELL,3,0.02h,Break Even,$-1.50,$46.50,$50367.50,6,$46.50
2024-01-08,23:46:00,16784.0,BUY,3,0.02h,Break Even,$-1.50,$45.00,$50366.00,6,$45.00
,,,,,,,,,,,
2024-01-09,00:18:00,16784.0,SELL,3,0.02h,Stop Loss,$-9.00,$-9.00,$50357.00,7,$-9.00
2024-01-09,00:49:00,16788.5,BUY,3,0.02h,Stop Loss,$-9.00,$-18.00,$50348.00,7,$-18.00
2024-01-09,01:01:00,16785.0,SELL,3,0.02h,Stop Loss,$-9.00,$-27.00,$50339.00,7,$-27.00
2024-01-09,01:02:00,16787.75,BUY,3,0.02h,Stop Loss,$-9.00,$-36.00,$50330.00,7,$-36.00
2024-01-09,01:05:00,16785.5,SELL,3,0.02h,Stop Loss,$-9.00,$-45.00,$50321.00,7,$-45.00
2024-01-09,01:07:00,16788.5,BUY,3,0.02h,Stop Loss,$-9.00,$-54.00,$50312.00,7,$-54.00
2024-01-09,01:19:00,16783.75,SELL,3,0.02h,Stop Loss,$-9.00,$-63.00,$50303.00,7,$-63.00
2024-01-09,01:22:00,16788.5,BUY,3,0.02h,Break Even,$-1.50,$-64.50,$50301.50,7,$-64.50
2024-01-09,01:35:00,16787.25,SELL,3,0.02h,Break Even,$-1.50,$-66.00,$50300.00,7,$-66.00
2024-01-09,01:53:00,16789.5,BUY,3,0.02h,Stop Loss,$-9.00,$-75.00,$50291.00,7,$-75.00
2024-01-09,02:45:00,16791.75,SELL,3,0.02h,Stop Loss,$-9.00,$-84.00,$50282.00,7,$-84.00
2024-01-09,03:00:00,16794.75,BUY,3,0.02h,Stop Loss,$-9.00,$-93.00,$50273.00,7,$-93.00
2024-01-09,03:12:00,16792.0,SELL,3,0.03h,Break Even,$-1.50,$-94.50,$50271.50,7,$-94.50
2024-01-09,04:00:00,16789.5,BUY,3,0.02h,Stop Loss,$-9.00,$-103.50,$50262.50,7,$-103.50
2024-01-09,04:01:00,16787.75,SELL,3,0.03h,Break Even,$-1.50,$-105.00,$50261.00,7,$-105.00
2024-01-09,04:43:00,16783.0,BUY,3,0.07h,Stop Loss,$-9.00,$-114.00,$50252.00,7,$-114.00
2024-01-09,04:59:00,16781.25,SELL,3,0.03h,Stop Loss,$-9.00,$-123.00,$50243.00,7,$-123.00
2024-01-09,05:05:00,16784.5,BUY,3,0.02h,Stop Loss,$-9.00,$-132.00,$50234.00,7,$-132.00
2024-01-09,05:17:00,16781.5,SELL,3,0.03h,Stop Loss,$-9.00,$-141.00,$50225.00,7,$-141.00
2024-01-09,06:20:00,16777.0,BUY,3,0.02h,Stop Loss,$-9.00,$-150.00,$50216.00,7,$-150.00
2024-01-09,06:21:00,16774.5,SELL,3,0.02h,Stop Loss,$-9.00,$-159.00,$50207.00,7,$-159.00
2024-01-09,06:27:00,16778.0,BUY,3,0.03h,Break Even,$-1.50,$-160.50,$50205.50,7,$-160.50
2024-01-09,07:01:00,16776.0,SELL,3,0.02h,Break Even,$-1.50,$-162.00,$50204.00,7,$-162.00
2024-01-09,09:01:00,16747.75,BUY,3,0.02h,Break Even,$-1.50,$-163.50,$50202.50,7,$-163.50
2024-01-09,09:08:00,16740.5,SELL,3,0.02h,Break Even,$-1.50,$-165.00,$50201.00,7,$-165.00
2024-01-09,09:33:00,16737.0,BUY,3,0.02h,Break Even,$-1.50,$-166.50,$50199.50,7,$-166.50
2024-01-09,10:03:00,16729.25,SELL,3,0.02h,Stop Loss,$-9.00,$-175.50,$50190.50,7,$-175.50
2024-01-09,10:16:00,16737.75,BUY,3,0.02h,Stop Loss,$4.50,$-171.00,$50195.00,7,$-171.00
2024-01-09,10:31:00,16732.0,SELL,3,0.02h,Stop Loss,$-9.00,$-180.00,$50186.00,7,$-180.00
2024-01-09,12:10:00,16703.0,BUY,3,0.02h,Stop Loss,$-9.00,$-189.00,$50177.00,7,$-189.00
2024-01-09,12:32:00,16704.0,SELL,3,0.02h,Stop Loss,$-9.00,$-198.00,$50168.00,7,$-198.00
2024-01-09,12:34:00,16714.25,BUY,3,0.02h,Stop Loss,$16.50,$-181.50,$50184.50,7,$-181.50
2024-01-09,13:04:00,16711.0,SELL,3,0.02h,Stop Loss,$9.00,$-172.50,$50193.50,7,$-172.50
2024-01-09,14:11:00,16677.5,BUY,3,0.02h,Break Even,$-1.50,$-174.00,$50192.00,7,$-174.00
2024-01-09,14:22:00,16670.0,SELL,3,0.02h,Stop Loss,$-9.00,$-183.00,$50183.00,7,$-183.00
2024-01-09,14:24:00,16674.25,BUY,3,0.02h,Stop Loss,$-9.00,$-192.00,$50174.00,7,$-192.00
2024-01-09,14:25:00,16667.75,SELL,3,0.02h,Stop Loss,$-9.00,$-201.00,$50165.00,7,$-201.00
2024-01-09,14:27:00,16676.0,BUY,3,0.02h,Stop Loss,$4.50,$-196.50,$50169.50,7,$-196.50
2024-01-09,14:46:00,16676.0,SELL,3,0.02h,Stop Loss,$4.50,$-192.00,$50174.00,7,$-192.00
2024-01-09,14:57:00,16687.5,BUY,3,0.02h,Stop Loss,$33.00,$-159.00,$50207.00,7,$-159.00
2024-01-09,15:33:00,16713.0,SELL,3,0.02h,Stop Loss,$-9.00,$-168.00,$50198.00,7,$-168.00
2024-01-09,15:36:00,16731.25,BUY,3,0.02h,Stop Loss,$15.00,$-153.00,$50213.00,7,$-153.00
2024-01-09,15:59:00,16729.5,SELL,3,0.02h,Stop Loss,$-9.00,$-162.00,$50204.00,7,$-162.00
2024-01-09,16:02:00,16750.0,BUY,3,0.02h,Stop Loss,$27.00,$-135.00,$50231.00,7,$-135.00
2024-01-09,17:34:00,16816.25,SELL,3,0.02h,Break Even,$-1.50,$-136.50,$50229.50,7,$-136.50
2024-01-09,17:41:00,16828.75,BUY,3,0.02h,Break Even,$-1.50,$-138.00,$50228.00,7,$-138.00
2024-01-09,18:25:00,16837.0,SELL,3,0.02h,Stop Loss,$34.50,$-103.50,$50262.50,7,$-103.50
2024-01-09,18:50:00,16830.5,BUY,3,0.02h,Stop Loss,$46.50,$-57.00,$50309.00,7,$-57.00
2024-01-09,19:15:00,16832.25,SELL,3,0.02h,Stop Loss,$52.50,$-4.50,$50361.50,7,$-4.50
2024-01-09,19:55:00,16826.75,BUY,3,0.02h,Stop Loss,$-9.00,$-13.50,$50352.50,7,$-13.50
2024-01-09,19:56:00,16819.75,SELL,3,0.02h,Break Even,$-1.50,$-15.00,$50351.00,7,$-15.00
2024-01-09,19:57:00,16822.0,BUY,3,0.02h,Break Even,$-1.50,$-16.50,$50349.50,7,$-16.50
2024-01-09,20:08:00,16814.0,SELL,3,0.02h,Stop Loss,$58.50,$42.00,$50408.00,7,$42.00
2024-01-09,20:18:00,16829.5,BUY,3,0.02h,Stop Loss,$-9.00,$33.00,$50399.00,7,$33.00
2024-01-09,20:19:00,16821.25,SELL,3,0.02h,Break Even,$-1.50,$31.50,$50397.50,7,$31.50
2024-01-09,20:20:00,16825.5,BUY,3,0.02h,Stop Loss,$13.50,$45.00,$50411.00,7,$45.00
2024-01-09,20:32:00,16820.75,SELL,3,0.02h,Stop Loss,$3.00,$48.00,$50414.00,7,$48.00
2024-01-09,20:55:00,16829.5,BUY,3,0.02h,Stop Loss,$51.00,$99.00,$50465.00,7,$99.00
2024-01-09,21:29:00,16828.75,SELL,3,0.07h,Break Even,$-1.50,$97.50,$50463.50,7,$97.50
2024-01-09,21:42:00,16831.25,BUY,3,0.02h,Stop Loss,$-9.00,$88.50,$50454.50,7,$88.50
2024-01-09,21:57:00,16828.75,SELL,3,0.02h,Break Even,$-1.50,$87.00,$50453.00,7,$87.00
2024-01-09,23:26:00,16824.0,BUY,3,0.02h,Stop Loss,$-9.00,$78.00,$50444.00,7,$78.00
,,,,,,,,,,,
2024-01-10,00:42:00,16843.5,SELL,3,0.02h,Break Even,$-1.50,$-1.50,$50442.50,8,$-1.50
2024-01-10,01:41:00,16830.25,BUY,3,0.02h,Stop Loss,$-9.00,$-10.50,$50433.50,8,$-10.50
2024-01-10,01:42:00,16827.25,SELL,3,0.02h,Break Even,$-1.50,$-12.00,$50432.00,8,$-12.00
2024-01-10,01:53:00,16830.0,BUY,3,0.08h,Stop Loss,$9.00,$-3.00,$50441.00,8,$-3.00
2024-01-10,02:26:00,16834.25,SELL,3,0.03h,Break Even,$-1.50,$-4.50,$50439.50,8,$-4.50
2024-01-10,02:37:00,16836.25,BUY,3,0.02h,Break Even,$-1.50,$-6.00,$50438.00,8,$-6.00
2024-01-10,03:02:00,16836.5,SELL,3,0.02h,Break Even,$-1.50,$-7.50,$50436.50,8,$-7.50
2024-01-10,04:04:00,16828.0,BUY,3,0.02h,Break Even,$-1.50,$-9.00,$50435.00,8,$-9.00
2024-01-10,04:32:00,16830.25,SELL,3,0.02h,Break Even,$-1.50,$-10.50,$50433.50,8,$-10.50
2024-01-10,04:52:00,16831.0,BUY,3,0.02h,Stop Loss,$-9.00,$-19.50,$50424.50,8,$-19.50
2024-01-10,04:59:00,16828.5,SELL,3,0.03h,Break Even,$-1.50,$-21.00,$50423.00,8,$-21.00
2024-01-10,05:16:00,16830.5,BUY,3,0.02h,Stop Loss,$-9.00,$-30.00,$50414.00,8,$-30.00
2024-01-10,05:20:00,16825.5,SELL,3,0.02h,Break Even,$-1.50,$-31.50,$50412.50,8,$-31.50
2024-01-10,05:49:00,16826.0,BUY,3,0.03h,Break Even,$-1.50,$-33.00,$50411.00,8,$-33.00
2024-01-10,06:19:00,16826.0,SELL,3,0.02h,Stop Loss,$-9.00,$-42.00,$50402.00,8,$-42.00
2024-01-10,06:23:00,16829.25,BUY,3,0.02h,Stop Loss,$-9.00,$-51.00,$50393.00,8,$-51.00
2024-01-10,06:28:00,16824.25,SELL,3,0.02h,Break Even,$-1.50,$-52.50,$50391.50,8,$-52.50
2024-01-10,07:08:00,16820.75,BUY,3,0.02h,Break Even,$-1.50,$-54.00,$50390.00,8,$-54.00
2024-01-10,08:15:00,16846.25,SELL,3,0.02h,Stop Loss,$-9.00,$-63.00,$50381.00,8,$-63.00
2024-01-10,08:18:00,16853.5,BUY,3,0.02h,Break Even,$-1.50,$-64.50,$50379.50,8,$-64.50
2024-01-10,08:41:00,16849.0,SELL,3,0.02h,Break Even,$-1.50,$-66.00,$50378.00,8,$-66.00
2024-01-10,08:47:00,16859.25,BUY,3,0.02h,Break Even,$-1.50,$-67.50,$50376.50,8,$-67.50
2024-01-10,09:49:00,16891.75,SELL,3,0.02h,Stop Loss,$-9.00,$-76.50,$50367.50,8,$-76.50
2024-01-10,09:59:00,16895.75,BUY,3,0.02h,Break Even,$-1.50,$-78.00,$50366.00,8,$-78.00
2024-01-10,10:03:00,16894.5,SELL,3,0.02h,Stop Loss,$-9.00,$-87.00,$50357.00,8,$-87.00
2024-01-10,10:04:00,16897.25,BUY,3,0.02h,Round Number,$13.50,$-73.50,$50370.50,8,$-73.50
2024-01-10,10:12:00,16894.5,SELL,3,0.02h,Break Even,$-1.50,$-75.00,$50369.00,8,$-75.00
2024-01-10,11:08:00,16880.0,BUY,3,0.02h,Break Even,$-1.50,$-76.50,$50367.50,8,$-76.50
2024-01-10,11:21:00,16872.0,SELL,3,0.02h,Stop Loss,$-9.00,$-85.50,$50358.50,8,$-85.50
2024-01-10,12:04:00,16858.25,BUY,3,0.02h,Stop Loss,$24.00,$-61.50,$50382.50,8,$-61.50
2024-01-10,12:37:00,16853.75,SELL,3,0.02h,Stop Loss,$-9.00,$-70.50,$50373.50,8,$-70.50
2024-01-10,13:16:00,16845.25,BUY,3,0.02h,Stop Loss,$-9.00,$-79.50,$50364.50,8,$-79.50
2024-01-10,13:19:00,16840.25,SELL,3,0.02h,Break Even,$-1.50,$-81.00,$50363.00,8,$-81.00
2024-01-10,13:29:00,16847.5,BUY,3,0.02h,Break Even,$-1.50,$-82.50,$50361.50,8,$-82.50
2024-01-10,13:30:00,16839.0,SELL,3,0.02h,Stop Loss,$21.00,$-61.50,$50382.50,8,$-61.50
2024-01-10,14:13:00,16825.5,BUY,3,0.02h,Break Even,$-1.50,$-63.00,$50381.00,8,$-63.00
2024-01-10,14:51:00,16831.75,SELL,3,0.02h,Stop Loss,$75.00,$12.00,$50456.00,8,$12.00
2024-01-10,15:13:00,16843.0,BUY,3,0.02h,Stop Loss,$45.00,$57.00,$50501.00,8,$57.00
2024-01-10,16:12:00,16876.5,SELL,3,0.02h,Stop Loss,$36.00,$93.00,$50537.00,8,$93.00
2024-01-10,16:42:00,16878.75,BUY,3,0.02h,Break Even,$-1.50,$91.50,$50535.50,8,$91.50
2024-01-10,16:53:00,16863.75,SELL,3,0.02h,Break Even,$-1.50,$90.00,$50534.00,8,$90.00
2024-01-10,16:57:00,16878.75,BUY,3,0.02h,Stop Loss,$3.00,$93.00,$50537.00,8,$93.00
2024-01-10,18:12:00,16893.0,SELL,3,0.02h,Stop Loss,$13.50,$106.50,$50550.50,8,$106.50
2024-01-10,18:19:00,16909.5,BUY,3,0.02h,Stop Loss,$-9.00,$97.50,$50541.50,8,$97.50
2024-01-10,18:22:00,16899.0,SELL,3,0.02h,Stop Loss,$9.00,$106.50,$50550.50,8,$106.50
2024-01-10,18:26:00,16910.25,BUY,3,0.02h,Break Even,$-1.50,$105.00,$50549.00,8,$105.00
2024-01-10,19:39:00,16944.25,SELL,3,0.02h,Stop Loss,$-9.00,$96.00,$50540.00,8,$96.00
2024-01-10,19:42:00,16952.0,BUY,3,0.02h,Break Even,$-1.50,$94.50,$50538.50,8,$94.50
2024-01-10,20:16:00,16962.5,SELL,3,0.02h,Break Even,$-1.50,$93.00,$50537.00,8,$93.00
2024-01-10,20:59:00,16946.0,BUY,3,0.02h,Stop Loss,$13.50,$106.50,$50550.50,8,$106.50
2024-01-10,21:42:00,16951.75,SELL,3,0.02h,Stop Loss,$-9.00,$97.50,$50541.50,8,$97.50
2024-01-10,21:43:00,16952.75,BUY,3,0.03h,Break Even,$-1.50,$96.00,$50540.00,8,$96.00
2024-01-10,23:02:00,16947.25,SELL,3,0.02h,Stop Loss,$10.50,$106.50,$50550.50,8,$106.50
2024-01-10,23:14:00,16956.0,BUY,3,0.02h,Break Even,$-1.50,$105.00,$50549.00,8,$105.00
2024-01-10,23:49:00,16960.0,SELL,3,0.02h,Break Even,$-1.50,$103.50,$50547.50,8,$103.50
2024-01-10,23:57:00,16963.75,BUY,3,0.02h,Stop Loss,$-9.00,$94.50,$50538.50,8,$94.50
,,,,,,,,,,,
2024-01-11,00:00:00,16960.75,SELL,3,0.03h,Stop Loss,$-9.00,$-9.00,$50529.50,9,$-9.00
2024-01-11,00:04:00,16964.75,BUY,3,0.02h,Break Even,$-1.50,$-10.50,$50528.00,9,$-10.50
2024-01-11,00:10:00,16959.5,SELL,3,0.02h,Stop Loss,$-9.00,$-19.50,$50519.00,9,$-19.50
2024-01-11,00:14:00,16963.5,BUY,3,0.03h,Break Even,$-1.50,$-21.00,$50517.50,9,$-21.00
2024-01-11,01:27:00,16981.75,SELL,3,0.02h,Break Even,$-1.50,$-22.50,$50516.00,9,$-22.50
2024-01-11,01:36:00,16989.25,BUY,3,0.02h,Stop Loss,$-9.00,$-31.50,$50507.00,9,$-31.50
2024-01-11,02:01:00,16984.25,SELL,3,0.03h,Stop Loss,$-9.00,$-40.50,$50498.00,9,$-40.50
2024-01-11,02:04:00,16988.75,BUY,3,0.02h,Stop Loss,$-9.00,$-49.50,$50489.00,9,$-49.50
2024-01-11,02:37:00,16990.25,SELL,3,0.02h,Stop Loss,$-9.00,$-58.50,$50480.00,9,$-58.50
2024-01-11,02:51:00,16992.75,BUY,3,0.02h,Stop Loss,$-9.00,$-67.50,$50471.00,9,$-67.50
2024-01-11,04:20:00,17003.0,SELL,3,0.02h,Stop Loss,$-9.00,$-76.50,$50462.00,9,$-76.50
2024-01-11,05:04:00,17000.75,BUY,3,0.02h,Stop Loss,$-9.00,$-85.50,$50453.00,9,$-85.50
2024-01-11,05:25:00,16993.0,SELL,3,0.02h,Break Even,$-1.50,$-87.00,$50451.50,9,$-87.00
2024-01-11,05:44:00,17000.25,BUY,3,0.02h,Break Even,$-1.50,$-88.50,$50450.00,9,$-88.50
2024-01-11,05:52:00,16996.75,SELL,3,0.02h,Stop Loss,$-9.00,$-97.50,$50441.00,9,$-97.50
2024-01-11,05:54:00,16999.5,BUY,3,0.02h,Stop Loss,$-9.00,$-106.50,$50432.00,9,$-106.50
2024-01-11,05:55:00,16995.25,SELL,3,0.02h,Stop Loss,$-9.00,$-115.50,$50423.00,9,$-115.50
2024-01-11,06:03:00,16999.75,BUY,3,0.02h,Stop Loss,$-9.00,$-124.50,$50414.00,9,$-124.50
2024-01-11,06:04:00,16997.5,SELL,3,0.02h,Break Even,$-1.50,$-126.00,$50412.50,9,$-126.00
2024-01-11,06:13:00,17000.25,BUY,3,0.05h,Stop Loss,$-9.00,$-135.00,$50403.50,9,$-135.00
2024-01-11,07:17:00,17007.0,SELL,3,0.02h,Stop Loss,$-9.00,$-144.00,$50394.50,9,$-144.00
2024-01-11,07:25:00,17011.75,BUY,3,0.02h,Break Even,$-1.50,$-145.50,$50393.00,9,$-145.50
2024-01-11,07:34:00,17008.25,SELL,3,0.02h,Break Even,$-1.50,$-147.00,$50391.50,9,$-147.00
2024-01-11,07:42:00,17014.75,BUY,3,0.02h,Break Even,$-1.50,$-148.50,$50390.00,9,$-148.50
2024-01-11,07:53:00,17010.75,SELL,3,0.02h,Stop Loss,$-9.00,$-157.50,$50381.00,9,$-157.50
2024-01-11,07:54:00,17013.5,BUY,3,0.02h,Stop Loss,$6.00,$-151.50,$50387.00,9,$-151.50
2024-01-11,07:56:00,17010.0,SELL,3,0.02h,Stop Loss,$-9.00,$-160.50,$50378.00,9,$-160.50
2024-01-11,08:10:00,17016.25,BUY,3,0.02h,Stop Loss,$-9.00,$-169.50,$50369.00,9,$-169.50
2024-01-11,09:03:00,17035.75,SELL,3,0.02h,Stop Loss,$-9.00,$-178.50,$50360.00,9,$-178.50
2024-01-11,10:03:00,17006.75,BUY,3,0.02h,Stop Loss,$-9.00,$-187.50,$50351.00,9,$-187.50
2024-01-11,10:07:00,17002.25,SELL,3,0.02h,Stop Loss,$6.00,$-181.50,$50357.00,9,$-181.50
2024-01-11,10:23:00,17003.0,BUY,3,0.02h,Stop Loss,$-9.00,$-190.50,$50348.00,9,$-190.50
2024-01-11,10:26:00,16997.75,SELL,3,0.02h,Stop Loss,$-9.00,$-199.50,$50339.00,9,$-199.50
2024-01-11,10:27:00,17003.5,BUY,3,0.02h,Break Even,$-1.50,$-201.00,$50337.50,9,$-201.00
2024-01-11,10:39:00,16999.5,SELL,3,0.02h,Stop Loss,$-9.00,$-210.00,$50328.50,9,$-210.00
2024-01-11,10:48:00,17003.25,BUY,3,0.02h,Stop Loss,$-9.00,$-219.00,$50319.50,9,$-219.00
2024-01-11,10:50:00,16999.75,SELL,3,0.02h,Break Even,$-1.50,$-220.50,$50318.00,9,$-220.50
2024-01-11,10:59:00,17002.0,BUY,3,0.02h,Break Even,$-1.50,$-222.00,$50316.50,9,$-222.00
2024-01-11,11:28:00,17012.75,SELL,3,0.02h,Break Even,$-1.50,$-223.50,$50315.00,9,$-223.50
2024-01-11,12:00:00,17007.75,BUY,3,0.02h,Break Even,$-1.50,$-225.00,$50313.50,9,$-225.00
2024-01-11,12:12:00,17001.75,SELL,3,0.02h,Stop Loss,$-9.00,$-234.00,$50304.50,9,$-234.00
2024-01-11,12:23:00,17010.75,BUY,3,0.02h,Stop Loss,$-9.00,$-243.00,$50295.50,9,$-243.00
2024-01-11,12:56:00,17007.25,SELL,3,0.02h,Stop Loss,$-9.00,$-252.00,$50286.50,9,$-252.00
2024-01-11,13:18:00,17009.0,BUY,3,0.02h,Stop Loss,$-9.00,$-261.00,$50277.50,9,$-261.00
2024-01-11,13:31:00,16956.25,SELL,3,0.02h,Stop Loss,$300.00,$39.00,$50577.50,9,$39.00
2024-01-11,14:10:00,16943.0,BUY,3,0.02h,Stop Loss,$10.50,$49.50,$50588.00,9,$49.50
2024-01-11,14:47:00,16972.5,SELL,3,0.02h,Stop Loss,$54.00,$103.50,$50642.00,9,$103.50
2024-01-11,15:29:00,16890.0,BUY,3,0.02h,Break Even,$-1.50,$102.00,$50640.50,9,$102.00
2024-01-11,15:50:00,16874.75,SELL,3,0.02h,Stop Loss,$72.00,$174.00,$50712.50,9,$174.00
2024-01-11,17:05:00,16794.25,BUY,3,0.02h,Stop Loss,$27.00,$201.00,$50739.50,9,$201.00
2024-01-11,17:29:00,16793.0,SELL,3,0.02h,Stop Loss,$54.00,$255.00,$50793.50,9,$255.00
2024-01-11,17:41:00,16811.0,BUY,3,0.02h,Stop Loss,$63.00,$318.00,$50856.50,9,$318.00
2024-01-11,19:25:00,16924.0,SELL,3,0.02h,Stop Loss,$-9.00,$309.00,$50847.50,9,$309.00
2024-01-11,19:26:00,16931.25,BUY,3,0.02h,Stop Loss,$10.50,$319.50,$50858.00,9,$319.50
2024-01-11,20:06:00,16949.75,SELL,3,0.02h,Stop Loss,$-9.00,$310.50,$50849.00,9,$310.50
2024-01-11,20:26:00,16957.25,BUY,3,0.02h,Stop Loss,$3.00,$313.50,$50852.00,9,$313.50
2024-01-11,20:38:00,16944.5,SELL,3,0.02h,Break Even,$-1.50,$312.00,$50850.50,9,$312.00
2024-01-11,20:50:00,16953.5,BUY,3,0.02h,Stop Loss,$3.00,$315.00,$50853.50,9,$315.00
2024-01-11,20:52:00,16941.75,SELL,3,0.02h,Stop Loss,$52.50,$367.50,$50906.00,9,$367.50
2024-01-11,20:55:00,16955.25,BUY,3,0.02h,Stop Loss,$19.50,$387.00,$50925.50,9,$387.00
2024-01-11,21:28:00,16961.5,SELL,3,0.02h,Stop Loss,$-9.00,$378.00,$50916.50,9,$378.00
2024-01-11,23:26:00,16955.5,BUY,3,0.02h,Break Even,$-1.50,$376.50,$50915.00,9,$376.50
2024-01-11,23:38:00,16948.5,SELL,3,0.02h,Break Even,$-1.50,$375.00,$50913.50,9,$375.00
2024-01-11,23:59:00,16953.0,BUY,3,0.02h,Break Even,$-1.50,$373.50,$50912.00,9,$373.50
,,,,,,,,,,,
2024-01-12,00:19:00,16953.75,SELL,3,0.02h,Stop Loss,$-9.00,$-9.00,$50903.00,10,$-9.00
2024-01-12,00:20:00,16959.25,BUY,3,0.02h,Stop Loss,$-9.00,$-18.00,$50894.00,10,$-18.00
2024-01-12,00:31:00,16954.0,SELL,3,0.02h,Stop Loss,$3.00,$-15.00,$50897.00,10,$-15.00
2024-01-12,01:37:00,16933.0,BUY,3,0.02h,Break Even,$-1.50,$-16.50,$50895.50,10,$-16.50
2024-01-12,03:03:00,16954.75,SELL,3,0.02h,Break Even,$-1.50,$-18.00,$50894.00,10,$-18.00
2024-01-12,03:21:00,16958.5,BUY,3,0.02h,Stop Loss,$-9.00,$-27.00,$50885.00,10,$-27.00
2024-01-12,03:41:00,16955.5,SELL,3,0.02h,Stop Loss,$-9.00,$-36.00,$50876.00,10,$-36.00
2024-01-12,03:53:00,16957.25,BUY,3,0.02h,Stop Loss,$-9.00,$-45.00,$50867.00,10,$-45.00
2024-01-12,03:54:00,16956.25,SELL,3,0.07h,Stop Loss,$-9.00,$-54.00,$50858.00,10,$-54.00
2024-01-12,04:02:00,16957.5,BUY,3,0.03h,Stop Loss,$-9.00,$-63.00,$50849.00,10,$-63.00
2024-01-12,04:04:00,16954.0,SELL,3,0.02h,Stop Loss,$4.50,$-58.50,$50853.50,10,$-58.50
2024-01-12,04:51:00,16943.5,BUY,3,0.03h,Stop Loss,$-9.00,$-67.50,$50844.50,10,$-67.50
2024-01-12,04:55:00,16943.0,SELL,3,0.02h,Stop Loss,$-9.00,$-76.50,$50835.50,10,$-76.50
2024-01-12,04:56:00,16944.25,BUY,3,0.15h,Stop Loss,$13.50,$-63.00,$50849.00,10,$-63.00
2024-01-12,05:42:00,16949.25,SELL,3,0.02h,Break Even,$-1.50,$-64.50,$50847.50,10,$-64.50
2024-01-12,06:15:00,16947.75,BUY,3,0.10h,Break Even,$-1.50,$-66.00,$50846.00,10,$-66.00
2024-01-12,06:39:00,16945.25,SELL,3,0.03h,Break Even,$-1.50,$-67.50,$50844.50,10,$-67.50
2024-01-12,06:50:00,16950.5,BUY,3,0.02h,Break Even,$-1.50,$-69.00,$50843.00,10,$-69.00
2024-01-12,07:05:00,16941.75,SELL,3,0.02h,Stop Loss,$-9.00,$-78.00,$50834.00,10,$-78.00
2024-01-12,07:21:00,16951.75,BUY,3,0.02h,Break Even,$-1.50,$-79.50,$50832.50,10,$-79.50
2024-01-12,07:25:00,16944.25,SELL,3,0.02h,Break Even,$-1.50,$-81.00,$50831.00,10,$-81.00
2024-01-12,08:06:00,16937.5,BUY,3,0.02h,Break Even,$-1.50,$-82.50,$50829.50,10,$-82.50
2024-01-12,08:44:00,16948.75,SELL,3,0.02h,Stop Loss,$-9.00,$-91.50,$50820.50,10,$-91.50
2024-01-12,08:56:00,16953.75,BUY,3,0.02h,Break Even,$-1.50,$-93.00,$50819.00,10,$-93.00
2024-01-12,09:22:00,16955.5,SELL,3,0.02h,Break Even,$-1.50,$-94.50,$50817.50,10,$-94.50
2024-01-12,09:36:00,16962.0,BUY,3,0.02h,Break Even,$-1.50,$-96.00,$50816.00,10,$-96.00
2024-01-12,09:39:00,16951.25,SELL,3,0.02h,Stop Loss,$25.50,$-70.50,$50841.50,10,$-70.50
2024-01-12,10:20:00,16937.5,BUY,3,0.02h,Stop Loss,$10.50,$-60.00,$50852.00,10,$-60.00
2024-01-12,10:41:00,16935.25,SELL,3,0.02h,Break Even,$-1.50,$-61.50,$50850.50,10,$-61.50
2024-01-12,11:04:00,16929.25,BUY,3,0.02h,Break Even,$-1.50,$-63.00,$50849.00,10,$-63.00
2024-01-12,11:07:00,16921.0,SELL,3,0.02h,Stop Loss,$6.00,$-57.00,$50855.00,10,$-57.00
2024-01-12,12:04:00,16904.0,BUY,3,0.02h,Stop Loss,$-9.00,$-66.00,$50846.00,10,$-66.00
2024-01-12,12:21:00,16890.0,SELL,3,0.02h,Stop Loss,$-9.00,$-75.00,$50837.00,10,$-75.00
2024-01-12,12:24:00,16903.0,BUY,3,0.02h,Stop Loss,$3.00,$-72.00,$50840.00,10,$-72.00
2024-01-12,12:57:00,16911.0,SELL,3,0.02h,Stop Loss,$3.00,$-69.00,$50843.00,10,$-69.00
2024-01-12,13:04:00,16925.0,BUY,3,0.02h,Break Even,$-1.50,$-70.50,$50841.50,10,$-70.50
2024-01-12,13:10:00,16909.0,SELL,3,0.02h,Break Even,$-1.50,$-72.00,$50840.00,10,$-72.00
2024-01-12,13:31:00,16952.5,BUY,3,0.02h,Stop Loss,$94.50,$22.50,$50934.50,10,$22.50
2024-01-12,15:00:00,16986.25,SELL,3,0.02h,Stop Loss,$193.50,$216.00,$51128.00,10,$216.00
2024-01-12,15:32:00,16984.0,BUY,3,0.02h,Stop Loss,$13.50,$229.50,$51141.50,10,$229.50
2024-01-12,15:40:00,16956.25,SELL,3,0.02h,Break Even,$-1.50,$228.00,$51140.00,10,$228.00
2024-01-12,16:07:00,16958.0,BUY,3,0.02h,Stop Loss,$40.50,$268.50,$51180.50,10,$268.50
2024-01-12,16:37:00,16963.5,SELL,3,0.02h,Stop Loss,$150.00,$418.50,$51330.50,10,$418.50
2024-01-12,17:15:00,16940.0,BUY,3,0.02h,Stop Loss,$7.50,$426.00,$51338.00,10,$426.00
2024-01-12,17:28:00,16936.0,SELL,3,0.02h,Stop Loss,$18.00,$444.00,$51356.00,10,$444.00
2024-01-12,17:31:00,16949.75,BUY,3,0.02h,Stop Loss,$9.00,$453.00,$51365.00,10,$453.00
2024-01-12,17:38:00,16935.25,SELL,3,0.02h,Stop Loss,$-9.00,$444.00,$51356.00,10,$444.00
2024-01-12,17:54:00,16957.5,BUY,3,0.02h,Stop Loss,$9.00,$453.00,$51365.00,10,$453.00
2024-01-12,19:23:00,16969.25,SELL,3,0.02h,Stop Loss,$-9.00,$444.00,$51356.00,10,$444.00
2024-01-12,20:30:00,16953.75,BUY,3,0.02h,Stop Loss,$9.00,$453.00,$51365.00,10,$453.00
2024-01-12,21:05:00,16959.75,SELL,3,0.02h,Stop Loss,$-9.00,$444.00,$51356.00,10,$444.00
2024-01-12,21:58:00,16955.25,BUY,3,0.02h,Break Even,$-1.50,$442.50,$51354.50,10,$442.50
,,,,,,,,,,,
2024-01-15,00:00:00,16945.25,SELL,3,0.02h,Break Even,$-1.50,$-1.50,$51353.00,11,$-1.50
2024-01-15,00:24:00,16948.5,BUY,3,0.02h,Break Even,$-1.50,$-3.00,$51351.50,11,$-3.00
2024-01-15,01:18:00,16955.75,SELL,3,0.05h,Break Even,$-1.50,$-4.50,$51350.00,11,$-4.50
2024-01-15,01:42:00,16957.5,BUY,3,0.02h,Stop Loss,$-9.00,$-13.50,$51341.00,11,$-13.50
2024-01-15,04:02:00,16983.0,SELL,3,0.02h,Break Even,$-1.50,$-15.00,$51339.50,11,$-15.00
2024-01-15,04:29:00,16986.25,BUY,3,0.02h,Break Even,$-1.50,$-16.50,$51338.00,11,$-16.50
2024-01-15,05:11:00,16985.0,SELL,3,0.02h,Break Even,$-1.50,$-18.00,$51336.50,11,$-18.00
2024-01-15,05:57:00,16984.25,BUY,3,0.03h,Stop Loss,$-9.00,$-27.00,$51327.50,11,$-27.00
2024-01-15,07:25:00,17010.75,SELL,3,0.02h,Break Even,$-1.50,$-28.50,$51326.00,11,$-28.50
2024-01-15,08:06:00,17008.0,BUY,3,0.02h,Stop Loss,$-9.00,$-37.50,$51317.00,11,$-37.50
2024-01-15,08:32:00,16999.75,SELL,3,0.02h,Break Even,$-1.50,$-39.00,$51315.50,11,$-39.00
2024-01-15,09:17:00,16977.25,BUY,3,0.02h,Stop Loss,$-9.00,$-48.00,$51306.50,11,$-48.00
2024-01-15,09:39:00,16973.0,SELL,3,0.02h,Stop Loss,$-9.00,$-57.00,$51297.50,11,$-57.00
2024-01-15,10:07:00,16972.75,BUY,3,0.02h,Stop Loss,$-9.00,$-66.00,$51288.50,11,$-66.00
2024-01-15,10:15:00,16962.5,SELL,3,0.02h,Stop Loss,$3.00,$-63.00,$51291.50,11,$-63.00
2024-01-15,10:25:00,16971.5,BUY,3,0.02h,Break Even,$-1.50,$-64.50,$51290.00,11,$-64.50
2024-01-15,10:36:00,16961.25,SELL,3,0.02h,Break Even,$-1.50,$-66.00,$51288.50,11,$-66.00
2024-01-15,10:41:00,16969.5,BUY,3,0.02h,Break Even,$-1.50,$-67.50,$51287.00,11,$-67.50
2024-01-15,10:48:00,16964.0,SELL,3,0.02h,Stop Loss,$-9.00,$-76.50,$51278.00,11,$-76.50
2024-01-15,10:51:00,16967.75,BUY,3,0.02h,Break Even,$-1.50,$-78.00,$51276.50,11,$-78.00
2024-01-15,11:06:00,16964.75,SELL,3,0.02h,Break Even,$-1.50,$-79.50,$51275.00,11,$-79.50
2024-01-15,11:39:00,16963.25,BUY,3,0.02h,Stop Loss,$6.00,$-73.50,$51281.00,11,$-73.50
2024-01-15,12:35:00,16973.25,SELL,3,0.02h,Break Even,$-1.50,$-75.00,$51279.50,11,$-75.00
2024-01-15,13:22:00,16964.25,BUY,3,0.02h,Stop Loss,$-9.00,$-84.00,$51270.50,11,$-84.00
2024-01-15,13:41:00,16959.0,SELL,3,0.02h,Break Even,$-1.50,$-85.50,$51269.00,11,$-85.50
2024-01-15,14:27:00,16954.75,BUY,3,0.03h,Stop Loss,$10.50,$-75.00,$51279.50,11,$-75.00
2024-01-15,14:47:00,16951.25,SELL,3,0.02h,Break Even,$-1.50,$-76.50,$51278.00,11,$-76.50
2024-01-15,15:03:00,16956.25,BUY,3,0.02h,Stop Loss,$-9.00,$-85.50,$51269.00,11,$-85.50
2024-01-15,15:05:00,16949.0,SELL,3,0.02h,Stop Loss,$-9.00,$-94.50,$51260.00,11,$-94.50
2024-01-15,15:26:00,16954.25,BUY,3,0.02h,Stop Loss,$-9.00,$-103.50,$51251.00,11,$-103.50
2024-01-15,16:11:00,16968.5,SELL,3,0.02h,Stop Loss,$-9.00,$-112.50,$51242.00,11,$-112.50
2024-01-15,16:28:00,16972.25,BUY,3,0.03h,Break Even,$-1.50,$-114.00,$51240.50,11,$-114.00
2024-01-15,16:47:00,16970.5,SELL,3,0.03h,Stop Loss,$-9.00,$-123.00,$51231.50,11,$-123.00
2024-01-15,17:09:00,16970.25,BUY,3,0.02h,Break Even,$-1.50,$-124.50,$51230.00,11,$-124.50
2024-01-15,17:22:00,16965.25,SELL,3,0.02h,Stop Loss,$-9.00,$-133.50,$51221.00,11,$-133.50
2024-01-15,17:27:00,16971.0,BUY,3,0.02h,Break Even,$-1.50,$-135.00,$51219.50,11,$-135.00
2024-01-15,17:39:00,16965.5,SELL,3,0.03h,Break Even,$-1.50,$-136.50,$51218.00,11,$-136.50
2024-01-15,17:50:00,16969.5,BUY,3,0.02h,Stop Loss,$-9.00,$-145.50,$51209.00,11,$-145.50
2024-01-15,17:52:00,16966.5,SELL,3,0.02h,Stop Loss,$-9.00,$-154.50,$51200.00,11,$-154.50
2024-01-15,17:56:00,16969.0,BUY,3,0.03h,Stop Loss,$-9.00,$-163.50,$51191.00,11,$-163.50
2024-01-15,23:01:00,16961.25,SELL,3,0.02h,Break Even,$-1.50,$-165.00,$51189.50,11,$-165.00
,,,,,,,,,,,
2024-01-16,01:25:00,16896.5,BUY,3,0.02h,Stop Loss,$-9.00,$-9.00,$51180.50,12,$-9.00
2024-01-16,01:26:00,16893.5,SELL,3,0.02h,Stop Loss,$-9.00,$-18.00,$51171.50,12,$-18.00
2024-01-16,01:27:00,16895.5,BUY,3,0.02h,Break Even,$-1.50,$-19.50,$51170.00,12,$-19.50
2024-01-16,02:04:00,16904.75,SELL,3,0.02h,Break Even,$-1.50,$-21.00,$51168.50,12,$-21.00
2024-01-16,02:09:00,16912.25,BUY,3,0.02h,Stop Loss,$-9.00,$-30.00,$51159.50,12,$-30.00
2024-01-16,02:31:00,16908.0,SELL,3,0.02h,Stop Loss,$4.50,$-25.50,$51164.00,12,$-25.50
2024-01-16,03:53:00,16894.25,BUY,3,0.03h,Stop Loss,$-9.00,$-34.50,$51155.00,12,$-34.50
2024-01-16,04:12:00,16892.0,SELL,3,0.02h,Stop Loss,$-9.00,$-43.50,$51146.00,12,$-43.50
2024-01-16,04:13:00,16894.5,BUY,3,0.07h,Break Even,$-1.50,$-45.00,$51144.50,12,$-45.00
2024-01-16,04:29:00,16893.0,SELL,3,0.02h,Break Even,$-1.50,$-46.50,$51143.00,12,$-46.50
2024-01-16,04:57:00,16895.25,BUY,3,0.02h,Stop Loss,$-9.00,$-55.50,$51134.00,12,$-55.50
2024-01-16,05:06:00,16890.75,SELL,3,0.03h,Stop Loss,$-9.00,$-64.50,$51125.00,12,$-64.50
2024-01-16,05:10:00,16894.5,BUY,3,0.02h,Break Even,$-1.50,$-66.00,$51123.50,12,$-66.00
2024-01-16,05:24:00,16891.25,SELL,3,0.02h,Stop Loss,$-9.00,$-75.00,$51114.50,12,$-75.00
2024-01-16,06:26:00,16877.25,BUY,3,0.08h,Stop Loss,$-9.00,$-84.00,$51105.50,12,$-84.00
2024-01-16,06:46:00,16871.5,SELL,3,0.02h,Stop Loss,$-9.00,$-93.00,$51096.50,12,$-93.00
2024-01-16,06:49:00,16876.0,BUY,3,0.05h,Stop Loss,$16.50,$-76.50,$51113.00,12,$-76.50
2024-01-16,07:11:00,16875.5,SELL,3,0.02h,Break Even,$-1.50,$-78.00,$51111.50,12,$-78.00
2024-01-16,07:30:00,16877.75,BUY,3,0.02h,Stop Loss,$-9.00,$-87.00,$51102.50,12,$-87.00
2024-01-16,07:59:00,16879.25,SELL,3,0.02h,Stop Loss,$-9.00,$-96.00,$51093.50,12,$-96.00
2024-01-16,08:40:00,16839.5,BUY,3,0.02h,Stop Loss,$-9.00,$-105.00,$51084.50,12,$-105.00
2024-01-16,08:43:00,16831.5,SELL,3,0.02h,Break Even,$-1.50,$-106.50,$51083.00,12,$-106.50
2024-01-16,08:48:00,16836.75,BUY,3,0.02h,Break Even,$-1.50,$-108.00,$51081.50,12,$-108.00
2024-01-16,09:26:00,16847.5,SELL,3,0.02h,Stop Loss,$15.00,$-93.00,$51096.50,12,$-93.00
2024-01-16,09:35:00,16860.5,BUY,3,0.02h,Stop Loss,$-9.00,$-102.00,$51087.50,12,$-102.00
2024-01-16,09:49:00,16848.5,SELL,3,0.02h,Break Even,$-1.50,$-103.50,$51086.00,12,$-103.50
2024-01-16,09:55:00,16858.5,BUY,3,0.02h,Stop Loss,$-9.00,$-112.50,$51077.00,12,$-112.50
2024-01-16,10:01:00,16850.0,SELL,3,0.02h,Stop Loss,$6.00,$-106.50,$51083.00,12,$-106.50
2024-01-16,10:39:00,16846.75,BUY,3,0.02h,Stop Loss,$12.00,$-94.50,$51095.00,12,$-94.50
2024-01-16,10:57:00,16841.25,SELL,3,0.02h,Stop Loss,$-9.00,$-103.50,$51086.00,12,$-103.50
2024-01-16,11:01:00,16849.5,BUY,3,0.02h,Break Even,$-1.50,$-105.00,$51084.50,12,$-105.00
2024-01-16,12:20:00,16878.25,SELL,3,0.02h,Stop Loss,$-9.00,$-114.00,$51075.50,12,$-114.00
2024-01-16,12:28:00,16891.5,BUY,3,0.02h,Break Even,$-1.50,$-115.50,$51074.00,12,$-115.50
2024-01-16,13:08:00,16906.5,SELL,3,0.02h,Break Even,$-1.50,$-117.00,$51072.50,12,$-117.00
2024-01-16,13:34:00,16909.0,BUY,3,0.02h,Stop Loss,$61.50,$-55.50,$51134.00,12,$-55.50
2024-01-16,13:52:00,16901.25,SELL,3,0.02h,Stop Loss,$13.50,$-42.00,$51147.50,12,$-42.00
2024-01-16,14:27:00,16905.75,BUY,3,0.02h,Break Even,$-1.50,$-43.50,$51146.00,12,$-43.50
2024-01-16,14:42:00,16884.0,SELL,3,0.02h,Stop Loss,$61.50,$18.00,$51207.50,12,$18.00
2024-01-16,14:59:00,16903.75,BUY,3,0.02h,Stop Loss,$75.00,$93.00,$51282.50,12,$93.00
2024-01-16,16:01:00,16977.75,SELL,3,0.02h,Stop Loss,$240.00,$333.00,$51522.50,12,$333.00
2024-01-16,16:20:00,16989.75,BUY,3,0.02h,Stop Loss,$27.00,$360.00,$51549.50,12,$360.00
2024-01-16,16:43:00,16997.0,SELL,3,0.02h,Stop Loss,$78.00,$438.00,$51627.50,12,$438.00
2024-01-16,18:12:00,16911.5,BUY,3,0.02h,Stop Loss,$-9.00,$429.00,$51618.50,12,$429.00
2024-01-16,18:43:00,16921.0,SELL,3,0.02h,Stop Loss,$15.00,$444.00,$51633.50,12,$444.00
2024-01-16,19:29:00,16894.75,BUY,3,0.02h,Break Even,$-1.50,$442.50,$51632.00,12,$442.50
2024-01-16,19:32:00,16882.0,SELL,3,0.02h,Break Even,$-1.50,$441.00,$51630.50,12,$441.00
2024-01-16,19:35:00,16898.0,BUY,3,0.02h,Break Even,$-1.50,$439.50,$51629.00,12,$439.50
2024-01-16,20:32:00,16929.0,SELL,3,0.02h,Break Even,$-1.50,$438.00,$51627.50,12,$438.00
2024-01-16,20:41:00,16936.0,BUY,3,0.02h,Break Even,$-1.50,$436.50,$51626.00,12,$436.50
2024-01-16,23:06:00,16972.5,SELL,3,0.02h,Break Even,$-1.50,$435.00,$51624.50,12,$435.00
2024-01-16,23:26:00,16974.0,BUY,3,0.02h,Stop Loss,$-9.00,$426.00,$51615.50,12,$426.00
2024-01-16,23:27:00,16972.5,SELL,3,0.02h,Stop Loss,$-9.00,$417.00,$51606.50,12,$417.00
2024-01-16,23:30:00,16974.5,BUY,3,0.02h,Stop Loss,$-9.00,$408.00,$51597.50,12,$408.00
2024-01-16,23:37:00,16972.75,SELL,3,0.02h,Stop Loss,$-9.00,$399.00,$51588.50,12,$399.00
2024-01-16,23:52:00,16976.0,BUY,3,0.02h,Stop Loss,$-9.00,$390.00,$51579.50,12,$390.00
,,,,,,,,,,,
2024-01-17,00:07:00,16972.5,SELL,3,0.02h,Stop Loss,$6.00,$6.00,$51585.50,13,$6.00
2024-01-17,01:19:00,16958.75,BUY,3,0.02h,Break Even,$-1.50,$4.50,$51584.00,13,$4.50
2024-01-17,01:39:00,16955.5,SELL,3,0.02h,Break Even,$-1.50,$3.00,$51582.50,13,$3.00
2024-01-17,02:11:00,16951.75,BUY,3,0.02h,Break Even,$-1.50,$1.50,$51581.00,13,$1.50
2024-01-17,02:16:00,16949.5,SELL,3,0.02h,Stop Loss,$3.00,$4.50,$51584.00,13,$4.50
2024-01-17,03:45:00,16924.5,BUY,3,0.02h,Stop Loss,$-9.00,$-4.50,$51575.00,13,$-4.50
2024-01-17,03:50:00,16921.5,SELL,3,0.02h,Stop Loss,$-9.00,$-13.50,$51566.00,13,$-13.50
2024-01-17,04:14:00,16917.0,BUY,3,0.02h,Break Even,$-1.50,$-15.00,$51564.50,13,$-15.00
2024-01-17,04:22:00,16911.0,SELL,3,0.02h,Stop Loss,$-9.00,$-24.00,$51555.50,13,$-24.00
2024-01-17,04:30:00,16915.5,BUY,3,0.02h,Break Even,$-1.50,$-25.50,$51554.00,13,$-25.50
2024-01-17,05:01:00,16919.25,SELL,3,0.02h,Stop Loss,$-9.00,$-34.50,$51545.00,13,$-34.50
2024-01-17,06:56:00,16851.0,BUY,3,0.03h,Stop Loss,$-9.00,$-43.50,$51536.00,13,$-43.50
2024-01-17,07:00:00,16843.25,SELL,3,0.02h,Break Even,$-1.50,$-45.00,$51534.50,13,$-45.00
2024-01-17,07:40:00,16836.25,BUY,3,0.02h,Break Even,$-1.50,$-46.50,$51533.00,13,$-46.50
2024-01-17,07:44:00,16828.5,SELL,3,0.02h,Stop Loss,$13.50,$-33.00,$51546.50,13,$-33.00
2024-01-17,07:51:00,16833.5,BUY,3,0.02h,Break Even,$-1.50,$-34.50,$51545.00,13,$-34.50
2024-01-17,08:48:00,16843.25,SELL,3,0.02h,Stop Loss,$-9.00,$-43.50,$51536.00,13,$-43.50
2024-01-17,09:22:00,16840.0,BUY,3,0.02h,Stop Loss,$37.50,$-6.00,$51573.50,13,$-6.00
2024-01-17,10:28:00,16869.0,SELL,3,0.02h,Break Even,$-1.50,$-7.50,$51572.00,13,$-7.50
2024-01-17,10:59:00,16869.0,BUY,3,0.02h,Break Even,$-1.50,$-9.00,$51570.50,13,$-9.00
2024-01-17,11:05:00,16860.75,SELL,3,0.02h,Break Even,$-1.50,$-10.50,$51569.00,13,$-10.50
2024-01-17,11:26:00,16863.0,BUY,3,0.02h,Stop Loss,$10.50,$0.00,$51579.50,13,$0.00
2024-01-17,12:13:00,16884.25,SELL,3,0.02h,Break Even,$-1.50,$-1.50,$51578.00,13,$-1.50
2024-01-17,12:16:00,16892.75,BUY,3,0.02h,Stop Loss,$-9.00,$-10.50,$51569.00,13,$-10.50
2024-01-17,12:39:00,16892.75,SELL,3,0.02h,Stop Loss,$4.50,$-6.00,$51573.50,13,$-6.00
2024-01-17,12:56:00,16899.25,BUY,3,0.02h,Break Even,$-1.50,$-7.50,$51572.00,13,$-7.50
2024-01-17,13:01:00,16882.5,SELL,3,0.02h,Break Even,$-1.50,$-9.00,$51570.50,13,$-9.00
2024-01-17,14:11:00,16834.0,BUY,3,0.02h,Break Even,$-1.50,$-10.50,$51569.00,13,$-10.50
2024-01-17,14:25:00,16821.5,SELL,3,0.02h,Stop Loss,$3.00,$-7.50,$51572.00,13,$-7.50
2024-01-17,15:10:00,16735.5,BUY,3,0.02h,Stop Loss,$-9.00,$-16.50,$51563.00,13,$-16.50
2024-01-17,15:22:00,16722.75,SELL,3,0.02h,Stop Loss,$16.50,$0.00,$51579.50,13,$0.00
2024-01-17,15:26:00,16745.75,BUY,3,0.02h,Stop Loss,$37.50,$37.50,$51617.00,13,$37.50
2024-01-17,15:58:00,16757.25,SELL,3,0.02h,Stop Loss,$9.00,$46.50,$51626.00,13,$46.50
2024-01-17,16:00:00,16769.25,BUY,3,0.02h,Stop Loss,$42.00,$88.50,$51668.00,13,$88.50
2024-01-17,16:52:00,16803.0,SELL,3,0.02h,Stop Loss,$-9.00,$79.50,$51659.00,13,$79.50
2024-01-17,17:15:00,16817.0,BUY,3,0.02h,Stop Loss,$13.50,$93.00,$51672.50,13,$93.00
2024-01-17,17:22:00,16806.5,SELL,3,0.02h,Stop Loss,$28.50,$121.50,$51701.00,13,$121.50
2024-01-17,17:52:00,16800.0,BUY,3,0.02h,Stop Loss,$13.50,$135.00,$51714.50,13,$135.00
2024-01-17,18:12:00,16792.75,SELL,3,0.02h,Break Even,$-1.50,$133.50,$51713.00,13,$133.50
2024-01-17,18:59:00,16763.25,BUY,3,0.02h,Stop Loss,$-9.00,$124.50,$51704.00,13,$124.50
2024-01-17,20:04:00,16811.25,SELL,3,0.02h,Break Even,$-1.50,$123.00,$51702.50,13,$123.00
2024-01-17,20:34:00,16818.75,BUY,3,0.02h,Stop Loss,$28.50,$151.50,$51731.00,13,$151.50
2024-01-17,21:13:00,16857.75,SELL,3,0.02h,Stop Loss,$-9.00,$142.50,$51722.00,13,$142.50
2024-01-17,21:16:00,16861.75,BUY,3,0.02h,Stop Loss,$-9.00,$133.50,$51713.00,13,$133.50
2024-01-17,21:58:00,16860.25,SELL,3,0.02h,Stop Loss,$-9.00,$124.50,$51704.00,13,$124.50
2024-01-17,23:20:00,16856.75,BUY,3,0.02h,Stop Loss,$-9.00,$115.50,$51695.00,13,$115.50
2024-01-17,23:51:00,16853.25,SELL,3,0.03h,Stop Loss,$-9.00,$106.50,$51686.00,13,$106.50
,,,,,,,,,,,
2024-01-18,00:15:00,16856.0,BUY,3,0.02h,Break Even,$-1.50,$-1.50,$51684.50,14,$-1.50
2024-01-18,00:26:00,16850.25,SELL,3,0.02h,Break Even,$-1.50,$-3.00,$51683.00,14,$-3.00
2024-01-18,00:34:00,16855.5,BUY,3,0.02h,Stop Loss,$-9.00,$-12.00,$51674.00,14,$-12.00
2024-01-18,01:22:00,16861.0,SELL,3,0.02h,Break Even,$-1.50,$-13.50,$51672.50,14,$-13.50
2024-01-18,01:56:00,16857.75,BUY,3,0.02h,Break Even,$-1.50,$-15.00,$51671.00,14,$-15.00
2024-01-18,02:39:00,16860.75,SELL,3,0.03h,Break Even,$-1.50,$-16.50,$51669.50,14,$-16.50
2024-01-18,03:09:00,16859.25,BUY,3,0.02h,Stop Loss,$-9.00,$-25.50,$51660.50,14,$-25.50
2024-01-18,03:10:00,16855.5,SELL,3,0.02h,Stop Loss,$-9.00,$-34.50,$51651.50,14,$-34.50
2024-01-18,03:19:00,16857.75,BUY,3,0.03h,Stop Loss,$7.50,$-27.00,$51659.00,14,$-27.00
2024-01-18,03:51:00,16858.75,SELL,3,0.02h,Break Even,$-1.50,$-28.50,$51657.50,14,$-28.50
2024-01-18,04:31:00,16852.5,BUY,3,0.02h,Stop Loss,$-9.00,$-37.50,$51648.50,14,$-37.50
2024-01-18,04:39:00,16849.0,SELL,3,0.03h,Stop Loss,$-9.00,$-46.50,$51639.50,14,$-46.50
2024-01-18,05:01:00,16850.0,BUY,3,0.03h,Break Even,$-1.50,$-48.00,$51638.00,14,$-48.00
2024-01-18,05:33:00,16845.75,SELL,3,0.02h,Break Even,$-1.50,$-49.50,$51636.50,14,$-49.50
2024-01-18,05:38:00,16852.75,BUY,3,0.02h,Break Even,$-1.50,$-51.00,$51635.00,14,$-51.00
2024-01-18,07:15:00,16888.75,SELL,3,0.02h,Stop Loss,$-9.00,$-60.00,$51626.00,14,$-60.00
2024-01-18,07:52:00,16885.25,BUY,3,0.02h,Stop Loss,$-9.00,$-69.00,$51617.00,14,$-69.00
2024-01-18,08:33:00,16897.0,SELL,3,0.02h,Stop Loss,$6.00,$-63.00,$51623.00,14,$-63.00
2024-01-18,08:47:00,16900.0,BUY,3,0.02h,Stop Loss,$-9.00,$-72.00,$51614.00,14,$-72.00
2024-01-18,08:48:00,16896.5,SELL,3,0.02h,Stop Loss,$-9.00,$-81.00,$51605.00,14,$-81.00
2024-01-18,08:49:00,16899.5,BUY,3,0.02h,Stop Loss,$-9.00,$-90.00,$51596.00,14,$-90.00
2024-01-18,08:50:00,16892.0,SELL,3,0.02h,Break Even,$-1.50,$-91.50,$51594.50,14,$-91.50
2024-01-18,09:03:00,16904.25,BUY,3,0.02h,Break Even,$-1.50,$-93.00,$51593.00,14,$-93.00
2024-01-18,09:53:00,16916.5,SELL,3,0.02h,Stop Loss,$-9.00,$-102.00,$51584.00,14,$-102.00
2024-01-18,10:29:00,16917.75,BUY,3,0.02h,Break Even,$-1.50,$-103.50,$51582.50,14,$-103.50
2024-01-18,13:00:00,17006.5,SELL,3,0.02h,Stop Loss,$-9.00,$-112.50,$51573.50,14,$-112.50
2024-01-18,13:08:00,17015.0,BUY,3,0.02h,Break Even,$-1.50,$-114.00,$51572.00,14,$-114.00
2024-01-18,13:31:00,17000.75,SELL,3,0.02h,Stop Loss,$-9.00,$-123.00,$51563.00,14,$-123.00
2024-01-18,13:36:00,17038.25,BUY,3,0.02h,Stop Loss,$18.00,$-105.00,$51581.00,14,$-105.00
2024-01-18,13:41:00,17006.5,SELL,3,0.02h,Stop Loss,$61.50,$-43.50,$51642.50,14,$-43.50
2024-01-18,14:07:00,17001.75,BUY,3,0.02h,Stop Loss,$-9.00,$-52.50,$51633.50,14,$-52.50
2024-01-18,14:24:00,16997.0,SELL,3,0.02h,Stop Loss,$-9.00,$-61.50,$51624.50,14,$-61.50
2024-01-18,14:31:00,17029.75,BUY,3,0.02h,Stop Loss,$85.50,$24.00,$51710.00,14,$24.00
2024-01-18,14:53:00,17016.0,SELL,3,0.02h,Stop Loss,$36.00,$60.00,$51746.00,14,$60.00
2024-01-18,14:59:00,17029.25,BUY,3,0.02h,Stop Loss,$12.00,$72.00,$51758.00,14,$72.00
2024-01-18,15:03:00,17000.25,SELL,3,0.02h,Stop Loss,$57.00,$129.00,$51815.00,14,$129.00
2024-01-18,15:17:00,17020.75,BUY,3,0.02h,Stop Loss,$72.00,$201.00,$51887.00,14,$201.00
2024-01-18,15:22:00,17007.75,SELL,3,0.02h,Stop Loss,$-9.00,$192.00,$51878.00,14,$192.00
2024-01-18,15:23:00,17027.5,BUY,3,0.02h,Stop Loss,$3.00,$195.00,$51881.00,14,$195.00
2024-01-18,16:01:00,17041.5,SELL,3,0.02h,Stop Loss,$22.50,$217.50,$51903.50,14,$217.50
2024-01-18,16:14:00,17063.0,BUY,3,0.02h,Break Even,$-1.50,$216.00,$51902.00,14,$216.00
2024-01-18,16:46:00,17076.75,SELL,3,0.02h,Stop Loss,$18.00,$234.00,$51920.00,14,$234.00
2024-01-18,16:54:00,17088.25,BUY,3,0.02h,Stop Loss,$-9.00,$225.00,$51911.00,14,$225.00
2024-01-18,16:58:00,17079.25,SELL,3,0.02h,Stop Loss,$-9.00,$216.00,$51902.00,14,$216.00
2024-01-18,17:45:00,17020.25,BUY,3,0.02h,Stop Loss,$22.50,$238.50,$51924.50,14,$238.50
2024-01-18,17:53:00,17005.75,SELL,3,0.02h,Stop Loss,$45.00,$283.50,$51969.50,14,$283.50
2024-01-18,18:34:00,16982.75,BUY,3,0.02h,Break Even,$-1.50,$282.00,$51968.00,14,$282.00
2024-01-18,19:48:00,17071.0,SELL,3,0.02h,Stop Loss,$-9.00,$273.00,$51959.00,14,$273.00
2024-01-18,19:50:00,17094.5,BUY,3,0.02h,Stop Loss,$13.50,$286.50,$51972.50,14,$286.50
2024-01-18,20:40:00,17093.0,SELL,3,0.02h,Stop Loss,$22.50,$309.00,$51995.00,14,$309.00
2024-01-18,20:47:00,17107.5,BUY,3,0.02h,Stop Loss,$7.50,$316.50,$52002.50,14,$316.50
2024-01-18,21:01:00,17095.5,SELL,3,0.02h,Break Even,$-1.50,$315.00,$52001.00,14,$315.00
2024-01-18,21:16:00,17107.25,BUY,3,0.02h,Stop Loss,$16.50,$331.50,$52017.50,14,$331.50
2024-01-18,21:47:00,17114.75,SELL,3,0.02h,Stop Loss,$-9.00,$322.50,$52008.50,14,$322.50
2024-01-18,21:53:00,17119.5,BUY,3,0.02h,Stop Loss,$-9.00,$313.50,$51999.50,14,$313.50
2024-01-18,21:57:00,17115.5,SELL,3,0.02h,Stop Loss,$-9.00,$304.50,$51990.50,14,$304.50
2024-01-18,23:15:00,17116.75,BUY,3,0.02h,Stop Loss,$-9.00,$295.50,$51981.50,14,$295.50
,,,,,,,,,,,
2024-01-19,00:17:00,17136.5,SELL,3,0.02h,Stop Loss,$-9.00,$-9.00,$51972.50,15,$-9.00
2024-01-19,00:18:00,17140.25,BUY,3,0.02h,Break Even,$-1.50,$-10.50,$51971.00,15,$-10.50
2024-01-19,00:50:00,17148.25,SELL,3,0.02h,Break Even,$-1.50,$-12.00,$51969.50,15,$-12.00
2024-01-19,01:00:00,17153.25,BUY,3,0.02h,Stop Loss,$12.00,$0.00,$51981.50,15,$0.00
2024-01-19,01:08:00,17143.5,SELL,3,0.02h,Break Even,$-1.50,$-1.50,$51980.00,15,$-1.50
2024-01-19,01:36:00,17144.5,BUY,3,0.02h,Stop Loss,$-9.00,$-10.50,$51971.00,15,$-10.50
2024-01-19,02:22:00,17152.75,SELL,3,0.02h,Stop Loss,$-9.00,$-19.50,$51962.00,15,$-19.50
2024-01-19,02:24:00,17156.25,BUY,3,0.02h,Break Even,$-1.50,$-21.00,$51960.50,15,$-21.00
2024-01-19,02:34:00,17152.0,SELL,3,0.02h,Stop Loss,$-9.00,$-30.00,$51951.50,15,$-30.00
2024-01-19,02:43:00,17158.75,BUY,3,0.02h,Stop Loss,$-9.00,$-39.00,$51942.50,15,$-39.00
2024-01-19,03:24:00,17167.5,SELL,3,0.02h,Stop Loss,$-9.00,$-48.00,$51933.50,15,$-48.00
2024-01-19,03:43:00,17171.75,BUY,3,0.02h,Break Even,$-1.50,$-49.50,$51932.00,15,$-49.50
2024-01-19,04:09:00,17170.5,SELL,3,0.02h,Break Even,$-1.50,$-51.00,$51930.50,15,$-51.00
2024-01-19,04:24:00,17172.25,BUY,3,0.03h,Stop Loss,$-9.00,$-60.00,$51921.50,15,$-60.00
2024-01-19,04:29:00,17167.75,SELL,3,0.02h,Stop Loss,$-9.00,$-69.00,$51912.50,15,$-69.00
2024-01-19,04:43:00,17170.0,BUY,3,0.02h,Stop Loss,$-9.00,$-78.00,$51903.50,15,$-78.00
2024-01-19,04:52:00,17167.5,SELL,3,0.07h,Stop Loss,$-9.00,$-87.00,$51894.50,15,$-87.00
2024-01-19,05:01:00,17172.5,BUY,3,0.02h,Break Even,$-1.50,$-88.50,$51893.00,15,$-88.50
2024-01-19,05:10:00,17168.0,SELL,3,0.03h,Break Even,$-1.50,$-90.00,$51891.50,15,$-90.00
2024-01-19,05:17:00,17170.5,BUY,3,0.03h,Stop Loss,$-9.00,$-99.00,$51882.50,15,$-99.00
2024-01-19,05:19:00,17168.25,SELL,3,0.02h,Break Even,$-1.50,$-100.50,$51881.00,15,$-100.50
2024-01-19,06:08:00,17158.5,BUY,3,0.02h,Break Even,$-1.50,$-102.00,$51879.50,15,$-102.00
2024-01-19,06:30:00,17154.25,SELL,3,0.02h,Break Even,$-1.50,$-103.50,$51878.00,15,$-103.50
2024-01-19,06:42:00,17160.75,BUY,3,0.02h,Break Even,$-1.50,$-105.00,$51876.50,15,$-105.00
2024-01-19,07:03:00,17159.75,SELL,3,0.02h,Stop Loss,$4.50,$-100.50,$51881.00,15,$-100.50
2024-01-19,07:18:00,17175.25,BUY,3,0.02h,Stop Loss,$-9.00,$-109.50,$51872.00,15,$-109.50
2024-01-19,08:07:00,17178.25,SELL,3,0.02h,Break Even,$-1.50,$-111.00,$51870.50,15,$-111.00
2024-01-19,08:25:00,17183.5,BUY,3,0.02h,Break Even,$-1.50,$-112.50,$51869.00,15,$-112.50
2024-01-19,08:31:00,17174.25,SELL,3,0.02h,Stop Loss,$6.00,$-106.50,$51875.00,15,$-106.50
2024-01-19,08:40:00,17181.0,BUY,3,0.02h,Break Even,$-1.50,$-108.00,$51873.50,15,$-108.00
2024-01-19,09:36:00,17215.0,SELL,3,0.02h,Break Even,$-1.50,$-109.50,$51872.00,15,$-109.50
2024-01-19,09:55:00,17218.25,BUY,3,0.02h,Stop Loss,$3.00,$-106.50,$51875.00,15,$-106.50
2024-01-19,10:18:00,17216.25,SELL,3,0.02h,Break Even,$-1.50,$-108.00,$51873.50,15,$-108.00
2024-01-19,10:24:00,17222.0,BUY,3,0.02h,Stop Loss,$-9.00,$-117.00,$51864.50,15,$-117.00
2024-01-19,10:26:00,17218.25,SELL,3,0.02h,Break Even,$-1.50,$-118.50,$51863.00,15,$-118.50
2024-01-19,10:35:00,17223.5,BUY,3,0.02h,Stop Loss,$3.00,$-115.50,$51866.00,15,$-115.50
2024-01-19,11:08:00,17231.25,SELL,3,0.02h,Break Even,$-1.50,$-117.00,$51864.50,15,$-117.00
2024-01-19,11:12:00,17240.75,BUY,3,0.02h,Stop Loss,$-9.00,$-126.00,$51855.50,15,$-126.00
2024-01-19,11:20:00,17234.5,SELL,3,0.02h,Break Even,$-1.50,$-127.50,$51854.00,15,$-127.50
2024-01-19,11:22:00,17237.0,BUY,3,0.02h,Break Even,$-1.50,$-129.00,$51852.50,15,$-129.00
2024-01-19,11:56:00,17242.75,SELL,3,0.02h,Stop Loss,$-9.00,$-138.00,$51843.50,15,$-138.00
2024-01-19,12:00:00,17247.0,BUY,3,0.02h,Stop Loss,$-9.00,$-147.00,$51834.50,15,$-147.00
2024-01-19,12:01:00,17245.5,SELL,3,0.02h,Stop Loss,$3.00,$-144.00,$51837.50,15,$-144.00
2024-01-19,12:53:00,17229.75,BUY,3,0.02h,Stop Loss,$4.50,$-139.50,$51842.00,15,$-139.50
2024-01-19,13:26:00,17239.5,SELL,3,0.02h,Stop Loss,$16.50,$-123.00,$51858.50,15,$-123.00
2024-01-19,14:25:00,17221.5,BUY,3,0.02h,Stop Loss,$-9.00,$-132.00,$51849.50,15,$-132.00
2024-01-19,14:26:00,17207.0,SELL,3,0.02h,Stop Loss,$-9.00,$-141.00,$51840.50,15,$-141.00
2024-01-19,14:54:00,17207.0,BUY,3,0.02h,Stop Loss,$15.00,$-126.00,$51855.50,15,$-126.00
2024-01-19,15:08:00,17182.0,SELL,3,0.02h,Stop Loss,$58.50,$-67.50,$51914.00,15,$-67.50
2024-01-19,15:19:00,17209.5,BUY,3,0.02h,Stop Loss,$22.50,$-45.00,$51936.50,15,$-45.00
2024-01-19,16:36:00,17245.25,SELL,3,0.02h,Stop Loss,$31.50,$-13.50,$51968.00,15,$-13.50
2024-01-19,16:53:00,17250.0,BUY,3,0.02h,Stop Loss,$10.50,$-3.00,$51978.50,15,$-3.00
2024-01-19,17:12:00,17241.25,SELL,3,0.02h,Stop Loss,$-9.00,$-12.00,$51969.50,15,$-12.00
2024-01-19,17:15:00,17258.75,BUY,3,0.02h,Stop Loss,$12.00,$0.00,$51981.50,15,$0.00
2024-01-19,19:34:00,17406.25,SELL,3,0.02h,Stop Loss,$57.00,$57.00,$52038.50,15,$57.00
2024-01-19,19:42:00,17420.75,BUY,3,0.02h,Stop Loss,$-9.00,$48.00,$52029.50,15,$48.00
2024-01-19,20:22:00,17423.0,SELL,3,0.02h,Break Even,$-1.50,$46.50,$52028.00,15,$46.50
2024-01-19,20:35:00,17435.5,BUY,3,0.02h,Stop Loss,$7.50,$54.00,$52035.50,15,$54.00
2024-01-19,20:41:00,17427.5,SELL,3,0.02h,Stop Loss,$-9.00,$45.00,$52026.50,15,$45.00
2024-01-19,20:42:00,17433.0,BUY,3,0.02h,Stop Loss,$3.00,$48.00,$52029.50,15,$48.00
2024-01-19,20:45:00,17426.0,SELL,3,0.02h,Break Even,$-1.50,$46.50,$52028.00,15,$46.50
2024-01-19,20:46:00,17435.25,BUY,3,0.02h,Stop Loss,$6.00,$52.50,$52034.00,15,$52.50
,,,,,,,,,,,
2024-01-22,01:38:00,17550.25,SELL,3,0.02h,Stop Loss,$-9.00,$-9.00,$52025.00,16,$-9.00
2024-01-22,02:11:00,17551.0,BUY,3,0.02h,Break Even,$-1.50,$-10.50,$52023.50,16,$-10.50
2024-01-22,02:29:00,17546.25,SELL,3,0.02h,Stop Loss,$-9.00,$-19.50,$52014.50,16,$-19.50
2024-01-22,02:47:00,17552.0,BUY,3,0.02h,Stop Loss,$-9.00,$-28.50,$52005.50,16,$-28.50
2024-01-22,03:03:00,17546.5,SELL,3,0.02h,Stop Loss,$-9.00,$-37.50,$51996.50,16,$-37.50
2024-01-22,03:31:00,17545.25,BUY,3,0.08h,Stop Loss,$4.50,$-33.00,$52001.00,16,$-33.00
2024-01-22,03:55:00,17543.75,SELL,3,0.02h,Break Even,$-1.50,$-34.50,$51999.50,16,$-34.50
2024-01-22,04:02:00,17551.5,BUY,3,0.02h,Stop Loss,$-9.00,$-43.50,$51990.50,16,$-43.50
2024-01-22,04:39:00,17550.75,SELL,3,0.02h,Break Even,$-1.50,$-45.00,$51989.00,16,$-45.00
2024-01-22,04:53:00,17551.75,BUY,3,0.03h,Stop Loss,$-9.00,$-54.00,$51980.00,16,$-54.00
2024-01-22,05:07:00,17548.25,SELL,3,0.02h,Stop Loss,$-9.00,$-63.00,$51971.00,16,$-63.00
2024-01-22,05:09:00,17551.75,BUY,3,0.02h,Break Even,$-1.50,$-64.50,$51969.50,16,$-64.50
2024-01-22,05:23:00,17550.5,SELL,3,0.03h,Stop Loss,$-9.00,$-73.50,$51960.50,16,$-73.50
2024-01-22,05:25:00,17553.0,BUY,3,0.02h,Stop Loss,$-9.00,$-82.50,$51951.50,16,$-82.50
2024-01-22,05:26:00,17551.0,SELL,3,0.07h,Stop Loss,$16.50,$-66.00,$51968.00,16,$-66.00
2024-01-22,06:06:00,17545.0,BUY,3,0.02h,Break Even,$-1.50,$-67.50,$51966.50,16,$-67.50
2024-01-22,06:23:00,17538.75,SELL,3,0.02h,Break Even,$-1.50,$-69.00,$51965.00,16,$-69.00
2024-01-22,06:48:00,17542.5,BUY,3,0.02h,Break Even,$-1.50,$-70.50,$51963.50,16,$-70.50
2024-01-22,07:03:00,17535.0,SELL,3,0.02h,Break Even,$-1.50,$-72.00,$51962.00,16,$-72.00
2024-01-22,07:14:00,17546.75,BUY,3,0.02h,Break Even,$-1.50,$-73.50,$51960.50,16,$-73.50
2024-01-22,07:36:00,17546.5,SELL,3,0.02h,Stop Loss,$42.00,$-31.50,$52002.50,16,$-31.50
2024-01-22,08:51:00,17526.75,BUY,3,0.02h,Stop Loss,$-9.00,$-40.50,$51993.50,16,$-40.50
2024-01-22,09:19:00,17532.0,SELL,3,0.02h,Stop Loss,$-9.00,$-49.50,$51984.50,16,$-49.50
2024-01-22,09:20:00,17536.5,BUY,3,0.02h,Stop Loss,$-9.00,$-58.50,$51975.50,16,$-58.50
2024-01-22,09:24:00,17531.0,SELL,3,0.02h,Break Even,$-1.50,$-60.00,$51974.00,16,$-60.00
2024-01-22,09:45:00,17534.0,BUY,3,0.02h,Stop Loss,$-9.00,$-69.00,$51965.00,16,$-69.00
2024-01-22,09:49:00,17528.75,SELL,3,0.02h,Break Even,$-1.50,$-70.50,$51963.50,16,$-70.50
2024-01-22,09:51:00,17532.75,BUY,3,0.02h,Break Even,$-1.50,$-72.00,$51962.00,16,$-72.00
2024-01-22,10:24:00,17533.75,SELL,3,0.02h,Stop Loss,$-9.00,$-81.00,$51953.00,16,$-81.00
2024-01-22,10:49:00,17537.25,BUY,3,0.03h,Break Even,$-1.50,$-82.50,$51951.50,16,$-82.50
2024-01-22,10:57:00,17532.0,SELL,3,0.02h,Stop Loss,$-9.00,$-91.50,$51942.50,16,$-91.50
2024-01-22,10:59:00,17536.75,BUY,3,0.02h,Stop Loss,$-9.00,$-100.50,$51933.50,16,$-100.50
2024-01-22,11:53:00,17543.75,SELL,3,0.03h,Stop Loss,$-9.00,$-109.50,$51924.50,16,$-109.50
2024-01-22,12:07:00,17551.5,BUY,3,0.02h,Break Even,$-1.50,$-111.00,$51923.00,16,$-111.00
2024-01-22,13:02:00,17567.0,SELL,3,0.02h,Stop Loss,$24.00,$-87.00,$51947.00,16,$-87.00
2024-01-22,13:30:00,17560.0,BUY,3,0.02h,Stop Loss,$-9.00,$-96.00,$51938.00,16,$-96.00
2024-01-22,13:31:00,17551.75,SELL,3,0.02h,Stop Loss,$16.50,$-79.50,$51954.50,16,$-79.50
2024-01-22,14:24:00,17530.75,BUY,3,0.02h,Stop Loss,$-9.00,$-88.50,$51945.50,16,$-88.50
2024-01-22,14:43:00,17514.0,SELL,3,0.02h,Stop Loss,$105.00,$16.50,$52050.50,16,$16.50
2024-01-22,14:54:00,17541.0,BUY,3,0.02h,Stop Loss,$7.50,$24.00,$52058.00,16,$24.00
2024-01-22,15:04:00,17522.0,SELL,3,0.02h,Stop Loss,$106.50,$130.50,$52164.50,16,$130.50
2024-01-22,15:15:00,17538.25,BUY,3,0.02h,Stop Loss,$10.50,$141.00,$52175.00,16,$141.00
2024-01-22,15:20:00,17514.5,SELL,3,0.02h,Stop Loss,$21.00,$162.00,$52196.00,16,$162.00
2024-01-22,16:11:00,17472.5,BUY,3,0.02h,Break Even,$-1.50,$160.50,$52194.50,16,$160.50
2024-01-22,17:07:00,17479.75,SELL,3,0.02h,Stop Loss,$78.00,$238.50,$52272.50,16,$238.50
2024-01-22,17:23:00,17493.75,BUY,3,0.02h,Stop Loss,$7.50,$246.00,$52280.00,16,$246.00
2024-01-22,17:35:00,17477.0,SELL,3,0.02h,Stop Loss,$24.00,$270.00,$52304.00,16,$270.00
2024-01-22,17:54:00,17490.75,BUY,3,0.02h,Break Even,$-1.50,$268.50,$52302.50,16,$268.50
2024-01-22,18:01:00,17470.75,SELL,3,0.02h,Stop Loss,$12.00,$280.50,$52314.50,16,$280.50
2024-01-22,18:39:00,17466.0,BUY,3,0.02h,Break Even,$-1.50,$279.00,$52313.00,16,$279.00
2024-01-22,19:14:00,17473.0,SELL,3,0.02h,Stop Loss,$13.50,$292.50,$52326.50,16,$292.50
2024-01-22,19:38:00,17466.0,BUY,3,0.02h,Stop Loss,$12.00,$304.50,$52338.50,16,$304.50
2024-01-22,19:49:00,17458.5,SELL,3,0.02h,Stop Loss,$-9.00,$295.50,$52329.50,16,$295.50
2024-01-22,19:57:00,17466.0,BUY,3,0.02h,Stop Loss,$-9.00,$286.50,$52320.50,16,$286.50
2024-01-22,20:03:00,17459.25,SELL,3,0.02h,Break Even,$-1.50,$285.00,$52319.00,16,$285.00
2024-01-22,20:11:00,17473.25,BUY,3,0.02h,Stop Loss,$4.50,$289.50,$52323.50,16,$289.50
2024-01-22,20:43:00,17470.75,SELL,3,0.02h,Break Even,$-1.50,$288.00,$52322.00,16,$288.00
2024-01-22,21:30:00,17454.5,BUY,3,0.02h,Stop Loss,$-9.00,$279.00,$52313.00,16,$279.00
2024-01-22,21:57:00,17456.25,SELL,3,0.03h,Stop Loss,$-9.00,$270.00,$52304.00,16,$270.00
2024-01-22,23:08:00,17462.75,BUY,3,0.02h,Break Even,$-1.50,$268.50,$52302.50,16,$268.50
2024-01-22,23:55:00,17468.0,SELL,3,0.02h,Break Even,$-1.50,$267.00,$52301.00,16,$267.00
,,,,,,,,,,,
2024-01-23,00:03:00,17471.25,BUY,3,0.02h,Stop Loss,$-9.00,$-9.00,$52292.00,17,$-9.00
2024-01-23,00:15:00,17465.5,SELL,3,0.02h,Break Even,$-1.50,$-10.50,$52290.50,17,$-10.50
2024-01-23,00:32:00,17469.0,BUY,3,0.03h,Break Even,$-1.50,$-12.00,$52289.00,17,$-12.00
2024-01-23,00:42:00,17467.25,SELL,3,0.02h,Stop Loss,$-9.00,$-21.00,$52280.00,17,$-21.00
2024-01-23,00:44:00,17470.0,BUY,3,0.02h,Break Even,$-1.50,$-22.50,$52278.50,17,$-22.50
2024-01-23,01:04:00,17466.25,SELL,3,0.02h,Stop Loss,$-9.00,$-31.50,$52269.50,17,$-31.50
2024-01-23,01:54:00,17461.25,BUY,3,0.07h,Stop Loss,$90.00,$58.50,$52359.50,17,$58.50
2024-01-23,02:40:00,17480.25,SELL,3,0.02h,Break Even,$-1.50,$57.00,$52358.00,17,$57.00
2024-01-23,03:19:00,17477.25,BUY,3,0.02h,Break Even,$-1.50,$55.50,$52356.50,17,$55.50
2024-01-23,03:41:00,17475.25,SELL,3,0.02h,Break Even,$-1.50,$54.00,$52355.00,17,$54.00
2024-01-23,04:06:00,17476.5,BUY,3,0.02h,Stop Loss,$-9.00,$45.00,$52346.00,17,$45.00
2024-01-23,04:36:00,17474.75,SELL,3,0.02h,Stop Loss,$-9.00,$36.00,$52337.00,17,$36.00
2024-01-23,04:41:00,17478.0,BUY,3,0.02h,Stop Loss,$-9.00,$27.00,$52328.00,17,$27.00
2024-01-23,04:55:00,17476.0,SELL,3,0.02h,Break Even,$-1.50,$25.50,$52326.50,17,$25.50
2024-01-23,05:04:00,17479.75,BUY,3,0.02h,Stop Loss,$-9.00,$16.50,$52317.50,17,$16.50
2024-01-23,05:19:00,17476.25,SELL,3,0.02h,Break Even,$-1.50,$15.00,$52316.00,17,$15.00
2024-01-23,05:25:00,17479.0,BUY,3,0.02h,Stop Loss,$-9.00,$6.00,$52307.00,17,$6.00
2024-01-23,05:27:00,17473.5,SELL,3,0.02h,Stop Loss,$-9.00,$-3.00,$52298.00,17,$-3.00
2024-01-23,06:05:00,17474.0,BUY,3,0.02h,Stop Loss,$-9.00,$-12.00,$52289.00,17,$-12.00
2024-01-23,06:07:00,17468.5,SELL,3,0.02h,Stop Loss,$-9.00,$-21.00,$52280.00,17,$-21.00
2024-01-23,06:10:00,17473.75,BUY,3,0.03h,Stop Loss,$-9.00,$-30.00,$52271.00,17,$-30.00
2024-01-23,06:37:00,17472.5,SELL,3,0.05h,Stop Loss,$-9.00,$-39.00,$52262.00,17,$-39.00
2024-01-23,06:48:00,17475.0,BUY,3,0.03h,Stop Loss,$15.00,$-24.00,$52277.00,17,$-24.00
2024-01-23,07:32:00,17480.25,SELL,3,0.02h,Stop Loss,$-9.00,$-33.00,$52268.00,17,$-33.00
2024-01-23,08:00:00,17479.75,BUY,3,0.02h,Break Even,$-1.50,$-34.50,$52266.50,17,$-34.50
2024-01-23,08:02:00,17475.75,SELL,3,0.02h,Break Even,$-1.50,$-36.00,$52265.00,17,$-36.00
2024-01-23,08:09:00,17479.25,BUY,3,0.02h,Stop Loss,$-9.00,$-45.00,$52256.00,17,$-45.00
2024-01-23,08:11:00,17475.75,SELL,3,0.02h,Stop Loss,$21.00,$-24.00,$52277.00,17,$-24.00
2024-01-23,09:01:00,17443.25,BUY,3,0.02h,Stop Loss,$28.50,$4.50,$52305.50,17,$4.50
2024-01-23,10:02:00,17459.0,SELL,3,0.02h,Break Even,$-1.50,$3.00,$52304.00,17,$3.00
2024-01-23,10:22:00,17456.0,BUY,3,0.02h,Stop Loss,$-9.00,$-6.00,$52295.00,17,$-6.00
2024-01-23,10:34:00,17446.25,SELL,3,0.02h,Break Even,$-1.50,$-7.50,$52293.50,17,$-7.50
2024-01-23,10:47:00,17450.75,BUY,3,0.02h,Break Even,$-1.50,$-9.00,$52292.00,17,$-9.00
2024-01-23,10:51:00,17448.75,SELL,3,0.05h,Stop Loss,$9.00,$0.00,$52301.00,17,$0.00
2024-01-23,11:02:00,17453.5,BUY,3,0.02h,Stop Loss,$-9.00,$-9.00,$52292.00,17,$-9.00
2024-01-23,11:23:00,17449.75,SELL,3,0.02h,Stop Loss,$-9.00,$-18.00,$52283.00,17,$-18.00
2024-01-23,11:33:00,17457.5,BUY,3,0.02h,Stop Loss,$18.00,$0.00,$52301.00,17,$0.00
2024-01-23,12:26:00,17470.25,SELL,3,0.02h,Stop Loss,$-9.00,$-9.00,$52292.00,17,$-9.00
2024-01-23,12:39:00,17477.25,BUY,3,0.02h,Stop Loss,$7.50,$-1.50,$52299.50,17,$-1.50
2024-01-23,12:49:00,17470.25,SELL,3,0.02h,Break Even,$-1.50,$-3.00,$52298.00,17,$-3.00
2024-01-23,12:57:00,17479.5,BUY,3,0.02h,Break Even,$-1.50,$-4.50,$52296.50,17,$-4.50
2024-01-23,13:52:00,17503.25,SELL,3,0.02h,Stop Loss,$-9.00,$-13.50,$52287.50,17,$-13.50
2024-01-23,14:51:00,17476.0,BUY,3,0.02h,Stop Loss,$7.50,$-6.00,$52295.00,17,$-6.00
2024-01-23,15:07:00,17467.5,SELL,3,0.02h,Break Even,$-1.50,$-7.50,$52293.50,17,$-7.50
2024-01-23,15:08:00,17473.25,BUY,3,0.02h,Stop Loss,$16.50,$9.00,$52310.00,17,$9.00
2024-01-23,15:10:00,17466.75,SELL,3,0.02h,Stop Loss,$13.50,$22.50,$52323.50,17,$22.50
2024-01-23,15:12:00,17479.5,BUY,3,0.02h,Stop Loss,$10.50,$33.00,$52334.00,17,$33.00
2024-01-23,15:19:00,17455.75,SELL,3,0.02h,Stop Loss,$9.00,$42.00,$52343.00,17,$42.00
2024-01-23,15:39:00,17466.75,BUY,3,0.02h,Stop Loss,$22.50,$64.50,$52365.50,17,$64.50
2024-01-23,15:51:00,17457.75,SELL,3,0.02h,Stop Loss,$19.50,$84.00,$52385.00,17,$84.00
2024-01-23,16:04:00,17466.0,BUY,3,0.02h,Stop Loss,$16.50,$100.50,$52401.50,17,$100.50
2024-01-23,16:17:00,17448.75,SELL,3,0.02h,Stop Loss,$30.00,$130.50,$52431.50,17,$130.50
2024-01-23,16:46:00,17450.75,BUY,3,0.02h,Stop Loss,$21.00,$151.50,$52452.50,17,$151.50
2024-01-23,17:17:00,17453.25,SELL,3,0.02h,Break Even,$-1.50,$150.00,$52451.00,17,$150.00
2024-01-23,17:43:00,17454.75,BUY,3,0.02h,Stop Loss,$-9.00,$141.00,$52442.00,17,$141.00
2024-01-23,18:30:00,17476.5,SELL,3,0.02h,Stop Loss,$-9.00,$132.00,$52433.00,17,$132.00
2024-01-23,18:49:00,17480.25,BUY,3,0.02h,Break Even,$-1.50,$130.50,$52431.50,17,$130.50
2024-01-23,19:07:00,17473.75,SELL,3,0.02h,Stop Loss,$12.00,$142.50,$52443.50,17,$142.50
2024-01-23,19:39:00,17478.0,BUY,3,0.02h,Stop Loss,$-9.00,$133.50,$52434.50,17,$133.50
2024-01-23,20:36:00,17503.25,SELL,3,0.02h,Break Even,$-1.50,$132.00,$52433.00,17,$132.00
2024-01-23,20:47:00,17513.0,BUY,3,0.02h,Stop Loss,$-9.00,$123.00,$52424.00,17,$123.00
2024-01-23,20:50:00,17503.5,SELL,3,0.02h,Break Even,$-1.50,$121.50,$52422.50,17,$121.50
2024-01-23,20:51:00,17519.0,BUY,3,0.02h,Stop Loss,$10.50,$132.00,$52433.00,17,$132.00
2024-01-23,21:11:00,17520.25,SELL,3,0.02h,Break Even,$-1.50,$130.50,$52431.50,17,$130.50
2024-01-23,21:15:00,17531.5,BUY,3,0.02h,Break Even,$-1.50,$129.00,$52430.00,17,$129.00
,,,,,,,,,,,
2024-01-24,00:04:00,17573.0,SELL,3,0.02h,Stop Loss,$-9.00,$-9.00,$52421.00,18,$-9.00
2024-01-24,00:17:00,17577.0,BUY,3,0.02h,Stop Loss,$-9.00,$-18.00,$52412.00,18,$-18.00
2024-01-24,00:29:00,17572.25,SELL,3,0.03h,Stop Loss,$-9.00,$-27.00,$52403.00,18,$-27.00
2024-01-24,00:42:00,17575.25,BUY,3,0.10h,Stop Loss,$-9.00,$-36.00,$52394.00,18,$-36.00
2024-01-24,01:05:00,17573.75,SELL,3,0.05h,Stop Loss,$-9.00,$-45.00,$52385.00,18,$-45.00
2024-01-24,01:32:00,17576.25,BUY,3,0.02h,Stop Loss,$-9.00,$-54.00,$52376.00,18,$-54.00
2024-01-24,02:15:00,17579.75,SELL,3,0.02h,Break Even,$-1.50,$-55.50,$52374.50,18,$-55.50
2024-01-24,02:31:00,17581.75,BUY,3,0.03h,Stop Loss,$-9.00,$-64.50,$52365.50,18,$-64.50
2024-01-24,02:41:00,17579.5,SELL,3,0.02h,Break Even,$-1.50,$-66.00,$52364.00,18,$-66.00
2024-01-24,02:48:00,17580.75,BUY,3,0.03h,Break Even,$-1.50,$-67.50,$52362.50,18,$-67.50
2024-01-24,03:45:00,17592.25,SELL,3,0.03h,Break Even,$-1.50,$-69.00,$52361.00,18,$-69.00
2024-01-24,04:00:00,17593.5,BUY,3,0.05h,Stop Loss,$-9.00,$-78.00,$52352.00,18,$-78.00
2024-01-24,04:06:00,17590.25,SELL,3,0.02h,Stop Loss,$-9.00,$-87.00,$52343.00,18,$-87.00
2024-01-24,04:24:00,17592.25,BUY,3,0.03h,Stop Loss,$-9.00,$-96.00,$52334.00,18,$-96.00
2024-01-24,04:55:00,17591.75,SELL,3,0.03h,Stop Loss,$-9.00,$-105.00,$52325.00,18,$-105.00
2024-01-24,05:06:00,17593.75,BUY,3,0.02h,Stop Loss,$-9.00,$-114.00,$52316.00,18,$-114.00
2024-01-24,05:07:00,17592.75,SELL,3,0.02h,Break Even,$-1.50,$-115.50,$52314.50,18,$-115.50
2024-01-24,05:08:00,17594.5,BUY,3,0.02h,Break Even,$-1.50,$-117.00,$52313.00,18,$-117.00
2024-01-24,05:17:00,17593.25,SELL,3,0.02h,Stop Loss,$-9.00,$-126.00,$52304.00,18,$-126.00
2024-01-24,05:18:00,17594.0,BUY,3,0.02h,Stop Loss,$-9.00,$-135.00,$52295.00,18,$-135.00
2024-01-24,05:19:00,17591.5,SELL,3,0.02h,Stop Loss,$-9.00,$-144.00,$52286.00,18,$-144.00
2024-01-24,05:22:00,17595.25,BUY,3,0.05h,Stop Loss,$-9.00,$-153.00,$52277.00,18,$-153.00
2024-01-24,06:36:00,17613.75,SELL,3,0.02h,Stop Loss,$-9.00,$-162.00,$52268.00,18,$-162.00
2024-01-24,06:38:00,17615.5,BUY,3,0.02h,Break Even,$-1.50,$-163.50,$52266.50,18,$-163.50
2024-01-24,07:27:00,17619.75,SELL,3,0.02h,Break Even,$-1.50,$-165.00,$52265.00,18,$-165.00
2024-01-24,07:35:00,17625.75,BUY,3,0.02h,Break Even,$-1.50,$-166.50,$52263.50,18,$-166.50
2024-01-24,07:53:00,17626.25,SELL,3,0.02h,Stop Loss,$-9.00,$-175.50,$52254.50,18,$-175.50
2024-01-24,08:02:00,17635.75,BUY,3,0.02h,Break Even,$-1.50,$-177.00,$52253.00,18,$-177.00
2024-01-24,08:28:00,17631.75,SELL,3,0.02h,Break Even,$-1.50,$-178.50,$52251.50,18,$-178.50
2024-01-24,08:32:00,17637.5,BUY,3,0.02h,Stop Loss,$3.00,$-175.50,$52254.50,18,$-175.50
2024-01-24,08:50:00,17637.0,SELL,3,0.02h,Stop Loss,$-9.00,$-184.50,$52245.50,18,$-184.50
2024-01-24,08:52:00,17643.5,BUY,3,0.02h,Stop Loss,$3.00,$-181.50,$52248.50,18,$-181.50
2024-01-24,09:18:00,17643.5,SELL,3,0.02h,Stop Loss,$-9.00,$-190.50,$52239.50,18,$-190.50
2024-01-24,09:21:00,17651.75,BUY,3,0.02h,Stop Loss,$-9.00,$-199.50,$52230.50,18,$-199.50
2024-01-24,09:56:00,17658.5,SELL,3,0.02h,Stop Loss,$-9.00,$-208.50,$52221.50,18,$-208.50
2024-01-24,09:57:00,17660.75,BUY,3,0.02h,Stop Loss,$-9.00,$-217.50,$52212.50,18,$-217.50
2024-01-24,10:11:00,17658.0,SELL,3,0.02h,Stop Loss,$-9.00,$-226.50,$52203.50,18,$-226.50
2024-01-24,10:44:00,17654.0,BUY,3,0.02h,Stop Loss,$-9.00,$-235.50,$52194.50,18,$-235.50
2024-01-24,10:46:00,17650.5,SELL,3,0.02h,Break Even,$-1.50,$-237.00,$52193.00,18,$-237.00
2024-01-24,11:01:00,17652.5,BUY,3,0.02h,Stop Loss,$-9.00,$-246.00,$52184.00,18,$-246.00
2024-01-24,11:06:00,17647.75,SELL,3,0.02h,Stop Loss,$-9.00,$-255.00,$52175.00,18,$-255.00
2024-01-24,11:08:00,17653.5,BUY,3,0.02h,Break Even,$-1.50,$-256.50,$52173.50,18,$-256.50
2024-01-24,11:22:00,17648.25,SELL,3,0.02h,Break Even,$-1.50,$-258.00,$52172.00,18,$-258.00
2024-01-24,11:51:00,17650.25,BUY,3,0.02h,Break Even,$-1.50,$-259.50,$52170.50,18,$-259.50
2024-01-24,11:59:00,17647.0,SELL,3,0.02h,Break Even,$-1.50,$-261.00,$52169.00,18,$-261.00
2024-01-24,12:12:00,17650.5,BUY,3,0.02h,Break Even,$-1.50,$-262.50,$52167.50,18,$-262.50
2024-01-24,13:40:00,17678.75,SELL,3,0.02h,Break Even,$-1.50,$-264.00,$52166.00,18,$-264.00
2024-01-24,14:15:00,17670.5,BUY,3,0.02h,Break Even,$-1.50,$-265.50,$52164.50,18,$-265.50
2024-01-24,14:33:00,17667.75,SELL,3,0.02h,Stop Loss,$-9.00,$-274.50,$52155.50,18,$-274.50
2024-01-24,14:54:00,17668.25,BUY,3,0.02h,Break Even,$-1.50,$-276.00,$52154.00,18,$-276.00
2024-01-24,15:02:00,17648.25,SELL,3,0.02h,Break Even,$-1.50,$-277.50,$52152.50,18,$-277.50
2024-01-24,15:09:00,17681.25,BUY,3,0.02h,Stop Loss,$-9.00,$-286.50,$52143.50,18,$-286.50
2024-01-24,15:57:00,17732.25,SELL,3,0.02h,Break Even,$-1.50,$-288.00,$52142.00,18,$-288.00
2024-01-24,16:01:00,17740.5,BUY,3,0.02h,Stop Loss,$-9.00,$-297.00,$52133.00,18,$-297.00
2024-01-24,16:07:00,17717.75,SELL,3,0.02h,Stop Loss,$93.00,$-204.00,$52226.00,18,$-204.00
2024-01-24,16:38:00,17718.0,BUY,3,0.02h,Stop Loss,$-9.00,$-213.00,$52217.00,18,$-213.00
2024-01-24,16:46:00,17708.75,SELL,3,0.02h,Break Even,$-1.50,$-214.50,$52215.50,18,$-214.50
2024-01-24,16:49:00,17722.25,BUY,3,0.02h,Stop Loss,$16.50,$-198.00,$52232.00,18,$-198.00
2024-01-24,17:20:00,17740.75,SELL,3,0.02h,Stop Loss,$13.50,$-184.50,$52245.50,18,$-184.50
2024-01-24,17:23:00,17748.75,BUY,3,0.02h,Stop Loss,$6.00,$-178.50,$52251.50,18,$-178.50
2024-01-24,18:02:00,17758.5,SELL,3,0.02h,Stop Loss,$45.00,$-133.50,$52296.50,18,$-133.50
2024-01-24,18:29:00,17763.75,BUY,3,0.02h,Stop Loss,$-9.00,$-142.50,$52287.50,18,$-142.50
2024-01-24,18:34:00,17739.75,SELL,3,0.02h,Stop Loss,$-9.00,$-151.50,$52278.50,18,$-151.50
2024-01-24,19:44:00,17675.25,BUY,3,0.02h,Stop Loss,$19.50,$-132.00,$52298.00,18,$-132.00
2024-01-24,19:58:00,17662.0,SELL,3,0.02h,Break Even,$-1.50,$-133.50,$52296.50,18,$-133.50
2024-01-24,20:07:00,17679.25,BUY,3,0.02h,Stop Loss,$3.00,$-130.50,$52299.50,18,$-130.50
2024-01-24,20:12:00,17660.0,SELL,3,0.02h,Break Even,$-1.50,$-132.00,$52298.00,18,$-132.00
2024-01-24,20:39:00,17649.5,BUY,3,0.02h,Break Even,$-1.50,$-133.50,$52296.50,18,$-133.50
2024-01-24,20:51:00,17621.0,SELL,3,0.02h,Break Even,$-1.50,$-135.00,$52295.00,18,$-135.00
2024-01-24,21:33:00,17604.75,BUY,3,0.02h,Stop Loss,$-9.00,$-144.00,$52286.00,18,$-144.00
2024-01-24,23:24:00,17620.25,SELL,3,0.02h,Stop Loss,$3.00,$-141.00,$52289.00,18,$-141.00
2024-01-24,23:56:00,17620.25,BUY,3,0.02h,Stop Loss,$-9.00,$-150.00,$52280.00,18,$-150.00
,,,,,,,,,,,
2024-01-25,00:03:00,17611.5,SELL,3,0.02h,Stop Loss,$-9.00,$-9.00,$52271.00,19,$-9.00
2024-01-25,00:25:00,17609.0,BUY,3,0.02h,Stop Loss,$-9.00,$-18.00,$52262.00,19,$-18.00
2024-01-25,01:18:00,17620.5,SELL,3,0.02h,Stop Loss,$-9.00,$-27.00,$52253.00,19,$-27.00
2024-01-25,02:01:00,17606.0,BUY,3,0.02h,Stop Loss,$-9.00,$-36.00,$52244.00,19,$-36.00
2024-01-25,02:22:00,17602.5,SELL,3,0.02h,Break Even,$-1.50,$-37.50,$52242.50,19,$-37.50
2024-01-25,02:29:00,17612.25,BUY,3,0.02h,Stop Loss,$-9.00,$-46.50,$52233.50,19,$-46.50
2024-01-25,02:34:00,17608.0,SELL,3,0.02h,Break Even,$-1.50,$-48.00,$52232.00,19,$-48.00
2024-01-25,02:59:00,17603.0,BUY,3,0.02h,Stop Loss,$-9.00,$-57.00,$52223.00,19,$-57.00
2024-01-25,03:12:00,17597.0,SELL,3,0.02h,Break Even,$-1.50,$-58.50,$52221.50,19,$-58.50
2024-01-25,03:21:00,17603.25,BUY,3,0.03h,Break Even,$-1.50,$-60.00,$52220.00,19,$-60.00
2024-01-25,03:31:00,17600.5,SELL,3,0.02h,Stop Loss,$-9.00,$-69.00,$52211.00,19,$-69.00
2024-01-25,03:32:00,17603.75,BUY,3,0.02h,Stop Loss,$-9.00,$-78.00,$52202.00,19,$-78.00
2024-01-25,03:48:00,17600.75,SELL,3,0.02h,Stop Loss,$-9.00,$-87.00,$52193.00,19,$-87.00
2024-01-25,03:52:00,17604.0,BUY,3,0.02h,Break Even,$-1.50,$-88.50,$52191.50,19,$-88.50
2024-01-25,04:44:00,17612.0,SELL,3,0.07h,Break Even,$-1.50,$-90.00,$52190.00,19,$-90.00
2024-01-25,05:16:00,17616.25,BUY,3,0.02h,Stop Loss,$-9.00,$-99.00,$52181.00,19,$-99.00
2024-01-25,06:07:00,17620.25,SELL,3,0.02h,Break Even,$-1.50,$-100.50,$52179.50,19,$-100.50
2024-01-25,06:18:00,17621.5,BUY,3,0.07h,Break Even,$-1.50,$-102.00,$52178.00,19,$-102.00
2024-01-25,06:25:00,17619.0,SELL,3,0.02h,Break Even,$-1.50,$-103.50,$52176.50,19,$-103.50
2024-01-25,06:31:00,17623.25,BUY,3,0.02h,Stop Loss,$-9.00,$-112.50,$52167.50,19,$-112.50
2024-01-25,06:49:00,17621.75,SELL,3,0.02h,Stop Loss,$-9.00,$-121.50,$52158.50,19,$-121.50
2024-01-25,07:02:00,17624.0,BUY,3,0.02h,Stop Loss,$-9.00,$-130.50,$52149.50,19,$-130.50
2024-01-25,07:35:00,17630.5,SELL,3,0.02h,Break Even,$-1.50,$-132.00,$52148.00,19,$-132.00
2024-01-25,07:42:00,17634.5,BUY,3,0.02h,Stop Loss,$-9.00,$-141.00,$52139.00,19,$-141.00
2024-01-25,07:53:00,17630.75,SELL,3,0.02h,Stop Loss,$-9.00,$-150.00,$52130.00,19,$-150.00
2024-01-25,08:30:00,17623.5,BUY,3,0.02h,Break Even,$-1.50,$-151.50,$52128.50,19,$-151.50
2024-01-25,09:01:00,17631.0,SELL,3,0.02h,Stop Loss,$-9.00,$-160.50,$52119.50,19,$-160.50
2024-01-25,09:32:00,17630.5,BUY,3,0.02h,Stop Loss,$-9.00,$-169.50,$52110.50,19,$-169.50
2024-01-25,10:02:00,17622.25,SELL,3,0.03h,Break Even,$-1.50,$-171.00,$52109.00,19,$-171.00
2024-01-25,10:27:00,17624.25,BUY,3,0.02h,Stop Loss,$-9.00,$-180.00,$52100.00,19,$-180.00
2024-01-25,10:30:00,17618.75,SELL,3,0.02h,Stop Loss,$7.50,$-172.50,$52107.50,19,$-172.50
2024-01-25,10:46:00,17620.75,BUY,3,0.02h,Stop Loss,$-9.00,$-181.50,$52098.50,19,$-181.50
2024-01-25,10:47:00,17618.5,SELL,3,0.02h,Break Even,$-1.50,$-183.00,$52097.00,19,$-183.00
2024-01-25,11:21:00,17618.0,BUY,3,0.02h,Break Even,$-1.50,$-184.50,$52095.50,19,$-184.50
2024-01-25,12:20:00,17646.25,SELL,3,0.02h,Break Even,$-1.50,$-186.00,$52094.00,19,$-186.00
2024-01-25,12:39:00,17650.0,BUY,3,0.02h,Stop Loss,$-9.00,$-195.00,$52085.00,19,$-195.00
2024-01-25,12:56:00,17643.75,SELL,3,0.02h,Stop Loss,$6.00,$-189.00,$52091.00,19,$-189.00
2024-01-25,13:17:00,17649.0,BUY,3,0.02h,Stop Loss,$6.00,$-183.00,$52097.00,19,$-183.00
2024-01-25,14:31:00,17687.75,SELL,3,0.02h,Stop Loss,$22.50,$-160.50,$52119.50,19,$-160.50
2024-01-25,15:10:00,17698.25,BUY,3,0.02h,Stop Loss,$36.00,$-124.50,$52155.50,19,$-124.50
2024-01-25,15:37:00,17694.5,SELL,3,0.02h,Stop Loss,$6.00,$-118.50,$52161.50,19,$-118.50
2024-01-25,15:45:00,17720.75,BUY,3,0.02h,Break Even,$-1.50,$-120.00,$52160.00,19,$-120.00
2024-01-25,15:50:00,17697.75,SELL,3,0.02h,Stop Loss,$24.00,$-96.00,$52184.00,19,$-96.00
2024-01-25,16:13:00,17709.75,BUY,3,0.02h,Stop Loss,$40.50,$-55.50,$52224.50,19,$-55.50
2024-01-25,16:43:00,17705.0,SELL,3,0.02h,Stop Loss,$-9.00,$-64.50,$52215.50,19,$-64.50
2024-01-25,16:48:00,17722.5,BUY,3,0.02h,Stop Loss,$58.50,$-6.00,$52274.00,19,$-6.00
2024-01-25,17:02:00,17720.0,SELL,3,0.02h,Stop Loss,$27.00,$21.00,$52301.00,19,$21.00
2024-01-25,18:03:00,17670.75,BUY,3,0.02h,Stop Loss,$19.50,$40.50,$52320.50,19,$40.50
2024-01-25,18:16:00,17646.5,SELL,3,0.02h,Stop Loss,$57.00,$97.50,$52377.50,19,$97.50
2024-01-25,18:45:00,17634.75,BUY,3,0.02h,Stop Loss,$6.00,$103.50,$52383.50,19,$103.50
2024-01-25,18:54:00,17620.75,SELL,3,0.02h,Stop Loss,$42.00,$145.50,$52425.50,19,$145.50
2024-01-25,19:31:00,17576.0,BUY,3,0.02h,Stop Loss,$16.50,$162.00,$52442.00,19,$162.00
2024-01-25,19:39:00,17565.5,SELL,3,0.02h,Stop Loss,$-9.00,$153.00,$52433.00,19,$153.00
2024-01-25,19:43:00,17574.5,BUY,3,0.02h,Stop Loss,$3.00,$156.00,$52436.00,19,$156.00
2024-01-25,20:25:00,17590.5,SELL,3,0.02h,Stop Loss,$-9.00,$147.00,$52427.00,19,$147.00
2024-01-25,20:33:00,17614.25,BUY,3,0.02h,Stop Loss,$55.50,$202.50,$52482.50,19,$202.50
2024-01-25,20:45:00,17604.25,SELL,3,0.02h,Break Even,$-1.50,$201.00,$52481.00,19,$201.00
2024-01-25,20:48:00,17610.0,BUY,3,0.02h,Break Even,$-1.50,$199.50,$52479.50,19,$199.50
2024-01-25,21:08:00,17606.5,SELL,3,0.02h,Break Even,$-1.50,$198.00,$52478.00,19,$198.00
2024-01-25,21:33:00,17606.25,BUY,3,0.02h,Stop Loss,$-9.00,$189.00,$52469.00,19,$189.00
2024-01-25,21:39:00,17598.25,SELL,3,0.02h,Break Even,$-1.50,$187.50,$52467.50,19,$187.50
2024-01-25,21:41:00,17605.0,BUY,3,0.02h,Stop Loss,$12.00,$199.50,$52479.50,19,$199.50
2024-01-25,21:47:00,17596.25,SELL,3,0.02h,Break Even,$-1.50,$198.00,$52478.00,19,$198.00
2024-01-25,23:47:00,17547.75,BUY,3,0.05h,Break Even,$-1.50,$196.50,$52476.50,19,$196.50
2024-01-25,23:59:00,17544.25,SELL,3,0.02h,Break Even,$-1.50,$195.00,$52475.00,19,$195.00
,,,,,,,,,,,
2024-01-26,00:06:00,17548.25,BUY,3,0.02h,Stop Loss,$-9.00,$-9.00,$52466.00,20,$-9.00
2024-01-26,00:07:00,17544.25,SELL,3,0.05h,Break Even,$-1.50,$-10.50,$52464.50,20,$-10.50
2024-01-26,00:34:00,17538.75,BUY,3,0.02h,Stop Loss,$-9.00,$-19.50,$52455.50,20,$-19.50
2024-01-26,00:56:00,17535.25,SELL,3,0.02h,Break Even,$-1.50,$-21.00,$52454.00,20,$-21.00
2024-01-26,01:22:00,17524.0,BUY,3,0.02h,Stop Loss,$-9.00,$-30.00,$52445.00,20,$-30.00
2024-01-26,01:31:00,17517.5,SELL,3,0.02h,Stop Loss,$6.00,$-24.00,$52451.00,20,$-24.00
2024-01-26,01:57:00,17516.75,BUY,3,0.02h,Break Even,$-1.50,$-25.50,$52449.50,20,$-25.50
2024-01-26,02:49:00,17529.25,SELL,3,0.02h,Break Even,$-1.50,$-27.00,$52448.00,20,$-27.00
2024-01-26,03:49:00,17524.75,BUY,3,0.02h,Break Even,$-1.50,$-28.50,$52446.50,20,$-28.50
2024-01-26,03:59:00,17517.75,SELL,3,0.03h,Stop Loss,$-9.00,$-37.50,$52437.50,20,$-37.50
2024-01-26,05:03:00,17493.75,BUY,3,0.02h,Break Even,$-1.50,$-39.00,$52436.00,20,$-39.00
2024-01-26,05:57:00,17514.75,SELL,3,0.02h,Stop Loss,$21.00,$-18.00,$52457.00,20,$-18.00
2024-01-26,06:40:00,17499.75,BUY,3,0.02h,Stop Loss,$-9.00,$-27.00,$52448.00,20,$-27.00
2024-01-26,07:16:00,17494.25,SELL,3,0.02h,Stop Loss,$10.50,$-16.50,$52458.50,20,$-16.50
2024-01-26,08:12:00,17484.5,BUY,3,0.02h,Stop Loss,$3.00,$-13.50,$52461.50,20,$-13.50
2024-01-26,08:55:00,17485.25,SELL,3,0.02h,Break Even,$-1.50,$-15.00,$52460.00,20,$-15.00
2024-01-26,09:18:00,17486.75,BUY,3,0.02h,Break Even,$-1.50,$-16.50,$52458.50,20,$-16.50
2024-01-26,10:37:00,17533.75,SELL,3,0.02h,Stop Loss,$-9.00,$-25.50,$52449.50,20,$-25.50
2024-01-26,10:43:00,17544.0,BUY,3,0.02h,Stop Loss,$-9.00,$-34.50,$52440.50,20,$-34.50
2024-01-26,10:52:00,17527.75,SELL,3,0.02h,Break Even,$-1.50,$-36.00,$52439.00,20,$-36.00
2024-01-26,11:05:00,17540.0,BUY,3,0.02h,Stop Loss,$-9.00,$-45.00,$52430.00,20,$-45.00
2024-01-26,11:07:00,17529.25,SELL,3,0.02h,Break Even,$-1.50,$-46.50,$52428.50,20,$-46.50
2024-01-26,11:24:00,17539.75,BUY,3,0.02h,Stop Loss,$-9.00,$-55.50,$52419.50,20,$-55.50
2024-01-26,11:46:00,17536.25,SELL,3,0.02h,Break Even,$-1.50,$-57.00,$52418.00,20,$-57.00
2024-01-26,11:50:00,17543.25,BUY,3,0.02h,Break Even,$-1.50,$-58.50,$52416.50,20,$-58.50
2024-01-26,12:52:00,17573.0,SELL,3,0.02h,Stop Loss,$-9.00,$-67.50,$52407.50,20,$-67.50
2024-01-26,13:08:00,17580.75,BUY,3,0.02h,Stop Loss,$3.00,$-64.50,$52410.50,20,$-64.50
2024-01-26,13:20:00,17573.25,SELL,3,0.02h,Stop Loss,$-9.00,$-73.50,$52401.50,20,$-73.50
2024-01-26,13:21:00,17580.75,BUY,3,0.02h,Break Even,$-1.50,$-75.00,$52400.00,20,$-75.00
2024-01-26,13:24:00,17575.5,SELL,3,0.02h,Break Even,$-1.50,$-76.50,$52398.50,20,$-76.50
2024-01-26,13:43:00,17586.25,BUY,3,0.02h,Stop Loss,$-9.00,$-85.50,$52389.50,20,$-85.50
2024-01-26,14:04:00,17578.0,SELL,3,0.02h,Stop Loss,$52.50,$-33.00,$52442.00,20,$-33.00
2024-01-26,14:34:00,17567.25,BUY,3,0.02h,Stop Loss,$4.50,$-28.50,$52446.50,20,$-28.50
2024-01-26,14:36:00,17549.25,SELL,3,0.02h,Stop Loss,$85.50,$57.00,$52532.00,20,$57.00
2024-01-26,15:15:00,17541.5,BUY,3,0.02h,Stop Loss,$-9.00,$48.00,$52523.00,20,$48.00
2024-01-26,15:17:00,17528.5,SELL,3,0.02h,Stop Loss,$49.50,$97.50,$52572.50,20,$97.50
2024-01-26,15:22:00,17553.25,BUY,3,0.02h,Stop Loss,$31.50,$129.00,$52604.00,20,$129.00
2024-01-26,16:15:00,17595.0,SELL,3,0.02h,Stop Loss,$-9.00,$120.00,$52595.00,20,$120.00
2024-01-26,16:24:00,17612.75,BUY,3,0.02h,Stop Loss,$-9.00,$111.00,$52586.00,20,$111.00
2024-01-26,16:38:00,17595.75,SELL,3,0.02h,Stop Loss,$55.50,$166.50,$52641.50,20,$166.50
2024-01-26,16:53:00,17602.25,BUY,3,0.02h,Break Even,$-1.50,$165.00,$52640.00,20,$165.00
2024-01-26,17:26:00,17604.5,SELL,3,0.02h,Stop Loss,$37.50,$202.50,$52677.50,20,$202.50
2024-01-26,18:13:00,17540.25,BUY,3,0.02h,Stop Loss,$-9.00,$193.50,$52668.50,20,$193.50
2024-01-26,18:16:00,17528.0,SELL,3,0.02h,Stop Loss,$10.50,$204.00,$52679.00,20,$204.00
2024-01-26,18:24:00,17541.0,BUY,3,0.02h,Stop Loss,$-9.00,$195.00,$52670.00,20,$195.00
2024-01-26,18:42:00,17521.25,SELL,3,0.02h,Stop Loss,$36.00,$231.00,$52706.00,20,$231.00
2024-01-26,19:03:00,17530.75,BUY,3,0.02h,Stop Loss,$16.50,$247.50,$52722.50,20,$247.50
2024-01-26,19:24:00,17527.75,SELL,3,0.02h,Stop Loss,$9.00,$256.50,$52731.50,20,$256.50
2024-01-26,19:38:00,17539.75,BUY,3,0.02h,Break Even,$-1.50,$255.00,$52730.00,20,$255.00
2024-01-26,20:10:00,17551.5,SELL,3,0.02h,Stop Loss,$-9.00,$246.00,$52721.00,20,$246.00
2024-01-26,20:11:00,17557.25,BUY,3,0.02h,Stop Loss,$-9.00,$237.00,$52712.00,20,$237.00
2024-01-26,20:12:00,17552.0,SELL,3,0.02h,Break Even,$-1.50,$235.50,$52710.50,20,$235.50
2024-01-26,20:14:00,17558.25,BUY,3,0.02h,Stop Loss,$9.00,$244.50,$52719.50,20,$244.50
2024-01-26,20:22:00,17547.75,SELL,3,0.02h,Stop Loss,$24.00,$268.50,$52743.50,20,$268.50
,,,,,,,,,,,
2024-01-29,00:39:00,17490.75,BUY,3,0.02h,Stop Loss,$-9.00,$-9.00,$52734.50,21,$-9.00
2024-01-29,02:12:00,17531.25,SELL,3,0.02h,Break Even,$-1.50,$-10.50,$52733.00,21,$-10.50
2024-01-29,02:43:00,17532.0,BUY,3,0.03h,Stop Loss,$-9.00,$-19.50,$52724.00,21,$-19.50
2024-01-29,02:48:00,17527.75,SELL,3,0.02h,Stop Loss,$-9.00,$-28.50,$52715.00,21,$-28.50
2024-01-29,02:58:00,17532.0,BUY,3,0.02h,Stop Loss,$6.00,$-22.50,$52721.00,21,$-22.50
2024-01-29,03:21:00,17535.5,SELL,3,0.02h,Break Even,$-1.50,$-24.00,$52719.50,21,$-24.00
2024-01-29,03:46:00,17534.5,BUY,3,0.02h,Stop Loss,$-9.00,$-33.00,$52710.50,21,$-33.00
2024-01-29,04:16:00,17533.75,SELL,3,0.07h,Break Even,$-1.50,$-34.50,$52709.00,21,$-34.50
2024-01-29,04:47:00,17535.5,BUY,3,0.05h,Stop Loss,$-9.00,$-43.50,$52700.00,21,$-43.50
2024-01-29,04:55:00,17531.75,SELL,3,0.03h,Stop Loss,$-9.00,$-52.50,$52691.00,21,$-52.50
2024-01-29,05:05:00,17535.75,BUY,3,0.02h,Stop Loss,$-9.00,$-61.50,$52682.00,21,$-61.50
2024-01-29,05:08:00,17530.5,SELL,3,0.02h,Stop Loss,$-9.00,$-70.50,$52673.00,21,$-70.50
2024-01-29,05:32:00,17532.0,BUY,3,0.02h,Stop Loss,$-9.00,$-79.50,$52664.00,21,$-79.50
2024-01-29,05:35:00,17529.0,SELL,3,0.02h,Stop Loss,$-9.00,$-88.50,$52655.00,21,$-88.50
2024-01-29,05:36:00,17530.75,BUY,3,0.02h,Stop Loss,$-9.00,$-97.50,$52646.00,21,$-97.50
2024-01-29,05:37:00,17528.5,SELL,3,0.02h,Stop Loss,$-9.00,$-106.50,$52637.00,21,$-106.50
2024-01-29,05:40:00,17532.5,BUY,3,0.02h,Break Even,$-1.50,$-108.00,$52635.50,21,$-108.00
2024-01-29,06:43:00,17542.25,SELL,3,0.02h,Break Even,$-1.50,$-109.50,$52634.00,21,$-109.50
2024-01-29,06:46:00,17544.5,BUY,3,0.02h,Stop Loss,$13.50,$-96.00,$52647.50,21,$-96.00
2024-01-29,07:03:00,17545.0,SELL,3,0.02h,Stop Loss,$3.00,$-93.00,$52650.50,21,$-93.00
2024-01-29,07:06:00,17548.25,BUY,3,0.03h,Stop Loss,$13.50,$-79.50,$52664.00,21,$-79.50
2024-01-29,07:25:00,17546.0,SELL,3,0.02h,Stop Loss,$-9.00,$-88.50,$52655.00,21,$-88.50
2024-01-29,07:33:00,17550.75,BUY,3,0.02h,Stop Loss,$-9.00,$-97.50,$52646.00,21,$-97.50
2024-01-29,07:35:00,17547.5,SELL,3,0.02h,Break Even,$-1.50,$-99.00,$52644.50,21,$-99.00
2024-01-29,07:42:00,17549.0,BUY,3,0.02h,Break Even,$-1.50,$-100.50,$52643.00,21,$-100.50
2024-01-29,08:07:00,17549.5,SELL,3,0.02h,Break Even,$-1.50,$-102.00,$52641.50,21,$-102.00
2024-01-29,08:20:00,17554.5,BUY,3,0.02h,Break Even,$-1.50,$-103.50,$52640.00,21,$-103.50
2024-01-29,09:15:00,17574.0,SELL,3,0.02h,Break Even,$-1.50,$-105.00,$52638.50,21,$-105.00
2024-01-29,10:06:00,17556.25,BUY,3,0.02h,Break Even,$-1.50,$-106.50,$52637.00,21,$-106.50
2024-01-29,10:38:00,17554.75,SELL,3,0.02h,Break Even,$-1.50,$-108.00,$52635.50,21,$-108.00
2024-01-29,10:41:00,17564.25,BUY,3,0.02h,Break Even,$-1.50,$-109.50,$52634.00,21,$-109.50
2024-01-29,11:01:00,17562.5,SELL,3,0.02h,Stop Loss,$12.00,$-97.50,$52646.00,21,$-97.50
2024-01-29,11:23:00,17564.75,BUY,3,0.02h,Break Even,$-1.50,$-99.00,$52644.50,21,$-99.00
2024-01-29,12:01:00,17562.75,SELL,3,0.02h,Stop Loss,$-9.00,$-108.00,$52635.50,21,$-108.00
2024-01-29,12:04:00,17573.0,BUY,3,0.02h,Break Even,$-1.50,$-109.50,$52634.00,21,$-109.50
2024-01-29,12:19:00,17564.75,SELL,3,0.02h,Break Even,$-1.50,$-111.00,$52632.50,21,$-111.00
2024-01-29,12:21:00,17572.25,BUY,3,0.02h,Stop Loss,$-9.00,$-120.00,$52623.50,21,$-120.00
2024-01-29,12:22:00,17568.75,SELL,3,0.02h,Stop Loss,$-9.00,$-129.00,$52614.50,21,$-129.00
2024-01-29,12:29:00,17572.0,BUY,3,0.02h,Break Even,$-1.50,$-130.50,$52613.00,21,$-130.50
2024-01-29,12:31:00,17568.5,SELL,3,0.02h,Break Even,$-1.50,$-132.00,$52611.50,21,$-132.00
2024-01-29,13:09:00,17564.0,BUY,3,0.02h,Stop Loss,$-9.00,$-141.00,$52602.50,21,$-141.00
2024-01-29,13:20:00,17552.0,SELL,3,0.02h,Break Even,$-1.50,$-142.50,$52601.00,21,$-142.50
2024-01-29,13:55:00,17548.75,BUY,3,0.02h,Stop Loss,$-9.00,$-151.50,$52592.00,21,$-151.50
2024-01-29,14:02:00,17541.25,SELL,3,0.02h,Break Even,$-1.50,$-153.00,$52590.50,21,$-153.00
2024-01-29,14:07:00,17548.25,BUY,3,0.02h,Break Even,$-1.50,$-154.50,$52589.00,21,$-154.50
2024-01-29,14:16:00,17543.25,SELL,3,0.02h,Stop Loss,$6.00,$-148.50,$52595.00,21,$-148.50
2024-01-29,14:23:00,17551.25,BUY,3,0.02h,Break Even,$-1.50,$-150.00,$52593.50,21,$-150.00
2024-01-29,14:31:00,17537.5,SELL,3,0.02h,Stop Loss,$25.50,$-124.50,$52619.00,21,$-124.50
2024-01-29,14:35:00,17553.25,BUY,3,0.02h,Stop Loss,$31.50,$-93.00,$52650.50,21,$-93.00
2024-01-29,14:58:00,17557.25,SELL,3,0.02h,Stop Loss,$13.50,$-79.50,$52664.00,21,$-79.50
2024-01-29,15:15:00,17560.25,BUY,3,0.02h,Stop Loss,$28.50,$-51.00,$52692.50,21,$-51.00
2024-01-29,15:23:00,17538.75,SELL,3,0.02h,Stop Loss,$7.50,$-43.50,$52700.00,21,$-43.50
2024-01-29,15:32:00,17560.5,BUY,3,0.02h,Break Even,$-1.50,$-45.00,$52698.50,21,$-45.00
2024-01-29,15:33:00,17550.25,SELL,3,0.02h,Stop Loss,$97.50,$52.50,$52796.00,21,$52.50
2024-01-29,16:12:00,17543.0,BUY,3,0.02h,Break Even,$-1.50,$51.00,$52794.50,21,$51.00
2024-01-29,17:47:00,17583.75,SELL,3,0.02h,Stop Loss,$-9.00,$42.00,$52785.50,21,$42.00
2024-01-29,17:57:00,17603.5,BUY,3,0.02h,Break Even,$-1.50,$40.50,$52784.00,21,$40.50
2024-01-29,18:02:00,17585.25,SELL,3,0.02h,Break Even,$-1.50,$39.00,$52782.50,21,$39.00
2024-01-29,18:22:00,17592.75,BUY,3,0.02h,Stop Loss,$-9.00,$30.00,$52773.50,21,$30.00
2024-01-29,18:23:00,17587.75,SELL,3,0.02h,Stop Loss,$-9.00,$21.00,$52764.50,21,$21.00
2024-01-29,18:26:00,17597.25,BUY,3,0.02h,Break Even,$-1.50,$19.50,$52763.00,21,$19.50
2024-01-29,18:53:00,17592.5,SELL,3,0.02h,Break Even,$-1.50,$18.00,$52761.50,21,$18.00
2024-01-29,19:08:00,17596.75,BUY,3,0.02h,Break Even,$-1.50,$16.50,$52760.00,21,$16.50
2024-01-29,19:54:00,17621.25,SELL,3,0.02h,Break Even,$-1.50,$15.00,$52758.50,21,$15.00
2024-01-29,19:56:00,17626.75,BUY,3,0.02h,Break Even,$-1.50,$13.50,$52757.00,21,$13.50
2024-01-29,20:45:00,17692.75,SELL,3,0.02h,Stop Loss,$43.50,$57.00,$52800.50,21,$57.00
2024-01-29,20:58:00,17698.5,BUY,3,0.02h,Stop Loss,$22.50,$79.50,$52823.00,21,$79.50
2024-01-29,21:07:00,17689.75,SELL,3,0.02h,Stop Loss,$-9.00,$70.50,$52814.00,21,$70.50
2024-01-29,21:16:00,17703.25,BUY,3,0.02h,Stop Loss,$7.50,$78.00,$52821.50,21,$78.00
2024-01-29,21:46:00,17701.5,SELL,3,0.02h,Stop Loss,$-9.00,$69.00,$52812.50,21,$69.00
2024-01-29,23:01:00,17711.5,BUY,3,0.02h,Stop Loss,$7.50,$76.50,$52820.00,21,$76.50
2024-01-29,23:43:00,17721.5,SELL,3,0.02h,Break Even,$-1.50,$75.00,$52818.50,21,$75.00
,,,,,,,,,,,
2024-01-30,00:18:00,17723.5,BUY,3,0.02h,Break Even,$-1.50,$-1.50,$52817.00,22,$-1.50
2024-01-30,00:51:00,17727.5,SELL,3,0.02h,Stop Loss,$-9.00,$-10.50,$52808.00,22,$-10.50
2024-01-30,01:15:00,17728.0,BUY,3,0.02h,Stop Loss,$-9.00,$-19.50,$52799.00,22,$-19.50
2024-01-30,01:18:00,17725.25,SELL,3,0.02h,Stop Loss,$16.50,$-3.00,$52815.50,22,$-3.00
2024-01-30,01:53:00,17714.5,BUY,3,0.02h,Break Even,$-1.50,$-4.50,$52814.00,22,$-4.50
2024-01-30,02:00:00,17712.0,SELL,3,0.02h,Break Even,$-1.50,$-6.00,$52812.50,22,$-6.00
2024-01-30,02:26:00,17711.0,BUY,3,0.02h,Stop Loss,$-9.00,$-15.00,$52803.50,22,$-15.00
2024-01-30,02:28:00,17708.0,SELL,3,0.02h,Stop Loss,$-9.00,$-24.00,$52794.50,22,$-24.00
2024-01-30,02:31:00,17711.0,BUY,3,0.03h,Break Even,$-1.50,$-25.50,$52793.00,22,$-25.50
2024-01-30,03:13:00,17713.75,SELL,3,0.02h,Stop Loss,$-9.00,$-34.50,$52784.00,22,$-34.50
2024-01-30,03:19:00,17718.5,BUY,3,0.02h,Stop Loss,$-9.00,$-43.50,$52775.00,22,$-43.50
2024-01-30,03:23:00,17716.75,SELL,3,0.02h,Break Even,$-1.50,$-45.00,$52773.50,22,$-45.00
2024-01-30,03:24:00,17717.75,BUY,3,0.02h,Stop Loss,$-9.00,$-54.00,$52764.50,22,$-54.00
2024-01-30,03:38:00,17717.5,SELL,3,0.08h,Break Even,$-1.50,$-55.50,$52763.00,22,$-55.50
2024-01-30,04:13:00,17714.5,BUY,3,0.02h,Stop Loss,$-9.00,$-64.50,$52754.00,22,$-64.50
2024-01-30,04:18:00,17712.5,SELL,3,0.05h,Stop Loss,$-9.00,$-73.50,$52745.00,22,$-73.50
2024-01-30,04:21:00,17714.0,BUY,3,0.05h,Stop Loss,$-9.00,$-82.50,$52736.00,22,$-82.50
2024-01-30,04:42:00,17711.75,SELL,3,0.05h,Stop Loss,$-9.00,$-91.50,$52727.00,22,$-91.50
2024-01-30,04:52:00,17714.25,BUY,3,0.02h,Break Even,$-1.50,$-93.00,$52725.50,22,$-93.00
2024-01-30,04:57:00,17713.25,SELL,3,0.03h,Break Even,$-1.50,$-94.50,$52724.00,22,$-94.50
2024-01-30,05:04:00,17715.0,BUY,3,0.03h,Stop Loss,$-9.00,$-103.50,$52715.00,22,$-103.50
2024-01-30,05:18:00,17713.75,SELL,3,0.05h,Stop Loss,$-9.00,$-112.50,$52706.00,22,$-112.50
2024-01-30,05:21:00,17715.25,BUY,3,0.03h,Stop Loss,$-9.00,$-121.50,$52697.00,22,$-121.50
2024-01-30,05:58:00,17722.0,SELL,3,0.02h,Stop Loss,$-9.00,$-130.50,$52688.00,22,$-130.50
2024-01-30,06:01:00,17725.25,BUY,3,0.02h,Stop Loss,$-9.00,$-139.50,$52679.00,22,$-139.50
2024-01-30,06:06:00,17720.0,SELL,3,0.02h,Break Even,$-1.50,$-141.00,$52677.50,22,$-141.00
2024-01-30,06:53:00,17710.0,BUY,3,0.02h,Stop Loss,$-9.00,$-150.00,$52668.50,22,$-150.00
2024-01-30,06:54:00,17707.75,SELL,3,0.02h,Break Even,$-1.50,$-151.50,$52667.00,22,$-151.50
2024-01-30,07:48:00,17687.25,BUY,3,0.02h,Stop Loss,$-9.00,$-160.50,$52658.00,22,$-160.50
2024-01-30,08:04:00,17682.0,SELL,3,0.02h,Stop Loss,$6.00,$-154.50,$52664.00,22,$-154.50
2024-01-30,08:22:00,17690.5,BUY,3,0.02h,Stop Loss,$-9.00,$-163.50,$52655.00,22,$-163.50
2024-01-30,09:13:00,17707.75,SELL,3,0.02h,Break Even,$-1.50,$-165.00,$52653.50,22,$-165.00
2024-01-30,10:03:00,17694.5,BUY,3,0.02h,Stop Loss,$-9.00,$-174.00,$52644.50,22,$-174.00
2024-01-30,10:07:00,17691.0,SELL,3,0.02h,Stop Loss,$-9.00,$-183.00,$52635.50,22,$-183.00
2024-01-30,10:12:00,17694.25,BUY,3,0.03h,Stop Loss,$13.50,$-169.50,$52649.00,22,$-169.50
2024-01-30,10:45:00,17702.5,SELL,3,0.02h,Break Even,$-1.50,$-171.00,$52647.50,22,$-171.00
2024-01-30,11:30:00,17696.25,BUY,3,0.02h,Stop Loss,$28.50,$-142.50,$52676.00,22,$-142.50
2024-01-30,12:07:00,17697.0,SELL,3,0.02h,Break Even,$-1.50,$-144.00,$52674.50,22,$-144.00
2024-01-30,12:22:00,17698.0,BUY,3,0.02h,Break Even,$-1.50,$-145.50,$52673.00,22,$-145.50
2024-01-30,12:28:00,17691.25,SELL,3,0.02h,Stop Loss,$-9.00,$-154.50,$52664.00,22,$-154.50
2024-01-30,13:31:00,17668.5,BUY,3,0.02h,Break Even,$-1.50,$-156.00,$52662.50,22,$-156.00
2024-01-30,13:37:00,17660.0,SELL,3,0.02h,Stop Loss,$-9.00,$-165.00,$52653.50,22,$-165.00
2024-01-30,14:02:00,17664.0,BUY,3,0.02h,Break Even,$-1.50,$-166.50,$52652.00,22,$-166.50
2024-01-30,14:15:00,17657.75,SELL,3,0.02h,Break Even,$-1.50,$-168.00,$52650.50,22,$-168.00
2024-01-30,14:27:00,17664.75,BUY,3,0.02h,Stop Loss,$4.50,$-163.50,$52655.00,22,$-163.50
2024-01-30,14:56:00,17668.25,SELL,3,0.02h,Stop Loss,$22.50,$-141.00,$52677.50,22,$-141.00
2024-01-30,15:21:00,17657.0,BUY,3,0.02h,Break Even,$-1.50,$-142.50,$52676.00,22,$-142.50
2024-01-30,15:22:00,17651.25,SELL,3,0.02h,Stop Loss,$15.00,$-127.50,$52691.00,22,$-127.50
2024-01-30,15:24:00,17657.0,BUY,3,0.02h,Stop Loss,$-9.00,$-136.50,$52682.00,22,$-136.50
2024-01-30,15:26:00,17644.75,SELL,3,0.02h,Stop Loss,$61.50,$-75.00,$52743.50,22,$-75.00
2024-01-30,15:32:00,17658.25,BUY,3,0.02h,Stop Loss,$25.50,$-49.50,$52769.00,22,$-49.50
2024-01-30,15:43:00,17650.0,SELL,3,0.02h,Stop Loss,$49.50,$0.00,$52818.50,22,$0.00
2024-01-30,16:24:00,17639.0,BUY,3,0.02h,Stop Loss,$10.50,$10.50,$52829.00,22,$10.50
2024-01-30,16:55:00,17636.5,SELL,3,0.02h,Stop Loss,$10.50,$21.00,$52839.50,22,$21.00
2024-01-30,18:14:00,17575.5,BUY,3,0.02h,Stop Loss,$6.00,$27.00,$52845.50,22,$27.00
2024-01-30,18:45:00,17583.5,SELL,3,0.02h,Stop Loss,$25.50,$52.50,$52871.00,22,$52.50
2024-01-30,19:24:00,17577.5,BUY,3,0.02h,Break Even,$-1.50,$51.00,$52869.50,22,$51.00
2024-01-30,20:06:00,17579.75,SELL,3,0.02h,Break Even,$-1.50,$49.50,$52868.00,22,$49.50
2024-01-30,20:21:00,17590.5,BUY,3,0.02h,Stop Loss,$3.00,$52.50,$52871.00,22,$52.50
2024-01-30,20:35:00,17580.5,SELL,3,0.02h,Break Even,$-1.50,$51.00,$52869.50,22,$51.00
2024-01-30,20:48:00,17593.5,BUY,3,0.02h,Stop Loss,$3.00,$54.00,$52872.50,22,$54.00
2024-01-30,20:55:00,17582.0,SELL,3,0.02h,Stop Loss,$-9.00,$45.00,$52863.50,22,$45.00
2024-01-30,21:01:00,17594.75,BUY,3,0.02h,Stop Loss,$52.50,$97.50,$52916.00,22,$97.50
2024-01-30,21:02:00,17578.75,SELL,3,0.02h,Stop Loss,$271.50,$369.00,$53187.50,22,$369.00
2024-01-30,23:42:00,17450.5,BUY,3,0.02h,Break Even,$-1.50,$367.50,$53186.00,22,$367.50
,,,,,,,,,,,
2024-01-31,00:25:00,17453.0,SELL,3,0.02h,Stop Loss,$-9.00,$-9.00,$53177.00,23,$-9.00
2024-01-31,01:09:00,17450.0,BUY,3,0.02h,Stop Loss,$-9.00,$-18.00,$53168.00,23,$-18.00
2024-01-31,01:25:00,17446.5,SELL,3,0.02h,Break Even,$-1.50,$-19.50,$53166.50,23,$-19.50
2024-01-31,02:22:00,17434.0,BUY,3,0.02h,Stop Loss,$-9.00,$-28.50,$53157.50,23,$-28.50
2024-01-31,02:53:00,17433.5,SELL,3,0.03h,Stop Loss,$-9.00,$-37.50,$53148.50,23,$-37.50
2024-01-31,02:58:00,17438.5,BUY,3,0.02h,Stop Loss,$-9.00,$-46.50,$53139.50,23,$-46.50
2024-01-31,03:30:00,17439.5,SELL,3,0.02h,Break Even,$-1.50,$-48.00,$53138.00,23,$-48.00
2024-01-31,03:49:00,17440.75,BUY,3,0.03h,Stop Loss,$-9.00,$-57.00,$53129.00,23,$-57.00
2024-01-31,03:52:00,17436.75,SELL,3,0.02h,Stop Loss,$-9.00,$-66.00,$53120.00,23,$-66.00
2024-01-31,03:56:00,17440.5,BUY,3,0.02h,Stop Loss,$-9.00,$-75.00,$53111.00,23,$-75.00
2024-01-31,03:59:00,17437.75,SELL,3,0.02h,Break Even,$-1.50,$-76.50,$53109.50,23,$-76.50
2024-01-31,04:04:00,17440.5,BUY,3,0.02h,Break Even,$-1.50,$-78.00,$53108.00,23,$-78.00
2024-01-31,04:31:00,17441.75,SELL,3,0.03h,Stop Loss,$-9.00,$-87.00,$53099.00,23,$-87.00
2024-01-31,04:34:00,17445.0,BUY,3,0.03h,Stop Loss,$-9.00,$-96.00,$53090.00,23,$-96.00
2024-01-31,04:37:00,17441.25,SELL,3,0.02h,Stop Loss,$-9.00,$-105.00,$53081.00,23,$-105.00
2024-01-31,04:38:00,17445.0,BUY,3,0.02h,Break Even,$-1.50,$-106.50,$53079.50,23,$-106.50
2024-01-31,05:13:00,17446.25,SELL,3,0.05h,Stop Loss,$-9.00,$-115.50,$53070.50,23,$-115.50
2024-01-31,05:20:00,17452.0,BUY,3,0.02h,Break Even,$-1.50,$-117.00,$53069.00,23,$-117.00
2024-01-31,05:37:00,17448.25,SELL,3,0.02h,Stop Loss,$-9.00,$-126.00,$53060.00,23,$-126.00
2024-01-31,06:06:00,17450.25,BUY,3,0.02h,Break Even,$-1.50,$-127.50,$53058.50,23,$-127.50
2024-01-31,06:35:00,17443.0,SELL,3,0.02h,Break Even,$-1.50,$-129.00,$53057.00,23,$-129.00
2024-01-31,07:06:00,17444.25,BUY,3,0.02h,Break Even,$-1.50,$-130.50,$53055.50,23,$-130.50
2024-01-31,07:58:00,17454.5,SELL,3,0.02h,Stop Loss,$-9.00,$-139.50,$53046.50,23,$-139.50
2024-01-31,08:04:00,17458.75,BUY,3,0.02h,Stop Loss,$-9.00,$-148.50,$53037.50,23,$-148.50
2024-01-31,08:09:00,17455.75,SELL,3,0.02h,Break Even,$-1.50,$-150.00,$53036.00,23,$-150.00
2024-01-31,08:11:00,17458.5,BUY,3,0.02h,Break Even,$-1.50,$-151.50,$53034.50,23,$-151.50
2024-01-31,08:33:00,17460.0,SELL,3,0.02h,Break Even,$-1.50,$-153.00,$53033.00,23,$-153.00
2024-01-31,09:50:00,17377.75,BUY,3,0.02h,Stop Loss,$22.50,$-130.50,$53055.50,23,$-130.50
2024-01-31,10:08:00,17371.25,SELL,3,0.02h,Stop Loss,$-9.00,$-139.50,$53046.50,23,$-139.50
2024-01-31,10:09:00,17379.0,BUY,3,0.02h,Break Even,$-1.50,$-141.00,$53045.00,23,$-141.00
2024-01-31,10:16:00,17368.75,SELL,3,0.02h,Stop Loss,$15.00,$-126.00,$53060.00,23,$-126.00
2024-01-31,10:24:00,17378.25,BUY,3,0.02h,Stop Loss,$-9.00,$-135.00,$53051.00,23,$-135.00
2024-01-31,10:27:00,17371.0,SELL,3,0.02h,Stop Loss,$-9.00,$-144.00,$53042.00,23,$-144.00
2024-01-31,10:30:00,17376.0,BUY,3,0.02h,Break Even,$-1.50,$-145.50,$53040.50,23,$-145.50
2024-01-31,10:39:00,17368.0,SELL,3,0.02h,Break Even,$-1.50,$-147.00,$53039.00,23,$-147.00
2024-01-31,11:13:00,17365.0,BUY,3,0.02h,Stop Loss,$-9.00,$-156.00,$53030.00,23,$-156.00
2024-01-31,12:28:00,17388.0,SELL,3,0.02h,Break Even,$-1.50,$-157.50,$53028.50,23,$-157.50
2024-01-31,12:32:00,17400.25,BUY,3,0.02h,Stop Loss,$-9.00,$-166.50,$53019.50,23,$-166.50
2024-01-31,12:33:00,17396.0,SELL,3,0.02h,Stop Loss,$18.00,$-148.50,$53037.50,23,$-148.50
2024-01-31,12:36:00,17397.5,BUY,3,0.02h,Stop Loss,$-9.00,$-157.50,$53028.50,23,$-157.50
2024-01-31,12:37:00,17390.25,SELL,3,0.02h,Stop Loss,$-9.00,$-166.50,$53019.50,23,$-166.50
2024-01-31,12:46:00,17400.75,BUY,3,0.02h,Stop Loss,$6.00,$-160.50,$53025.50,23,$-160.50
2024-01-31,13:28:00,17425.25,SELL,3,0.02h,Stop Loss,$-9.00,$-169.50,$53016.50,23,$-169.50
2024-01-31,13:31:00,17435.75,BUY,3,0.02h,Stop Loss,$-9.00,$-178.50,$53007.50,23,$-178.50
2024-01-31,13:36:00,17422.0,SELL,3,0.02h,Stop Loss,$52.50,$-126.00,$53060.00,23,$-126.00
2024-01-31,14:34:00,17408.0,BUY,3,0.02h,Stop Loss,$88.50,$-37.50,$53148.50,23,$-37.50
2024-01-31,14:40:00,17389.5,SELL,3,0.02h,Stop Loss,$109.50,$72.00,$53258.00,23,$72.00
2024-01-31,16:02:00,17319.75,BUY,3,0.02h,Stop Loss,$16.50,$88.50,$53274.50,23,$88.50
2024-01-31,16:34:00,17327.0,SELL,3,0.02h,Stop Loss,$6.00,$94.50,$53280.50,23,$94.50
2024-01-31,16:38:00,17337.0,BUY,3,0.02h,Break Even,$-1.50,$93.00,$53279.00,23,$93.00
2024-01-31,16:42:00,17329.75,SELL,3,0.02h,Break Even,$-1.50,$91.50,$53277.50,23,$91.50
2024-01-31,16:45:00,17336.0,BUY,3,0.02h,Stop Loss,$30.00,$121.50,$53307.50,23,$121.50
2024-01-31,16:54:00,17321.25,SELL,3,0.02h,Stop Loss,$-9.00,$112.50,$53298.50,23,$112.50
2024-01-31,16:57:00,17340.75,BUY,3,0.02h,Stop Loss,$3.00,$115.50,$53301.50,23,$115.50
2024-01-31,17:24:00,17347.5,SELL,3,0.02h,Stop Loss,$-9.00,$106.50,$53292.50,23,$106.50
2024-01-31,17:27:00,17359.0,BUY,3,0.02h,Break Even,$-1.50,$105.00,$53291.00,23,$105.00
2024-01-31,17:36:00,17349.0,SELL,3,0.02h,Stop Loss,$27.00,$132.00,$53318.00,23,$132.00
2024-01-31,17:52:00,17360.75,BUY,3,0.02h,Stop Loss,$-9.00,$123.00,$53309.00,23,$123.00
2024-01-31,18:29:00,17375.5,SELL,3,0.02h,Stop Loss,$3.00,$126.00,$53312.00,23,$126.00
2024-01-31,18:47:00,17391.25,BUY,3,0.02h,Break Even,$-1.50,$124.50,$53310.50,23,$124.50
2024-01-31,19:00:00,17381.0,SELL,3,0.02h,Stop Loss,$282.00,$406.50,$53592.50,23,$406.50
2024-01-31,19:33:00,17363.5,BUY,3,0.02h,Stop Loss,$27.00,$433.50,$53619.50,23,$433.50
2024-01-31,20:00:00,17379.0,SELL,3,0.02h,Stop Loss,$109.50,$543.00,$53729.00,23,$543.00
2024-01-31,21:11:00,17263.0,BUY,3,0.02h,Stop Loss,$12.00,$555.00,$53741.00,23,$555.00
2024-01-31,21:25:00,17255.25,SELL,3,0.02h,Break Even,$-1.50,$553.50,$53739.50,23,$553.50
2024-01-31,21:38:00,17262.75,BUY,3,0.02h,Break Even,$-1.50,$552.00,$53738.00,23,$552.00
2024-01-31,21:41:00,17249.75,SELL,3,0.02h,Break Even,$-1.50,$550.50,$53736.50,23,$550.50
2024-01-31,21:51:00,17259.0,BUY,3,0.02h,Stop Loss,$10.50,$561.00,$53747.00,23,$561.00
2024-01-31,23:59:00,17283.0,SELL,3,0.02h,Break Even,$-1.50,$559.50,$53745.50,23,$559.50
,,,,,,,,,,,
2024-02-01,00:14:00,17287.25,BUY,3,0.02h,Break Even,$-1.50,$-1.50,$53744.00,24,$-1.50
2024-02-01,00:56:00,17303.0,SELL,3,0.03h,Stop Loss,$-9.00,$-10.50,$53735.00,24,$-10.50
2024-02-01,01:05:00,17310.5,BUY,3,0.02h,Stop Loss,$-9.00,$-19.50,$53726.00,24,$-19.50
2024-02-01,01:10:00,17300.75,SELL,3,0.02h,Stop Loss,$-9.00,$-28.50,$53717.00,24,$-28.50
2024-02-01,01:15:00,17306.25,BUY,3,0.02h,Stop Loss,$-9.00,$-37.50,$53708.00,24,$-37.50
2024-02-01,01:17:00,17303.0,SELL,3,0.02h,Break Even,$-1.50,$-39.00,$53706.50,24,$-39.00
2024-02-01,01:46:00,17299.25,BUY,3,0.02h,Stop Loss,$10.50,$-28.50,$53717.00,24,$-28.50
2024-02-01,02:51:00,17316.75,SELL,3,0.02h,Break Even,$-1.50,$-30.00,$53715.50,24,$-30.00
2024-02-01,03:02:00,17319.0,BUY,3,0.03h,Break Even,$-1.50,$-31.50,$53714.00,24,$-31.50
2024-02-01,03:18:00,17316.5,SELL,3,0.02h,Stop Loss,$-9.00,$-40.50,$53705.00,24,$-40.50
2024-02-01,03:52:00,17308.25,BUY,3,0.03h,Break Even,$-1.50,$-42.00,$53703.50,24,$-42.00
2024-02-01,04:48:00,17316.75,SELL,3,0.02h,Break Even,$-1.50,$-43.50,$53702.00,24,$-43.50
2024-02-01,04:55:00,17321.5,BUY,3,0.03h,Stop Loss,$-9.00,$-52.50,$53693.00,24,$-52.50
2024-02-01,04:58:00,17317.75,SELL,3,0.05h,Break Even,$-1.50,$-54.00,$53691.50,24,$-54.00
2024-02-01,06:14:00,17304.25,BUY,3,0.02h,Break Even,$-1.50,$-55.50,$53690.00,24,$-55.50
2024-02-01,06:18:00,17298.25,SELL,3,0.02h,Stop Loss,$-9.00,$-64.50,$53681.00,24,$-64.50
2024-02-01,06:44:00,17298.25,BUY,3,0.02h,Break Even,$-1.50,$-66.00,$53679.50,24,$-66.00
2024-02-01,06:51:00,17285.75,SELL,3,0.02h,Stop Loss,$-9.00,$-75.00,$53670.50,24,$-75.00
2024-02-01,07:19:00,17286.5,BUY,3,0.02h,Stop Loss,$-9.00,$-84.00,$53661.50,24,$-84.00
2024-02-01,08:38:00,17328.25,SELL,3,0.02h,Stop Loss,$-9.00,$-93.00,$53652.50,24,$-93.00
2024-02-01,08:40:00,17340.0,BUY,3,0.02h,Stop Loss,$27.00,$-66.00,$53679.50,24,$-66.00
2024-02-01,09:05:00,17335.0,SELL,3,0.02h,Stop Loss,$21.00,$-45.00,$53700.50,24,$-45.00
2024-02-01,09:18:00,17346.0,BUY,3,0.02h,Break Even,$-1.50,$-46.50,$53699.00,24,$-46.50
2024-02-01,09:22:00,17335.0,SELL,3,0.02h,Break Even,$-1.50,$-48.00,$53697.50,24,$-48.00
2024-02-01,09:34:00,17340.25,BUY,3,0.02h,Stop Loss,$-9.00,$-57.00,$53688.50,24,$-57.00
2024-02-01,09:35:00,17334.5,SELL,3,0.02h,Stop Loss,$4.50,$-52.50,$53693.00,24,$-52.50
2024-02-01,09:50:00,17337.0,BUY,3,0.02h,Break Even,$-1.50,$-54.00,$53691.50,24,$-54.00
2024-02-01,10:01:00,17329.0,SELL,3,0.02h,Break Even,$-1.50,$-55.50,$53690.00,24,$-55.50
2024-02-01,10:04:00,17337.0,BUY,3,0.02h,Stop Loss,$4.50,$-51.00,$53694.50,24,$-51.00
2024-02-01,11:10:00,17343.0,SELL,3,0.02h,Break Even,$-1.50,$-52.50,$53693.00,24,$-52.50
2024-02-01,12:00:00,17337.5,BUY,3,0.02h,Break Even,$-1.50,$-54.00,$53691.50,24,$-54.00
2024-02-01,12:03:00,17332.5,SELL,3,0.02h,Break Even,$-1.50,$-55.50,$53690.00,24,$-55.50
2024-02-01,12:04:00,17338.0,BUY,3,0.02h,Break Even,$-1.50,$-57.00,$53688.50,24,$-57.00
2024-02-01,12:59:00,17344.25,SELL,3,0.02h,Stop Loss,$-9.00,$-66.00,$53679.50,24,$-66.00
2024-02-01,13:31:00,17343.75,BUY,3,0.02h,Break Even,$-1.50,$-67.50,$53678.00,24,$-67.50
2024-02-01,14:01:00,17339.25,SELL,3,0.02h,Stop Loss,$-9.00,$-76.50,$53669.00,24,$-76.50
2024-02-01,14:02:00,17347.25,BUY,3,0.02h,Break Even,$-1.50,$-78.00,$53667.50,24,$-78.00
2024-02-01,14:05:00,17326.25,SELL,3,0.02h,Stop Loss,$4.50,$-73.50,$53672.00,24,$-73.50
2024-02-01,14:43:00,17332.25,BUY,3,0.02h,Break Even,$-1.50,$-75.00,$53670.50,24,$-75.00
2024-02-01,14:49:00,17310.25,SELL,3,0.02h,Stop Loss,$21.00,$-54.00,$53691.50,24,$-54.00
2024-02-01,15:08:00,17327.25,BUY,3,0.02h,Stop Loss,$91.50,$37.50,$53783.00,24,$37.50
2024-02-01,15:45:00,17343.25,SELL,3,0.02h,Break Even,$-1.50,$36.00,$53781.50,24,$36.00
2024-02-01,16:24:00,17295.0,BUY,3,0.02h,Stop Loss,$4.50,$40.50,$53786.00,24,$40.50
2024-02-01,16:26:00,17283.25,SELL,3,0.02h,Break Even,$-1.50,$39.00,$53784.50,24,$39.00
2024-02-01,16:33:00,17296.25,BUY,3,0.02h,Stop Loss,$60.00,$99.00,$53844.50,24,$99.00
2024-02-01,17:28:00,17353.0,SELL,3,0.02h,Stop Loss,$19.50,$118.50,$53864.00,24,$118.50
2024-02-01,17:47:00,17367.5,BUY,3,0.02h,Break Even,$-1.50,$117.00,$53862.50,24,$117.00
2024-02-01,18:04:00,17354.75,SELL,3,0.02h,Stop Loss,$76.50,$193.50,$53939.00,24,$193.50
2024-02-01,18:17:00,17369.5,BUY,3,0.02h,Stop Loss,$3.00,$196.50,$53942.00,24,$196.50
2024-02-01,18:39:00,17355.75,SELL,3,0.02h,Stop Loss,$28.50,$225.00,$53970.50,24,$225.00
2024-02-01,18:50:00,17374.75,BUY,3,0.02h,Stop Loss,$31.50,$256.50,$54002.00,24,$256.50
2024-02-01,19:35:00,17383.25,SELL,3,0.02h,Stop Loss,$-9.00,$247.50,$53993.00,24,$247.50
2024-02-01,19:40:00,17397.25,BUY,3,0.02h,Stop Loss,$39.00,$286.50,$54032.00,24,$286.50
2024-02-01,20:48:00,17434.0,SELL,3,0.02h,Stop Loss,$42.00,$328.50,$54074.00,24,$328.50
2024-02-01,21:02:00,17462.0,BUY,3,0.02h,Stop Loss,$45.00,$373.50,$54119.00,24,$373.50
2024-02-01,23:06:00,17591.5,SELL,3,0.02h,Stop Loss,$33.00,$406.50,$54152.00,24,$406.50
2024-02-01,23:42:00,17595.75,BUY,3,0.02h,Break Even,$-1.50,$405.00,$54150.50,24,$405.00
2024-02-01,23:58:00,17590.25,SELL,3,0.02h,Stop Loss,$-9.00,$396.00,$54141.50,24,$396.00
,,,,,,,,,,,
2024-02-02,00:26:00,17592.0,BUY,3,0.03h,Stop Loss,$-9.00,$-9.00,$54132.50,25,$-9.00
2024-02-02,01:49:00,17615.25,SELL,3,0.02h,Stop Loss,$-9.00,$-18.00,$54123.50,25,$-18.00
2024-02-02,01:53:00,17622.0,BUY,3,0.03h,Stop Loss,$-9.00,$-27.00,$54114.50,25,$-27.00
2024-02-02,02:12:00,17616.75,SELL,3,0.02h,Stop Loss,$-9.00,$-36.00,$54105.50,25,$-36.00
2024-02-02,02:44:00,17616.75,BUY,3,0.02h,Stop Loss,$-9.00,$-45.00,$54096.50,25,$-45.00
2024-02-02,03:14:00,17614.0,SELL,3,0.02h,Stop Loss,$-9.00,$-54.00,$54087.50,25,$-54.00
2024-02-02,04:16:00,17607.0,BUY,3,0.02h,Break Even,$-1.50,$-55.50,$54086.00,25,$-55.50
2024-02-02,04:48:00,17608.5,SELL,3,0.02h,Break Even,$-1.50,$-57.00,$54084.50,25,$-57.00
2024-02-02,05:09:00,17608.75,BUY,3,0.02h,Stop Loss,$-9.00,$-66.00,$54075.50,25,$-66.00
2024-02-02,05:54:00,17609.75,SELL,3,0.02h,Stop Loss,$-9.00,$-75.00,$54066.50,25,$-75.00
2024-02-02,06:31:00,17606.5,BUY,3,0.02h,Stop Loss,$-9.00,$-84.00,$54057.50,25,$-84.00
2024-02-02,06:56:00,17605.5,SELL,3,0.02h,Break Even,$-1.50,$-85.50,$54056.00,25,$-85.50
2024-02-02,07:23:00,17605.25,BUY,3,0.02h,Stop Loss,$-9.00,$-94.50,$54047.00,25,$-94.50
2024-02-02,07:27:00,17598.25,SELL,3,0.02h,Stop Loss,$-9.00,$-103.50,$54038.00,25,$-103.50
2024-02-02,07:35:00,17601.75,BUY,3,0.02h,Stop Loss,$-9.00,$-112.50,$54029.00,25,$-112.50
2024-02-02,07:36:00,17597.25,SELL,3,0.02h,Break Even,$-1.50,$-114.00,$54027.50,25,$-114.00
2024-02-02,08:23:00,17591.25,BUY,3,0.02h,Stop Loss,$9.00,$-105.00,$54036.50,25,$-105.00
2024-02-02,09:21:00,17616.5,SELL,3,0.02h,Break Even,$-1.50,$-106.50,$54035.00,25,$-106.50
2024-02-02,10:14:00,17612.75,BUY,3,0.02h,Stop Loss,$-9.00,$-115.50,$54026.00,25,$-115.50
2024-02-02,10:55:00,17616.75,SELL,3,0.02h,Stop Loss,$9.00,$-106.50,$54035.00,25,$-106.50
2024-02-02,11:16:00,17615.5,BUY,3,0.02h,Stop Loss,$-9.00,$-115.50,$54026.00,25,$-115.50
2024-02-02,11:27:00,17608.5,SELL,3,0.02h,Stop Loss,$-9.00,$-124.50,$54017.00,25,$-124.50
2024-02-02,11:30:00,17614.25,BUY,3,0.02h,Stop Loss,$-9.00,$-133.50,$54008.00,25,$-133.50
2024-02-02,12:06:00,17606.25,SELL,3,0.02h,Break Even,$-1.50,$-135.00,$54006.50,25,$-135.00
2024-02-02,12:18:00,17620.0,BUY,3,0.02h,Break Even,$-1.50,$-136.50,$54005.00,25,$-136.50
2024-02-02,12:51:00,17626.0,SELL,3,0.02h,Break Even,$-1.50,$-138.00,$54003.50,25,$-138.00
2024-02-02,13:05:00,17631.25,BUY,3,0.02h,Break Even,$-1.50,$-139.50,$54002.00,25,$-139.50
2024-02-02,13:10:00,17623.75,SELL,3,0.02h,Break Even,$-1.50,$-141.00,$54000.50,25,$-141.00
2024-02-02,14:36:00,17524.75,BUY,3,0.02h,Stop Loss,$28.50,$-112.50,$54029.00,25,$-112.50
2024-02-02,15:13:00,17571.0,SELL,3,0.02h,Stop Loss,$3.00,$-109.50,$54032.00,25,$-109.50
2024-02-02,15:15:00,17592.0,BUY,3,0.02h,Stop Loss,$31.50,$-78.00,$54063.50,25,$-78.00
2024-02-02,15:30:00,17584.75,SELL,3,0.02h,Stop Loss,$15.00,$-63.00,$54078.50,25,$-63.00
2024-02-02,15:40:00,17616.5,BUY,3,0.02h,Stop Loss,$73.50,$10.50,$54152.00,25,$10.50
2024-02-02,16:04:00,17613.75,SELL,3,0.02h,Stop Loss,$25.50,$36.00,$54177.50,25,$36.00
2024-02-02,16:11:00,17643.25,BUY,3,0.02h,Break Even,$-1.50,$34.50,$54176.00,25,$34.50
2024-02-02,17:45:00,17682.5,SELL,3,0.02h,Stop Loss,$42.00,$76.50,$54218.00,25,$76.50
2024-02-02,18:02:00,17721.5,BUY,3,0.02h,Break Even,$-1.50,$75.00,$54216.50,25,$75.00
2024-02-02,18:27:00,17696.5,SELL,3,0.02h,Stop Loss,$3.00,$78.00,$54219.50,25,$78.00
2024-02-02,18:45:00,17719.0,BUY,3,0.02h,Stop Loss,$42.00,$120.00,$54261.50,25,$120.00
2024-02-02,19:54:00,17752.75,SELL,3,0.02h,Stop Loss,$-9.00,$111.00,$54252.50,25,$111.00
2024-02-02,20:08:00,17762.75,BUY,3,0.02h,Break Even,$-1.50,$109.50,$54251.00,25,$109.50
2024-02-02,20:19:00,17756.25,SELL,3,0.02h,Stop Loss,$-9.00,$100.50,$54242.00,25,$100.50
2024-02-02,20:20:00,17762.75,BUY,3,0.02h,Break Even,$-1.50,$99.00,$54240.50,25,$99.00
2024-02-02,20:23:00,17754.25,SELL,3,0.02h,Stop Loss,$94.50,$193.50,$54335.00,25,$193.50
2024-02-02,20:30:00,17766.25,BUY,3,0.02h,Stop Loss,$-9.00,$184.50,$54326.00,25,$184.50
2024-02-02,20:33:00,17751.75,SELL,3,0.02h,Stop Loss,$10.50,$195.00,$54336.50,25,$195.00
2024-02-02,20:51:00,17760.75,BUY,3,0.02h,Stop Loss,$25.50,$220.50,$54362.00,25,$220.50
2024-02-02,20:58:00,17746.75,SELL,3,0.02h,Stop Loss,$25.50,$246.00,$54387.50,25,$246.00
,,,,,,,,,,,
2024-02-05,00:05:00,17716.25,BUY,3,0.02h,Break Even,$-1.50,$-1.50,$54386.00,26,$-1.50
2024-02-05,00:22:00,17698.0,SELL,3,0.02h,Break Even,$-1.50,$-3.00,$54384.50,26,$-3.00
2024-02-05,01:33:00,17681.25,BUY,3,0.02h,Break Even,$-1.50,$-4.50,$54383.00,26,$-4.50
2024-02-05,02:04:00,17680.0,SELL,3,0.02h,Stop Loss,$9.00,$4.50,$54392.00,26,$4.50
2024-02-05,02:24:00,17680.75,BUY,3,0.02h,Break Even,$-1.50,$3.00,$54390.50,26,$3.00
2024-02-05,02:39:00,17676.5,SELL,3,0.02h,Break Even,$-1.50,$1.50,$54389.00,26,$1.50
2024-02-05,02:59:00,17676.25,BUY,3,0.02h,Break Even,$-1.50,$0.00,$54387.50,26,$0.00
2024-02-05,03:21:00,17676.0,SELL,3,0.03h,Stop Loss,$-9.00,$-9.00,$54378.50,26,$-9.00
2024-02-05,03:41:00,17677.25,BUY,3,0.02h,Stop Loss,$-9.00,$-18.00,$54369.50,26,$-18.00
2024-02-05,04:26:00,17681.5,SELL,3,0.22h,Break Even,$-1.50,$-19.50,$54368.00,26,$-19.50
2024-02-05,04:49:00,17682.0,BUY,3,0.05h,Break Even,$-1.50,$-21.00,$54366.50,26,$-21.00
2024-02-05,05:11:00,17681.0,SELL,3,0.05h,Stop Loss,$4.50,$-16.50,$54371.00,26,$-16.50
2024-02-05,05:16:00,17688.5,BUY,3,0.02h,Stop Loss,$3.00,$-13.50,$54374.00,26,$-13.50
2024-02-05,05:33:00,17686.5,SELL,3,0.02h,Stop Loss,$9.00,$-4.50,$54383.00,26,$-4.50
2024-02-05,05:50:00,17687.25,BUY,3,0.02h,Stop Loss,$-9.00,$-13.50,$54374.00,26,$-13.50
2024-02-05,06:36:00,17694.0,SELL,3,0.02h,Break Even,$-1.50,$-15.00,$54372.50,26,$-15.00
2024-02-05,06:49:00,17698.5,BUY,3,0.02h,Stop Loss,$-9.00,$-24.00,$54363.50,26,$-24.00
2024-02-05,06:51:00,17693.0,SELL,3,0.02h,Break Even,$-1.50,$-25.50,$54362.00,26,$-25.50
2024-02-05,06:59:00,17696.5,BUY,3,0.02h,Stop Loss,$-9.00,$-34.50,$54353.00,26,$-34.50
2024-02-05,07:01:00,17694.25,SELL,3,0.02h,Break Even,$-1.50,$-36.00,$54351.50,26,$-36.00
2024-02-05,07:02:00,17695.5,BUY,3,0.02h,Break Even,$-1.50,$-37.50,$54350.00,26,$-37.50
2024-02-05,07:06:00,17692.25,SELL,3,0.02h,Stop Loss,$6.00,$-31.50,$54356.00,26,$-31.50
2024-02-05,07:26:00,17695.0,BUY,3,0.02h,Stop Loss,$-9.00,$-40.50,$54347.00,26,$-40.50
2024-02-05,07:28:00,17691.5,SELL,3,0.05h,Stop Loss,$-9.00,$-49.50,$54338.00,26,$-49.50
2024-02-05,07:37:00,17701.0,BUY,3,0.02h,Stop Loss,$-9.00,$-58.50,$54329.00,26,$-58.50
2024-02-05,08:00:00,17695.25,SELL,3,0.02h,Stop Loss,$10.50,$-48.00,$54339.50,26,$-48.00
2024-02-05,08:08:00,17704.75,BUY,3,0.02h,Break Even,$-1.50,$-49.50,$54338.00,26,$-49.50
2024-02-05,09:04:00,17713.0,SELL,3,0.02h,Break Even,$-1.50,$-51.00,$54336.50,26,$-51.00
2024-02-05,09:14:00,17719.25,BUY,3,0.02h,Break Even,$-1.50,$-52.50,$54335.00,26,$-52.50
2024-02-05,09:18:00,17714.5,SELL,3,0.02h,Break Even,$-1.50,$-54.00,$54333.50,26,$-54.00
2024-02-05,10:04:00,17694.0,BUY,3,0.02h,Stop Loss,$-9.00,$-63.00,$54324.50,26,$-63.00
2024-02-05,11:04:00,17711.5,SELL,3,0.02h,Stop Loss,$-9.00,$-72.00,$54315.50,26,$-72.00
2024-02-05,11:14:00,17718.5,BUY,3,0.02h,Break Even,$-1.50,$-73.50,$54314.00,26,$-73.50
2024-02-05,11:36:00,17714.5,SELL,3,0.02h,Break Even,$-1.50,$-75.00,$54312.50,26,$-75.00
2024-02-05,12:09:00,17716.75,BUY,3,0.02h,Break Even,$-1.50,$-76.50,$54311.00,26,$-76.50
2024-02-05,12:32:00,17719.5,SELL,3,0.02h,Stop Loss,$-9.00,$-85.50,$54302.00,26,$-85.50
2024-02-05,12:36:00,17724.75,BUY,3,0.02h,Break Even,$-1.50,$-87.00,$54300.50,26,$-87.00
2024-02-05,12:49:00,17721.25,SELL,3,0.02h,Stop Loss,$-9.00,$-96.00,$54291.50,26,$-96.00
2024-02-05,12:52:00,17728.0,BUY,3,0.02h,Break Even,$-1.50,$-97.50,$54290.00,26,$-97.50
2024-02-05,13:11:00,17727.5,SELL,3,0.02h,Stop Loss,$-9.00,$-106.50,$54281.00,26,$-106.50
2024-02-05,13:15:00,17732.5,BUY,3,0.02h,Stop Loss,$-9.00,$-115.50,$54272.00,26,$-115.50
2024-02-05,13:17:00,17726.75,SELL,3,0.02h,Break Even,$-1.50,$-117.00,$54270.50,26,$-117.00
2024-02-05,14:12:00,17707.5,BUY,3,0.02h,Break Even,$-1.50,$-118.50,$54269.00,26,$-118.50
2024-02-05,14:41:00,17699.25,SELL,3,0.02h,Break Even,$-1.50,$-120.00,$54267.50,26,$-120.00
2024-02-05,16:02:00,17595.75,BUY,3,0.02h,Stop Loss,$3.00,$-117.00,$54270.50,26,$-117.00
2024-02-05,17:54:00,17693.25,SELL,3,0.02h,Stop Loss,$-9.00,$-126.00,$54261.50,26,$-126.00
2024-02-05,18:08:00,17702.0,BUY,3,0.02h,Stop Loss,$22.50,$-103.50,$54284.00,26,$-103.50
2024-02-05,18:23:00,17696.5,SELL,3,0.02h,Break Even,$-1.50,$-105.00,$54282.50,26,$-105.00
2024-02-05,18:48:00,17695.75,BUY,3,0.02h,Break Even,$-1.50,$-106.50,$54281.00,26,$-106.50
2024-02-05,18:54:00,17688.75,SELL,3,0.02h,Break Even,$-1.50,$-108.00,$54279.50,26,$-108.00
2024-02-05,18:59:00,17695.75,BUY,3,0.02h,Stop Loss,$19.50,$-88.50,$54299.00,26,$-88.50
2024-02-05,19:02:00,17688.0,SELL,3,0.02h,Break Even,$-1.50,$-90.00,$54297.50,26,$-90.00
2024-02-05,19:08:00,17700.75,BUY,3,0.02h,Stop Loss,$22.50,$-67.50,$54320.00,26,$-67.50
2024-02-05,20:03:00,17720.25,SELL,3,0.02h,Stop Loss,$25.50,$-42.00,$54345.50,26,$-42.00
2024-02-05,20:29:00,17715.5,BUY,3,0.02h,Break Even,$-1.50,$-43.50,$54344.00,26,$-43.50
2024-02-05,20:41:00,17703.0,SELL,3,0.02h,Break Even,$-1.50,$-45.00,$54342.50,26,$-45.00
2024-02-05,20:48:00,17709.25,BUY,3,0.02h,Stop Loss,$3.00,$-42.00,$54345.50,26,$-42.00
2024-02-05,20:50:00,17702.25,SELL,3,0.02h,Break Even,$-1.50,$-43.50,$54344.00,26,$-43.50
2024-02-05,20:51:00,17722.75,BUY,3,0.02h,Break Even,$-1.50,$-45.00,$54342.50,26,$-45.00
2024-02-05,21:01:00,17685.0,SELL,3,0.02h,Break Even,$-1.50,$-46.50,$54341.00,26,$-46.50
2024-02-05,21:52:00,17698.0,BUY,3,0.02h,Break Even,$-1.50,$-48.00,$54339.50,26,$-48.00
2024-02-05,23:39:00,17703.0,SELL,3,0.02h,Stop Loss,$-9.00,$-57.00,$54330.50,26,$-57.00
,,,,,,,,,,,
2024-02-06,00:07:00,17702.25,BUY,3,0.02h,Stop Loss,$-9.00,$-9.00,$54321.50,27,$-9.00
2024-02-06,01:26:00,17710.75,SELL,3,0.03h,Break Even,$-1.50,$-10.50,$54320.00,27,$-10.50
2024-02-06,01:32:00,17715.5,BUY,3,0.02h,Break Even,$-1.50,$-12.00,$54318.50,27,$-12.00
2024-02-06,01:41:00,17708.25,SELL,3,0.02h,Stop Loss,$-9.00,$-21.00,$54309.50,27,$-21.00
2024-02-06,01:47:00,17714.75,BUY,3,0.02h,Break Even,$-1.50,$-22.50,$54308.00,27,$-22.50
2024-02-06,02:56:00,17724.75,SELL,3,0.02h,Break Even,$-1.50,$-24.00,$54306.50,27,$-24.00
2024-02-06,03:10:00,17728.0,BUY,3,0.03h,Break Even,$-1.50,$-25.50,$54305.00,27,$-25.50
2024-02-06,03:40:00,17730.5,SELL,3,0.02h,Stop Loss,$-9.00,$-34.50,$54296.00,27,$-34.50
2024-02-06,04:08:00,17731.5,BUY,3,0.03h,Stop Loss,$-9.00,$-43.50,$54287.00,27,$-43.50
2024-02-06,04:12:00,17728.5,SELL,3,0.05h,Stop Loss,$-9.00,$-52.50,$54278.00,27,$-52.50
2024-02-06,04:19:00,17732.0,BUY,3,0.03h,Stop Loss,$-9.00,$-61.50,$54269.00,27,$-61.50
2024-02-06,05:21:00,17738.75,SELL,3,0.02h,Stop Loss,$-9.00,$-70.50,$54260.00,27,$-70.50
2024-02-06,05:44:00,17745.5,BUY,3,0.03h,Break Even,$-1.50,$-72.00,$54258.50,27,$-72.00
2024-02-06,05:53:00,17740.5,SELL,3,0.02h,Break Even,$-1.50,$-73.50,$54257.00,27,$-73.50
2024-02-06,06:40:00,17736.25,BUY,3,0.02h,Stop Loss,$9.00,$-64.50,$54266.00,27,$-64.50
2024-02-06,06:52:00,17731.5,SELL,3,0.02h,Stop Loss,$-9.00,$-73.50,$54257.00,27,$-73.50
2024-02-06,06:59:00,17737.25,BUY,3,0.03h,Stop Loss,$-9.00,$-82.50,$54248.00,27,$-82.50
2024-02-06,08:06:00,17756.5,SELL,3,0.02h,Stop Loss,$3.00,$-79.50,$54251.00,27,$-79.50
2024-02-06,08:23:00,17765.25,BUY,3,0.02h,Break Even,$-1.50,$-81.00,$54249.50,27,$-81.00
2024-02-06,08:30:00,17756.5,SELL,3,0.02h,Stop Loss,$6.00,$-75.00,$54255.50,27,$-75.00
2024-02-06,09:06:00,17754.75,BUY,3,0.02h,Stop Loss,$-9.00,$-84.00,$54246.50,27,$-84.00
2024-02-06,09:11:00,17745.0,SELL,3,0.02h,Stop Loss,$25.50,$-58.50,$54272.00,27,$-58.50
2024-02-06,09:19:00,17749.5,BUY,3,0.02h,Stop Loss,$-9.00,$-67.50,$54263.00,27,$-67.50
2024-02-06,09:20:00,17747.75,SELL,3,0.02h,Break Even,$-1.50,$-69.00,$54261.50,27,$-69.00
2024-02-06,09:22:00,17749.5,BUY,3,0.02h,Break Even,$-1.50,$-70.50,$54260.00,27,$-70.50
2024-02-06,09:25:00,17742.75,SELL,3,0.02h,Break Even,$-1.50,$-72.00,$54258.50,27,$-72.00
2024-02-06,09:43:00,17744.75,BUY,3,0.02h,Stop Loss,$-9.00,$-81.00,$54249.50,27,$-81.00
2024-02-06,09:44:00,17740.0,SELL,3,0.02h,Stop Loss,$-9.00,$-90.00,$54240.50,27,$-90.00
2024-02-06,10:43:00,17727.75,BUY,3,0.02h,Stop Loss,$-9.00,$-99.00,$54231.50,27,$-99.00
2024-02-06,11:14:00,17727.0,SELL,3,0.02h,Stop Loss,$-9.00,$-108.00,$54222.50,27,$-108.00
2024-02-06,12:04:00,17694.25,BUY,3,0.02h,Stop Loss,$-9.00,$-117.00,$54213.50,27,$-117.00
2024-02-06,12:06:00,17691.5,SELL,3,0.02h,Break Even,$-1.50,$-118.50,$54212.00,27,$-118.50
2024-02-06,12:08:00,17696.75,BUY,3,0.02h,Break Even,$-1.50,$-120.00,$54210.50,27,$-120.00
2024-02-06,12:18:00,17689.25,SELL,3,0.02h,Stop Loss,$13.50,$-106.50,$54224.00,27,$-106.50
2024-02-06,12:40:00,17690.5,BUY,3,0.02h,Stop Loss,$9.00,$-97.50,$54233.00,27,$-97.50
2024-02-06,14:30:00,17741.25,SELL,3,0.02h,Break Even,$-1.50,$-99.00,$54231.50,27,$-99.00
2024-02-06,14:31:00,17764.25,BUY,3,0.02h,Break Even,$-1.50,$-100.50,$54230.00,27,$-100.50
2024-02-06,14:35:00,17729.25,SELL,3,0.02h,Stop Loss,$102.00,$1.50,$54332.00,27,$1.50
2024-02-06,15:36:00,17655.25,BUY,3,0.02h,Stop Loss,$-9.00,$-7.50,$54323.00,27,$-7.50
2024-02-06,15:43:00,17627.5,SELL,3,0.02h,Stop Loss,$22.50,$15.00,$54345.50,27,$15.00
2024-02-06,15:48:00,17643.5,BUY,3,0.02h,Break Even,$-1.50,$13.50,$54344.00,27,$13.50
2024-02-06,15:50:00,17626.0,SELL,3,0.02h,Stop Loss,$24.00,$37.50,$54368.00,27,$37.50
2024-02-06,15:58:00,17637.75,BUY,3,0.02h,Stop Loss,$15.00,$52.50,$54383.00,27,$52.50
2024-02-06,16:15:00,17627.5,SELL,3,0.02h,Break Even,$-1.50,$51.00,$54381.50,27,$51.00
2024-02-06,16:21:00,17647.75,BUY,3,0.02h,Stop Loss,$-9.00,$42.00,$54372.50,27,$42.00
2024-02-06,16:40:00,17644.0,SELL,3,0.02h,Stop Loss,$72.00,$114.00,$54444.50,27,$114.00
2024-02-06,17:29:00,17599.0,BUY,3,0.02h,Stop Loss,$15.00,$129.00,$54459.50,27,$129.00
2024-02-06,17:54:00,17594.25,SELL,3,0.02h,Stop Loss,$18.00,$147.00,$54477.50,27,$147.00
2024-02-06,18:03:00,17604.25,BUY,3,0.02h,Stop Loss,$-9.00,$138.00,$54468.50,27,$138.00
2024-02-06,18:15:00,17595.75,SELL,3,0.02h,Break Even,$-1.50,$136.50,$54467.00,27,$136.50
2024-02-06,18:17:00,17607.25,BUY,3,0.02h,Stop Loss,$18.00,$154.50,$54485.00,27,$154.50
2024-02-06,18:20:00,17595.0,SELL,3,0.02h,Stop Loss,$6.00,$160.50,$54491.00,27,$160.50
2024-02-06,18:30:00,17608.75,BUY,3,0.02h,Stop Loss,$15.00,$175.50,$54506.00,27,$175.50
2024-02-06,19:06:00,17610.0,SELL,3,0.02h,Stop Loss,$57.00,$232.50,$54563.00,27,$232.50
2024-02-06,19:30:00,17594.25,BUY,3,0.02h,Stop Loss,$19.50,$252.00,$54582.50,27,$252.00
2024-02-06,20:30:00,17635.5,SELL,3,0.02h,Stop Loss,$16.50,$268.50,$54599.00,27,$268.50
2024-02-06,20:51:00,17626.5,BUY,3,0.02h,Stop Loss,$30.00,$298.50,$54629.00,27,$298.50
2024-02-06,21:20:00,17642.25,SELL,3,0.02h,Stop Loss,$-9.00,$289.50,$54620.00,27,$289.50
2024-02-06,21:23:00,17646.75,BUY,3,0.02h,Stop Loss,$4.50,$294.00,$54624.50,27,$294.00
2024-02-06,21:44:00,17647.0,SELL,3,0.03h,Break Even,$-1.50,$292.50,$54623.00,27,$292.50
2024-02-06,23:01:00,17652.75,BUY,3,0.02h,Break Even,$-1.50,$291.00,$54621.50,27,$291.00
2024-02-06,23:38:00,17657.0,SELL,3,0.02h,Stop Loss,$-9.00,$282.00,$54612.50,27,$282.00
2024-02-06,23:39:00,17660.0,BUY,3,0.02h,Break Even,$-1.50,$280.50,$54611.00,27,$280.50
2024-02-06,23:47:00,17655.25,SELL,3,0.02h,Stop Loss,$-9.00,$271.50,$54602.00,27,$271.50
,,,,,,,,,,,
2024-02-07,00:19:00,17653.75,BUY,3,0.02h,Break Even,$-1.50,$-1.50,$54600.50,28,$-1.50
2024-02-07,00:50:00,17655.0,SELL,3,0.02h,Break Even,$-1.50,$-3.00,$54599.00,28,$-3.00
2024-02-07,00:57:00,17659.0,BUY,3,0.03h,Stop Loss,$-9.00,$-12.00,$54590.00,28,$-12.00
2024-02-07,01:51:00,17701.0,SELL,3,0.02h,Stop Loss,$-9.00,$-21.00,$54581.00,28,$-21.00
2024-02-07,02:57:00,17682.5,BUY,3,0.02h,Break Even,$-1.50,$-22.50,$54579.50,28,$-22.50
2024-02-07,03:12:00,17680.25,SELL,3,0.03h,Stop Loss,$-9.00,$-31.50,$54570.50,28,$-31.50
2024-02-07,04:23:00,17662.5,BUY,3,0.02h,Stop Loss,$-9.00,$-40.50,$54561.50,28,$-40.50
2024-02-07,04:24:00,17660.25,SELL,3,0.02h,Stop Loss,$-9.00,$-49.50,$54552.50,28,$-49.50
2024-02-07,04:26:00,17663.0,BUY,3,0.03h,Stop Loss,$-9.00,$-58.50,$54543.50,28,$-58.50
2024-02-07,04:37:00,17659.75,SELL,3,0.02h,Stop Loss,$-9.00,$-67.50,$54534.50,28,$-67.50
2024-02-07,04:39:00,17663.0,BUY,3,0.05h,Stop Loss,$-9.00,$-76.50,$54525.50,28,$-76.50
2024-02-07,04:50:00,17660.25,SELL,3,0.02h,Break Even,$-1.50,$-78.00,$54524.00,28,$-78.00
2024-02-07,05:18:00,17662.0,BUY,3,0.02h,Break Even,$-1.50,$-79.50,$54522.50,28,$-79.50
2024-02-07,05:34:00,17658.0,SELL,3,0.02h,Stop Loss,$4.50,$-75.00,$54527.00,28,$-75.00
2024-02-07,05:48:00,17661.0,BUY,3,0.02h,Stop Loss,$-9.00,$-84.00,$54518.00,28,$-84.00
2024-02-07,06:06:00,17659.0,SELL,3,0.02h,Break Even,$-1.50,$-85.50,$54516.50,28,$-85.50
2024-02-07,06:53:00,17646.0,BUY,3,0.02h,Stop Loss,$-9.00,$-94.50,$54507.50,28,$-94.50
2024-02-07,06:54:00,17643.5,SELL,3,0.02h,Break Even,$-1.50,$-96.00,$54506.00,28,$-96.00
2024-02-07,06:57:00,17648.0,BUY,3,0.02h,Stop Loss,$-9.00,$-105.00,$54497.00,28,$-105.00
2024-02-07,07:11:00,17645.0,SELL,3,0.02h,Break Even,$-1.50,$-106.50,$54495.50,28,$-106.50
2024-02-07,07:29:00,17649.5,BUY,3,0.02h,Stop Loss,$-9.00,$-115.50,$54486.50,28,$-115.50
2024-02-07,07:31:00,17642.25,SELL,3,0.02h,Break Even,$-1.50,$-117.00,$54485.00,28,$-117.00
2024-02-07,07:57:00,17640.0,BUY,3,0.02h,Stop Loss,$-9.00,$-126.00,$54476.00,28,$-126.00
2024-02-07,08:23:00,17638.75,SELL,3,0.02h,Stop Loss,$-9.00,$-135.00,$54467.00,28,$-135.00
2024-02-07,08:30:00,17646.25,BUY,3,0.02h,Break Even,$-1.50,$-136.50,$54465.50,28,$-136.50
2024-02-07,09:07:00,17650.5,SELL,3,0.02h,Stop Loss,$-9.00,$-145.50,$54456.50,28,$-145.50
2024-02-07,09:13:00,17655.75,BUY,3,0.02h,Break Even,$-1.50,$-147.00,$54455.00,28,$-147.00
2024-02-07,10:33:00,17673.25,SELL,3,0.02h,Stop Loss,$6.00,$-141.00,$54461.00,28,$-141.00
2024-02-07,11:09:00,17667.25,BUY,3,0.02h,Stop Loss,$-9.00,$-150.00,$54452.00,28,$-150.00
2024-02-07,11:54:00,17676.75,SELL,3,0.02h,Break Even,$-1.50,$-151.50,$54450.50,28,$-151.50
2024-02-07,12:00:00,17680.75,BUY,3,0.02h,Stop Loss,$-9.00,$-160.50,$54441.50,28,$-160.50
2024-02-07,12:01:00,17675.0,SELL,3,0.02h,Stop Loss,$25.50,$-135.00,$54467.00,28,$-135.00
2024-02-07,12:31:00,17675.5,BUY,3,0.02h,Stop Loss,$-9.00,$-144.00,$54458.00,28,$-144.00
2024-02-07,13:56:00,17733.25,SELL,3,0.02h,Stop Loss,$-9.00,$-153.00,$54449.00,28,$-153.00
2024-02-07,13:59:00,17738.5,BUY,3,0.02h,Stop Loss,$-9.00,$-162.00,$54440.00,28,$-162.00
2024-02-07,14:35:00,17750.5,SELL,3,0.02h,Break Even,$-1.50,$-163.50,$54438.50,28,$-163.50
2024-02-07,14:52:00,17760.75,BUY,3,0.02h,Stop Loss,$22.50,$-141.00,$54461.00,28,$-141.00
2024-02-07,14:56:00,17724.75,SELL,3,0.02h,Stop Loss,$18.00,$-123.00,$54479.00,28,$-123.00
2024-02-07,15:10:00,17757.75,BUY,3,0.02h,Stop Loss,$33.00,$-90.00,$54512.00,28,$-90.00
2024-02-07,15:59:00,17839.75,SELL,3,0.02h,Stop Loss,$33.00,$-57.00,$54545.00,28,$-57.00
2024-02-07,16:12:00,17850.5,BUY,3,0.02h,Break Even,$-1.50,$-58.50,$54543.50,28,$-58.50
2024-02-07,16:18:00,17834.75,SELL,3,0.02h,Stop Loss,$22.50,$-36.00,$54566.00,28,$-36.00
2024-02-07,16:46:00,17828.5,BUY,3,0.02h,Stop Loss,$9.00,$-27.00,$54575.00,28,$-27.00
2024-02-07,17:13:00,17827.5,SELL,3,0.02h,Stop Loss,$-9.00,$-36.00,$54566.00,28,$-36.00
2024-02-07,17:18:00,17849.75,BUY,3,0.02h,Stop Loss,$-9.00,$-45.00,$54557.00,28,$-45.00
2024-02-07,17:23:00,17833.5,SELL,3,0.02h,Stop Loss,$6.00,$-39.00,$54563.00,28,$-39.00
2024-02-07,17:55:00,17813.75,BUY,3,0.02h,Stop Loss,$3.00,$-36.00,$54566.00,28,$-36.00
2024-02-07,18:06:00,17801.75,SELL,3,0.02h,Stop Loss,$-9.00,$-45.00,$54557.00,28,$-45.00
2024-02-07,18:11:00,17822.0,BUY,3,0.02h,Stop Loss,$15.00,$-30.00,$54572.00,28,$-30.00
2024-02-07,19:11:00,17846.0,SELL,3,0.02h,Break Even,$-1.50,$-31.50,$54570.50,28,$-31.50
2024-02-07,19:12:00,17849.0,BUY,3,0.02h,Break Even,$-1.50,$-33.00,$54569.00,28,$-33.00
2024-02-07,19:14:00,17843.75,SELL,3,0.02h,Break Even,$-1.50,$-34.50,$54567.50,28,$-34.50
2024-02-07,19:16:00,17854.25,BUY,3,0.02h,Stop Loss,$-9.00,$-43.50,$54558.50,28,$-43.50
2024-02-07,19:18:00,17846.0,SELL,3,0.02h,Break Even,$-1.50,$-45.00,$54557.00,28,$-45.00
2024-02-07,19:25:00,17851.75,BUY,3,0.02h,Stop Loss,$-9.00,$-54.00,$54548.00,28,$-54.00
2024-02-07,19:27:00,17845.25,SELL,3,0.02h,Break Even,$-1.50,$-55.50,$54546.50,28,$-55.50
2024-02-07,19:43:00,17844.5,BUY,3,0.02h,Stop Loss,$-9.00,$-64.50,$54537.50,28,$-64.50
2024-02-07,19:44:00,17839.0,SELL,3,0.02h,Break Even,$-1.50,$-66.00,$54536.00,28,$-66.00
2024-02-07,19:48:00,17852.75,BUY,3,0.02h,Break Even,$-1.50,$-67.50,$54534.50,28,$-67.50
2024-02-07,20:24:00,17852.0,SELL,3,0.02h,Break Even,$-1.50,$-69.00,$54533.00,28,$-69.00
2024-02-07,20:26:00,17857.75,BUY,3,0.02h,Break Even,$-1.50,$-70.50,$54531.50,28,$-70.50
2024-02-07,20:28:00,17854.0,SELL,3,0.02h,Break Even,$-1.50,$-72.00,$54530.00,28,$-72.00
2024-02-07,21:13:00,17851.0,BUY,3,0.02h,Break Even,$-1.50,$-73.50,$54528.50,28,$-73.50
2024-02-07,23:03:00,17845.25,SELL,3,0.02h,Break Even,$-1.50,$-75.00,$54527.00,28,$-75.00
2024-02-07,23:25:00,17846.0,BUY,3,0.02h,Stop Loss,$-9.00,$-84.00,$54518.00,28,$-84.00
2024-02-07,23:27:00,17842.5,SELL,3,0.02h,Stop Loss,$-9.00,$-93.00,$54509.00,28,$-93.00
2024-02-07,23:57:00,17841.75,BUY,3,0.03h,Break Even,$-1.50,$-94.50,$54507.50,28,$-94.50
,,,,,,,,,,,
2024-02-08,00:03:00,17837.5,SELL,3,0.03h,Stop Loss,$-9.00,$-9.00,$54498.50,29,$-9.00
2024-02-08,00:07:00,17841.25,BUY,3,0.02h,Stop Loss,$-9.00,$-18.00,$54489.50,29,$-18.00
2024-02-08,00:12:00,17838.75,SELL,3,0.02h,Stop Loss,$-9.00,$-27.00,$54480.50,29,$-27.00
2024-02-08,00:25:00,17840.75,BUY,3,0.02h,Stop Loss,$-9.00,$-36.00,$54471.50,29,$-36.00
2024-02-08,00:48:00,17839.75,SELL,3,0.05h,Break Even,$-1.50,$-37.50,$54470.00,29,$-37.50
2024-02-08,01:16:00,17845.0,BUY,3,0.02h,Stop Loss,$-9.00,$-46.50,$54461.00,29,$-46.50
2024-02-08,01:27:00,17839.0,SELL,3,0.05h,Break Even,$-1.50,$-48.00,$54459.50,29,$-48.00
2024-02-08,01:33:00,17840.25,BUY,3,0.02h,Break Even,$-1.50,$-49.50,$54458.00,29,$-49.50
2024-02-08,02:26:00,17849.5,SELL,3,0.02h,Stop Loss,$-9.00,$-58.50,$54449.00,29,$-58.50
2024-02-08,03:05:00,17848.75,BUY,3,0.08h,Stop Loss,$-9.00,$-67.50,$54440.00,29,$-67.50
2024-02-08,03:14:00,17845.75,SELL,3,0.03h,Stop Loss,$-9.00,$-76.50,$54431.00,29,$-76.50
2024-02-08,03:52:00,17847.75,BUY,3,0.07h,Stop Loss,$-9.00,$-85.50,$54422.00,29,$-85.50
2024-02-08,04:11:00,17845.75,SELL,3,0.02h,Stop Loss,$-9.00,$-94.50,$54413.00,29,$-94.50
2024-02-08,04:15:00,17848.25,BUY,3,0.03h,Stop Loss,$-9.00,$-103.50,$54404.00,29,$-103.50
2024-02-08,04:54:00,17850.0,SELL,3,0.05h,Stop Loss,$-9.00,$-112.50,$54395.00,29,$-112.50
2024-02-08,04:57:00,17851.25,BUY,3,0.02h,Stop Loss,$-9.00,$-121.50,$54386.00,29,$-121.50
2024-02-08,05:03:00,17849.5,SELL,3,0.05h,Stop Loss,$-9.00,$-130.50,$54377.00,29,$-130.50
2024-02-08,05:19:00,17850.75,BUY,3,0.03h,Break Even,$-1.50,$-132.00,$54375.50,29,$-132.00
2024-02-08,05:35:00,17849.75,SELL,3,0.05h,Break Even,$-1.50,$-133.50,$54374.00,29,$-133.50
2024-02-08,06:03:00,17849.5,BUY,3,0.02h,Stop Loss,$-9.00,$-142.50,$54365.00,29,$-142.50
2024-02-08,06:05:00,17845.25,SELL,3,0.02h,Stop Loss,$-9.00,$-151.50,$54356.00,29,$-151.50
2024-02-08,06:27:00,17846.5,BUY,3,0.02h,Stop Loss,$-9.00,$-160.50,$54347.00,29,$-160.50
2024-02-08,07:03:00,17850.5,SELL,3,0.02h,Break Even,$-1.50,$-162.00,$54345.50,29,$-162.00
2024-02-08,07:08:00,17855.75,BUY,3,0.02h,Break Even,$-1.50,$-163.50,$54344.00,29,$-163.50
2024-02-08,07:25:00,17853.5,SELL,3,0.02h,Break Even,$-1.50,$-165.00,$54342.50,29,$-165.00
2024-02-08,08:45:00,17838.25,BUY,3,0.02h,Stop Loss,$-9.00,$-174.00,$54333.50,29,$-174.00
2024-02-08,08:48:00,17830.5,SELL,3,0.02h,Stop Loss,$-9.00,$-183.00,$54324.50,29,$-183.00
2024-02-08,08:57:00,17836.0,BUY,3,0.02h,Break Even,$-1.50,$-184.50,$54323.00,29,$-184.50
2024-02-08,09:54:00,17846.75,SELL,3,0.02h,Stop Loss,$-9.00,$-193.50,$54314.00,29,$-193.50
2024-02-08,10:01:00,17850.5,BUY,3,0.02h,Stop Loss,$-9.00,$-202.50,$54305.00,29,$-202.50
2024-02-08,10:05:00,17843.5,SELL,3,0.02h,Stop Loss,$-9.00,$-211.50,$54296.00,29,$-211.50
2024-02-08,10:19:00,17847.0,BUY,3,0.02h,Stop Loss,$-9.00,$-220.50,$54287.00,29,$-220.50
2024-02-08,10:21:00,17846.25,SELL,3,0.02h,Break Even,$-1.50,$-222.00,$54285.50,29,$-222.00
2024-02-08,10:23:00,17847.25,BUY,3,0.05h,Stop Loss,$-9.00,$-231.00,$54276.50,29,$-231.00
2024-02-08,10:27:00,17843.25,SELL,3,0.02h,Stop Loss,$-9.00,$-240.00,$54267.50,29,$-240.00
2024-02-08,11:04:00,17839.0,BUY,3,0.02h,Stop Loss,$-9.00,$-249.00,$54258.50,29,$-249.00
2024-02-08,11:06:00,17836.0,SELL,3,0.02h,Stop Loss,$-9.00,$-258.00,$54249.50,29,$-258.00
2024-02-08,12:05:00,17814.25,BUY,3,0.02h,Stop Loss,$-9.00,$-267.00,$54240.50,29,$-267.00
2024-02-08,12:08:00,17809.5,SELL,3,0.02h,Break Even,$-1.50,$-268.50,$54239.00,29,$-268.50
2024-02-08,12:14:00,17817.25,BUY,3,0.02h,Stop Loss,$6.00,$-262.50,$54245.00,29,$-262.50
2024-02-08,12:32:00,17811.5,SELL,3,0.02h,Stop Loss,$-9.00,$-271.50,$54236.00,29,$-271.50
2024-02-08,12:46:00,17820.0,BUY,3,0.02h,Stop Loss,$-9.00,$-280.50,$54227.00,29,$-280.50
2024-02-08,12:56:00,17809.0,SELL,3,0.02h,Stop Loss,$3.00,$-277.50,$54230.00,29,$-277.50
2024-02-08,13:07:00,17815.25,BUY,3,0.02h,Stop Loss,$-9.00,$-286.50,$54221.00,29,$-286.50
2024-02-08,13:09:00,17809.5,SELL,3,0.02h,Stop Loss,$-9.00,$-295.50,$54212.00,29,$-295.50
2024-02-08,13:34:00,17812.5,BUY,3,0.02h,Stop Loss,$-9.00,$-304.50,$54203.00,29,$-304.50
2024-02-08,14:43:00,17812.25,SELL,3,0.02h,Stop Loss,$7.50,$-297.00,$54210.50,29,$-297.00
2024-02-08,14:51:00,17835.5,BUY,3,0.02h,Stop Loss,$13.50,$-283.50,$54224.00,29,$-283.50
2024-02-08,15:26:00,17837.5,SELL,3,0.02h,Break Even,$-1.50,$-285.00,$54222.50,29,$-285.00
2024-02-08,15:36:00,17857.5,BUY,3,0.02h,Break Even,$-1.50,$-286.50,$54221.00,29,$-286.50
2024-02-08,16:27:00,17867.5,SELL,3,0.02h,Break Even,$-1.50,$-288.00,$54219.50,29,$-288.00
2024-02-08,16:38:00,17881.5,BUY,3,0.02h,Break Even,$-1.50,$-289.50,$54218.00,29,$-289.50
2024-02-08,16:45:00,17867.5,SELL,3,0.02h,Break Even,$-1.50,$-291.00,$54216.50,29,$-291.00
2024-02-08,16:54:00,17880.0,BUY,3,0.02h,Break Even,$-1.50,$-292.50,$54215.00,29,$-292.50
2024-02-08,17:07:00,17872.25,SELL,3,0.02h,Stop Loss,$18.00,$-274.50,$54233.00,29,$-274.50
2024-02-08,17:15:00,17884.0,BUY,3,0.02h,Break Even,$-1.50,$-276.00,$54231.50,29,$-276.00
2024-02-08,17:40:00,17882.5,SELL,3,0.02h,Stop Loss,$6.00,$-270.00,$54237.50,29,$-270.00
2024-02-08,18:03:00,17877.75,BUY,3,0.02h,Stop Loss,$7.50,$-262.50,$54245.00,29,$-262.50
2024-02-08,18:17:00,17862.5,SELL,3,0.02h,Break Even,$-1.50,$-264.00,$54243.50,29,$-264.00
2024-02-08,18:26:00,17877.75,BUY,3,0.02h,Break Even,$-1.50,$-265.50,$54242.00,29,$-265.50
2024-02-08,18:47:00,17878.0,SELL,3,0.02h,Break Even,$-1.50,$-267.00,$54240.50,29,$-267.00
2024-02-08,19:46:00,17851.25,BUY,3,0.02h,Stop Loss,$-9.00,$-276.00,$54231.50,29,$-276.00
2024-02-08,20:37:00,17866.25,SELL,3,0.02h,Stop Loss,$-9.00,$-285.00,$54222.50,29,$-285.00
2024-02-08,21:18:00,17861.5,BUY,3,0.02h,Break Even,$-1.50,$-286.50,$54221.00,29,$-286.50
2024-02-08,23:01:00,17858.0,SELL,3,0.02h,Stop Loss,$-9.00,$-295.50,$54212.00,29,$-295.50
2024-02-08,23:22:00,17862.25,BUY,3,0.05h,Stop Loss,$-9.00,$-304.50,$54203.00,29,$-304.50
,,,,,,,,,,,
2024-02-09,00:04:00,17864.5,SELL,3,0.02h,Stop Loss,$-9.00,$-9.00,$54194.00,30,$-9.00
2024-02-09,00:05:00,17871.5,BUY,3,0.02h,Stop Loss,$-9.00,$-18.00,$54185.00,30,$-18.00
2024-02-09,00:25:00,17870.0,SELL,3,0.02h,Break Even,$-1.50,$-19.50,$54183.50,30,$-19.50
2024-02-09,00:29:00,17871.75,BUY,3,0.02h,Stop Loss,$-9.00,$-28.50,$54174.50,30,$-28.50
2024-02-09,00:30:00,17870.25,SELL,3,0.02h,Stop Loss,$-9.00,$-37.50,$54165.50,30,$-37.50
2024-02-09,00:31:00,17871.0,BUY,3,0.03h,Stop Loss,$-9.00,$-46.50,$54156.50,30,$-46.50
2024-02-09,00:41:00,17871.75,BUY,3,0.02h,Stop Loss,$-9.00,$-55.50,$54147.50,30,$-55.50
2024-02-09,00:48:00,17869.5,SELL,3,0.02h,Break Even,$-1.50,$-57.00,$54146.00,30,$-57.00
2024-02-09,02:11:00,17857.5,BUY,3,0.05h,Break Even,$-1.50,$-58.50,$54144.50,30,$-58.50
2024-02-09,02:35:00,17859.0,SELL,3,0.03h,Stop Loss,$-9.00,$-67.50,$54135.50,30,$-67.50
2024-02-09,02:38:00,17861.25,BUY,3,0.02h,Break Even,$-1.50,$-69.00,$54134.00,30,$-69.00
2024-02-09,03:34:00,17861.75,SELL,3,0.02h,Stop Loss,$-9.00,$-78.00,$54125.00,30,$-78.00
2024-02-09,03:39:00,17865.5,BUY,3,0.02h,Break Even,$-1.50,$-79.50,$54123.50,30,$-79.50
2024-02-09,04:15:00,17867.0,SELL,3,0.05h,Stop Loss,$-9.00,$-88.50,$54114.50,30,$-88.50
2024-02-09,04:19:00,17869.0,BUY,3,0.02h,Stop Loss,$-9.00,$-97.50,$54105.50,30,$-97.50
2024-02-09,04:31:00,17866.75,SELL,3,0.08h,Stop Loss,$-9.00,$-106.50,$54096.50,30,$-106.50
2024-02-09,04:48:00,17867.5,BUY,3,0.12h,Stop Loss,$-9.00,$-115.50,$54087.50,30,$-115.50
2024-02-09,04:56:00,17865.75,SELL,3,0.05h,Stop Loss,$4.50,$-111.00,$54092.00,30,$-111.00
2024-02-09,05:07:00,17868.0,BUY,3,0.03h,Break Even,$-1.50,$-112.50,$54090.50,30,$-112.50
2024-02-09,05:38:00,17866.25,SELL,3,0.02h,Stop Loss,$-9.00,$-121.50,$54081.50,30,$-121.50
2024-02-09,06:35:00,17866.5,BUY,3,0.02h,Stop Loss,$-9.00,$-130.50,$54072.50,30,$-130.50
2024-02-09,06:52:00,17862.0,SELL,3,0.02h,Stop Loss,$-9.00,$-139.50,$54063.50,30,$-139.50
2024-02-09,07:03:00,17868.0,BUY,3,0.05h,Stop Loss,$-9.00,$-148.50,$54054.50,30,$-148.50
2024-02-09,08:47:00,17910.5,SELL,3,0.02h,Stop Loss,$-9.00,$-157.50,$54045.50,30,$-157.50
2024-02-09,08:54:00,17915.75,BUY,3,0.02h,Stop Loss,$-9.00,$-166.50,$54036.50,30,$-166.50
2024-02-09,09:04:00,17911.0,SELL,3,0.02h,Stop Loss,$9.00,$-157.50,$54045.50,30,$-157.50
2024-02-09,09:39:00,17899.0,BUY,3,0.02h,Stop Loss,$7.50,$-150.00,$54053.00,30,$-150.00
2024-02-09,10:53:00,17913.25,SELL,3,0.02h,Break Even,$-1.50,$-151.50,$54051.50,30,$-151.50
2024-02-09,11:30:00,17911.5,BUY,3,0.02h,Break Even,$-1.50,$-153.00,$54050.00,30,$-153.00
2024-02-09,11:53:00,17912.75,SELL,3,0.03h,Stop Loss,$-9.00,$-162.00,$54041.00,30,$-162.00
2024-02-09,11:58:00,17916.5,BUY,3,0.02h,Break Even,$-1.50,$-163.50,$54039.50,30,$-163.50
2024-02-09,12:38:00,17926.75,SELL,3,0.02h,Break Even,$-1.50,$-165.00,$54038.00,30,$-165.00
2024-02-09,13:27:00,17916.25,BUY,3,0.02h,Stop Loss,$-9.00,$-174.00,$54029.00,30,$-174.00
2024-02-09,13:29:00,17912.75,SELL,3,0.02h,Break Even,$-1.50,$-175.50,$54027.50,30,$-175.50
2024-02-09,13:31:00,17918.25,BUY,3,0.02h,Stop Loss,$186.00,$10.50,$54213.50,30,$10.50
2024-02-09,14:01:00,17925.5,SELL,3,0.02h,Break Even,$-1.50,$9.00,$54212.00,30,$9.00
2024-02-09,14:14:00,17931.0,BUY,3,0.02h,Break Even,$-1.50,$7.50,$54210.50,30,$7.50
2024-02-09,14:21:00,17923.5,SELL,3,0.02h,Break Even,$-1.50,$6.00,$54209.00,30,$6.00
2024-02-09,14:49:00,17908.75,BUY,3,0.02h,Break Even,$-1.50,$4.50,$54207.50,30,$4.50
2024-02-09,16:19:00,17989.75,SELL,3,0.02h,Stop Loss,$-9.00,$-4.50,$54198.50,30,$-4.50
2024-02-09,16:22:00,17999.5,BUY,3,0.02h,Break Even,$-1.50,$-6.00,$54197.00,30,$-6.00
2024-02-09,16:25:00,17990.5,SELL,3,0.02h,Break Even,$-1.50,$-7.50,$54195.50,30,$-7.50
2024-02-09,16:43:00,17993.25,BUY,3,0.02h,Break Even,$-1.50,$-9.00,$54194.00,30,$-9.00
2024-02-09,17:02:00,17987.25,SELL,3,0.02h,Stop Loss,$-9.00,$-18.00,$54185.00,30,$-18.00
2024-02-09,17:26:00,17993.25,BUY,3,0.02h,Break Even,$-1.50,$-19.50,$54183.50,30,$-19.50
2024-02-09,18:49:00,18032.25,SELL,3,0.02h,Stop Loss,$-9.00,$-28.50,$54174.50,30,$-28.50
2024-02-09,18:57:00,18038.25,BUY,3,0.02h,Stop Loss,$3.00,$-25.50,$54177.50,30,$-25.50
2024-02-09,19:10:00,18032.0,SELL,3,0.02h,Stop Loss,$-9.00,$-34.50,$54168.50,30,$-34.50
2024-02-09,19:15:00,18037.5,BUY,3,0.02h,Stop Loss,$-9.00,$-43.50,$54159.50,30,$-43.50
2024-02-09,19:16:00,18035.5,SELL,3,0.02h,Stop Loss,$-9.00,$-52.50,$54150.50,30,$-52.50
2024-02-09,19:17:00,18036.75,BUY,3,0.02h,Break Even,$-1.50,$-54.00,$54149.00,30,$-54.00
2024-02-09,19:18:00,18035.25,SELL,3,0.02h,Stop Loss,$-9.00,$-63.00,$54140.00,30,$-63.00
2024-02-09,19:19:00,18038.25,BUY,3,0.02h,Break Even,$-1.50,$-64.50,$54138.50,30,$-64.50
2024-02-09,20:01:00,18051.75,SELL,3,0.02h,Stop Loss,$43.50,$-21.00,$54182.00,30,$-21.00
2024-02-09,20:19:00,18052.75,BUY,3,0.02h,Stop Loss,$-9.00,$-30.00,$54173.00,30,$-30.00
2024-02-09,20:24:00,18043.25,SELL,3,0.02h,Break Even,$-1.50,$-31.50,$54171.50,30,$-31.50
2024-02-09,20:56:00,18046.25,BUY,3,0.02h,Stop Loss,$-9.00,$-40.50,$54162.50,30,$-40.50
2024-02-09,20:58:00,18037.0,SELL,3,0.02h,Break Even,$-1.50,$-42.00,$54161.00,30,$-42.00
2024-02-09,21:36:00,18034.25,BUY,3,0.07h,Stop Loss,$-9.00,$-51.00,$54152.00,30,$-51.00
2024-02-09,21:44:00,18032.75,SELL,3,0.02h,Stop Loss,$-9.00,$-60.00,$54143.00,30,$-60.00
2024-02-09,21:46:00,18033.5,BUY,3,0.02h,Break Even,$-1.50,$-61.50,$54141.50,30,$-61.50
,,,,,,,,,,,
2024-02-12,00:07:00,18031.5,SELL,3,0.02h,Stop Loss,$-9.00,$-9.00,$54132.50,31,$-9.00
2024-02-12,00:29:00,18032.5,BUY,3,0.02h,Stop Loss,$-9.00,$-18.00,$54123.50,31,$-18.00
2024-02-12,00:45:00,18032.5,SELL,3,0.02h,Stop Loss,$-9.00,$-27.00,$54114.50,31,$-27.00
2024-02-12,00:46:00,18033.75,BUY,3,0.15h,Stop Loss,$10.50,$-16.50,$54125.00,31,$-16.50
2024-02-12,01:01:00,18033.5,SELL,3,0.02h,Stop Loss,$-9.00,$-25.50,$54116.00,31,$-25.50
2024-02-12,01:04:00,18035.75,BUY,3,0.03h,Stop Loss,$-9.00,$-34.50,$54107.00,31,$-34.50
2024-02-12,01:08:00,18033.25,SELL,3,0.03h,Stop Loss,$-9.00,$-43.50,$54098.00,31,$-43.50
2024-02-12,01:12:00,18035.0,BUY,3,0.02h,Break Even,$-1.50,$-45.00,$54096.50,31,$-45.00
2024-02-12,01:45:00,18037.0,SELL,3,0.03h,Break Even,$-1.50,$-46.50,$54095.00,31,$-46.50
2024-02-12,02:32:00,18034.0,BUY,3,0.03h,Stop Loss,$-9.00,$-55.50,$54086.00,31,$-55.50
2024-02-12,02:44:00,18033.0,SELL,3,0.05h,Stop Loss,$-9.00,$-64.50,$54077.00,31,$-64.50
2024-02-12,02:47:00,18034.0,BUY,3,0.13h,Stop Loss,$-9.00,$-73.50,$54068.00,31,$-73.50
2024-02-12,02:55:00,18033.25,SELL,3,0.05h,Break Even,$-1.50,$-75.00,$54066.50,31,$-75.00
2024-02-12,03:06:00,18033.75,BUY,3,0.02h,Stop Loss,$-9.00,$-84.00,$54057.50,31,$-84.00
2024-02-12,03:11:00,18032.5,SELL,3,0.10h,Stop Loss,$-9.00,$-93.00,$54048.50,31,$-93.00
2024-02-12,04:07:00,18031.25,BUY,3,0.02h,Stop Loss,$-9.00,$-102.00,$54039.50,31,$-102.00
2024-02-12,04:30:00,18027.5,SELL,3,0.02h,Break Even,$-1.50,$-103.50,$54038.00,31,$-103.50
2024-02-12,05:22:00,18021.5,BUY,3,0.02h,Stop Loss,$-9.00,$-112.50,$54029.00,31,$-112.50
2024-02-12,05:24:00,18019.25,SELL,3,0.05h,Stop Loss,$-9.00,$-121.50,$54020.00,31,$-121.50
2024-02-12,05:28:00,18020.75,BUY,3,0.03h,Stop Loss,$-9.00,$-130.50,$54011.00,31,$-130.50
2024-02-12,05:30:00,18019.25,SELL,3,0.02h,Break Even,$-1.50,$-132.00,$54009.50,31,$-132.00
2024-02-12,06:00:00,18019.0,BUY,3,0.05h,Break Even,$-1.50,$-133.50,$54008.00,31,$-133.50
2024-02-12,06:23:00,18018.5,SELL,3,0.03h,Stop Loss,$-9.00,$-142.50,$53999.00,31,$-142.50
2024-02-12,06:26:00,18021.75,BUY,3,0.02h,Stop Loss,$19.50,$-123.00,$54018.50,31,$-123.00
2024-02-12,06:57:00,18022.25,SELL,3,0.03h,Stop Loss,$-9.00,$-132.00,$54009.50,31,$-132.00
2024-02-12,07:07:00,18025.5,BUY,3,0.02h,Break Even,$-1.50,$-133.50,$54008.00,31,$-133.50
2024-02-12,07:38:00,18033.5,SELL,3,0.02h,Stop Loss,$-9.00,$-142.50,$53999.00,31,$-142.50
2024-02-12,07:47:00,18039.0,BUY,3,0.02h,Break Even,$-1.50,$-144.00,$53997.50,31,$-144.00
2024-02-12,08:46:00,18045.75,SELL,3,0.02h,Break Even,$-1.50,$-145.50,$53996.00,31,$-145.50
2024-02-12,09:02:00,18048.25,BUY,3,0.02h,Break Even,$-1.50,$-147.00,$53994.50,31,$-147.00
2024-02-12,09:27:00,18049.0,SELL,3,0.02h,Stop Loss,$-9.00,$-156.00,$53985.50,31,$-156.00
2024-02-12,09:28:00,18053.25,BUY,3,0.02h,Stop Loss,$-9.00,$-165.00,$53976.50,31,$-165.00
2024-02-12,09:51:00,18051.5,SELL,3,0.03h,Break Even,$-1.50,$-166.50,$53975.00,31,$-166.50
2024-02-12,10:04:00,18053.25,BUY,3,0.03h,Stop Loss,$-9.00,$-175.50,$53966.00,31,$-175.50
2024-02-12,10:06:00,18048.0,SELL,3,0.02h,Break Even,$-1.50,$-177.00,$53964.50,31,$-177.00
2024-02-12,10:15:00,18056.5,BUY,3,0.02h,Break Even,$-1.50,$-178.50,$53963.00,31,$-178.50
2024-02-12,10:23:00,18049.0,SELL,3,0.02h,Stop Loss,$-9.00,$-187.50,$53954.00,31,$-187.50
2024-02-12,10:31:00,18051.75,BUY,3,0.03h,Break Even,$-1.50,$-189.00,$53952.50,31,$-189.00
2024-02-12,10:34:00,18050.0,SELL,3,0.02h,Stop Loss,$-9.00,$-198.00,$53943.50,31,$-198.00
2024-02-12,10:51:00,18050.0,BUY,3,0.02h,Stop Loss,$-9.00,$-207.00,$53934.50,31,$-207.00
2024-02-12,10:52:00,18046.25,SELL,3,0.02h,Stop Loss,$-9.00,$-216.00,$53925.50,31,$-216.00
2024-02-12,10:57:00,18050.75,BUY,3,0.02h,Stop Loss,$-9.00,$-225.00,$53916.50,31,$-225.00
2024-02-12,11:02:00,18047.5,SELL,3,0.03h,Stop Loss,$-9.00,$-234.00,$53907.50,31,$-234.00
2024-02-12,11:17:00,18053.5,BUY,3,0.02h,Stop Loss,$-9.00,$-243.00,$53898.50,31,$-243.00
2024-02-12,11:35:00,18049.0,SELL,3,0.02h,Break Even,$-1.50,$-244.50,$53897.00,31,$-244.50
2024-02-12,12:18:00,18045.75,BUY,3,0.02h,Stop Loss,$-9.00,$-253.50,$53888.00,31,$-253.50
2024-02-12,12:19:00,18042.25,SELL,3,0.03h,Stop Loss,$-9.00,$-262.50,$53879.00,31,$-262.50
2024-02-12,12:48:00,18039.5,BUY,3,0.02h,Stop Loss,$-9.00,$-271.50,$53870.00,31,$-271.50
2024-02-12,12:51:00,18036.0,SELL,3,0.02h,Stop Loss,$-9.00,$-280.50,$53861.00,31,$-280.50
2024-02-12,13:05:00,18039.25,BUY,3,0.02h,Stop Loss,$-9.00,$-289.50,$53852.00,31,$-289.50
2024-02-12,13:32:00,18037.0,SELL,3,0.02h,Stop Loss,$7.50,$-282.00,$53859.50,31,$-282.00
2024-02-12,14:07:00,18034.25,BUY,3,0.02h,Stop Loss,$-9.00,$-291.00,$53850.50,31,$-291.00
2024-02-12,14:15:00,18023.25,SELL,3,0.02h,Stop Loss,$-9.00,$-300.00,$53841.50,31,$-300.00
2024-02-12,14:35:00,18045.25,BUY,3,0.02h,Stop Loss,$12.00,$-288.00,$53853.50,31,$-288.00
2024-02-12,14:48:00,18028.75,SELL,3,0.02h,Stop Loss,$46.50,$-241.50,$53900.00,31,$-241.50
2024-02-12,14:57:00,18035.5,BUY,3,0.02h,Break Even,$-1.50,$-243.00,$53898.50,31,$-243.00
2024-02-12,15:04:00,18027.5,SELL,3,0.02h,Stop Loss,$-9.00,$-252.00,$53889.50,31,$-252.00
2024-02-12,15:27:00,18032.25,BUY,3,0.02h,Stop Loss,$12.00,$-240.00,$53901.50,31,$-240.00
2024-02-12,16:50:00,18084.25,SELL,3,0.02h,Stop Loss,$-9.00,$-249.00,$53892.50,31,$-249.00
2024-02-12,16:56:00,18105.5,BUY,3,0.02h,Break Even,$-1.50,$-250.50,$53891.00,31,$-250.50
2024-02-12,17:02:00,18092.75,SELL,3,0.02h,Stop Loss,$7.50,$-243.00,$53898.50,31,$-243.00
2024-02-12,17:06:00,18104.25,BUY,3,0.02h,Break Even,$-1.50,$-244.50,$53897.00,31,$-244.50
2024-02-12,17:17:00,18095.75,SELL,3,0.02h,Break Even,$-1.50,$-246.00,$53895.50,31,$-246.00
2024-02-12,17:50:00,18093.0,BUY,3,0.02h,Stop Loss,$-9.00,$-255.00,$53886.50,31,$-255.00
2024-02-12,18:23:00,18084.5,SELL,3,0.02h,Stop Loss,$49.50,$-205.50,$53936.00,31,$-205.50
2024-02-12,19:43:00,17984.0,BUY,3,0.02h,Stop Loss,$-9.00,$-214.50,$53927.00,31,$-214.50
2024-02-12,19:46:00,17976.25,SELL,3,0.02h,Stop Loss,$21.00,$-193.50,$53948.00,31,$-193.50
2024-02-12,20:08:00,17973.25,BUY,3,0.02h,Break Even,$-1.50,$-195.00,$53946.50,31,$-195.00
2024-02-12,20:34:00,17972.5,SELL,3,0.02h,Stop Loss,$4.50,$-190.50,$53951.00,31,$-190.50
2024-02-12,20:53:00,17978.75,BUY,3,0.02h,Break Even,$-1.50,$-192.00,$53949.50,31,$-192.00
2024-02-12,20:56:00,17953.0,SELL,3,0.02h,Stop Loss,$-9.00,$-201.00,$53940.50,31,$-201.00
2024-02-12,21:56:00,17923.5,BUY,3,0.03h,Stop Loss,$15.00,$-186.00,$53955.50,31,$-186.00
2024-02-12,23:14:00,17921.5,SELL,3,0.02h,Stop Loss,$7.50,$-178.50,$53963.00,31,$-178.50
2024-02-12,23:23:00,17933.75,BUY,3,0.02h,Stop Loss,$-9.00,$-187.50,$53954.00,31,$-187.50
,,,,,,,,,,,
2024-02-13,00:04:00,17931.5,SELL,3,0.02h,Stop Loss,$-9.00,$-9.00,$53945.00,32,$-9.00
2024-02-13,00:33:00,17930.0,BUY,3,0.02h,Stop Loss,$-9.00,$-18.00,$53936.00,32,$-18.00
2024-02-13,00:48:00,17926.0,SELL,3,0.02h,Stop Loss,$-9.00,$-27.00,$53927.00,32,$-27.00
2024-02-13,00:56:00,17929.75,BUY,3,0.02h,Break Even,$-1.50,$-28.50,$53925.50,32,$-28.50
2024-02-13,01:03:00,17925.0,SELL,3,0.02h,Stop Loss,$-9.00,$-37.50,$53916.50,32,$-37.50
2024-02-13,01:07:00,17931.5,BUY,3,0.02h,Stop Loss,$-9.00,$-46.50,$53907.50,32,$-46.50
2024-02-13,01:09:00,17927.0,SELL,3,0.03h,Break Even,$-1.50,$-48.00,$53906.00,32,$-48.00
2024-02-13,01:44:00,17926.0,BUY,3,0.02h,Stop Loss,$-9.00,$-57.00,$53897.00,32,$-57.00
2024-02-13,02:04:00,17923.5,SELL,3,0.02h,Stop Loss,$-9.00,$-66.00,$53888.00,32,$-66.00
2024-02-13,02:12:00,17926.25,BUY,3,0.62h,Stop Loss,$58.50,$-7.50,$53946.50,32,$-7.50
2024-02-13,02:58:00,17933.75,SELL,3,0.02h,Stop Loss,$-9.00,$-16.50,$53937.50,32,$-16.50
2024-02-13,04:23:00,17928.0,BUY,3,0.05h,Break Even,$-1.50,$-18.00,$53936.00,32,$-18.00
2024-02-13,04:40:00,17927.25,SELL,3,0.02h,Break Even,$-1.50,$-19.50,$53934.50,32,$-19.50
2024-02-13,04:47:00,17930.25,BUY,3,0.02h,Stop Loss,$-9.00,$-28.50,$53925.50,32,$-28.50
2024-02-13,05:51:00,17937.0,SELL,3,0.02h,Stop Loss,$-9.00,$-37.50,$53916.50,32,$-37.50
2024-02-13,05:52:00,17938.5,BUY,3,0.08h,Stop Loss,$4.50,$-33.00,$53921.00,32,$-33.00
2024-02-13,06:40:00,17952.25,SELL,3,0.02h,Stop Loss,$-9.00,$-42.00,$53912.00,32,$-42.00
2024-02-13,06:42:00,17955.5,BUY,3,0.02h,Break Even,$-1.50,$-43.50,$53910.50,32,$-43.50
2024-02-13,06:54:00,17953.0,SELL,3,0.02h,Stop Loss,$-9.00,$-52.50,$53901.50,32,$-52.50
2024-02-13,07:13:00,17955.0,BUY,3,0.02h,Stop Loss,$-9.00,$-61.50,$53892.50,32,$-61.50
2024-02-13,07:20:00,17951.25,SELL,3,0.02h,Stop Loss,$-9.00,$-70.50,$53883.50,32,$-70.50
2024-02-13,07:29:00,17955.0,BUY,3,0.02h,Break Even,$-1.50,$-72.00,$53882.00,32,$-72.00
2024-02-13,07:33:00,17951.25,SELL,3,0.02h,Stop Loss,$19.50,$-52.50,$53901.50,32,$-52.50
2024-02-13,08:00:00,17954.0,BUY,3,0.02h,Break Even,$-1.50,$-54.00,$53900.00,32,$-54.00
2024-02-13,08:14:00,17946.75,SELL,3,0.02h,Stop Loss,$-9.00,$-63.00,$53891.00,32,$-63.00
2024-02-13,09:26:00,17901.25,BUY,3,0.02h,Stop Loss,$-9.00,$-72.00,$53882.00,32,$-72.00
2024-02-13,09:29:00,17894.25,SELL,3,0.02h,Stop Loss,$15.00,$-57.00,$53897.00,32,$-57.00
2024-02-13,10:35:00,17862.75,BUY,3,0.02h,Break Even,$-1.50,$-58.50,$53895.50,32,$-58.50
2024-02-13,10:45:00,17857.5,SELL,3,0.02h,Break Even,$-1.50,$-60.00,$53894.00,32,$-60.00
2024-02-13,11:09:00,17855.5,BUY,3,0.02h,Stop Loss,$-9.00,$-69.00,$53885.00,32,$-69.00
2024-02-13,11:11:00,17848.5,SELL,3,0.02h,Stop Loss,$6.00,$-63.00,$53891.00,32,$-63.00
2024-02-13,11:21:00,17856.5,BUY,3,0.02h,Break Even,$-1.50,$-64.50,$53889.50,32,$-64.50
2024-02-13,11:34:00,17850.75,SELL,3,0.02h,Break Even,$-1.50,$-66.00,$53888.00,32,$-66.00
2024-02-13,12:21:00,17832.25,BUY,3,0.02h,Stop Loss,$-9.00,$-75.00,$53879.00,32,$-75.00
2024-02-13,12:31:00,17824.25,SELL,3,0.02h,Break Even,$-1.50,$-76.50,$53877.50,32,$-76.50
2024-02-13,12:33:00,17832.5,BUY,3,0.02h,Break Even,$-1.50,$-78.00,$53876.00,32,$-78.00
2024-02-13,12:41:00,17828.25,SELL,3,0.02h,Stop Loss,$24.00,$-54.00,$53900.00,32,$-54.00
2024-02-13,12:57:00,17832.25,BUY,3,0.02h,Stop Loss,$9.00,$-45.00,$53909.00,32,$-45.00
2024-02-13,13:31:00,17731.5,SELL,3,0.02h,Stop Loss,$78.00,$33.00,$53987.00,32,$33.00
2024-02-13,14:37:00,17654.25,BUY,3,0.02h,Break Even,$-1.50,$31.50,$53985.50,32,$31.50
2024-02-13,14:53:00,17634.5,SELL,3,0.02h,Stop Loss,$7.50,$39.00,$53993.00,32,$39.00
2024-02-13,14:54:00,17659.75,BUY,3,0.02h,Stop Loss,$121.50,$160.50,$54114.50,32,$160.50
2024-02-13,15:15:00,17649.75,SELL,3,0.02h,Stop Loss,$61.50,$222.00,$54176.00,32,$222.00
2024-02-13,15:21:00,17689.0,BUY,3,0.02h,Stop Loss,$22.50,$244.50,$54198.50,32,$244.50
2024-02-13,15:58:00,17735.75,SELL,3,0.02h,Stop Loss,$18.00,$262.50,$54216.50,32,$262.50
2024-02-13,16:07:00,17761.0,BUY,3,0.02h,Stop Loss,$15.00,$277.50,$54231.50,32,$277.50
2024-02-13,16:18:00,17744.25,SELL,3,0.02h,Stop Loss,$28.50,$306.00,$54260.00,32,$306.00
2024-02-13,16:38:00,17757.0,BUY,3,0.02h,Break Even,$-1.50,$304.50,$54258.50,32,$304.50
2024-02-13,16:54:00,17725.25,SELL,3,0.02h,Break Even,$-1.50,$303.00,$54257.00,32,$303.00
2024-02-13,17:34:00,17721.25,BUY,3,0.02h,Stop Loss,$-9.00,$294.00,$54248.00,32,$294.00
2024-02-13,17:50:00,17700.5,SELL,3,0.02h,Break Even,$-1.50,$292.50,$54246.50,32,$292.50
2024-02-13,18:16:00,17696.5,BUY,3,0.02h,Stop Loss,$-9.00,$283.50,$54237.50,32,$283.50
2024-02-13,18:21:00,17673.0,SELL,3,0.02h,Break Even,$-1.50,$282.00,$54236.00,32,$282.00
2024-02-13,18:26:00,17685.0,BUY,3,0.02h,Stop Loss,$16.50,$298.50,$54252.50,32,$298.50
2024-02-13,18:33:00,17680.25,SELL,3,0.02h,Break Even,$-1.50,$297.00,$54251.00,32,$297.00
2024-02-13,19:33:00,17626.25,BUY,3,0.02h,Stop Loss,$-9.00,$288.00,$54242.00,32,$288.00
2024-02-13,19:49:00,17608.25,SELL,3,0.02h,Break Even,$-1.50,$286.50,$54240.50,32,$286.50
2024-02-13,20:33:00,17571.0,BUY,3,0.02h,Stop Loss,$48.00,$334.50,$54288.50,32,$334.50
2024-02-13,23:01:00,17687.75,SELL,3,0.02h,Break Even,$-1.50,$333.00,$54287.00,32,$333.00
2024-02-13,23:33:00,17689.0,BUY,3,0.02h,Break Even,$-1.50,$331.50,$54285.50,32,$331.50
2024-02-13,23:50:00,17684.75,SELL,3,0.02h,Break Even,$-1.50,$330.00,$54284.00,32,$330.00
,,,,,,,,,,,
2024-02-14,00:46:00,17685.5,BUY,3,0.02h,Stop Loss,$-9.00,$-9.00,$54275.00,33,$-9.00
2024-02-14,01:13:00,17685.25,SELL,3,0.03h,Stop Loss,$9.00,$0.00,$54284.00,33,$0.00
2024-02-14,01:45:00,17680.25,BUY,3,0.02h,Stop Loss,$-9.00,$-9.00,$54275.00,33,$-9.00
2024-02-14,01:47:00,17673.5,SELL,3,0.02h,Stop Loss,$-9.00,$-18.00,$54266.00,33,$-18.00
2024-02-14,01:50:00,17679.5,BUY,3,0.03h,Break Even,$-1.50,$-19.50,$54264.50,33,$-19.50
2024-02-14,02:27:00,17681.25,SELL,3,0.02h,Break Even,$-1.50,$-21.00,$54263.00,33,$-21.00
2024-02-14,03:04:00,17675.75,BUY,3,0.03h,Break Even,$-1.50,$-22.50,$54261.50,33,$-22.50
2024-02-14,03:20:00,17674.5,SELL,3,0.02h,Stop Loss,$-9.00,$-31.50,$54252.50,33,$-31.50
2024-02-14,03:21:00,17675.75,BUY,3,0.02h,Stop Loss,$-9.00,$-40.50,$54243.50,33,$-40.50
2024-02-14,03:36:00,17675.0,SELL,3,0.02h,Break Even,$-1.50,$-42.00,$54242.00,33,$-42.00
2024-02-14,03:40:00,17676.75,BUY,3,0.02h,Break Even,$-1.50,$-43.50,$54240.50,33,$-43.50
2024-02-14,03:58:00,17675.75,SELL,3,0.02h,Stop Loss,$-9.00,$-52.50,$54231.50,33,$-52.50
2024-02-14,04:43:00,17675.5,BUY,3,0.02h,Stop Loss,$-9.00,$-61.50,$54222.50,33,$-61.50
2024-02-14,05:55:00,17685.25,SELL,3,0.08h,Break Even,$-1.50,$-63.00,$54221.00,33,$-63.00
2024-02-14,06:04:00,17688.75,BUY,3,0.02h,Break Even,$-1.50,$-64.50,$54219.50,33,$-64.50
2024-02-14,07:06:00,17695.5,SELL,3,0.02h,Stop Loss,$-9.00,$-73.50,$54210.50,33,$-73.50
2024-02-14,07:09:00,17705.75,BUY,3,0.02h,Stop Loss,$-9.00,$-82.50,$54201.50,33,$-82.50
2024-02-14,08:09:00,17734.5,SELL,3,0.02h,Stop Loss,$-9.00,$-91.50,$54192.50,33,$-91.50
2024-02-14,08:10:00,17739.0,BUY,3,0.02h,Stop Loss,$-9.00,$-100.50,$54183.50,33,$-100.50
2024-02-14,08:11:00,17734.75,SELL,3,0.02h,Break Even,$-1.50,$-102.00,$54182.00,33,$-102.00
2024-02-14,08:22:00,17738.25,BUY,3,0.02h,Stop Loss,$-9.00,$-111.00,$54173.00,33,$-111.00
2024-02-14,08:52:00,17741.25,SELL,3,0.02h,Stop Loss,$-9.00,$-120.00,$54164.00,33,$-120.00
2024-02-14,08:56:00,17746.5,BUY,3,0.02h,Break Even,$-1.50,$-121.50,$54162.50,33,$-121.50
2024-02-14,10:15:00,17783.25,SELL,3,0.02h,Stop Loss,$-9.00,$-130.50,$54153.50,33,$-130.50
2024-02-14,10:17:00,17787.25,BUY,3,0.02h,Break Even,$-1.50,$-132.00,$54152.00,33,$-132.00
2024-02-14,10:22:00,17781.0,SELL,3,0.02h,Stop Loss,$-9.00,$-141.00,$54143.00,33,$-141.00
2024-02-14,10:47:00,17781.25,BUY,3,0.02h,Break Even,$-1.50,$-142.50,$54141.50,33,$-142.50
2024-02-14,10:48:00,17780.25,SELL,3,0.02h,Break Even,$-1.50,$-144.00,$54140.00,33,$-144.00
2024-02-14,10:50:00,17784.25,BUY,3,0.02h,Stop Loss,$-9.00,$-153.00,$54131.00,33,$-153.00
2024-02-14,11:03:00,17773.0,SELL,3,0.02h,Stop Loss,$6.00,$-147.00,$54137.00,33,$-147.00
2024-02-14,11:31:00,17774.0,BUY,3,0.02h,Stop Loss,$-9.00,$-156.00,$54128.00,33,$-156.00
2024-02-14,11:35:00,17770.75,SELL,3,0.02h,Stop Loss,$10.50,$-145.50,$54138.50,33,$-145.50
2024-02-14,11:51:00,17779.5,BUY,3,0.02h,Stop Loss,$4.50,$-141.00,$54143.00,33,$-141.00
2024-02-14,12:32:00,17791.25,SELL,3,0.02h,Stop Loss,$-9.00,$-150.00,$54134.00,33,$-150.00
2024-02-14,12:49:00,17795.0,BUY,3,0.02h,Break Even,$-1.50,$-151.50,$54132.50,33,$-151.50
2024-02-14,12:57:00,17788.0,SELL,3,0.02h,Break Even,$-1.50,$-153.00,$54131.00,33,$-153.00
2024-02-14,13:03:00,17799.5,BUY,3,0.02h,Stop Loss,$18.00,$-135.00,$54149.00,33,$-135.00
2024-02-14,13:19:00,17793.75,SELL,3,0.02h,Break Even,$-1.50,$-136.50,$54147.50,33,$-136.50
2024-02-14,13:43:00,17794.5,BUY,3,0.02h,Break Even,$-1.50,$-138.00,$54146.00,33,$-138.00
2024-02-14,13:50:00,17783.5,SELL,3,0.02h,Stop Loss,$7.50,$-130.50,$54153.50,33,$-130.50
2024-02-14,14:26:00,17785.75,BUY,3,0.02h,Break Even,$-1.50,$-132.00,$54152.00,33,$-132.00
2024-02-14,14:39:00,17767.0,SELL,3,0.02h,Stop Loss,$75.00,$-57.00,$54227.00,33,$-57.00
2024-02-14,14:48:00,17790.0,BUY,3,0.02h,Break Even,$-1.50,$-58.50,$54225.50,33,$-58.50
2024-02-14,14:51:00,17761.5,SELL,3,0.02h,Stop Loss,$43.50,$-15.00,$54269.00,33,$-15.00
2024-02-14,15:00:00,17789.25,BUY,3,0.02h,Stop Loss,$48.00,$33.00,$54317.00,33,$33.00
2024-02-14,15:40:00,17810.0,SELL,3,0.02h,Stop Loss,$55.50,$88.50,$54372.50,33,$88.50
2024-02-14,16:26:00,17755.0,BUY,3,0.02h,Break Even,$-1.50,$87.00,$54371.00,33,$87.00
2024-02-14,16:45:00,17728.75,SELL,3,0.02h,Stop Loss,$6.00,$93.00,$54377.00,33,$93.00
2024-02-14,17:15:00,17732.0,BUY,3,0.02h,Break Even,$-1.50,$91.50,$54375.50,33,$91.50
2024-02-14,18:11:00,17755.75,SELL,3,0.02h,Break Even,$-1.50,$90.00,$54374.00,33,$90.00
2024-02-14,18:33:00,17774.25,BUY,3,0.02h,Break Even,$-1.50,$88.50,$54372.50,33,$88.50
2024-02-14,18:58:00,17781.25,SELL,3,0.02h,Break Even,$-1.50,$87.00,$54371.00,33,$87.00
2024-02-14,19:26:00,17772.25,BUY,3,0.02h,Break Even,$-1.50,$85.50,$54369.50,33,$85.50
2024-02-14,21:46:00,17872.25,SELL,3,0.03h,Stop Loss,$-9.00,$76.50,$54360.50,33,$76.50
2024-02-14,23:17:00,17873.25,BUY,3,0.03h,Stop Loss,$-9.00,$67.50,$54351.50,33,$67.50
,,,,,,,,,,,
2024-02-15,00:05:00,17875.0,SELL,3,0.02h,Stop Loss,$-9.00,$-9.00,$54342.50,34,$-9.00
2024-02-15,00:37:00,17873.0,BUY,3,0.02h,Stop Loss,$-9.00,$-18.00,$54333.50,34,$-18.00
2024-02-15,00:51:00,17870.0,SELL,3,0.03h,Stop Loss,$-9.00,$-27.00,$54324.50,34,$-27.00
2024-02-15,01:57:00,17852.0,BUY,3,0.03h,Stop Loss,$-9.00,$-36.00,$54315.50,34,$-36.00
2024-02-15,02:05:00,17849.5,SELL,3,0.02h,Break Even,$-1.50,$-37.50,$54314.00,34,$-37.50
2024-02-15,02:19:00,17853.25,BUY,3,0.02h,Break Even,$-1.50,$-39.00,$54312.50,34,$-39.00
2024-02-15,03:40:00,17876.5,SELL,3,0.22h,Stop Loss,$7.50,$-31.50,$54320.00,34,$-31.50
2024-02-15,04:23:00,17872.75,BUY,3,0.02h,Stop Loss,$-9.00,$-40.50,$54311.00,34,$-40.50
2024-02-15,04:44:00,17871.0,SELL,3,0.02h,Stop Loss,$-9.00,$-49.50,$54302.00,34,$-49.50
2024-02-15,04:46:00,17875.5,BUY,3,0.03h,Stop Loss,$-9.00,$-58.50,$54293.00,34,$-58.50
2024-02-15,05:10:00,17874.0,SELL,3,0.10h,Break Even,$-1.50,$-60.00,$54291.50,34,$-60.00
2024-02-15,05:21:00,17877.25,BUY,3,0.05h,Break Even,$-1.50,$-61.50,$54290.00,34,$-61.50
2024-02-15,05:41:00,17877.0,SELL,3,0.05h,Stop Loss,$-9.00,$-70.50,$54281.00,34,$-70.50
2024-02-15,05:45:00,17879.5,BUY,3,0.02h,Stop Loss,$-9.00,$-79.50,$54272.00,34,$-79.50
2024-02-15,05:47:00,17877.5,SELL,3,0.02h,Stop Loss,$-9.00,$-88.50,$54263.00,34,$-88.50
2024-02-15,06:16:00,17878.0,BUY,3,0.07h,Stop Loss,$-9.00,$-97.50,$54254.00,34,$-97.50
2024-02-15,07:59:00,17912.5,SELL,3,0.02h,Break Even,$-1.50,$-99.00,$54252.50,34,$-99.00
2024-02-15,08:13:00,17918.0,BUY,3,0.02h,Stop Loss,$-9.00,$-108.00,$54243.50,34,$-108.00
2024-02-15,08:38:00,17911.25,SELL,3,0.02h,Stop Loss,$-9.00,$-117.00,$54234.50,34,$-117.00
2024-02-15,08:41:00,17920.0,BUY,3,0.02h,Stop Loss,$-9.00,$-126.00,$54225.50,34,$-126.00
2024-02-15,08:44:00,17915.25,SELL,3,0.02h,Stop Loss,$-9.00,$-135.00,$54216.50,34,$-135.00
2024-02-15,08:47:00,17918.75,BUY,3,0.02h,Stop Loss,$-9.00,$-144.00,$54207.50,34,$-144.00
2024-02-15,08:51:00,17912.25,SELL,3,0.02h,Stop Loss,$13.50,$-130.50,$54221.00,34,$-130.50
2024-02-15,08:59:00,17919.75,BUY,3,0.02h,Stop Loss,$-9.00,$-139.50,$54212.00,34,$-139.50
2024-02-15,09:03:00,17910.5,SELL,3,0.02h,Break Even,$-1.50,$-141.00,$54210.50,34,$-141.00
2024-02-15,09:29:00,17907.0,BUY,3,0.02h,Stop Loss,$-9.00,$-150.00,$54201.50,34,$-150.00
2024-02-15,09:32:00,17902.5,SELL,3,0.02h,Stop Loss,$9.00,$-141.00,$54210.50,34,$-141.00
2024-02-15,10:05:00,17893.0,BUY,3,0.02h,Break Even,$-1.50,$-142.50,$54209.00,34,$-142.50
2024-02-15,10:20:00,17892.25,SELL,3,0.02h,Break Even,$-1.50,$-144.00,$54207.50,34,$-144.00
2024-02-15,10:34:00,17894.0,BUY,3,0.02h,Stop Loss,$3.00,$-141.00,$54210.50,34,$-141.00
2024-02-15,10:51:00,17888.25,SELL,3,0.02h,Break Even,$-1.50,$-142.50,$54209.00,34,$-142.50
2024-02-15,10:58:00,17896.5,BUY,3,0.02h,Stop Loss,$-9.00,$-151.50,$54200.00,34,$-151.50
2024-02-15,11:37:00,17901.0,SELL,3,0.02h,Break Even,$-1.50,$-153.00,$54198.50,34,$-153.00
2024-02-15,11:58:00,17904.5,BUY,3,0.02h,Stop Loss,$-9.00,$-162.00,$54189.50,34,$-162.00
2024-02-15,12:23:00,17902.75,SELL,3,0.02h,Stop Loss,$-9.00,$-171.00,$54180.50,34,$-171.00
2024-02-15,12:29:00,17913.25,BUY,3,0.02h,Break Even,$-1.50,$-172.50,$54179.00,34,$-172.50
2024-02-15,12:54:00,17908.5,SELL,3,0.02h,Stop Loss,$3.00,$-169.50,$54182.00,34,$-169.50
2024-02-15,13:32:00,17904.5,BUY,3,0.02h,Stop Loss,$84.00,$-85.50,$54266.00,34,$-85.50
2024-02-15,13:49:00,17894.75,SELL,3,0.02h,Stop Loss,$55.50,$-30.00,$54321.50,34,$-30.00
2024-02-15,14:23:00,17897.25,BUY,3,0.02h,Break Even,$-1.50,$-31.50,$54320.00,34,$-31.50
2024-02-15,14:29:00,17883.0,SELL,3,0.02h,Break Even,$-1.50,$-33.00,$54318.50,34,$-33.00
2024-02-15,15:13:00,17850.25,BUY,3,0.02h,Stop Loss,$21.00,$-12.00,$54339.50,34,$-12.00
2024-02-15,15:29:00,17813.0,SELL,3,0.02h,Stop Loss,$-9.00,$-21.00,$54330.50,34,$-21.00
2024-02-15,15:46:00,17840.5,BUY,3,0.02h,Break Even,$-1.50,$-22.50,$54329.00,34,$-22.50
2024-02-15,16:03:00,17826.75,SELL,3,0.02h,Break Even,$-1.50,$-24.00,$54327.50,34,$-24.00
2024-02-15,16:25:00,17816.5,BUY,3,0.02h,Stop Loss,$9.00,$-15.00,$54336.50,34,$-15.00
2024-02-15,16:53:00,17822.5,SELL,3,0.02h,Break Even,$-1.50,$-16.50,$54335.00,34,$-16.50
2024-02-15,17:02:00,17837.25,BUY,3,0.02h,Stop Loss,$-9.00,$-25.50,$54326.00,34,$-25.50
2024-02-15,17:03:00,17825.0,SELL,3,0.02h,Break Even,$-1.50,$-27.00,$54324.50,34,$-27.00
2024-02-15,17:11:00,17840.75,BUY,3,0.02h,Stop Loss,$4.50,$-22.50,$54329.00,34,$-22.50
2024-02-15,17:55:00,17866.5,SELL,3,0.02h,Stop Loss,$7.50,$-15.00,$54336.50,34,$-15.00
2024-02-15,18:08:00,17874.75,BUY,3,0.02h,Stop Loss,$64.50,$49.50,$54401.00,34,$49.50
2024-02-15,18:45:00,17905.25,SELL,3,0.02h,Stop Loss,$4.50,$54.00,$54405.50,34,$54.00
2024-02-15,19:05:00,17913.0,BUY,3,0.02h,Stop Loss,$-9.00,$45.00,$54396.50,34,$45.00
2024-02-15,19:06:00,17906.0,SELL,3,0.02h,Break Even,$-1.50,$43.50,$54395.00,34,$43.50
2024-02-15,19:07:00,17914.75,BUY,3,0.02h,Stop Loss,$15.00,$58.50,$54410.00,34,$58.50
2024-02-15,19:12:00,17896.75,SELL,3,0.02h,Stop Loss,$70.50,$129.00,$54480.50,34,$129.00
2024-02-15,19:23:00,17906.5,BUY,3,0.02h,Stop Loss,$15.00,$144.00,$54495.50,34,$144.00
2024-02-15,20:00:00,17906.75,SELL,3,0.02h,Stop Loss,$40.50,$184.50,$54536.00,34,$184.50
2024-02-15,20:52:00,17908.5,BUY,3,0.02h,Break Even,$-1.50,$183.00,$54534.50,34,$183.00
2024-02-15,21:44:00,17950.0,SELL,3,0.02h,Break Even,$-1.50,$181.50,$54533.00,34,$181.50
2024-02-15,21:53:00,17958.5,BUY,3,0.02h,Stop Loss,$-9.00,$172.50,$54524.00,34,$172.50
2024-02-15,23:04:00,17953.25,SELL,3,0.03h,Stop Loss,$4.50,$177.00,$54528.50,34,$177.00
2024-02-15,23:40:00,17951.75,BUY,3,0.02h,Break Even,$-1.50,$175.50,$54527.00,34,$175.50
,,,,,,,,,,,
2024-02-16,00:03:00,17950.5,SELL,3,0.03h,Stop Loss,$3.00,$3.00,$54530.00,35,$3.00
2024-02-16,01:24:00,17930.0,BUY,3,0.02h,Break Even,$-1.50,$1.50,$54528.50,35,$1.50
2024-02-16,01:37:00,17925.75,SELL,3,0.02h,Break Even,$-1.50,$0.00,$54527.00,35,$0.00
2024-02-16,01:54:00,17928.0,BUY,3,0.02h,Stop Loss,$-9.00,$-9.00,$54518.00,35,$-9.00
2024-02-16,02:07:00,17923.5,SELL,3,0.02h,Stop Loss,$-9.00,$-18.00,$54509.00,35,$-18.00
2024-02-16,02:13:00,17927.5,BUY,3,0.03h,Break Even,$-1.50,$-19.50,$54507.50,35,$-19.50
2024-02-16,02:29:00,17925.75,SELL,3,0.02h,Stop Loss,$-9.00,$-28.50,$54498.50,35,$-28.50
2024-02-16,02:31:00,17929.5,BUY,3,0.02h,Break Even,$-1.50,$-30.00,$54497.00,35,$-30.00
2024-02-16,03:24:00,17937.75,SELL,3,0.05h,Break Even,$-1.50,$-31.50,$54495.50,35,$-31.50
2024-02-16,03:40:00,17939.0,BUY,3,0.03h,Stop Loss,$-9.00,$-40.50,$54486.50,35,$-40.50
2024-02-16,04:51:00,17943.75,SELL,3,0.02h,Stop Loss,$-9.00,$-49.50,$54477.50,35,$-49.50
2024-02-16,05:07:00,17946.0,BUY,3,0.02h,Stop Loss,$-9.00,$-58.50,$54468.50,35,$-58.50
2024-02-16,05:24:00,17943.5,SELL,3,0.02h,Break Even,$-1.50,$-60.00,$54467.00,35,$-60.00
2024-02-16,06:12:00,17938.25,BUY,3,0.02h,Stop Loss,$-9.00,$-69.00,$54458.00,35,$-69.00
2024-02-16,06:23:00,17934.25,SELL,3,0.02h,Break Even,$-1.50,$-70.50,$54456.50,35,$-70.50
2024-02-16,06:28:00,17940.0,BUY,3,0.02h,Stop Loss,$-9.00,$-79.50,$54447.50,35,$-79.50
2024-02-16,09:07:00,18004.5,SELL,3,0.02h,Break Even,$-1.50,$-81.00,$54446.00,35,$-81.00
2024-02-16,09:25:00,18003.75,BUY,3,0.02h,Stop Loss,$7.50,$-73.50,$54453.50,35,$-73.50
2024-02-16,09:54:00,18006.5,SELL,3,0.02h,Stop Loss,$-9.00,$-82.50,$54444.50,35,$-82.50
2024-02-16,10:03:00,18013.75,BUY,3,0.02h,Break Even,$-1.50,$-84.00,$54443.00,35,$-84.00
2024-02-16,10:35:00,18016.75,SELL,3,0.02h,Stop Loss,$-9.00,$-93.00,$54434.00,35,$-93.00
2024-02-16,10:39:00,18021.75,BUY,3,0.02h,Stop Loss,$-9.00,$-102.00,$54425.00,35,$-102.00
2024-02-16,10:54:00,18017.75,SELL,3,0.02h,Stop Loss,$-9.00,$-111.00,$54416.00,35,$-111.00
2024-02-16,11:11:00,18020.25,BUY,3,0.02h,Stop Loss,$6.00,$-105.00,$54422.00,35,$-105.00
2024-02-16,11:20:00,18018.25,SELL,3,0.02h,Break Even,$-1.50,$-106.50,$54420.50,35,$-106.50
2024-02-16,11:39:00,18019.5,BUY,3,0.02h,Stop Loss,$-9.00,$-115.50,$54411.50,35,$-115.50
2024-02-16,11:49:00,18012.75,SELL,3,0.02h,Break Even,$-1.50,$-117.00,$54410.00,35,$-117.00
2024-02-16,12:48:00,18007.75,BUY,3,0.02h,Stop Loss,$-9.00,$-126.00,$54401.00,35,$-126.00
2024-02-16,12:54:00,18000.75,SELL,3,0.02h,Break Even,$-1.50,$-127.50,$54399.50,35,$-127.50
2024-02-16,13:03:00,18006.25,BUY,3,0.02h,Break Even,$-1.50,$-129.00,$54398.00,35,$-129.00
2024-02-16,13:06:00,17996.25,SELL,3,0.02h,Break Even,$-1.50,$-130.50,$54396.50,35,$-130.50
2024-02-16,13:11:00,18003.5,BUY,3,0.02h,Break Even,$-1.50,$-132.00,$54395.00,35,$-132.00
2024-02-16,13:22:00,17997.5,SELL,3,0.02h,Break Even,$-1.50,$-133.50,$54393.50,35,$-133.50
2024-02-16,14:01:00,17944.75,BUY,3,0.02h,Stop Loss,$-9.00,$-142.50,$54384.50,35,$-142.50
2024-02-16,14:19:00,17933.25,SELL,3,0.02h,Break Even,$-1.50,$-144.00,$54383.00,35,$-144.00
2024-02-16,15:39:00,17789.5,BUY,3,0.02h,Stop Loss,$87.00,$-57.00,$54470.00,35,$-57.00
2024-02-16,16:50:00,17852.25,SELL,3,0.02h,Stop Loss,$30.00,$-27.00,$54500.00,35,$-27.00
2024-02-16,16:55:00,17866.25,BUY,3,0.02h,Stop Loss,$7.50,$-19.50,$54507.50,35,$-19.50
2024-02-16,17:11:00,17856.0,SELL,3,0.02h,Break Even,$-1.50,$-21.00,$54506.00,35,$-21.00
2024-02-16,17:26:00,17872.0,BUY,3,0.02h,Break Even,$-1.50,$-22.50,$54504.50,35,$-22.50
2024-02-16,17:39:00,17861.5,SELL,3,0.02h,Stop Loss,$-9.00,$-31.50,$54495.50,35,$-31.50
2024-02-16,18:26:00,17839.5,BUY,3,0.02h,Break Even,$-1.50,$-33.00,$54494.00,35,$-33.00
2024-02-16,19:29:00,17885.25,SELL,3,0.02h,Stop Loss,$-9.00,$-42.00,$54485.00,35,$-42.00
2024-02-16,20:25:00,17791.25,BUY,3,0.02h,Break Even,$-1.50,$-43.50,$54483.50,35,$-43.50
2024-02-16,20:34:00,17783.5,SELL,3,0.02h,Break Even,$-1.50,$-45.00,$54482.00,35,$-45.00
2024-02-16,20:35:00,17786.5,BUY,3,0.02h,Break Even,$-1.50,$-46.50,$54480.50,35,$-46.50
2024-02-16,20:36:00,17784.0,SELL,3,0.02h,Stop Loss,$9.00,$-37.50,$54489.50,35,$-37.50
,,,,,,,,,,,
2024-02-19,00:00:00,17777.5,BUY,3,0.02h,Stop Loss,$3.00,$3.00,$54492.50,36,$3.00
2024-02-19,01:18:00,17789.75,SELL,3,0.02h,Stop Loss,$-9.00,$-6.00,$54483.50,36,$-6.00
2024-02-19,01:53:00,17773.0,BUY,3,0.02h,Stop Loss,$-9.00,$-15.00,$54474.50,36,$-15.00
2024-02-19,02:00:00,17767.5,SELL,3,0.02h,Stop Loss,$-9.00,$-24.00,$54465.50,36,$-24.00
2024-02-19,02:02:00,17771.25,BUY,3,0.02h,Stop Loss,$-9.00,$-33.00,$54456.50,36,$-33.00
2024-02-19,02:03:00,17765.75,SELL,3,0.02h,Break Even,$-1.50,$-34.50,$54455.00,36,$-34.50
2024-02-19,02:21:00,17768.0,BUY,3,0.02h,Break Even,$-1.50,$-36.00,$54453.50,36,$-36.00
2024-02-19,02:58:00,17766.25,SELL,3,0.02h,Stop Loss,$4.50,$-31.50,$54458.00,36,$-31.50
2024-02-19,03:04:00,17772.5,BUY,3,0.02h,Stop Loss,$-9.00,$-40.50,$54449.00,36,$-40.50
2024-02-19,03:20:00,17771.75,SELL,3,0.02h,Break Even,$-1.50,$-42.00,$54447.50,36,$-42.00
2024-02-19,03:36:00,17772.25,BUY,3,0.02h,Stop Loss,$-9.00,$-51.00,$54438.50,36,$-51.00
2024-02-19,03:44:00,17767.75,SELL,3,0.02h,Stop Loss,$-9.00,$-60.00,$54429.50,36,$-60.00
2024-02-19,03:52:00,17772.25,BUY,3,0.02h,Stop Loss,$-9.00,$-69.00,$54420.50,36,$-69.00
2024-02-19,03:58:00,17768.25,SELL,3,0.02h,Stop Loss,$-9.00,$-78.00,$54411.50,36,$-78.00
2024-02-19,04:09:00,17770.75,BUY,3,0.02h,Stop Loss,$-9.00,$-87.00,$54402.50,36,$-87.00
2024-02-19,04:11:00,17768.0,SELL,3,0.02h,Stop Loss,$-9.00,$-96.00,$54393.50,36,$-96.00
2024-02-19,04:12:00,17770.0,BUY,3,0.10h,Stop Loss,$-9.00,$-105.00,$54384.50,36,$-105.00
2024-02-19,04:19:00,17767.5,SELL,3,0.02h,Stop Loss,$-9.00,$-114.00,$54375.50,36,$-114.00
2024-02-19,04:33:00,17771.0,BUY,3,0.05h,Break Even,$-1.50,$-115.50,$54374.00,36,$-115.50
2024-02-19,05:09:00,17776.0,SELL,3,0.02h,Stop Loss,$-9.00,$-124.50,$54365.00,36,$-124.50
2024-02-19,05:27:00,17782.5,BUY,3,0.02h,Break Even,$-1.50,$-126.00,$54363.50,36,$-126.00
2024-02-19,05:59:00,17782.5,SELL,3,0.03h,Stop Loss,$9.00,$-117.00,$54372.50,36,$-117.00
2024-02-19,06:19:00,17782.25,BUY,3,0.02h,Stop Loss,$-9.00,$-126.00,$54363.50,36,$-126.00
2024-02-19,06:21:00,17778.75,SELL,3,0.02h,Stop Loss,$-9.00,$-135.00,$54354.50,36,$-135.00
2024-02-19,06:29:00,17783.0,BUY,3,0.03h,Break Even,$-1.50,$-136.50,$54353.00,36,$-136.50
2024-02-19,06:49:00,17780.5,SELL,3,0.02h,Stop Loss,$-9.00,$-145.50,$54344.00,36,$-145.50
2024-02-19,06:54:00,17784.75,BUY,3,0.02h,Stop Loss,$-9.00,$-154.50,$54335.00,36,$-154.50
2024-02-19,06:57:00,17780.5,SELL,3,0.02h,Stop Loss,$-9.00,$-163.50,$54326.00,36,$-163.50
2024-02-19,06:58:00,17783.5,BUY,3,0.02h,Stop Loss,$-9.00,$-172.50,$54317.00,36,$-172.50
2024-02-19,06:59:00,17781.25,SELL,3,0.02h,Stop Loss,$-9.00,$-181.50,$54308.00,36,$-181.50
2024-02-19,07:44:00,17764.25,BUY,3,0.02h,Stop Loss,$-9.00,$-190.50,$54299.00,36,$-190.50
2024-02-19,07:50:00,17754.5,SELL,3,0.02h,Stop Loss,$-9.00,$-199.50,$54290.00,36,$-199.50
2024-02-19,08:01:00,17764.5,BUY,3,0.02h,Stop Loss,$15.00,$-184.50,$54305.00,36,$-184.50
2024-02-19,08:17:00,17757.5,SELL,3,0.02h,Break Even,$-1.50,$-186.00,$54303.50,36,$-186.00
2024-02-19,08:21:00,17764.25,BUY,3,0.02h,Stop Loss,$-9.00,$-195.00,$54294.50,36,$-195.00
2024-02-19,08:22:00,17754.75,SELL,3,0.02h,Break Even,$-1.50,$-196.50,$54293.00,36,$-196.50
2024-02-19,08:33:00,17764.5,BUY,3,0.02h,Stop Loss,$6.00,$-190.50,$54299.00,36,$-190.50
2024-02-19,09:32:00,17778.75,SELL,3,0.02h,Stop Loss,$-9.00,$-199.50,$54290.00,36,$-199.50
2024-02-19,09:33:00,17782.25,BUY,3,0.02h,Stop Loss,$-9.00,$-208.50,$54281.00,36,$-208.50
2024-02-19,09:34:00,17780.5,SELL,3,0.02h,Break Even,$-1.50,$-210.00,$54279.50,36,$-210.00
2024-02-19,09:55:00,17780.5,BUY,3,0.02h,Break Even,$-1.50,$-211.50,$54278.00,36,$-211.50
2024-02-19,10:21:00,17778.5,SELL,3,0.02h,Stop Loss,$4.50,$-207.00,$54282.50,36,$-207.00
2024-02-19,11:03:00,17775.25,BUY,3,0.02h,Stop Loss,$-9.00,$-216.00,$54273.50,36,$-216.00
2024-02-19,11:21:00,17771.0,SELL,3,0.02h,Break Even,$-1.50,$-217.50,$54272.00,36,$-217.50
2024-02-19,11:42:00,17774.0,BUY,3,0.03h,Break Even,$-1.50,$-219.00,$54270.50,36,$-219.00
2024-02-19,11:47:00,17768.75,SELL,3,0.02h,Break Even,$-1.50,$-220.50,$54269.00,36,$-220.50
2024-02-19,12:35:00,17763.75,BUY,3,0.02h,Stop Loss,$-9.00,$-229.50,$54260.00,36,$-229.50
2024-02-19,12:37:00,17759.25,SELL,3,0.02h,Stop Loss,$-9.00,$-238.50,$54251.00,36,$-238.50
2024-02-19,12:38:00,17762.5,BUY,3,0.02h,Break Even,$-1.50,$-240.00,$54249.50,36,$-240.00
2024-02-19,13:04:00,17759.5,SELL,3,0.02h,Stop Loss,$-9.00,$-249.00,$54240.50,36,$-249.00
2024-02-19,13:12:00,17766.25,BUY,3,0.02h,Break Even,$-1.50,$-250.50,$54239.00,36,$-250.50
2024-02-19,13:45:00,17775.75,SELL,3,0.02h,Break Even,$-1.50,$-252.00,$54237.50,36,$-252.00
2024-02-19,14:00:00,17778.25,BUY,3,0.02h,Break Even,$-1.50,$-253.50,$54236.00,36,$-253.50
2024-02-19,14:07:00,17776.25,SELL,3,0.03h,Break Even,$-1.50,$-255.00,$54234.50,36,$-255.00
2024-02-19,14:12:00,17780.25,BUY,3,0.02h,Stop Loss,$-9.00,$-264.00,$54225.50,36,$-264.00
2024-02-19,14:58:00,17793.25,SELL,3,0.02h,Break Even,$-1.50,$-265.50,$54224.00,36,$-265.50
2024-02-19,15:07:00,17798.25,BUY,3,0.02h,Stop Loss,$-9.00,$-274.50,$54215.00,36,$-274.50
2024-02-19,15:08:00,17792.25,SELL,3,0.02h,Break Even,$-1.50,$-276.00,$54213.50,36,$-276.00
2024-02-19,15:40:00,17785.5,BUY,3,0.02h,Stop Loss,$-9.00,$-285.00,$54204.50,36,$-285.00
2024-02-19,15:41:00,17783.25,SELL,3,0.02h,Break Even,$-1.50,$-286.50,$54203.00,36,$-286.50
2024-02-19,16:04:00,17783.5,BUY,3,0.02h,Stop Loss,$-9.00,$-295.50,$54194.00,36,$-295.50
2024-02-19,16:10:00,17775.25,SELL,3,0.02h,Break Even,$-1.50,$-297.00,$54192.50,36,$-297.00
2024-02-19,16:19:00,17783.75,BUY,3,0.03h,Break Even,$-1.50,$-298.50,$54191.00,36,$-298.50
2024-02-19,16:43:00,17780.25,SELL,3,0.02h,Break Even,$-1.50,$-300.00,$54189.50,36,$-300.00
2024-02-19,16:58:00,17784.25,BUY,3,0.02h,Break Even,$-1.50,$-301.50,$54188.00,36,$-301.50
2024-02-19,17:27:00,17783.25,SELL,3,0.03h,Stop Loss,$-9.00,$-310.50,$54179.00,36,$-310.50
2024-02-19,17:29:00,17784.0,BUY,3,0.02h,Break Even,$-1.50,$-312.00,$54177.50,36,$-312.00
2024-02-19,23:01:00,17785.0,SELL,3,0.02h,Stop Loss,$21.00,$-291.00,$54198.50,36,$-291.00
,,,,,,,,,,,
2024-02-20,00:57:00,17733.5,BUY,3,0.03h,Break Even,$-1.50,$-1.50,$54197.00,37,$-1.50
2024-02-20,01:35:00,17735.25,SELL,3,0.02h,Break Even,$-1.50,$-3.00,$54195.50,37,$-3.00
2024-02-20,02:43:00,17689.75,BUY,3,0.02h,Stop Loss,$-9.00,$-12.00,$54186.50,37,$-12.00
2024-02-20,02:49:00,17683.5,SELL,3,0.02h,Break Even,$-1.50,$-13.50,$54185.00,37,$-13.50
2024-02-20,03:31:00,17682.25,BUY,3,0.02h,Stop Loss,$3.00,$-10.50,$54188.00,37,$-10.50
2024-02-20,03:47:00,17679.5,SELL,3,0.02h,Stop Loss,$3.00,$-7.50,$54191.00,37,$-7.50
2024-02-20,03:57:00,17682.25,BUY,3,0.02h,Stop Loss,$-9.00,$-16.50,$54182.00,37,$-16.50
2024-02-20,03:59:00,17680.5,SELL,3,0.02h,Stop Loss,$-9.00,$-25.50,$54173.00,37,$-25.50
2024-02-20,04:00:00,17681.75,BUY,3,0.02h,Break Even,$-1.50,$-27.00,$54171.50,37,$-27.00
2024-02-20,04:03:00,17679.5,SELL,3,0.02h,Stop Loss,$-9.00,$-36.00,$54162.50,37,$-36.00
2024-02-20,04:08:00,17682.5,BUY,3,0.05h,Break Even,$-1.50,$-37.50,$54161.00,37,$-37.50
2024-02-20,04:27:00,17681.0,SELL,3,0.02h,Stop Loss,$15.00,$-22.50,$54176.00,37,$-22.50
2024-02-20,04:39:00,17684.25,BUY,3,0.03h,Stop Loss,$-9.00,$-31.50,$54167.00,37,$-31.50
2024-02-20,04:41:00,17681.5,SELL,3,0.02h,Break Even,$-1.50,$-33.00,$54165.50,37,$-33.00
2024-02-20,05:06:00,17683.0,BUY,3,0.02h,Stop Loss,$-9.00,$-42.00,$54156.50,37,$-42.00
2024-02-20,05:11:00,17680.75,SELL,3,0.02h,Stop Loss,$-9.00,$-51.00,$54147.50,37,$-51.00
2024-02-20,05:47:00,17681.75,BUY,3,0.02h,Break Even,$-1.50,$-52.50,$54146.00,37,$-52.50
2024-02-20,06:49:00,17702.0,SELL,3,0.02h,Break Even,$-1.50,$-54.00,$54144.50,37,$-54.00
2024-02-20,06:59:00,17706.5,BUY,3,0.02h,Stop Loss,$-9.00,$-63.00,$54135.50,37,$-63.00
2024-02-20,07:08:00,17701.5,SELL,3,0.02h,Stop Loss,$7.50,$-55.50,$54143.00,37,$-55.50
2024-02-20,07:12:00,17705.25,BUY,3,0.02h,Stop Loss,$6.00,$-49.50,$54149.00,37,$-49.50
2024-02-20,07:33:00,17711.25,SELL,3,0.02h,Break Even,$-1.50,$-51.00,$54147.50,37,$-51.00
2024-02-20,07:52:00,17714.5,BUY,3,0.02h,Break Even,$-1.50,$-52.50,$54146.00,37,$-52.50
2024-02-20,08:07:00,17706.25,SELL,3,0.02h,Break Even,$-1.50,$-54.00,$54144.50,37,$-54.00
2024-02-20,08:41:00,17677.25,BUY,3,0.02h,Break Even,$-1.50,$-55.50,$54143.00,37,$-55.50
2024-02-20,09:26:00,17673.25,SELL,3,0.02h,Stop Loss,$27.00,$-28.50,$54170.00,37,$-28.50
2024-02-20,09:57:00,17671.25,BUY,3,0.02h,Break Even,$-1.50,$-30.00,$54168.50,37,$-30.00
2024-02-20,10:00:00,17665.5,SELL,3,0.02h,Stop Loss,$66.00,$36.00,$54234.50,37,$36.00
2024-02-20,10:41:00,17639.0,BUY,3,0.02h,Stop Loss,$-9.00,$27.00,$54225.50,37,$27.00
2024-02-20,10:43:00,17631.25,SELL,3,0.02h,Stop Loss,$7.50,$34.50,$54233.00,37,$34.50
2024-02-20,10:47:00,17637.5,BUY,3,0.02h,Stop Loss,$-9.00,$25.50,$54224.00,37,$25.50
2024-02-20,10:49:00,17631.75,SELL,3,0.02h,Stop Loss,$-9.00,$16.50,$54215.00,37,$16.50
2024-02-20,10:50:00,17636.5,BUY,3,0.02h,Break Even,$-1.50,$15.00,$54213.50,37,$15.00
2024-02-20,10:52:00,17629.0,SELL,3,0.02h,Break Even,$-1.50,$13.50,$54212.00,37,$13.50
2024-02-20,11:15:00,17633.25,BUY,3,0.02h,Stop Loss,$-9.00,$4.50,$54203.00,37,$4.50
2024-02-20,12:46:00,17669.0,SELL,3,0.02h,Stop Loss,$-9.00,$-4.50,$54194.00,37,$-4.50
2024-02-20,13:00:00,17675.0,BUY,3,0.02h,Break Even,$-1.50,$-6.00,$54192.50,37,$-6.00
2024-02-20,13:06:00,17665.5,SELL,3,0.02h,Stop Loss,$-9.00,$-15.00,$54183.50,37,$-15.00
2024-02-20,13:07:00,17676.25,BUY,3,0.02h,Stop Loss,$-9.00,$-24.00,$54174.50,37,$-24.00
2024-02-20,13:09:00,17669.5,SELL,3,0.02h,Break Even,$-1.50,$-25.50,$54173.00,37,$-25.50
2024-02-20,13:12:00,17677.75,BUY,3,0.02h,Break Even,$-1.50,$-27.00,$54171.50,37,$-27.00
2024-02-20,13:21:00,17667.75,SELL,3,0.02h,Break Even,$-1.50,$-28.50,$54170.00,37,$-28.50
2024-02-20,13:41:00,17688.5,BUY,3,0.02h,Stop Loss,$18.00,$-10.50,$54188.00,37,$-10.50
2024-02-20,13:54:00,17676.0,SELL,3,0.02h,Stop Loss,$-9.00,$-19.50,$54179.00,37,$-19.50
2024-02-20,13:55:00,17682.5,BUY,3,0.02h,Stop Loss,$-9.00,$-28.50,$54170.00,37,$-28.50
2024-02-20,13:57:00,17676.25,SELL,3,0.02h,Stop Loss,$7.50,$-21.00,$54177.50,37,$-21.00
2024-02-20,14:16:00,17677.25,BUY,3,0.02h,Break Even,$-1.50,$-22.50,$54176.00,37,$-22.50
2024-02-20,14:23:00,17666.0,SELL,3,0.02h,Stop Loss,$-9.00,$-31.50,$54167.00,37,$-31.50
2024-02-20,14:32:00,17711.75,BUY,3,0.02h,Stop Loss,$52.50,$21.00,$54219.50,37,$21.00
2024-02-20,14:38:00,17641.0,SELL,3,0.02h,Stop Loss,$112.50,$133.50,$54332.00,37,$133.50
2024-02-20,15:45:00,17525.5,BUY,3,0.02h,Stop Loss,$55.50,$189.00,$54387.50,37,$189.00
2024-02-20,16:23:00,17562.5,SELL,3,0.02h,Stop Loss,$4.50,$193.50,$54392.00,37,$193.50
2024-02-20,16:26:00,17570.75,BUY,3,0.02h,Break Even,$-1.50,$192.00,$54390.50,37,$192.00
2024-02-20,16:27:00,17565.5,SELL,3,0.02h,Break Even,$-1.50,$190.50,$54389.00,37,$190.50
2024-02-20,16:29:00,17574.75,BUY,3,0.02h,Break Even,$-1.50,$189.00,$54387.50,37,$189.00
2024-02-20,16:32:00,17549.0,SELL,3,0.02h,Stop Loss,$16.50,$205.50,$54404.00,37,$205.50
2024-02-20,17:34:00,17489.75,BUY,3,0.02h,Stop Loss,$4.50,$210.00,$54408.50,37,$210.00
2024-02-20,17:39:00,17467.25,SELL,3,0.02h,Stop Loss,$67.50,$277.50,$54476.00,37,$277.50
2024-02-20,17:44:00,17491.25,BUY,3,0.02h,Stop Loss,$40.50,$318.00,$54516.50,37,$318.00
2024-02-20,18:08:00,17492.5,SELL,3,0.02h,Stop Loss,$-9.00,$309.00,$54507.50,37,$309.00
2024-02-20,18:09:00,17498.0,BUY,3,0.02h,Stop Loss,$13.50,$322.50,$54521.00,37,$322.50
2024-02-20,18:12:00,17492.5,SELL,3,0.02h,Break Even,$-1.50,$321.00,$54519.50,37,$321.00
2024-02-20,18:14:00,17502.5,BUY,3,0.02h,Break Even,$-1.50,$319.50,$54518.00,37,$319.50
2024-02-20,18:16:00,17490.5,SELL,3,0.02h,Stop Loss,$40.50,$360.00,$54558.50,37,$360.00
2024-02-20,18:20:00,17510.5,BUY,3,0.02h,Stop Loss,$28.50,$388.50,$54587.00,37,$388.50
2024-02-20,18:30:00,17492.75,SELL,3,0.02h,Stop Loss,$10.50,$399.00,$54597.50,37,$399.00
2024-02-20,18:43:00,17513.25,BUY,3,0.02h,Break Even,$-1.50,$397.50,$54596.00,37,$397.50
2024-02-20,19:18:00,17509.0,SELL,3,0.02h,Break Even,$-1.50,$396.00,$54594.50,37,$396.00
2024-02-20,19:20:00,17543.25,BUY,3,0.02h,Stop Loss,$-9.00,$387.00,$54585.50,37,$387.00
2024-02-20,19:25:00,17519.5,SELL,3,0.02h,Stop Loss,$39.00,$426.00,$54624.50,37,$426.00
2024-02-20,19:28:00,17533.75,BUY,3,0.02h,Stop Loss,$10.50,$436.50,$54635.00,37,$436.50
2024-02-20,20:33:00,17557.0,SELL,3,0.02h,Stop Loss,$130.50,$567.00,$54765.50,37,$567.00
2024-02-20,20:46:00,17584.0,BUY,3,0.02h,Stop Loss,$3.00,$570.00,$54768.50,37,$570.00
2024-02-20,21:12:00,17586.25,SELL,3,0.02h,Break Even,$-1.50,$568.50,$54767.00,37,$568.50
2024-02-20,21:27:00,17587.25,BUY,3,0.02h,Stop Loss,$-9.00,$559.50,$54758.00,37,$559.50
2024-02-20,21:55:00,17588.5,SELL,3,0.02h,Break Even,$-1.50,$558.00,$54756.50,37,$558.00
2024-02-20,23:19:00,17583.5,BUY,3,0.02h,Stop Loss,$15.00,$573.00,$54771.50,37,$573.00
2024-02-20,23:34:00,17579.75,SELL,3,0.02h,Stop Loss,$-9.00,$564.00,$54762.50,37,$564.00
,,,,,,,,,,,
2024-02-21,00:09:00,17574.25,BUY,3,0.02h,Stop Loss,$-9.00,$-9.00,$54753.50,38,$-9.00
2024-02-21,00:21:00,17568.5,SELL,3,0.02h,Stop Loss,$-9.00,$-18.00,$54744.50,38,$-18.00
2024-02-21,00:24:00,17577.5,BUY,3,0.02h,Break Even,$-1.50,$-19.50,$54743.00,38,$-19.50
2024-02-21,00:36:00,17572.5,SELL,3,0.03h,Break Even,$-1.50,$-21.00,$54741.50,38,$-21.00
2024-02-21,01:38:00,17553.75,BUY,3,0.02h,Break Even,$-1.50,$-22.50,$54740.00,38,$-22.50
2024-02-21,02:15:00,17560.25,SELL,3,0.02h,Stop Loss,$-9.00,$-31.50,$54731.00,38,$-31.50
2024-02-21,02:16:00,17563.75,BUY,3,0.02h,Break Even,$-1.50,$-33.00,$54729.50,38,$-33.00
2024-02-21,02:22:00,17559.5,SELL,3,0.02h,Break Even,$-1.50,$-34.50,$54728.00,38,$-34.50
2024-02-21,02:49:00,17557.75,BUY,3,0.02h,Stop Loss,$-9.00,$-43.50,$54719.00,38,$-43.50
2024-02-21,02:52:00,17552.75,SELL,3,0.02h,Break Even,$-1.50,$-45.00,$54717.50,38,$-45.00
2024-02-21,03:12:00,17555.75,BUY,3,0.05h,Break Even,$-1.50,$-46.50,$54716.00,38,$-46.50
2024-02-21,03:18:00,17553.5,SELL,3,0.02h,Stop Loss,$-9.00,$-55.50,$54707.00,38,$-55.50
2024-02-21,03:19:00,17555.25,BUY,3,0.02h,Stop Loss,$-9.00,$-64.50,$54698.00,38,$-64.50
2024-02-21,03:20:00,17554.0,SELL,3,0.03h,Break Even,$-1.50,$-66.00,$54696.50,38,$-66.00
2024-02-21,03:39:00,17553.0,BUY,3,0.02h,Stop Loss,$-9.00,$-75.00,$54687.50,38,$-75.00
2024-02-21,04:37:00,17560.5,SELL,3,0.02h,Stop Loss,$-9.00,$-84.00,$54678.50,38,$-84.00
2024-02-21,05:06:00,17559.75,BUY,3,0.02h,Stop Loss,$-9.00,$-93.00,$54669.50,38,$-93.00
2024-02-21,05:08:00,17556.75,SELL,3,0.02h,Stop Loss,$-9.00,$-102.00,$54660.50,38,$-102.00
2024-02-21,05:32:00,17560.75,BUY,3,0.02h,Stop Loss,$-9.00,$-111.00,$54651.50,38,$-111.00
2024-02-21,06:16:00,17556.0,SELL,3,0.02h,Stop Loss,$-9.00,$-120.00,$54642.50,38,$-120.00
2024-02-21,06:37:00,17567.75,BUY,3,0.02h,Stop Loss,$-9.00,$-129.00,$54633.50,38,$-129.00
2024-02-21,07:10:00,17565.0,SELL,3,0.02h,Break Even,$-1.50,$-130.50,$54632.00,38,$-130.50
2024-02-21,07:22:00,17570.0,BUY,3,0.02h,Break Even,$-1.50,$-132.00,$54630.50,38,$-132.00
2024-02-21,08:00:00,17576.25,SELL,3,0.02h,Break Even,$-1.50,$-133.50,$54629.00,38,$-133.50
2024-02-21,09:13:00,17530.25,BUY,3,0.02h,Stop Loss,$-9.00,$-142.50,$54620.00,38,$-142.50
2024-02-21,09:14:00,17523.5,SELL,3,0.02h,Break Even,$-1.50,$-144.00,$54618.50,38,$-144.00
2024-02-21,09:21:00,17532.5,BUY,3,0.02h,Break Even,$-1.50,$-145.50,$54617.00,38,$-145.50
2024-02-21,09:29:00,17524.75,SELL,3,0.02h,Stop Loss,$-9.00,$-154.50,$54608.00,38,$-154.50
2024-02-21,09:35:00,17531.75,BUY,3,0.02h,Stop Loss,$-9.00,$-163.50,$54599.00,38,$-163.50
2024-02-21,09:51:00,17523.25,SELL,3,0.02h,Stop Loss,$-9.00,$-172.50,$54590.00,38,$-172.50
2024-02-21,10:03:00,17531.5,BUY,3,0.02h,Break Even,$-1.50,$-174.00,$54588.50,38,$-174.00
2024-02-21,10:10:00,17527.0,SELL,3,0.02h,Stop Loss,$-9.00,$-183.00,$54579.50,38,$-183.00
2024-02-21,10:13:00,17531.75,BUY,3,0.02h,Break Even,$-1.50,$-184.50,$54578.00,38,$-184.50
2024-02-21,10:35:00,17536.0,SELL,3,0.02h,Break Even,$-1.50,$-186.00,$54576.50,38,$-186.00
2024-02-21,10:52:00,17544.0,BUY,3,0.02h,Stop Loss,$-9.00,$-195.00,$54567.50,38,$-195.00
2024-02-21,11:06:00,17535.5,SELL,3,0.02h,Stop Loss,$-9.00,$-204.00,$54558.50,38,$-204.00
2024-02-21,11:42:00,17530.5,BUY,3,0.02h,Break Even,$-1.50,$-205.50,$54557.00,38,$-205.50
2024-02-21,11:45:00,17518.0,SELL,3,0.02h,Stop Loss,$-9.00,$-214.50,$54548.00,38,$-214.50
2024-02-21,11:54:00,17526.5,BUY,3,0.02h,Break Even,$-1.50,$-216.00,$54546.50,38,$-216.00
2024-02-21,12:02:00,17518.75,SELL,3,0.02h,Break Even,$-1.50,$-217.50,$54545.00,38,$-217.50
2024-02-21,12:15:00,17527.5,BUY,3,0.02h,Stop Loss,$4.50,$-213.00,$54549.50,38,$-213.00
2024-02-21,12:33:00,17515.25,SELL,3,0.02h,Stop Loss,$-9.00,$-222.00,$54540.50,38,$-222.00
2024-02-21,13:06:00,17507.5,BUY,3,0.02h,Stop Loss,$-9.00,$-231.00,$54531.50,38,$-231.00
2024-02-21,13:14:00,17496.0,SELL,3,0.02h,Break Even,$-1.50,$-232.50,$54530.00,38,$-232.50
2024-02-21,13:20:00,17500.75,BUY,3,0.02h,Stop Loss,$-9.00,$-241.50,$54521.00,38,$-241.50
2024-02-21,13:21:00,17497.0,SELL,3,0.02h,Stop Loss,$13.50,$-228.00,$54534.50,38,$-228.00
2024-02-21,13:40:00,17500.0,BUY,3,0.02h,Break Even,$-1.50,$-229.50,$54533.00,38,$-229.50
2024-02-21,14:18:00,17498.75,SELL,3,0.02h,Stop Loss,$-9.00,$-238.50,$54524.00,38,$-238.50
2024-02-21,14:40:00,17500.0,BUY,3,0.02h,Stop Loss,$7.50,$-231.00,$54531.50,38,$-231.00
2024-02-21,14:41:00,17494.5,SELL,3,0.02h,Stop Loss,$90.00,$-141.00,$54621.50,38,$-141.00
2024-02-21,15:04:00,17501.0,BUY,3,0.02h,Stop Loss,$127.50,$-13.50,$54749.00,38,$-13.50
2024-02-21,15:27:00,17476.75,SELL,3,0.02h,Break Even,$-1.50,$-15.00,$54747.50,38,$-15.00
2024-02-21,15:59:00,17478.5,BUY,3,0.02h,Break Even,$-1.50,$-16.50,$54746.00,38,$-16.50
2024-02-21,16:00:00,17469.25,SELL,3,0.02h,Break Even,$-1.50,$-18.00,$54744.50,38,$-18.00
2024-02-21,16:02:00,17485.5,BUY,3,0.02h,Break Even,$-1.50,$-19.50,$54743.00,38,$-19.50
2024-02-21,16:30:00,17490.0,SELL,3,0.02h,Stop Loss,$3.00,$-16.50,$54746.00,38,$-16.50
2024-02-21,16:52:00,17497.0,BUY,3,0.02h,Stop Loss,$6.00,$-10.50,$54752.00,38,$-10.50
2024-02-21,17:05:00,17483.25,SELL,3,0.02h,Stop Loss,$124.50,$114.00,$54876.50,38,$114.00
2024-02-21,17:41:00,17455.25,BUY,3,0.02h,Stop Loss,$10.50,$124.50,$54887.00,38,$124.50
2024-02-21,17:44:00,17448.0,SELL,3,0.02h,Stop Loss,$55.50,$180.00,$54942.50,38,$180.00
2024-02-21,17:47:00,17459.25,BUY,3,0.02h,Break Even,$-1.50,$178.50,$54941.00,38,$178.50
2024-02-21,18:03:00,17431.0,SELL,3,0.02h,Stop Loss,$-9.00,$169.50,$54932.00,38,$169.50
2024-02-21,18:12:00,17469.0,BUY,3,0.02h,Stop Loss,$24.00,$193.50,$54956.00,38,$193.50
2024-02-21,18:28:00,17460.5,SELL,3,0.02h,Stop Loss,$25.50,$219.00,$54981.50,38,$219.00
2024-02-21,18:46:00,17468.0,BUY,3,0.02h,Stop Loss,$-9.00,$210.00,$54972.50,38,$210.00
2024-02-21,18:48:00,17459.75,SELL,3,0.02h,Stop Loss,$13.50,$223.50,$54986.00,38,$223.50
2024-02-21,18:51:00,17463.5,BUY,3,0.02h,Stop Loss,$-9.00,$214.50,$54977.00,38,$214.50
2024-02-21,18:52:00,17458.5,SELL,3,0.02h,Stop Loss,$3.00,$217.50,$54980.00,38,$217.50
2024-02-21,19:07:00,17462.5,BUY,3,0.02h,Stop Loss,$28.50,$246.00,$55008.50,38,$246.00
2024-02-21,19:17:00,17455.75,SELL,3,0.02h,Stop Loss,$22.50,$268.50,$55031.00,38,$268.50
2024-02-21,19:18:00,17466.75,BUY,3,0.02h,Stop Loss,$3.00,$271.50,$55034.00,38,$271.50
2024-02-21,19:19:00,17455.75,SELL,3,0.02h,Stop Loss,$60.00,$331.50,$55094.00,38,$331.50
2024-02-21,19:57:00,17409.0,BUY,3,0.02h,Stop Loss,$-9.00,$322.50,$55085.00,38,$322.50
2024-02-21,20:08:00,17394.75,SELL,3,0.02h,Break Even,$-1.50,$321.00,$55083.50,38,$321.00
2024-02-21,20:19:00,17408.75,BUY,3,0.02h,Stop Loss,$-9.00,$312.00,$55074.50,38,$312.00
2024-02-21,20:22:00,17388.75,SELL,3,0.02h,Break Even,$-1.50,$310.50,$55073.00,38,$310.50
2024-02-21,20:25:00,17401.5,BUY,3,0.02h,Stop Loss,$48.00,$358.50,$55121.00,38,$358.50
2024-02-21,21:22:00,17426.0,SELL,3,0.02h,Stop Loss,$9.00,$367.50,$55130.00,38,$367.50
2024-02-21,21:27:00,17544.0,BUY,3,0.02h,Stop Loss,$103.50,$471.00,$55233.50,38,$471.00
2024-02-21,23:37:00,17692.0,SELL,3,0.02h,Stop Loss,$7.50,$478.50,$55241.00,38,$478.50
2024-02-21,23:47:00,17698.25,BUY,3,0.02h,Break Even,$-1.50,$477.00,$55239.50,38,$477.00
,,,,,,,,,,,
2024-02-22,01:42:00,17781.0,SELL,3,0.02h,Break Even,$-1.50,$-1.50,$55238.00,39,$-1.50
2024-02-22,02:26:00,17772.5,BUY,3,0.02h,Break Even,$-1.50,$-3.00,$55236.50,39,$-3.00
2024-02-22,03:25:00,17789.0,SELL,3,0.02h,Stop Loss,$-9.00,$-12.00,$55227.50,39,$-12.00
2024-02-22,04:05:00,17790.0,BUY,3,0.02h,Stop Loss,$-9.00,$-21.00,$55218.50,39,$-21.00
2024-02-22,05:07:00,17793.75,SELL,3,0.02h,Stop Loss,$-9.00,$-30.00,$55209.50,39,$-30.00
2024-02-22,05:18:00,17796.25,BUY,3,0.02h,Break Even,$-1.50,$-31.50,$55208.00,39,$-31.50
2024-02-22,05:33:00,17794.75,SELL,3,0.02h,Break Even,$-1.50,$-33.00,$55206.50,39,$-33.00
2024-02-22,05:37:00,17801.0,BUY,3,0.02h,Break Even,$-1.50,$-34.50,$55205.00,39,$-34.50
2024-02-22,05:53:00,17790.5,SELL,3,0.02h,Stop Loss,$-9.00,$-43.50,$55196.00,39,$-43.50
2024-02-22,06:16:00,17796.5,BUY,3,0.02h,Stop Loss,$-9.00,$-52.50,$55187.00,39,$-52.50
2024-02-22,07:14:00,17817.75,SELL,3,0.02h,Stop Loss,$-9.00,$-61.50,$55178.00,39,$-61.50
2024-02-22,07:39:00,17820.75,BUY,3,0.02h,Break Even,$-1.50,$-63.00,$55176.50,39,$-63.00
2024-02-22,09:03:00,17877.0,SELL,3,0.02h,Stop Loss,$64.50,$1.50,$55241.00,39,$1.50
2024-02-22,09:12:00,17891.0,BUY,3,0.02h,Stop Loss,$-9.00,$-7.50,$55232.00,39,$-7.50
2024-02-22,09:15:00,17881.25,SELL,3,0.02h,Stop Loss,$18.00,$10.50,$55250.00,39,$10.50
2024-02-22,09:39:00,17877.5,BUY,3,0.02h,Break Even,$-1.50,$9.00,$55248.50,39,$9.00
2024-02-22,10:18:00,17880.25,SELL,3,0.02h,Break Even,$-1.50,$7.50,$55247.00,39,$7.50
2024-02-22,10:34:00,17883.25,BUY,3,0.02h,Break Even,$-1.50,$6.00,$55245.50,39,$6.00
2024-02-22,11:02:00,17880.5,SELL,3,0.02h,Stop Loss,$-9.00,$-3.00,$55236.50,39,$-3.00
2024-02-22,11:14:00,17890.75,BUY,3,0.02h,Stop Loss,$7.50,$4.50,$55244.00,39,$4.50
2024-02-22,11:57:00,17906.75,SELL,3,0.02h,Stop Loss,$-9.00,$-4.50,$55235.00,39,$-4.50
2024-02-22,12:36:00,17900.75,BUY,3,0.02h,Break Even,$-1.50,$-6.00,$55233.50,39,$-6.00
2024-02-22,12:43:00,17894.75,SELL,3,0.02h,Stop Loss,$-9.00,$-15.00,$55224.50,39,$-15.00
2024-02-22,12:44:00,17896.25,BUY,3,0.02h,Stop Loss,$-9.00,$-24.00,$55215.50,39,$-24.00
2024-02-22,12:45:00,17892.25,SELL,3,0.02h,Stop Loss,$-9.00,$-33.00,$55206.50,39,$-33.00
2024-02-22,13:13:00,17895.0,BUY,3,0.02h,Stop Loss,$25.50,$-7.50,$55232.00,39,$-7.50
2024-02-22,13:28:00,17891.25,SELL,3,0.02h,Break Even,$-1.50,$-9.00,$55230.50,39,$-9.00
2024-02-22,13:37:00,17900.25,BUY,3,0.02h,Stop Loss,$-9.00,$-18.00,$55221.50,39,$-18.00
2024-02-22,13:43:00,17889.25,SELL,3,0.02h,Stop Loss,$-9.00,$-27.00,$55212.50,39,$-27.00
2024-02-22,13:46:00,17898.75,BUY,3,0.02h,Stop Loss,$-9.00,$-36.00,$55203.50,39,$-36.00
2024-02-22,13:47:00,17893.0,SELL,3,0.02h,Break Even,$-1.50,$-37.50,$55202.00,39,$-37.50
2024-02-22,13:50:00,17897.75,BUY,3,0.02h,Stop Loss,$4.50,$-33.00,$55206.50,39,$-33.00
2024-02-22,14:04:00,17891.25,SELL,3,0.02h,Break Even,$-1.50,$-34.50,$55205.00,39,$-34.50
2024-02-22,14:30:00,17896.0,BUY,3,0.02h,Stop Loss,$120.00,$85.50,$55325.00,39,$85.50
2024-02-22,14:32:00,17870.75,SELL,3,0.02h,Stop Loss,$15.00,$100.50,$55340.00,39,$100.50
2024-02-22,14:33:00,17883.5,BUY,3,0.02h,Stop Loss,$25.50,$126.00,$55365.50,39,$126.00
2024-02-22,14:34:00,17868.5,SELL,3,0.02h,Stop Loss,$6.00,$132.00,$55371.50,39,$132.00
2024-02-22,14:40:00,17892.75,BUY,3,0.02h,Stop Loss,$66.00,$198.00,$55437.50,39,$198.00
2024-02-22,15:44:00,17936.0,SELL,3,0.02h,Stop Loss,$7.50,$205.50,$55445.00,39,$205.50
2024-02-22,16:07:00,17941.0,BUY,3,0.02h,Break Even,$-1.50,$204.00,$55443.50,39,$204.00
2024-02-22,16:49:00,17952.0,SELL,3,0.02h,Break Even,$-1.50,$202.50,$55442.00,39,$202.50
2024-02-22,17:07:00,17968.5,BUY,3,0.02h,Stop Loss,$-9.00,$193.50,$55433.00,39,$193.50
2024-02-22,19:36:00,18068.25,SELL,3,0.02h,Break Even,$-1.50,$192.00,$55431.50,39,$192.00
2024-02-22,20:06:00,18071.5,BUY,3,0.02h,Stop Loss,$19.50,$211.50,$55451.00,39,$211.50
2024-02-22,20:31:00,18058.25,SELL,3,0.02h,Stop Loss,$42.00,$253.50,$55493.00,39,$253.50
2024-02-22,20:40:00,18075.25,BUY,3,0.02h,Break Even,$-1.50,$252.00,$55491.50,39,$252.00
2024-02-22,20:48:00,18061.75,SELL,3,0.02h,Stop Loss,$4.50,$256.50,$55496.00,39,$256.50
2024-02-22,21:41:00,18020.25,BUY,3,0.03h,Break Even,$-1.50,$255.00,$55494.50,39,$255.00
2024-02-22,21:45:00,18018.25,SELL,3,0.02h,Break Even,$-1.50,$253.50,$55493.00,39,$253.50
2024-02-22,21:47:00,18020.75,BUY,3,0.02h,Stop Loss,$-9.00,$244.50,$55484.00,39,$244.50
2024-02-22,23:56:00,18040.5,SELL,3,0.02h,Stop Loss,$-9.00,$235.50,$55475.00,39,$235.50
,,,,,,,,,,,
2024-02-23,00:57:00,18029.75,BUY,3,0.03h,Stop Loss,$-9.00,$-9.00,$55466.00,40,$-9.00
2024-02-23,01:02:00,18022.75,SELL,3,0.02h,Stop Loss,$-9.00,$-18.00,$55457.00,40,$-18.00
2024-02-23,01:04:00,18030.25,BUY,3,0.03h,Break Even,$-1.50,$-19.50,$55455.50,40,$-19.50
2024-02-23,01:17:00,18026.75,SELL,3,0.02h,Stop Loss,$-9.00,$-28.50,$55446.50,40,$-28.50
2024-02-23,01:23:00,18030.5,BUY,3,0.03h,Stop Loss,$9.00,$-19.50,$55455.50,40,$-19.50
2024-02-23,01:56:00,18039.5,SELL,3,0.02h,Break Even,$-1.50,$-21.00,$55454.00,40,$-21.00
2024-02-23,02:04:00,18042.5,BUY,3,0.02h,Stop Loss,$-9.00,$-30.00,$55445.00,40,$-30.00
2024-02-23,02:19:00,18041.25,SELL,3,0.02h,Stop Loss,$-9.00,$-39.00,$55436.00,40,$-39.00
2024-02-23,02:21:00,18044.5,BUY,3,0.03h,Break Even,$-1.50,$-40.50,$55434.50,40,$-40.50
2024-02-23,02:32:00,18042.0,SELL,3,0.02h,Stop Loss,$-9.00,$-49.50,$55425.50,40,$-49.50
2024-02-23,02:38:00,18046.0,BUY,3,0.02h,Stop Loss,$-9.00,$-58.50,$55416.50,40,$-58.50
2024-02-23,02:53:00,18042.25,SELL,3,0.02h,Stop Loss,$-9.00,$-67.50,$55407.50,40,$-67.50
2024-02-23,03:18:00,18043.25,BUY,3,0.02h,Break Even,$-1.50,$-69.00,$55406.00,40,$-69.00
2024-02-23,03:50:00,18042.0,SELL,3,0.02h,Stop Loss,$-9.00,$-78.00,$55397.00,40,$-78.00
2024-02-23,04:16:00,18044.75,BUY,3,0.03h,Stop Loss,$-9.00,$-87.00,$55388.00,40,$-87.00
2024-02-23,05:05:00,18045.5,SELL,3,0.02h,Stop Loss,$-9.00,$-96.00,$55379.00,40,$-96.00
2024-02-23,05:11:00,18049.75,BUY,3,0.02h,Break Even,$-1.50,$-97.50,$55377.50,40,$-97.50
2024-02-23,05:34:00,18049.0,SELL,3,0.10h,Break Even,$-1.50,$-99.00,$55376.00,40,$-99.00
2024-02-23,06:00:00,18050.0,BUY,3,0.05h,Break Even,$-1.50,$-100.50,$55374.50,40,$-100.50
2024-02-23,06:24:00,18047.5,SELL,3,0.02h,Break Even,$-1.50,$-102.00,$55373.00,40,$-102.00
2024-02-23,06:57:00,18049.25,BUY,3,0.02h,Break Even,$-1.50,$-103.50,$55371.50,40,$-103.50
2024-02-23,07:01:00,18039.0,SELL,3,0.02h,Stop Loss,$-9.00,$-112.50,$55362.50,40,$-112.50
2024-02-23,07:21:00,18038.0,BUY,3,0.02h,Stop Loss,$-9.00,$-121.50,$55353.50,40,$-121.50
2024-02-23,07:22:00,18036.0,SELL,3,0.02h,Stop Loss,$-9.00,$-130.50,$55344.50,40,$-130.50
2024-02-23,07:23:00,18037.5,BUY,3,0.02h,Break Even,$-1.50,$-132.00,$55343.00,40,$-132.00
2024-02-23,07:25:00,18035.5,SELL,3,0.02h,Stop Loss,$-9.00,$-141.00,$55334.00,40,$-141.00
2024-02-23,07:34:00,18036.75,BUY,3,0.02h,Stop Loss,$-9.00,$-150.00,$55325.00,40,$-150.00
2024-02-23,07:40:00,18035.0,SELL,3,0.02h,Break Even,$-1.50,$-151.50,$55323.50,40,$-151.50
2024-02-23,07:46:00,18039.0,BUY,3,0.07h,Stop Loss,$15.00,$-136.50,$55338.50,40,$-136.50
2024-02-23,08:03:00,18039.5,SELL,3,0.02h,Stop Loss,$-9.00,$-145.50,$55329.50,40,$-145.50
2024-02-23,08:33:00,18034.5,BUY,3,0.02h,Stop Loss,$-9.00,$-154.50,$55320.50,40,$-154.50
2024-02-23,08:48:00,18028.0,SELL,3,0.02h,Break Even,$-1.50,$-156.00,$55319.00,40,$-156.00
2024-02-23,09:12:00,18024.75,BUY,3,0.02h,Stop Loss,$3.00,$-153.00,$55322.00,40,$-153.00
2024-02-23,09:17:00,18020.75,SELL,3,0.02h,Stop Loss,$-9.00,$-162.00,$55313.00,40,$-162.00
2024-02-23,09:51:00,18015.0,BUY,3,0.02h,Break Even,$-1.50,$-163.50,$55311.50,40,$-163.50
2024-02-23,10:08:00,18007.5,SELL,3,0.02h,Break Even,$-1.50,$-165.00,$55310.00,40,$-165.00
2024-02-23,10:20:00,18016.5,BUY,3,0.02h,Break Even,$-1.50,$-166.50,$55308.50,40,$-166.50
2024-02-23,11:01:00,18017.5,SELL,3,0.02h,Stop Loss,$-9.00,$-175.50,$55299.50,40,$-175.50
2024-02-23,11:06:00,18024.75,BUY,3,0.02h,Break Even,$-1.50,$-177.00,$55298.00,40,$-177.00
2024-02-23,11:32:00,18023.75,SELL,3,0.02h,Stop Loss,$-9.00,$-186.00,$55289.00,40,$-186.00
2024-02-23,11:34:00,18029.25,BUY,3,0.03h,Stop Loss,$-9.00,$-195.00,$55280.00,40,$-195.00
2024-02-23,12:12:00,18030.75,SELL,3,0.02h,Stop Loss,$-9.00,$-204.00,$55271.00,40,$-204.00
2024-02-23,12:28:00,18038.25,BUY,3,0.02h,Stop Loss,$-9.00,$-213.00,$55262.00,40,$-213.00
2024-02-23,12:47:00,18035.0,SELL,3,0.02h,Break Even,$-1.50,$-214.50,$55260.50,40,$-214.50
2024-02-23,12:50:00,18042.5,BUY,3,0.02h,Stop Loss,$-9.00,$-223.50,$55251.50,40,$-223.50
2024-02-23,13:03:00,18036.0,SELL,3,0.02h,Stop Loss,$-9.00,$-232.50,$55242.50,40,$-232.50
2024-02-23,13:07:00,18045.0,BUY,3,0.02h,Stop Loss,$-9.00,$-241.50,$55233.50,40,$-241.50
2024-02-23,14:51:00,18110.5,SELL,3,0.02h,Stop Loss,$27.00,$-214.50,$55260.50,40,$-214.50
2024-02-23,16:26:00,17996.75,BUY,3,0.02h,Stop Loss,$25.50,$-189.00,$55286.00,40,$-189.00
2024-02-23,17:20:00,18035.75,SELL,3,0.02h,Stop Loss,$-9.00,$-198.00,$55277.00,40,$-198.00
2024-02-23,17:48:00,18033.0,BUY,3,0.02h,Break Even,$-1.50,$-199.50,$55275.50,40,$-199.50
2024-02-23,18:39:00,18043.25,SELL,3,0.02h,Stop Loss,$-9.00,$-208.50,$55266.50,40,$-208.50
2024-02-23,19:37:00,18016.25,BUY,3,0.02h,Stop Loss,$3.00,$-205.50,$55269.50,40,$-205.50
2024-02-23,19:51:00,18007.0,SELL,3,0.02h,Stop Loss,$6.00,$-199.50,$55275.50,40,$-199.50
2024-02-23,19:53:00,18018.5,BUY,3,0.02h,Break Even,$-1.50,$-201.00,$55274.00,40,$-201.00
2024-02-23,20:08:00,18001.0,SELL,3,0.02h,Stop Loss,$39.00,$-162.00,$55313.00,40,$-162.00
2024-02-23,20:39:00,18001.5,BUY,3,0.02h,Stop Loss,$-9.00,$-171.00,$55304.00,40,$-171.00
2024-02-23,21:01:00,17977.25,SELL,3,0.02h,Break Even,$-1.50,$-172.50,$55302.50,40,$-172.50
2024-02-23,21:34:00,17969.75,BUY,3,0.02h,Stop Loss,$-9.00,$-181.50,$55293.50,40,$-181.50
2024-02-23,21:52:00,17968.25,SELL,3,0.03h,Break Even,$-1.50,$-183.00,$55292.00,40,$-183.00
,,,,,,,,,,,
2024-02-26,00:00:00,17982.5,BUY,3,0.02h,Break Even,$-1.50,$-1.50,$55290.50,41,$-1.50
2024-02-26,00:04:00,17963.75,SELL,3,0.02h,Break Even,$-1.50,$-3.00,$55289.00,41,$-3.00
2024-02-26,01:22:00,17942.75,BUY,3,0.02h,Stop Loss,$-9.00,$-12.00,$55280.00,41,$-12.00
2024-02-26,01:54:00,17944.25,SELL,3,0.02h,Break Even,$-1.50,$-13.50,$55278.50,41,$-13.50
2024-02-26,02:13:00,17949.75,BUY,3,0.03h,Break Even,$-1.50,$-15.00,$55277.00,41,$-15.00
2024-02-26,02:36:00,17949.0,SELL,3,0.03h,Stop Loss,$-9.00,$-24.00,$55268.00,41,$-24.00
2024-02-26,02:39:00,17952.75,BUY,3,0.02h,Break Even,$-1.50,$-25.50,$55266.50,41,$-25.50
2024-02-26,02:54:00,17946.75,SELL,3,0.02h,Stop Loss,$-9.00,$-34.50,$55257.50,41,$-34.50
2024-02-26,03:21:00,17950.0,BUY,3,0.02h,Stop Loss,$-9.00,$-43.50,$55248.50,41,$-43.50
2024-02-26,03:25:00,17947.25,SELL,3,0.02h,Stop Loss,$-9.00,$-52.50,$55239.50,41,$-52.50
2024-02-26,03:35:00,17950.75,BUY,3,0.02h,Stop Loss,$-9.00,$-61.50,$55230.50,41,$-61.50
2024-02-26,03:59:00,17948.25,SELL,3,0.03h,Stop Loss,$-9.00,$-70.50,$55221.50,41,$-70.50
2024-02-26,04:40:00,17948.25,BUY,3,0.02h,Stop Loss,$-9.00,$-79.50,$55212.50,41,$-79.50
2024-02-26,05:46:00,17955.5,SELL,3,0.02h,Break Even,$-1.50,$-81.00,$55211.00,41,$-81.00
2024-02-26,06:05:00,17957.5,BUY,3,0.02h,Stop Loss,$-9.00,$-90.00,$55202.00,41,$-90.00
2024-02-26,06:10:00,17951.75,SELL,3,0.02h,Stop Loss,$-9.00,$-99.00,$55193.00,41,$-99.00
2024-02-26,07:06:00,17942.0,BUY,3,0.02h,Stop Loss,$-9.00,$-108.00,$55184.00,41,$-108.00
2024-02-26,07:07:00,17936.5,SELL,3,0.02h,Stop Loss,$-9.00,$-117.00,$55175.00,41,$-117.00
2024-02-26,07:13:00,17942.0,BUY,3,0.02h,Break Even,$-1.50,$-118.50,$55173.50,41,$-118.50
2024-02-26,07:20:00,17932.75,SELL,3,0.02h,Break Even,$-1.50,$-120.00,$55172.00,41,$-120.00
2024-02-26,07:29:00,17943.75,BUY,3,0.02h,Break Even,$-1.50,$-121.50,$55170.50,41,$-121.50
2024-02-26,07:52:00,17939.0,SELL,3,0.02h,Stop Loss,$-9.00,$-130.50,$55161.50,41,$-130.50
2024-02-26,07:58:00,17947.75,BUY,3,0.02h,Stop Loss,$-9.00,$-139.50,$55152.50,41,$-139.50
2024-02-26,09:07:00,17961.5,SELL,3,0.02h,Stop Loss,$37.50,$-102.00,$55190.00,41,$-102.00
2024-02-26,09:23:00,17959.5,BUY,3,0.02h,Break Even,$-1.50,$-103.50,$55188.50,41,$-103.50
2024-02-26,10:25:00,17984.5,SELL,3,0.02h,Stop Loss,$-9.00,$-112.50,$55179.50,41,$-112.50
2024-02-26,10:26:00,17986.5,BUY,3,0.02h,Break Even,$-1.50,$-114.00,$55178.00,41,$-114.00
2024-02-26,10:56:00,17988.25,SELL,3,0.02h,Break Even,$-1.50,$-115.50,$55176.50,41,$-115.50
2024-02-26,11:16:00,17993.25,BUY,3,0.02h,Stop Loss,$4.50,$-111.00,$55181.00,41,$-111.00
2024-02-26,11:39:00,17996.0,SELL,3,0.02h,Break Even,$-1.50,$-112.50,$55179.50,41,$-112.50
2024-02-26,11:40:00,17998.0,BUY,3,0.02h,Break Even,$-1.50,$-114.00,$55178.00,41,$-114.00
2024-02-26,11:47:00,17993.5,SELL,3,0.02h,Stop Loss,$-9.00,$-123.00,$55169.00,41,$-123.00
2024-02-26,12:21:00,17990.0,BUY,3,0.02h,Stop Loss,$-9.00,$-132.00,$55160.00,41,$-132.00
2024-02-26,12:40:00,17983.25,SELL,3,0.02h,Break Even,$-1.50,$-133.50,$55158.50,41,$-133.50
2024-02-26,13:08:00,17987.25,BUY,3,0.02h,Break Even,$-1.50,$-135.00,$55157.00,41,$-135.00
2024-02-26,13:56:00,18013.25,SELL,3,0.02h,Break Even,$-1.50,$-136.50,$55155.50,41,$-136.50
2024-02-26,13:59:00,18016.75,BUY,3,0.02h,Stop Loss,$-9.00,$-145.50,$55146.50,41,$-145.50
2024-02-26,14:01:00,18012.75,SELL,3,0.02h,Stop Loss,$-9.00,$-154.50,$55137.50,41,$-154.50
2024-02-26,14:30:00,18017.0,BUY,3,0.02h,Stop Loss,$108.00,$-46.50,$55245.50,41,$-46.50
2024-02-26,14:45:00,17992.25,SELL,3,0.02h,Stop Loss,$18.00,$-28.50,$55263.50,41,$-28.50
2024-02-26,15:08:00,18006.75,BUY,3,0.02h,Stop Loss,$30.00,$1.50,$55293.50,41,$1.50
2024-02-26,15:58:00,18019.75,SELL,3,0.02h,Stop Loss,$-9.00,$-7.50,$55284.50,41,$-7.50
2024-02-26,16:32:00,18025.5,BUY,3,0.02h,Stop Loss,$9.00,$1.50,$55293.50,41,$1.50
2024-02-26,17:03:00,18020.0,SELL,3,0.02h,Stop Loss,$-9.00,$-7.50,$55284.50,41,$-7.50
2024-02-26,17:16:00,18037.0,BUY,3,0.02h,Break Even,$-1.50,$-9.00,$55283.00,41,$-9.00
2024-02-26,17:39:00,18037.25,SELL,3,0.02h,Break Even,$-1.50,$-10.50,$55281.50,41,$-10.50
2024-02-26,18:09:00,18035.5,BUY,3,0.02h,Break Even,$-1.50,$-12.00,$55280.00,41,$-12.00
2024-02-26,18:20:00,18015.5,SELL,3,0.02h,Stop Loss,$19.50,$7.50,$55299.50,41,$7.50
2024-02-26,18:58:00,18006.25,BUY,3,0.02h,Stop Loss,$15.00,$22.50,$55314.50,41,$22.50
2024-02-26,19:16:00,18009.75,SELL,3,0.02h,Stop Loss,$-9.00,$13.50,$55305.50,41,$13.50
2024-02-26,19:23:00,18025.75,BUY,3,0.02h,Stop Loss,$24.00,$37.50,$55329.50,41,$37.50
2024-02-26,19:43:00,18020.75,SELL,3,0.02h,Stop Loss,$19.50,$57.00,$55349.00,41,$57.00
2024-02-26,20:12:00,18024.75,BUY,3,0.02h,Stop Loss,$3.00,$60.00,$55352.00,41,$60.00
2024-02-26,20:21:00,18010.75,SELL,3,0.02h,Stop Loss,$-9.00,$51.00,$55343.00,41,$51.00
2024-02-26,23:12:00,17960.0,BUY,3,0.02h,Break Even,$-1.50,$49.50,$55341.50,41,$49.50
2024-02-26,23:59:00,17963.75,SELL,3,0.03h,Stop Loss,$6.00,$55.50,$55347.50,41,$55.50
,,,,,,,,,,,
2024-02-27,00:24:00,17958.0,BUY,3,0.02h,Stop Loss,$-9.00,$-9.00,$55338.50,42,$-9.00
2024-02-27,00:57:00,17957.0,SELL,3,0.02h,Stop Loss,$-9.00,$-18.00,$55329.50,42,$-18.00
2024-02-27,01:05:00,17962.5,BUY,3,0.02h,Stop Loss,$-9.00,$-27.00,$55320.50,42,$-27.00
2024-02-27,01:17:00,17957.0,SELL,3,0.02h,Break Even,$-1.50,$-28.50,$55319.00,42,$-28.50
2024-02-27,01:29:00,17960.75,BUY,3,0.02h,Stop Loss,$-9.00,$-37.50,$55310.00,42,$-37.50
2024-02-27,01:30:00,17958.75,SELL,3,0.02h,Stop Loss,$-9.00,$-46.50,$55301.00,42,$-46.50
2024-02-27,01:32:00,17961.5,BUY,3,0.02h,Stop Loss,$18.00,$-28.50,$55319.00,42,$-28.50
2024-02-27,01:42:00,17958.5,SELL,3,0.03h,Stop Loss,$-9.00,$-37.50,$55310.00,42,$-37.50
2024-02-27,01:45:00,17963.0,BUY,3,0.03h,Stop Loss,$-9.00,$-46.50,$55301.00,42,$-46.50
2024-02-27,01:50:00,17959.75,SELL,3,0.02h,Break Even,$-1.50,$-48.00,$55299.50,42,$-48.00
2024-02-27,01:59:00,17962.75,BUY,3,0.02h,Stop Loss,$-9.00,$-57.00,$55290.50,42,$-57.00
2024-02-27,02:17:00,17957.75,SELL,3,0.02h,Break Even,$-1.50,$-58.50,$55289.00,42,$-58.50
2024-02-27,03:21:00,17947.5,BUY,3,0.05h,Break Even,$-1.50,$-60.00,$55287.50,42,$-60.00
2024-02-27,04:08:00,17953.5,SELL,3,0.03h,Stop Loss,$-9.00,$-69.00,$55278.50,42,$-69.00
2024-02-27,04:37:00,17954.25,BUY,3,0.02h,Stop Loss,$-9.00,$-78.00,$55269.50,42,$-78.00
2024-02-27,05:03:00,17952.25,SELL,3,0.02h,Stop Loss,$-9.00,$-87.00,$55260.50,42,$-87.00
2024-02-27,05:07:00,17955.0,BUY,3,0.03h,Break Even,$-1.50,$-88.50,$55259.00,42,$-88.50
2024-02-27,05:21:00,17950.75,SELL,3,0.02h,Stop Loss,$-9.00,$-97.50,$55250.00,42,$-97.50
2024-02-27,06:29:00,17937.75,BUY,3,0.02h,Stop Loss,$-9.00,$-106.50,$55241.00,42,$-106.50
2024-02-27,06:31:00,17935.75,SELL,3,0.02h,Stop Loss,$-9.00,$-115.50,$55232.00,42,$-115.50
2024-02-27,06:32:00,17937.5,BUY,3,0.05h,Stop Loss,$15.00,$-100.50,$55247.00,42,$-100.50
2024-02-27,08:18:00,17973.25,SELL,3,0.02h,Break Even,$-1.50,$-102.00,$55245.50,42,$-102.00
2024-02-27,09:01:00,17970.5,BUY,3,0.02h,Stop Loss,$18.00,$-84.00,$55263.50,42,$-84.00
2024-02-27,10:18:00,18013.0,SELL,3,0.02h,Break Even,$-1.50,$-85.50,$55262.00,42,$-85.50
2024-02-27,10:52:00,18014.5,BUY,3,0.02h,Break Even,$-1.50,$-87.00,$55260.50,42,$-87.00
2024-02-27,11:07:00,18010.75,SELL,3,0.02h,Break Even,$-1.50,$-88.50,$55259.00,42,$-88.50
2024-02-27,11:43:00,18007.0,BUY,3,0.02h,Stop Loss,$-9.00,$-97.50,$55250.00,42,$-97.50
2024-02-27,11:50:00,18002.25,SELL,3,0.02h,Break Even,$-1.50,$-99.00,$55248.50,42,$-99.00
2024-02-27,11:56:00,18006.5,BUY,3,0.02h,Stop Loss,$-9.00,$-108.00,$55239.50,42,$-108.00
2024-02-27,11:57:00,18002.75,SELL,3,0.02h,Stop Loss,$-9.00,$-117.00,$55230.50,42,$-117.00
2024-02-27,11:59:00,18007.75,BUY,3,0.02h,Stop Loss,$-9.00,$-126.00,$55221.50,42,$-126.00
2024-02-27,12:55:00,18029.75,SELL,3,0.02h,Break Even,$-1.50,$-127.50,$55220.00,42,$-127.50
2024-02-27,13:37:00,18014.25,BUY,3,0.02h,Stop Loss,$-9.00,$-136.50,$55211.00,42,$-136.50
2024-02-27,14:10:00,18017.25,SELL,3,0.02h,Break Even,$-1.50,$-138.00,$55209.50,42,$-138.00
2024-02-27,15:00:00,17990.25,BUY,3,0.02h,Stop Loss,$145.50,$7.50,$55355.00,42,$7.50
2024-02-27,15:40:00,17998.25,SELL,3,0.02h,Stop Loss,$19.50,$27.00,$55374.50,42,$27.00
2024-02-27,15:49:00,18023.25,BUY,3,0.02h,Break Even,$-1.50,$25.50,$55373.00,42,$25.50
2024-02-27,16:05:00,18006.25,SELL,3,0.02h,Stop Loss,$57.00,$82.50,$55430.00,42,$82.50
2024-02-27,16:51:00,17992.0,BUY,3,0.02h,Stop Loss,$22.50,$105.00,$55452.50,42,$105.00
2024-02-27,17:18:00,17988.5,SELL,3,0.02h,Break Even,$-1.50,$103.50,$55451.00,42,$103.50
2024-02-27,18:13:00,17951.75,BUY,3,0.02h,Break Even,$-1.50,$102.00,$55449.50,42,$102.00
2024-02-27,18:30:00,17941.25,SELL,3,0.02h,Stop Loss,$7.50,$109.50,$55457.00,42,$109.50
2024-02-27,18:40:00,17952.5,BUY,3,0.02h,Break Even,$-1.50,$108.00,$55455.50,42,$108.00
2024-02-27,20:18:00,18017.5,SELL,3,0.02h,Stop Loss,$13.50,$121.50,$55469.00,42,$121.50
2024-02-27,20:25:00,18023.75,BUY,3,0.02h,Stop Loss,$-9.00,$112.50,$55460.00,42,$112.50
2024-02-27,20:33:00,18010.0,SELL,3,0.02h,Break Even,$-1.50,$111.00,$55458.50,42,$111.00
2024-02-27,20:49:00,18015.5,BUY,3,0.02h,Stop Loss,$4.50,$115.50,$55463.00,42,$115.50
2024-02-27,21:03:00,18010.5,SELL,3,0.02h,Break Even,$-1.50,$114.00,$55461.50,42,$114.00
2024-02-27,21:12:00,18016.25,BUY,3,0.02h,Break Even,$-1.50,$112.50,$55460.00,42,$112.50
2024-02-27,21:50:00,18020.5,SELL,3,0.02h,Stop Loss,$-9.00,$103.50,$55451.00,42,$103.50
,,,,,,,,,,,
2024-02-28,00:10:00,18008.0,BUY,3,0.02h,Stop Loss,$-9.00,$-9.00,$55442.00,43,$-9.00
2024-02-28,00:24:00,18006.75,SELL,3,0.02h,Stop Loss,$-9.00,$-18.00,$55433.00,43,$-18.00
2024-02-28,00:26:00,18008.0,BUY,3,0.02h,Stop Loss,$-9.00,$-27.00,$55424.00,43,$-27.00
2024-02-28,00:33:00,18006.5,SELL,3,0.02h,Break Even,$-1.50,$-28.50,$55422.50,43,$-28.50
2024-02-28,01:17:00,18007.75,BUY,3,0.02h,Stop Loss,$16.50,$-12.00,$55439.00,43,$-12.00
2024-02-28,01:36:00,18006.5,SELL,3,0.02h,Stop Loss,$-9.00,$-21.00,$55430.00,43,$-21.00
2024-02-28,01:44:00,18011.5,BUY,3,0.02h,Break Even,$-1.50,$-22.50,$55428.50,43,$-22.50
2024-02-28,02:06:00,18009.5,SELL,3,0.02h,Break Even,$-1.50,$-24.00,$55427.00,43,$-24.00
2024-02-28,02:19:00,18010.5,BUY,3,0.02h,Stop Loss,$-9.00,$-33.00,$55418.00,43,$-33.00
2024-02-28,02:43:00,18009.5,SELL,3,0.08h,Break Even,$-1.50,$-34.50,$55416.50,43,$-34.50
2024-02-28,03:00:00,18011.5,BUY,3,0.02h,Stop Loss,$-9.00,$-43.50,$55407.50,43,$-43.50
2024-02-28,03:09:00,18009.25,SELL,3,0.02h,Break Even,$-1.50,$-45.00,$55406.00,43,$-45.00
2024-02-28,03:24:00,18010.0,BUY,3,0.02h,Stop Loss,$-9.00,$-54.00,$55397.00,43,$-54.00
2024-02-28,04:10:00,18013.5,SELL,3,0.58h,Round Number,$78.00,$24.00,$55475.00,43,$24.00
2024-02-28,05:08:00,18004.0,BUY,3,0.02h,Stop Loss,$-9.00,$15.00,$55466.00,43,$15.00
2024-02-28,05:24:00,18000.75,SELL,3,0.02h,Stop Loss,$-9.00,$6.00,$55457.00,43,$6.00
2024-02-28,06:38:00,17992.25,BUY,3,0.03h,Stop Loss,$-9.00,$-3.00,$55448.00,43,$-3.00
2024-02-28,07:18:00,17993.5,SELL,3,0.02h,Break Even,$-1.50,$-4.50,$55446.50,43,$-4.50
2024-02-28,07:54:00,17980.75,BUY,3,0.02h,Stop Loss,$-9.00,$-13.50,$55437.50,43,$-13.50
2024-02-28,08:01:00,17972.75,SELL,3,0.02h,Stop Loss,$13.50,$0.00,$55451.00,43,$0.00
2024-02-28,08:06:00,17985.25,BUY,3,0.02h,Stop Loss,$-9.00,$-9.00,$55442.00,43,$-9.00
2024-02-28,08:16:00,17978.25,SELL,3,0.02h,Break Even,$-1.50,$-10.50,$55440.50,43,$-10.50
2024-02-28,09:07:00,17957.75,BUY,3,0.02h,Break Even,$-1.50,$-12.00,$55439.00,43,$-12.00
2024-02-28,09:17:00,17948.5,SELL,3,0.02h,Stop Loss,$-9.00,$-21.00,$55430.00,43,$-21.00
2024-02-28,10:23:00,17907.25,BUY,3,0.02h,Stop Loss,$15.00,$-6.00,$55445.00,43,$-6.00
2024-02-28,11:09:00,17934.5,SELL,3,0.02h,Break Even,$-1.50,$-7.50,$55443.50,43,$-7.50
2024-02-28,11:11:00,17938.5,BUY,3,0.02h,Stop Loss,$-9.00,$-16.50,$55434.50,43,$-16.50
2024-02-28,11:57:00,17946.0,SELL,3,0.02h,Stop Loss,$13.50,$-3.00,$55448.00,43,$-3.00
2024-02-28,12:02:00,17952.75,BUY,3,0.02h,Break Even,$-1.50,$-4.50,$55446.50,43,$-4.50
2024-02-28,12:13:00,17942.75,SELL,3,0.02h,Break Even,$-1.50,$-6.00,$55445.00,43,$-6.00
2024-02-28,12:28:00,17948.0,BUY,3,0.02h,Stop Loss,$-9.00,$-15.00,$55436.00,43,$-15.00
2024-02-28,12:30:00,17943.25,SELL,3,0.02h,Stop Loss,$-9.00,$-24.00,$55427.00,43,$-24.00
2024-02-28,12:31:00,17946.25,BUY,3,0.02h,Stop Loss,$-9.00,$-33.00,$55418.00,43,$-33.00
2024-02-28,12:32:00,17944.25,SELL,3,0.02h,Stop Loss,$-9.00,$-42.00,$55409.00,43,$-42.00
2024-02-28,12:33:00,17945.75,BUY,3,0.02h,Break Even,$-1.50,$-43.50,$55407.50,43,$-43.50
2024-02-28,12:41:00,17939.0,SELL,3,0.02h,Stop Loss,$-9.00,$-52.50,$55398.50,43,$-52.50
2024-02-28,13:10:00,17935.25,BUY,3,0.02h,Stop Loss,$-9.00,$-61.50,$55389.50,43,$-61.50
2024-02-28,13:12:00,17932.0,SELL,3,0.02h,Stop Loss,$4.50,$-57.00,$55394.00,43,$-57.00
2024-02-28,13:20:00,17937.0,BUY,3,0.02h,Stop Loss,$9.00,$-48.00,$55403.00,43,$-48.00
2024-02-28,13:42:00,17926.25,SELL,3,0.02h,Stop Loss,$25.50,$-22.50,$55428.50,43,$-22.50
2024-02-28,13:48:00,17944.5,BUY,3,0.02h,Stop Loss,$7.50,$-15.00,$55436.00,43,$-15.00
2024-02-28,13:54:00,17931.5,SELL,3,0.02h,Break Even,$-1.50,$-16.50,$55434.50,43,$-16.50
2024-02-28,14:00:00,17944.75,BUY,3,0.02h,Stop Loss,$-9.00,$-25.50,$55425.50,43,$-25.50
2024-02-28,14:05:00,17933.75,SELL,3,0.02h,Stop Loss,$15.00,$-10.50,$55440.50,43,$-10.50
2024-02-28,14:31:00,17937.0,BUY,3,0.02h,Stop Loss,$-9.00,$-19.50,$55431.50,43,$-19.50
2024-02-28,14:32:00,17924.5,SELL,3,0.02h,Stop Loss,$70.50,$51.00,$55502.00,43,$51.00
2024-02-28,14:37:00,17940.25,BUY,3,0.02h,Break Even,$-1.50,$49.50,$55500.50,43,$49.50
2024-02-28,14:46:00,17913.5,SELL,3,0.02h,Stop Loss,$12.00,$61.50,$55512.50,43,$61.50
2024-02-28,15:11:00,17914.75,BUY,3,0.02h,Stop Loss,$30.00,$91.50,$55542.50,43,$91.50
2024-02-28,15:27:00,17904.5,SELL,3,0.02h,Stop Loss,$75.00,$166.50,$55617.50,43,$166.50
2024-02-28,15:33:00,17918.25,BUY,3,0.02h,Break Even,$-1.50,$165.00,$55616.00,43,$165.00
2024-02-28,15:57:00,17916.0,SELL,3,0.02h,Break Even,$-1.50,$163.50,$55614.50,43,$163.50
2024-02-28,15:58:00,17923.0,BUY,3,0.02h,Stop Loss,$27.00,$190.50,$55641.50,43,$190.50
2024-02-28,17:01:00,17955.75,SELL,3,0.02h,Break Even,$-1.50,$189.00,$55640.00,43,$189.00
2024-02-28,17:55:00,17922.0,BUY,3,0.02h,Break Even,$-1.50,$187.50,$55638.50,43,$187.50
2024-02-28,18:01:00,17911.0,SELL,3,0.02h,Stop Loss,$-9.00,$178.50,$55629.50,43,$178.50
2024-02-28,18:17:00,17919.75,BUY,3,0.02h,Stop Loss,$19.50,$198.00,$55649.00,43,$198.00
2024-02-28,18:52:00,17934.5,SELL,3,0.02h,Stop Loss,$-9.00,$189.00,$55640.00,43,$189.00
2024-02-28,18:59:00,17945.75,BUY,3,0.02h,Stop Loss,$3.00,$192.00,$55643.00,43,$192.00
2024-02-28,19:07:00,17935.25,SELL,3,0.02h,Stop Loss,$15.00,$207.00,$55658.00,43,$207.00
2024-02-28,19:57:00,17915.5,BUY,3,0.02h,Stop Loss,$-9.00,$198.00,$55649.00,43,$198.00
2024-02-28,20:11:00,17899.5,SELL,3,0.02h,Break Even,$-1.50,$196.50,$55647.50,43,$196.50
2024-02-28,20:21:00,17909.5,BUY,3,0.02h,Stop Loss,$-9.00,$187.50,$55638.50,43,$187.50
2024-02-28,20:46:00,17906.0,SELL,3,0.02h,Stop Loss,$13.50,$201.00,$55652.00,43,$201.00
2024-02-28,21:01:00,17912.0,BUY,3,0.02h,Break Even,$-1.50,$199.50,$55650.50,43,$199.50
2024-02-28,21:02:00,17909.25,SELL,3,0.02h,Stop Loss,$91.50,$291.00,$55742.00,43,$291.00
2024-02-28,21:58:00,17864.5,BUY,3,0.02h,Stop Loss,$-9.00,$282.00,$55733.00,43,$282.00
2024-02-28,23:38:00,17873.0,SELL,3,0.02h,Stop Loss,$-9.00,$273.00,$55724.00,43,$273.00
2024-02-28,23:41:00,17874.75,BUY,3,0.02h,Stop Loss,$-9.00,$264.00,$55715.00,43,$264.00
2024-02-28,23:42:00,17873.5,SELL,3,0.03h,Stop Loss,$-9.00,$255.00,$55706.00,43,$255.00
2024-02-28,23:44:00,17875.75,BUY,3,0.02h,Stop Loss,$-9.00,$246.00,$55697.00,43,$246.00
2024-02-28,23:49:00,17873.0,SELL,3,0.02h,Stop Loss,$-9.00,$237.00,$55688.00,43,$237.00
,,,,,,,,,,,
2024-02-29,00:04:00,17874.25,BUY,3,0.02h,Break Even,$-1.50,$-1.50,$55686.50,44,$-1.50
2024-02-29,01:06:00,17896.75,SELL,3,0.02h,Stop Loss,$-9.00,$-10.50,$55677.50,44,$-10.50
2024-02-29,01:31:00,17898.0,BUY,3,0.02h,Stop Loss,$-9.00,$-19.50,$55668.50,44,$-19.50
2024-02-29,01:51:00,17895.25,SELL,3,0.02h,Stop Loss,$-9.00,$-28.50,$55659.50,44,$-28.50
2024-02-29,02:03:00,17900.25,BUY,3,0.05h,Break Even,$-1.50,$-30.00,$55658.00,44,$-30.00
2024-02-29,02:30:00,17901.25,SELL,3,0.02h,Round Number,$4.50,$-25.50,$55662.50,44,$-25.50
2024-02-29,02:51:00,17904.0,BUY,3,0.02h,Stop Loss,$-9.00,$-34.50,$55653.50,44,$-34.50
2024-02-29,03:16:00,17905.75,SELL,3,0.15h,Round Number,$31.50,$-3.00,$55685.00,44,$-3.00
2024-02-29,03:40:00,17905.75,BUY,3,0.07h,Break Even,$-1.50,$-4.50,$55683.50,44,$-4.50
2024-02-29,05:12:00,17922.0,SELL,3,0.02h,Stop Loss,$-9.00,$-13.50,$55674.50,44,$-13.50
2024-02-29,05:45:00,17921.75,BUY,3,0.02h,Break Even,$-1.50,$-15.00,$55673.00,44,$-15.00
2024-02-29,05:59:00,17918.5,SELL,3,0.03h,Break Even,$-1.50,$-16.50,$55671.50,44,$-16.50
2024-02-29,07:11:00,17911.5,BUY,3,0.02h,Stop Loss,$-9.00,$-25.50,$55662.50,44,$-25.50
2024-02-29,07:30:00,17905.5,SELL,3,0.02h,Stop Loss,$7.50,$-18.00,$55670.00,44,$-18.00
2024-02-29,07:44:00,17912.0,BUY,3,0.02h,Stop Loss,$-9.00,$-27.00,$55661.00,44,$-27.00
2024-02-29,07:47:00,17906.75,SELL,3,0.02h,Stop Loss,$-9.00,$-36.00,$55652.00,44,$-36.00
2024-02-29,07:48:00,17907.25,BUY,3,0.02h,Stop Loss,$-9.00,$-45.00,$55643.00,44,$-45.00
2024-02-29,07:49:00,17902.5,SELL,3,0.02h,Break Even,$-1.50,$-46.50,$55641.50,44,$-46.50
2024-02-29,08:40:00,17874.25,BUY,3,0.02h,Break Even,$-1.50,$-48.00,$55640.00,44,$-48.00
2024-02-29,08:50:00,17861.25,SELL,3,0.02h,Stop Loss,$-9.00,$-57.00,$55631.00,44,$-57.00
2024-02-29,08:57:00,17868.75,BUY,3,0.02h,Stop Loss,$12.00,$-45.00,$55643.00,44,$-45.00
2024-02-29,09:02:00,17860.75,SELL,3,0.02h,Stop Loss,$7.50,$-37.50,$55650.50,44,$-37.50
2024-02-29,09:23:00,17862.0,BUY,3,0.02h,Stop Loss,$12.00,$-25.50,$55662.50,44,$-25.50
2024-02-29,09:26:00,17854.75,SELL,3,0.02h,Stop Loss,$9.00,$-16.50,$55671.50,44,$-16.50
2024-02-29,09:36:00,17863.75,BUY,3,0.02h,Stop Loss,$25.50,$9.00,$55697.00,44,$9.00
2024-02-29,10:10:00,17865.5,SELL,3,0.02h,Stop Loss,$-9.00,$0.00,$55688.00,44,$0.00
2024-02-29,10:13:00,17872.25,BUY,3,0.02h,Stop Loss,$6.00,$6.00,$55694.00,44,$6.00
2024-02-29,10:35:00,17868.0,SELL,3,0.02h,Stop Loss,$-9.00,$-3.00,$55685.00,44,$-3.00
2024-02-29,10:57:00,17871.75,BUY,3,0.02h,Stop Loss,$-9.00,$-12.00,$55676.00,44,$-12.00
2024-02-29,11:00:00,17868.5,SELL,3,0.02h,Break Even,$-1.50,$-13.50,$55674.50,44,$-13.50
2024-02-29,11:04:00,17877.75,BUY,3,0.02h,Break Even,$-1.50,$-15.00,$55673.00,44,$-15.00
2024-02-29,11:31:00,17879.5,SELL,3,0.02h,Stop Loss,$-9.00,$-24.00,$55664.00,44,$-24.00
2024-02-29,11:50:00,17882.75,BUY,3,0.02h,Break Even,$-1.50,$-25.50,$55662.50,44,$-25.50
2024-02-29,12:05:00,17881.0,SELL,3,0.02h,Break Even,$-1.50,$-27.00,$55661.00,44,$-27.00
2024-02-29,12:57:00,17874.75,BUY,3,0.02h,Stop Loss,$-9.00,$-36.00,$55652.00,44,$-36.00
2024-02-29,13:03:00,17865.25,SELL,3,0.02h,Stop Loss,$-9.00,$-45.00,$55643.00,44,$-45.00
2024-02-29,13:06:00,17874.25,BUY,3,0.02h,Stop Loss,$7.50,$-37.50,$55650.50,44,$-37.50
2024-02-29,13:24:00,17866.0,SELL,3,0.02h,Stop Loss,$-9.00,$-46.50,$55641.50,44,$-46.50
2024-02-29,13:31:00,17936.5,BUY,3,0.02h,Stop Loss,$132.00,$85.50,$55773.50,44,$85.50
2024-02-29,15:11:00,18011.5,SELL,3,0.02h,Stop Loss,$54.00,$139.50,$55827.50,44,$139.50
2024-02-29,15:37:00,18022.5,BUY,3,0.02h,Stop Loss,$-9.00,$130.50,$55818.50,44,$130.50
2024-02-29,15:44:00,18005.25,SELL,3,0.02h,Break Even,$-1.50,$129.00,$55817.00,44,$129.00
2024-02-29,15:51:00,18025.25,BUY,3,0.02h,Stop Loss,$-9.00,$120.00,$55808.00,44,$120.00
2024-02-29,15:53:00,18016.0,SELL,3,0.02h,Stop Loss,$43.50,$163.50,$55851.50,44,$163.50
2024-02-29,16:16:00,18011.25,BUY,3,0.02h,Break Even,$-1.50,$162.00,$55850.00,44,$162.00
2024-02-29,16:23:00,17996.0,SELL,3,0.02h,Stop Loss,$4.50,$166.50,$55854.50,44,$166.50
2024-02-29,16:54:00,17970.25,BUY,3,0.02h,Stop Loss,$13.50,$180.00,$55868.00,44,$180.00
2024-02-29,17:29:00,17983.75,SELL,3,0.02h,Stop Loss,$67.50,$247.50,$55935.50,44,$247.50
2024-02-29,17:43:00,17987.25,BUY,3,0.02h,Break Even,$-1.50,$246.00,$55934.00,44,$246.00
2024-02-29,18:41:00,18031.25,SELL,3,0.02h,Stop Loss,$22.50,$268.50,$55956.50,44,$268.50
2024-02-29,18:53:00,18041.0,BUY,3,0.02h,Stop Loss,$-9.00,$259.50,$55947.50,44,$259.50
2024-02-29,19:06:00,18028.25,SELL,3,0.02h,Break Even,$-1.50,$258.00,$55946.00,44,$258.00
2024-02-29,19:12:00,18041.5,BUY,3,0.02h,Break Even,$-1.50,$256.50,$55944.50,44,$256.50
2024-02-29,19:27:00,18027.75,SELL,3,0.02h,Stop Loss,$10.50,$267.00,$55955.00,44,$267.00
2024-02-29,20:00:00,18037.0,BUY,3,0.02h,Stop Loss,$9.00,$276.00,$55964.00,44,$276.00
2024-02-29,21:05:00,18055.0,SELL,3,0.02h,Stop Loss,$94.50,$370.50,$56058.50,44,$370.50
2024-02-29,21:19:00,18066.25,BUY,3,0.02h,Break Even,$-1.50,$369.00,$56057.00,44,$369.00
2024-02-29,21:46:00,18067.0,SELL,3,0.02h,Stop Loss,$-9.00,$360.00,$56048.00,44,$360.00
2024-02-29,23:01:00,18078.25,BUY,3,0.02h,Stop Loss,$-9.00,$351.00,$56039.00,44,$351.00
2024-02-29,23:13:00,18071.25,SELL,3,0.05h,Break Even,$-1.50,$349.50,$56037.50,44,$349.50
2024-02-29,23:51:00,18061.5,BUY,3,0.02h,Stop Loss,$-9.00,$340.50,$56028.50,44,$340.50
,,,,,,,,,,,
2024-03-01,00:34:00,18067.75,SELL,3,0.02h,Stop Loss,$-9.00,$-9.00,$56019.50,45,$-9.00
2024-03-01,00:37:00,18072.5,BUY,3,0.02h,Stop Loss,$-9.00,$-18.00,$56010.50,45,$-18.00
2024-03-01,00:39:00,18067.5,SELL,3,0.02h,Stop Loss,$-9.00,$-27.00,$56001.50,45,$-27.00
2024-03-01,00:49:00,18070.25,BUY,3,0.02h,Break Even,$-1.50,$-28.50,$56000.00,45,$-28.50
2024-03-01,01:20:00,18076.0,SELL,3,0.02h,Stop Loss,$-9.00,$-37.50,$55991.00,45,$-37.50
2024-03-01,01:30:00,18077.75,BUY,3,0.02h,Stop Loss,$9.00,$-28.50,$56000.00,45,$-28.50
2024-03-01,03:23:00,18123.0,SELL,3,0.02h,Stop Loss,$-9.00,$-37.50,$55991.00,45,$-37.50
2024-03-01,03:28:00,18129.75,BUY,3,0.02h,Stop Loss,$-9.00,$-46.50,$55982.00,45,$-46.50
2024-03-01,03:32:00,18125.5,SELL,3,0.05h,Stop Loss,$-9.00,$-55.50,$55973.00,45,$-55.50
2024-03-01,03:52:00,18127.75,BUY,3,0.02h,Stop Loss,$-9.00,$-64.50,$55964.00,45,$-64.50
2024-03-01,04:10:00,18124.75,SELL,3,0.02h,Stop Loss,$-9.00,$-73.50,$55955.00,45,$-73.50
2024-03-01,05:15:00,18121.5,BUY,3,0.02h,Stop Loss,$-9.00,$-82.50,$55946.00,45,$-82.50
2024-03-01,05:33:00,18119.5,SELL,3,0.02h,Stop Loss,$-9.00,$-91.50,$55937.00,45,$-91.50
2024-03-01,05:41:00,18121.5,BUY,3,0.02h,Break Even,$-1.50,$-93.00,$55935.50,45,$-93.00
2024-03-01,06:36:00,18135.0,SELL,3,0.02h,Break Even,$-1.50,$-94.50,$55934.00,45,$-94.50
2024-03-01,06:46:00,18137.5,BUY,3,0.02h,Break Even,$-1.50,$-96.00,$55932.50,45,$-96.00
2024-03-01,07:53:00,18152.75,SELL,3,0.02h,Stop Loss,$-9.00,$-105.00,$55923.50,45,$-105.00
2024-03-01,09:11:00,18132.25,BUY,3,0.02h,Break Even,$-1.50,$-106.50,$55922.00,45,$-106.50
2024-03-01,09:52:00,18137.0,SELL,3,0.02h,Break Even,$-1.50,$-108.00,$55920.50,45,$-108.00
2024-03-01,10:41:00,18066.75,BUY,3,0.02h,Stop Loss,$-9.00,$-117.00,$55911.50,45,$-117.00
2024-03-01,10:54:00,18057.0,SELL,3,0.02h,Stop Loss,$9.00,$-108.00,$55920.50,45,$-108.00
2024-03-01,11:02:00,18072.25,BUY,3,0.02h,Break Even,$-1.50,$-109.50,$55919.00,45,$-109.50
2024-03-01,11:11:00,18062.0,SELL,3,0.02h,Break Even,$-1.50,$-111.00,$55917.50,45,$-111.00
2024-03-01,11:15:00,18072.75,BUY,3,0.02h,Break Even,$-1.50,$-112.50,$55916.00,45,$-112.50
2024-03-01,12:09:00,18082.25,SELL,3,0.02h,Stop Loss,$3.00,$-109.50,$55919.00,45,$-109.50
2024-03-01,12:18:00,18090.5,BUY,3,0.02h,Break Even,$-1.50,$-111.00,$55917.50,45,$-111.00
2024-03-01,12:23:00,18081.5,SELL,3,0.02h,Stop Loss,$19.50,$-91.50,$55937.00,45,$-91.50
2024-03-01,12:39:00,18088.75,BUY,3,0.02h,Break Even,$-1.50,$-93.00,$55935.50,45,$-93.00
2024-03-01,13:24:00,18093.25,SELL,3,0.02h,Stop Loss,$15.00,$-78.00,$55950.50,45,$-78.00
2024-03-01,13:32:00,18102.0,BUY,3,0.02h,Stop Loss,$-9.00,$-87.00,$55941.50,45,$-87.00
2024-03-01,13:33:00,18096.25,SELL,3,0.02h,Stop Loss,$-9.00,$-96.00,$55932.50,45,$-96.00
2024-03-01,13:50:00,18098.75,BUY,3,0.02h,Stop Loss,$-9.00,$-105.00,$55923.50,45,$-105.00
2024-03-01,13:55:00,18084.25,SELL,3,0.02h,Break Even,$-1.50,$-106.50,$55922.00,45,$-106.50
2024-03-01,14:17:00,18091.0,BUY,3,0.02h,Stop Loss,$-9.00,$-115.50,$55913.00,45,$-115.50
2024-03-01,15:33:00,18158.0,SELL,3,0.02h,Stop Loss,$9.00,$-106.50,$55922.00,45,$-106.50
2024-03-01,15:46:00,18182.25,BUY,3,0.02h,Stop Loss,$16.50,$-90.00,$55938.50,45,$-90.00
2024-03-01,16:36:00,18215.0,SELL,3,0.02h,Stop Loss,$-9.00,$-99.00,$55929.50,45,$-99.00
2024-03-01,16:38:00,18230.5,BUY,3,0.02h,Stop Loss,$-9.00,$-108.00,$55920.50,45,$-108.00
2024-03-01,17:04:00,18229.0,SELL,3,0.02h,Break Even,$-1.50,$-109.50,$55919.00,45,$-109.50
2024-03-01,17:13:00,18244.0,BUY,3,0.02h,Break Even,$-1.50,$-111.00,$55917.50,45,$-111.00
2024-03-01,19:35:00,18352.75,SELL,3,0.02h,Stop Loss,$37.50,$-73.50,$55955.00,45,$-73.50
2024-03-01,19:51:00,18360.75,BUY,3,0.02h,Break Even,$-1.50,$-75.00,$55953.50,45,$-75.00
2024-03-01,20:04:00,18346.25,SELL,3,0.02h,Break Even,$-1.50,$-76.50,$55952.00,45,$-76.50
2024-03-01,20:29:00,18346.0,BUY,3,0.02h,Stop Loss,$-9.00,$-85.50,$55943.00,45,$-85.50
2024-03-01,20:33:00,18333.5,SELL,3,0.02h,Stop Loss,$-9.00,$-94.50,$55934.00,45,$-94.50
2024-03-01,20:46:00,18344.5,BUY,3,0.02h,Break Even,$-1.50,$-96.00,$55932.50,45,$-96.00
2024-03-01,21:00:00,18335.0,SELL,3,0.02h,Stop Loss,$55.50,$-40.50,$55988.00,45,$-40.50
,,,,,,,,,,,
2024-03-04,00:00:00,18343.5,BUY,3,0.02h,Stop Loss,$-9.00,$-9.00,$55979.00,46,$-9.00
2024-03-04,00:50:00,18338.5,SELL,3,0.02h,Stop Loss,$-9.00,$-18.00,$55970.00,46,$-18.00
2024-03-04,00:51:00,18341.0,BUY,3,0.03h,Stop Loss,$4.50,$-13.50,$55974.50,46,$-13.50
2024-03-04,01:07:00,18338.25,SELL,3,0.02h,Stop Loss,$-9.00,$-22.50,$55965.50,46,$-22.50
2024-03-04,01:16:00,18341.5,BUY,3,0.05h,Break Even,$-1.50,$-24.00,$55964.00,46,$-24.00
2024-03-04,01:55:00,18343.25,SELL,3,0.02h,Stop Loss,$-9.00,$-33.00,$55955.00,46,$-33.00
2024-03-04,01:58:00,18349.25,BUY,3,0.02h,Stop Loss,$-9.00,$-42.00,$55946.00,46,$-42.00
2024-03-04,02:11:00,18343.5,SELL,3,0.02h,Stop Loss,$-9.00,$-51.00,$55937.00,46,$-51.00
2024-03-04,02:18:00,18349.0,BUY,3,0.02h,Break Even,$-1.50,$-52.50,$55935.50,46,$-52.50
2024-03-04,03:07:00,18354.75,SELL,3,0.03h,Break Even,$-1.50,$-54.00,$55934.00,46,$-54.00
2024-03-04,03:25:00,18356.0,BUY,3,0.02h,Stop Loss,$-9.00,$-63.00,$55925.00,46,$-63.00
2024-03-04,03:26:00,18353.75,SELL,3,0.02h,Stop Loss,$-9.00,$-72.00,$55916.00,46,$-72.00
2024-03-04,03:51:00,18353.75,BUY,3,0.02h,Stop Loss,$-9.00,$-81.00,$55907.00,46,$-81.00
2024-03-04,04:13:00,18351.75,SELL,3,0.02h,Stop Loss,$-9.00,$-90.00,$55898.00,46,$-90.00
2024-03-04,05:03:00,18349.75,BUY,3,0.05h,Stop Loss,$-9.00,$-99.00,$55889.00,46,$-99.00
2024-03-04,05:36:00,18349.0,SELL,3,0.02h,Stop Loss,$-9.00,$-108.00,$55880.00,46,$-108.00
2024-03-04,05:54:00,18351.0,BUY,3,0.02h,Stop Loss,$-9.00,$-117.00,$55871.00,46,$-117.00
2024-03-04,06:01:00,18344.0,SELL,3,0.02h,Stop Loss,$-9.00,$-126.00,$55862.00,46,$-126.00
2024-03-04,06:15:00,18351.25,BUY,3,0.02h,Stop Loss,$-9.00,$-135.00,$55853.00,46,$-135.00
2024-03-04,06:50:00,18350.75,SELL,3,0.03h,Break Even,$-1.50,$-136.50,$55851.50,46,$-136.50
2024-03-04,06:56:00,18352.75,BUY,3,0.02h,Stop Loss,$-9.00,$-145.50,$55842.50,46,$-145.50
2024-03-04,06:57:00,18349.25,SELL,3,0.02h,Stop Loss,$-9.00,$-154.50,$55833.50,46,$-154.50
2024-03-04,07:06:00,18356.25,BUY,3,0.02h,Stop Loss,$-9.00,$-163.50,$55824.50,46,$-163.50
2024-03-04,07:22:00,18354.75,SELL,3,0.02h,Stop Loss,$-9.00,$-172.50,$55815.50,46,$-172.50
2024-03-04,07:31:00,18357.25,BUY,3,0.02h,Stop Loss,$-9.00,$-181.50,$55806.50,46,$-181.50
2024-03-04,07:38:00,18351.75,SELL,3,0.02h,Stop Loss,$-9.00,$-190.50,$55797.50,46,$-190.50
2024-03-04,07:54:00,18355.5,BUY,3,0.03h,Break Even,$-1.50,$-192.00,$55796.00,46,$-192.00
2024-03-04,08:26:00,18357.75,SELL,3,0.02h,Stop Loss,$-9.00,$-201.00,$55787.00,46,$-201.00
2024-03-04,08:28:00,18363.75,BUY,3,0.02h,Break Even,$-1.50,$-202.50,$55785.50,46,$-202.50
2024-03-04,08:40:00,18359.75,SELL,3,0.02h,Break Even,$-1.50,$-204.00,$55784.00,46,$-204.00
2024-03-04,08:43:00,18363.25,BUY,3,0.02h,Stop Loss,$-9.00,$-213.00,$55775.00,46,$-213.00
2024-03-04,08:50:00,18358.75,SELL,3,0.02h,Stop Loss,$-9.00,$-222.00,$55766.00,46,$-222.00
2024-03-04,09:00:00,18364.5,BUY,3,0.02h,Break Even,$-1.50,$-223.50,$55764.50,46,$-223.50
2024-03-04,09:13:00,18351.5,SELL,3,0.02h,Stop Loss,$-9.00,$-232.50,$55755.50,46,$-232.50
2024-03-04,10:36:00,18330.75,BUY,3,0.02h,Break Even,$-1.50,$-234.00,$55754.00,46,$-234.00
2024-03-04,10:39:00,18326.0,SELL,3,0.02h,Stop Loss,$-9.00,$-243.00,$55745.00,46,$-243.00
2024-03-04,10:42:00,18330.5,BUY,3,0.02h,Stop Loss,$-9.00,$-252.00,$55736.00,46,$-252.00
2024-03-04,10:49:00,18326.25,SELL,3,0.02h,Stop Loss,$-9.00,$-261.00,$55727.00,46,$-261.00
2024-03-04,10:51:00,18329.25,BUY,3,0.02h,Stop Loss,$-9.00,$-270.00,$55718.00,46,$-270.00
2024-03-04,10:53:00,18325.75,SELL,3,0.02h,Stop Loss,$-9.00,$-279.00,$55709.00,46,$-279.00
2024-03-04,10:55:00,18329.75,BUY,3,0.03h,Stop Loss,$-9.00,$-288.00,$55700.00,46,$-288.00
2024-03-04,11:01:00,18325.0,SELL,3,0.02h,Stop Loss,$-9.00,$-297.00,$55691.00,46,$-297.00
2024-03-04,11:02:00,18330.5,BUY,3,0.02h,Stop Loss,$-9.00,$-306.00,$55682.00,46,$-306.00
2024-03-04,11:04:00,18325.5,SELL,3,0.02h,Break Even,$-1.50,$-307.50,$55680.50,46,$-307.50
2024-03-04,11:31:00,18325.0,BUY,3,0.02h,Stop Loss,$-9.00,$-316.50,$55671.50,46,$-316.50
2024-03-04,11:42:00,18320.25,SELL,3,0.02h,Stop Loss,$-9.00,$-325.50,$55662.50,46,$-325.50
2024-03-04,11:45:00,18325.75,BUY,3,0.02h,Break Even,$-1.50,$-327.00,$55661.00,46,$-327.00
2024-03-04,12:40:00,18339.25,SELL,3,0.02h,Stop Loss,$-9.00,$-336.00,$55652.00,46,$-336.00
2024-03-04,12:44:00,18348.25,BUY,3,0.02h,Stop Loss,$4.50,$-331.50,$55656.50,46,$-331.50
2024-03-04,12:53:00,18342.5,SELL,3,0.02h,Break Even,$-1.50,$-333.00,$55655.00,46,$-333.00
2024-03-04,13:13:00,18346.75,BUY,3,0.02h,Stop Loss,$-9.00,$-342.00,$55646.00,46,$-342.00
2024-03-04,13:27:00,18340.0,SELL,3,0.02h,Stop Loss,$21.00,$-321.00,$55667.00,46,$-321.00
2024-03-04,13:43:00,18344.75,BUY,3,0.02h,Stop Loss,$-9.00,$-330.00,$55658.00,46,$-330.00
2024-03-04,13:50:00,18335.0,SELL,3,0.02h,Break Even,$-1.50,$-331.50,$55656.50,46,$-331.50
2024-03-04,15:19:00,18300.25,BUY,3,0.02h,Stop Loss,$-9.00,$-340.50,$55647.50,46,$-340.50
2024-03-04,15:20:00,18298.25,SELL,3,0.02h,Stop Loss,$51.00,$-289.50,$55698.50,46,$-289.50
2024-03-04,15:34:00,18301.75,BUY,3,0.02h,Stop Loss,$30.00,$-259.50,$55728.50,46,$-259.50
2024-03-04,16:06:00,18312.0,SELL,3,0.02h,Stop Loss,$40.50,$-219.00,$55769.00,46,$-219.00
2024-03-04,16:49:00,18307.75,BUY,3,0.02h,Stop Loss,$-9.00,$-228.00,$55760.00,46,$-228.00
2024-03-04,17:07:00,18306.25,SELL,3,0.02h,Stop Loss,$24.00,$-204.00,$55784.00,46,$-204.00
2024-03-04,17:14:00,18310.0,BUY,3,0.02h,Stop Loss,$-9.00,$-213.00,$55775.00,46,$-213.00
2024-03-04,17:36:00,18309.75,SELL,3,0.02h,Stop Loss,$15.00,$-198.00,$55790.00,46,$-198.00
2024-03-04,18:03:00,18309.25,BUY,3,0.02h,Stop Loss,$-9.00,$-207.00,$55781.00,46,$-207.00
2024-03-04,18:07:00,18300.75,SELL,3,0.02h,Break Even,$-1.50,$-208.50,$55779.50,46,$-208.50
2024-03-04,18:39:00,18294.25,BUY,3,0.02h,Stop Loss,$-9.00,$-217.50,$55770.50,46,$-217.50
2024-03-04,19:08:00,18292.75,SELL,3,0.02h,Stop Loss,$3.00,$-214.50,$55773.50,46,$-214.50
2024-03-04,19:16:00,18302.0,BUY,3,0.02h,Stop Loss,$-9.00,$-223.50,$55764.50,46,$-223.50
2024-03-04,19:17:00,18298.0,SELL,3,0.02h,Break Even,$-1.50,$-225.00,$55763.00,46,$-225.00
2024-03-04,19:18:00,18301.0,BUY,3,0.02h,Stop Loss,$31.50,$-193.50,$55794.50,46,$-193.50
2024-03-04,19:29:00,18297.75,SELL,3,0.02h,Break Even,$-1.50,$-195.00,$55793.00,46,$-195.00
2024-03-04,19:34:00,18307.25,BUY,3,0.02h,Stop Loss,$13.50,$-181.50,$55806.50,46,$-181.50
2024-03-04,20:08:00,18327.75,SELL,3,0.02h,Stop Loss,$-9.00,$-190.50,$55797.50,46,$-190.50
2024-03-04,20:09:00,18335.25,BUY,3,0.02h,Stop Loss,$4.50,$-186.00,$55802.00,46,$-186.00
2024-03-04,20:29:00,18334.75,SELL,3,0.02h,Stop Loss,$90.00,$-96.00,$55892.00,46,$-96.00
2024-03-04,21:59:00,18242.0,BUY,3,1.03h,Stop Loss,$51.00,$-45.00,$55943.00,46,$-45.00
2024-03-04,23:11:00,18223.75,SELL,3,0.02h,Stop Loss,$10.50,$-34.50,$55953.50,46,$-34.50
2024-03-04,23:30:00,18235.25,BUY,3,0.02h,Break Even,$-1.50,$-36.00,$55952.00,46,$-36.00
2024-03-04,23:31:00,18232.75,SELL,3,0.02h,Stop Loss,$-9.00,$-45.00,$55943.00,46,$-45.00
2024-03-04,23:32:00,18234.0,BUY,3,0.02h,Stop Loss,$-9.00,$-54.00,$55934.00,46,$-54.00
2024-03-04,23:33:00,18233.0,SELL,3,0.02h,Stop Loss,$-9.00,$-63.00,$55925.00,46,$-63.00
2024-03-04,23:34:00,18235.75,BUY,3,0.02h,Break Even,$-1.50,$-64.50,$55923.50,46,$-64.50
2024-03-04,23:46:00,18232.0,SELL,3,0.02h,Break Even,$-1.50,$-66.00,$55922.00,46,$-66.00
,,,,,,,,,,,
2024-03-05,00:06:00,18233.25,BUY,3,0.02h,Break Even,$-1.50,$-1.50,$55920.50,47,$-1.50
2024-03-05,00:21:00,18227.0,SELL,3,0.02h,Break Even,$-1.50,$-3.00,$55919.00,47,$-3.00
2024-03-05,00:55:00,18224.75,BUY,3,0.02h,Stop Loss,$-9.00,$-12.00,$55910.00,47,$-12.00
2024-03-05,00:57:00,18223.25,SELL,3,0.02h,Stop Loss,$-9.00,$-21.00,$55901.00,47,$-21.00
2024-03-05,00:58:00,18225.25,BUY,3,0.02h,Stop Loss,$-9.00,$-30.00,$55892.00,47,$-30.00
2024-03-05,01:02:00,18222.75,SELL,3,0.02h,Stop Loss,$-9.00,$-39.00,$55883.00,47,$-39.00
2024-03-05,01:03:00,18226.0,BUY,3,0.02h,Break Even,$-1.50,$-40.50,$55881.50,47,$-40.50
2024-03-05,01:06:00,18222.75,SELL,3,0.02h,Stop Loss,$-9.00,$-49.50,$55872.50,47,$-49.50
2024-03-05,01:07:00,18224.5,BUY,3,0.02h,Break Even,$-1.50,$-51.00,$55871.00,47,$-51.00
2024-03-05,01:15:00,18222.0,SELL,3,0.02h,Stop Loss,$-9.00,$-60.00,$55862.00,47,$-60.00
2024-03-05,02:03:00,18204.0,BUY,3,0.02h,Break Even,$-1.50,$-61.50,$55860.50,47,$-61.50
2024-03-05,02:18:00,18200.25,SELL,3,0.02h,Stop Loss,$-9.00,$-70.50,$55851.50,47,$-70.50
2024-03-05,02:23:00,18206.0,BUY,3,0.03h,Stop Loss,$-9.00,$-79.50,$55842.50,47,$-79.50
2024-03-05,02:27:00,18198.5,SELL,3,0.02h,Break Even,$-1.50,$-81.00,$55841.00,47,$-81.00
2024-03-05,03:10:00,18195.75,BUY,3,0.03h,Break Even,$-1.50,$-82.50,$55839.50,47,$-82.50
2024-03-05,04:19:00,18211.75,SELL,3,0.02h,Stop Loss,$-9.00,$-91.50,$55830.50,47,$-91.50
2024-03-05,04:53:00,18209.75,BUY,3,0.05h,Stop Loss,$-9.00,$-100.50,$55821.50,47,$-100.50
2024-03-05,05:01:00,18207.5,SELL,3,0.02h,Break Even,$-1.50,$-102.00,$55820.00,47,$-102.00
2024-03-05,06:05:00,18193.75,BUY,3,0.02h,Stop Loss,$-9.00,$-111.00,$55811.00,47,$-111.00
2024-03-05,06:08:00,18190.25,SELL,3,0.02h,Break Even,$-1.50,$-112.50,$55809.50,47,$-112.50
2024-03-05,06:50:00,18180.0,BUY,3,0.02h,Break Even,$-1.50,$-114.00,$55808.00,47,$-114.00
2024-03-05,07:15:00,18176.25,SELL,3,0.02h,Break Even,$-1.50,$-115.50,$55806.50,47,$-115.50
2024-03-05,07:47:00,18167.5,BUY,3,0.02h,Stop Loss,$-9.00,$-124.50,$55797.50,47,$-124.50
2024-03-05,08:24:00,18175.5,SELL,3,0.02h,Break Even,$-1.50,$-126.00,$55796.00,47,$-126.00
2024-03-05,09:23:00,18152.0,BUY,3,0.02h,Break Even,$-1.50,$-127.50,$55794.50,47,$-127.50
2024-03-05,09:36:00,18141.0,SELL,3,0.02h,Stop Loss,$6.00,$-121.50,$55800.50,47,$-121.50
2024-03-05,10:20:00,18129.25,BUY,3,0.02h,Break Even,$-1.50,$-123.00,$55799.00,47,$-123.00
2024-03-05,11:45:00,18147.0,SELL,3,0.02h,Stop Loss,$-9.00,$-132.00,$55790.00,47,$-132.00
2024-03-05,11:49:00,18151.25,BUY,3,0.02h,Stop Loss,$-9.00,$-141.00,$55781.00,47,$-141.00
2024-03-05,11:51:00,18146.25,SELL,3,0.02h,Stop Loss,$-9.00,$-150.00,$55772.00,47,$-150.00
2024-03-05,11:57:00,18151.25,BUY,3,0.02h,Stop Loss,$6.00,$-144.00,$55778.00,47,$-144.00
2024-03-05,12:33:00,18160.75,SELL,3,0.02h,Stop Loss,$12.00,$-132.00,$55790.00,47,$-132.00
2024-03-05,13:04:00,18161.75,BUY,3,0.02h,Stop Loss,$-9.00,$-141.00,$55781.00,47,$-141.00
2024-03-05,13:23:00,18160.0,SELL,3,0.02h,Stop Loss,$-9.00,$-150.00,$55772.00,47,$-150.00
2024-03-05,15:04:00,18078.75,BUY,3,0.02h,Stop Loss,$10.50,$-139.50,$55782.50,47,$-139.50
2024-03-05,15:07:00,18050.75,SELL,3,0.02h,Stop Loss,$120.00,$-19.50,$55902.50,47,$-19.50
2024-03-05,16:07:00,17942.75,BUY,3,0.02h,Stop Loss,$6.00,$-13.50,$55908.50,47,$-13.50
2024-03-05,16:11:00,17931.0,SELL,3,0.02h,Stop Loss,$67.50,$54.00,$55976.00,47,$54.00
2024-03-05,16:19:00,17949.25,BUY,3,0.02h,Break Even,$-1.50,$52.50,$55974.50,47,$52.50
2024-03-05,16:37:00,17937.75,SELL,3,0.02h,Break Even,$-1.50,$51.00,$55973.00,47,$51.00
2024-03-05,17:01:00,17943.25,BUY,3,0.02h,Break Even,$-1.50,$49.50,$55971.50,47,$49.50
2024-03-05,17:40:00,17951.25,SELL,3,0.02h,Stop Loss,$39.00,$88.50,$56010.50,47,$88.50
2024-03-05,17:47:00,17966.25,BUY,3,0.02h,Break Even,$-1.50,$87.00,$56009.00,47,$87.00
2024-03-05,17:52:00,17948.5,SELL,3,0.02h,Break Even,$-1.50,$85.50,$56007.50,47,$85.50
2024-03-05,17:56:00,17965.25,BUY,3,0.02h,Break Even,$-1.50,$84.00,$56006.00,47,$84.00
2024-03-05,18:01:00,17946.25,SELL,3,0.02h,Break Even,$-1.50,$82.50,$56004.50,47,$82.50
2024-03-05,19:11:00,17899.5,BUY,3,0.02h,Break Even,$-1.50,$81.00,$56003.00,47,$81.00
2024-03-05,19:21:00,17881.75,SELL,3,0.02h,Stop Loss,$-9.00,$72.00,$55994.00,47,$72.00
2024-03-05,19:24:00,17898.25,BUY,3,0.02h,Break Even,$-1.50,$70.50,$55992.50,47,$70.50
2024-03-05,19:31:00,17888.75,SELL,3,0.02h,Stop Loss,$49.50,$120.00,$56042.00,47,$120.00
2024-03-05,20:05:00,17872.75,BUY,3,0.02h,Stop Loss,$42.00,$162.00,$56084.00,47,$162.00
2024-03-05,20:09:00,17861.25,SELL,3,0.02h,Stop Loss,$4.50,$166.50,$56088.50,47,$166.50
2024-03-05,20:36:00,17858.25,BUY,3,0.02h,Break Even,$-1.50,$165.00,$56087.00,47,$165.00
2024-03-05,23:05:00,17967.25,SELL,3,0.02h,Stop Loss,$4.50,$169.50,$56091.50,47,$169.50
2024-03-05,23:46:00,17965.75,BUY,3,0.02h,Stop Loss,$-9.00,$160.50,$56082.50,47,$160.50
2024-03-05,23:48:00,17961.25,SELL,3,0.02h,Break Even,$-1.50,$159.00,$56081.00,47,$159.00
,,,,,,,,,,,
2024-03-06,00:29:00,17960.75,BUY,3,0.02h,Stop Loss,$-9.00,$-9.00,$56072.00,48,$-9.00
2024-03-06,00:42:00,17955.75,SELL,3,0.02h,Stop Loss,$-9.00,$-18.00,$56063.00,48,$-18.00
2024-03-06,01:06:00,17955.5,BUY,3,0.02h,Stop Loss,$3.00,$-15.00,$56066.00,48,$-15.00
2024-03-06,01:38:00,17955.25,SELL,3,0.02h,Stop Loss,$19.50,$4.50,$56085.50,48,$4.50
2024-03-06,01:53:00,17958.0,BUY,3,0.02h,Break Even,$-1.50,$3.00,$56084.00,48,$3.00
2024-03-06,02:55:00,17971.5,SELL,3,0.02h,Break Even,$-1.50,$1.50,$56082.50,48,$1.50
2024-03-06,03:27:00,17972.25,BUY,3,0.02h,Break Even,$-1.50,$0.00,$56081.00,48,$0.00
2024-03-06,04:14:00,17979.25,SELL,3,0.02h,Stop Loss,$-9.00,$-9.00,$56072.00,48,$-9.00
2024-03-06,04:18:00,17981.75,BUY,3,0.02h,Stop Loss,$-9.00,$-18.00,$56063.00,48,$-18.00
2024-03-06,04:25:00,17979.5,SELL,3,0.03h,Break Even,$-1.50,$-19.50,$56061.50,48,$-19.50
2024-03-06,04:50:00,17979.0,BUY,3,0.02h,Stop Loss,$-9.00,$-28.50,$56052.50,48,$-28.50
2024-03-06,05:21:00,17979.75,SELL,3,0.02h,Stop Loss,$-9.00,$-37.50,$56043.50,48,$-37.50
2024-03-06,05:38:00,17982.25,BUY,3,0.13h,Break Even,$-1.50,$-39.00,$56042.00,48,$-39.00
2024-03-06,05:50:00,17978.5,SELL,3,0.02h,Stop Loss,$-9.00,$-48.00,$56033.00,48,$-48.00
2024-03-06,06:01:00,17982.5,BUY,3,0.02h,Break Even,$-1.50,$-49.50,$56031.50,48,$-49.50
2024-03-06,06:05:00,17977.0,SELL,3,0.02h,Break Even,$-1.50,$-51.00,$56030.00,48,$-51.00
2024-03-06,06:23:00,17977.5,BUY,3,0.02h,Break Even,$-1.50,$-52.50,$56028.50,48,$-52.50
2024-03-06,06:27:00,17973.25,SELL,3,0.02h,Break Even,$-1.50,$-54.00,$56027.00,48,$-54.00
2024-03-06,06:33:00,17976.75,BUY,3,0.07h,Stop Loss,$3.00,$-51.00,$56030.00,48,$-51.00
2024-03-06,07:02:00,17971.75,SELL,3,0.02h,Break Even,$-1.50,$-52.50,$56028.50,48,$-52.50
2024-03-06,07:09:00,17980.25,BUY,3,0.02h,Stop Loss,$-9.00,$-61.50,$56019.50,48,$-61.50
2024-03-06,07:10:00,17974.75,SELL,3,0.02h,Stop Loss,$-9.00,$-70.50,$56010.50,48,$-70.50
2024-03-06,07:21:00,17981.25,BUY,3,0.02h,Break Even,$-1.50,$-72.00,$56009.00,48,$-72.00
2024-03-06,07:32:00,17974.25,SELL,3,0.02h,Break Even,$-1.50,$-73.50,$56007.50,48,$-73.50
2024-03-06,07:40:00,17981.75,BUY,3,0.02h,Break Even,$-1.50,$-75.00,$56006.00,48,$-75.00
2024-03-06,08:48:00,18023.25,SELL,3,0.02h,Stop Loss,$-9.00,$-84.00,$55997.00,48,$-84.00
2024-03-06,09:02:00,18029.75,BUY,3,0.02h,Stop Loss,$22.50,$-61.50,$56019.50,48,$-61.50
2024-03-06,09:49:00,18049.5,SELL,3,0.02h,Stop Loss,$4.50,$-57.00,$56024.00,48,$-57.00
2024-03-06,09:59:00,18056.75,BUY,3,0.02h,Stop Loss,$-9.00,$-66.00,$56015.00,48,$-66.00
2024-03-06,10:44:00,18061.5,SELL,3,0.02h,Stop Loss,$15.00,$-51.00,$56030.00,48,$-51.00
2024-03-06,11:15:00,18063.25,BUY,3,0.02h,Break Even,$-1.50,$-52.50,$56028.50,48,$-52.50
2024-03-06,11:23:00,18052.75,SELL,3,0.02h,Break Even,$-1.50,$-54.00,$56027.00,48,$-54.00
2024-03-06,12:09:00,18061.25,BUY,3,0.02h,Stop Loss,$13.50,$-40.50,$56040.50,48,$-40.50
2024-03-06,12:26:00,18053.25,SELL,3,0.02h,Break Even,$-1.50,$-42.00,$56039.00,48,$-42.00
2024-03-06,12:30:00,18058.75,BUY,3,0.02h,Stop Loss,$4.50,$-37.50,$56043.50,48,$-37.50
2024-03-06,13:32:00,18076.0,SELL,3,0.02h,Stop Loss,$55.50,$18.00,$56099.00,48,$18.00
2024-03-06,13:49:00,18083.0,BUY,3,0.02h,Stop Loss,$19.50,$37.50,$56118.50,48,$37.50
2024-03-06,14:37:00,18074.25,SELL,3,0.02h,Break Even,$-1.50,$36.00,$56117.00,48,$36.00
2024-03-06,14:46:00,18108.75,BUY,3,0.02h,Break Even,$-1.50,$34.50,$56115.50,48,$34.50
2024-03-06,14:47:00,18086.0,SELL,3,0.02h,Stop Loss,$57.00,$91.50,$56172.50,48,$91.50
2024-03-06,15:23:00,18030.0,BUY,3,0.02h,Stop Loss,$9.00,$100.50,$56181.50,48,$100.50
2024-03-06,15:25:00,18013.0,SELL,3,0.02h,Break Even,$-1.50,$99.00,$56180.00,48,$99.00
2024-03-06,15:34:00,18034.75,BUY,3,0.02h,Stop Loss,$64.50,$163.50,$56244.50,48,$163.50
2024-03-06,16:33:00,18078.0,SELL,3,0.02h,Stop Loss,$66.00,$229.50,$56310.50,48,$229.50
2024-03-06,16:41:00,18093.75,BUY,3,0.02h,Break Even,$-1.50,$228.00,$56309.00,48,$228.00
2024-03-06,17:42:00,18146.75,SELL,3,0.02h,Stop Loss,$16.50,$244.50,$56325.50,48,$244.50
2024-03-06,18:16:00,18142.25,BUY,3,0.02h,Stop Loss,$-9.00,$235.50,$56316.50,48,$235.50
2024-03-06,18:34:00,18082.0,SELL,3,0.02h,Stop Loss,$10.50,$246.00,$56327.00,48,$246.00
2024-03-06,19:25:00,18066.25,BUY,3,0.02h,Break Even,$-1.50,$244.50,$56325.50,48,$244.50
2024-03-06,19:35:00,18053.0,SELL,3,0.02h,Stop Loss,$94.50,$339.00,$56420.00,48,$339.00
2024-03-06,20:11:00,18044.75,BUY,3,0.02h,Stop Loss,$6.00,$345.00,$56426.00,48,$345.00
2024-03-06,20:14:00,18021.5,SELL,3,0.02h,Stop Loss,$127.50,$472.50,$56553.50,48,$472.50
2024-03-06,20:41:00,18034.5,BUY,3,0.02h,Stop Loss,$4.50,$477.00,$56558.00,48,$477.00
2024-03-06,21:09:00,18034.0,SELL,3,0.02h,Break Even,$-1.50,$475.50,$56556.50,48,$475.50
2024-03-06,21:14:00,18039.5,BUY,3,0.02h,Stop Loss,$-9.00,$466.50,$56547.50,48,$466.50
2024-03-06,21:51:00,18041.75,SELL,3,0.02h,Stop Loss,$-9.00,$457.50,$56538.50,48,$457.50
,,,,,,,,,,,
2024-03-07,00:59:00,17996.25,BUY,3,0.02h,Stop Loss,$-9.00,$-9.00,$56529.50,49,$-9.00
2024-03-07,01:01:00,17985.75,SELL,3,0.02h,Stop Loss,$-9.00,$-18.00,$56520.50,49,$-18.00
2024-03-07,01:19:00,17989.25,BUY,3,0.02h,Stop Loss,$-9.00,$-27.00,$56511.50,49,$-27.00
2024-03-07,01:37:00,17976.0,SELL,3,0.02h,Stop Loss,$25.50,$-1.50,$56537.00,49,$-1.50
2024-03-07,02:49:00,17948.75,BUY,3,0.02h,Stop Loss,$-9.00,$-10.50,$56528.00,49,$-10.50
2024-03-07,03:23:00,17944.75,SELL,3,0.02h,Stop Loss,$-9.00,$-19.50,$56519.00,49,$-19.50
2024-03-07,03:24:00,18191.0,BUY,3,0.02h,Stop Loss,$-9.00,$-28.50,$56510.00,49,$-28.50
2024-03-07,03:25:00,17945.5,SELL,3,0.02h,Stop Loss,$-9.00,$-37.50,$56501.00,49,$-37.50
2024-03-07,03:33:00,18197.5,BUY,3,0.02h,Stop Loss,$-9.00,$-46.50,$56492.00,49,$-46.50
2024-03-07,03:36:00,17949.0,SELL,3,0.02h,Stop Loss,$-9.00,$-55.50,$56483.00,49,$-55.50
2024-03-07,03:39:00,18193.5,BUY,3,0.02h,Stop Loss,$-9.00,$-64.50,$56474.00,49,$-64.50
2024-03-07,03:40:00,17953.25,SELL,3,0.02h,Stop Loss,$-9.00,$-73.50,$56465.00,49,$-73.50
2024-03-07,03:42:00,18204.5,BUY,3,0.02h,Stop Loss,$-9.00,$-82.50,$56456.00,49,$-82.50
2024-03-07,03:49:00,17963.0,SELL,3,0.02h,Break Even,$-1.50,$-84.00,$56454.50,49,$-84.00
2024-03-07,03:52:00,18213.5,BUY,3,0.02h,Stop Loss,$-9.00,$-93.00,$56445.50,49,$-93.00
2024-03-07,03:53:00,17969.75,SELL,3,0.02h,Stop Loss,$-9.00,$-102.00,$56436.50,49,$-102.00
2024-03-07,03:55:00,18211.5,BUY,3,0.02h,Stop Loss,$-9.00,$-111.00,$56427.50,49,$-111.00
2024-03-07,03:56:00,17968.75,SELL,3,0.02h,Stop Loss,$-9.00,$-120.00,$56418.50,49,$-120.00
2024-03-07,03:57:00,18213.75,BUY,3,0.05h,Stop Loss,$-9.00,$-129.00,$56409.50,49,$-129.00
2024-03-07,04:12:00,17961.0,SELL,3,0.02h,Stop Loss,$-9.00,$-138.00,$56400.50,49,$-138.00
2024-03-07,04:13:00,18202.5,BUY,3,0.02h,Stop Loss,$-9.00,$-147.00,$56391.50,49,$-147.00
2024-03-07,04:14:00,17959.5,SELL,3,0.02h,Stop Loss,$-9.00,$-156.00,$56382.50,49,$-156.00
2024-03-07,04:15:00,18205.0,BUY,3,0.02h,Stop Loss,$-9.00,$-165.00,$56373.50,49,$-165.00
2024-03-07,04:16:00,17964.5,SELL,3,0.02h,Stop Loss,$-9.00,$-174.00,$56364.50,49,$-174.00
2024-03-07,04:32:00,18215.0,BUY,3,0.02h,Stop Loss,$-9.00,$-183.00,$56355.50,49,$-183.00
2024-03-07,04:42:00,17974.25,SELL,3,0.02h,Stop Loss,$-9.00,$-192.00,$56346.50,49,$-192.00
2024-03-07,04:43:00,18220.0,BUY,3,0.02h,Stop Loss,$-9.00,$-201.00,$56337.50,49,$-201.00
2024-03-07,04:47:00,17973.75,SELL,3,0.02h,Break Even,$-1.50,$-202.50,$56336.00,49,$-202.50
2024-03-07,05:02:00,18218.5,BUY,3,0.02h,Stop Loss,$-9.00,$-211.50,$56327.00,49,$-211.50
2024-03-07,05:06:00,17974.25,SELL,3,0.02h,Stop Loss,$-9.00,$-220.50,$56318.00,49,$-220.50
2024-03-07,05:08:00,18223.25,BUY,3,0.02h,Stop Loss,$-9.00,$-229.50,$56309.00,49,$-229.50
2024-03-07,05:12:00,17979.5,SELL,3,0.02h,Stop Loss,$-9.00,$-238.50,$56300.00,49,$-238.50
2024-03-07,05:19:00,18229.5,BUY,3,0.05h,Stop Loss,$-9.00,$-247.50,$56291.00,49,$-247.50
2024-03-07,05:29:00,17982.0,SELL,3,0.03h,Break Even,$-1.50,$-249.00,$56289.50,49,$-249.00
2024-03-07,05:33:00,18227.0,BUY,3,0.02h,Stop Loss,$-9.00,$-258.00,$56280.50,49,$-258.00
2024-03-07,05:44:00,17979.5,SELL,3,0.02h,Stop Loss,$-9.00,$-267.00,$56271.50,49,$-267.00
2024-03-07,05:45:00,18223.25,BUY,3,0.02h,Stop Loss,$-9.00,$-276.00,$56262.50,49,$-276.00
2024-03-07,05:46:00,17978.75,SELL,3,0.02h,Break Even,$-1.50,$-277.50,$56261.00,49,$-277.50
2024-03-07,05:48:00,18221.25,BUY,3,0.02h,Stop Loss,$-9.00,$-286.50,$56252.00,49,$-286.50
2024-03-07,05:49:00,17975.75,SELL,3,0.02h,Stop Loss,$-9.00,$-295.50,$56243.00,49,$-295.50
2024-03-07,05:54:00,18223.0,BUY,3,0.02h,Stop Loss,$-9.00,$-304.50,$56234.00,49,$-304.50
2024-03-07,05:55:00,17976.75,SELL,3,0.02h,Stop Loss,$-9.00,$-313.50,$56225.00,49,$-313.50
2024-03-07,05:57:00,18226.25,BUY,3,0.03h,Stop Loss,$-9.00,$-322.50,$56216.00,49,$-322.50
2024-03-07,06:00:00,17978.75,SELL,3,0.02h,Stop Loss,$9.00,$-313.50,$56225.00,49,$-313.50
2024-03-07,06:09:00,18226.0,BUY,3,0.02h,Stop Loss,$-9.00,$-322.50,$56216.00,49,$-322.50
2024-03-07,06:18:00,17977.0,SELL,3,0.02h,Stop Loss,$-9.00,$-331.50,$56207.00,49,$-331.50
2024-03-07,06:29:00,18235.0,BUY,3,0.02h,Stop Loss,$-9.00,$-340.50,$56198.00,49,$-340.50
2024-03-07,06:30:00,17989.75,SELL,3,0.02h,Stop Loss,$-9.00,$-349.50,$56189.00,49,$-349.50
2024-03-07,06:31:00,18234.0,BUY,3,0.02h,Break Even,$-1.50,$-351.00,$56187.50,49,$-351.00
2024-03-07,06:37:00,17990.25,SELL,3,0.02h,Break Even,$-1.50,$-352.50,$56186.00,49,$-352.50
2024-03-07,06:39:00,18231.75,BUY,3,0.02h,Stop Loss,$-9.00,$-361.50,$56177.00,49,$-361.50
2024-03-07,06:49:00,17974.25,SELL,3,0.02h,Stop Loss,$-9.00,$-370.50,$56168.00,49,$-370.50
2024-03-07,06:50:00,18217.75,BUY,3,0.02h,Stop Loss,$-9.00,$-379.50,$56159.00,49,$-379.50
2024-03-07,06:51:00,17970.25,SELL,3,0.02h,Stop Loss,$7.50,$-372.00,$56166.50,49,$-372.00
2024-03-07,06:56:00,18208.75,BUY,3,0.02h,Stop Loss,$-9.00,$-381.00,$56157.50,49,$-381.00
2024-03-07,06:58:00,17954.0,SELL,3,0.02h,Stop Loss,$-9.00,$-390.00,$56148.50,49,$-390.00
2024-03-07,06:59:00,18200.0,BUY,3,0.03h,Stop Loss,$19.50,$-370.50,$56168.00,49,$-370.50
2024-03-07,07:03:00,17957.25,SELL,3,0.02h,Stop Loss,$-9.00,$-379.50,$56159.00,49,$-379.50
2024-03-07,07:04:00,18194.75,BUY,3,0.02h,Stop Loss,$-9.00,$-388.50,$56150.00,49,$-388.50
2024-03-07,07:05:00,17948.75,SELL,3,0.02h,Stop Loss,$-9.00,$-397.50,$56141.00,49,$-397.50
2024-03-07,07:17:00,18188.75,BUY,3,0.02h,Stop Loss,$-9.00,$-406.50,$56132.00,49,$-406.50
2024-03-07,07:18:00,17944.5,SELL,3,0.02h,Break Even,$-1.50,$-408.00,$56130.50,49,$-408.00
2024-03-07,07:30:00,18188.0,BUY,3,0.02h,Break Even,$-1.50,$-409.50,$56129.00,49,$-409.50
2024-03-07,07:39:00,17941.5,SELL,3,0.02h,Stop Loss,$-9.00,$-418.50,$56120.00,49,$-418.50
2024-03-07,07:43:00,18197.25,BUY,3,0.02h,Stop Loss,$-9.00,$-427.50,$56111.00,49,$-427.50
2024-03-07,07:44:00,17953.0,SELL,3,0.02h,Break Even,$-1.50,$-429.00,$56109.50,49,$-429.00
2024-03-07,07:51:00,18203.25,BUY,3,0.02h,Stop Loss,$-9.00,$-438.00,$56100.50,49,$-438.00
2024-03-07,07:52:00,17961.75,SELL,3,0.02h,Stop Loss,$-9.00,$-447.00,$56091.50,49,$-447.00
2024-03-07,07:53:00,18203.25,BUY,3,0.02h,Stop Loss,$-9.00,$-456.00,$56082.50,49,$-456.00
2024-03-07,07:57:00,17956.5,SELL,3,0.02h,Break Even,$-1.50,$-457.50,$56081.00,49,$-457.50
2024-03-07,07:59:00,18195.5,BUY,3,0.03h,Stop Loss,$6.00,$-451.50,$56087.00,49,$-451.50
2024-03-07,08:05:00,17960.75,SELL,3,0.02h,Stop Loss,$-9.00,$-460.50,$56078.00,49,$-460.50
2024-03-07,08:11:00,18173.75,BUY,3,0.02h,Stop Loss,$-9.00,$-469.50,$56069.00,49,$-469.50
2024-03-07,08:12:00,17922.0,SELL,3,0.02h,Stop Loss,$18.00,$-451.50,$56087.00,49,$-451.50
2024-03-07,08:16:00,18176.0,BUY,3,0.02h,Stop Loss,$-9.00,$-460.50,$56078.00,49,$-460.50
2024-03-07,08:17:00,17946.5,SELL,3,0.02h,Stop Loss,$-9.00,$-469.50,$56069.00,49,$-469.50
2024-03-07,08:18:00,18192.5,BUY,3,0.02h,Stop Loss,$-9.00,$-478.50,$56060.00,49,$-478.50
2024-03-07,08:25:00,17968.25,SELL,3,0.02h,Stop Loss,$-9.00,$-487.50,$56051.00,49,$-487.50
2024-03-07,08:26:00,18215.0,BUY,3,0.03h,Stop Loss,$24.00,$-463.50,$56075.00,49,$-463.50
2024-03-07,08:40:00,17977.0,SELL,3,0.02h,Stop Loss,$24.00,$-439.50,$56099.00,49,$-439.50
2024-03-07,08:51:00,18218.0,BUY,3,0.03h,Stop Loss,$6.00,$-433.50,$56105.00,49,$-433.50
2024-03-07,09:02:00,17978.5,SELL,3,0.02h,Stop Loss,$-9.00,$-442.50,$56096.00,49,$-442.50
2024-03-07,09:06:00,18242.75,BUY,3,0.02h,Stop Loss,$-9.00,$-451.50,$56087.00,49,$-451.50
2024-03-07,09:08:00,17996.0,SELL,3,0.02h,Stop Loss,$-9.00,$-460.50,$56078.00,49,$-460.50
2024-03-07,09:09:00,18243.25,BUY,3,0.02h,Break Even,$-1.50,$-462.00,$56076.50,49,$-462.00
2024-03-07,09:12:00,18004.0,SELL,3,0.02h,Stop Loss,$-9.00,$-471.00,$56067.50,49,$-471.00
2024-03-07,09:13:00,18251.0,BUY,3,0.02h,Stop Loss,$-9.00,$-480.00,$56058.50,49,$-480.00
2024-03-07,09:14:00,18012.0,SELL,3,0.02h,Stop Loss,$-9.00,$-489.00,$56049.50,49,$-489.00
2024-03-07,09:15:00,18253.0,BUY,3,0.02h,Stop Loss,$87.00,$-402.00,$56136.50,49,$-402.00
2024-03-07,09:25:00,18045.25,SELL,3,0.02h,Stop Loss,$-9.00,$-411.00,$56127.50,49,$-411.00
2024-03-07,09:28:00,18294.0,BUY,3,0.02h,Stop Loss,$15.00,$-396.00,$56142.50,49,$-396.00
2024-03-07,09:37:00,18056.5,SELL,3,0.02h,Stop Loss,$-9.00,$-405.00,$56133.50,49,$-405.00
2024-03-07,09:38:00,18300.0,BUY,3,0.02h,Stop Loss,$-9.00,$-414.00,$56124.50,49,$-414.00
2024-03-07,09:39:00,18056.75,SELL,3,0.02h,Stop Loss,$-9.00,$-423.00,$56115.50,49,$-423.00
2024-03-07,09:45:00,18306.75,BUY,3,0.02h,Stop Loss,$-9.00,$-432.00,$56106.50,49,$-432.00
2024-03-07,09:48:00,18061.5,SELL,3,0.02h,Stop Loss,$-9.00,$-441.00,$56097.50,49,$-441.00
2024-03-07,09:49:00,18308.0,BUY,3,0.02h,Stop Loss,$-9.00,$-450.00,$56088.50,49,$-450.00
2024-03-07,09:53:00,18070.0,SELL,3,0.02h,Stop Loss,$-9.00,$-459.00,$56079.50,49,$-459.00
2024-03-07,09:54:00,18306.0,BUY,3,0.03h,Stop Loss,$18.00,$-441.00,$56097.50,49,$-441.00
2024-03-07,10:04:00,18076.5,SELL,3,0.02h,Break Even,$-1.50,$-442.50,$56096.00,49,$-442.50
2024-03-07,10:16:00,18328.5,BUY,3,0.07h,Stop Loss,$9.00,$-433.50,$56105.00,49,$-433.50
2024-03-07,10:25:00,18090.5,SELL,3,0.02h,Stop Loss,$3.00,$-430.50,$56108.00,49,$-430.50
2024-03-07,10:35:00,18334.0,BUY,3,0.02h,Break Even,$-1.50,$-432.00,$56106.50,49,$-432.00
2024-03-07,10:49:00,18106.25,SELL,3,0.02h,Break Even,$-1.50,$-433.50,$56105.00,49,$-433.50
2024-03-07,10:59:00,18366.0,BUY,3,0.02h,Stop Loss,$-9.00,$-442.50,$56096.00,49,$-442.50
2024-03-07,11:10:00,18121.25,SELL,3,0.02h,Stop Loss,$9.00,$-433.50,$56105.00,49,$-433.50
2024-03-07,11:12:00,18359.5,BUY,3,0.02h,Break Even,$-1.50,$-435.00,$56103.50,49,$-435.00
2024-03-07,11:25:00,18100.75,SELL,3,0.02h,Stop Loss,$-9.00,$-444.00,$56094.50,49,$-444.00
2024-03-07,11:26:00,18349.5,BUY,3,0.03h,Break Even,$-1.50,$-445.50,$56093.00,49,$-445.50
2024-03-07,11:31:00,18104.25,SELL,3,0.02h,Stop Loss,$-9.00,$-454.50,$56084.00,49,$-454.50
2024-03-07,11:32:00,18349.0,BUY,3,0.02h,Stop Loss,$4.50,$-450.00,$56088.50,49,$-450.00
2024-03-07,11:36:00,18102.75,SELL,3,0.02h,Stop Loss,$-9.00,$-459.00,$56079.50,49,$-459.00
2024-03-07,11:46:00,18366.75,BUY,3,0.02h,Stop Loss,$-9.00,$-468.00,$56070.50,49,$-468.00
2024-03-07,11:47:00,18118.25,SELL,3,0.02h,Break Even,$-1.50,$-469.50,$56069.00,49,$-469.50
2024-03-07,11:50:00,18362.5,BUY,3,0.02h,Break Even,$-1.50,$-471.00,$56067.50,49,$-471.00
2024-03-07,11:55:00,18112.0,SELL,3,0.02h,Stop Loss,$-9.00,$-480.00,$56058.50,49,$-480.00
2024-03-07,11:56:00,18356.5,BUY,3,0.02h,Stop Loss,$-9.00,$-489.00,$56049.50,49,$-489.00
2024-03-07,11:58:00,18107.75,SELL,3,0.02h,Break Even,$-1.50,$-490.50,$56048.00,49,$-490.50
2024-03-07,12:12:00,18354.25,BUY,3,0.02h,Stop Loss,$-9.00,$-499.50,$56039.00,49,$-499.50
2024-03-07,12:13:00,18114.5,SELL,3,0.02h,Break Even,$-1.50,$-501.00,$56037.50,49,$-501.00
2024-03-07,12:15:00,18361.5,BUY,3,0.02h,Stop Loss,$-9.00,$-510.00,$56028.50,49,$-510.00
2024-03-07,12:19:00,18114.5,SELL,3,0.02h,Break Even,$-1.50,$-511.50,$56027.00,49,$-511.50
2024-03-07,12:22:00,18373.5,BUY,3,0.02h,Stop Loss,$-9.00,$-520.50,$56018.00,49,$-520.50
2024-03-07,12:23:00,18129.0,SELL,3,0.02h,Stop Loss,$-9.00,$-529.50,$56009.00,49,$-529.50
2024-03-07,12:24:00,18379.0,BUY,3,0.02h,Stop Loss,$-9.00,$-538.50,$56000.00,49,$-538.50
2024-03-07,12:26:00,18129.75,SELL,3,0.02h,Stop Loss,$30.00,$-508.50,$56030.00,49,$-508.50
2024-03-07,12:28:00,18370.75,BUY,3,0.02h,Stop Loss,$-9.00,$-517.50,$56021.00,49,$-517.50
2024-03-07,12:29:00,18124.5,SELL,3,0.02h,Stop Loss,$-9.00,$-526.50,$56012.00,49,$-526.50
2024-03-07,12:34:00,18372.25,BUY,3,0.02h,Break Even,$-1.50,$-528.00,$56010.50,49,$-528.00
2024-03-07,12:46:00,18122.5,SELL,3,0.02h,Break Even,$-1.50,$-529.50,$56009.00,49,$-529.50
2024-03-07,12:58:00,18364.25,BUY,3,0.02h,Stop Loss,$-9.00,$-538.50,$56000.00,49,$-538.50
2024-03-07,12:59:00,18121.0,SELL,3,0.02h,Stop Loss,$-9.00,$-547.50,$55991.00,49,$-547.50
2024-03-07,13:00:00,18364.75,BUY,3,0.03h,Break Even,$-1.50,$-549.00,$55989.50,49,$-549.00
2024-03-07,13:03:00,18117.0,SELL,3,0.02h,Stop Loss,$-9.00,$-558.00,$55980.50,49,$-558.00
2024-03-07,13:04:00,18361.25,BUY,3,0.02h,Stop Loss,$-9.00,$-567.00,$55971.50,49,$-567.00
2024-03-07,13:15:00,18119.0,SELL,3,0.02h,Stop Loss,$-9.00,$-576.00,$55962.50,49,$-576.00
2024-03-07,13:16:00,18371.5,BUY,3,0.02h,Stop Loss,$-9.00,$-585.00,$55953.50,49,$-585.00
2024-03-07,13:17:00,18146.25,SELL,3,0.02h,Stop Loss,$-9.00,$-594.00,$55944.50,49,$-594.00
2024-03-07,13:18:00,18386.0,BUY,3,0.02h,Stop Loss,$-9.00,$-603.00,$55935.50,49,$-603.00
2024-03-07,13:19:00,18141.75,SELL,3,0.02h,Stop Loss,$-9.00,$-612.00,$55926.50,49,$-612.00
2024-03-07,13:21:00,18384.75,BUY,3,0.02h,Stop Loss,$-9.00,$-621.00,$55917.50,49,$-621.00
2024-03-07,13:22:00,18134.75,SELL,3,0.02h,Stop Loss,$-9.00,$-630.00,$55908.50,49,$-630.00
2024-03-07,13:24:00,18387.0,BUY,3,0.02h,Stop Loss,$-9.00,$-639.00,$55899.50,49,$-639.00
2024-03-07,13:27:00,18141.0,SELL,3,0.02h,Stop Loss,$-9.00,$-648.00,$55890.50,49,$-648.00
2024-03-07,13:28:00,18385.0,BUY,3,0.02h,Stop Loss,$-9.00,$-657.00,$55881.50,49,$-657.00
2024-03-07,13:35:00,18151.0,SELL,3,0.02h,Break Even,$-1.50,$-658.50,$55880.00,49,$-658.50
2024-03-07,13:37:00,18399.0,BUY,3,0.02h,Break Even,$-1.50,$-660.00,$55878.50,49,$-660.00
2024-03-07,13:40:00,18147.5,SELL,3,0.02h,Stop Loss,$-9.00,$-669.00,$55869.50,49,$-669.00
2024-03-07,13:41:00,18385.0,BUY,3,0.02h,Stop Loss,$-9.00,$-678.00,$55860.50,49,$-678.00
2024-03-07,13:42:00,18151.25,SELL,3,0.02h,Stop Loss,$27.00,$-651.00,$55887.50,49,$-651.00
2024-03-07,13:44:00,18400.75,BUY,3,0.02h,Stop Loss,$-9.00,$-660.00,$55878.50,49,$-660.00
2024-03-07,13:45:00,18158.75,SELL,3,0.02h,Break Even,$-1.50,$-661.50,$55877.00,49,$-661.50
2024-03-07,13:47:00,18405.0,BUY,3,0.02h,Stop Loss,$-9.00,$-670.50,$55868.00,49,$-670.50
2024-03-07,13:48:00,18158.0,SELL,3,0.02h,Stop Loss,$4.50,$-666.00,$55872.50,49,$-666.00
2024-03-07,13:54:00,18393.75,BUY,3,0.02h,Stop Loss,$10.50,$-655.50,$55883.00,49,$-655.50
2024-03-07,14:00:00,18152.75,SELL,3,0.02h,Stop Loss,$-9.00,$-664.50,$55874.00,49,$-664.50
2024-03-07,14:01:00,18390.0,BUY,3,0.02h,Stop Loss,$10.50,$-654.00,$55884.50,49,$-654.00
2024-03-07,14:10:00,18146.5,SELL,3,0.02h,Stop Loss,$6.00,$-648.00,$55890.50,49,$-648.00
2024-03-07,14:14:00,18396.75,BUY,3,0.02h,Stop Loss,$-9.00,$-657.00,$55881.50,49,$-657.00
2024-03-07,14:15:00,18154.5,SELL,3,0.02h,Stop Loss,$-9.00,$-666.00,$55872.50,49,$-666.00
2024-03-07,14:16:00,18400.0,BUY,3,0.02h,Stop Loss,$-9.00,$-675.00,$55863.50,49,$-675.00
2024-03-07,14:17:00,18153.75,SELL,3,0.02h,Stop Loss,$-9.00,$-684.00,$55854.50,49,$-684.00
2024-03-07,14:18:00,18398.75,BUY,3,0.02h,Stop Loss,$85.50,$-598.50,$55940.00,49,$-598.50
2024-03-07,14:23:00,18179.0,SELL,3,0.02h,Break Even,$-1.50,$-600.00,$55938.50,49,$-600.00
2024-03-07,14:30:00,18428.25,BUY,3,0.02h,Stop Loss,$42.00,$-558.00,$55980.50,49,$-558.00
2024-03-07,14:38:00,18216.25,SELL,3,0.02h,Stop Loss,$-9.00,$-567.00,$55971.50,49,$-567.00
2024-03-07,14:39:00,18453.75,BUY,3,0.02h,Stop Loss,$4.50,$-562.50,$55976.00,49,$-562.50
2024-03-07,14:46:00,18144.5,SELL,3,0.02h,Stop Loss,$132.00,$-430.50,$56108.00,49,$-430.50
2024-03-07,14:51:00,18408.25,BUY,3,0.02h,Stop Loss,$-9.00,$-439.50,$56099.00,49,$-439.50
2024-03-07,14:52:00,18184.5,SELL,3,0.02h,Break Even,$-1.50,$-441.00,$56097.50,49,$-441.00
2024-03-07,14:59:00,18431.0,BUY,3,0.02h,Stop Loss,$-9.00,$-450.00,$56088.50,49,$-450.00
2024-03-07,15:00:00,18192.75,SELL,3,0.02h,Stop Loss,$-9.00,$-459.00,$56079.50,49,$-459.00
2024-03-07,15:01:00,18434.0,BUY,3,0.02h,Stop Loss,$24.00,$-435.00,$56103.50,49,$-435.00
2024-03-07,15:04:00,18186.75,SELL,3,0.02h,Stop Loss,$45.00,$-390.00,$56148.50,49,$-390.00
2024-03-07,15:10:00,18435.5,BUY,3,0.02h,Stop Loss,$-9.00,$-399.00,$56139.50,49,$-399.00
2024-03-07,15:12:00,18207.75,SELL,3,0.02h,Break Even,$-1.50,$-400.50,$56138.00,49,$-400.50
2024-03-07,15:16:00,18474.75,BUY,3,0.02h,Stop Loss,$-9.00,$-409.50,$56129.00,49,$-409.50
2024-03-07,15:18:00,18220.25,SELL,3,0.02h,Stop Loss,$-9.00,$-418.50,$56120.00,49,$-418.50
2024-03-07,15:19:00,18457.75,BUY,3,0.02h,Stop Loss,$-9.00,$-427.50,$56111.00,49,$-427.50
2024-03-07,15:21:00,18226.0,SELL,3,0.02h,Break Even,$-1.50,$-429.00,$56109.50,49,$-429.00
2024-03-07,15:23:00,18471.5,BUY,3,0.02h,Stop Loss,$-9.00,$-438.00,$56100.50,49,$-438.00
2024-03-07,15:32:00,18226.5,SELL,3,0.02h,Stop Loss,$-9.00,$-447.00,$56091.50,49,$-447.00
2024-03-07,15:33:00,18472.75,BUY,3,0.02h,Stop Loss,$-9.00,$-456.00,$56082.50,49,$-456.00
2024-03-07,15:34:00,18233.0,SELL,3,0.02h,Stop Loss,$-9.00,$-465.00,$56073.50,49,$-465.00
2024-03-07,15:39:00,18492.75,BUY,3,0.02h,Stop Loss,$-9.00,$-474.00,$56064.50,49,$-474.00
2024-03-07,15:40:00,18251.75,SELL,3,0.02h,Break Even,$-1.50,$-475.50,$56063.00,49,$-475.50
2024-03-07,15:42:00,18500.25,BUY,3,0.02h,Stop Loss,$72.00,$-403.50,$56135.00,49,$-403.50
2024-03-07,15:53:00,18248.75,SELL,3,0.02h,Stop Loss,$-9.00,$-412.50,$56126.00,49,$-412.50
2024-03-07,15:54:00,18492.0,BUY,3,0.02h,Stop Loss,$25.50,$-387.00,$56151.50,49,$-387.00
2024-03-07,16:10:00,18263.75,SELL,3,0.02h,Stop Loss,$-9.00,$-396.00,$56142.50,49,$-396.00
2024-03-07,16:16:00,18517.0,BUY,3,0.02h,Stop Loss,$-9.00,$-405.00,$56133.50,49,$-405.00
2024-03-07,16:17:00,18267.25,SELL,3,0.02h,Stop Loss,$37.50,$-367.50,$56171.00,49,$-367.50
2024-03-07,16:23:00,18524.5,BUY,3,0.02h,Stop Loss,$-9.00,$-376.50,$56162.00,49,$-376.50
2024-03-07,16:24:00,18269.5,SELL,3,0.02h,Stop Loss,$-9.00,$-385.50,$56153.00,49,$-385.50
2024-03-07,16:25:00,18535.25,BUY,3,0.02h,Stop Loss,$-9.00,$-394.50,$56144.00,49,$-394.50
2024-03-07,16:26:00,18287.5,SELL,3,0.02h,Stop Loss,$21.00,$-373.50,$56165.00,49,$-373.50
2024-03-07,16:29:00,18536.25,BUY,3,0.02h,Stop Loss,$12.00,$-361.50,$56177.00,49,$-361.50
2024-03-07,16:36:00,18267.25,SELL,3,0.02h,Break Even,$-1.50,$-363.00,$56175.50,49,$-363.00
2024-03-07,16:41:00,18534.75,BUY,3,0.02h,Break Even,$-1.50,$-364.50,$56174.00,49,$-364.50
2024-03-07,16:44:00,18289.25,SELL,3,0.02h,Break Even,$-1.50,$-366.00,$56172.50,49,$-366.00
2024-03-07,16:52:00,18533.0,BUY,3,0.02h,Break Even,$-1.50,$-367.50,$56171.00,49,$-367.50
2024-03-07,17:05:00,18305.25,SELL,3,0.02h,Break Even,$-1.50,$-369.00,$56169.50,49,$-369.00
2024-03-07,17:12:00,18563.0,BUY,3,0.02h,Break Even,$-1.50,$-370.50,$56168.00,49,$-370.50
2024-03-07,17:19:00,18319.75,SELL,3,0.02h,Break Even,$-1.50,$-372.00,$56166.50,49,$-372.00
2024-03-07,17:23:00,18563.0,BUY,3,0.02h,Stop Loss,$-9.00,$-381.00,$56157.50,49,$-381.00
2024-03-07,17:24:00,18306.75,SELL,3,0.02h,Stop Loss,$-9.00,$-390.00,$56148.50,49,$-390.00
2024-03-07,17:25:00,18565.25,BUY,3,0.02h,Stop Loss,$-9.00,$-399.00,$56139.50,49,$-399.00
2024-03-07,17:26:00,18317.25,SELL,3,0.02h,Stop Loss,$-9.00,$-408.00,$56130.50,49,$-408.00
2024-03-07,17:35:00,18553.5,BUY,3,0.02h,Stop Loss,$24.00,$-384.00,$56154.50,49,$-384.00
2024-03-07,17:39:00,18311.5,SELL,3,0.02h,Stop Loss,$21.00,$-363.00,$56175.50,49,$-363.00
2024-03-07,17:52:00,18555.5,BUY,3,0.02h,Stop Loss,$24.00,$-339.00,$56199.50,49,$-339.00
2024-03-07,18:02:00,18312.0,SELL,3,0.02h,Break Even,$-1.50,$-340.50,$56198.00,49,$-340.50
2024-03-07,18:05:00,18556.5,BUY,3,0.02h,Stop Loss,$-9.00,$-349.50,$56189.00,49,$-349.50
2024-03-07,18:06:00,18296.5,SELL,3,0.02h,Stop Loss,$-9.00,$-358.50,$56180.00,49,$-358.50
2024-03-07,18:07:00,18550.5,BUY,3,0.02h,Stop Loss,$9.00,$-349.50,$56189.00,49,$-349.50
2024-03-07,18:10:00,18312.75,SELL,3,0.02h,Stop Loss,$-9.00,$-358.50,$56180.00,49,$-358.50
2024-03-07,18:13:00,18563.0,BUY,3,0.02h,Stop Loss,$-9.00,$-367.50,$56171.00,49,$-367.50
2024-03-07,18:14:00,18310.0,SELL,3,0.02h,Stop Loss,$-9.00,$-376.50,$56162.00,49,$-376.50
2024-03-07,18:15:00,18558.5,BUY,3,0.02h,Stop Loss,$43.50,$-333.00,$56205.50,49,$-333.00
2024-03-07,18:28:00,18320.25,SELL,3,0.02h,Stop Loss,$-9.00,$-342.00,$56196.50,49,$-342.00
2024-03-07,18:29:00,18572.25,BUY,3,0.02h,Stop Loss,$15.00,$-327.00,$56211.50,49,$-327.00
2024-03-07,18:32:00,18325.0,SELL,3,0.02h,Break Even,$-1.50,$-328.50,$56210.00,49,$-328.50
2024-03-07,18:37:00,18589.5,BUY,3,0.02h,Stop Loss,$-9.00,$-337.50,$56201.00,49,$-337.50
2024-03-07,18:38:00,18335.25,SELL,3,0.02h,Stop Loss,$-9.00,$-346.50,$56192.00,49,$-346.50
2024-03-07,18:41:00,18591.5,BUY,3,0.02h,Stop Loss,$-9.00,$-355.50,$56183.00,49,$-355.50
2024-03-07,18:44:00,18340.5,SELL,3,0.02h,Stop Loss,$-9.00,$-364.50,$56174.00,49,$-364.50
2024-03-07,18:45:00,18593.5,BUY,3,0.02h,Stop Loss,$-9.00,$-373.50,$56165.00,49,$-373.50
2024-03-07,18:46:00,18341.0,SELL,3,0.02h,Stop Loss,$-9.00,$-382.50,$56156.00,49,$-382.50
2024-03-07,18:51:00,18602.0,BUY,3,0.02h,Stop Loss,$-9.00,$-391.50,$56147.00,49,$-391.50
2024-03-07,18:52:00,18351.75,SELL,3,0.02h,Stop Loss,$-9.00,$-400.50,$56138.00,49,$-400.50
2024-03-07,18:53:00,18603.75,BUY,3,0.02h,Stop Loss,$-9.00,$-409.50,$56129.00,49,$-409.50
2024-03-07,18:54:00,18348.5,SELL,3,0.02h,Stop Loss,$-9.00,$-418.50,$56120.00,49,$-418.50
2024-03-07,18:56:00,18605.75,BUY,3,0.02h,Stop Loss,$-9.00,$-427.50,$56111.00,49,$-427.50
2024-03-07,18:57:00,18358.5,SELL,3,0.02h,Stop Loss,$4.50,$-423.00,$56115.50,49,$-423.00
2024-03-07,18:59:00,18607.5,BUY,3,0.02h,Break Even,$-1.50,$-424.50,$56114.00,49,$-424.50
2024-03-07,19:14:00,18347.0,SELL,3,0.02h,Stop Loss,$-9.00,$-433.50,$56105.00,49,$-433.50
2024-03-07,19:26:00,18588.5,BUY,3,0.02h,Stop Loss,$-9.00,$-442.50,$56096.00,49,$-442.50
2024-03-07,19:27:00,18341.0,SELL,3,0.02h,Break Even,$-1.50,$-444.00,$56094.50,49,$-444.00
2024-03-07,19:33:00,18593.25,BUY,3,0.02h,Stop Loss,$-9.00,$-453.00,$56085.50,49,$-453.00
2024-03-07,19:36:00,18345.75,SELL,3,0.02h,Break Even,$-1.50,$-454.50,$56084.00,49,$-454.50
2024-03-07,19:38:00,18595.75,BUY,3,0.02h,Break Even,$-1.50,$-456.00,$56082.50,49,$-456.00
2024-03-07,19:44:00,18347.0,SELL,3,0.02h,Stop Loss,$15.00,$-441.00,$56097.50,49,$-441.00
2024-03-07,19:52:00,18601.75,BUY,3,0.02h,Stop Loss,$-9.00,$-450.00,$56088.50,49,$-450.00
2024-03-07,20:00:00,18326.75,SELL,3,0.02h,Stop Loss,$208.50,$-241.50,$56297.00,49,$-241.50
2024-03-07,20:06:00,18563.75,BUY,3,0.02h,Stop Loss,$-9.00,$-250.50,$56288.00,49,$-250.50
2024-03-07,20:07:00,18321.25,SELL,3,0.02h,Stop Loss,$16.50,$-234.00,$56304.50,49,$-234.00
2024-03-07,20:18:00,18558.25,BUY,3,0.02h,Break Even,$-1.50,$-235.50,$56303.00,49,$-235.50
2024-03-07,20:21:00,18305.0,SELL,3,0.02h,Stop Loss,$4.50,$-231.00,$56307.50,49,$-231.00
2024-03-07,20:26:00,18556.5,BUY,3,0.02h,Stop Loss,$-9.00,$-240.00,$56298.50,49,$-240.00
2024-03-07,20:27:00,18305.75,SELL,3,0.02h,Break Even,$-1.50,$-241.50,$56297.00,49,$-241.50
2024-03-07,20:29:00,18551.5,BUY,3,0.02h,Stop Loss,$-9.00,$-250.50,$56288.00,49,$-250.50
2024-03-07,20:30:00,18303.75,SELL,3,0.02h,Break Even,$-1.50,$-252.00,$56286.50,49,$-252.00
2024-03-07,20:32:00,18557.75,BUY,3,0.02h,Stop Loss,$34.50,$-217.50,$56321.00,49,$-217.50
2024-03-07,20:50:00,18313.25,SELL,3,0.02h,Stop Loss,$-9.00,$-226.50,$56312.00,49,$-226.50
2024-03-07,20:54:00,18570.75,BUY,3,0.02h,Stop Loss,$54.00,$-172.50,$56366.00,49,$-172.50
2024-03-07,20:56:00,18333.0,SELL,3,0.02h,Stop Loss,$81.00,$-91.50,$56447.00,49,$-91.50
2024-03-07,21:05:00,18542.75,BUY,3,0.02h,Stop Loss,$-9.00,$-100.50,$56438.00,49,$-100.50
2024-03-07,21:06:00,18253.5,SELL,3,0.02h,Stop Loss,$-9.00,$-109.50,$56429.00,49,$-109.50
2024-03-07,21:12:00,18509.5,BUY,3,0.02h,Break Even,$-1.50,$-111.00,$56427.50,49,$-111.00
2024-03-07,21:14:00,18267.5,SELL,3,0.02h,Stop Loss,$-9.00,$-120.00,$56418.50,49,$-120.00
2024-03-07,21:15:00,18515.0,BUY,3,0.02h,Stop Loss,$-9.00,$-129.00,$56409.50,49,$-129.00
2024-03-07,21:16:00,18204.25,SELL,3,0.02h,Stop Loss,$249.00,$120.00,$56658.50,49,$120.00
2024-03-07,21:31:00,18479.0,BUY,3,0.02h,Stop Loss,$-9.00,$111.00,$56649.50,49,$111.00
2024-03-07,21:32:00,18229.0,SELL,3,0.02h,Stop Loss,$-9.00,$102.00,$56640.50,49,$102.00
2024-03-07,21:33:00,18480.0,BUY,3,0.02h,Stop Loss,$-9.00,$93.00,$56631.50,49,$93.00
2024-03-07,21:34:00,18224.75,SELL,3,0.02h,Stop Loss,$46.50,$139.50,$56678.00,49,$139.50
2024-03-07,21:37:00,18471.25,BUY,3,0.02h,Stop Loss,$132.00,$271.50,$56810.00,49,$271.50
2024-03-07,21:43:00,18244.0,SELL,3,0.02h,Stop Loss,$-9.00,$262.50,$56801.00,49,$262.50
2024-03-07,21:44:00,18487.5,BUY,3,0.02h,Stop Loss,$-9.00,$253.50,$56792.00,49,$253.50
2024-03-07,21:45:00,18238.0,SELL,3,0.02h,Stop Loss,$24.00,$277.50,$56816.00,49,$277.50
2024-03-07,21:48:00,18493.0,BUY,3,0.02h,Stop Loss,$-9.00,$268.50,$56807.00,49,$268.50
2024-03-07,21:49:00,18246.25,SELL,3,0.02h,Stop Loss,$-9.00,$259.50,$56798.00,49,$259.50
2024-03-07,21:50:00,18489.5,BUY,3,0.02h,Break Even,$-1.50,$258.00,$56796.50,49,$258.00
2024-03-07,21:56:00,18261.0,SELL,3,0.02h,Stop Loss,$-9.00,$249.00,$56787.50,49,$249.00
2024-03-07,21:57:00,18505.25,BUY,3,0.02h,Stop Loss,$-9.00,$240.00,$56778.50,49,$240.00
2024-03-07,21:59:00,18253.0,SELL,3,1.03h,Stop Loss,$-9.00,$231.00,$56769.50,49,$231.00
2024-03-07,23:01:00,18527.75,BUY,3,0.02h,Stop Loss,$-9.00,$222.00,$56760.50,49,$222.00
2024-03-07,23:02:00,18267.25,SELL,3,0.02h,Stop Loss,$18.00,$240.00,$56778.50,49,$240.00
2024-03-07,23:06:00,18509.25,BUY,3,0.02h,Stop Loss,$85.50,$325.50,$56864.00,49,$325.50
2024-03-07,23:12:00,18263.25,SELL,3,0.02h,Break Even,$-1.50,$324.00,$56862.50,49,$324.00
2024-03-07,23:21:00,18524.25,BUY,3,0.02h,Break Even,$-1.50,$322.50,$56861.00,49,$322.50
2024-03-07,23:35:00,18266.0,SELL,3,0.03h,Stop Loss,$-9.00,$313.50,$56852.00,49,$313.50
2024-03-07,23:38:00,18511.0,BUY,3,0.02h,Stop Loss,$-9.00,$304.50,$56843.00,49,$304.50
2024-03-07,23:39:00,18264.25,SELL,3,0.02h,Break Even,$-1.50,$303.00,$56841.50,49,$303.00
2024-03-07,23:48:00,18513.25,BUY,3,0.03h,Stop Loss,$-9.00,$294.00,$56832.50,49,$294.00
2024-03-07,23:55:00,18263.0,SELL,3,0.02h,Stop Loss,$-9.00,$285.00,$56823.50,49,$285.00
2024-03-07,23:56:00,18511.0,BUY,3,0.02h,Stop Loss,$-9.00,$276.00,$56814.50,49,$276.00
,,,,,,,,,,,
2024-03-08,00:03:00,18271.0,SELL,3,0.02h,Break Even,$-1.50,$-1.50,$56813.00,50,$-1.50
2024-03-08,00:10:00,18504.25,BUY,3,0.02h,Stop Loss,$7.50,$6.00,$56820.50,50,$6.00
2024-03-08,00:14:00,18253.75,SELL,3,0.02h,Stop Loss,$-9.00,$-3.00,$56811.50,50,$-3.00
2024-03-08,00:28:00,18523.0,BUY,3,0.02h,Stop Loss,$-9.00,$-12.00,$56802.50,50,$-12.00
2024-03-08,00:44:00,18271.5,SELL,3,0.02h,Stop Loss,$-9.00,$-21.00,$56793.50,50,$-21.00
2024-03-08,00:46:00,18524.25,BUY,3,0.02h,Stop Loss,$-9.00,$-30.00,$56784.50,50,$-30.00
2024-03-08,00:47:00,18273.25,SELL,3,0.02h,Stop Loss,$-9.00,$-39.00,$56775.50,50,$-39.00
2024-03-08,00:48:00,18528.0,BUY,3,0.02h,Break Even,$-1.50,$-40.50,$56774.00,50,$-40.50
2024-03-08,00:54:00,18272.25,SELL,3,0.02h,Stop Loss,$-9.00,$-49.50,$56765.00,50,$-49.50
2024-03-08,00:55:00,18521.5,BUY,3,0.02h,Stop Loss,$-9.00,$-58.50,$56756.00,50,$-58.50
2024-03-08,00:59:00,18266.5,SELL,3,0.02h,Stop Loss,$-9.00,$-67.50,$56747.00,50,$-67.50
2024-03-08,01:01:00,18520.5,BUY,3,0.02h,Stop Loss,$-9.00,$-76.50,$56738.00,50,$-76.50
2024-03-08,01:02:00,18269.0,SELL,3,0.02h,Stop Loss,$-9.00,$-85.50,$56729.00,50,$-85.50
2024-03-08,01:03:00,18516.0,BUY,3,0.02h,Stop Loss,$-9.00,$-94.50,$56720.00,50,$-94.50
2024-03-08,01:09:00,18259.75,SELL,3,0.03h,Stop Loss,$-9.00,$-103.50,$56711.00,50,$-103.50
2024-03-08,01:19:00,18517.0,BUY,3,0.03h,Stop Loss,$-9.00,$-112.50,$56702.00,50,$-112.50
2024-03-08,01:21:00,18261.75,SELL,3,0.02h,Stop Loss,$-9.00,$-121.50,$56693.00,50,$-121.50
2024-03-08,01:22:00,18513.5,BUY,3,0.02h,Stop Loss,$-9.00,$-130.50,$56684.00,50,$-130.50
2024-03-08,01:23:00,18265.5,SELL,3,0.03h,Stop Loss,$-9.00,$-139.50,$56675.00,50,$-139.50
2024-03-08,01:38:00,18521.25,BUY,3,0.02h,Stop Loss,$-9.00,$-148.50,$56666.00,50,$-148.50
2024-03-08,01:53:00,18272.75,SELL,3,0.02h,Stop Loss,$-9.00,$-157.50,$56657.00,50,$-157.50
2024-03-08,01:54:00,18525.5,BUY,3,0.02h,Stop Loss,$-9.00,$-166.50,$56648.00,50,$-166.50
2024-03-08,02:02:00,18271.75,SELL,3,0.02h,Stop Loss,$-9.00,$-175.50,$56639.00,50,$-175.50
2024-03-08,02:03:00,18518.75,BUY,3,0.02h,Stop Loss,$-9.00,$-184.50,$56630.00,50,$-184.50
2024-03-08,02:05:00,18266.5,SELL,3,0.02h,Stop Loss,$-9.00,$-193.50,$56621.00,50,$-193.50
2024-03-08,02:19:00,18521.75,BUY,3,0.03h,Stop Loss,$-9.00,$-202.50,$56612.00,50,$-202.50
2024-03-08,02:26:00,18268.75,SELL,3,0.02h,Stop Loss,$-9.00,$-211.50,$56603.00,50,$-211.50
2024-03-08,02:27:00,18519.0,BUY,3,0.05h,Break Even,$-1.50,$-213.00,$56601.50,50,$-213.00
2024-03-08,02:34:00,18265.75,SELL,3,0.02h,Stop Loss,$-9.00,$-222.00,$56592.50,50,$-222.00
2024-03-08,02:35:00,18518.0,BUY,3,0.02h,Stop Loss,$-9.00,$-231.00,$56583.50,50,$-231.00
2024-03-08,02:36:00,18268.25,SELL,3,0.02h,Stop Loss,$-9.00,$-240.00,$56574.50,50,$-240.00
2024-03-08,02:37:00,18520.0,BUY,3,0.02h,Stop Loss,$-9.00,$-249.00,$56565.50,50,$-249.00
2024-03-08,02:39:00,18269.0,SELL,3,0.02h,Stop Loss,$-9.00,$-258.00,$56556.50,50,$-258.00
2024-03-08,02:40:00,18516.75,BUY,3,0.02h,Stop Loss,$-9.00,$-267.00,$56547.50,50,$-267.00
2024-03-08,02:41:00,18265.75,SELL,3,0.03h,Stop Loss,$-9.00,$-276.00,$56538.50,50,$-276.00
2024-03-08,02:48:00,18514.75,BUY,3,0.02h,Stop Loss,$-9.00,$-285.00,$56529.50,50,$-285.00
2024-03-08,02:49:00,18262.75,SELL,3,0.02h,Stop Loss,$-9.00,$-294.00,$56520.50,50,$-294.00
2024-03-08,03:02:00,18515.0,BUY,3,0.02h,Stop Loss,$-9.00,$-303.00,$56511.50,50,$-303.00
2024-03-08,03:03:00,18265.75,SELL,3,0.07h,Stop Loss,$7.50,$-295.50,$56519.00,50,$-295.50
2024-03-08,03:07:00,18519.0,BUY,3,0.02h,Stop Loss,$-9.00,$-304.50,$56510.00,50,$-304.50
2024-03-08,03:08:00,18268.5,SELL,3,0.02h,Stop Loss,$15.00,$-289.50,$56525.00,50,$-289.50
2024-03-08,03:17:00,18519.25,BUY,3,0.08h,Break Even,$-1.50,$-291.00,$56523.50,50,$-291.00
2024-03-08,03:33:00,18286.0,SELL,3,0.02h,Stop Loss,$-9.00,$-300.00,$56514.50,50,$-300.00
2024-03-08,03:34:00,18537.25,BUY,3,0.02h,Stop Loss,$-9.00,$-309.00,$56505.50,50,$-309.00
2024-03-08,03:35:00,18287.0,SELL,3,0.02h,Stop Loss,$-9.00,$-318.00,$56496.50,50,$-318.00
2024-03-08,03:44:00,18539.5,BUY,3,0.02h,Stop Loss,$-9.00,$-327.00,$56487.50,50,$-327.00
2024-03-08,03:48:00,18288.0,SELL,3,0.03h,Break Even,$-1.50,$-328.50,$56486.00,50,$-328.50
2024-03-08,03:52:00,18539.25,BUY,3,0.02h,Stop Loss,$-9.00,$-337.50,$56477.00,50,$-337.50
2024-03-08,03:53:00,18287.0,SELL,3,0.02h,Stop Loss,$-9.00,$-346.50,$56468.00,50,$-346.50
2024-03-08,03:54:00,18541.75,BUY,3,0.02h,Stop Loss,$-9.00,$-355.50,$56459.00,50,$-355.50
2024-03-08,03:56:00,18288.75,SELL,3,0.02h,Stop Loss,$-9.00,$-364.50,$56450.00,50,$-364.50
2024-03-08,03:58:00,18539.5,BUY,3,0.03h,Stop Loss,$-9.00,$-373.50,$56441.00,50,$-373.50
2024-03-08,04:11:00,18293.5,SELL,3,0.02h,Stop Loss,$-9.00,$-382.50,$56432.00,50,$-382.50
2024-03-08,04:13:00,18547.25,BUY,3,0.02h,Break Even,$-1.50,$-384.00,$56430.50,50,$-384.00
2024-03-08,04:15:00,18296.0,SELL,3,0.02h,Stop Loss,$-9.00,$-393.00,$56421.50,50,$-393.00
2024-03-08,04:21:00,18560.0,BUY,3,0.02h,Break Even,$-1.50,$-394.50,$56420.00,50,$-394.50
2024-03-08,04:26:00,18302.25,SELL,3,0.02h,Stop Loss,$-9.00,$-403.50,$56411.00,50,$-403.50
2024-03-08,04:27:00,18553.0,BUY,3,0.02h,Stop Loss,$-9.00,$-412.50,$56402.00,50,$-412.50
2024-03-08,04:28:00,18300.5,SELL,3,0.02h,Break Even,$-1.50,$-414.00,$56400.50,50,$-414.00
2024-03-08,04:30:00,18549.25,BUY,3,0.02h,Stop Loss,$-9.00,$-423.00,$56391.50,50,$-423.00
2024-03-08,04:36:00,18287.25,SELL,3,0.02h,Stop Loss,$-9.00,$-432.00,$56382.50,50,$-432.00
2024-03-08,04:45:00,18537.75,BUY,3,0.03h,Stop Loss,$-9.00,$-441.00,$56373.50,50,$-441.00
2024-03-08,04:48:00,18284.75,SELL,3,0.02h,Stop Loss,$-9.00,$-450.00,$56364.50,50,$-450.00
2024-03-08,04:49:00,18538.25,BUY,3,0.03h,Break Even,$-1.50,$-451.50,$56363.00,50,$-451.50
2024-03-08,04:52:00,18289.0,SELL,3,0.02h,Stop Loss,$18.00,$-433.50,$56381.00,50,$-433.50
2024-03-08,04:55:00,18537.0,BUY,3,0.02h,Stop Loss,$-9.00,$-442.50,$56372.00,50,$-442.50
2024-03-08,05:03:00,18281.5,SELL,3,0.02h,Stop Loss,$-9.00,$-451.50,$56363.00,50,$-451.50
2024-03-08,05:04:00,18535.0,BUY,3,0.02h,Stop Loss,$-9.00,$-460.50,$56354.00,50,$-460.50
2024-03-08,05:05:00,18283.0,SELL,3,0.02h,Stop Loss,$-9.00,$-469.50,$56345.00,50,$-469.50
2024-03-08,05:08:00,18533.75,BUY,3,0.02h,Stop Loss,$-9.00,$-478.50,$56336.00,50,$-478.50
2024-03-08,05:10:00,18281.0,SELL,3,0.03h,Stop Loss,$-9.00,$-487.50,$56327.00,50,$-487.50
2024-03-08,05:23:00,18534.25,BUY,3,0.02h,Stop Loss,$-9.00,$-496.50,$56318.00,50,$-496.50
2024-03-08,05:24:00,18279.75,SELL,3,0.02h,Stop Loss,$-9.00,$-505.50,$56309.00,50,$-505.50
2024-03-08,05:25:00,18531.5,BUY,3,0.03h,Break Even,$-1.50,$-507.00,$56307.50,50,$-507.00
2024-03-08,05:28:00,18282.75,SELL,3,0.02h,Stop Loss,$-9.00,$-516.00,$56298.50,50,$-516.00
2024-03-08,05:31:00,18538.75,BUY,3,0.13h,Stop Loss,$28.50,$-487.50,$56327.00,50,$-487.50
2024-03-08,05:46:00,18289.75,SELL,3,0.02h,Stop Loss,$-9.00,$-496.50,$56318.00,50,$-496.50
2024-03-08,05:52:00,18543.75,BUY,3,0.02h,Stop Loss,$-9.00,$-505.50,$56309.00,50,$-505.50
2024-03-08,05:58:00,18291.0,SELL,3,0.02h,Stop Loss,$-9.00,$-514.50,$56300.00,50,$-514.50
2024-03-08,06:08:00,18540.25,BUY,3,0.02h,Stop Loss,$-9.00,$-523.50,$56291.00,50,$-523.50
2024-03-08,06:17:00,18291.0,SELL,3,0.02h,Break Even,$-1.50,$-525.00,$56289.50,50,$-525.00
2024-03-08,06:22:00,18538.75,BUY,3,0.02h,Stop Loss,$-9.00,$-534.00,$56280.50,50,$-534.00
2024-03-08,06:23:00,18286.25,SELL,3,0.02h,Stop Loss,$-9.00,$-543.00,$56271.50,50,$-543.00
2024-03-08,06:26:00,18539.0,BUY,3,0.02h,Stop Loss,$-9.00,$-552.00,$56262.50,50,$-552.00
2024-03-08,06:27:00,18286.5,SELL,3,0.03h,Stop Loss,$-9.00,$-561.00,$56253.50,50,$-561.00
2024-03-08,06:37:00,18543.75,BUY,3,0.03h,Stop Loss,$-9.00,$-570.00,$56244.50,50,$-570.00
2024-03-08,06:40:00,18289.0,SELL,3,0.02h,Stop Loss,$-9.00,$-579.00,$56235.50,50,$-579.00
2024-03-08,06:41:00,18540.75,BUY,3,0.02h,Stop Loss,$-9.00,$-588.00,$56226.50,50,$-588.00
2024-03-08,06:42:00,18287.5,SELL,3,0.02h,Stop Loss,$-9.00,$-597.00,$56217.50,50,$-597.00
2024-03-08,06:43:00,18537.5,BUY,3,0.02h,Break Even,$-1.50,$-598.50,$56216.00,50,$-598.50
2024-03-08,06:58:00,18287.25,SELL,3,0.02h,Break Even,$-1.50,$-600.00,$56214.50,50,$-600.00
2024-03-08,07:06:00,18531.75,BUY,3,0.02h,Stop Loss,$-9.00,$-609.00,$56205.50,50,$-609.00
2024-03-08,07:07:00,18278.75,SELL,3,0.02h,Stop Loss,$-9.00,$-618.00,$56196.50,50,$-618.00
2024-03-08,07:08:00,18529.75,BUY,3,0.05h,Stop Loss,$10.50,$-607.50,$56207.00,50,$-607.50
2024-03-08,07:15:00,18281.5,SELL,3,0.02h,Stop Loss,$-9.00,$-616.50,$56198.00,50,$-616.50
2024-03-08,07:16:00,18536.0,BUY,3,0.02h,Stop Loss,$-9.00,$-625.50,$56189.00,50,$-625.50
2024-03-08,07:18:00,18285.25,SELL,3,0.02h,Stop Loss,$-9.00,$-634.50,$56180.00,50,$-634.50
2024-03-08,07:27:00,18538.5,BUY,3,0.02h,Stop Loss,$-9.00,$-643.50,$56171.00,50,$-643.50
2024-03-08,07:28:00,18284.0,SELL,3,0.02h,Stop Loss,$-9.00,$-652.50,$56162.00,50,$-652.50
2024-03-08,07:29:00,18540.0,BUY,3,0.02h,Stop Loss,$-9.00,$-661.50,$56153.00,50,$-661.50
2024-03-08,07:32:00,18289.25,SELL,3,0.02h,Stop Loss,$7.50,$-654.00,$56160.50,50,$-654.00
2024-03-08,07:36:00,18541.5,BUY,3,0.02h,Stop Loss,$-9.00,$-663.00,$56151.50,50,$-663.00
2024-03-08,07:38:00,18291.0,SELL,3,0.02h,Stop Loss,$-9.00,$-672.00,$56142.50,50,$-672.00
2024-03-08,07:47:00,18550.75,BUY,3,0.02h,Break Even,$-1.50,$-673.50,$56141.00,50,$-673.50
2024-03-08,07:56:00,18296.5,SELL,3,0.02h,Stop Loss,$-9.00,$-682.50,$56132.00,50,$-682.50
2024-03-08,07:57:00,18549.75,BUY,3,0.02h,Stop Loss,$-9.00,$-691.50,$56123.00,50,$-691.50
2024-03-08,08:02:00,18297.0,SELL,3,0.02h,Break Even,$-1.50,$-693.00,$56121.50,50,$-693.00
2024-03-08,08:12:00,18570.5,BUY,3,0.02h,Stop Loss,$21.00,$-672.00,$56142.50,50,$-672.00
2024-03-08,08:21:00,18315.75,SELL,3,0.02h,Stop Loss,$-9.00,$-681.00,$56133.50,50,$-681.00
2024-03-08,08:22:00,18568.75,BUY,3,0.02h,Stop Loss,$-9.00,$-690.00,$56124.50,50,$-690.00
2024-03-08,08:23:00,18316.25,SELL,3,0.02h,Break Even,$-1.50,$-691.50,$56123.00,50,$-691.50
2024-03-08,08:25:00,18575.5,BUY,3,0.02h,Stop Loss,$-9.00,$-700.50,$56114.00,50,$-700.50
2024-03-08,08:26:00,18324.75,SELL,3,0.02h,Break Even,$-1.50,$-702.00,$56112.50,50,$-702.00
2024-03-08,08:28:00,18574.25,BUY,3,0.02h,Stop Loss,$-9.00,$-711.00,$56103.50,50,$-711.00
2024-03-08,08:29:00,18321.0,SELL,3,0.02h,Stop Loss,$-9.00,$-720.00,$56094.50,50,$-720.00
2024-03-08,08:30:00,18579.25,BUY,3,0.02h,Stop Loss,$-9.00,$-729.00,$56085.50,50,$-729.00
2024-03-08,08:31:00,18323.0,SELL,3,0.02h,Break Even,$-1.50,$-730.50,$56084.00,50,$-730.50
2024-03-08,08:41:00,18580.0,BUY,3,0.02h,Stop Loss,$-9.00,$-739.50,$56075.00,50,$-739.50
2024-03-08,09:03:00,18315.5,SELL,3,0.02h,Stop Loss,$-9.00,$-748.50,$56066.00,50,$-748.50
2024-03-08,09:04:00,18573.25,BUY,3,0.02h,Stop Loss,$-9.00,$-757.50,$56057.00,50,$-757.50
2024-03-08,09:05:00,18324.0,SELL,3,0.02h,Stop Loss,$-9.00,$-766.50,$56048.00,50,$-766.50
2024-03-08,09:09:00,18575.0,BUY,3,0.02h,Stop Loss,$-9.00,$-775.50,$56039.00,50,$-775.50
2024-03-08,09:11:00,18322.75,SELL,3,0.02h,Stop Loss,$-9.00,$-784.50,$56030.00,50,$-784.50
2024-03-08,09:12:00,18574.0,BUY,3,0.02h,Stop Loss,$-9.00,$-793.50,$56021.00,50,$-793.50
2024-03-08,09:13:00,18319.5,SELL,3,0.02h,Stop Loss,$-9.00,$-802.50,$56012.00,50,$-802.50
2024-03-08,09:23:00,18579.25,BUY,3,0.02h,Stop Loss,$12.00,$-790.50,$56024.00,50,$-790.50
2024-03-08,09:26:00,18327.25,SELL,3,0.02h,Break Even,$-1.50,$-792.00,$56022.50,50,$-792.00
2024-03-08,09:30:00,18582.5,BUY,3,0.02h,Stop Loss,$16.50,$-775.50,$56039.00,50,$-775.50
2024-03-08,09:33:00,18330.0,SELL,3,0.02h,Break Even,$-1.50,$-777.00,$56037.50,50,$-777.00
2024-03-08,09:35:00,18582.25,BUY,3,0.02h,Stop Loss,$-9.00,$-786.00,$56028.50,50,$-786.00
2024-03-08,09:36:00,18330.5,SELL,3,0.02h,Break Even,$-1.50,$-787.50,$56027.00,50,$-787.50
2024-03-08,09:38:00,18581.0,BUY,3,0.02h,Stop Loss,$-9.00,$-796.50,$56018.00,50,$-796.50
2024-03-08,09:39:00,18332.5,SELL,3,0.02h,Break Even,$-1.50,$-798.00,$56016.50,50,$-798.00
2024-03-08,09:42:00,18592.0,BUY,3,0.02h,Stop Loss,$-9.00,$-807.00,$56007.50,50,$-807.00
2024-03-08,09:43:00,18335.75,SELL,3,0.02h,Stop Loss,$-9.00,$-816.00,$55998.50,50,$-816.00
2024-03-08,09:44:00,18591.5,BUY,3,0.03h,Stop Loss,$3.00,$-813.00,$56001.50,50,$-813.00
2024-03-08,09:48:00,18339.75,SELL,3,0.02h,Stop Loss,$-9.00,$-822.00,$55992.50,50,$-822.00
2024-03-08,09:49:00,18589.75,BUY,3,0.02h,Break Even,$-1.50,$-823.50,$55991.00,50,$-823.50
2024-03-08,09:58:00,18336.25,SELL,3,0.02h,Stop Loss,$-9.00,$-832.50,$55982.00,50,$-832.50
2024-03-08,10:06:00,18585.5,BUY,3,0.02h,Stop Loss,$-9.00,$-841.50,$55973.00,50,$-841.50
2024-03-08,10:07:00,18318.75,SELL,3,0.02h,Stop Loss,$-9.00,$-850.50,$55964.00,50,$-850.50
2024-03-08,10:12:00,18581.25,BUY,3,0.02h,Stop Loss,$-9.00,$-859.50,$55955.00,50,$-859.50
2024-03-08,10:13:00,18328.75,SELL,3,0.02h,Stop Loss,$15.00,$-844.50,$55970.00,50,$-844.50
2024-03-08,10:15:00,18574.0,BUY,3,0.02h,Stop Loss,$-9.00,$-853.50,$55961.00,50,$-853.50
2024-03-08,10:16:00,18321.5,SELL,3,0.02h,Stop Loss,$-9.00,$-862.50,$55952.00,50,$-862.50
2024-03-08,10:17:00,18577.0,BUY,3,0.02h,Stop Loss,$-9.00,$-871.50,$55943.00,50,$-871.50
2024-03-08,10:18:00,18323.25,SELL,3,0.02h,Stop Loss,$3.00,$-868.50,$55946.00,50,$-868.50
2024-03-08,10:20:00,18573.5,BUY,3,0.02h,Stop Loss,$-9.00,$-877.50,$55937.00,50,$-877.50
2024-03-08,10:26:00,18318.0,SELL,3,0.02h,Stop Loss,$7.50,$-870.00,$55944.50,50,$-870.00
2024-03-08,10:30:00,18565.25,BUY,3,0.02h,Stop Loss,$7.50,$-862.50,$55952.00,50,$-862.50
2024-03-08,10:35:00,18317.5,SELL,3,0.02h,Break Even,$-1.50,$-864.00,$55950.50,50,$-864.00
2024-03-08,10:45:00,18577.25,BUY,3,0.02h,Stop Loss,$-9.00,$-873.00,$55941.50,50,$-873.00
2024-03-08,10:46:00,18321.25,SELL,3,0.02h,Stop Loss,$-9.00,$-882.00,$55932.50,50,$-882.00
2024-03-08,10:47:00,18576.0,BUY,3,0.02h,Stop Loss,$-9.00,$-891.00,$55923.50,50,$-891.00
2024-03-08,10:56:00,18318.0,SELL,3,0.02h,Stop Loss,$-9.00,$-900.00,$55914.50,50,$-900.00
2024-03-08,10:57:00,18575.75,BUY,3,0.02h,Break Even,$-1.50,$-901.50,$55913.00,50,$-901.50
2024-03-08,11:06:00,18320.5,SELL,3,0.02h,Stop Loss,$-9.00,$-910.50,$55904.00,50,$-910.50
2024-03-08,11:14:00,18582.75,BUY,3,0.02h,Stop Loss,$-9.00,$-919.50,$55895.00,50,$-919.50
2024-03-08,11:15:00,18325.75,SELL,3,0.02h,Break Even,$-1.50,$-921.00,$55893.50,50,$-921.00
2024-03-08,11:17:00,18579.5,BUY,3,0.02h,Stop Loss,$-9.00,$-930.00,$55884.50,50,$-930.00
2024-03-08,11:19:00,18324.25,SELL,3,0.02h,Stop Loss,$-9.00,$-939.00,$55875.50,50,$-939.00
2024-03-08,11:20:00,18577.5,BUY,3,0.02h,Break Even,$-1.50,$-940.50,$55874.00,50,$-940.50
2024-03-08,11:24:00,18320.5,SELL,3,0.02h,Stop Loss,$-9.00,$-949.50,$55865.00,50,$-949.50
2024-03-08,11:25:00,18574.0,BUY,3,0.02h,Stop Loss,$-9.00,$-958.50,$55856.00,50,$-958.50
2024-03-08,11:27:00,18308.0,SELL,3,0.02h,Stop Loss,$-9.00,$-967.50,$55847.00,50,$-967.50
2024-03-08,11:28:00,18559.0,BUY,3,0.02h,Break Even,$-1.50,$-969.00,$55845.50,50,$-969.00
2024-03-08,11:30:00,18305.0,SELL,3,0.02h,Stop Loss,$21.00,$-948.00,$55866.50,50,$-948.00
2024-03-08,11:35:00,18553.5,BUY,3,0.02h,Stop Loss,$-9.00,$-957.00,$55857.50,50,$-957.00
2024-03-08,11:37:00,18295.0,SELL,3,0.02h,Stop Loss,$-9.00,$-966.00,$55848.50,50,$-966.00
2024-03-08,11:38:00,18548.5,BUY,3,0.02h,Stop Loss,$-9.00,$-975.00,$55839.50,50,$-975.00
2024-03-08,11:39:00,18295.25,SELL,3,0.02h,Break Even,$-1.50,$-976.50,$55838.00,50,$-976.50
2024-03-08,11:43:00,18542.5,BUY,3,0.02h,Stop Loss,$19.50,$-957.00,$55857.50,50,$-957.00
2024-03-08,11:50:00,18278.0,SELL,3,0.02h,Stop Loss,$21.00,$-936.00,$55878.50,50,$-936.00
2024-03-08,11:54:00,18533.75,BUY,3,0.02h,Stop Loss,$13.50,$-922.50,$55892.00,50,$-922.50
2024-03-08,11:57:00,18286.25,SELL,3,0.02h,Break Even,$-1.50,$-924.00,$55890.50,50,$-924.00
2024-03-08,12:02:00,18540.0,BUY,3,0.02h,Stop Loss,$-9.00,$-933.00,$55881.50,50,$-933.00
2024-03-08,12:03:00,18282.75,SELL,3,0.02h,Stop Loss,$-9.00,$-942.00,$55872.50,50,$-942.00
2024-03-08,12:04:00,18535.5,BUY,3,0.02h,Stop Loss,$16.50,$-925.50,$55889.00,50,$-925.50
2024-03-08,12:11:00,18293.0,SELL,3,0.02h,Break Even,$-1.50,$-927.00,$55887.50,50,$-927.00
2024-03-08,12:22:00,18523.5,BUY,3,0.02h,Stop Loss,$33.00,$-894.00,$55920.50,50,$-894.00
2024-03-08,12:26:00,18281.25,SELL,3,0.02h,Stop Loss,$-9.00,$-903.00,$55911.50,50,$-903.00
2024-03-08,12:31:00,18525.0,BUY,3,0.02h,Stop Loss,$9.00,$-894.00,$55920.50,50,$-894.00
2024-03-08,12:41:00,18269.5,SELL,3,0.02h,Stop Loss,$16.50,$-877.50,$55937.00,50,$-877.50
2024-03-08,12:47:00,18513.5,BUY,3,0.02h,Stop Loss,$36.00,$-841.50,$55973.00,50,$-841.50
2024-03-08,12:51:00,18260.75,SELL,3,0.02h,Stop Loss,$-9.00,$-850.50,$55964.00,50,$-850.50
2024-03-08,12:52:00,18510.5,BUY,3,0.02h,Stop Loss,$-9.00,$-859.50,$55955.00,50,$-859.50
2024-03-08,12:53:00,18254.75,SELL,3,0.02h,Stop Loss,$-9.00,$-868.50,$55946.00,50,$-868.50
2024-03-08,13:04:00,18534.75,BUY,3,0.02h,Stop Loss,$-9.00,$-877.50,$55937.00,50,$-877.50
2024-03-08,13:05:00,18281.75,SELL,3,0.02h,Stop Loss,$-9.00,$-886.50,$55928.00,50,$-886.50
2024-03-08,13:06:00,18524.75,BUY,3,0.02h,Stop Loss,$-9.00,$-895.50,$55919.00,50,$-895.50
2024-03-08,13:07:00,18279.25,SELL,3,0.02h,Stop Loss,$-9.00,$-904.50,$55910.00,50,$-904.50
2024-03-08,13:08:00,18538.0,BUY,3,0.02h,Stop Loss,$-9.00,$-913.50,$55901.00,50,$-913.50
2024-03-08,13:15:00,18287.25,SELL,3,0.02h,Stop Loss,$-9.00,$-922.50,$55892.00,50,$-922.50
2024-03-08,13:16:00,18541.25,BUY,3,0.02h,Stop Loss,$3.00,$-919.50,$55895.00,50,$-919.50
2024-03-08,13:22:00,18282.0,SELL,3,0.02h,Stop Loss,$-9.00,$-928.50,$55886.00,50,$-928.50
2024-03-08,13:29:00,18533.25,BUY,3,0.02h,Stop Loss,$31.50,$-897.00,$55917.50,50,$-897.00
2024-03-08,13:47:00,18364.25,SELL,3,0.02h,Stop Loss,$-9.00,$-906.00,$55908.50,50,$-906.00
2024-03-08,13:48:00,18613.75,BUY,3,0.02h,Stop Loss,$-9.00,$-915.00,$55899.50,50,$-915.00
2024-03-08,13:50:00,18345.25,SELL,3,0.02h,Stop Loss,$-9.00,$-924.00,$55890.50,50,$-924.00
2024-03-08,13:51:00,18595.0,BUY,3,0.02h,Stop Loss,$-9.00,$-933.00,$55881.50,50,$-933.00
2024-03-08,13:52:00,18356.25,SELL,3,0.02h,Stop Loss,$4.50,$-928.50,$55886.00,50,$-928.50
2024-03-08,13:55:00,18614.0,BUY,3,0.02h,Stop Loss,$15.00,$-913.50,$55901.00,50,$-913.50
2024-03-08,14:04:00,18361.25,SELL,3,0.02h,Break Even,$-1.50,$-915.00,$55899.50,50,$-915.00
2024-03-08,14:13:00,18592.5,BUY,3,0.02h,Stop Loss,$-9.00,$-924.00,$55890.50,50,$-924.00
2024-03-08,14:14:00,18337.75,SELL,3,0.02h,Break Even,$-1.50,$-925.50,$55889.00,50,$-925.50
2024-03-08,14:17:00,18576.25,BUY,3,0.02h,Stop Loss,$-9.00,$-934.50,$55880.00,50,$-934.50
2024-03-08,14:18:00,18330.5,SELL,3,0.02h,Stop Loss,$28.50,$-906.00,$55908.50,50,$-906.00
2024-03-08,14:21:00,18583.25,BUY,3,0.02h,Stop Loss,$-9.00,$-915.00,$55899.50,50,$-915.00
2024-03-08,14:22:00,18333.0,SELL,3,0.02h,Stop Loss,$10.50,$-904.50,$55910.00,50,$-904.50
2024-03-08,14:27:00,18588.0,BUY,3,0.02h,Stop Loss,$-9.00,$-913.50,$55901.00,50,$-913.50
2024-03-08,14:34:00,18329.5,SELL,3,0.02h,Stop Loss,$-9.00,$-922.50,$55892.00,50,$-922.50
2024-03-08,14:35:00,18597.75,BUY,3,0.02h,Stop Loss,$-9.00,$-931.50,$55883.00,50,$-931.50
2024-03-08,14:36:00,18315.0,SELL,3,0.02h,Stop Loss,$87.00,$-844.50,$55970.00,50,$-844.50
2024-03-08,14:41:00,18573.75,BUY,3,0.02h,Stop Loss,$16.50,$-828.00,$55986.50,50,$-828.00
2024-03-08,14:43:00,18318.75,SELL,3,0.02h,Stop Loss,$-9.00,$-837.00,$55977.50,50,$-837.00
2024-03-08,14:46:00,18584.25,BUY,3,0.02h,Stop Loss,$46.50,$-790.50,$56024.00,50,$-790.50
2024-03-08,14:52:00,18358.25,SELL,3,0.02h,Break Even,$-1.50,$-792.00,$56022.50,50,$-792.00
2024-03-08,14:54:00,18619.0,BUY,3,0.02h,Stop Loss,$30.00,$-762.00,$56052.50,50,$-762.00
2024-03-08,14:59:00,18381.25,SELL,3,0.02h,Stop Loss,$-9.00,$-771.00,$56043.50,50,$-771.00
2024-03-08,15:00:00,18642.0,BUY,3,0.02h,Stop Loss,$16.50,$-754.50,$56060.00,50,$-754.50
2024-03-08,15:09:00,18411.25,SELL,3,0.02h,Stop Loss,$7.50,$-747.00,$56067.50,50,$-747.00
2024-03-08,15:14:00,18679.25,BUY,3,0.02h,Break Even,$-1.50,$-748.50,$56066.00,50,$-748.50
2024-03-08,15:18:00,18420.0,SELL,3,0.02h,Stop Loss,$-9.00,$-757.50,$56057.00,50,$-757.50
2024-03-08,15:19:00,18659.5,BUY,3,0.02h,Stop Loss,$-9.00,$-766.50,$56048.00,50,$-766.50
2024-03-08,15:20:00,18406.0,SELL,3,0.02h,Stop Loss,$-9.00,$-775.50,$56039.00,50,$-775.50
2024-03-08,15:22:00,18668.25,BUY,3,0.02h,Stop Loss,$-9.00,$-784.50,$56030.00,50,$-784.50
2024-03-08,15:26:00,18415.25,SELL,3,0.02h,Stop Loss,$49.50,$-735.00,$56079.50,50,$-735.00
2024-03-08,15:35:00,18670.0,BUY,3,0.02h,Stop Loss,$-9.00,$-744.00,$56070.50,50,$-744.00
2024-03-08,15:36:00,18397.25,SELL,3,0.02h,Stop Loss,$-9.00,$-753.00,$56061.50,50,$-753.00
2024-03-08,15:37:00,18635.0,BUY,3,0.02h,Stop Loss,$-9.00,$-762.00,$56052.50,50,$-762.00
2024-03-08,15:38:00,18388.75,SELL,3,0.02h,Stop Loss,$-9.00,$-771.00,$56043.50,50,$-771.00
2024-03-08,15:39:00,18638.25,BUY,3,0.02h,Break Even,$-1.50,$-772.50,$56042.00,50,$-772.50
2024-03-08,15:41:00,18380.0,SELL,3,0.02h,Stop Loss,$-9.00,$-781.50,$56033.00,50,$-781.50
2024-03-08,15:45:00,18645.5,BUY,3,0.02h,Stop Loss,$-9.00,$-790.50,$56024.00,50,$-790.50
2024-03-08,15:47:00,18362.75,SELL,3,0.02h,Stop Loss,$6.00,$-784.50,$56030.00,50,$-784.50
2024-03-08,15:53:00,18624.75,BUY,3,0.02h,Stop Loss,$34.50,$-750.00,$56064.50,50,$-750.00
2024-03-08,15:58:00,18388.75,SELL,3,0.02h,Stop Loss,$6.00,$-744.00,$56070.50,50,$-744.00
2024-03-08,16:01:00,18620.25,BUY,3,0.02h,Stop Loss,$-9.00,$-753.00,$56061.50,50,$-753.00
2024-03-08,16:02:00,18357.25,SELL,3,0.02h,Stop Loss,$-9.00,$-762.00,$56052.50,50,$-762.00
2024-03-08,16:03:00,18588.0,BUY,3,0.02h,Stop Loss,$-9.00,$-771.00,$56043.50,50,$-771.00
2024-03-08,16:07:00,18319.5,SELL,3,0.02h,Stop Loss,$-9.00,$-780.00,$56034.50,50,$-780.00
2024-03-08,16:11:00,18529.5,BUY,3,0.02h,Stop Loss,$18.00,$-762.00,$56052.50,50,$-762.00
2024-03-08,16:13:00,18281.75,SELL,3,0.02h,Stop Loss,$9.00,$-753.00,$56061.50,50,$-753.00
2024-03-08,16:37:00,18464.0,BUY,3,0.02h,Stop Loss,$79.50,$-673.50,$56141.00,50,$-673.50
2024-03-08,16:39:00,18205.0,SELL,3,0.02h,Break Even,$-1.50,$-675.00,$56139.50,50,$-675.00
2024-03-08,16:54:00,18428.0,BUY,3,0.02h,Stop Loss,$73.50,$-601.50,$56213.00,50,$-601.50
2024-03-08,16:56:00,18188.5,SELL,3,0.02h,Break Even,$-1.50,$-603.00,$56211.50,50,$-603.00
2024-03-08,17:03:00,18452.0,BUY,3,0.02h,Stop Loss,$-9.00,$-612.00,$56202.50,50,$-612.00
2024-03-08,17:04:00,18189.0,SELL,3,0.02h,Stop Loss,$-9.00,$-621.00,$56193.50,50,$-621.00
2024-03-08,17:05:00,18436.75,BUY,3,0.02h,Stop Loss,$-9.00,$-630.00,$56184.50,50,$-630.00
2024-03-08,17:06:00,18185.0,SELL,3,0.02h,Break Even,$-1.50,$-631.50,$56183.00,50,$-631.50
2024-03-08,17:09:00,18420.5,BUY,3,0.02h,Stop Loss,$-9.00,$-640.50,$56174.00,50,$-640.50
2024-03-08,17:10:00,18151.25,SELL,3,0.02h,Stop Loss,$-9.00,$-649.50,$56165.00,50,$-649.50
2024-03-08,17:11:00,18391.75,BUY,3,0.02h,Stop Loss,$208.50,$-441.00,$56373.50,50,$-441.00
2024-03-08,17:17:00,18175.25,SELL,3,0.02h,Stop Loss,$51.00,$-390.00,$56424.50,50,$-390.00
2024-03-08,17:32:00,18438.75,BUY,3,0.02h,Stop Loss,$-9.00,$-399.00,$56415.50,50,$-399.00
2024-03-08,17:33:00,18189.5,SELL,3,0.02h,Break Even,$-1.50,$-400.50,$56414.00,50,$-400.50
2024-03-08,17:35:00,18437.25,BUY,3,0.02h,Stop Loss,$-9.00,$-409.50,$56405.00,50,$-409.50
2024-03-08,17:54:00,18102.0,SELL,3,0.02h,Stop Loss,$-9.00,$-418.50,$56396.00,50,$-418.50
2024-03-08,18:20:00,18327.25,BUY,3,0.02h,Stop Loss,$-9.00,$-427.50,$56387.00,50,$-427.50
2024-03-08,18:21:00,18078.5,SELL,3,0.02h,Stop Loss,$-9.00,$-436.50,$56378.00,50,$-436.50
2024-03-08,18:22:00,18317.0,BUY,3,0.02h,Stop Loss,$-9.00,$-445.50,$56369.00,50,$-445.50
2024-03-08,18:23:00,18068.25,SELL,3,0.02h,Stop Loss,$22.50,$-423.00,$56391.50,50,$-423.00
2024-03-08,18:26:00,18313.75,BUY,3,0.02h,Stop Loss,$42.00,$-381.00,$56433.50,50,$-381.00
2024-03-08,18:29:00,18063.25,SELL,3,0.02h,Stop Loss,$22.50,$-358.50,$56456.00,50,$-358.50
2024-03-08,18:41:00,18272.75,BUY,3,0.02h,Stop Loss,$-9.00,$-367.50,$56447.00,50,$-367.50
2024-03-08,18:42:00,18020.0,SELL,3,0.02h,Stop Loss,$19.50,$-348.00,$56466.50,50,$-348.00
2024-03-08,18:51:00,18271.75,BUY,3,0.02h,Stop Loss,$-9.00,$-357.00,$56457.50,50,$-357.00
2024-03-08,18:52:00,18036.25,SELL,3,0.02h,Stop Loss,$-9.00,$-366.00,$56448.50,50,$-366.00
2024-03-08,18:54:00,18275.75,BUY,3,0.02h,Stop Loss,$-9.00,$-375.00,$56439.50,50,$-375.00
2024-03-08,18:55:00,18037.5,SELL,3,0.02h,Stop Loss,$22.50,$-352.50,$56462.00,50,$-352.50
2024-03-08,19:00:00,18293.5,BUY,3,0.02h,Stop Loss,$-9.00,$-361.50,$56453.00,50,$-361.50
2024-03-08,19:02:00,18061.5,SELL,3,0.02h,Stop Loss,$-9.00,$-370.50,$56444.00,50,$-370.50
2024-03-08,19:03:00,18322.75,BUY,3,0.02h,Stop Loss,$-9.00,$-379.50,$56435.00,50,$-379.50
2024-03-08,19:06:00,18077.25,SELL,3,0.02h,Stop Loss,$-9.00,$-388.50,$56426.00,50,$-388.50
2024-03-08,19:07:00,18332.25,BUY,3,0.02h,Stop Loss,$64.50,$-324.00,$56490.50,50,$-324.00
2024-03-08,19:20:00,18091.25,SELL,3,0.02h,Stop Loss,$-9.00,$-333.00,$56481.50,50,$-333.00
2024-03-08,19:21:00,18354.0,BUY,3,0.02h,Stop Loss,$28.50,$-304.50,$56510.00,50,$-304.50
2024-03-08,19:24:00,18118.75,SELL,3,0.02h,Stop Loss,$12.00,$-292.50,$56522.00,50,$-292.50
2024-03-08,19:28:00,18370.5,BUY,3,0.02h,Stop Loss,$12.00,$-280.50,$56534.00,50,$-280.50
2024-03-08,19:35:00,18141.0,SELL,3,0.02h,Break Even,$-1.50,$-282.00,$56532.50,50,$-282.00
2024-03-08,19:38:00,18404.0,BUY,3,0.02h,Stop Loss,$-9.00,$-291.00,$56523.50,50,$-291.00
2024-03-08,19:39:00,18146.75,SELL,3,0.02h,Stop Loss,$12.00,$-279.00,$56535.50,50,$-279.00
2024-03-08,19:41:00,18399.0,BUY,3,0.02h,Stop Loss,$-9.00,$-288.00,$56526.50,50,$-288.00
2024-03-08,19:42:00,18151.5,SELL,3,0.02h,Stop Loss,$-9.00,$-297.00,$56517.50,50,$-297.00
2024-03-08,19:43:00,18411.25,BUY,3,0.02h,Stop Loss,$-9.00,$-306.00,$56508.50,50,$-306.00
2024-03-08,19:45:00,18171.25,SELL,3,0.02h,Stop Loss,$-9.00,$-315.00,$56499.50,50,$-315.00
2024-03-08,19:46:00,18418.75,BUY,3,0.02h,Stop Loss,$-9.00,$-324.00,$56490.50,50,$-324.00
2024-03-08,19:57:00,18140.75,SELL,3,0.02h,Stop Loss,$-9.00,$-333.00,$56481.50,50,$-333.00
2024-03-08,19:58:00,18387.75,BUY,3,0.02h,Stop Loss,$-9.00,$-342.00,$56472.50,50,$-342.00
2024-03-08,19:59:00,18146.25,SELL,3,0.02h,Stop Loss,$-9.00,$-351.00,$56463.50,50,$-351.00
2024-03-08,20:00:00,18393.25,BUY,3,0.02h,Stop Loss,$90.00,$-261.00,$56553.50,50,$-261.00
2024-03-08,20:06:00,18141.0,SELL,3,0.02h,Stop Loss,$79.50,$-181.50,$56633.00,50,$-181.50
2024-03-08,20:16:00,18358.0,BUY,3,0.02h,Break Even,$-1.50,$-183.00,$56631.50,50,$-183.00
2024-03-08,20:18:00,18091.75,SELL,3,0.02h,Stop Loss,$3.00,$-180.00,$56634.50,50,$-180.00
2024-03-08,20:27:00,18345.75,BUY,3,0.02h,Stop Loss,$4.50,$-175.50,$56639.00,50,$-175.50
2024-03-08,20:30:00,18050.5,SELL,3,0.02h,Stop Loss,$36.00,$-139.50,$56675.00,50,$-139.50
2024-03-08,20:37:00,18312.75,BUY,3,0.02h,Stop Loss,$-9.00,$-148.50,$56666.00,50,$-148.50
2024-03-08,20:38:00,18072.5,SELL,3,0.02h,Stop Loss,$-9.00,$-157.50,$56657.00,50,$-157.50
2024-03-08,20:42:00,18304.5,BUY,3,0.02h,Stop Loss,$9.00,$-148.50,$56666.00,50,$-148.50
2024-03-08,20:53:00,18055.0,SELL,3,0.02h,Break Even,$-1.50,$-150.00,$56664.50,50,$-150.00
2024-03-08,21:03:00,18324.5,BUY,3,0.02h,Stop Loss,$-9.00,$-159.00,$56655.50,50,$-159.00
2024-03-08,21:04:00,18072.75,SELL,3,0.02h,Stop Loss,$-9.00,$-168.00,$56646.50,50,$-168.00
2024-03-08,21:05:00,18323.25,BUY,3,0.02h,Stop Loss,$-9.00,$-177.00,$56637.50,50,$-177.00
2024-03-08,21:07:00,18067.0,SELL,3,0.02h,Break Even,$-1.50,$-178.50,$56636.00,50,$-178.50
2024-03-08,21:10:00,18314.0,BUY,3,0.02h,Break Even,$-1.50,$-180.00,$56634.50,50,$-180.00
2024-03-08,21:16:00,18065.75,SELL,3,0.03h,Stop Loss,$-9.00,$-189.00,$56625.50,50,$-189.00
2024-03-08,21:19:00,18315.0,BUY,3,0.02h,Stop Loss,$-9.00,$-198.00,$56616.50,50,$-198.00
2024-03-08,21:20:00,18062.75,SELL,3,0.02h,Break Even,$-1.50,$-199.50,$56615.00,50,$-199.50
2024-03-08,21:30:00,18308.0,BUY,3,0.02h,Stop Loss,$-9.00,$-208.50,$56606.00,50,$-208.50
2024-03-08,21:31:00,18059.5,SELL,3,0.02h,Stop Loss,$-9.00,$-217.50,$56597.00,50,$-217.50
2024-03-08,21:33:00,18309.0,BUY,3,0.02h,Stop Loss,$-9.00,$-226.50,$56588.00,50,$-226.50
2024-03-08,21:34:00,18056.5,SELL,3,0.02h,Stop Loss,$-9.00,$-235.50,$56579.00,50,$-235.50
2024-03-08,21:35:00,18306.25,BUY,3,0.02h,Stop Loss,$-9.00,$-244.50,$56570.00,50,$-244.50
2024-03-08,21:36:00,18058.0,SELL,3,0.02h,Stop Loss,$-9.00,$-253.50,$56561.00,50,$-253.50
2024-03-08,21:37:00,18305.5,BUY,3,0.02h,Stop Loss,$-9.00,$-262.50,$56552.00,50,$-262.50
2024-03-08,21:47:00,18053.5,SELL,3,0.02h,Stop Loss,$-9.00,$-271.50,$56543.00,50,$-271.50
2024-03-08,21:53:00,18304.25,BUY,3,0.02h,Stop Loss,$-9.00,$-280.50,$56534.00,50,$-280.50
2024-03-08,21:54:00,18054.75,SELL,3,0.02h,Stop Loss,$-9.00,$-289.50,$56525.00,50,$-289.50
2024-03-08,21:55:00,18306.25,BUY,3,0.02h,Stop Loss,$-9.00,$-298.50,$56516.00,50,$-298.50
2024-03-08,21:57:00,18054.75,SELL,3,0.02h,Break Even,$-1.50,$-300.00,$56514.50,50,$-300.00
,,,,,,,,,,,
2024-03-11,00:09:00,18278.0,BUY,3,0.02h,Stop Loss,$-9.00,$-9.00,$56505.50,51,$-9.00
2024-03-11,00:12:00,18033.25,SELL,3,0.02h,Stop Loss,$-9.00,$-18.00,$56496.50,51,$-18.00
2024-03-11,00:15:00,18283.75,BUY,3,0.02h,Stop Loss,$24.00,$6.00,$56520.50,51,$6.00
2024-03-11,00:30:00,18022.0,SELL,3,0.02h,Stop Loss,$-9.00,$-3.00,$56511.50,51,$-3.00
2024-03-11,00:31:00,18271.25,BUY,3,0.02h,Break Even,$-1.50,$-4.50,$56510.00,51,$-4.50
2024-03-11,00:33:00,18026.75,SELL,3,0.02h,Stop Loss,$-9.00,$-13.50,$56501.00,51,$-13.50
2024-03-11,00:34:00,18268.25,BUY,3,0.02h,Break Even,$-1.50,$-15.00,$56499.50,51,$-15.00
2024-03-11,00:45:00,18014.25,SELL,3,0.02h,Stop Loss,$-9.00,$-24.00,$56490.50,51,$-24.00
2024-03-11,00:46:00,18259.5,BUY,3,0.02h,Stop Loss,$-9.00,$-33.00,$56481.50,51,$-33.00
2024-03-11,00:47:00,18016.0,SELL,3,0.02h,Stop Loss,$-9.00,$-42.00,$56472.50,51,$-42.00
2024-03-11,00:55:00,18268.0,BUY,3,0.02h,Stop Loss,$-9.00,$-51.00,$56463.50,51,$-51.00
2024-03-11,01:01:00,18019.25,SELL,3,0.02h,Stop Loss,$-9.00,$-60.00,$56454.50,51,$-60.00
2024-03-11,01:02:00,18264.0,BUY,3,0.02h,Break Even,$-1.50,$-61.50,$56453.00,51,$-61.50
2024-03-11,01:06:00,18022.5,SELL,3,0.02h,Stop Loss,$-9.00,$-70.50,$56444.00,51,$-70.50
2024-03-11,01:07:00,18269.75,BUY,3,0.02h,Break Even,$-1.50,$-72.00,$56442.50,51,$-72.00
2024-03-11,01:09:00,18025.5,SELL,3,0.02h,Stop Loss,$-9.00,$-81.00,$56433.50,51,$-81.00
2024-03-11,01:13:00,18273.25,BUY,3,0.02h,Stop Loss,$-9.00,$-90.00,$56424.50,51,$-90.00
2024-03-11,01:14:00,18022.0,SELL,3,0.02h,Stop Loss,$-9.00,$-99.00,$56415.50,51,$-99.00
2024-03-11,01:19:00,18279.75,BUY,3,0.02h,Stop Loss,$-9.00,$-108.00,$56406.50,51,$-108.00
2024-03-11,01:20:00,18033.0,SELL,3,0.02h,Stop Loss,$-9.00,$-117.00,$56397.50,51,$-117.00
2024-03-11,01:21:00,18281.75,BUY,3,0.02h,Stop Loss,$-9.00,$-126.00,$56388.50,51,$-126.00
2024-03-11,01:29:00,18034.5,SELL,3,0.02h,Stop Loss,$-9.00,$-135.00,$56379.50,51,$-135.00
2024-03-11,01:53:00,18279.5,BUY,3,0.02h,Stop Loss,$-9.00,$-144.00,$56370.50,51,$-144.00
2024-03-11,02:10:00,18029.0,SELL,3,0.02h,Stop Loss,$18.00,$-126.00,$56388.50,51,$-126.00
2024-03-11,02:18:00,18275.25,BUY,3,0.02h,Stop Loss,$-9.00,$-135.00,$56379.50,51,$-135.00
2024-03-11,02:19:00,18025.0,SELL,3,0.05h,Break Even,$-1.50,$-136.50,$56378.00,51,$-136.50
2024-03-11,02:23:00,18272.25,BUY,3,0.02h,Stop Loss,$-9.00,$-145.50,$56369.00,51,$-145.50
2024-03-11,02:26:00,18027.5,SELL,3,0.02h,Stop Loss,$-9.00,$-154.50,$56360.00,51,$-154.50
2024-03-11,02:27:00,18276.0,BUY,3,0.02h,Break Even,$-1.50,$-156.00,$56358.50,51,$-156.00
2024-03-11,02:30:00,18029.75,SELL,3,0.02h,Break Even,$-1.50,$-157.50,$56357.00,51,$-157.50
2024-03-11,02:36:00,18260.0,BUY,3,0.02h,Stop Loss,$-9.00,$-166.50,$56348.00,51,$-166.50
2024-03-11,02:37:00,18012.5,SELL,3,0.02h,Stop Loss,$-9.00,$-175.50,$56339.00,51,$-175.50
2024-03-11,02:39:00,18258.75,BUY,3,0.02h,Stop Loss,$-9.00,$-184.50,$56330.00,51,$-184.50
2024-03-11,02:40:00,18012.25,SELL,3,0.02h,Stop Loss,$-9.00,$-193.50,$56321.00,51,$-193.50
2024-03-11,02:49:00,18264.0,BUY,3,0.02h,Stop Loss,$-9.00,$-202.50,$56312.00,51,$-202.50
2024-03-11,02:52:00,18013.25,SELL,3,0.02h,Break Even,$-1.50,$-204.00,$56310.50,51,$-204.00
2024-03-11,02:54:00,18258.75,BUY,3,0.02h,Break Even,$-1.50,$-205.50,$56309.00,51,$-205.50
2024-03-11,02:57:00,18013.25,SELL,3,0.02h,Stop Loss,$-9.00,$-214.50,$56300.00,51,$-214.50
2024-03-11,03:00:00,18260.0,BUY,3,0.02h,Break Even,$-1.50,$-216.00,$56298.50,51,$-216.00
2024-03-11,03:46:00,18258.5,SELL,3,0.02h,Stop Loss,$-9.00,$-225.00,$56289.50,51,$-225.00
2024-03-11,04:20:00,18240.5,BUY,3,0.02h,Stop Loss,$-9.00,$-234.00,$56280.50,51,$-234.00
2024-03-11,04:26:00,18236.25,SELL,3,0.02h,Stop Loss,$-9.00,$-243.00,$56271.50,51,$-243.00
2024-03-11,04:29:00,18239.5,BUY,3,0.02h,Stop Loss,$-9.00,$-252.00,$56262.50,51,$-252.00
2024-03-11,04:30:00,18236.5,SELL,3,0.02h,Break Even,$-1.50,$-253.50,$56261.00,51,$-253.50
2024-03-11,04:57:00,18234.0,BUY,3,0.02h,Break Even,$-1.50,$-255.00,$56259.50,51,$-255.00
2024-03-11,05:19:00,18234.75,SELL,3,0.02h,Stop Loss,$-9.00,$-264.00,$56250.50,51,$-264.00
2024-03-11,05:20:00,18237.0,BUY,3,0.02h,Stop Loss,$-9.00,$-273.00,$56241.50,51,$-273.00
2024-03-11,06:25:00,18265.0,SELL,3,0.02h,Stop Loss,$-9.00,$-282.00,$56232.50,51,$-282.00
2024-03-11,06:40:00,18270.75,BUY,3,0.02h,Stop Loss,$-9.00,$-291.00,$56223.50,51,$-291.00
2024-03-11,06:44:00,18265.75,SELL,3,0.02h,Break Even,$-1.50,$-292.50,$56222.00,51,$-292.50
2024-03-11,06:45:00,18268.75,BUY,3,0.02h,Break Even,$-1.50,$-294.00,$56220.50,51,$-294.00
2024-03-11,07:22:00,18268.75,SELL,3,0.02h,Stop Loss,$-9.00,$-303.00,$56211.50,51,$-303.00
2024-03-11,07:51:00,18280.25,BUY,3,0.02h,Stop Loss,$45.00,$-258.00,$56256.50,51,$-258.00
2024-03-11,08:05:00,18249.0,SELL,3,0.02h,Stop Loss,$42.00,$-216.00,$56298.50,51,$-216.00
2024-03-11,08:28:00,18245.5,BUY,3,0.02h,Stop Loss,$4.50,$-211.50,$56303.00,51,$-211.50
2024-03-11,08:49:00,18231.0,SELL,3,0.02h,Stop Loss,$19.50,$-192.00,$56322.50,51,$-192.00
2024-03-11,08:59:00,18253.5,BUY,3,0.02h,Stop Loss,$43.50,$-148.50,$56366.00,51,$-148.50
2024-03-11,09:36:00,18278.25,SELL,3,0.02h,Break Even,$-1.50,$-150.00,$56364.50,51,$-150.00
2024-03-11,10:01:00,18283.0,BUY,3,0.02h,Break Even,$-1.50,$-151.50,$56363.00,51,$-151.50
2024-03-11,10:16:00,18273.5,SELL,3,0.02h,Break Even,$-1.50,$-153.00,$56361.50,51,$-153.00
2024-03-11,10:36:00,18277.75,BUY,3,0.02h,Stop Loss,$34.50,$-118.50,$56396.00,51,$-118.50
2024-03-11,11:01:00,18278.25,SELL,3,0.02h,Stop Loss,$13.50,$-105.00,$56409.50,51,$-105.00
2024-03-11,11:05:00,18291.5,BUY,3,0.02h,Stop Loss,$-9.00,$-114.00,$56400.50,51,$-114.00
2024-03-11,11:06:00,18282.75,SELL,3,0.02h,Stop Loss,$55.50,$-58.50,$56456.00,51,$-58.50
2024-03-11,12:55:00,18201.0,BUY,3,0.02h,Break Even,$-1.50,$-60.00,$56454.50,51,$-60.00
2024-03-11,13:32:00,18185.25,SELL,3,0.02h,Stop Loss,$118.50,$58.50,$56573.00,51,$58.50
2024-03-11,13:41:00,18229.0,BUY,3,0.02h,Stop Loss,$90.00,$148.50,$56663.00,51,$148.50
2024-03-11,13:53:00,18202.5,SELL,3,0.02h,Stop Loss,$84.00,$232.50,$56747.00,51,$232.50
2024-03-11,14:21:00,18169.25,BUY,3,0.02h,Break Even,$-1.50,$231.00,$56745.50,51,$231.00
2024-03-11,14:22:00,18162.25,SELL,3,0.02h,Stop Loss,$27.00,$258.00,$56772.50,51,$258.00
2024-03-11,14:30:00,18175.25,BUY,3,0.02h,Stop Loss,$154.50,$412.50,$56927.00,51,$412.50
2024-03-11,15:11:00,18214.0,SELL,3,0.02h,Stop Loss,$144.00,$556.50,$57071.00,51,$556.50
2024-03-11,15:46:00,18200.25,BUY,3,0.02h,Stop Loss,$84.00,$640.50,$57155.00,51,$640.50
2024-03-11,16:10:00,18213.25,SELL,3,0.02h,Stop Loss,$51.00,$691.50,$57206.00,51,$691.50
2024-03-11,16:19:00,18231.5,BUY,3,0.02h,Break Even,$-1.50,$690.00,$57204.50,51,$690.00
2024-03-11,16:47:00,18220.25,SELL,3,0.02h,Stop Loss,$12.00,$702.00,$57216.50,51,$702.00
2024-03-11,16:55:00,18234.0,BUY,3,0.02h,Break Even,$-1.50,$700.50,$57215.00,51,$700.50
2024-03-11,17:05:00,18225.5,SELL,3,0.02h,Stop Loss,$-9.00,$691.50,$57206.00,51,$691.50
2024-03-11,17:24:00,18231.0,BUY,3,0.02h,Break Even,$-1.50,$690.00,$57204.50,51,$690.00
2024-03-11,17:41:00,18223.75,SELL,3,0.02h,Stop Loss,$109.50,$799.50,$57314.00,51,$799.50
2024-03-11,17:59:00,18218.75,BUY,3,0.02h,Stop Loss,$15.00,$814.50,$57329.00,51,$814.50
2024-03-11,18:37:00,18223.75,SELL,3,0.02h,Stop Loss,$-9.00,$805.50,$57320.00,51,$805.50
2024-03-11,18:43:00,18239.5,BUY,3,0.02h,Break Even,$-1.50,$804.00,$57318.50,51,$804.00
2024-03-11,19:02:00,18231.0,SELL,3,0.02h,Break Even,$-1.50,$802.50,$57317.00,51,$802.50
2024-03-11,19:43:00,18223.75,BUY,3,0.02h,Stop Loss,$19.50,$822.00,$57336.50,51,$822.00
2024-03-11,19:51:00,18209.5,SELL,3,0.02h,Stop Loss,$39.00,$861.00,$57375.50,51,$861.00
2024-03-11,20:01:00,18225.25,BUY,3,0.02h,Stop Loss,$9.00,$870.00,$57384.50,51,$870.00
,,,,,,,,,,,
2024-03-12,00:05:00,18286.25,SELL,3,0.02h,Stop Loss,$-9.00,$-9.00,$57375.50,52,$-9.00
2024-03-12,00:18:00,18290.5,BUY,3,0.02h,Stop Loss,$-9.00,$-18.00,$57366.50,52,$-18.00
2024-03-12,00:45:00,18292.25,SELL,3,0.02h,Break Even,$-1.50,$-19.50,$57365.00,52,$-19.50
2024-03-12,01:09:00,18294.0,BUY,3,0.02h,Stop Loss,$-9.00,$-28.50,$57356.00,52,$-28.50
2024-03-12,01:10:00,18286.75,SELL,3,0.02h,Stop Loss,$-9.00,$-37.50,$57347.00,52,$-37.50
2024-03-12,01:22:00,18293.0,BUY,3,0.02h,Stop Loss,$-9.00,$-46.50,$57338.00,52,$-46.50
2024-03-12,01:24:00,18289.5,SELL,3,0.02h,Stop Loss,$-9.00,$-55.50,$57329.00,52,$-55.50
2024-03-12,01:41:00,18290.75,BUY,3,0.02h,Break Even,$-1.50,$-57.00,$57327.50,52,$-57.00
2024-03-12,02:02:00,18290.75,SELL,3,0.02h,Stop Loss,$-9.00,$-66.00,$57318.50,52,$-66.00
2024-03-12,02:21:00,18294.25,BUY,3,0.02h,Break Even,$-1.50,$-67.50,$57317.00,52,$-67.50
2024-03-12,02:41:00,18291.25,SELL,3,0.03h,Stop Loss,$-9.00,$-76.50,$57308.00,52,$-76.50
2024-03-12,02:47:00,18296.25,BUY,3,0.02h,Stop Loss,$-9.00,$-85.50,$57299.00,52,$-85.50
2024-03-12,02:53:00,18292.75,SELL,3,0.03h,Stop Loss,$-9.00,$-94.50,$57290.00,52,$-94.50
2024-03-12,02:57:00,18293.75,BUY,3,0.05h,Break Even,$-1.50,$-96.00,$57288.50,52,$-96.00
2024-03-12,03:01:00,18051.25,SELL,3,0.02h,Stop Loss,$-9.00,$-105.00,$57279.50,52,$-105.00
2024-03-12,03:20:00,18302.0,BUY,3,0.02h,Stop Loss,$-9.00,$-114.00,$57270.50,52,$-114.00
2024-03-12,03:23:00,18054.75,SELL,3,0.02h,Stop Loss,$-9.00,$-123.00,$57261.50,52,$-123.00
2024-03-12,03:24:00,18299.25,BUY,3,0.02h,Stop Loss,$-9.00,$-132.00,$57252.50,52,$-132.00
2024-03-12,03:26:00,18053.5,SELL,3,0.02h,Stop Loss,$-9.00,$-141.00,$57243.50,52,$-141.00
2024-03-12,03:33:00,18302.5,BUY,3,0.02h,Stop Loss,$-9.00,$-150.00,$57234.50,52,$-150.00
2024-03-12,03:38:00,18056.5,SELL,3,0.02h,Stop Loss,$-9.00,$-159.00,$57225.50,52,$-159.00
2024-03-12,03:40:00,18302.5,BUY,3,0.03h,Stop Loss,$-9.00,$-168.00,$57216.50,52,$-168.00
2024-03-12,03:43:00,18055.5,SELL,3,0.02h,Stop Loss,$-9.00,$-177.00,$57207.50,52,$-177.00
2024-03-12,03:44:00,18301.5,BUY,3,0.02h,Stop Loss,$-9.00,$-186.00,$57198.50,52,$-186.00
2024-03-12,03:45:00,18056.25,SELL,3,0.02h,Stop Loss,$-9.00,$-195.00,$57189.50,52,$-195.00
2024-03-12,03:46:00,18299.75,BUY,3,0.02h,Round Number,$-1.50,$-196.50,$57188.00,52,$-196.50
2024-03-12,03:52:00,18056.75,SELL,3,0.03h,Stop Loss,$-9.00,$-205.50,$57179.00,52,$-205.50
2024-03-12,03:54:00,18301.0,BUY,3,0.02h,Stop Loss,$-9.00,$-214.50,$57170.00,52,$-214.50
2024-03-12,03:59:00,18053.75,SELL,3,0.03h,Stop Loss,$-9.00,$-223.50,$57161.00,52,$-223.50
2024-03-12,04:07:00,18299.0,BUY,3,0.02h,Stop Loss,$-9.00,$-232.50,$57152.00,52,$-232.50
2024-03-12,04:08:00,18055.0,SELL,3,0.05h,Stop Loss,$-9.00,$-241.50,$57143.00,52,$-241.50
2024-03-12,04:11:00,18299.5,BUY,3,0.02h,Stop Loss,$-9.00,$-250.50,$57134.00,52,$-250.50
2024-03-12,04:12:00,18053.75,SELL,3,0.02h,Stop Loss,$-9.00,$-259.50,$57125.00,52,$-259.50
2024-03-12,04:13:00,18298.75,BUY,3,0.02h,Stop Loss,$-9.00,$-268.50,$57116.00,52,$-268.50
2024-03-12,04:17:00,18054.0,SELL,3,0.02h,Stop Loss,$-9.00,$-277.50,$57107.00,52,$-277.50
2024-03-12,04:18:00,18299.5,BUY,3,0.02h,Stop Loss,$-9.00,$-286.50,$57098.00,52,$-286.50
2024-03-12,04:19:00,18054.5,SELL,3,0.02h,Stop Loss,$-9.00,$-295.50,$57089.00,52,$-295.50
2024-03-12,04:20:00,18299.75,BUY,3,0.02h,Round Number,$-1.50,$-297.00,$57087.50,52,$-297.00
2024-03-12,04:26:00,18053.5,SELL,3,0.02h,Stop Loss,$-9.00,$-306.00,$57078.50,52,$-306.00
2024-03-12,04:35:00,18300.75,BUY,3,0.02h,Stop Loss,$-9.00,$-315.00,$57069.50,52,$-315.00
2024-03-12,04:36:00,18057.0,SELL,3,0.05h,Stop Loss,$-9.00,$-324.00,$57060.50,52,$-324.00
2024-03-12,04:42:00,18303.5,BUY,3,0.07h,Stop Loss,$-9.00,$-333.00,$57051.50,52,$-333.00
2024-03-12,04:48:00,18058.75,SELL,3,0.02h,Stop Loss,$-9.00,$-342.00,$57042.50,52,$-342.00
2024-03-12,04:49:00,18304.5,BUY,3,0.02h,Stop Loss,$-9.00,$-351.00,$57033.50,52,$-351.00
2024-03-12,05:05:00,18074.25,SELL,3,0.02h,Stop Loss,$-9.00,$-360.00,$57024.50,52,$-360.00
2024-03-12,05:18:00,18328.0,BUY,3,0.02h,Stop Loss,$-9.00,$-369.00,$57015.50,52,$-369.00
2024-03-12,05:19:00,18082.25,SELL,3,0.02h,Stop Loss,$-9.00,$-378.00,$57006.50,52,$-378.00
2024-03-12,05:20:00,18327.75,BUY,3,0.02h,Stop Loss,$-9.00,$-387.00,$56997.50,52,$-387.00
2024-03-12,05:21:00,18083.75,SELL,3,0.02h,Stop Loss,$-9.00,$-396.00,$56988.50,52,$-396.00
2024-03-12,05:23:00,18331.5,BUY,3,0.02h,Stop Loss,$-9.00,$-405.00,$56979.50,52,$-405.00
2024-03-12,05:24:00,18084.0,SELL,3,0.02h,Stop Loss,$-9.00,$-414.00,$56970.50,52,$-414.00
2024-03-12,05:25:00,18330.75,BUY,3,0.02h,Stop Loss,$-9.00,$-423.00,$56961.50,52,$-423.00
2024-03-12,05:31:00,18084.5,SELL,3,0.02h,Stop Loss,$-9.00,$-432.00,$56952.50,52,$-432.00
2024-03-12,05:35:00,18332.75,BUY,3,0.02h,Stop Loss,$-9.00,$-441.00,$56943.50,52,$-441.00
2024-03-12,05:36:00,18086.0,SELL,3,0.02h,Stop Loss,$-9.00,$-450.00,$56934.50,52,$-450.00
2024-03-12,05:37:00,18331.75,BUY,3,0.02h,Break Even,$-1.50,$-451.50,$56933.00,52,$-451.50
2024-03-12,05:41:00,18085.5,SELL,3,0.02h,Break Even,$-1.50,$-453.00,$56931.50,52,$-453.00
2024-03-12,05:46:00,18331.25,BUY,3,0.05h,Break Even,$-1.50,$-454.50,$56930.00,52,$-454.50
2024-03-12,05:50:00,18083.75,SELL,3,0.02h,Stop Loss,$-9.00,$-463.50,$56921.00,52,$-463.50
2024-03-12,05:51:00,18332.25,BUY,3,0.02h,Stop Loss,$-9.00,$-472.50,$56912.00,52,$-472.50
2024-03-12,05:52:00,18090.0,SELL,3,0.02h,Stop Loss,$-9.00,$-481.50,$56903.00,52,$-481.50
2024-03-12,05:53:00,18336.75,BUY,3,0.02h,Break Even,$-1.50,$-483.00,$56901.50,52,$-483.00
2024-03-12,05:56:00,18091.5,SELL,3,0.02h,Stop Loss,$-9.00,$-492.00,$56892.50,52,$-492.00
2024-03-12,06:07:00,18331.25,BUY,3,0.02h,Stop Loss,$-9.00,$-501.00,$56883.50,52,$-501.00
2024-03-12,06:08:00,18086.25,SELL,3,0.02h,Stop Loss,$-9.00,$-510.00,$56874.50,52,$-510.00
2024-03-12,06:09:00,18330.25,BUY,3,0.02h,Stop Loss,$-9.00,$-519.00,$56865.50,52,$-519.00
2024-03-12,06:19:00,18074.75,SELL,3,0.02h,Stop Loss,$-9.00,$-528.00,$56856.50,52,$-528.00
2024-03-12,06:20:00,18320.75,BUY,3,0.02h,Stop Loss,$-9.00,$-537.00,$56847.50,52,$-537.00
2024-03-12,06:22:00,18074.75,SELL,3,0.02h,Stop Loss,$-9.00,$-546.00,$56838.50,52,$-546.00
2024-03-12,06:23:00,18318.5,BUY,3,0.03h,Stop Loss,$18.00,$-528.00,$56856.50,52,$-528.00
2024-03-12,06:29:00,18078.0,SELL,3,0.02h,Stop Loss,$-9.00,$-537.00,$56847.50,52,$-537.00
2024-03-12,06:40:00,18329.25,BUY,3,0.02h,Stop Loss,$-9.00,$-546.00,$56838.50,52,$-546.00
2024-03-12,06:41:00,18083.75,SELL,3,0.02h,Stop Loss,$-9.00,$-555.00,$56829.50,52,$-555.00
2024-03-12,06:42:00,18328.75,BUY,3,0.03h,Stop Loss,$-9.00,$-564.00,$56820.50,52,$-564.00
2024-03-12,06:47:00,18085.0,SELL,3,0.02h,Stop Loss,$-9.00,$-573.00,$56811.50,52,$-573.00
2024-03-12,06:48:00,18327.0,BUY,3,0.03h,Stop Loss,$-9.00,$-582.00,$56802.50,52,$-582.00
2024-03-12,06:50:00,18080.0,SELL,3,0.02h,Stop Loss,$-9.00,$-591.00,$56793.50,52,$-591.00
2024-03-12,06:51:00,18325.5,BUY,3,0.02h,Stop Loss,$-9.00,$-600.00,$56784.50,52,$-600.00
2024-03-12,07:01:00,18078.25,SELL,3,0.02h,Stop Loss,$-9.00,$-609.00,$56775.50,52,$-609.00
2024-03-12,07:02:00,18320.0,BUY,3,0.02h,Break Even,$-1.50,$-610.50,$56774.00,52,$-610.50
2024-03-12,07:05:00,18076.25,SELL,3,0.02h,Stop Loss,$-9.00,$-619.50,$56765.00,52,$-619.50
2024-03-12,07:17:00,18327.0,BUY,3,0.02h,Stop Loss,$-9.00,$-628.50,$56756.00,52,$-628.50
2024-03-12,07:19:00,18081.5,SELL,3,0.02h,Stop Loss,$-9.00,$-637.50,$56747.00,52,$-637.50
2024-03-12,07:20:00,18323.75,BUY,3,0.02h,Break Even,$-1.50,$-639.00,$56745.50,52,$-639.00
2024-03-12,07:23:00,18081.0,SELL,3,0.02h,Break Even,$-1.50,$-640.50,$56744.00,52,$-640.50
2024-03-12,07:27:00,18326.25,BUY,3,0.02h,Stop Loss,$-9.00,$-649.50,$56735.00,52,$-649.50
2024-03-12,07:28:00,18081.0,SELL,3,0.02h,Stop Loss,$-9.00,$-658.50,$56726.00,52,$-658.50
2024-03-12,07:29:00,18327.25,BUY,3,0.02h,Stop Loss,$-9.00,$-667.50,$56717.00,52,$-667.50
2024-03-12,07:30:00,18080.0,SELL,3,0.02h,Stop Loss,$-9.00,$-676.50,$56708.00,52,$-676.50
2024-03-12,07:31:00,18324.5,BUY,3,0.02h,Stop Loss,$-9.00,$-685.50,$56699.00,52,$-685.50
2024-03-12,07:35:00,18080.75,SELL,3,0.02h,Stop Loss,$-9.00,$-694.50,$56690.00,52,$-694.50
2024-03-12,07:36:00,18325.0,BUY,3,0.02h,Stop Loss,$-9.00,$-703.50,$56681.00,52,$-703.50
2024-03-12,07:37:00,18079.25,SELL,3,0.02h,Stop Loss,$-9.00,$-712.50,$56672.00,52,$-712.50
2024-03-12,07:38:00,18326.0,BUY,3,0.02h,Break Even,$-1.50,$-714.00,$56670.50,52,$-714.00
2024-03-12,07:43:00,18075.25,SELL,3,0.02h,Stop Loss,$-9.00,$-723.00,$56661.50,52,$-723.00
2024-03-12,07:44:00,18321.5,BUY,3,0.02h,Stop Loss,$-9.00,$-732.00,$56652.50,52,$-732.00
2024-03-12,07:45:00,18075.25,SELL,3,0.03h,Stop Loss,$-9.00,$-741.00,$56643.50,52,$-741.00
2024-03-12,07:49:00,18323.0,BUY,3,0.02h,Stop Loss,$-9.00,$-750.00,$56634.50,52,$-750.00
2024-03-12,07:50:00,18077.0,SELL,3,0.03h,Break Even,$-1.50,$-751.50,$56633.00,52,$-751.50
2024-03-12,07:58:00,18327.25,BUY,3,0.02h,Stop Loss,$-9.00,$-760.50,$56624.00,52,$-760.50
2024-03-12,07:59:00,18083.75,SELL,3,0.02h,Break Even,$-1.50,$-762.00,$56622.50,52,$-762.00
2024-03-12,08:02:00,18320.5,BUY,3,0.02h,Stop Loss,$-9.00,$-771.00,$56613.50,52,$-771.00
2024-03-12,08:03:00,18078.25,SELL,3,0.02h,Stop Loss,$-9.00,$-780.00,$56604.50,52,$-780.00
2024-03-12,08:05:00,18335.25,BUY,3,0.02h,Stop Loss,$-9.00,$-789.00,$56595.50,52,$-789.00
2024-03-12,08:06:00,18094.0,SELL,3,0.02h,Stop Loss,$-9.00,$-798.00,$56586.50,52,$-798.00
2024-03-12,08:07:00,18335.25,BUY,3,0.02h,Stop Loss,$-9.00,$-807.00,$56577.50,52,$-807.00
2024-03-12,08:25:00,18061.5,SELL,3,0.02h,Stop Loss,$-9.00,$-816.00,$56568.50,52,$-816.00
2024-03-12,08:29:00,18302.5,BUY,3,0.02h,Stop Loss,$-9.00,$-825.00,$56559.50,52,$-825.00
2024-03-12,08:31:00,18034.25,SELL,3,0.02h,Stop Loss,$-9.00,$-834.00,$56550.50,52,$-834.00
2024-03-12,08:36:00,18298.25,BUY,3,0.02h,Stop Loss,$-9.00,$-843.00,$56541.50,52,$-843.00
2024-03-12,08:45:00,18054.75,SELL,3,0.02h,Stop Loss,$-9.00,$-852.00,$56532.50,52,$-852.00
2024-03-12,08:46:00,18300.25,BUY,3,0.02h,Stop Loss,$-9.00,$-861.00,$56523.50,52,$-861.00
2024-03-12,08:47:00,18047.25,SELL,3,0.02h,Break Even,$-1.50,$-862.50,$56522.00,52,$-862.50
2024-03-12,08:58:00,18286.5,BUY,3,0.02h,Stop Loss,$-9.00,$-871.50,$56513.00,52,$-871.50
2024-03-12,09:00:00,18041.0,SELL,3,0.02h,Break Even,$-1.50,$-873.00,$56511.50,52,$-873.00
2024-03-12,09:07:00,18287.5,BUY,3,0.02h,Stop Loss,$-9.00,$-882.00,$56502.50,52,$-882.00
2024-03-12,09:08:00,18042.25,SELL,3,0.02h,Stop Loss,$10.50,$-871.50,$56513.00,52,$-871.50
2024-03-12,09:21:00,18285.25,BUY,3,0.02h,Stop Loss,$-9.00,$-880.50,$56504.00,52,$-880.50
2024-03-12,09:33:00,18048.5,SELL,3,0.02h,Stop Loss,$-9.00,$-889.50,$56495.00,52,$-889.50
2024-03-12,09:34:00,18299.5,BUY,3,0.02h,Stop Loss,$-9.00,$-898.50,$56486.00,52,$-898.50
2024-03-12,09:42:00,18051.5,SELL,3,0.02h,Break Even,$-1.50,$-900.00,$56484.50,52,$-900.00
2024-03-12,09:47:00,18289.75,BUY,3,0.02h,Stop Loss,$-9.00,$-909.00,$56475.50,52,$-909.00
2024-03-12,09:48:00,18045.0,SELL,3,0.02h,Stop Loss,$-9.00,$-918.00,$56466.50,52,$-918.00
2024-03-12,09:50:00,18294.75,BUY,3,0.02h,Break Even,$-1.50,$-919.50,$56465.00,52,$-919.50
2024-03-12,09:57:00,18040.0,SELL,3,0.02h,Stop Loss,$-9.00,$-928.50,$56456.00,52,$-928.50
2024-03-12,09:58:00,18282.0,BUY,3,0.02h,Stop Loss,$-9.00,$-937.50,$56447.00,52,$-937.50
2024-03-12,10:00:00,18033.5,SELL,3,0.02h,Break Even,$-1.50,$-939.00,$56445.50,52,$-939.00
2024-03-12,10:09:00,18292.0,BUY,3,0.02h,Stop Loss,$-9.00,$-948.00,$56436.50,52,$-948.00
2024-03-12,10:10:00,18047.0,SELL,3,0.02h,Stop Loss,$-9.00,$-957.00,$56427.50,52,$-957.00
2024-03-12,10:11:00,18295.75,BUY,3,0.02h,Stop Loss,$-9.00,$-966.00,$56418.50,52,$-966.00
2024-03-12,10:12:00,18049.75,SELL,3,0.02h,Stop Loss,$13.50,$-952.50,$56432.00,52,$-952.50
2024-03-12,10:17:00,18289.0,BUY,3,0.02h,Stop Loss,$10.50,$-942.00,$56442.50,52,$-942.00
2024-03-12,10:22:00,18052.0,SELL,3,0.02h,Stop Loss,$-9.00,$-951.00,$56433.50,52,$-951.00
2024-03-12,10:23:00,18298.75,BUY,3,0.02h,Stop Loss,$-9.00,$-960.00,$56424.50,52,$-960.00
2024-03-12,10:28:00,18054.25,SELL,3,0.02h,Break Even,$-1.50,$-961.50,$56423.00,52,$-961.50
2024-03-12,10:35:00,18294.75,BUY,3,0.02h,Stop Loss,$-9.00,$-970.50,$56414.00,52,$-970.50
2024-03-12,10:36:00,18047.25,SELL,3,0.02h,Stop Loss,$-9.00,$-979.50,$56405.00,52,$-979.50
2024-03-12,10:45:00,18298.0,BUY,3,0.02h,Stop Loss,$10.50,$-969.00,$56415.50,52,$-969.00
2024-03-12,10:56:00,18056.5,SELL,3,0.03h,Stop Loss,$-9.00,$-978.00,$56406.50,52,$-978.00
2024-03-12,10:59:00,18302.25,BUY,3,0.02h,Stop Loss,$-9.00,$-987.00,$56397.50,52,$-987.00
2024-03-12,11:00:00,18049.5,SELL,3,0.02h,Stop Loss,$-9.00,$-996.00,$56388.50,52,$-996.00
2024-03-12,11:01:00,18291.5,BUY,3,0.02h,Break Even,$-1.50,$-997.50,$56387.00,52,$-997.50
2024-03-12,11:09:00,18038.75,SELL,3,0.02h,Stop Loss,$-9.00,$-1006.50,$56378.00,52,$-1006.50
2024-03-12,11:11:00,18282.5,BUY,3,0.02h,Break Even,$-1.50,$-1008.00,$56376.50,52,$-1008.00
2024-03-12,11:15:00,18042.0,SELL,3,0.02h,Stop Loss,$-9.00,$-1017.00,$56367.50,52,$-1017.00
2024-03-12,11:32:00,18299.5,BUY,3,0.02h,Break Even,$-1.50,$-1018.50,$56366.00,52,$-1018.50
2024-03-12,11:45:00,18058.25,SELL,3,0.02h,Stop Loss,$6.00,$-1012.50,$56372.00,52,$-1012.50
2024-03-12,12:00:00,18293.5,BUY,3,0.02h,Break Even,$-1.50,$-1014.00,$56370.50,52,$-1014.00
2024-03-12,12:05:00,18048.75,SELL,3,0.02h,Break Even,$-1.50,$-1015.50,$56369.00,52,$-1015.50
2024-03-12,12:12:00,18291.5,BUY,3,0.02h,Break Even,$-1.50,$-1017.00,$56367.50,52,$-1017.00
2024-03-12,12:22:00,18053.75,SELL,3,0.02h,Stop Loss,$-9.00,$-1026.00,$56358.50,52,$-1026.00
2024-03-12,12:23:00,18298.0,BUY,3,0.02h,Stop Loss,$-9.00,$-1035.00,$56349.50,52,$-1035.00
2024-03-12,12:24:00,18053.5,SELL,3,0.02h,Stop Loss,$-9.00,$-1044.00,$56340.50,52,$-1044.00
2024-03-12,12:25:00,18298.5,BUY,3,0.02h,Break Even,$-1.50,$-1045.50,$56339.00,52,$-1045.50
2024-03-12,12:32:00,18022.5,SELL,3,0.02h,Stop Loss,$-9.00,$-1054.50,$56330.00,52,$-1054.50
2024-03-12,12:33:00,18318.0,BUY,3,0.02h,Stop Loss,$-9.00,$-1063.50,$56321.00,52,$-1063.50
2024-03-12,12:34:00,18083.0,SELL,3,0.02h,Stop Loss,$99.00,$-964.50,$56420.00,52,$-964.50
2024-03-12,12:39:00,18334.25,BUY,3,0.02h,Stop Loss,$-9.00,$-973.50,$56411.00,52,$-973.50
2024-03-12,12:48:00,18112.25,SELL,3,0.02h,Stop Loss,$19.50,$-954.00,$56430.50,52,$-954.00
2024-03-12,12:50:00,18356.25,BUY,3,0.02h,Stop Loss,$15.00,$-939.00,$56445.50,52,$-939.00
2024-03-12,12:57:00,18076.5,SELL,3,0.02h,Stop Loss,$22.50,$-916.50,$56468.00,52,$-916.50
2024-03-12,13:03:00,18318.75,BUY,3,0.02h,Stop Loss,$-9.00,$-925.50,$56459.00,52,$-925.50
2024-03-12,13:05:00,18066.75,SELL,3,0.02h,Stop Loss,$-9.00,$-934.50,$56450.00,52,$-934.50
2024-03-12,13:06:00,18297.25,BUY,3,0.02h,Stop Loss,$-9.00,$-943.50,$56441.00,52,$-943.50
2024-03-12,13:07:00,18057.25,SELL,3,0.02h,Stop Loss,$46.50,$-897.00,$56487.50,52,$-897.00
2024-03-12,13:17:00,18292.5,BUY,3,0.02h,Stop Loss,$-9.00,$-906.00,$56478.50,52,$-906.00
2024-03-12,13:18:00,18046.0,SELL,3,0.02h,Break Even,$-1.50,$-907.50,$56477.00,52,$-907.50
2024-03-12,13:24:00,18290.0,BUY,3,0.02h,Stop Loss,$-9.00,$-916.50,$56468.00,52,$-916.50
2024-03-12,13:25:00,18047.0,SELL,3,0.02h,Stop Loss,$-9.00,$-925.50,$56459.00,52,$-925.50
2024-03-12,13:26:00,18307.5,BUY,3,0.02h,Stop Loss,$-9.00,$-934.50,$56450.00,52,$-934.50
2024-03-12,13:27:00,18059.0,SELL,3,0.02h,Stop Loss,$-9.00,$-943.50,$56441.00,52,$-943.50
2024-03-12,13:28:00,18300.5,BUY,3,0.02h,Stop Loss,$33.00,$-910.50,$56474.00,52,$-910.50
2024-03-12,13:34:00,18056.25,SELL,3,0.02h,Stop Loss,$-9.00,$-919.50,$56465.00,52,$-919.50
2024-03-12,13:35:00,18265.75,BUY,3,0.02h,Stop Loss,$-9.00,$-928.50,$56456.00,52,$-928.50
2024-03-12,13:36:00,18003.5,SELL,3,0.02h,Stop Loss,$88.50,$-840.00,$56544.50,52,$-840.00
2024-03-12,13:57:00,18269.75,BUY,3,0.02h,Break Even,$-1.50,$-841.50,$56543.00,52,$-841.50
2024-03-12,14:08:00,18080.0,SELL,3,0.02h,Stop Loss,$-9.00,$-850.50,$56534.00,52,$-850.50
2024-03-12,14:09:00,18325.0,BUY,3,0.02h,Break Even,$-1.50,$-852.00,$56532.50,52,$-852.00
2024-03-12,14:14:00,18054.75,SELL,3,0.02h,Stop Loss,$-9.00,$-861.00,$56523.50,52,$-861.00
2024-03-12,14:15:00,18301.0,BUY,3,0.02h,Stop Loss,$105.00,$-756.00,$56628.50,52,$-756.00
2024-03-12,14:18:00,18059.75,SELL,3,0.02h,Stop Loss,$52.50,$-703.50,$56681.00,52,$-703.50
2024-03-12,14:21:00,18304.5,BUY,3,0.02h,Stop Loss,$-9.00,$-712.50,$56672.00,52,$-712.50
2024-03-12,14:22:00,18064.75,SELL,3,0.02h,Break Even,$-1.50,$-714.00,$56670.50,52,$-714.00
2024-03-12,14:31:00,18389.25,BUY,3,0.02h,Stop Loss,$63.00,$-651.00,$56733.50,52,$-651.00
2024-03-12,14:59:00,18161.25,SELL,3,0.02h,Stop Loss,$24.00,$-627.00,$56757.50,52,$-627.00
2024-03-12,15:08:00,18420.5,BUY,3,0.02h,Stop Loss,$45.00,$-582.00,$56802.50,52,$-582.00
2024-03-12,15:13:00,18186.75,SELL,3,0.02h,Stop Loss,$39.00,$-543.00,$56841.50,52,$-543.00
2024-03-12,15:16:00,18438.0,BUY,3,0.02h,Stop Loss,$15.00,$-528.00,$56856.50,52,$-528.00
2024-03-12,15:29:00,18205.5,SELL,3,0.02h,Stop Loss,$-9.00,$-537.00,$56847.50,52,$-537.00
2024-03-12,15:30:00,18453.5,BUY,3,0.02h,Stop Loss,$-9.00,$-546.00,$56838.50,52,$-546.00
2024-03-12,15:31:00,18190.5,SELL,3,0.02h,Stop Loss,$4.50,$-541.50,$56843.00,52,$-541.50
2024-03-12,15:45:00,18407.5,BUY,3,0.02h,Break Even,$-1.50,$-543.00,$56841.50,52,$-543.00
2024-03-12,15:47:00,18144.0,SELL,3,0.02h,Stop Loss,$-9.00,$-552.00,$56832.50,52,$-552.00
2024-03-12,15:53:00,18421.75,BUY,3,0.02h,Stop Loss,$-9.00,$-561.00,$56823.50,52,$-561.00
2024-03-12,15:54:00,18182.25,SELL,3,0.02h,Break Even,$-1.50,$-562.50,$56822.00,52,$-562.50
2024-03-12,15:56:00,18422.0,BUY,3,0.02h,Stop Loss,$15.00,$-547.50,$56837.00,52,$-547.50
2024-03-12,15:59:00,18170.75,SELL,3,0.02h,Break Even,$-1.50,$-549.00,$56835.50,52,$-549.00
2024-03-12,16:03:00,18391.75,BUY,3,0.02h,Stop Loss,$-9.00,$-558.00,$56826.50,52,$-558.00
2024-03-12,16:04:00,18147.25,SELL,3,0.02h,Stop Loss,$28.50,$-529.50,$56855.00,52,$-529.50
2024-03-12,16:08:00,18399.75,BUY,3,0.02h,Stop Loss,$-9.00,$-538.50,$56846.00,52,$-538.50
2024-03-12,16:09:00,18155.5,SELL,3,0.02h,Stop Loss,$-9.00,$-547.50,$56837.00,52,$-547.50
2024-03-12,16:10:00,18390.5,BUY,3,0.02h,Stop Loss,$49.50,$-498.00,$56886.50,52,$-498.00
2024-03-12,16:13:00,18157.0,SELL,3,0.02h,Stop Loss,$-9.00,$-507.00,$56877.50,52,$-507.00
2024-03-12,16:21:00,18391.5,BUY,3,0.02h,Stop Loss,$-9.00,$-516.00,$56868.50,52,$-516.00
2024-03-12,16:22:00,18144.75,SELL,3,0.02h,Stop Loss,$-9.00,$-525.00,$56859.50,52,$-525.00
2024-03-12,16:23:00,18387.5,BUY,3,0.02h,Stop Loss,$-9.00,$-534.00,$56850.50,52,$-534.00
2024-03-12,16:24:00,18135.0,SELL,3,0.02h,Stop Loss,$27.00,$-507.00,$56877.50,52,$-507.00
2024-03-12,16:34:00,18375.5,BUY,3,0.02h,Stop Loss,$48.00,$-459.00,$56925.50,52,$-459.00
2024-03-12,16:40:00,18114.5,SELL,3,0.02h,Break Even,$-1.50,$-460.50,$56924.00,52,$-460.50
2024-03-12,16:44:00,18352.0,BUY,3,0.02h,Break Even,$-1.50,$-462.00,$56922.50,52,$-462.00
2024-03-12,16:49:00,18093.5,SELL,3,0.02h,Stop Loss,$-9.00,$-471.00,$56913.50,52,$-471.00
2024-03-12,16:50:00,18344.0,BUY,3,0.02h,Stop Loss,$4.50,$-466.50,$56918.00,52,$-466.50
2024-03-12,16:54:00,18104.75,SELL,3,0.02h,Stop Loss,$-9.00,$-475.50,$56909.00,52,$-475.50
2024-03-12,16:55:00,18358.75,BUY,3,0.02h,Stop Loss,$-9.00,$-484.50,$56900.00,52,$-484.50
2024-03-12,16:56:00,18114.5,SELL,3,0.02h,Stop Loss,$99.00,$-385.50,$56999.00,52,$-385.50
2024-03-12,17:02:00,18346.25,BUY,3,0.02h,Stop Loss,$-9.00,$-394.50,$56990.00,52,$-394.50
2024-03-12,17:03:00,18085.0,SELL,3,0.02h,Stop Loss,$-9.00,$-403.50,$56981.00,52,$-403.50
2024-03-12,17:23:00,18396.25,BUY,3,0.02h,Stop Loss,$-9.00,$-412.50,$56972.00,52,$-412.50
2024-03-12,17:29:00,18140.25,SELL,3,0.02h,Stop Loss,$-9.00,$-421.50,$56963.00,52,$-421.50
2024-03-12,17:30:00,18383.0,BUY,3,0.02h,Stop Loss,$34.50,$-387.00,$56997.50,52,$-387.00
2024-03-12,17:46:00,18150.25,SELL,3,0.02h,Stop Loss,$27.00,$-360.00,$57024.50,52,$-360.00
2024-03-12,17:49:00,18404.0,BUY,3,0.02h,Break Even,$-1.50,$-361.50,$57023.00,52,$-361.50
2024-03-12,17:57:00,18145.75,SELL,3,0.02h,Stop Loss,$-9.00,$-370.50,$57014.00,52,$-370.50
2024-03-12,17:58:00,18408.0,BUY,3,0.02h,Stop Loss,$-9.00,$-379.50,$57005.00,52,$-379.50
2024-03-12,17:59:00,18155.25,SELL,3,0.02h,Stop Loss,$19.50,$-360.00,$57024.50,52,$-360.00
2024-03-12,18:03:00,18407.0,BUY,3,0.02h,Stop Loss,$27.00,$-333.00,$57051.50,52,$-333.00
2024-03-12,18:13:00,18183.25,SELL,3,0.02h,Stop Loss,$22.50,$-310.50,$57074.00,52,$-310.50
2024-03-12,18:23:00,18433.75,BUY,3,0.02h,Stop Loss,$-9.00,$-319.50,$57065.00,52,$-319.50
2024-03-12,18:24:00,18184.25,SELL,3,0.02h,Stop Loss,$6.00,$-313.50,$57071.00,52,$-313.50
2024-03-12,18:33:00,18455.0,BUY,3,0.02h,Break Even,$-1.50,$-315.00,$57069.50,52,$-315.00
2024-03-12,18:52:00,18198.5,SELL,3,0.02h,Stop Loss,$-9.00,$-324.00,$57060.50,52,$-324.00
2024-03-12,18:57:00,18456.75,BUY,3,0.02h,Stop Loss,$-9.00,$-333.00,$57051.50,52,$-333.00
2024-03-12,19:04:00,18201.5,SELL,3,0.02h,Stop Loss,$-9.00,$-342.00,$57042.50,52,$-342.00
2024-03-12,19:05:00,18454.0,BUY,3,0.02h,Stop Loss,$-9.00,$-351.00,$57033.50,52,$-351.00
2024-03-12,19:06:00,18201.75,SELL,3,0.02h,Break Even,$-1.50,$-352.50,$57032.00,52,$-352.50
2024-03-12,19:09:00,18455.25,BUY,3,0.02h,Stop Loss,$-9.00,$-361.50,$57023.00,52,$-361.50
2024-03-12,19:10:00,18211.25,SELL,3,0.02h,Break Even,$-1.50,$-363.00,$57021.50,52,$-363.00
2024-03-12,19:13:00,18458.0,BUY,3,0.02h,Stop Loss,$-9.00,$-372.00,$57012.50,52,$-372.00
2024-03-12,19:14:00,18214.0,SELL,3,0.02h,Stop Loss,$-9.00,$-381.00,$57003.50,52,$-381.00
2024-03-12,19:15:00,18459.25,BUY,3,0.02h,Break Even,$-1.50,$-382.50,$57002.00,52,$-382.50
2024-03-12,19:17:00,18198.5,SELL,3,0.02h,Stop Loss,$-9.00,$-391.50,$56993.00,52,$-391.50
2024-03-12,19:18:00,18442.0,BUY,3,0.02h,Stop Loss,$-9.00,$-400.50,$56984.00,52,$-400.50
2024-03-12,19:19:00,18191.5,SELL,3,0.02h,Stop Loss,$-9.00,$-409.50,$56975.00,52,$-409.50
2024-03-12,19:22:00,18459.5,BUY,3,0.02h,Stop Loss,$-9.00,$-418.50,$56966.00,52,$-418.50
2024-03-12,19:23:00,18213.0,SELL,3,0.02h,Stop Loss,$-9.00,$-427.50,$56957.00,52,$-427.50
2024-03-12,19:24:00,18462.75,BUY,3,0.02h,Stop Loss,$15.00,$-412.50,$56972.00,52,$-412.50
2024-03-12,19:27:00,18218.0,SELL,3,0.02h,Stop Loss,$25.50,$-387.00,$56997.50,52,$-387.00
2024-03-12,19:33:00,18460.0,BUY,3,0.02h,Stop Loss,$-9.00,$-396.00,$56988.50,52,$-396.00
2024-03-12,19:34:00,18217.25,SELL,3,0.02h,Break Even,$-1.50,$-397.50,$56987.00,52,$-397.50
2024-03-12,19:39:00,18466.75,BUY,3,0.02h,Stop Loss,$-9.00,$-406.50,$56978.00,52,$-406.50
2024-03-12,19:40:00,18218.0,SELL,3,0.02h,Stop Loss,$-9.00,$-415.50,$56969.00,52,$-415.50
2024-03-12,19:41:00,18471.0,BUY,3,0.02h,Stop Loss,$42.00,$-373.50,$57011.00,52,$-373.50
2024-03-12,19:51:00,18222.75,SELL,3,0.02h,Stop Loss,$-9.00,$-382.50,$57002.00,52,$-382.50
2024-03-12,19:52:00,18483.0,BUY,3,0.02h,Break Even,$-1.50,$-384.00,$57000.50,52,$-384.00
2024-03-12,19:55:00,18230.5,SELL,3,0.02h,Stop Loss,$-9.00,$-393.00,$56991.50,52,$-393.00
2024-03-12,19:59:00,18480.0,BUY,3,0.02h,Break Even,$-1.50,$-394.50,$56990.00,52,$-394.50
2024-03-12,20:04:00,18227.75,SELL,3,0.02h,Stop Loss,$-9.00,$-403.50,$56981.00,52,$-403.50
2024-03-12,20:05:00,18476.0,BUY,3,0.02h,Break Even,$-1.50,$-405.00,$56979.50,52,$-405.00
2024-03-12,20:07:00,18219.5,SELL,3,0.02h,Stop Loss,$-9.00,$-414.00,$56970.50,52,$-414.00
2024-03-12,20:17:00,18467.75,BUY,3,0.02h,Break Even,$-1.50,$-415.50,$56969.00,52,$-415.50
2024-03-12,20:28:00,18222.25,SELL,3,0.02h,Stop Loss,$-9.00,$-424.50,$56960.00,52,$-424.50
2024-03-12,20:31:00,18474.75,BUY,3,0.02h,Stop Loss,$-9.00,$-433.50,$56951.00,52,$-433.50
2024-03-12,20:32:00,18227.25,SELL,3,0.03h,Stop Loss,$-9.00,$-442.50,$56942.00,52,$-442.50
2024-03-12,20:35:00,18473.0,BUY,3,0.02h,Stop Loss,$-9.00,$-451.50,$56933.00,52,$-451.50
2024-03-12,20:36:00,18226.25,SELL,3,0.03h,Stop Loss,$-9.00,$-460.50,$56924.00,52,$-460.50
2024-03-12,20:50:00,18474.5,BUY,3,0.02h,Stop Loss,$-9.00,$-469.50,$56915.00,52,$-469.50
2024-03-12,20:51:00,18228.0,SELL,3,0.02h,Stop Loss,$-9.00,$-478.50,$56906.00,52,$-478.50
2024-03-12,20:52:00,18475.75,BUY,3,0.02h,Stop Loss,$-9.00,$-487.50,$56897.00,52,$-487.50
2024-03-12,23:01:00,18224.25,SELL,3,0.02h,Break Even,$-1.50,$-489.00,$56895.50,52,$-489.00
2024-03-12,23:07:00,18477.0,BUY,3,0.02h,Stop Loss,$-9.00,$-498.00,$56886.50,52,$-498.00
2024-03-12,23:08:00,18226.75,SELL,3,0.02h,Stop Loss,$-9.00,$-507.00,$56877.50,52,$-507.00
2024-03-12,23:09:00,18476.25,BUY,3,0.03h,Stop Loss,$-9.00,$-516.00,$56868.50,52,$-516.00
2024-03-12,23:17:00,18230.25,SELL,3,0.02h,Stop Loss,$-9.00,$-525.00,$56859.50,52,$-525.00
2024-03-12,23:31:00,18485.5,BUY,3,0.02h,Stop Loss,$-9.00,$-534.00,$56850.50,52,$-534.00
2024-03-12,23:33:00,18237.0,SELL,3,0.03h,Break Even,$-1.50,$-535.50,$56849.00,52,$-535.50
2024-03-12,23:36:00,18483.75,BUY,3,0.03h,Stop Loss,$-9.00,$-544.50,$56840.00,52,$-544.50
2024-03-12,23:45:00,18232.5,SELL,3,0.02h,Break Even,$-1.50,$-546.00,$56838.50,52,$-546.00
2024-03-12,23:47:00,18481.25,BUY,3,0.02h,Stop Loss,$-9.00,$-555.00,$56829.50,52,$-555.00
2024-03-12,23:48:00,18232.0,SELL,3,0.07h,Stop Loss,$-9.00,$-564.00,$56820.50,52,$-564.00
,,,,,,,,,,,
2024-03-13,00:00:00,18478.5,BUY,3,0.02h,Stop Loss,$-9.00,$-9.00,$56811.50,53,$-9.00
2024-03-13,00:12:00,18226.5,SELL,3,0.05h,Stop Loss,$-9.00,$-18.00,$56802.50,53,$-18.00
2024-03-13,00:18:00,18473.5,BUY,3,0.02h,Break Even,$-1.50,$-19.50,$56801.00,53,$-19.50
2024-03-13,00:33:00,18227.25,SELL,3,0.02h,Stop Loss,$-9.00,$-28.50,$56792.00,53,$-28.50
2024-03-13,00:35:00,18473.5,BUY,3,0.02h,Stop Loss,$-9.00,$-37.50,$56783.00,53,$-37.50
2024-03-13,00:36:00,18223.5,SELL,3,0.02h,Stop Loss,$-9.00,$-46.50,$56774.00,53,$-46.50
2024-03-13,00:42:00,18462.0,BUY,3,0.02h,Break Even,$-1.50,$-48.00,$56772.50,53,$-48.00
2024-03-13,00:52:00,18215.75,SELL,3,0.02h,Stop Loss,$-9.00,$-57.00,$56763.50,53,$-57.00
2024-03-13,01:24:00,18460.0,BUY,3,0.02h,Break Even,$-1.50,$-58.50,$56762.00,53,$-58.50
2024-03-13,01:33:00,18213.25,SELL,3,0.07h,Break Even,$-1.50,$-60.00,$56760.50,53,$-60.00
2024-03-13,01:39:00,18459.75,BUY,3,0.02h,Break Even,$-1.50,$-61.50,$56759.00,53,$-61.50
2024-03-13,01:46:00,18209.5,SELL,3,0.02h,Stop Loss,$-9.00,$-70.50,$56750.00,53,$-70.50
2024-03-13,01:47:00,18459.5,BUY,3,0.02h,Stop Loss,$-9.00,$-79.50,$56741.00,53,$-79.50
2024-03-13,01:55:00,18210.25,SELL,3,0.03h,Break Even,$-1.50,$-81.00,$56739.50,53,$-81.00
2024-03-13,02:03:00,18460.5,BUY,3,0.02h,Stop Loss,$-9.00,$-90.00,$56730.50,53,$-90.00
2024-03-13,02:04:00,18211.5,SELL,3,0.08h,Break Even,$-1.50,$-91.50,$56729.00,53,$-91.50
2024-03-13,02:14:00,18459.5,BUY,3,0.02h,Break Even,$-1.50,$-93.00,$56727.50,53,$-93.00
2024-03-13,02:25:00,18213.5,SELL,3,0.07h,Stop Loss,$12.00,$-81.00,$56739.50,53,$-81.00
2024-03-13,02:30:00,18457.75,BUY,3,0.02h,Stop Loss,$-9.00,$-90.00,$56730.50,53,$-90.00
2024-03-13,02:31:00,18209.25,SELL,3,0.02h,Break Even,$-1.50,$-91.50,$56729.00,53,$-91.50
2024-03-13,02:37:00,18458.25,BUY,3,0.02h,Stop Loss,$-9.00,$-100.50,$56720.00,53,$-100.50
2024-03-13,02:38:00,18207.75,SELL,3,0.03h,Break Even,$-1.50,$-102.00,$56718.50,53,$-102.00
2024-03-13,02:48:00,18454.5,BUY,3,0.02h,Stop Loss,$-9.00,$-111.00,$56709.50,53,$-111.00
2024-03-13,02:59:00,18206.5,SELL,3,0.02h,Break Even,$-1.50,$-112.50,$56708.00,53,$-112.50
2024-03-13,03:05:00,18449.5,BUY,3,0.02h,Break Even,$-1.50,$-114.00,$56706.50,53,$-114.00
2024-03-13,03:10:00,18201.5,SELL,3,0.03h,Stop Loss,$-9.00,$-123.00,$56697.50,53,$-123.00
2024-03-13,03:13:00,18449.5,BUY,3,0.03h,Stop Loss,$-9.00,$-132.00,$56688.50,53,$-132.00
2024-03-13,03:17:00,18198.25,SELL,3,0.02h,Stop Loss,$-9.00,$-141.00,$56679.50,53,$-141.00
2024-03-13,03:20:00,18448.25,BUY,3,0.02h,Break Even,$-1.50,$-142.50,$56678.00,53,$-142.50
2024-03-13,03:26:00,18202.25,SELL,3,0.02h,Stop Loss,$-9.00,$-151.50,$56669.00,53,$-151.50
2024-03-13,03:40:00,18450.75,BUY,3,0.03h,Stop Loss,$-9.00,$-160.50,$56660.00,53,$-160.50
2024-03-13,03:47:00,18205.75,SELL,3,0.02h,Stop Loss,$-9.00,$-169.50,$56651.00,53,$-169.50
2024-03-13,03:49:00,18457.0,BUY,3,0.03h,Stop Loss,$-9.00,$-178.50,$56642.00,53,$-178.50
2024-03-13,03:55:00,18209.0,SELL,3,0.03h,Break Even,$-1.50,$-180.00,$56640.50,53,$-180.00
2024-03-13,04:05:00,18458.75,BUY,3,0.02h,Break Even,$-1.50,$-181.50,$56639.00,53,$-181.50
2024-03-13,04:15:00,18215.5,SELL,3,0.02h,Stop Loss,$-9.00,$-190.50,$56630.00,53,$-190.50
2024-03-13,04:16:00,18462.25,BUY,3,0.02h,Stop Loss,$-9.00,$-199.50,$56621.00,53,$-199.50
2024-03-13,04:22:00,18212.75,SELL,3,0.02h,Stop Loss,$-9.00,$-208.50,$56612.00,53,$-208.50
2024-03-13,04:23:00,18460.0,BUY,3,0.05h,Stop Loss,$-9.00,$-217.50,$56603.00,53,$-217.50
2024-03-13,04:32:00,18213.0,SELL,3,0.02h,Stop Loss,$-9.00,$-226.50,$56594.00,53,$-226.50
2024-03-13,04:34:00,18461.25,BUY,3,0.02h,Stop Loss,$-9.00,$-235.50,$56585.00,53,$-235.50
2024-03-13,04:35:00,18214.25,SELL,3,0.02h,Stop Loss,$-9.00,$-244.50,$56576.00,53,$-244.50
2024-03-13,04:36:00,18461.25,BUY,3,0.02h,Stop Loss,$-9.00,$-253.50,$56567.00,53,$-253.50
2024-03-13,04:37:00,18213.5,SELL,3,0.02h,Stop Loss,$-9.00,$-262.50,$56558.00,53,$-262.50
2024-03-13,04:39:00,18461.75,BUY,3,0.03h,Stop Loss,$-9.00,$-271.50,$56549.00,53,$-271.50
2024-03-13,04:41:00,18214.5,SELL,3,0.03h,Stop Loss,$-9.00,$-280.50,$56540.00,53,$-280.50
2024-03-13,04:46:00,18463.25,BUY,3,0.02h,Break Even,$-1.50,$-282.00,$56538.50,53,$-282.00
2024-03-13,04:54:00,18218.75,SELL,3,0.02h,Stop Loss,$-9.00,$-291.00,$56529.50,53,$-291.00
2024-03-13,05:05:00,18469.75,BUY,3,0.02h,Break Even,$-1.50,$-292.50,$56528.00,53,$-292.50
2024-03-13,05:10:00,18224.75,SELL,3,0.02h,Break Even,$-1.50,$-294.00,$56526.50,53,$-294.00
2024-03-13,05:14:00,18472.0,BUY,3,0.02h,Stop Loss,$-9.00,$-303.00,$56517.50,53,$-303.00
2024-03-13,05:15:00,18223.75,SELL,3,0.02h,Stop Loss,$-9.00,$-312.00,$56508.50,53,$-312.00
2024-03-13,05:16:00,18472.0,BUY,3,0.02h,Stop Loss,$-9.00,$-321.00,$56499.50,53,$-321.00
2024-03-13,05:23:00,18225.75,SELL,3,0.02h,Stop Loss,$-9.00,$-330.00,$56490.50,53,$-330.00
2024-03-13,05:24:00,18474.25,BUY,3,0.02h,Stop Loss,$-9.00,$-339.00,$56481.50,53,$-339.00
2024-03-13,05:25:00,18227.5,SELL,3,0.02h,Stop Loss,$-9.00,$-348.00,$56472.50,53,$-348.00
2024-03-13,05:26:00,18476.25,BUY,3,0.02h,Break Even,$-1.50,$-349.50,$56471.00,53,$-349.50
2024-03-13,05:28:00,18231.75,SELL,3,0.02h,Stop Loss,$-9.00,$-358.50,$56462.00,53,$-358.50
2024-03-13,05:29:00,18479.5,BUY,3,0.02h,Stop Loss,$-9.00,$-367.50,$56453.00,53,$-367.50
2024-03-13,05:30:00,18231.0,SELL,3,0.02h,Stop Loss,$-9.00,$-376.50,$56444.00,53,$-376.50
2024-03-13,05:31:00,18478.5,BUY,3,0.02h,Stop Loss,$-9.00,$-385.50,$56435.00,53,$-385.50
2024-03-13,05:33:00,18227.75,SELL,3,0.02h,Stop Loss,$-9.00,$-394.50,$56426.00,53,$-394.50
2024-03-13,05:34:00,18478.0,BUY,3,0.02h,Stop Loss,$-9.00,$-403.50,$56417.00,53,$-403.50
2024-03-13,05:35:00,18230.75,SELL,3,0.02h,Stop Loss,$-9.00,$-412.50,$56408.00,53,$-412.50
2024-03-13,05:36:00,18479.0,BUY,3,0.02h,Stop Loss,$-9.00,$-421.50,$56399.00,53,$-421.50
2024-03-13,05:37:00,18234.5,SELL,3,0.02h,Stop Loss,$-9.00,$-430.50,$56390.00,53,$-430.50
2024-03-13,05:38:00,18481.25,BUY,3,0.02h,Stop Loss,$-9.00,$-439.50,$56381.00,53,$-439.50
2024-03-13,05:39:00,18234.5,SELL,3,0.02h,Break Even,$-1.50,$-441.00,$56379.50,53,$-441.00
2024-03-13,06:05:00,18477.5,BUY,3,0.02h,Break Even,$-1.50,$-442.50,$56378.00,53,$-442.50
2024-03-13,06:15:00,18228.5,SELL,3,0.02h,Stop Loss,$-9.00,$-451.50,$56369.00,53,$-451.50
2024-03-13,06:18:00,18474.75,BUY,3,0.02h,Stop Loss,$-9.00,$-460.50,$56360.00,53,$-460.50
2024-03-13,06:19:00,18226.25,SELL,3,0.02h,Break Even,$-1.50,$-462.00,$56358.50,53,$-462.00
2024-03-13,06:24:00,18471.75,BUY,3,0.02h,Stop Loss,$-9.00,$-471.00,$56349.50,53,$-471.00
2024-03-13,06:25:00,18224.25,SELL,3,0.02h,Stop Loss,$-9.00,$-480.00,$56340.50,53,$-480.00
2024-03-13,06:26:00,18471.0,BUY,3,0.03h,Stop Loss,$-9.00,$-489.00,$56331.50,53,$-489.00
2024-03-13,06:48:00,18225.25,SELL,3,0.03h,Break Even,$-1.50,$-490.50,$56330.00,53,$-490.50
2024-03-13,06:59:00,18472.75,BUY,3,0.02h,Break Even,$-1.50,$-492.00,$56328.50,53,$-492.00
2024-03-13,07:06:00,18239.25,SELL,3,0.02h,Stop Loss,$-9.00,$-501.00,$56319.50,53,$-501.00
2024-03-13,07:07:00,18490.75,BUY,3,0.02h,Stop Loss,$9.00,$-492.00,$56328.50,53,$-492.00
2024-03-13,07:11:00,18245.75,SELL,3,0.02h,Stop Loss,$-9.00,$-501.00,$56319.50,53,$-501.00
2024-03-13,07:12:00,18496.75,BUY,3,0.02h,Stop Loss,$-9.00,$-510.00,$56310.50,53,$-510.00
2024-03-13,07:13:00,18243.75,SELL,3,0.02h,Stop Loss,$-9.00,$-519.00,$56301.50,53,$-519.00
2024-03-13,07:14:00,18494.5,BUY,3,0.02h,Break Even,$-1.50,$-520.50,$56300.00,53,$-520.50
2024-03-13,07:20:00,18253.5,SELL,3,0.02h,Stop Loss,$-9.00,$-529.50,$56291.00,53,$-529.50
2024-03-13,07:21:00,18502.25,BUY,3,0.02h,Stop Loss,$-9.00,$-538.50,$56282.00,53,$-538.50
2024-03-13,07:23:00,18250.25,SELL,3,0.02h,Stop Loss,$-9.00,$-547.50,$56273.00,53,$-547.50
2024-03-13,07:24:00,18501.25,BUY,3,0.02h,Stop Loss,$-9.00,$-556.50,$56264.00,53,$-556.50
2024-03-13,07:30:00,18252.5,SELL,3,0.02h,Break Even,$-1.50,$-558.00,$56262.50,53,$-558.00
2024-03-13,07:33:00,18495.0,BUY,3,0.02h,Stop Loss,$-9.00,$-567.00,$56253.50,53,$-567.00
2024-03-13,07:34:00,18244.5,SELL,3,0.02h,Stop Loss,$-9.00,$-576.00,$56244.50,53,$-576.00
2024-03-13,07:42:00,18493.25,BUY,3,0.02h,Stop Loss,$-9.00,$-585.00,$56235.50,53,$-585.00
2024-03-13,07:43:00,18248.0,SELL,3,0.02h,Stop Loss,$-9.00,$-594.00,$56226.50,53,$-594.00
2024-03-13,07:44:00,18497.75,BUY,3,0.02h,Stop Loss,$-9.00,$-603.00,$56217.50,53,$-603.00
2024-03-13,07:46:00,18248.0,SELL,3,0.02h,Break Even,$-1.50,$-604.50,$56216.00,53,$-604.50
2024-03-13,07:51:00,18498.0,BUY,3,0.02h,Stop Loss,$-9.00,$-613.50,$56207.00,53,$-613.50
2024-03-13,07:52:00,18248.25,SELL,3,0.02h,Stop Loss,$-9.00,$-622.50,$56198.00,53,$-622.50
2024-03-13,07:53:00,18498.0,BUY,3,0.02h,Stop Loss,$-9.00,$-631.50,$56189.00,53,$-631.50
2024-03-13,07:54:00,18249.5,SELL,3,0.02h,Stop Loss,$-9.00,$-640.50,$56180.00,53,$-640.50
2024-03-13,07:59:00,18497.25,BUY,3,0.02h,Break Even,$-1.50,$-642.00,$56178.50,53,$-642.00
2024-03-13,08:02:00,18248.5,SELL,3,0.02h,Break Even,$-1.50,$-643.50,$56177.00,53,$-643.50
2024-03-13,08:08:00,18478.75,BUY,3,0.02h,Stop Loss,$-9.00,$-652.50,$56168.00,53,$-652.50
2024-03-13,08:09:00,18233.5,SELL,3,0.02h,Stop Loss,$-9.00,$-661.50,$56159.00,53,$-661.50
2024-03-13,08:10:00,18481.25,BUY,3,0.02h,Stop Loss,$16.50,$-645.00,$56175.50,53,$-645.00
2024-03-13,08:19:00,18235.25,SELL,3,0.02h,Stop Loss,$-9.00,$-654.00,$56166.50,53,$-654.00
2024-03-13,08:20:00,18489.0,BUY,3,0.02h,Stop Loss,$-9.00,$-663.00,$56157.50,53,$-663.00
2024-03-13,08:24:00,18231.5,SELL,3,0.02h,Stop Loss,$19.50,$-643.50,$56177.00,53,$-643.50
2024-03-13,08:32:00,18445.0,BUY,3,0.02h,Stop Loss,$52.50,$-591.00,$56229.50,53,$-591.00
2024-03-13,08:41:00,18206.5,SELL,3,0.02h,Stop Loss,$7.50,$-583.50,$56237.00,53,$-583.50
2024-03-13,08:49:00,18443.75,BUY,3,0.02h,Stop Loss,$19.50,$-564.00,$56256.50,53,$-564.00
2024-03-13,08:51:00,18191.75,SELL,3,0.02h,Break Even,$-1.50,$-565.50,$56255.00,53,$-565.50
2024-03-13,09:03:00,18452.5,BUY,3,0.02h,Stop Loss,$-9.00,$-574.50,$56246.00,53,$-574.50
2024-03-13,09:04:00,18194.0,SELL,3,0.02h,Stop Loss,$-9.00,$-583.50,$56237.00,53,$-583.50
2024-03-13,09:05:00,18444.25,BUY,3,0.02h,Stop Loss,$21.00,$-562.50,$56258.00,53,$-562.50
2024-03-13,09:10:00,18198.5,SELL,3,0.02h,Stop Loss,$-9.00,$-571.50,$56249.00,53,$-571.50
2024-03-13,09:11:00,18452.75,BUY,3,0.02h,Break Even,$-1.50,$-573.00,$56247.50,53,$-573.00
2024-03-13,09:16:00,18202.0,SELL,3,0.02h,Break Even,$-1.50,$-574.50,$56246.00,53,$-574.50
2024-03-13,09:20:00,18455.0,BUY,3,0.02h,Stop Loss,$-9.00,$-583.50,$56237.00,53,$-583.50
2024-03-13,09:30:00,18211.75,SELL,3,0.02h,Stop Loss,$-9.00,$-592.50,$56228.00,53,$-592.50
2024-03-13,09:31:00,18458.25,BUY,3,0.02h,Break Even,$-1.50,$-594.00,$56226.50,53,$-594.00
2024-03-13,09:39:00,18207.0,SELL,3,0.02h,Stop Loss,$6.00,$-588.00,$56232.50,53,$-588.00
2024-03-13,09:46:00,18459.25,BUY,3,0.02h,Stop Loss,$-9.00,$-597.00,$56223.50,53,$-597.00
2024-03-13,09:50:00,18209.0,SELL,3,0.02h,Stop Loss,$-9.00,$-606.00,$56214.50,53,$-606.00
2024-03-13,09:57:00,18455.5,BUY,3,0.02h,Break Even,$-1.50,$-607.50,$56213.00,53,$-607.50
2024-03-13,09:59:00,18206.75,SELL,3,0.02h,Stop Loss,$-9.00,$-616.50,$56204.00,53,$-616.50
2024-03-13,10:00:00,18458.25,BUY,3,0.02h,Break Even,$-1.50,$-618.00,$56202.50,53,$-618.00
2024-03-13,10:03:00,18212.25,SELL,3,0.02h,Stop Loss,$-9.00,$-627.00,$56193.50,53,$-627.00
2024-03-13,10:04:00,18456.0,BUY,3,0.02h,Stop Loss,$-9.00,$-636.00,$56184.50,53,$-636.00
2024-03-13,10:05:00,18206.5,SELL,3,0.02h,Stop Loss,$-9.00,$-645.00,$56175.50,53,$-645.00
2024-03-13,10:14:00,18457.25,BUY,3,0.02h,Stop Loss,$-9.00,$-654.00,$56166.50,53,$-654.00
2024-03-13,10:27:00,18210.0,SELL,3,0.02h,Break Even,$-1.50,$-655.50,$56165.00,53,$-655.50
2024-03-13,10:30:00,18458.5,BUY,3,0.02h,Stop Loss,$-9.00,$-664.50,$56156.00,53,$-664.50
2024-03-13,10:31:00,18208.75,SELL,3,0.02h,Break Even,$-1.50,$-666.00,$56154.50,53,$-666.00
2024-03-13,10:50:00,18469.25,BUY,3,0.02h,Break Even,$-1.50,$-667.50,$56153.00,53,$-667.50
2024-03-13,10:54:00,18219.0,SELL,3,0.02h,Stop Loss,$-9.00,$-676.50,$56144.00,53,$-676.50
2024-03-13,10:56:00,18470.0,BUY,3,0.02h,Stop Loss,$-9.00,$-685.50,$56135.00,53,$-685.50
2024-03-13,11:19:00,18230.75,SELL,3,0.02h,Stop Loss,$-9.00,$-694.50,$56126.00,53,$-694.50
2024-03-13,11:20:00,18477.75,BUY,3,0.02h,Stop Loss,$-9.00,$-703.50,$56117.00,53,$-703.50
2024-03-13,11:21:00,18236.5,SELL,3,0.02h,Break Even,$-1.50,$-705.00,$56115.50,53,$-705.00
2024-03-13,11:37:00,18483.0,BUY,3,0.02h,Break Even,$-1.50,$-706.50,$56114.00,53,$-706.50
2024-03-13,11:46:00,18232.5,SELL,3,0.02h,Stop Loss,$-9.00,$-715.50,$56105.00,53,$-715.50
2024-03-13,11:48:00,18480.25,BUY,3,0.02h,Break Even,$-1.50,$-717.00,$56103.50,53,$-717.00
2024-03-13,11:55:00,18219.0,SELL,3,0.02h,Stop Loss,$-9.00,$-726.00,$56094.50,53,$-726.00
2024-03-13,11:56:00,18466.25,BUY,3,0.02h,Stop Loss,$-9.00,$-735.00,$56085.50,53,$-735.00
2024-03-13,11:57:00,18213.75,SELL,3,0.02h,Break Even,$-1.50,$-736.50,$56084.00,53,$-736.50
2024-03-13,12:05:00,18450.75,BUY,3,0.02h,Stop Loss,$24.00,$-712.50,$56108.00,53,$-712.50
2024-03-13,12:07:00,18204.0,SELL,3,0.02h,Break Even,$-1.50,$-714.00,$56106.50,53,$-714.00
2024-03-13,12:09:00,18456.25,BUY,3,0.02h,Stop Loss,$-9.00,$-723.00,$56097.50,53,$-723.00
2024-03-13,12:11:00,18202.0,SELL,3,0.02h,Stop Loss,$13.50,$-709.50,$56111.00,53,$-709.50
2024-03-13,12:15:00,18455.0,BUY,3,0.02h,Break Even,$-1.50,$-711.00,$56109.50,53,$-711.00
2024-03-13,12:19:00,18198.25,SELL,3,0.02h,Stop Loss,$-9.00,$-720.00,$56100.50,53,$-720.00
2024-03-13,12:20:00,18448.0,BUY,3,0.02h,Stop Loss,$-9.00,$-729.00,$56091.50,53,$-729.00
2024-03-13,12:21:00,18199.0,SELL,3,0.02h,Stop Loss,$13.50,$-715.50,$56105.00,53,$-715.50
2024-03-13,12:42:00,18418.5,BUY,3,0.02h,Stop Loss,$-9.00,$-724.50,$56096.00,53,$-724.50
2024-03-13,12:43:00,18174.75,SELL,3,0.02h,Break Even,$-1.50,$-726.00,$56094.50,53,$-726.00
2024-03-13,12:46:00,18420.5,BUY,3,0.02h,Stop Loss,$-9.00,$-735.00,$56085.50,53,$-735.00
2024-03-13,12:47:00,18178.0,SELL,3,0.02h,Stop Loss,$4.50,$-730.50,$56090.00,53,$-730.50
2024-03-13,12:50:00,18423.25,BUY,3,0.02h,Stop Loss,$-9.00,$-739.50,$56081.00,53,$-739.50
2024-03-13,12:54:00,18168.0,SELL,3,0.02h,Stop Loss,$-9.00,$-748.50,$56072.00,53,$-748.50
2024-03-13,12:55:00,18417.0,BUY,3,0.02h,Break Even,$-1.50,$-750.00,$56070.50,53,$-750.00
2024-03-13,12:58:00,18171.25,SELL,3,0.02h,Stop Loss,$-9.00,$-759.00,$56061.50,53,$-759.00
2024-03-13,12:59:00,18424.25,BUY,3,0.02h,Break Even,$-1.50,$-760.50,$56060.00,53,$-760.50
2024-03-13,13:15:00,18192.5,SELL,3,0.02h,Stop Loss,$-9.00,$-769.50,$56051.00,53,$-769.50
2024-03-13,13:16:00,18437.5,BUY,3,0.02h,Break Even,$-1.50,$-771.00,$56049.50,53,$-771.00
2024-03-13,13:20:00,18190.5,SELL,3,0.02h,Stop Loss,$-9.00,$-780.00,$56040.50,53,$-780.00
2024-03-13,13:21:00,18435.5,BUY,3,0.02h,Stop Loss,$-9.00,$-789.00,$56031.50,53,$-789.00
2024-03-13,13:23:00,18187.25,SELL,3,0.02h,Stop Loss,$-9.00,$-798.00,$56022.50,53,$-798.00
2024-03-13,13:24:00,18432.0,BUY,3,0.02h,Stop Loss,$-9.00,$-807.00,$56013.50,53,$-807.00
2024-03-13,13:25:00,18184.0,SELL,3,0.02h,Break Even,$-1.50,$-808.50,$56012.00,53,$-808.50
2024-03-13,13:29:00,18429.0,BUY,3,0.02h,Stop Loss,$15.00,$-793.50,$56027.00,53,$-793.50
2024-03-13,13:37:00,18152.75,SELL,3,0.02h,Stop Loss,$40.50,$-753.00,$56067.50,53,$-753.00
2024-03-13,13:50:00,18350.5,BUY,3,0.02h,Stop Loss,$-9.00,$-762.00,$56058.50,53,$-762.00
2024-03-13,13:51:00,18108.75,SELL,3,0.02h,Stop Loss,$-9.00,$-771.00,$56049.50,53,$-771.00
2024-03-13,13:58:00,18347.25,BUY,3,0.02h,Break Even,$-1.50,$-772.50,$56048.00,53,$-772.50
2024-03-13,14:01:00,18076.5,SELL,3,0.02h,Stop Loss,$81.00,$-691.50,$56129.00,53,$-691.50
2024-03-13,14:10:00,18337.75,BUY,3,0.02h,Stop Loss,$-9.00,$-700.50,$56120.00,53,$-700.50
2024-03-13,14:12:00,18102.5,SELL,3,0.02h,Stop Loss,$-9.00,$-709.50,$56111.00,53,$-709.50
2024-03-13,14:13:00,18355.0,BUY,3,0.02h,Stop Loss,$-9.00,$-718.50,$56102.00,53,$-718.50
2024-03-13,14:24:00,18097.0,SELL,3,0.02h,Break Even,$-1.50,$-720.00,$56100.50,53,$-720.00
2024-03-13,14:40:00,18346.0,BUY,3,0.02h,Stop Loss,$22.50,$-697.50,$56123.00,53,$-697.50
2024-03-13,14:48:00,18118.75,SELL,3,0.02h,Stop Loss,$73.50,$-624.00,$56196.50,53,$-624.00
2024-03-13,14:50:00,18360.25,BUY,3,0.02h,Break Even,$-1.50,$-625.50,$56195.00,53,$-625.50
2024-03-13,14:52:00,18092.75,SELL,3,0.02h,Stop Loss,$10.50,$-615.00,$56205.50,53,$-615.00
2024-03-13,15:03:00,18336.75,BUY,3,0.02h,Stop Loss,$24.00,$-591.00,$56229.50,53,$-591.00
2024-03-13,15:13:00,18115.25,SELL,3,0.02h,Stop Loss,$46.50,$-544.50,$56276.00,53,$-544.50
2024-03-13,15:17:00,18347.5,BUY,3,0.02h,Stop Loss,$-9.00,$-553.50,$56267.00,53,$-553.50
2024-03-13,15:18:00,18105.5,SELL,3,0.02h,Stop Loss,$-9.00,$-562.50,$56258.00,53,$-562.50
2024-03-13,15:19:00,18363.0,BUY,3,0.02h,Stop Loss,$-9.00,$-571.50,$56249.00,53,$-571.50
2024-03-13,15:20:00,18107.5,SELL,3,0.02h,Stop Loss,$28.50,$-543.00,$56277.50,53,$-543.00
2024-03-13,15:27:00,18341.75,BUY,3,0.02h,Stop Loss,$4.50,$-538.50,$56282.00,53,$-538.50
2024-03-13,15:33:00,18088.75,SELL,3,0.02h,Stop Loss,$-9.00,$-547.50,$56273.00,53,$-547.50
2024-03-13,15:34:00,18326.75,BUY,3,0.02h,Break Even,$-1.50,$-549.00,$56271.50,53,$-549.00
2024-03-13,15:39:00,18077.25,SELL,3,0.02h,Stop Loss,$-9.00,$-558.00,$56262.50,53,$-558.00
2024-03-13,15:40:00,18315.0,BUY,3,0.02h,Stop Loss,$-9.00,$-567.00,$56253.50,53,$-567.00
2024-03-13,15:41:00,18064.5,SELL,3,0.02h,Stop Loss,$57.00,$-510.00,$56310.50,53,$-510.00
2024-03-13,15:59:00,18330.25,BUY,3,0.02h,Stop Loss,$-9.00,$-519.00,$56301.50,53,$-519.00
2024-03-13,16:21:00,18089.5,SELL,3,0.02h,Stop Loss,$-9.00,$-528.00,$56292.50,53,$-528.00
2024-03-13,16:22:00,18338.5,BUY,3,0.02h,Stop Loss,$10.50,$-517.50,$56303.00,53,$-517.50
2024-03-13,16:24:00,18090.0,SELL,3,0.02h,Stop Loss,$-9.00,$-526.50,$56294.00,53,$-526.50
2024-03-13,16:39:00,18333.25,BUY,3,0.02h,Stop Loss,$-9.00,$-535.50,$56285.00,53,$-535.50
2024-03-13,16:40:00,18091.25,SELL,3,0.02h,Break Even,$-1.50,$-537.00,$56283.50,53,$-537.00
2024-03-13,16:44:00,18351.5,BUY,3,0.02h,Break Even,$-1.50,$-538.50,$56282.00,53,$-538.50
2024-03-13,17:01:00,18112.0,SELL,3,0.02h,Stop Loss,$34.50,$-504.00,$56316.50,53,$-504.00
2024-03-13,17:05:00,18362.75,BUY,3,0.02h,Stop Loss,$-9.00,$-513.00,$56307.50,53,$-513.00
2024-03-13,17:06:00,18116.75,SELL,3,0.02h,Stop Loss,$-9.00,$-522.00,$56298.50,53,$-522.00
2024-03-13,17:09:00,18384.75,BUY,3,0.02h,Stop Loss,$-9.00,$-531.00,$56289.50,53,$-531.00
2024-03-13,17:10:00,18129.0,SELL,3,0.02h,Stop Loss,$-9.00,$-540.00,$56280.50,53,$-540.00
2024-03-13,17:11:00,18385.0,BUY,3,0.02h,Break Even,$-1.50,$-541.50,$56279.00,53,$-541.50
2024-03-13,17:17:00,18104.25,SELL,3,0.02h,Stop Loss,$-9.00,$-550.50,$56270.00,53,$-550.50
2024-03-13,17:18:00,18357.0,BUY,3,0.02h,Stop Loss,$-9.00,$-559.50,$56261.00,53,$-559.50
2024-03-13,17:19:00,18109.5,SELL,3,0.02h,Break Even,$-1.50,$-561.00,$56259.50,53,$-561.00
2024-03-13,17:23:00,18366.0,BUY,3,0.02h,Break Even,$-1.50,$-562.50,$56258.00,53,$-562.50
2024-03-13,17:26:00,18123.25,SELL,3,0.02h,Stop Loss,$-9.00,$-571.50,$56249.00,53,$-571.50
2024-03-13,17:27:00,18375.25,BUY,3,0.02h,Stop Loss,$-9.00,$-580.50,$56240.00,53,$-580.50
2024-03-13,17:28:00,18128.0,SELL,3,0.02h,Break Even,$-1.50,$-582.00,$56238.50,53,$-582.00
2024-03-13,17:30:00,18385.0,BUY,3,0.02h,Stop Loss,$-9.00,$-591.00,$56229.50,53,$-591.00
2024-03-13,17:31:00,18142.5,SELL,3,0.02h,Stop Loss,$-9.00,$-600.00,$56220.50,53,$-600.00
2024-03-13,17:32:00,18381.0,BUY,3,0.02h,Break Even,$-1.50,$-601.50,$56219.00,53,$-601.50
2024-03-13,17:37:00,18131.75,SELL,3,0.02h,Break Even,$-1.50,$-603.00,$56217.50,53,$-603.00
2024-03-13,17:39:00,18380.0,BUY,3,0.02h,Break Even,$-1.50,$-604.50,$56216.00,53,$-604.50
2024-03-13,17:46:00,18125.25,SELL,3,0.02h,Stop Loss,$7.50,$-597.00,$56223.50,53,$-597.00
2024-03-13,17:54:00,18393.25,BUY,3,0.02h,Break Even,$-1.50,$-598.50,$56222.00,53,$-598.50
2024-03-13,18:00:00,18136.25,SELL,3,0.02h,Stop Loss,$-9.00,$-607.50,$56213.00,53,$-607.50
2024-03-13,18:01:00,18389.0,BUY,3,0.02h,Stop Loss,$18.00,$-589.50,$56231.00,53,$-589.50
2024-03-13,18:14:00,18132.75,SELL,3,0.02h,Stop Loss,$-9.00,$-598.50,$56222.00,53,$-598.50
2024-03-13,18:15:00,18377.0,BUY,3,0.02h,Break Even,$-1.50,$-600.00,$56220.50,53,$-600.00
2024-03-13,18:17:00,18130.0,SELL,3,0.02h,Break Even,$-1.50,$-601.50,$56219.00,53,$-601.50
2024-03-13,18:29:00,18383.5,BUY,3,0.02h,Stop Loss,$-9.00,$-610.50,$56210.00,53,$-610.50
2024-03-13,18:30:00,18131.5,SELL,3,0.02h,Stop Loss,$-9.00,$-619.50,$56201.00,53,$-619.50
2024-03-13,18:37:00,18385.25,BUY,3,0.02h,Stop Loss,$-9.00,$-628.50,$56192.00,53,$-628.50
2024-03-13,18:38:00,18130.5,SELL,3,0.02h,Stop Loss,$-9.00,$-637.50,$56183.00,53,$-637.50
2024-03-13,18:40:00,18385.5,BUY,3,0.02h,Stop Loss,$22.50,$-615.00,$56205.50,53,$-615.00
2024-03-13,18:51:00,18142.25,SELL,3,0.02h,Break Even,$-1.50,$-616.50,$56204.00,53,$-616.50
2024-03-13,18:55:00,18391.0,BUY,3,0.02h,Stop Loss,$-9.00,$-625.50,$56195.00,53,$-625.50
2024-03-13,18:56:00,18144.75,SELL,3,0.02h,Stop Loss,$-9.00,$-634.50,$56186.00,53,$-634.50
2024-03-13,18:57:00,18391.5,BUY,3,0.02h,Break Even,$-1.50,$-636.00,$56184.50,53,$-636.00
2024-03-13,19:04:00,18133.0,SELL,3,0.02h,Stop Loss,$-9.00,$-645.00,$56175.50,53,$-645.00
2024-03-13,19:05:00,18384.0,BUY,3,0.02h,Stop Loss,$-9.00,$-654.00,$56166.50,53,$-654.00
2024-03-13,19:08:00,18123.0,SELL,3,0.02h,Stop Loss,$-9.00,$-663.00,$56157.50,53,$-663.00
2024-03-13,19:09:00,18373.75,BUY,3,0.02h,Stop Loss,$9.00,$-654.00,$56166.50,53,$-654.00
2024-03-13,19:11:00,18123.75,SELL,3,0.02h,Stop Loss,$21.00,$-633.00,$56187.50,53,$-633.00
2024-03-13,19:14:00,18374.25,BUY,3,0.02h,Stop Loss,$-9.00,$-642.00,$56178.50,53,$-642.00
2024-03-13,19:15:00,18118.75,SELL,3,0.02h,Stop Loss,$-9.00,$-651.00,$56169.50,53,$-651.00
2024-03-13,19:16:00,18373.5,BUY,3,0.02h,Stop Loss,$16.50,$-634.50,$56186.00,53,$-634.50
2024-03-13,19:18:00,18132.5,SELL,3,0.02h,Stop Loss,$-9.00,$-643.50,$56177.00,53,$-643.50
2024-03-13,19:19:00,18381.0,BUY,3,0.02h,Stop Loss,$16.50,$-627.00,$56193.50,53,$-627.00
2024-03-13,19:21:00,18131.75,SELL,3,0.02h,Stop Loss,$-9.00,$-636.00,$56184.50,53,$-636.00
2024-03-13,19:22:00,18378.0,BUY,3,0.02h,Stop Loss,$4.50,$-631.50,$56189.00,53,$-631.50
2024-03-13,19:27:00,18116.5,SELL,3,0.02h,Stop Loss,$172.50,$-459.00,$56361.50,53,$-459.00
2024-03-13,19:38:00,18320.5,BUY,3,0.02h,Break Even,$-1.50,$-460.50,$56360.00,53,$-460.50
2024-03-13,19:41:00,18071.0,SELL,3,0.02h,Stop Loss,$-9.00,$-469.50,$56351.00,53,$-469.50
2024-03-13,19:43:00,18332.5,BUY,3,0.02h,Stop Loss,$-9.00,$-478.50,$56342.00,53,$-478.50
2024-03-13,19:44:00,18081.75,SELL,3,0.02h,Break Even,$-1.50,$-480.00,$56340.50,53,$-480.00
2024-03-13,20:02:00,18336.5,BUY,3,0.02h,Stop Loss,$-9.00,$-489.00,$56331.50,53,$-489.00
2024-03-13,20:09:00,18087.75,SELL,3,0.02h,Stop Loss,$-9.00,$-498.00,$56322.50,53,$-498.00
2024-03-13,20:10:00,18341.0,BUY,3,0.02h,Stop Loss,$-9.00,$-507.00,$56313.50,53,$-507.00
2024-03-13,20:11:00,18091.0,SELL,3,0.02h,Stop Loss,$-9.00,$-516.00,$56304.50,53,$-516.00
2024-03-13,20:17:00,18345.0,BUY,3,0.02h,Stop Loss,$-9.00,$-525.00,$56295.50,53,$-525.00
2024-03-13,20:18:00,18095.25,SELL,3,0.05h,Break Even,$-1.50,$-526.50,$56294.00,53,$-526.50
2024-03-13,20:24:00,18343.5,BUY,3,0.02h,Stop Loss,$-9.00,$-535.50,$56285.00,53,$-535.50
2024-03-13,20:25:00,18093.75,SELL,3,0.02h,Stop Loss,$-9.00,$-544.50,$56276.00,53,$-544.50
2024-03-13,20:29:00,18347.5,BUY,3,0.02h,Stop Loss,$-9.00,$-553.50,$56267.00,53,$-553.50
2024-03-13,20:47:00,18099.5,SELL,3,0.02h,Break Even,$-1.50,$-555.00,$56265.50,53,$-555.00
2024-03-13,20:56:00,18356.0,BUY,3,0.02h,Stop Loss,$-9.00,$-564.00,$56256.50,53,$-564.00
2024-03-13,20:57:00,18104.75,SELL,3,0.02h,Stop Loss,$-9.00,$-573.00,$56247.50,53,$-573.00
2024-03-13,23:00:00,18357.5,BUY,3,0.02h,Stop Loss,$-9.00,$-582.00,$56238.50,53,$-582.00
2024-03-13,23:01:00,18108.5,SELL,3,0.02h,Stop Loss,$-9.00,$-591.00,$56229.50,53,$-591.00
2024-03-13,23:02:00,18357.75,BUY,3,0.02h,Break Even,$-1.50,$-592.50,$56228.00,53,$-592.50
2024-03-13,23:08:00,18113.75,SELL,3,0.02h,Stop Loss,$-9.00,$-601.50,$56219.00,53,$-601.50
2024-03-13,23:13:00,18364.75,BUY,3,0.02h,Stop Loss,$-9.00,$-610.50,$56210.00,53,$-610.50
2024-03-13,23:20:00,18116.5,SELL,3,0.02h,Stop Loss,$-9.00,$-619.50,$56201.00,53,$-619.50
2024-03-13,23:21:00,18366.0,BUY,3,0.02h,Stop Loss,$-9.00,$-628.50,$56192.00,53,$-628.50
2024-03-13,23:23:00,18115.75,SELL,3,0.03h,Stop Loss,$-9.00,$-637.50,$56183.00,53,$-637.50
2024-03-13,23:25:00,18366.0,BUY,3,0.02h,Stop Loss,$-9.00,$-646.50,$56174.00,53,$-646.50
2024-03-13,23:26:00,18116.0,SELL,3,0.02h,Stop Loss,$-9.00,$-655.50,$56165.00,53,$-655.50
2024-03-13,23:37:00,18375.0,BUY,3,0.03h,Stop Loss,$-9.00,$-664.50,$56156.00,53,$-664.50
2024-03-13,23:46:00,18122.75,SELL,3,0.05h,Stop Loss,$-9.00,$-673.50,$56147.00,53,$-673.50
2024-03-13,23:51:00,18373.5,BUY,3,0.02h,Stop Loss,$-9.00,$-682.50,$56138.00,53,$-682.50
2024-03-13,23:52:00,18123.75,SELL,3,0.15h,Break Even,$-1.50,$-684.00,$56136.50,53,$-684.00
,,,,,,,,,,,
2024-03-14,00:02:00,18367.5,BUY,3,0.02h,Stop Loss,$-9.00,$-9.00,$56127.50,54,$-9.00
2024-03-14,00:13:00,18114.5,SELL,3,0.05h,Break Even,$-1.50,$-10.50,$56126.00,54,$-10.50
2024-03-14,00:23:00,18361.25,BUY,3,0.02h,Stop Loss,$-9.00,$-19.50,$56117.00,54,$-19.50
2024-03-14,00:27:00,18104.5,SELL,3,0.02h,Stop Loss,$-9.00,$-28.50,$56108.00,54,$-28.50
2024-03-14,00:31:00,18357.5,BUY,3,0.02h,Stop Loss,$-9.00,$-37.50,$56099.00,54,$-37.50
2024-03-14,00:32:00,18108.75,SELL,3,0.02h,Stop Loss,$-9.00,$-46.50,$56090.00,54,$-46.50
2024-03-14,00:33:00,18359.0,BUY,3,0.02h,Stop Loss,$-9.00,$-55.50,$56081.00,54,$-55.50
2024-03-14,00:34:00,18110.5,SELL,3,0.02h,Stop Loss,$-9.00,$-64.50,$56072.00,54,$-64.50
2024-03-14,00:46:00,18363.0,BUY,3,0.02h,Break Even,$-1.50,$-66.00,$56070.50,54,$-66.00
2024-03-14,00:53:00,18118.0,SELL,3,0.03h,Stop Loss,$-9.00,$-75.00,$56061.50,54,$-75.00
2024-03-14,00:55:00,18367.25,BUY,3,0.03h,Break Even,$-1.50,$-76.50,$56060.00,54,$-76.50
2024-03-14,00:59:00,18119.5,SELL,3,0.03h,Break Even,$-1.50,$-78.00,$56058.50,54,$-78.00
2024-03-14,01:05:00,18370.0,BUY,3,0.02h,Stop Loss,$-9.00,$-87.00,$56049.50,54,$-87.00
2024-03-14,01:10:00,18122.25,SELL,3,0.03h,Stop Loss,$-9.00,$-96.00,$56040.50,54,$-96.00
2024-03-14,01:12:00,18367.0,BUY,3,0.02h,Stop Loss,$-9.00,$-105.00,$56031.50,54,$-105.00
2024-03-14,01:15:00,18114.0,SELL,3,0.02h,Stop Loss,$-9.00,$-114.00,$56022.50,54,$-114.00
2024-03-14,01:20:00,18365.0,BUY,3,0.02h,Stop Loss,$-9.00,$-123.00,$56013.50,54,$-123.00
2024-03-14,01:21:00,18117.25,SELL,3,0.02h,Stop Loss,$-9.00,$-132.00,$56004.50,54,$-132.00
2024-03-14,01:22:00,18368.5,BUY,3,0.02h,Stop Loss,$-9.00,$-141.00,$55995.50,54,$-141.00
2024-03-14,01:32:00,18116.5,SELL,3,0.02h,Stop Loss,$-9.00,$-150.00,$55986.50,54,$-150.00
2024-03-14,01:37:00,18369.0,BUY,3,0.02h,Stop Loss,$-9.00,$-159.00,$55977.50,54,$-159.00
2024-03-14,01:38:00,18122.25,SELL,3,0.02h,Stop Loss,$-9.00,$-168.00,$55968.50,54,$-168.00
2024-03-14,01:39:00,18373.5,BUY,3,0.02h,Break Even,$-1.50,$-169.50,$55967.00,54,$-169.50
2024-03-14,01:44:00,18125.25,SELL,3,0.03h,Stop Loss,$-9.00,$-178.50,$55958.00,54,$-178.50
2024-03-14,01:49:00,18375.75,BUY,3,0.02h,Break Even,$-1.50,$-180.00,$55956.50,54,$-180.00
2024-03-14,02:00:00,18129.0,SELL,3,0.02h,Stop Loss,$-9.00,$-189.00,$55947.50,54,$-189.00
2024-03-14,02:15:00,18372.25,BUY,3,0.02h,Stop Loss,$-9.00,$-198.00,$55938.50,54,$-198.00
2024-03-14,02:16:00,18123.25,SELL,3,0.02h,Stop Loss,$-9.00,$-207.00,$55929.50,54,$-207.00
2024-03-14,02:17:00,18373.25,BUY,3,0.02h,Stop Loss,$-9.00,$-216.00,$55920.50,54,$-216.00
2024-03-14,02:19:00,18124.5,SELL,3,0.02h,Stop Loss,$-9.00,$-225.00,$55911.50,54,$-225.00
2024-03-14,02:20:00,18375.75,BUY,3,0.02h,Stop Loss,$-9.00,$-234.00,$55902.50,54,$-234.00
2024-03-14,02:21:00,18122.25,SELL,3,0.02h,Stop Loss,$-9.00,$-243.00,$55893.50,54,$-243.00
2024-03-14,02:22:00,18372.5,BUY,3,0.02h,Stop Loss,$-9.00,$-252.00,$55884.50,54,$-252.00
2024-03-14,02:24:00,18124.5,SELL,3,0.02h,Stop Loss,$-9.00,$-261.00,$55875.50,54,$-261.00
2024-03-14,02:25:00,18376.25,BUY,3,0.03h,Break Even,$-1.50,$-262.50,$55874.00,54,$-262.50
2024-03-14,02:38:00,18126.25,SELL,3,0.05h,Stop Loss,$-9.00,$-271.50,$55865.00,54,$-271.50
2024-03-14,02:44:00,18377.25,BUY,3,0.07h,Break Even,$-1.50,$-273.00,$55863.50,54,$-273.00
2024-03-14,02:49:00,18127.5,SELL,3,0.03h,Stop Loss,$-9.00,$-282.00,$55854.50,54,$-282.00
2024-03-14,02:53:00,18377.25,BUY,3,0.02h,Stop Loss,$-9.00,$-291.00,$55845.50,54,$-291.00
2024-03-14,02:54:00,18126.25,SELL,3,0.02h,Stop Loss,$-9.00,$-300.00,$55836.50,54,$-300.00
2024-03-14,02:55:00,18376.25,BUY,3,0.02h,Stop Loss,$-9.00,$-309.00,$55827.50,54,$-309.00
2024-03-14,02:58:00,18125.0,SELL,3,0.02h,Stop Loss,$-9.00,$-318.00,$55818.50,54,$-318.00
2024-03-14,02:59:00,18374.5,BUY,3,0.02h,Stop Loss,$-9.00,$-327.00,$55809.50,54,$-327.00
2024-03-14,03:00:00,18122.0,SELL,3,0.02h,Stop Loss,$-9.00,$-336.00,$55800.50,54,$-336.00
2024-03-14,03:01:00,18371.5,BUY,3,0.02h,Stop Loss,$-9.00,$-345.00,$55791.50,54,$-345.00
2024-03-14,03:06:00,18123.0,SELL,3,0.02h,Stop Loss,$-9.00,$-354.00,$55782.50,54,$-354.00
2024-03-14,03:14:00,18372.5,BUY,3,0.02h,Stop Loss,$-9.00,$-363.00,$55773.50,54,$-363.00
2024-03-14,03:15:00,18122.5,SELL,3,0.02h,Break Even,$-1.50,$-364.50,$55772.00,54,$-364.50
2024-03-14,03:21:00,18369.0,BUY,3,0.02h,Stop Loss,$-9.00,$-373.50,$55763.00,54,$-373.50
2024-03-14,03:22:00,18118.25,SELL,3,0.02h,Stop Loss,$-9.00,$-382.50,$55754.00,54,$-382.50
2024-03-14,03:23:00,18368.5,BUY,3,0.03h,Stop Loss,$-9.00,$-391.50,$55745.00,54,$-391.50
2024-03-14,03:26:00,18118.75,SELL,3,0.07h,Break Even,$-1.50,$-393.00,$55743.50,54,$-393.00
2024-03-14,03:35:00,18367.5,BUY,3,0.02h,Stop Loss,$-9.00,$-402.00,$55734.50,54,$-402.00
2024-03-14,03:40:00,18113.75,SELL,3,0.02h,Stop Loss,$-9.00,$-411.00,$55725.50,54,$-411.00
2024-03-14,03:41:00,18364.5,BUY,3,0.02h,Stop Loss,$-9.00,$-420.00,$55716.50,54,$-420.00
2024-03-14,03:42:00,18115.0,SELL,3,0.03h,Stop Loss,$-9.00,$-429.00,$55707.50,54,$-429.00
2024-03-14,03:44:00,18365.0,BUY,3,0.02h,Stop Loss,$-9.00,$-438.00,$55698.50,54,$-438.00
2024-03-14,03:45:00,18115.75,SELL,3,0.02h,Break Even,$-1.50,$-439.50,$55697.00,54,$-439.50
2024-03-14,03:48:00,18366.75,BUY,3,0.03h,Stop Loss,$-9.00,$-448.50,$55688.00,54,$-448.50
2024-03-14,03:51:00,18118.25,SELL,3,0.02h,Stop Loss,$-9.00,$-457.50,$55679.00,54,$-457.50
2024-03-14,03:52:00,18369.0,BUY,3,0.03h,Stop Loss,$-9.00,$-466.50,$55670.00,54,$-466.50
2024-03-14,03:55:00,18120.25,SELL,3,0.03h,Stop Loss,$-9.00,$-475.50,$55661.00,54,$-475.50
2024-03-14,03:57:00,18370.0,BUY,3,0.02h,Break Even,$-1.50,$-477.00,$55659.50,54,$-477.00
2024-03-14,04:00:00,18121.5,SELL,3,0.02h,Stop Loss,$-9.00,$-486.00,$55650.50,54,$-486.00
2024-03-14,04:02:00,18373.75,BUY,3,0.02h,Stop Loss,$-9.00,$-495.00,$55641.50,54,$-495.00
2024-03-14,04:03:00,18121.0,SELL,3,0.02h,Stop Loss,$-9.00,$-504.00,$55632.50,54,$-504.00
2024-03-14,04:04:00,18370.25,BUY,3,0.03h,Break Even,$-1.50,$-505.50,$55631.00,54,$-505.50
2024-03-14,04:16:00,18117.0,SELL,3,0.02h,Stop Loss,$-9.00,$-514.50,$55622.00,54,$-514.50
2024-03-14,04:25:00,18370.25,BUY,3,0.02h,Stop Loss,$-9.00,$-523.50,$55613.00,54,$-523.50
2024-03-14,04:31:00,18119.0,SELL,3,0.02h,Stop Loss,$-9.00,$-532.50,$55604.00,54,$-532.50
2024-03-14,04:32:00,18369.5,BUY,3,0.02h,Stop Loss,$-9.00,$-541.50,$55595.00,54,$-541.50
2024-03-14,04:33:00,18118.75,SELL,3,0.05h,Stop Loss,$-9.00,$-550.50,$55586.00,54,$-550.50
2024-03-14,04:48:00,18374.75,BUY,3,0.02h,Stop Loss,$-9.00,$-559.50,$55577.00,54,$-559.50
2024-03-14,04:49:00,18125.25,SELL,3,0.02h,Stop Loss,$-9.00,$-568.50,$55568.00,54,$-568.50
2024-03-14,04:53:00,18378.0,BUY,3,0.02h,Stop Loss,$-9.00,$-577.50,$55559.00,54,$-577.50
2024-03-14,04:55:00,18128.0,SELL,3,0.02h,Stop Loss,$-9.00,$-586.50,$55550.00,54,$-586.50
2024-03-14,04:56:00,18377.5,BUY,3,0.05h,Break Even,$-1.50,$-588.00,$55548.50,54,$-588.00
2024-03-14,05:01:00,18131.75,SELL,3,0.02h,Stop Loss,$-9.00,$-597.00,$55539.50,54,$-597.00
2024-03-14,05:04:00,18384.75,BUY,3,0.03h,Stop Loss,$-9.00,$-606.00,$55530.50,54,$-606.00
2024-03-14,05:19:00,18128.75,SELL,3,0.02h,Stop Loss,$-9.00,$-615.00,$55521.50,54,$-615.00
2024-03-14,05:20:00,18377.5,BUY,3,0.05h,Stop Loss,$-9.00,$-624.00,$55512.50,54,$-624.00
2024-03-14,05:34:00,18131.5,SELL,3,0.02h,Stop Loss,$-9.00,$-633.00,$55503.50,54,$-633.00
2024-03-14,05:40:00,18382.0,BUY,3,0.02h,Stop Loss,$-9.00,$-642.00,$55494.50,54,$-642.00
2024-03-14,05:43:00,18130.0,SELL,3,0.07h,Stop Loss,$-9.00,$-651.00,$55485.50,54,$-651.00
2024-03-14,05:54:00,18383.5,BUY,3,0.03h,Stop Loss,$-9.00,$-660.00,$55476.50,54,$-660.00
2024-03-14,05:58:00,18132.75,SELL,3,0.02h,Stop Loss,$-9.00,$-669.00,$55467.50,54,$-669.00
2024-03-14,05:59:00,18383.75,BUY,3,0.03h,Stop Loss,$-9.00,$-678.00,$55458.50,54,$-678.00
2024-03-14,06:03:00,18129.25,SELL,3,0.02h,Stop Loss,$-9.00,$-687.00,$55449.50,54,$-687.00
2024-03-14,06:04:00,18380.5,BUY,3,0.02h,Stop Loss,$-9.00,$-696.00,$55440.50,54,$-696.00
2024-03-14,06:05:00,18129.5,SELL,3,0.03h,Stop Loss,$-9.00,$-705.00,$55431.50,54,$-705.00
2024-03-14,06:08:00,18385.25,BUY,3,0.02h,Stop Loss,$-9.00,$-714.00,$55422.50,54,$-714.00
2024-03-14,06:11:00,18132.0,SELL,3,0.02h,Stop Loss,$-9.00,$-723.00,$55413.50,54,$-723.00
2024-03-14,06:17:00,18383.5,BUY,3,0.03h,Stop Loss,$-9.00,$-732.00,$55404.50,54,$-732.00
2024-03-14,06:19:00,18136.0,SELL,3,0.02h,Stop Loss,$-9.00,$-741.00,$55395.50,54,$-741.00
2024-03-14,06:21:00,18391.75,BUY,3,0.02h,Stop Loss,$-9.00,$-750.00,$55386.50,54,$-750.00
2024-03-14,06:28:00,18135.25,SELL,3,0.02h,Stop Loss,$-9.00,$-759.00,$55377.50,54,$-759.00
2024-03-14,06:29:00,18384.0,BUY,3,0.02h,Stop Loss,$-9.00,$-768.00,$55368.50,54,$-768.00
2024-03-14,06:30:00,18136.0,SELL,3,0.02h,Stop Loss,$-9.00,$-777.00,$55359.50,54,$-777.00
2024-03-14,06:31:00,18385.0,BUY,3,0.02h,Stop Loss,$-9.00,$-786.00,$55350.50,54,$-786.00
2024-03-14,06:44:00,18133.75,SELL,3,0.02h,Stop Loss,$-9.00,$-795.00,$55341.50,54,$-795.00
2024-03-14,06:50:00,18385.25,BUY,3,0.02h,Stop Loss,$-9.00,$-804.00,$55332.50,54,$-804.00
2024-03-14,06:54:00,18134.25,SELL,3,0.02h,Stop Loss,$-9.00,$-813.00,$55323.50,54,$-813.00
2024-03-14,07:16:00,18375.0,BUY,3,0.02h,Stop Loss,$-9.00,$-822.00,$55314.50,54,$-822.00
2024-03-14,07:17:00,18129.25,SELL,3,0.02h,Stop Loss,$-9.00,$-831.00,$55305.50,54,$-831.00
2024-03-14,07:18:00,18379.75,BUY,3,0.02h,Stop Loss,$-9.00,$-840.00,$55296.50,54,$-840.00
2024-03-14,07:19:00,18134.25,SELL,3,0.02h,Stop Loss,$15.00,$-825.00,$55311.50,54,$-825.00
2024-03-14,07:29:00,18383.5,BUY,3,0.02h,Break Even,$-1.50,$-826.50,$55310.00,54,$-826.50
2024-03-14,07:36:00,18142.75,SELL,3,0.02h,Break Even,$-1.50,$-828.00,$55308.50,54,$-828.00
2024-03-14,07:38:00,18390.0,BUY,3,0.02h,Stop Loss,$-9.00,$-837.00,$55299.50,54,$-837.00
2024-03-14,07:41:00,18138.25,SELL,3,0.02h,Stop Loss,$-9.00,$-846.00,$55290.50,54,$-846.00
2024-03-14,07:42:00,18388.5,BUY,3,0.02h,Stop Loss,$16.50,$-829.50,$55307.00,54,$-829.50
2024-03-14,07:45:00,18143.5,SELL,3,0.02h,Stop Loss,$-9.00,$-838.50,$55298.00,54,$-838.50
2024-03-14,07:48:00,18394.25,BUY,3,0.02h,Stop Loss,$-9.00,$-847.50,$55289.00,54,$-847.50
2024-03-14,08:01:00,18150.75,SELL,3,0.02h,Stop Loss,$-9.00,$-856.50,$55280.00,54,$-856.50
2024-03-14,08:02:00,18399.25,BUY,3,0.02h,Stop Loss,$3.00,$-853.50,$55283.00,54,$-853.50
2024-03-14,08:12:00,18168.0,SELL,3,0.02h,Break Even,$-1.50,$-855.00,$55281.50,54,$-855.00
2024-03-14,08:18:00,18417.25,BUY,3,0.02h,Break Even,$-1.50,$-856.50,$55280.00,54,$-856.50
2024-03-14,08:21:00,18175.0,SELL,3,0.02h,Break Even,$-1.50,$-858.00,$55278.50,54,$-858.00
2024-03-14,08:23:00,18418.25,BUY,3,0.02h,Stop Loss,$4.50,$-853.50,$55283.00,54,$-853.50
2024-03-14,08:28:00,18172.0,SELL,3,0.02h,Break Even,$-1.50,$-855.00,$55281.50,54,$-855.00
2024-03-14,08:33:00,18409.75,BUY,3,0.02h,Stop Loss,$7.50,$-847.50,$55289.00,54,$-847.50
2024-03-14,08:36:00,18163.25,SELL,3,0.02h,Stop Loss,$-9.00,$-856.50,$55280.00,54,$-856.50
2024-03-14,08:41:00,18415.25,BUY,3,0.02h,Stop Loss,$-9.00,$-865.50,$55271.00,54,$-865.50
2024-03-14,08:50:00,18162.5,SELL,3,0.02h,Break Even,$-1.50,$-867.00,$55269.50,54,$-867.00
2024-03-14,08:52:00,18410.25,BUY,3,0.02h,Break Even,$-1.50,$-868.50,$55268.00,54,$-868.50
2024-03-14,09:00:00,18167.5,SELL,3,0.02h,Break Even,$-1.50,$-870.00,$55266.50,54,$-870.00
2024-03-14,09:11:00,18414.0,BUY,3,0.02h,Break Even,$-1.50,$-871.50,$55265.00,54,$-871.50
2024-03-14,09:14:00,18170.0,SELL,3,0.02h,Stop Loss,$-9.00,$-880.50,$55256.00,54,$-880.50
2024-03-14,09:17:00,18413.0,BUY,3,0.02h,Stop Loss,$-9.00,$-889.50,$55247.00,54,$-889.50
2024-03-14,09:18:00,18162.75,SELL,3,0.02h,Stop Loss,$-9.00,$-898.50,$55238.00,54,$-898.50
2024-03-14,09:19:00,18414.0,BUY,3,0.02h,Break Even,$-1.50,$-900.00,$55236.50,54,$-900.00
2024-03-14,09:23:00,18171.5,SELL,3,0.02h,Break Even,$-1.50,$-901.50,$55235.00,54,$-901.50
2024-03-14,09:39:00,18422.0,BUY,3,0.02h,Stop Loss,$-9.00,$-910.50,$55226.00,54,$-910.50
2024-03-14,09:49:00,18164.25,SELL,3,0.02h,Break Even,$-1.50,$-912.00,$55224.50,54,$-912.00
2024-03-14,09:51:00,18410.5,BUY,3,0.02h,Stop Loss,$-9.00,$-921.00,$55215.50,54,$-921.00
2024-03-14,09:56:00,18160.75,SELL,3,0.02h,Stop Loss,$-9.00,$-930.00,$55206.50,54,$-930.00
2024-03-14,09:58:00,18412.75,BUY,3,0.02h,Stop Loss,$-9.00,$-939.00,$55197.50,54,$-939.00
2024-03-14,09:59:00,18167.25,SELL,3,0.02h,Break Even,$-1.50,$-940.50,$55196.00,54,$-940.50
2024-03-14,10:05:00,18412.0,BUY,3,0.02h,Stop Loss,$-9.00,$-949.50,$55187.00,54,$-949.50
2024-03-14,10:06:00,18166.25,SELL,3,0.02h,Break Even,$-1.50,$-951.00,$55185.50,54,$-951.00
2024-03-14,10:08:00,18415.25,BUY,3,0.02h,Stop Loss,$-9.00,$-960.00,$55176.50,54,$-960.00
2024-03-14,10:09:00,18165.75,SELL,3,0.02h,Stop Loss,$-9.00,$-969.00,$55167.50,54,$-969.00
2024-03-14,10:10:00,18415.0,BUY,3,0.02h,Stop Loss,$-9.00,$-978.00,$55158.50,54,$-978.00
2024-03-14,10:11:00,18164.25,SELL,3,0.02h,Break Even,$-1.50,$-979.50,$55157.00,54,$-979.50
2024-03-14,10:16:00,18415.5,BUY,3,0.02h,Stop Loss,$-9.00,$-988.50,$55148.00,54,$-988.50
2024-03-14,10:18:00,18169.0,SELL,3,0.02h,Break Even,$-1.50,$-990.00,$55146.50,54,$-990.00
2024-03-14,10:22:00,18414.0,BUY,3,0.02h,Stop Loss,$3.00,$-987.00,$55149.50,54,$-987.00
2024-03-14,10:37:00,18165.0,SELL,3,0.03h,Stop Loss,$-9.00,$-996.00,$55140.50,54,$-996.00
2024-03-14,10:47:00,18406.25,BUY,3,0.02h,Break Even,$-1.50,$-997.50,$55139.00,54,$-997.50
2024-03-14,10:49:00,18155.5,SELL,3,0.02h,Stop Loss,$-9.00,$-1006.50,$55130.00,54,$-1006.50
2024-03-14,10:50:00,18405.0,BUY,3,0.02h,Stop Loss,$-9.00,$-1015.50,$55121.00,54,$-1015.50
2024-03-14,10:51:00,18158.25,SELL,3,0.02h,Stop Loss,$4.50,$-1011.00,$55125.50,54,$-1011.00
2024-03-14,11:00:00,18408.75,BUY,3,0.02h,Stop Loss,$-9.00,$-1020.00,$55116.50,54,$-1020.00
2024-03-14,11:08:00,18158.0,SELL,3,0.02h,Break Even,$-1.50,$-1021.50,$55115.00,54,$-1021.50
2024-03-14,11:15:00,18407.25,BUY,3,0.02h,Break Even,$-1.50,$-1023.00,$55113.50,54,$-1023.00
2024-03-14,11:19:00,18170.0,SELL,3,0.02h,Stop Loss,$-9.00,$-1032.00,$55104.50,54,$-1032.00
2024-03-14,11:21:00,18418.25,BUY,3,0.02h,Break Even,$-1.50,$-1033.50,$55103.00,54,$-1033.50
2024-03-14,11:27:00,18156.0,SELL,3,0.02h,Stop Loss,$-9.00,$-1042.50,$55094.00,54,$-1042.50
2024-03-14,11:28:00,18404.0,BUY,3,0.02h,Stop Loss,$-9.00,$-1051.50,$55085.00,54,$-1051.50
2024-03-14,11:29:00,18157.0,SELL,3,0.02h,Stop Loss,$-9.00,$-1060.50,$55076.00,54,$-1060.50
2024-03-14,11:40:00,18399.5,BUY,3,0.02h,Stop Loss,$-9.00,$-1069.50,$55067.00,54,$-1069.50
2024-03-14,11:41:00,18151.5,SELL,3,0.02h,Stop Loss,$-9.00,$-1078.50,$55058.00,54,$-1078.50
2024-03-14,11:42:00,18400.75,BUY,3,0.02h,Break Even,$-1.50,$-1080.00,$55056.50,54,$-1080.00
2024-03-14,11:59:00,18143.0,SELL,3,0.02h,Stop Loss,$-9.00,$-1089.00,$55047.50,54,$-1089.00
2024-03-14,12:03:00,18405.75,BUY,3,0.02h,Break Even,$-1.50,$-1090.50,$55046.00,54,$-1090.50
2024-03-14,12:06:00,18157.5,SELL,3,0.02h,Stop Loss,$-9.00,$-1099.50,$55037.00,54,$-1099.50
2024-03-14,12:07:00,18401.5,BUY,3,0.02h,Stop Loss,$-9.00,$-1108.50,$55028.00,54,$-1108.50
2024-03-14,12:08:00,18155.0,SELL,3,0.02h,Break Even,$-1.50,$-1110.00,$55026.50,54,$-1110.00
2024-03-14,12:20:00,18408.25,BUY,3,0.02h,Stop Loss,$-9.00,$-1119.00,$55017.50,54,$-1119.00
2024-03-14,12:34:00,18127.75,SELL,3,0.02h,Stop Loss,$67.50,$-1051.50,$55085.00,54,$-1051.50
2024-03-14,12:56:00,18369.25,BUY,3,0.02h,Stop Loss,$-9.00,$-1060.50,$55076.00,54,$-1060.50
2024-03-14,12:57:00,18125.5,SELL,3,0.02h,Stop Loss,$-9.00,$-1069.50,$55067.00,54,$-1069.50
2024-03-14,12:58:00,18374.0,BUY,3,0.02h,Stop Loss,$-9.00,$-1078.50,$55058.00,54,$-1078.50
2024-03-14,13:09:00,18107.25,SELL,3,0.02h,Stop Loss,$-9.00,$-1087.50,$55049.00,54,$-1087.50
2024-03-14,13:10:00,18357.75,BUY,3,0.02h,Stop Loss,$-9.00,$-1096.50,$55040.00,54,$-1096.50
2024-03-14,13:11:00,18109.5,SELL,3,0.02h,Break Even,$-1.50,$-1098.00,$55038.50,54,$-1098.00
2024-03-14,13:16:00,18361.0,BUY,3,0.02h,Break Even,$-1.50,$-1099.50,$55037.00,54,$-1099.50
2024-03-14,13:23:00,18099.75,SELL,3,0.02h,Stop Loss,$4.50,$-1095.00,$55041.50,54,$-1095.00
2024-03-14,13:31:00,18355.5,BUY,3,0.02h,Stop Loss,$-9.00,$-1104.00,$55032.50,54,$-1104.00
2024-03-14,13:34:00,18095.25,SELL,3,0.02h,Stop Loss,$-9.00,$-1113.00,$55023.50,54,$-1113.00
2024-03-14,13:35:00,18374.5,BUY,3,0.02h,Stop Loss,$-9.00,$-1122.00,$55014.50,54,$-1122.00
2024-03-14,13:36:00,18116.25,SELL,3,0.02h,Break Even,$-1.50,$-1123.50,$55013.00,54,$-1123.50
2024-03-14,13:38:00,18393.0,BUY,3,0.02h,Stop Loss,$9.00,$-1114.50,$55022.00,54,$-1114.50
2024-03-14,13:48:00,18067.0,SELL,3,0.02h,Stop Loss,$-9.00,$-1123.50,$55013.00,54,$-1123.50
2024-03-14,14:08:00,18261.75,BUY,3,0.02h,Stop Loss,$-9.00,$-1132.50,$55004.00,54,$-1132.50
2024-03-14,14:09:00,18015.0,SELL,3,0.02h,Break Even,$-1.50,$-1134.00,$55002.50,54,$-1134.00
2024-03-14,14:12:00,18292.0,BUY,3,0.02h,Stop Loss,$45.00,$-1089.00,$55047.50,54,$-1089.00
2024-03-14,14:14:00,18058.75,SELL,3,0.02h,Stop Loss,$-9.00,$-1098.00,$55038.50,54,$-1098.00
2024-03-14,14:15:00,18309.0,BUY,3,0.02h,Stop Loss,$9.00,$-1089.00,$55047.50,54,$-1089.00
2024-03-14,14:18:00,18047.5,SELL,3,0.02h,Stop Loss,$51.00,$-1038.00,$55098.50,54,$-1038.00
2024-03-14,14:22:00,18294.25,BUY,3,0.02h,Stop Loss,$-9.00,$-1047.00,$55089.50,54,$-1047.00
2024-03-14,14:23:00,18038.25,SELL,3,0.02h,Stop Loss,$54.00,$-993.00,$55143.50,54,$-993.00
2024-03-14,14:28:00,18285.5,BUY,3,0.02h,Stop Loss,$60.00,$-933.00,$55203.50,54,$-933.00
2024-03-14,14:38:00,18084.75,SELL,3,0.02h,Stop Loss,$-9.00,$-942.00,$55194.50,54,$-942.00
2024-03-14,14:39:00,18314.75,BUY,3,0.02h,Stop Loss,$13.50,$-928.50,$55208.00,54,$-928.50
2024-03-14,14:41:00,18050.75,SELL,3,0.02h,Stop Loss,$-9.00,$-937.50,$55199.00,54,$-937.50
2024-03-14,14:42:00,18293.5,BUY,3,0.02h,Stop Loss,$61.50,$-876.00,$55260.50,54,$-876.00
2024-03-14,14:51:00,18046.5,SELL,3,0.02h,Stop Loss,$-9.00,$-885.00,$55251.50,54,$-885.00
2024-03-14,14:53:00,18292.0,BUY,3,0.02h,Stop Loss,$19.50,$-865.50,$55271.00,54,$-865.50
2024-03-14,14:55:00,18041.25,SELL,3,0.02h,Stop Loss,$-9.00,$-874.50,$55262.00,54,$-874.50
2024-03-14,14:59:00,18291.0,BUY,3,0.02h,Stop Loss,$33.00,$-841.50,$55295.00,54,$-841.50
2024-03-14,15:02:00,18076.25,SELL,3,0.02h,Stop Loss,$-9.00,$-850.50,$55286.00,54,$-850.50
2024-03-14,15:11:00,18325.5,BUY,3,0.02h,Break Even,$-1.50,$-852.00,$55284.50,54,$-852.00
2024-03-14,15:16:00,18074.5,SELL,3,0.02h,Stop Loss,$40.50,$-811.50,$55325.00,54,$-811.50
2024-03-14,15:19:00,18313.25,BUY,3,0.02h,Stop Loss,$9.00,$-802.50,$55334.00,54,$-802.50
2024-03-14,15:22:00,18031.0,SELL,3,0.02h,Stop Loss,$-9.00,$-811.50,$55325.00,54,$-811.50
2024-03-14,15:25:00,18275.0,BUY,3,0.02h,Stop Loss,$15.00,$-796.50,$55340.00,54,$-796.50
2024-03-14,15:27:00,18026.25,SELL,3,0.02h,Stop Loss,$33.00,$-763.50,$55373.00,54,$-763.50
2024-03-14,15:38:00,18304.0,BUY,3,0.02h,Stop Loss,$-9.00,$-772.50,$55364.00,54,$-772.50
2024-03-14,15:39:00,18048.25,SELL,3,0.02h,Stop Loss,$-9.00,$-781.50,$55355.00,54,$-781.50
2024-03-14,15:40:00,18296.25,BUY,3,0.02h,Stop Loss,$45.00,$-736.50,$55400.00,54,$-736.50
2024-03-14,15:46:00,18051.25,SELL,3,0.02h,Stop Loss,$16.50,$-720.00,$55416.50,54,$-720.00
2024-03-14,15:53:00,18292.5,BUY,3,0.02h,Break Even,$-1.50,$-721.50,$55415.00,54,$-721.50
2024-03-14,16:00:00,18053.5,SELL,3,0.02h,Stop Loss,$3.00,$-718.50,$55418.00,54,$-718.50
2024-03-14,16:02:00,18310.0,BUY,3,0.02h,Stop Loss,$-9.00,$-727.50,$55409.00,54,$-727.50
2024-03-14,16:04:00,18040.0,SELL,3,0.02h,Stop Loss,$-9.00,$-736.50,$55400.00,54,$-736.50
2024-03-14,16:05:00,18285.5,BUY,3,0.02h,Stop Loss,$-9.00,$-745.50,$55391.00,54,$-745.50
2024-03-14,16:06:00,18022.0,SELL,3,0.02h,Stop Loss,$100.50,$-645.00,$55491.50,54,$-645.00
2024-03-14,16:17:00,18253.25,BUY,3,0.02h,Stop Loss,$-9.00,$-654.00,$55482.50,54,$-654.00
2024-03-14,16:18:00,18010.25,SELL,3,0.02h,Stop Loss,$-9.00,$-663.00,$55473.50,54,$-663.00
2024-03-14,16:19:00,18260.0,BUY,3,0.02h,Stop Loss,$-9.00,$-672.00,$55464.50,54,$-672.00
2024-03-14,16:20:00,18002.25,SELL,3,0.02h,Stop Loss,$-9.00,$-681.00,$55455.50,54,$-681.00
2024-03-14,16:21:00,18254.5,BUY,3,0.02h,Stop Loss,$64.50,$-616.50,$55520.00,54,$-616.50
2024-03-14,16:44:00,18035.25,SELL,3,0.02h,Stop Loss,$-9.00,$-625.50,$55511.00,54,$-625.50
2024-03-14,16:45:00,18273.75,BUY,3,0.02h,Stop Loss,$-9.00,$-634.50,$55502.00,54,$-634.50
2024-03-14,16:46:00,18027.25,SELL,3,0.02h,Stop Loss,$-9.00,$-643.50,$55493.00,54,$-643.50
2024-03-14,16:53:00,18274.5,BUY,3,0.02h,Stop Loss,$28.50,$-615.00,$55521.50,54,$-615.00
2024-03-14,16:55:00,18020.75,SELL,3,0.02h,Stop Loss,$28.50,$-586.50,$55550.00,54,$-586.50
2024-03-14,17:12:00,18234.25,BUY,3,0.02h,Break Even,$-1.50,$-588.00,$55548.50,54,$-588.00
2024-03-14,17:22:00,17976.0,SELL,3,0.02h,Stop Loss,$-9.00,$-597.00,$55539.50,54,$-597.00
2024-03-14,17:23:00,18229.5,BUY,3,0.02h,Stop Loss,$-9.00,$-606.00,$55530.50,54,$-606.00
2024-03-14,17:24:00,17993.25,SELL,3,0.02h,Break Even,$-1.50,$-607.50,$55529.00,54,$-607.50
2024-03-14,17:32:00,18228.25,BUY,3,0.02h,Stop Loss,$-9.00,$-616.50,$55520.00,54,$-616.50
2024-03-14,17:33:00,17983.0,SELL,3,0.02h,Break Even,$-1.50,$-618.00,$55518.50,54,$-618.00
2024-03-14,17:39:00,18253.5,BUY,3,0.02h,Break Even,$-1.50,$-619.50,$55517.00,54,$-619.50
2024-03-14,17:49:00,18001.0,SELL,3,0.02h,Stop Loss,$-9.00,$-628.50,$55508.00,54,$-628.50
2024-03-14,17:50:00,18258.75,BUY,3,0.02h,Stop Loss,$7.50,$-621.00,$55515.50,54,$-621.00
2024-03-14,18:02:00,18064.75,SELL,3,0.02h,Stop Loss,$-9.00,$-630.00,$55506.50,54,$-630.00
2024-03-14,18:03:00,18315.75,BUY,3,0.02h,Stop Loss,$-9.00,$-639.00,$55497.50,54,$-639.00
2024-03-14,18:04:00,18068.75,SELL,3,0.02h,Stop Loss,$4.50,$-634.50,$55502.00,54,$-634.50
2024-03-14,18:07:00,18314.5,BUY,3,0.02h,Stop Loss,$-9.00,$-643.50,$55493.00,54,$-643.50
2024-03-14,18:08:00,18063.5,SELL,3,0.02h,Stop Loss,$-9.00,$-652.50,$55484.00,54,$-652.50
2024-03-14,18:10:00,18322.25,BUY,3,0.02h,Stop Loss,$4.50,$-648.00,$55488.50,54,$-648.00
2024-03-14,18:23:00,18056.25,SELL,3,0.02h,Stop Loss,$33.00,$-615.00,$55521.50,54,$-615.00
2024-03-14,18:36:00,18294.75,BUY,3,0.02h,Stop Loss,$-9.00,$-624.00,$55512.50,54,$-624.00
2024-03-14,18:37:00,18037.5,SELL,3,0.02h,Stop Loss,$-9.00,$-633.00,$55503.50,54,$-633.00
2024-03-14,18:38:00,18282.5,BUY,3,0.02h,Stop Loss,$31.50,$-601.50,$55535.00,54,$-601.50
2024-03-14,18:43:00,18037.0,SELL,3,0.02h,Stop Loss,$-9.00,$-610.50,$55526.00,54,$-610.50
2024-03-14,18:44:00,18289.75,BUY,3,0.02h,Stop Loss,$-9.00,$-619.50,$55517.00,54,$-619.50
2024-03-14,18:45:00,18046.5,SELL,3,0.02h,Stop Loss,$-9.00,$-628.50,$55508.00,54,$-628.50
2024-03-14,18:46:00,18298.75,BUY,3,0.02h,Stop Loss,$-9.00,$-637.50,$55499.00,54,$-637.50
2024-03-14,18:47:00,18050.0,SELL,3,0.02h,Stop Loss,$-9.00,$-646.50,$55490.00,54,$-646.50
2024-03-14,18:48:00,18303.25,BUY,3,0.02h,Stop Loss,$-9.00,$-655.50,$55481.00,54,$-655.50
2024-03-14,18:49:00,18059.75,SELL,3,0.02h,Stop Loss,$37.50,$-618.00,$55518.50,54,$-618.00
2024-03-14,18:53:00,18265.0,BUY,3,0.02h,Stop Loss,$-9.00,$-627.00,$55509.50,54,$-627.00
2024-03-14,18:54:00,18022.0,SELL,3,0.02h,Stop Loss,$43.50,$-583.50,$55553.00,54,$-583.50
2024-03-14,18:59:00,18254.75,BUY,3,0.02h,Stop Loss,$4.50,$-579.00,$55557.50,54,$-579.00
2024-03-14,19:01:00,17989.25,SELL,3,0.02h,Stop Loss,$46.50,$-532.50,$55604.00,54,$-532.50
2024-03-14,19:06:00,18228.75,BUY,3,0.02h,Stop Loss,$-9.00,$-541.50,$55595.00,54,$-541.50
2024-03-14,19:07:00,17982.0,SELL,3,0.02h,Stop Loss,$18.00,$-523.50,$55613.00,54,$-523.50
2024-03-14,19:13:00,18197.0,BUY,3,0.02h,Stop Loss,$-9.00,$-532.50,$55604.00,54,$-532.50
2024-03-14,19:15:00,17937.75,SELL,3,0.02h,Stop Loss,$-9.00,$-541.50,$55595.00,54,$-541.50
2024-03-14,19:16:00,18187.75,BUY,3,0.02h,Stop Loss,$-9.00,$-550.50,$55586.00,54,$-550.50
2024-03-14,19:17:00,17954.75,SELL,3,0.02h,Stop Loss,$6.00,$-544.50,$55592.00,54,$-544.50
2024-03-14,19:34:00,18173.75,BUY,3,0.02h,Stop Loss,$-9.00,$-553.50,$55583.00,54,$-553.50
2024-03-14,19:37:00,17917.75,SELL,3,0.02h,Break Even,$-1.50,$-555.00,$55581.50,54,$-555.00
2024-03-14,19:39:00,18188.75,BUY,3,0.02h,Stop Loss,$79.50,$-475.50,$55661.00,54,$-475.50
2024-03-14,19:46:00,17976.75,SELL,3,0.02h,Stop Loss,$-9.00,$-484.50,$55652.00,54,$-484.50
2024-03-14,19:47:00,18206.0,BUY,3,0.02h,Stop Loss,$82.50,$-402.00,$55734.50,54,$-402.00
2024-03-14,20:06:00,18025.5,SELL,3,0.02h,Stop Loss,$36.00,$-366.00,$55770.50,54,$-366.00
2024-03-14,20:10:00,18271.25,BUY,3,0.02h,Break Even,$-1.50,$-367.50,$55769.00,54,$-367.50
2024-03-14,20:18:00,18016.25,SELL,3,0.02h,Stop Loss,$-9.00,$-376.50,$55760.00,54,$-376.50
2024-03-14,20:19:00,18261.0,BUY,3,0.02h,Stop Loss,$-9.00,$-385.50,$55751.00,54,$-385.50
2024-03-14,20:20:00,18012.25,SELL,3,0.02h,Stop Loss,$-9.00,$-394.50,$55742.00,54,$-394.50
2024-03-14,20:24:00,18262.5,BUY,3,0.02h,Stop Loss,$-9.00,$-403.50,$55733.00,54,$-403.50
2024-03-14,20:31:00,18016.0,SELL,3,0.02h,Break Even,$-1.50,$-405.00,$55731.50,54,$-405.00
2024-03-14,20:36:00,18258.25,BUY,3,0.02h,Stop Loss,$10.50,$-394.50,$55742.00,54,$-394.50
2024-03-14,20:38:00,18013.75,SELL,3,0.02h,Stop Loss,$-9.00,$-403.50,$55733.00,54,$-403.50
2024-03-14,20:39:00,18264.0,BUY,3,0.02h,Stop Loss,$-9.00,$-412.50,$55724.00,54,$-412.50
2024-03-14,20:43:00,18021.5,SELL,3,0.02h,Stop Loss,$-9.00,$-421.50,$55715.00,54,$-421.50
2024-03-14,20:47:00,18272.25,BUY,3,0.02h,Stop Loss,$-9.00,$-430.50,$55706.00,54,$-430.50
2024-03-14,20:50:00,18023.0,SELL,3,0.02h,Stop Loss,$-9.00,$-439.50,$55697.00,54,$-439.50
2024-03-14,20:51:00,18266.75,BUY,3,0.02h,Stop Loss,$-9.00,$-448.50,$55688.00,54,$-448.50
2024-03-14,20:53:00,18014.25,SELL,3,0.02h,Stop Loss,$-9.00,$-457.50,$55679.00,54,$-457.50
2024-03-14,20:58:00,18266.5,BUY,3,0.02h,Stop Loss,$-9.00,$-466.50,$55670.00,54,$-466.50
2024-03-14,20:59:00,18020.0,SELL,3,0.02h,Stop Loss,$-9.00,$-475.50,$55661.00,54,$-475.50
2024-03-14,21:00:00,18267.0,BUY,3,2.00h,Stop Loss,$-9.00,$-484.50,$55652.00,54,$-484.50
2024-03-14,23:00:00,18001.75,SELL,3,0.02h,Break Even,$-1.50,$-486.00,$55650.50,54,$-486.00
2024-03-14,23:03:00,18246.5,BUY,3,0.02h,Stop Loss,$-9.00,$-495.00,$55641.50,54,$-495.00
2024-03-14,23:04:00,17994.75,SELL,3,0.02h,Break Even,$-1.50,$-496.50,$55640.00,54,$-496.50
2024-03-14,23:07:00,18246.0,BUY,3,0.02h,Stop Loss,$-9.00,$-505.50,$55631.00,54,$-505.50
2024-03-14,23:12:00,17986.5,SELL,3,0.02h,Stop Loss,$-9.00,$-514.50,$55622.00,54,$-514.50
2024-03-14,23:21:00,18235.75,BUY,3,0.03h,Break Even,$-1.50,$-516.00,$55620.50,54,$-516.00
2024-03-14,23:26:00,17987.75,SELL,3,0.02h,Stop Loss,$-9.00,$-525.00,$55611.50,54,$-525.00
2024-03-14,23:27:00,18236.75,BUY,3,0.02h,Stop Loss,$-9.00,$-534.00,$55602.50,54,$-534.00
2024-03-14,23:28:00,17986.75,SELL,3,0.03h,Stop Loss,$4.50,$-529.50,$55607.00,54,$-529.50
2024-03-14,23:30:00,18229.5,BUY,3,0.02h,Stop Loss,$-9.00,$-538.50,$55598.00,54,$-538.50
2024-03-14,23:31:00,17980.5,SELL,3,0.02h,Stop Loss,$-9.00,$-547.50,$55589.00,54,$-547.50
2024-03-14,23:36:00,18234.75,BUY,3,0.02h,Stop Loss,$-9.00,$-556.50,$55580.00,54,$-556.50
2024-03-14,23:37:00,17985.0,SELL,3,0.02h,Stop Loss,$-9.00,$-565.50,$55571.00,54,$-565.50
2024-03-14,23:38:00,18231.75,BUY,3,0.02h,Stop Loss,$-9.00,$-574.50,$55562.00,54,$-574.50
2024-03-14,23:39:00,17982.5,SELL,3,0.02h,Stop Loss,$-9.00,$-583.50,$55553.00,54,$-583.50
2024-03-14,23:40:00,18229.5,BUY,3,0.02h,Stop Loss,$-9.00,$-592.50,$55544.00,54,$-592.50
2024-03-14,23:50:00,17983.0,SELL,3,0.02h,Stop Loss,$-9.00,$-601.50,$55535.00,54,$-601.50
2024-03-14,23:51:00,18233.0,BUY,3,0.02h,Stop Loss,$-9.00,$-610.50,$55526.00,54,$-610.50
2024-03-14,23:53:00,17985.75,SELL,3,0.03h,Break Even,$-1.50,$-612.00,$55524.50,54,$-612.00
,,,,,,,,,,,
2024-03-15,00:07:00,18247.5,BUY,3,0.02h,Stop Loss,$-9.00,$-9.00,$55515.50,55,$-9.00
2024-03-15,00:08:00,17999.0,SELL,3,0.08h,Stop Loss,$30.00,$21.00,$55545.50,55,$21.00
2024-03-15,00:13:00,18239.75,BUY,3,0.02h,Break Even,$-1.50,$19.50,$55544.00,55,$19.50
2024-03-15,00:16:00,17994.0,SELL,3,0.02h,Stop Loss,$-9.00,$10.50,$55535.00,55,$10.50
2024-03-15,00:17:00,18242.5,BUY,3,0.02h,Break Even,$-1.50,$9.00,$55533.50,55,$9.00
2024-03-15,00:24:00,18003.0,SELL,3,0.02h,Stop Loss,$-9.00,$0.00,$55524.50,55,$0.00
2024-03-15,00:25:00,18251.25,BUY,3,0.02h,Stop Loss,$-9.00,$-9.00,$55515.50,55,$-9.00
2024-03-15,00:28:00,18001.25,SELL,3,0.02h,Round Number,$4.50,$-4.50,$55520.00,55,$-4.50
2024-03-15,00:37:00,18257.75,BUY,3,0.02h,Stop Loss,$-9.00,$-13.50,$55511.00,55,$-13.50
2024-03-15,00:38:00,18010.0,SELL,3,0.10h,Stop Loss,$7.50,$-6.00,$55518.50,55,$-6.00
2024-03-15,00:44:00,18252.5,BUY,3,0.03h,Stop Loss,$4.50,$-1.50,$55523.00,55,$-1.50
2024-03-15,00:56:00,18008.25,SELL,3,0.02h,Stop Loss,$-9.00,$-10.50,$55514.00,55,$-10.50
2024-03-15,01:04:00,18260.5,BUY,3,0.02h,Stop Loss,$3.00,$-7.50,$55517.00,55,$-7.50
2024-03-15,01:07:00,18020.0,SELL,3,0.05h,Stop Loss,$36.00,$28.50,$55553.00,55,$28.50
2024-03-15,01:11:00,18262.5,BUY,3,0.02h,Stop Loss,$-9.00,$19.50,$55544.00,55,$19.50
2024-03-15,01:12:00,18012.75,SELL,3,0.02h,Stop Loss,$-9.00,$10.50,$55535.00,55,$10.50
2024-03-15,01:14:00,18260.75,BUY,3,0.02h,Stop Loss,$-9.00,$1.50,$55526.00,55,$1.50
2024-03-15,01:36:00,18016.0,SELL,3,0.02h,Break Even,$-1.50,$0.00,$55524.50,55,$0.00
2024-03-15,01:41:00,18261.0,BUY,3,0.02h,Stop Loss,$-9.00,$-9.00,$55515.50,55,$-9.00
2024-03-15,01:47:00,18010.75,SELL,3,0.03h,Break Even,$-1.50,$-10.50,$55514.00,55,$-10.50
2024-03-15,02:09:00,18236.5,BUY,3,0.02h,Stop Loss,$-9.00,$-19.50,$55505.00,55,$-19.50
2024-03-15,02:16:00,17992.75,SELL,3,0.02h,Stop Loss,$-9.00,$-28.50,$55496.00,55,$-28.50
2024-03-15,02:17:00,18240.75,BUY,3,0.02h,Stop Loss,$-9.00,$-37.50,$55487.00,55,$-37.50
2024-03-15,02:18:00,17990.25,SELL,3,0.02h,Stop Loss,$-9.00,$-46.50,$55478.00,55,$-46.50
2024-03-15,02:27:00,18236.25,BUY,3,0.03h,Stop Loss,$-9.00,$-55.50,$55469.00,55,$-55.50
2024-03-15,02:30:00,17992.5,SELL,3,0.02h,Stop Loss,$-9.00,$-64.50,$55460.00,55,$-64.50
2024-03-15,02:31:00,18238.75,BUY,3,0.02h,Stop Loss,$-9.00,$-73.50,$55451.00,55,$-73.50
2024-03-15,02:32:00,17988.0,SELL,3,0.02h,Break Even,$-1.50,$-75.00,$55449.50,55,$-75.00
2024-03-15,02:34:00,18235.0,BUY,3,0.02h,Stop Loss,$-9.00,$-84.00,$55440.50,55,$-84.00
2024-03-15,02:41:00,17985.25,SELL,3,0.02h,Stop Loss,$-9.00,$-93.00,$55431.50,55,$-93.00
2024-03-15,02:42:00,18229.5,BUY,3,0.02h,Break Even,$-1.50,$-94.50,$55430.00,55,$-94.50
2024-03-15,02:53:00,17987.75,SELL,3,0.02h,Stop Loss,$-9.00,$-103.50,$55421.00,55,$-103.50
2024-03-15,02:56:00,18238.0,BUY,3,0.02h,Stop Loss,$-9.00,$-112.50,$55412.00,55,$-112.50
2024-03-15,02:59:00,17991.0,SELL,3,0.02h,Stop Loss,$-9.00,$-121.50,$55403.00,55,$-121.50
2024-03-15,03:07:00,18240.0,BUY,3,0.02h,Stop Loss,$-9.00,$-130.50,$55394.00,55,$-130.50
2024-03-15,03:08:00,17995.25,SELL,3,0.02h,Stop Loss,$-9.00,$-139.50,$55385.00,55,$-139.50
2024-03-15,03:09:00,18242.5,BUY,3,0.02h,Stop Loss,$-9.00,$-148.50,$55376.00,55,$-148.50
2024-03-15,03:10:00,17991.25,SELL,3,0.02h,Stop Loss,$-9.00,$-157.50,$55367.00,55,$-157.50
2024-03-15,03:14:00,18234.75,BUY,3,0.02h,Stop Loss,$-9.00,$-166.50,$55358.00,55,$-166.50
2024-03-15,03:25:00,17995.0,SELL,3,0.02h,Stop Loss,$-9.00,$-175.50,$55349.00,55,$-175.50
2024-03-15,03:36:00,18243.75,BUY,3,0.02h,Stop Loss,$-9.00,$-184.50,$55340.00,55,$-184.50
2024-03-15,03:37:00,17997.0,SELL,3,0.02h,Stop Loss,$-9.00,$-193.50,$55331.00,55,$-193.50
2024-03-15,03:45:00,18247.0,BUY,3,0.02h,Stop Loss,$-9.00,$-202.50,$55322.00,55,$-202.50
2024-03-15,03:52:00,17996.75,SELL,3,0.02h,Break Even,$-1.50,$-204.00,$55320.50,55,$-204.00
2024-03-15,04:00:00,18244.75,BUY,3,0.02h,Stop Loss,$-9.00,$-213.00,$55311.50,55,$-213.00
2024-03-15,04:15:00,17992.5,SELL,3,0.02h,Stop Loss,$7.50,$-205.50,$55319.00,55,$-205.50
2024-03-15,04:18:00,18239.75,BUY,3,0.02h,Stop Loss,$-9.00,$-214.50,$55310.00,55,$-214.50
2024-03-15,04:21:00,17989.0,SELL,3,0.02h,Stop Loss,$-9.00,$-223.50,$55301.00,55,$-223.50
2024-03-15,04:22:00,18234.75,BUY,3,0.02h,Stop Loss,$-9.00,$-232.50,$55292.00,55,$-232.50
2024-03-15,04:26:00,17984.5,SELL,3,0.02h,Stop Loss,$-9.00,$-241.50,$55283.00,55,$-241.50
2024-03-15,04:48:00,18221.5,BUY,3,0.02h,Stop Loss,$-9.00,$-250.50,$55274.00,55,$-250.50
2024-03-15,04:49:00,17972.5,SELL,3,0.02h,Stop Loss,$-9.00,$-259.50,$55265.00,55,$-259.50
2024-03-15,04:52:00,18223.5,BUY,3,0.02h,Break Even,$-1.50,$-261.00,$55263.50,55,$-261.00
2024-03-15,05:00:00,17975.75,SELL,3,0.02h,Stop Loss,$-9.00,$-270.00,$55254.50,55,$-270.00
2024-03-15,05:06:00,18225.5,BUY,3,0.02h,Break Even,$-1.50,$-271.50,$55253.00,55,$-271.50
2024-03-15,05:09:00,17978.5,SELL,3,0.02h,Stop Loss,$-9.00,$-280.50,$55244.00,55,$-280.50
2024-03-15,05:10:00,18230.0,BUY,3,0.02h,Break Even,$-1.50,$-282.00,$55242.50,55,$-282.00
2024-03-15,05:21:00,17978.0,SELL,3,0.02h,Stop Loss,$-9.00,$-291.00,$55233.50,55,$-291.00
2024-03-15,05:22:00,18228.0,BUY,3,0.03h,Stop Loss,$-9.00,$-300.00,$55224.50,55,$-300.00
2024-03-15,05:24:00,17980.25,SELL,3,0.08h,Stop Loss,$16.50,$-283.50,$55241.00,55,$-283.50
2024-03-15,05:35:00,18220.0,BUY,3,0.02h,Stop Loss,$-9.00,$-292.50,$55232.00,55,$-292.50
2024-03-15,05:36:00,17970.0,SELL,3,0.02h,Stop Loss,$-9.00,$-301.50,$55223.00,55,$-301.50
2024-03-15,05:43:00,18211.0,BUY,3,0.02h,Stop Loss,$-9.00,$-310.50,$55214.00,55,$-310.50
2024-03-15,05:55:00,17972.75,SELL,3,0.02h,Stop Loss,$-9.00,$-319.50,$55205.00,55,$-319.50
2024-03-15,05:56:00,18222.0,BUY,3,0.02h,Stop Loss,$-9.00,$-328.50,$55196.00,55,$-328.50
2024-03-15,05:58:00,17966.75,SELL,3,0.02h,Stop Loss,$-9.00,$-337.50,$55187.00,55,$-337.50
2024-03-15,05:59:00,18216.75,BUY,3,0.02h,Stop Loss,$-9.00,$-346.50,$55178.00,55,$-346.50
2024-03-15,06:00:00,17966.0,SELL,3,0.03h,Stop Loss,$18.00,$-328.50,$55196.00,55,$-328.50
2024-03-15,06:05:00,18212.75,BUY,3,0.02h,Stop Loss,$-9.00,$-337.50,$55187.00,55,$-337.50
2024-03-15,06:07:00,17960.0,SELL,3,0.02h,Stop Loss,$-9.00,$-346.50,$55178.00,55,$-346.50
2024-03-15,06:08:00,18212.25,BUY,3,0.02h,Break Even,$-1.50,$-348.00,$55176.50,55,$-348.00
2024-03-15,06:10:00,17962.5,SELL,3,0.02h,Stop Loss,$-9.00,$-357.00,$55167.50,55,$-357.00
2024-03-15,06:11:00,18210.0,BUY,3,0.02h,Break Even,$-1.50,$-358.50,$55166.00,55,$-358.50
2024-03-15,06:21:00,17969.5,SELL,3,0.03h,Break Even,$-1.50,$-360.00,$55164.50,55,$-360.00
2024-03-15,06:28:00,18214.25,BUY,3,0.02h,Stop Loss,$-9.00,$-369.00,$55155.50,55,$-369.00
2024-03-15,06:33:00,17961.5,SELL,3,0.02h,Stop Loss,$-9.00,$-378.00,$55146.50,55,$-378.00
2024-03-15,06:36:00,18215.75,BUY,3,0.02h,Break Even,$-1.50,$-379.50,$55145.00,55,$-379.50
2024-03-15,06:41:00,17964.5,SELL,3,0.02h,Break Even,$-1.50,$-381.00,$55143.50,55,$-381.00
2024-03-15,06:53:00,18218.0,BUY,3,0.02h,Stop Loss,$-9.00,$-390.00,$55134.50,55,$-390.00
2024-03-15,06:55:00,17963.0,SELL,3,0.02h,Break Even,$-1.50,$-391.50,$55133.00,55,$-391.50
2024-03-15,07:00:00,18219.25,BUY,3,0.02h,Break Even,$-1.50,$-393.00,$55131.50,55,$-393.00
2024-03-15,07:04:00,17967.5,SELL,3,0.02h,Stop Loss,$-9.00,$-402.00,$55122.50,55,$-402.00
2024-03-15,07:06:00,18223.5,BUY,3,0.02h,Stop Loss,$-9.00,$-411.00,$55113.50,55,$-411.00
2024-03-15,07:07:00,17981.5,SELL,3,0.02h,Break Even,$-1.50,$-412.50,$55112.00,55,$-412.50
2024-03-15,07:17:00,18223.75,BUY,3,0.02h,Break Even,$-1.50,$-414.00,$55110.50,55,$-414.00
2024-03-15,07:21:00,17985.5,SELL,3,0.02h,Stop Loss,$-9.00,$-423.00,$55101.50,55,$-423.00
2024-03-15,07:22:00,18229.5,BUY,3,0.02h,Stop Loss,$-9.00,$-432.00,$55092.50,55,$-432.00
2024-03-15,07:23:00,17983.5,SELL,3,0.02h,Stop Loss,$-9.00,$-441.00,$55083.50,55,$-441.00
2024-03-15,07:24:00,18234.25,BUY,3,0.02h,Stop Loss,$-9.00,$-450.00,$55074.50,55,$-450.00
2024-03-15,07:26:00,17982.5,SELL,3,0.02h,Stop Loss,$-9.00,$-459.00,$55065.50,55,$-459.00
2024-03-15,07:28:00,18234.25,BUY,3,0.02h,Stop Loss,$-9.00,$-468.00,$55056.50,55,$-468.00
2024-03-15,07:29:00,17991.0,SELL,3,0.02h,Stop Loss,$-9.00,$-477.00,$55047.50,55,$-477.00
2024-03-15,07:30:00,18238.5,BUY,3,0.02h,Stop Loss,$-9.00,$-486.00,$55038.50,55,$-486.00
2024-03-15,07:33:00,17990.5,SELL,3,0.02h,Stop Loss,$-9.00,$-495.00,$55029.50,55,$-495.00
2024-03-15,07:34:00,18234.25,BUY,3,0.02h,Break Even,$-1.50,$-496.50,$55028.00,55,$-496.50
2024-03-15,07:42:00,17992.0,SELL,3,0.02h,Stop Loss,$-9.00,$-505.50,$55019.00,55,$-505.50
2024-03-15,07:43:00,18237.25,BUY,3,0.02h,Stop Loss,$-9.00,$-514.50,$55010.00,55,$-514.50
2024-03-15,07:44:00,17989.75,SELL,3,0.05h,Stop Loss,$-9.00,$-523.50,$55001.00,55,$-523.50
2024-03-15,07:48:00,18233.5,BUY,3,0.02h,Stop Loss,$-9.00,$-532.50,$54992.00,55,$-532.50
2024-03-15,07:49:00,17982.5,SELL,3,0.02h,Stop Loss,$-9.00,$-541.50,$54983.00,55,$-541.50
2024-03-15,07:50:00,18230.0,BUY,3,0.02h,Stop Loss,$-9.00,$-550.50,$54974.00,55,$-550.50
2024-03-15,07:55:00,17975.25,SELL,3,0.02h,Stop Loss,$24.00,$-526.50,$54998.00,55,$-526.50
2024-03-15,08:02:00,18221.0,BUY,3,0.02h,Stop Loss,$-9.00,$-535.50,$54989.00,55,$-535.50
2024-03-15,08:03:00,17972.0,SELL,3,0.02h,Stop Loss,$-9.00,$-544.50,$54980.00,55,$-544.50
2024-03-15,08:04:00,18222.0,BUY,3,0.02h,Stop Loss,$-9.00,$-553.50,$54971.00,55,$-553.50
2024-03-15,08:05:00,17978.5,SELL,3,0.02h,Stop Loss,$-9.00,$-562.50,$54962.00,55,$-562.50
2024-03-15,08:09:00,18244.0,BUY,3,0.02h,Break Even,$-1.50,$-564.00,$54960.50,55,$-564.00
2024-03-15,08:13:00,17995.5,SELL,3,0.02h,Stop Loss,$-9.00,$-573.00,$54951.50,55,$-573.00
2024-03-15,08:14:00,18244.75,BUY,3,0.02h,Stop Loss,$-9.00,$-582.00,$54942.50,55,$-582.00
2024-03-15,08:15:00,17996.0,SELL,3,0.02h,Stop Loss,$-9.00,$-591.00,$54933.50,55,$-591.00
2024-03-15,08:17:00,18242.5,BUY,3,0.02h,Stop Loss,$-9.00,$-600.00,$54924.50,55,$-600.00
2024-03-15,08:27:00,17995.5,SELL,3,0.02h,Stop Loss,$-9.00,$-609.00,$54915.50,55,$-609.00
2024-03-15,08:28:00,18242.5,BUY,3,0.02h,Stop Loss,$-9.00,$-618.00,$54906.50,55,$-618.00
2024-03-15,08:30:00,17995.5,SELL,3,0.02h,Stop Loss,$-9.00,$-627.00,$54897.50,55,$-627.00
2024-03-15,08:36:00,18241.5,BUY,3,0.02h,Stop Loss,$-9.00,$-636.00,$54888.50,55,$-636.00
2024-03-15,08:37:00,17989.75,SELL,3,0.02h,Stop Loss,$-9.00,$-645.00,$54879.50,55,$-645.00
2024-03-15,08:45:00,18258.5,BUY,3,0.02h,Stop Loss,$-9.00,$-654.00,$54870.50,55,$-654.00
2024-03-15,08:46:00,18006.25,SELL,3,0.02h,Stop Loss,$-9.00,$-663.00,$54861.50,55,$-663.00
2024-03-15,08:47:00,18256.75,BUY,3,0.02h,Stop Loss,$-9.00,$-672.00,$54852.50,55,$-672.00
2024-03-15,08:48:00,18005.75,SELL,3,0.02h,Stop Loss,$-9.00,$-681.00,$54843.50,55,$-681.00
2024-03-15,08:50:00,18253.5,BUY,3,0.02h,Break Even,$-1.50,$-682.50,$54842.00,55,$-682.50
2024-03-15,08:54:00,18006.0,SELL,3,0.02h,Break Even,$-1.50,$-684.00,$54840.50,55,$-684.00
2024-03-15,09:02:00,18262.25,BUY,3,0.02h,Break Even,$-1.50,$-685.50,$54839.00,55,$-685.50
2024-03-15,09:16:00,18015.0,SELL,3,0.02h,Stop Loss,$12.00,$-673.50,$54851.00,55,$-673.50
2024-03-15,09:20:00,18267.0,BUY,3,0.02h,Stop Loss,$-9.00,$-682.50,$54842.00,55,$-682.50
2024-03-15,09:21:00,18017.25,SELL,3,0.02h,Stop Loss,$-9.00,$-691.50,$54833.00,55,$-691.50
2024-03-15,09:22:00,18262.25,BUY,3,0.02h,Stop Loss,$-9.00,$-700.50,$54824.00,55,$-700.50
2024-03-15,09:23:00,18014.5,SELL,3,0.02h,Stop Loss,$-9.00,$-709.50,$54815.00,55,$-709.50
2024-03-15,09:24:00,18268.0,BUY,3,0.02h,Break Even,$-1.50,$-711.00,$54813.50,55,$-711.00
2024-03-15,09:26:00,18016.0,SELL,3,0.03h,Stop Loss,$55.50,$-655.50,$54869.00,55,$-655.50
2024-03-15,09:35:00,18282.5,BUY,3,0.02h,Stop Loss,$-9.00,$-664.50,$54860.00,55,$-664.50
2024-03-15,09:36:00,18031.5,SELL,3,0.02h,Break Even,$-1.50,$-666.00,$54858.50,55,$-666.00
2024-03-15,09:38:00,18281.0,BUY,3,0.02h,Stop Loss,$-9.00,$-675.00,$54849.50,55,$-675.00
2024-03-15,09:48:00,18038.25,SELL,3,0.02h,Stop Loss,$-9.00,$-684.00,$54840.50,55,$-684.00
2024-03-15,09:51:00,18291.25,BUY,3,0.02h,Stop Loss,$-9.00,$-693.00,$54831.50,55,$-693.00
2024-03-15,09:52:00,18043.5,SELL,3,0.02h,Stop Loss,$-9.00,$-702.00,$54822.50,55,$-702.00
2024-03-15,09:53:00,18291.75,BUY,3,0.02h,Stop Loss,$-9.00,$-711.00,$54813.50,55,$-711.00
2024-03-15,09:54:00,18045.5,SELL,3,0.02h,Stop Loss,$-9.00,$-720.00,$54804.50,55,$-720.00
2024-03-15,09:58:00,18293.5,BUY,3,0.02h,Stop Loss,$-9.00,$-729.00,$54795.50,55,$-729.00
2024-03-15,10:06:00,18047.75,SELL,3,0.02h,Stop Loss,$-9.00,$-738.00,$54786.50,55,$-738.00
2024-03-15,10:11:00,18303.0,BUY,3,0.02h,Break Even,$-1.50,$-739.50,$54785.00,55,$-739.50
2024-03-15,10:24:00,18063.5,SELL,3,0.02h,Stop Loss,$-9.00,$-748.50,$54776.00,55,$-748.50
2024-03-15,10:25:00,18307.5,BUY,3,0.02h,Stop Loss,$-9.00,$-757.50,$54767.00,55,$-757.50
2024-03-15,10:26:00,18060.75,SELL,3,0.02h,Stop Loss,$-9.00,$-766.50,$54758.00,55,$-766.50
2024-03-15,10:27:00,18307.25,BUY,3,0.02h,Stop Loss,$-9.00,$-775.50,$54749.00,55,$-775.50
2024-03-15,10:29:00,18057.0,SELL,3,0.02h,Stop Loss,$-9.00,$-784.50,$54740.00,55,$-784.50
2024-03-15,10:30:00,18304.75,BUY,3,0.02h,Stop Loss,$-9.00,$-793.50,$54731.00,55,$-793.50
2024-03-15,10:31:00,18060.5,SELL,3,0.02h,Stop Loss,$-9.00,$-802.50,$54722.00,55,$-802.50
2024-03-15,10:32:00,18312.25,BUY,3,0.02h,Stop Loss,$-9.00,$-811.50,$54713.00,55,$-811.50
2024-03-15,10:33:00,18063.0,SELL,3,0.02h,Stop Loss,$-9.00,$-820.50,$54704.00,55,$-820.50
2024-03-15,10:34:00,18312.0,BUY,3,0.02h,Stop Loss,$3.00,$-817.50,$54707.00,55,$-817.50
2024-03-15,10:38:00,18068.5,SELL,3,0.02h,Stop Loss,$-9.00,$-826.50,$54698.00,55,$-826.50
2024-03-15,10:45:00,18311.75,BUY,3,0.02h,Stop Loss,$12.00,$-814.50,$54710.00,55,$-814.50
2024-03-15,10:55:00,18070.25,SELL,3,0.02h,Stop Loss,$-9.00,$-823.50,$54701.00,55,$-823.50
2024-03-15,10:56:00,18317.0,BUY,3,0.02h,Stop Loss,$-9.00,$-832.50,$54692.00,55,$-832.50
2024-03-15,11:01:00,18056.25,SELL,3,0.02h,Stop Loss,$-9.00,$-841.50,$54683.00,55,$-841.50
2024-03-15,11:03:00,18305.25,BUY,3,0.02h,Stop Loss,$-9.00,$-850.50,$54674.00,55,$-850.50
2024-03-15,11:04:00,18056.25,SELL,3,0.02h,Stop Loss,$-9.00,$-859.50,$54665.00,55,$-859.50
2024-03-15,11:06:00,18303.0,BUY,3,0.02h,Stop Loss,$12.00,$-847.50,$54677.00,55,$-847.50
2024-03-15,11:10:00,18053.0,SELL,3,0.02h,Stop Loss,$-9.00,$-856.50,$54668.00,55,$-856.50
2024-03-15,11:11:00,18294.25,BUY,3,0.02h,Break Even,$-1.50,$-858.00,$54666.50,55,$-858.00
2024-03-15,11:14:00,18049.0,SELL,3,0.02h,Stop Loss,$-9.00,$-867.00,$54657.50,55,$-867.00
2024-03-15,11:15:00,18301.25,BUY,3,0.02h,Stop Loss,$-9.00,$-876.00,$54648.50,55,$-876.00
2024-03-15,11:19:00,18052.5,SELL,3,0.02h,Break Even,$-1.50,$-877.50,$54647.00,55,$-877.50
2024-03-15,11:25:00,18301.0,BUY,3,0.02h,Stop Loss,$-9.00,$-886.50,$54638.00,55,$-886.50
2024-03-15,11:26:00,18052.25,SELL,3,0.02h,Stop Loss,$-9.00,$-895.50,$54629.00,55,$-895.50
2024-03-15,11:28:00,18304.25,BUY,3,0.02h,Break Even,$-1.50,$-897.00,$54627.50,55,$-897.00
2024-03-15,11:30:00,18053.0,SELL,3,0.02h,Stop Loss,$-9.00,$-906.00,$54618.50,55,$-906.00
2024-03-15,11:31:00,18303.0,BUY,3,0.02h,Stop Loss,$-9.00,$-915.00,$54609.50,55,$-915.00
2024-03-15,11:32:00,18054.25,SELL,3,0.02h,Stop Loss,$-9.00,$-924.00,$54600.50,55,$-924.00
2024-03-15,11:45:00,18300.5,BUY,3,0.02h,Stop Loss,$-9.00,$-933.00,$54591.50,55,$-933.00
2024-03-15,11:46:00,18046.5,SELL,3,0.02h,Stop Loss,$-9.00,$-942.00,$54582.50,55,$-942.00
2024-03-15,11:57:00,18283.75,BUY,3,0.02h,Stop Loss,$-9.00,$-951.00,$54573.50,55,$-951.00
2024-03-15,11:58:00,18031.75,SELL,3,0.02h,Stop Loss,$7.50,$-943.50,$54581.00,55,$-943.50
2024-03-15,12:09:00,18266.75,BUY,3,0.02h,Stop Loss,$-9.00,$-952.50,$54572.00,55,$-952.50
2024-03-15,12:10:00,18022.25,SELL,3,0.02h,Stop Loss,$-9.00,$-961.50,$54563.00,55,$-961.50
2024-03-15,12:11:00,18273.25,BUY,3,0.02h,Stop Loss,$-9.00,$-970.50,$54554.00,55,$-970.50
2024-03-15,12:13:00,18011.75,SELL,3,0.02h,Stop Loss,$-9.00,$-979.50,$54545.00,55,$-979.50
2024-03-15,12:14:00,18256.5,BUY,3,0.02h,Break Even,$-1.50,$-981.00,$54543.50,55,$-981.00
2024-03-15,12:21:00,18007.0,SELL,3,0.02h,Stop Loss,$-9.00,$-990.00,$54534.50,55,$-990.00
2024-03-15,12:22:00,18256.25,BUY,3,0.02h,Break Even,$-1.50,$-991.50,$54533.00,55,$-991.50
2024-03-15,12:42:00,17992.75,SELL,3,0.02h,Stop Loss,$-9.00,$-1000.50,$54524.00,55,$-1000.50
2024-03-15,12:58:00,18258.5,BUY,3,0.02h,Stop Loss,$-9.00,$-1009.50,$54515.00,55,$-1009.50
2024-03-15,13:07:00,17990.0,SELL,3,0.02h,Stop Loss,$-9.00,$-1018.50,$54506.00,55,$-1018.50
2024-03-15,13:11:00,18233.5,BUY,3,0.02h,Stop Loss,$-9.00,$-1027.50,$54497.00,55,$-1027.50
2024-03-15,13:12:00,17981.5,SELL,3,0.02h,Stop Loss,$16.50,$-1011.00,$54513.50,55,$-1011.00
2024-03-15,13:23:00,18201.0,BUY,3,0.02h,Stop Loss,$-9.00,$-1020.00,$54504.50,55,$-1020.00
2024-03-15,13:24:00,17952.0,SELL,3,0.02h,Stop Loss,$18.00,$-1002.00,$54522.50,55,$-1002.00
2024-03-15,13:33:00,18146.5,BUY,3,0.02h,Stop Loss,$21.00,$-981.00,$54543.50,55,$-981.00
2024-03-15,13:47:00,18079.0,SELL,3,0.02h,Stop Loss,$-9.00,$-990.00,$54534.50,55,$-990.00
2024-03-15,13:54:00,18113.0,BUY,3,0.02h,Break Even,$-1.50,$-991.50,$54533.00,55,$-991.50
2024-03-15,13:59:00,18093.25,SELL,3,0.02h,Stop Loss,$33.00,$-958.50,$54566.00,55,$-958.50
2024-03-15,14:16:00,18110.75,BUY,3,0.02h,Break Even,$-1.50,$-960.00,$54564.50,55,$-960.00
2024-03-15,14:59:00,18128.5,SELL,3,0.02h,Stop Loss,$30.00,$-930.00,$54594.50,55,$-930.00
2024-03-15,16:33:00,18067.75,BUY,3,0.02h,Stop Loss,$-9.00,$-939.00,$54585.50,55,$-939.00
2024-03-15,16:49:00,18045.0,SELL,3,0.02h,Stop Loss,$27.00,$-912.00,$54612.50,55,$-912.00
2024-03-15,17:11:00,18035.5,BUY,3,0.02h,Stop Loss,$64.50,$-847.50,$54677.00,55,$-847.50
2024-03-15,17:49:00,18044.0,SELL,3,0.02h,Stop Loss,$22.50,$-825.00,$54699.50,55,$-825.00
2024-03-15,17:55:00,18068.5,BUY,3,0.02h,Stop Loss,$51.00,$-774.00,$54750.50,55,$-774.00
2024-03-15,18:14:00,18059.75,SELL,3,0.02h,Stop Loss,$16.50,$-757.50,$54767.00,55,$-757.50
2024-03-15,18:34:00,18071.25,BUY,3,0.02h,Break Even,$-1.50,$-759.00,$54765.50,55,$-759.00
2024-03-15,19:10:00,18071.75,SELL,3,0.02h,Stop Loss,$9.00,$-750.00,$54774.50,55,$-750.00
2024-03-15,19:27:00,18087.5,BUY,3,0.02h,Stop Loss,$42.00,$-708.00,$54816.50,55,$-708.00
2024-03-15,19:39:00,18068.75,SELL,3,0.02h,Break Even,$-1.50,$-709.50,$54815.00,55,$-709.50
2024-03-15,20:05:00,18069.5,BUY,3,0.02h,Break Even,$-1.50,$-711.00,$54813.50,55,$-711.00
2024-03-15,20:22:00,18066.25,SELL,3,0.02h,Stop Loss,$-9.00,$-720.00,$54804.50,55,$-720.00
2024-03-15,20:25:00,18073.75,BUY,3,0.03h,Stop Loss,$22.50,$-697.50,$54827.00,55,$-697.50
2024-03-15,20:38:00,18068.75,SELL,3,0.02h,Break Even,$-1.50,$-699.00,$54825.50,55,$-699.00
,,,,,,,,,,,
2024-03-18,00:00:00,18079.0,BUY,3,0.02h,Stop Loss,$-9.00,$-9.00,$54816.50,56,$-9.00
2024-03-18,01:24:00,18091.0,SELL,3,0.02h,Stop Loss,$-9.00,$-18.00,$54807.50,56,$-18.00
2024-03-18,01:26:00,18094.75,BUY,3,0.02h,Stop Loss,$-9.00,$-27.00,$54798.50,56,$-27.00
2024-03-18,01:27:00,18090.25,SELL,3,0.02h,Break Even,$-1.50,$-28.50,$54797.00,56,$-28.50
2024-03-18,01:32:00,18096.75,BUY,3,0.02h,Break Even,$-1.50,$-30.00,$54795.50,56,$-30.00
2024-03-18,03:20:00,18120.5,SELL,3,0.02h,Stop Loss,$-9.00,$-39.00,$54786.50,56,$-39.00
2024-03-18,03:27:00,18123.75,BUY,3,0.02h,Stop Loss,$-9.00,$-48.00,$54777.50,56,$-48.00
2024-03-18,03:42:00,18119.5,SELL,3,0.02h,Break Even,$-1.50,$-49.50,$54776.00,56,$-49.50
2024-03-18,03:59:00,18123.5,BUY,3,0.02h,Break Even,$-1.50,$-51.00,$54774.50,56,$-51.00
2024-03-18,05:02:00,18136.25,SELL,3,0.03h,Stop Loss,$-9.00,$-60.00,$54765.50,56,$-60.00
2024-03-18,05:07:00,18139.5,BUY,3,0.02h,Break Even,$-1.50,$-61.50,$54764.00,56,$-61.50
2024-03-18,06:24:00,18158.0,SELL,3,0.02h,Stop Loss,$-9.00,$-70.50,$54755.00,56,$-70.50
2024-03-18,06:49:00,18161.0,BUY,3,0.02h,Break Even,$-1.50,$-72.00,$54753.50,56,$-72.00
2024-03-18,06:58:00,18156.5,SELL,3,0.03h,Stop Loss,$7.50,$-64.50,$54761.00,56,$-64.50
2024-03-18,07:03:00,18159.75,BUY,3,0.02h,Stop Loss,$-9.00,$-73.50,$54752.00,56,$-73.50
2024-03-18,07:14:00,18154.5,SELL,3,0.02h,Stop Loss,$-9.00,$-82.50,$54743.00,56,$-82.50
2024-03-18,07:17:00,18159.25,BUY,3,0.02h,Stop Loss,$-9.00,$-91.50,$54734.00,56,$-91.50
2024-03-18,07:18:00,18154.25,SELL,3,0.02h,Stop Loss,$-9.00,$-100.50,$54725.00,56,$-100.50
2024-03-18,07:22:00,18160.5,BUY,3,0.02h,Stop Loss,$10.50,$-90.00,$54735.50,56,$-90.00
2024-03-18,07:30:00,18150.0,SELL,3,0.02h,Break Even,$-1.50,$-91.50,$54734.00,56,$-91.50
2024-03-18,07:43:00,18160.75,BUY,3,0.02h,Break Even,$-1.50,$-93.00,$54732.50,56,$-93.00
2024-03-18,07:49:00,18156.25,SELL,3,0.02h,Break Even,$-1.50,$-94.50,$54731.00,56,$-94.50
2024-03-18,08:04:00,18161.75,BUY,3,0.02h,Stop Loss,$13.50,$-81.00,$54744.50,56,$-81.00
2024-03-18,08:21:00,18153.25,SELL,3,0.02h,Stop Loss,$-9.00,$-90.00,$54735.50,56,$-90.00
2024-03-18,08:42:00,18158.0,BUY,3,0.02h,Break Even,$-1.50,$-91.50,$54734.00,56,$-91.50
2024-03-18,09:17:00,18177.75,SELL,3,0.02h,Break Even,$-1.50,$-93.00,$54732.50,56,$-93.00
2024-03-18,09:44:00,18177.25,BUY,3,0.02h,Stop Loss,$6.00,$-87.00,$54738.50,56,$-87.00
2024-03-18,09:54:00,18172.5,SELL,3,0.02h,Stop Loss,$-9.00,$-96.00,$54729.50,56,$-96.00
2024-03-18,09:57:00,18177.0,BUY,3,0.02h,Stop Loss,$-9.00,$-105.00,$54720.50,56,$-105.00
2024-03-18,09:59:00,18174.75,SELL,3,0.02h,Stop Loss,$-9.00,$-114.00,$54711.50,56,$-114.00
2024-03-18,10:01:00,18176.25,BUY,3,0.02h,Stop Loss,$-9.00,$-123.00,$54702.50,56,$-123.00
2024-03-18,10:02:00,18174.0,SELL,3,0.02h,Stop Loss,$-9.00,$-132.00,$54693.50,56,$-132.00
2024-03-18,10:04:00,18178.5,BUY,3,0.02h,Break Even,$-1.50,$-133.50,$54692.00,56,$-133.50
2024-03-18,11:03:00,18192.5,SELL,3,0.02h,Stop Loss,$-9.00,$-142.50,$54683.00,56,$-142.50
2024-03-18,11:06:00,18199.0,BUY,3,0.02h,Stop Loss,$-9.00,$-151.50,$54674.00,56,$-151.50
2024-03-18,12:35:00,18270.5,SELL,3,0.02h,Break Even,$-1.50,$-153.00,$54672.50,56,$-153.00
2024-03-18,12:37:00,18274.75,BUY,3,0.02h,Break Even,$-1.50,$-154.50,$54671.00,56,$-154.50
2024-03-18,12:38:00,18274.25,SELL,3,0.02h,Stop Loss,$-9.00,$-163.50,$54662.00,56,$-163.50
2024-03-18,12:39:00,18276.75,BUY,3,0.02h,Stop Loss,$-9.00,$-172.50,$54653.00,56,$-172.50
2024-03-18,12:40:00,18270.75,SELL,3,0.02h,Stop Loss,$-9.00,$-181.50,$54644.00,56,$-181.50
2024-03-18,12:48:00,18276.5,BUY,3,0.02h,Break Even,$-1.50,$-183.00,$54642.50,56,$-183.00
2024-03-18,12:50:00,18268.5,SELL,3,0.02h,Stop Loss,$-9.00,$-192.00,$54633.50,56,$-192.00
2024-03-18,13:00:00,18276.75,BUY,3,0.02h,Stop Loss,$24.00,$-168.00,$54657.50,56,$-168.00
2024-03-18,13:24:00,18277.0,SELL,3,0.02h,Stop Loss,$-9.00,$-177.00,$54648.50,56,$-177.00
2024-03-18,13:31:00,18294.75,BUY,3,0.02h,Stop Loss,$103.50,$-73.50,$54752.00,56,$-73.50
2024-03-18,13:57:00,18314.25,SELL,3,0.02h,Stop Loss,$126.00,$52.50,$54878.00,56,$52.50
2024-03-18,14:09:00,18333.25,BUY,3,0.02h,Break Even,$-1.50,$51.00,$54876.50,56,$51.00
2024-03-18,14:52:00,18353.75,SELL,3,0.02h,Break Even,$-1.50,$49.50,$54875.00,56,$49.50
2024-03-18,16:11:00,18301.75,BUY,3,0.02h,Break Even,$-1.50,$48.00,$54873.50,56,$48.00
2024-03-18,16:27:00,18291.5,SELL,3,0.02h,Break Even,$-1.50,$46.50,$54872.00,56,$46.50
2024-03-18,16:45:00,18298.5,BUY,3,0.02h,Stop Loss,$-9.00,$37.50,$54863.00,56,$37.50
2024-03-18,16:50:00,18282.5,SELL,3,0.02h,Stop Loss,$123.00,$160.50,$54986.00,56,$160.50
2024-03-18,17:22:00,18274.0,BUY,3,0.02h,Break Even,$-1.50,$159.00,$54984.50,56,$159.00
2024-03-18,17:39:00,18254.25,SELL,3,0.02h,Stop Loss,$12.00,$171.00,$54996.50,56,$171.00
2024-03-18,17:59:00,18274.0,BUY,3,0.02h,Break Even,$-1.50,$169.50,$54995.00,56,$169.50
2024-03-18,18:42:00,18278.5,SELL,3,0.02h,Stop Loss,$123.00,$292.50,$55118.00,56,$292.50
2024-03-18,19:08:00,18289.5,BUY,3,0.02h,Stop Loss,$24.00,$316.50,$55142.00,56,$316.50
2024-03-18,19:26:00,18280.0,SELL,3,0.02h,Break Even,$-1.50,$315.00,$55140.50,56,$315.00
2024-03-18,19:35:00,18286.75,BUY,3,0.02h,Stop Loss,$-9.00,$306.00,$55131.50,56,$306.00
2024-03-18,19:37:00,18277.75,SELL,3,0.02h,Stop Loss,$7.50,$313.50,$55139.00,56,$313.50
2024-03-18,20:29:00,18232.5,BUY,3,0.02h,Stop Loss,$43.50,$357.00,$55182.50,56,$357.00
2024-03-18,20:40:00,18226.0,SELL,3,0.02h,Break Even,$-1.50,$355.50,$55181.00,56,$355.50
2024-03-18,23:39:00,18196.25,BUY,3,0.02h,Stop Loss,$-9.00,$346.50,$55172.00,56,$346.50
2024-03-18,23:44:00,18193.25,SELL,3,0.02h,Stop Loss,$3.00,$349.50,$55175.00,56,$349.50
,,,,,,,,,,,
2024-03-19,00:42:00,18184.25,BUY,3,0.02h,Stop Loss,$-9.00,$-9.00,$55166.00,57,$-9.00
2024-03-19,00:46:00,18178.5,SELL,3,0.02h,Stop Loss,$54.00,$45.00,$55220.00,57,$45.00
2024-03-19,01:44:00,18164.0,BUY,3,0.02h,Stop Loss,$7.50,$52.50,$55227.50,57,$52.50
2024-03-19,02:41:00,18185.0,SELL,3,0.02h,Break Even,$-1.50,$51.00,$55226.00,57,$51.00
2024-03-19,02:47:00,18188.25,BUY,3,0.02h,Break Even,$-1.50,$49.50,$55224.50,57,$49.50
2024-03-19,03:24:00,18190.5,SELL,3,0.02h,Break Even,$-1.50,$48.00,$55223.00,57,$48.00
2024-03-19,03:41:00,18202.25,BUY,3,0.02h,Stop Loss,$19.50,$67.50,$55242.50,57,$67.50
2024-03-19,03:47:00,18176.75,SELL,3,0.02h,Stop Loss,$10.50,$78.00,$55253.00,57,$78.00
2024-03-19,04:06:00,18187.0,BUY,3,0.02h,Break Even,$-1.50,$76.50,$55251.50,57,$76.50
2024-03-19,04:29:00,18185.5,SELL,3,0.02h,Stop Loss,$-9.00,$67.50,$55242.50,57,$67.50
2024-03-19,04:44:00,18187.75,BUY,3,0.02h,Stop Loss,$-9.00,$58.50,$55233.50,57,$58.50
2024-03-19,04:45:00,18183.75,SELL,3,0.02h,Break Even,$-1.50,$57.00,$55232.00,57,$57.00
2024-03-19,04:58:00,18186.75,BUY,3,0.02h,Break Even,$-1.50,$55.50,$55230.50,57,$55.50
2024-03-19,05:04:00,18183.5,SELL,3,0.02h,Break Even,$-1.50,$54.00,$55229.00,57,$54.00
2024-03-19,05:18:00,18185.25,BUY,3,0.02h,Stop Loss,$-9.00,$45.00,$55220.00,57,$45.00
2024-03-19,05:32:00,18178.75,SELL,3,0.02h,Stop Loss,$-9.00,$36.00,$55211.00,57,$36.00
2024-03-19,05:34:00,18186.0,BUY,3,0.02h,Break Even,$-1.50,$34.50,$55209.50,57,$34.50
2024-03-19,05:38:00,18180.75,SELL,3,0.02h,Stop Loss,$-9.00,$25.50,$55200.50,57,$25.50
2024-03-19,05:42:00,18188.75,BUY,3,0.02h,Stop Loss,$-9.00,$16.50,$55191.50,57,$16.50
2024-03-19,06:06:00,18184.0,SELL,3,0.02h,Break Even,$-1.50,$15.00,$55190.00,57,$15.00
2024-03-19,06:31:00,18191.0,BUY,3,0.02h,Break Even,$-1.50,$13.50,$55188.50,57,$13.50
2024-03-19,06:44:00,18185.0,SELL,3,0.02h,Stop Loss,$-9.00,$4.50,$55179.50,57,$4.50
2024-03-19,06:48:00,18189.75,BUY,3,0.02h,Stop Loss,$-9.00,$-4.50,$55170.50,57,$-4.50
2024-03-19,06:51:00,18186.0,SELL,3,0.02h,Break Even,$-1.50,$-6.00,$55169.00,57,$-6.00
2024-03-19,07:08:00,18187.75,BUY,3,0.02h,Break Even,$-1.50,$-7.50,$55167.50,57,$-7.50
2024-03-19,07:21:00,18184.0,SELL,3,0.02h,Break Even,$-1.50,$-9.00,$55166.00,57,$-9.00
2024-03-19,07:29:00,18188.5,BUY,3,0.02h,Break Even,$-1.50,$-10.50,$55164.50,57,$-10.50
2024-03-19,07:43:00,18181.5,SELL,3,0.02h,Stop Loss,$-9.00,$-19.50,$55155.50,57,$-19.50
2024-03-19,08:03:00,18191.75,BUY,3,0.02h,Stop Loss,$9.00,$-10.50,$55164.50,57,$-10.50
2024-03-19,08:07:00,18167.5,SELL,3,0.02h,Break Even,$-1.50,$-12.00,$55163.00,57,$-12.00
2024-03-19,08:24:00,18189.25,BUY,3,0.02h,Stop Loss,$-9.00,$-21.00,$55154.00,57,$-21.00
2024-03-19,09:06:00,18203.5,SELL,3,0.02h,Stop Loss,$24.00,$3.00,$55178.00,57,$3.00
2024-03-19,10:09:00,18187.0,BUY,3,0.02h,Stop Loss,$-9.00,$-6.00,$55169.00,57,$-6.00
2024-03-19,10:27:00,18184.0,SELL,3,0.02h,Stop Loss,$-9.00,$-15.00,$55160.00,57,$-15.00
2024-03-19,10:31:00,18187.25,BUY,3,0.02h,Stop Loss,$-9.00,$-24.00,$55151.00,57,$-24.00
2024-03-19,10:32:00,18184.0,SELL,3,0.02h,Break Even,$-1.50,$-25.50,$55149.50,57,$-25.50
2024-03-19,10:35:00,18187.0,BUY,3,0.02h,Stop Loss,$7.50,$-18.00,$55157.00,57,$-18.00
2024-03-19,10:53:00,18178.0,SELL,3,0.02h,Stop Loss,$43.50,$25.50,$55200.50,57,$25.50
2024-03-19,11:58:00,18118.0,BUY,3,0.02h,Stop Loss,$6.00,$31.50,$55206.50,57,$31.50
2024-03-19,12:08:00,18108.0,SELL,3,0.02h,Stop Loss,$12.00,$43.50,$55218.50,57,$43.50
2024-03-19,12:37:00,18109.25,BUY,3,0.02h,Stop Loss,$12.00,$55.50,$55230.50,57,$55.50
2024-03-19,13:32:00,18116.5,SELL,3,0.02h,Break Even,$-1.50,$54.00,$55229.00,57,$54.00
2024-03-19,14:01:00,18099.0,BUY,3,0.02h,Stop Loss,$39.00,$93.00,$55268.00,57,$93.00
2024-03-19,14:18:00,18093.0,SELL,3,0.02h,Stop Loss,$37.50,$130.50,$55305.50,57,$130.50
2024-03-19,14:36:00,18105.75,BUY,3,0.02h,Break Even,$-1.50,$129.00,$55304.00,57,$129.00
2024-03-19,15:04:00,18117.0,SELL,3,0.02h,Stop Loss,$-9.00,$120.00,$55295.00,57,$120.00
2024-03-19,15:05:00,18129.0,BUY,3,0.02h,Stop Loss,$55.50,$175.50,$55350.50,57,$175.50
2024-03-19,15:21:00,18118.0,SELL,3,0.02h,Break Even,$-1.50,$174.00,$55349.00,57,$174.00
2024-03-19,15:30:00,18131.25,BUY,3,0.02h,Stop Loss,$40.50,$214.50,$55389.50,57,$214.50
2024-03-19,15:55:00,18135.75,SELL,3,0.02h,Break Even,$-1.50,$213.00,$55388.00,57,$213.00
2024-03-19,16:00:00,18158.75,BUY,3,0.02h,Break Even,$-1.50,$211.50,$55386.50,57,$211.50
2024-03-19,17:16:00,18235.5,SELL,3,0.02h,Break Even,$-1.50,$210.00,$55385.00,57,$210.00
2024-03-19,17:28:00,18254.75,BUY,3,0.02h,Break Even,$-1.50,$208.50,$55383.50,57,$208.50
2024-03-19,17:55:00,18253.25,SELL,3,0.02h,Stop Loss,$6.00,$214.50,$55389.50,57,$214.50
2024-03-19,18:16:00,18271.0,BUY,3,0.02h,Stop Loss,$19.50,$234.00,$55409.00,57,$234.00
2024-03-19,18:56:00,18255.5,SELL,3,0.02h,Stop Loss,$-9.00,$225.00,$55400.00,57,$225.00
2024-03-19,19:38:00,18241.0,BUY,3,0.02h,Stop Loss,$15.00,$240.00,$55415.00,57,$240.00
2024-03-19,20:21:00,18269.25,SELL,3,0.02h,Break Even,$-1.50,$238.50,$55413.50,57,$238.50
2024-03-19,20:35:00,18272.25,BUY,3,0.02h,Break Even,$-1.50,$237.00,$55412.00,57,$237.00
2024-03-19,20:56:00,18274.0,SELL,3,0.02h,Break Even,$-1.50,$235.50,$55410.50,57,$235.50
2024-03-19,23:02:00,18280.5,BUY,3,0.05h,Break Even,$-1.50,$234.00,$55409.00,57,$234.00
2024-03-19,23:15:00,18274.75,SELL,3,0.02h,Stop Loss,$-9.00,$225.00,$55400.00,57,$225.00
2024-03-19,23:20:00,18279.25,BUY,3,0.02h,Break Even,$-1.50,$223.50,$55398.50,57,$223.50
2024-03-19,23:23:00,18277.25,SELL,3,0.02h,Stop Loss,$-9.00,$214.50,$55389.50,57,$214.50
2024-03-19,23:27:00,18279.75,BUY,3,0.02h,Stop Loss,$-9.00,$205.50,$55380.50,57,$205.50
2024-03-19,23:34:00,18277.25,SELL,3,0.02h,Break Even,$-1.50,$204.00,$55379.00,57,$204.00
,,,,,,,,,,,
2024-03-20,00:43:00,18258.0,BUY,3,0.02h,Stop Loss,$-9.00,$-9.00,$55370.00,58,$-9.00
2024-03-20,00:49:00,18255.25,SELL,3,0.02h,Break Even,$-1.50,$-10.50,$55368.50,58,$-10.50
2024-03-20,02:08:00,18237.75,BUY,3,0.02h,Stop Loss,$-9.00,$-19.50,$55359.50,58,$-19.50
2024-03-20,02:30:00,18237.25,SELL,3,0.02h,Break Even,$-1.50,$-21.00,$55358.00,58,$-21.00
2024-03-20,02:42:00,18239.5,BUY,3,0.03h,Break Even,$-1.50,$-22.50,$55356.50,58,$-22.50
2024-03-20,03:18:00,18241.75,SELL,3,0.03h,Stop Loss,$-9.00,$-31.50,$55347.50,58,$-31.50
2024-03-20,03:20:00,18244.75,BUY,3,0.03h,Break Even,$-1.50,$-33.00,$55346.00,58,$-33.00
2024-03-20,03:42:00,18245.5,SELL,3,0.13h,Break Even,$-1.50,$-34.50,$55344.50,58,$-34.50
2024-03-20,03:53:00,18247.25,BUY,3,0.05h,Stop Loss,$-9.00,$-43.50,$55335.50,58,$-43.50
2024-03-20,03:58:00,18245.0,SELL,3,0.03h,Stop Loss,$-9.00,$-52.50,$55326.50,58,$-52.50
2024-03-20,04:18:00,18245.5,BUY,3,0.07h,Stop Loss,$-9.00,$-61.50,$55317.50,58,$-61.50
2024-03-20,04:48:00,18245.5,SELL,3,0.02h,Break Even,$-1.50,$-63.00,$55316.00,58,$-63.00
2024-03-20,05:20:00,18240.5,BUY,3,0.08h,Stop Loss,$-9.00,$-72.00,$55307.00,58,$-72.00
2024-03-20,05:30:00,18239.0,SELL,3,0.02h,Stop Loss,$-9.00,$-81.00,$55298.00,58,$-81.00
2024-03-20,05:38:00,18244.0,BUY,3,0.02h,Break Even,$-1.50,$-82.50,$55296.50,58,$-82.50
2024-03-20,06:04:00,18245.75,SELL,3,0.03h,Break Even,$-1.50,$-84.00,$55295.00,58,$-84.00
2024-03-20,06:14:00,18250.0,BUY,3,0.02h,Break Even,$-1.50,$-85.50,$55293.50,58,$-85.50
2024-03-20,06:32:00,18246.5,SELL,3,0.02h,Stop Loss,$-9.00,$-94.50,$55284.50,58,$-94.50
2024-03-20,06:45:00,18250.25,BUY,3,0.02h,Break Even,$-1.50,$-96.00,$55283.00,58,$-96.00
2024-03-20,07:41:00,18266.75,SELL,3,0.02h,Break Even,$-1.50,$-97.50,$55281.50,58,$-97.50
2024-03-20,07:46:00,18275.25,BUY,3,0.02h,Stop Loss,$-9.00,$-106.50,$55272.50,58,$-106.50
2024-03-20,07:51:00,18270.5,SELL,3,0.02h,Stop Loss,$-9.00,$-115.50,$55263.50,58,$-115.50
2024-03-20,08:15:00,18270.0,BUY,3,0.02h,Break Even,$-1.50,$-117.00,$55262.00,58,$-117.00
2024-03-20,08:22:00,18261.5,SELL,3,0.02h,Stop Loss,$-9.00,$-126.00,$55253.00,58,$-126.00
2024-03-20,09:16:00,18250.25,BUY,3,0.02h,Break Even,$-1.50,$-127.50,$55251.50,58,$-127.50
2024-03-20,09:52:00,18257.5,SELL,3,0.02h,Stop Loss,$-9.00,$-136.50,$55242.50,58,$-136.50
2024-03-20,09:54:00,18262.75,BUY,3,0.02h,Stop Loss,$-9.00,$-145.50,$55233.50,58,$-145.50
2024-03-20,10:25:00,18264.75,SELL,3,0.02h,Break Even,$-1.50,$-147.00,$55232.00,58,$-147.00
2024-03-20,10:33:00,18283.25,BUY,3,0.02h,Stop Loss,$34.50,$-112.50,$55266.50,58,$-112.50
2024-03-20,12:06:00,18319.0,SELL,3,0.02h,Stop Loss,$24.00,$-88.50,$55290.50,58,$-88.50
2024-03-20,12:33:00,18310.5,BUY,3,0.02h,Break Even,$-1.50,$-90.00,$55289.00,58,$-90.00
2024-03-20,12:41:00,18295.5,SELL,3,0.02h,Stop Loss,$54.00,$-36.00,$55343.00,58,$-36.00
2024-03-20,13:10:00,18302.5,BUY,3,0.02h,Stop Loss,$-9.00,$-45.00,$55334.00,58,$-45.00
2024-03-20,13:12:00,18293.75,SELL,3,0.02h,Break Even,$-1.50,$-46.50,$55332.50,58,$-46.50
2024-03-20,13:19:00,18302.25,BUY,3,0.02h,Stop Loss,$6.00,$-40.50,$55338.50,58,$-40.50
2024-03-20,13:38:00,18280.5,SELL,3,0.02h,Break Even,$-1.50,$-42.00,$55337.00,58,$-42.00
2024-03-20,14:24:00,18278.5,BUY,3,0.02h,Stop Loss,$28.50,$-13.50,$55365.50,58,$-13.50
2024-03-20,14:38:00,18265.0,SELL,3,0.02h,Break Even,$-1.50,$-15.00,$55364.00,58,$-15.00
2024-03-20,15:03:00,18270.75,BUY,3,0.02h,Stop Loss,$6.00,$-9.00,$55370.00,58,$-9.00
2024-03-20,15:35:00,18278.5,SELL,3,0.02h,Stop Loss,$-9.00,$-18.00,$55361.00,58,$-18.00
2024-03-20,15:56:00,18279.75,BUY,3,0.02h,Stop Loss,$9.00,$-9.00,$55370.00,58,$-9.00
2024-03-20,16:09:00,18268.0,SELL,3,0.02h,Break Even,$-1.50,$-10.50,$55368.50,58,$-10.50
2024-03-20,16:26:00,18275.25,BUY,3,0.02h,Stop Loss,$21.00,$10.50,$55389.50,58,$10.50
2024-03-20,16:34:00,18262.75,SELL,3,0.02h,Stop Loss,$-9.00,$1.50,$55380.50,58,$1.50
2024-03-20,16:38:00,18273.75,BUY,3,0.02h,Stop Loss,$18.00,$19.50,$55398.50,58,$19.50
2024-03-20,17:10:00,18277.25,SELL,3,0.02h,Break Even,$-1.50,$18.00,$55397.00,58,$18.00
2024-03-20,17:52:00,18269.25,BUY,3,0.02h,Stop Loss,$-9.00,$9.00,$55388.00,58,$9.00
2024-03-20,18:35:00,18297.75,SELL,3,0.02h,Stop Loss,$46.50,$55.50,$55434.50,58,$55.50
2024-03-20,18:40:00,18366.5,BUY,3,0.02h,Stop Loss,$46.50,$102.00,$55481.00,58,$102.00
2024-03-20,19:44:00,18458.75,SELL,3,0.02h,Stop Loss,$39.00,$141.00,$55520.00,58,$141.00
2024-03-20,19:58:00,18474.25,BUY,3,0.02h,Stop Loss,$16.50,$157.50,$55536.50,58,$157.50
2024-03-20,23:49:00,18575.0,SELL,3,0.02h,Break Even,$-1.50,$156.00,$55535.00,58,$156.00
,,,,,,,,,,,
2024-03-21,00:26:00,18575.0,BUY,3,0.02h,Stop Loss,$-9.00,$-9.00,$55526.00,59,$-9.00
2024-03-21,00:27:00,18573.0,SELL,3,0.02h,Break Even,$-1.50,$-10.50,$55524.50,59,$-10.50
2024-03-21,01:11:00,18568.25,BUY,3,0.02h,Break Even,$-1.50,$-12.00,$55523.00,59,$-12.00
2024-03-21,01:24:00,18561.5,SELL,3,0.02h,Stop Loss,$-9.00,$-21.00,$55514.00,59,$-21.00
2024-03-21,01:51:00,18566.0,BUY,3,0.02h,Stop Loss,$-9.00,$-30.00,$55505.00,59,$-30.00
2024-03-21,03:02:00,18587.75,SELL,3,0.02h,Stop Loss,$-9.00,$-39.00,$55496.00,59,$-39.00
2024-03-21,03:03:00,18590.0,BUY,3,0.02h,Stop Loss,$-9.00,$-48.00,$55487.00,59,$-48.00
2024-03-21,03:19:00,18588.5,SELL,3,0.03h,Stop Loss,$-9.00,$-57.00,$55478.00,59,$-57.00
2024-03-21,03:23:00,18593.0,BUY,3,0.02h,Break Even,$-1.50,$-58.50,$55476.50,59,$-58.50
2024-03-21,03:40:00,18587.75,SELL,3,0.02h,Break Even,$-1.50,$-60.00,$55475.00,59,$-60.00
2024-03-21,03:56:00,18591.0,BUY,3,0.02h,Stop Loss,$-9.00,$-69.00,$55466.00,59,$-69.00
2024-03-21,05:04:00,18597.5,SELL,3,0.02h,Stop Loss,$-9.00,$-78.00,$55457.00,59,$-78.00
2024-03-21,05:09:00,18602.5,BUY,3,0.02h,Break Even,$-1.50,$-79.50,$55455.50,59,$-79.50
2024-03-21,05:13:00,18600.0,SELL,3,0.02h,Stop Loss,$-9.00,$-88.50,$55446.50,59,$-88.50
2024-03-21,05:14:00,18600.75,BUY,3,0.02h,Break Even,$-1.50,$-90.00,$55445.00,59,$-90.00
2024-03-21,05:28:00,18599.75,SELL,3,0.02h,Stop Loss,$-9.00,$-99.00,$55436.00,59,$-99.00
2024-03-21,05:35:00,18603.25,BUY,3,0.02h,Break Even,$-1.50,$-100.50,$55434.50,59,$-100.50
2024-03-21,08:03:00,18639.25,SELL,3,0.02h,Stop Loss,$-9.00,$-109.50,$55425.50,59,$-109.50
2024-03-21,09:03:00,18622.75,BUY,3,0.02h,Break Even,$-1.50,$-111.00,$55424.00,59,$-111.00
2024-03-21,09:04:00,18616.5,SELL,3,0.02h,Stop Loss,$13.50,$-97.50,$55437.50,59,$-97.50
2024-03-21,09:39:00,18604.75,BUY,3,0.02h,Stop Loss,$-9.00,$-106.50,$55428.50,59,$-106.50
2024-03-21,10:05:00,18604.75,SELL,3,0.02h,Stop Loss,$24.00,$-82.50,$55452.50,59,$-82.50
2024-03-21,10:20:00,18606.5,BUY,3,0.02h,Stop Loss,$-9.00,$-91.50,$55443.50,59,$-91.50
2024-03-21,10:38:00,18599.75,SELL,3,0.02h,Stop Loss,$-9.00,$-100.50,$55434.50,59,$-100.50
2024-03-21,10:57:00,18603.5,BUY,3,0.02h,Stop Loss,$4.50,$-96.00,$55439.00,59,$-96.00
2024-03-21,11:59:00,18634.0,SELL,3,0.02h,Stop Loss,$-9.00,$-105.00,$55430.00,59,$-105.00
2024-03-21,12:01:00,18640.0,BUY,3,0.02h,Stop Loss,$21.00,$-84.00,$55451.00,59,$-84.00
2024-03-21,12:37:00,18648.25,SELL,3,0.02h,Stop Loss,$-9.00,$-93.00,$55442.00,59,$-93.00
2024-03-21,12:51:00,18660.5,BUY,3,0.02h,Stop Loss,$-9.00,$-102.00,$55433.00,59,$-102.00
2024-03-21,13:04:00,18653.5,SELL,3,0.02h,Stop Loss,$-9.00,$-111.00,$55424.00,59,$-111.00
2024-03-21,13:21:00,18656.25,BUY,3,0.02h,Stop Loss,$3.00,$-108.00,$55427.00,59,$-108.00
2024-03-21,13:49:00,18644.75,SELL,3,0.02h,Stop Loss,$21.00,$-87.00,$55448.00,59,$-87.00
2024-03-21,14:11:00,18653.75,BUY,3,0.02h,Stop Loss,$3.00,$-84.00,$55451.00,59,$-84.00
2024-03-21,14:18:00,18643.75,SELL,3,0.02h,Break Even,$-1.50,$-85.50,$55449.50,59,$-85.50
2024-03-21,14:20:00,18661.75,BUY,3,0.02h,Stop Loss,$13.50,$-72.00,$55463.00,59,$-72.00
2024-03-21,14:32:00,18637.5,SELL,3,0.02h,Stop Loss,$30.00,$-42.00,$55493.00,59,$-42.00
2024-03-21,14:49:00,18664.5,BUY,3,0.02h,Stop Loss,$7.50,$-34.50,$55500.50,59,$-34.50
2024-03-21,15:00:00,18643.5,SELL,3,0.02h,Stop Loss,$-9.00,$-43.50,$55491.50,59,$-43.50
2024-03-21,15:02:00,18661.75,BUY,3,0.02h,Break Even,$-1.50,$-45.00,$55490.00,59,$-45.00
2024-03-21,15:04:00,18641.0,SELL,3,0.02h,Stop Loss,$7.50,$-37.50,$55497.50,59,$-37.50
2024-03-21,15:22:00,18648.75,BUY,3,0.02h,Stop Loss,$31.50,$-6.00,$55529.00,59,$-6.00
2024-03-21,16:38:00,18688.5,SELL,3,0.02h,Break Even,$-1.50,$-7.50,$55527.50,59,$-7.50
2024-03-21,16:57:00,18695.0,BUY,3,0.02h,Stop Loss,$-9.00,$-16.50,$55518.50,59,$-16.50
2024-03-21,17:00:00,18689.0,SELL,3,0.02h,Stop Loss,$3.00,$-13.50,$55521.50,59,$-13.50
2024-03-21,18:27:00,18616.0,BUY,3,0.02h,Break Even,$-1.50,$-15.00,$55520.00,59,$-15.00
2024-03-21,18:35:00,18594.5,SELL,3,0.02h,Stop Loss,$112.50,$97.50,$55632.50,59,$97.50
2024-03-21,19:11:00,18585.0,BUY,3,0.02h,Stop Loss,$10.50,$108.00,$55643.00,59,$108.00
2024-03-21,19:27:00,18579.25,SELL,3,0.02h,Stop Loss,$6.00,$114.00,$55649.00,59,$114.00
2024-03-21,19:30:00,18586.5,BUY,3,0.02h,Stop Loss,$31.50,$145.50,$55680.50,59,$145.50
2024-03-21,19:35:00,18578.5,SELL,3,0.02h,Stop Loss,$22.50,$168.00,$55703.00,59,$168.00
2024-03-21,19:45:00,18590.5,BUY,3,0.02h,Break Even,$-1.50,$166.50,$55701.50,59,$166.50
2024-03-21,19:48:00,18578.75,SELL,3,0.02h,Stop Loss,$43.50,$210.00,$55745.00,59,$210.00
2024-03-21,20:14:00,18576.5,BUY,3,0.02h,Stop Loss,$-9.00,$201.00,$55736.00,59,$201.00
2024-03-21,20:37:00,18575.25,SELL,3,0.02h,Break Even,$-1.50,$199.50,$55734.50,59,$199.50
2024-03-21,20:58:00,18580.25,BUY,3,0.02h,Stop Loss,$-9.00,$190.50,$55725.50,59,$190.50
2024-03-21,23:20:00,18581.75,SELL,3,0.03h,Stop Loss,$-9.00,$181.50,$55716.50,59,$181.50
2024-03-21,23:23:00,18586.5,BUY,3,0.02h,Stop Loss,$-9.00,$172.50,$55707.50,59,$172.50
,,,,,,,,,,,
2024-03-22,00:11:00,18585.75,SELL,3,0.02h,Stop Loss,$-9.00,$-9.00,$55698.50,60,$-9.00
2024-03-22,00:13:00,18591.0,BUY,3,0.02h,Stop Loss,$-9.00,$-18.00,$55689.50,60,$-18.00
2024-03-22,00:15:00,18587.5,SELL,3,0.02h,Break Even,$-1.50,$-19.50,$55688.00,60,$-19.50
2024-03-22,00:22:00,18593.5,BUY,3,0.03h,Stop Loss,$-9.00,$-28.50,$55679.00,60,$-28.50
2024-03-22,00:35:00,18588.25,SELL,3,0.02h,Stop Loss,$-9.00,$-37.50,$55670.00,60,$-37.50
2024-03-22,00:38:00,18591.25,BUY,3,0.02h,Stop Loss,$-9.00,$-46.50,$55661.00,60,$-46.50
2024-03-22,00:39:00,18589.75,SELL,3,0.02h,Break Even,$-1.50,$-48.00,$55659.50,60,$-48.00
2024-03-22,00:58:00,18587.75,BUY,3,0.02h,Stop Loss,$-9.00,$-57.00,$55650.50,60,$-57.00
2024-03-22,01:05:00,18584.0,SELL,3,0.02h,Stop Loss,$-9.00,$-66.00,$55641.50,60,$-66.00
2024-03-22,01:07:00,18588.5,BUY,3,0.03h,Break Even,$-1.50,$-67.50,$55640.00,60,$-67.50
2024-03-22,01:24:00,18587.75,SELL,3,0.02h,Break Even,$-1.50,$-69.00,$55638.50,60,$-69.00
2024-03-22,01:28:00,18589.5,BUY,3,0.02h,Stop Loss,$-9.00,$-78.00,$55629.50,60,$-78.00
2024-03-22,01:37:00,18578.0,SELL,3,0.02h,Break Even,$-1.50,$-79.50,$55628.00,60,$-79.50
2024-03-22,03:19:00,18544.0,BUY,3,0.02h,Stop Loss,$-9.00,$-88.50,$55619.00,60,$-88.50
2024-03-22,03:20:00,18540.5,SELL,3,0.02h,Stop Loss,$-9.00,$-97.50,$55610.00,60,$-97.50
2024-03-22,03:21:00,18542.25,BUY,3,0.02h,Break Even,$-1.50,$-99.00,$55608.50,60,$-99.00
2024-03-22,03:35:00,18536.5,SELL,3,0.02h,Stop Loss,$-9.00,$-108.00,$55599.50,60,$-108.00
2024-03-22,03:39:00,18544.25,BUY,3,0.02h,Break Even,$-1.50,$-109.50,$55598.00,60,$-109.50
2024-03-22,05:01:00,18574.5,SELL,3,0.02h,Stop Loss,$-9.00,$-118.50,$55589.00,60,$-118.50
2024-03-22,05:06:00,18577.75,BUY,3,0.03h,Stop Loss,$-9.00,$-127.50,$55580.00,60,$-127.50
2024-03-22,05:10:00,18574.5,SELL,3,0.02h,Stop Loss,$-9.00,$-136.50,$55571.00,60,$-136.50
2024-03-22,05:11:00,18577.75,BUY,3,0.02h,Stop Loss,$-9.00,$-145.50,$55562.00,60,$-145.50
2024-03-22,05:56:00,18580.5,SELL,3,0.02h,Break Even,$-1.50,$-147.00,$55560.50,60,$-147.00
2024-03-22,06:09:00,18582.0,BUY,3,0.02h,Stop Loss,$-9.00,$-156.00,$55551.50,60,$-156.00
2024-03-22,06:10:00,18578.75,SELL,3,0.02h,Stop Loss,$-9.00,$-165.00,$55542.50,60,$-165.00
2024-03-22,06:11:00,18582.25,BUY,3,0.02h,Stop Loss,$-9.00,$-174.00,$55533.50,60,$-174.00
2024-03-22,06:23:00,18578.75,SELL,3,0.02h,Stop Loss,$-9.00,$-183.00,$55524.50,60,$-183.00
2024-03-22,06:58:00,18571.5,BUY,3,0.02h,Stop Loss,$-9.00,$-192.00,$55515.50,60,$-192.00
2024-03-22,07:00:00,18568.25,SELL,3,0.02h,Break Even,$-1.50,$-193.50,$55514.00,60,$-193.50
2024-03-22,07:46:00,18556.5,BUY,3,0.02h,Stop Loss,$6.00,$-187.50,$55520.00,60,$-187.50
2024-03-22,09:21:00,18587.0,SELL,3,0.02h,Stop Loss,$-9.00,$-196.50,$55511.00,60,$-196.50
2024-03-22,09:56:00,18584.0,BUY,3,0.02h,Stop Loss,$18.00,$-178.50,$55529.00,60,$-178.50
2024-03-22,10:15:00,18577.25,SELL,3,0.02h,Break Even,$-1.50,$-180.00,$55527.50,60,$-180.00
2024-03-22,10:29:00,18586.5,BUY,3,0.02h,Stop Loss,$-9.00,$-189.00,$55518.50,60,$-189.00
2024-03-22,10:34:00,18583.25,SELL,3,0.02h,Break Even,$-1.50,$-190.50,$55517.00,60,$-190.50
2024-03-22,10:46:00,18587.5,BUY,3,0.02h,Stop Loss,$3.00,$-187.50,$55520.00,60,$-187.50
2024-03-22,10:56:00,18571.25,SELL,3,0.02h,Break Even,$-1.50,$-189.00,$55518.50,60,$-189.00
2024-03-22,11:15:00,18580.75,BUY,3,0.02h,Stop Loss,$-9.00,$-198.00,$55509.50,60,$-198.00
2024-03-22,11:18:00,18577.5,SELL,3,0.02h,Break Even,$-1.50,$-199.50,$55508.00,60,$-199.50
2024-03-22,12:43:00,18512.0,BUY,3,0.02h,Stop Loss,$30.00,$-169.50,$55538.00,60,$-169.50
2024-03-22,13:23:00,18525.0,SELL,3,0.02h,Stop Loss,$-9.00,$-178.50,$55529.00,60,$-178.50
2024-03-22,13:32:00,18544.0,BUY,3,0.02h,Stop Loss,$-9.00,$-187.50,$55520.00,60,$-187.50
2024-03-22,13:33:00,18528.0,SELL,3,0.02h,Stop Loss,$45.00,$-142.50,$55565.00,60,$-142.50
2024-03-22,13:55:00,18538.0,BUY,3,0.02h,Stop Loss,$10.50,$-132.00,$55575.50,60,$-132.00
2024-03-22,14:16:00,18529.25,SELL,3,0.02h,Stop Loss,$-9.00,$-141.00,$55566.50,60,$-141.00
2024-03-22,14:21:00,18544.5,BUY,3,0.02h,Stop Loss,$-9.00,$-150.00,$55557.50,60,$-150.00
2024-03-22,14:23:00,18525.75,SELL,3,0.02h,Stop Loss,$10.50,$-139.50,$55568.00,60,$-139.50
2024-03-22,15:03:00,18532.0,BUY,3,0.02h,Stop Loss,$21.00,$-118.50,$55589.00,60,$-118.50
2024-03-22,15:43:00,18543.25,SELL,3,0.02h,Stop Loss,$-9.00,$-127.50,$55580.00,60,$-127.50
2024-03-22,15:51:00,18553.5,BUY,3,0.02h,Break Even,$-1.50,$-129.00,$55578.50,60,$-129.00
2024-03-22,16:09:00,18546.0,SELL,3,0.02h,Stop Loss,$-9.00,$-138.00,$55569.50,60,$-138.00
2024-03-22,16:12:00,18555.5,BUY,3,0.02h,Stop Loss,$-9.00,$-147.00,$55560.50,60,$-147.00
2024-03-22,16:13:00,18549.75,SELL,3,0.02h,Stop Loss,$10.50,$-136.50,$55571.00,60,$-136.50
2024-03-22,16:27:00,18553.0,BUY,3,0.02h,Stop Loss,$-9.00,$-145.50,$55562.00,60,$-145.50
2024-03-22,16:35:00,18536.0,SELL,3,0.02h,Break Even,$-1.50,$-147.00,$55560.50,60,$-147.00
2024-03-22,16:44:00,18553.0,BUY,3,0.02h,Break Even,$-1.50,$-148.50,$55559.00,60,$-148.50
2024-03-22,17:42:00,18591.5,SELL,3,0.02h,Stop Loss,$-9.00,$-157.50,$55550.00,60,$-157.50
2024-03-22,17:45:00,18602.75,BUY,3,0.02h,Break Even,$-1.50,$-159.00,$55548.50,60,$-159.00
2024-03-22,18:12:00,18612.0,SELL,3,0.02h,Stop Loss,$-9.00,$-168.00,$55539.50,60,$-168.00
2024-03-22,18:30:00,18609.5,BUY,3,0.02h,Break Even,$-1.50,$-169.50,$55538.00,60,$-169.50
2024-03-22,18:34:00,18599.0,SELL,3,0.02h,Stop Loss,$-9.00,$-178.50,$55529.00,60,$-178.50
2024-03-22,18:35:00,18606.75,BUY,3,0.02h,Break Even,$-1.50,$-180.00,$55527.50,60,$-180.00
2024-03-22,18:42:00,18597.75,SELL,3,0.02h,Stop Loss,$-9.00,$-189.00,$55518.50,60,$-189.00
2024-03-22,19:37:00,18580.5,BUY,3,0.02h,Break Even,$-1.50,$-190.50,$55517.00,60,$-190.50
2024-03-22,20:01:00,18569.25,SELL,3,0.02h,Stop Loss,$9.00,$-181.50,$55526.00,60,$-181.50
2024-03-22,20:48:00,18562.75,BUY,3,0.03h,Break Even,$-1.50,$-183.00,$55524.50,60,$-183.00
,,,,,,,,,,,
2024-03-25,00:38:00,18586.25,SELL,3,0.02h,Break Even,$-1.50,$-1.50,$55523.00,61,$-1.50
2024-03-25,01:18:00,18588.75,BUY,3,0.02h,Stop Loss,$-9.00,$-10.50,$55514.00,61,$-10.50
2024-03-25,01:51:00,18588.25,SELL,3,0.02h,Stop Loss,$-9.00,$-19.50,$55505.00,61,$-19.50
2024-03-25,02:54:00,18574.0,BUY,3,0.02h,Break Even,$-1.50,$-21.00,$55503.50,61,$-21.00
2024-03-25,03:04:00,18569.25,SELL,3,0.02h,Stop Loss,$-9.00,$-30.00,$55494.50,61,$-30.00
2024-03-25,03:09:00,18575.75,BUY,3,0.02h,Stop Loss,$-9.00,$-39.00,$55485.50,61,$-39.00
2024-03-25,03:11:00,18569.25,SELL,3,0.02h,Break Even,$-1.50,$-40.50,$55484.00,61,$-40.50
2024-03-25,03:16:00,18575.25,BUY,3,0.02h,Break Even,$-1.50,$-42.00,$55482.50,61,$-42.00
2024-03-25,03:26:00,18572.25,SELL,3,0.02h,Break Even,$-1.50,$-43.50,$55481.00,61,$-43.50
2024-03-25,03:42:00,18572.75,BUY,3,0.02h,Stop Loss,$-9.00,$-52.50,$55472.00,61,$-52.50
2024-03-25,03:43:00,18571.0,SELL,3,0.02h,Break Even,$-1.50,$-54.00,$55470.50,61,$-54.00
2024-03-25,03:49:00,18574.0,BUY,3,0.02h,Break Even,$-1.50,$-55.50,$55469.00,61,$-55.50
2024-03-25,04:07:00,18571.25,SELL,3,0.03h,Break Even,$-1.50,$-57.00,$55467.50,61,$-57.00
2024-03-25,04:30:00,18573.25,BUY,3,0.02h,Stop Loss,$-9.00,$-66.00,$55458.50,61,$-66.00
2024-03-25,04:48:00,18569.75,SELL,3,0.13h,Break Even,$-1.50,$-67.50,$55457.00,61,$-67.50
2024-03-25,06:39:00,18539.75,BUY,3,0.02h,Stop Loss,$-9.00,$-76.50,$55448.00,61,$-76.50
2024-03-25,06:40:00,18538.5,SELL,3,0.02h,Break Even,$-1.50,$-78.00,$55446.50,61,$-78.00
2024-03-25,06:45:00,18543.5,BUY,3,0.03h,Break Even,$-1.50,$-79.50,$55445.00,61,$-79.50
2024-03-25,07:05:00,18540.5,SELL,3,0.02h,Stop Loss,$12.00,$-67.50,$55457.00,61,$-67.50
2024-03-25,07:13:00,18547.25,BUY,3,0.02h,Break Even,$-1.50,$-69.00,$55455.50,61,$-69.00
2024-03-25,07:32:00,18542.75,SELL,3,0.02h,Break Even,$-1.50,$-70.50,$55454.00,61,$-70.50
2024-03-25,07:39:00,18545.0,BUY,3,0.02h,Stop Loss,$-9.00,$-79.50,$55445.00,61,$-79.50
2024-03-25,07:40:00,18542.0,SELL,3,0.02h,Stop Loss,$-9.00,$-88.50,$55436.00,61,$-88.50
2024-03-25,07:44:00,18546.75,BUY,3,0.03h,Break Even,$-1.50,$-90.00,$55434.50,61,$-90.00
2024-03-25,07:51:00,18542.0,SELL,3,0.02h,Stop Loss,$-9.00,$-99.00,$55425.50,61,$-99.00
2024-03-25,07:56:00,18548.0,BUY,3,0.02h,Stop Loss,$-9.00,$-108.00,$55416.50,61,$-108.00
2024-03-25,07:59:00,18542.5,SELL,3,0.02h,Break Even,$-1.50,$-109.50,$55415.00,61,$-109.50
2024-03-25,08:02:00,18554.25,BUY,3,0.02h,Break Even,$-1.50,$-111.00,$55413.50,61,$-111.00
2024-03-25,08:22:00,18544.75,SELL,3,0.02h,Stop Loss,$7.50,$-103.50,$55421.00,61,$-103.50
2024-03-25,08:32:00,18553.25,BUY,3,0.02h,Stop Loss,$-9.00,$-112.50,$55412.00,61,$-112.50
2024-03-25,08:54:00,18547.5,SELL,3,0.02h,Stop Loss,$-9.00,$-121.50,$55403.00,61,$-121.50
2024-03-25,11:39:00,18473.0,BUY,3,0.02h,Stop Loss,$-9.00,$-130.50,$55394.00,61,$-130.50
2024-03-25,11:42:00,18468.0,SELL,3,0.02h,Break Even,$-1.50,$-132.00,$55392.50,61,$-132.00
2024-03-25,11:46:00,18473.25,BUY,3,0.02h,Stop Loss,$-9.00,$-141.00,$55383.50,61,$-141.00
2024-03-25,11:51:00,18462.0,SELL,3,0.02h,Stop Loss,$-9.00,$-150.00,$55374.50,61,$-150.00
2024-03-25,12:03:00,18474.5,BUY,3,0.02h,Break Even,$-1.50,$-151.50,$55373.00,61,$-151.50
2024-03-25,12:11:00,18464.25,SELL,3,0.02h,Break Even,$-1.50,$-153.00,$55371.50,61,$-153.00
2024-03-25,12:18:00,18478.25,BUY,3,0.02h,Break Even,$-1.50,$-154.50,$55370.00,61,$-154.50
2024-03-25,12:39:00,18470.5,SELL,3,0.02h,Break Even,$-1.50,$-156.00,$55368.50,61,$-156.00
2024-03-25,12:46:00,18482.0,BUY,3,0.02h,Break Even,$-1.50,$-157.50,$55367.00,61,$-157.50
2024-03-25,12:56:00,18475.75,SELL,3,0.02h,Break Even,$-1.50,$-159.00,$55365.50,61,$-159.00
2024-03-25,13:18:00,18477.75,BUY,3,0.02h,Break Even,$-1.50,$-160.50,$55364.00,61,$-160.50
2024-03-25,13:23:00,18468.25,SELL,3,0.02h,Stop Loss,$-9.00,$-169.50,$55355.00,61,$-169.50
2024-03-25,13:52:00,18480.25,BUY,3,0.02h,Stop Loss,$6.00,$-163.50,$55361.00,61,$-163.50
2024-03-25,14:47:00,18511.25,SELL,3,0.02h,Stop Loss,$24.00,$-139.50,$55385.00,61,$-139.50
2024-03-25,14:59:00,18519.75,BUY,3,0.02h,Break Even,$-1.50,$-141.00,$55383.50,61,$-141.00
2024-03-25,15:26:00,18520.0,SELL,3,0.02h,Stop Loss,$12.00,$-129.00,$55395.50,61,$-129.00
2024-03-25,15:38:00,18531.0,BUY,3,0.02h,Stop Loss,$10.50,$-118.50,$55406.00,61,$-118.50
2024-03-25,16:03:00,18530.75,SELL,3,0.02h,Stop Loss,$27.00,$-91.50,$55433.00,61,$-91.50
2024-03-25,16:22:00,18533.5,BUY,3,0.02h,Stop Loss,$-9.00,$-100.50,$55424.00,61,$-100.50
2024-03-25,16:23:00,18527.25,SELL,3,0.02h,Break Even,$-1.50,$-102.00,$55422.50,61,$-102.00
2024-03-25,16:47:00,18528.25,BUY,3,0.02h,Break Even,$-1.50,$-103.50,$55421.00,61,$-103.50
2024-03-25,16:51:00,18519.5,SELL,3,0.02h,Break Even,$-1.50,$-105.00,$55419.50,61,$-105.00
2024-03-25,16:52:00,18526.0,BUY,3,0.02h,Stop Loss,$12.00,$-93.00,$55431.50,61,$-93.00
2024-03-25,17:09:00,18524.75,SELL,3,0.02h,Stop Loss,$-9.00,$-102.00,$55422.50,61,$-102.00
2024-03-25,17:15:00,18534.0,BUY,3,0.02h,Break Even,$-1.50,$-103.50,$55421.00,61,$-103.50
2024-03-25,18:30:00,18558.75,SELL,3,0.02h,Break Even,$-1.50,$-105.00,$55419.50,61,$-105.00
2024-03-25,18:41:00,18560.25,BUY,3,0.02h,Break Even,$-1.50,$-106.50,$55418.00,61,$-106.50
2024-03-25,19:04:00,18558.0,SELL,3,0.02h,Stop Loss,$3.00,$-103.50,$55421.00,61,$-103.50
2024-03-25,19:41:00,18544.25,BUY,3,0.02h,Stop Loss,$15.00,$-88.50,$55436.00,61,$-88.50
2024-03-25,19:52:00,18531.25,SELL,3,0.02h,Stop Loss,$18.00,$-70.50,$55454.00,61,$-70.50
2024-03-25,20:25:00,18520.25,BUY,3,0.05h,Stop Loss,$-9.00,$-79.50,$55445.00,61,$-79.50
2024-03-25,23:21:00,18528.75,SELL,3,0.02h,Break Even,$-1.50,$-81.00,$55443.50,61,$-81.00
2024-03-25,23:29:00,18533.5,BUY,3,0.03h,Break Even,$-1.50,$-82.50,$55442.00,61,$-82.50
,,,,,,,,,,,
2024-03-26,01:26:00,18547.0,SELL,3,0.02h,Break Even,$-1.50,$-1.50,$55440.50,62,$-1.50
2024-03-26,02:31:00,18544.0,BUY,3,0.02h,Stop Loss,$-9.00,$-10.50,$55431.50,62,$-10.50
2024-03-26,02:49:00,18541.5,SELL,3,0.02h,Stop Loss,$-9.00,$-19.50,$55422.50,62,$-19.50
2024-03-26,03:29:00,18537.0,BUY,3,0.03h,Break Even,$-1.50,$-21.00,$55421.00,62,$-21.00
2024-03-26,03:34:00,18534.5,SELL,3,0.03h,Break Even,$-1.50,$-22.50,$55419.50,62,$-22.50
2024-03-26,04:07:00,18527.25,BUY,3,0.02h,Stop Loss,$-9.00,$-31.50,$55410.50,62,$-31.50
2024-03-26,05:01:00,18535.0,SELL,3,0.02h,Break Even,$-1.50,$-33.00,$55409.00,62,$-33.00
2024-03-26,05:07:00,18540.0,BUY,3,0.02h,Stop Loss,$4.50,$-28.50,$55413.50,62,$-28.50
2024-03-26,06:03:00,18542.75,SELL,3,0.03h,Break Even,$-1.50,$-30.00,$55412.00,62,$-30.00
2024-03-26,06:23:00,18544.75,BUY,3,0.02h,Stop Loss,$-9.00,$-39.00,$55403.00,62,$-39.00
2024-03-26,06:24:00,18543.25,SELL,3,0.02h,Stop Loss,$-9.00,$-48.00,$55394.00,62,$-48.00
2024-03-26,06:30:00,18545.75,BUY,3,0.02h,Stop Loss,$7.50,$-40.50,$55401.50,62,$-40.50
2024-03-26,07:40:00,18593.0,SELL,3,0.02h,Stop Loss,$-9.00,$-49.50,$55392.50,62,$-49.50
2024-03-26,08:15:00,18579.0,BUY,3,0.02h,Stop Loss,$3.00,$-46.50,$55395.50,62,$-46.50
2024-03-26,09:43:00,18599.75,SELL,3,0.02h,Stop Loss,$3.00,$-43.50,$55398.50,62,$-43.50
2024-03-26,10:01:00,18604.25,BUY,3,0.02h,Break Even,$-1.50,$-45.00,$55397.00,62,$-45.00
2024-03-26,10:27:00,18605.5,SELL,3,0.02h,Stop Loss,$18.00,$-27.00,$55415.00,62,$-27.00
2024-03-26,10:48:00,18604.25,BUY,3,0.07h,Break Even,$-1.50,$-28.50,$55413.50,62,$-28.50
2024-03-26,11:16:00,18604.0,SELL,3,0.02h,Stop Loss,$-9.00,$-37.50,$55404.50,62,$-37.50
2024-03-26,11:39:00,18607.25,BUY,3,0.02h,Stop Loss,$-9.00,$-46.50,$55395.50,62,$-46.50
2024-03-26,12:09:00,18602.75,SELL,3,0.02h,Stop Loss,$-9.00,$-55.50,$55386.50,62,$-55.50
2024-03-26,13:29:00,18569.25,BUY,3,0.02h,Break Even,$-1.50,$-57.00,$55385.00,62,$-57.00
2024-03-26,14:25:00,18587.75,SELL,3,0.02h,Stop Loss,$36.00,$-21.00,$55421.00,62,$-21.00
2024-03-26,14:59:00,18558.5,BUY,3,0.02h,Stop Loss,$18.00,$-3.00,$55439.00,62,$-3.00
2024-03-26,15:41:00,18560.5,SELL,3,0.02h,Stop Loss,$-9.00,$-12.00,$55430.00,62,$-12.00
2024-03-26,15:53:00,18576.5,BUY,3,0.02h,Stop Loss,$-9.00,$-21.00,$55421.00,62,$-21.00
2024-03-26,16:14:00,18572.5,SELL,3,0.02h,Break Even,$-1.50,$-22.50,$55419.50,62,$-22.50
2024-03-26,17:09:00,18549.75,BUY,3,0.02h,Break Even,$-1.50,$-24.00,$55418.00,62,$-24.00
2024-03-26,17:21:00,18545.25,SELL,3,0.02h,Break Even,$-1.50,$-25.50,$55416.50,62,$-25.50
2024-03-26,17:31:00,18552.25,BUY,3,0.02h,Break Even,$-1.50,$-27.00,$55415.00,62,$-27.00
2024-03-26,17:45:00,18541.25,SELL,3,0.02h,Stop Loss,$40.50,$13.50,$55455.50,62,$13.50
2024-03-26,18:03:00,18548.0,BUY,3,0.02h,Stop Loss,$-9.00,$4.50,$55446.50,62,$4.50
2024-03-26,18:42:00,18548.25,SELL,3,0.02h,Stop Loss,$13.50,$18.00,$55460.00,62,$18.00
2024-03-26,18:57:00,18556.25,BUY,3,0.02h,Break Even,$-1.50,$16.50,$55458.50,62,$16.50
2024-03-26,19:04:00,18546.25,SELL,3,0.02h,Break Even,$-1.50,$15.00,$55457.00,62,$15.00
2024-03-26,20:14:00,18470.5,BUY,3,0.02h,Break Even,$-1.50,$13.50,$55455.50,62,$13.50
2024-03-26,20:53:00,18477.25,SELL,3,0.02h,Break Even,$-1.50,$12.00,$55454.00,62,$12.00
2024-03-26,20:57:00,18481.75,BUY,3,0.02h,Stop Loss,$-9.00,$3.00,$55445.00,62,$3.00
2024-03-26,23:00:00,18476.5,SELL,3,0.02h,Break Even,$-1.50,$1.50,$55443.50,62,$1.50
2024-03-26,23:15:00,18479.5,BUY,3,0.02h,Stop Loss,$-9.00,$-7.50,$55434.50,62,$-7.50
,,,,,,,,,,,
2024-03-27,00:09:00,18486.75,SELL,3,0.02h,Stop Loss,$-9.00,$-9.00,$55425.50,63,$-9.00
2024-03-27,00:24:00,18489.0,BUY,3,0.02h,Stop Loss,$-9.00,$-18.00,$55416.50,63,$-18.00
2024-03-27,00:35:00,18487.25,SELL,3,0.02h,Stop Loss,$-9.00,$-27.00,$55407.50,63,$-27.00
2024-03-27,00:49:00,18492.75,BUY,3,0.02h,Break Even,$-1.50,$-28.50,$55406.00,63,$-28.50
2024-03-27,01:10:00,18490.25,SELL,3,0.02h,Stop Loss,$-9.00,$-37.50,$55397.00,63,$-37.50
2024-03-27,01:11:00,18491.75,BUY,3,0.02h,Stop Loss,$-9.00,$-46.50,$55388.00,63,$-46.50
2024-03-27,01:20:00,18488.5,SELL,3,0.07h,Stop Loss,$7.50,$-39.00,$55395.50,63,$-39.00
2024-03-27,01:30:00,18491.0,BUY,3,0.02h,Stop Loss,$-9.00,$-48.00,$55386.50,63,$-48.00
2024-03-27,01:33:00,18489.0,SELL,3,0.02h,Stop Loss,$-9.00,$-57.00,$55377.50,63,$-57.00
2024-03-27,01:55:00,18489.5,BUY,3,0.02h,Break Even,$-1.50,$-58.50,$55376.00,63,$-58.50
2024-03-27,02:11:00,18488.25,SELL,3,0.02h,Stop Loss,$-9.00,$-67.50,$55367.00,63,$-67.50
2024-03-27,02:13:00,18491.0,BUY,3,0.03h,Stop Loss,$-9.00,$-76.50,$55358.00,63,$-76.50
2024-03-27,02:44:00,18492.0,SELL,3,0.02h,Stop Loss,$-9.00,$-85.50,$55349.00,63,$-85.50
2024-03-27,03:02:00,18494.5,BUY,3,0.02h,Stop Loss,$-9.00,$-94.50,$55340.00,63,$-94.50
2024-03-27,03:49:00,18497.0,SELL,3,0.02h,Break Even,$-1.50,$-96.00,$55338.50,63,$-96.00
2024-03-27,04:05:00,18498.25,BUY,3,0.03h,Stop Loss,$-9.00,$-105.00,$55329.50,63,$-105.00
2024-03-27,05:24:00,18513.25,SELL,3,0.02h,Stop Loss,$-9.00,$-114.00,$55320.50,63,$-114.00
2024-03-27,05:42:00,18516.75,BUY,3,0.02h,Stop Loss,$9.00,$-105.00,$55329.50,63,$-105.00
2024-03-27,05:56:00,18512.5,SELL,3,0.03h,Stop Loss,$-9.00,$-114.00,$55320.50,63,$-114.00
2024-03-27,06:40:00,18507.75,BUY,3,0.02h,Stop Loss,$-9.00,$-123.00,$55311.50,63,$-123.00
2024-03-27,06:44:00,18503.75,SELL,3,0.02h,Break Even,$-1.50,$-124.50,$55310.00,63,$-124.50
2024-03-27,06:48:00,18507.5,BUY,3,0.02h,Break Even,$-1.50,$-126.00,$55308.50,63,$-126.00
2024-03-27,06:59:00,18503.0,SELL,3,0.02h,Stop Loss,$15.00,$-111.00,$55323.50,63,$-111.00
2024-03-27,08:02:00,18487.0,BUY,3,0.02h,Break Even,$-1.50,$-112.50,$55322.00,63,$-112.50
2024-03-27,09:21:00,18513.25,SELL,3,0.02h,Stop Loss,$-9.00,$-121.50,$55313.00,63,$-121.50
2024-03-27,09:45:00,18517.25,BUY,3,0.02h,Stop Loss,$7.50,$-114.00,$55320.50,63,$-114.00
2024-03-27,10:09:00,18512.5,SELL,3,0.02h,Break Even,$-1.50,$-115.50,$55319.00,63,$-115.50
2024-03-27,10:18:00,18520.0,BUY,3,0.02h,Break Even,$-1.50,$-117.00,$55317.50,63,$-117.00
2024-03-27,11:04:00,18530.5,SELL,3,0.02h,Break Even,$-1.50,$-118.50,$55316.00,63,$-118.50
2024-03-27,11:30:00,18530.75,BUY,3,0.02h,Stop Loss,$3.00,$-115.50,$55319.00,63,$-115.50
2024-03-27,11:39:00,18527.0,SELL,3,0.02h,Break Even,$-1.50,$-117.00,$55317.50,63,$-117.00
2024-03-27,12:14:00,18526.25,BUY,3,0.02h,Stop Loss,$-9.00,$-126.00,$55308.50,63,$-126.00
2024-03-27,12:17:00,18521.75,SELL,3,0.02h,Stop Loss,$6.00,$-120.00,$55314.50,63,$-120.00
2024-03-27,12:35:00,18524.5,BUY,3,0.02h,Break Even,$-1.50,$-121.50,$55313.00,63,$-121.50
2024-03-27,13:33:00,18536.25,SELL,3,0.02h,Stop Loss,$75.00,$-46.50,$55388.00,63,$-46.50
2024-03-27,14:35:00,18432.25,BUY,3,0.02h,Stop Loss,$-9.00,$-55.50,$55379.00,63,$-55.50
2024-03-27,14:49:00,18422.0,SELL,3,0.02h,Stop Loss,$88.50,$33.00,$55467.50,63,$33.00
2024-03-27,15:18:00,18428.0,BUY,3,0.02h,Break Even,$-1.50,$31.50,$55466.00,63,$31.50
2024-03-27,15:25:00,18411.5,SELL,3,0.02h,Stop Loss,$3.00,$34.50,$55469.00,63,$34.50
2024-03-27,15:42:00,18421.0,BUY,3,0.02h,Stop Loss,$4.50,$39.00,$55473.50,63,$39.00
2024-03-27,15:54:00,18410.0,SELL,3,0.02h,Stop Loss,$3.00,$42.00,$55476.50,63,$42.00
2024-03-27,16:07:00,18418.75,BUY,3,0.02h,Break Even,$-1.50,$40.50,$55475.00,63,$40.50
2024-03-27,16:13:00,18404.75,SELL,3,0.02h,Stop Loss,$-9.00,$31.50,$55466.00,63,$31.50
2024-03-27,16:18:00,18417.0,BUY,3,0.02h,Stop Loss,$18.00,$49.50,$55484.00,63,$49.50
2024-03-27,17:05:00,18433.25,SELL,3,0.02h,Stop Loss,$16.50,$66.00,$55500.50,63,$66.00
2024-03-27,17:22:00,18432.0,BUY,3,0.02h,Stop Loss,$22.50,$88.50,$55523.00,63,$88.50
2024-03-27,17:29:00,18422.5,SELL,3,0.02h,Stop Loss,$-9.00,$79.50,$55514.00,63,$79.50
2024-03-27,17:32:00,18433.25,BUY,3,0.02h,Break Even,$-1.50,$78.00,$55512.50,63,$78.00
2024-03-27,17:36:00,18423.75,SELL,3,0.02h,Stop Loss,$-9.00,$69.00,$55503.50,63,$69.00
2024-03-27,17:38:00,18430.75,BUY,3,0.02h,Break Even,$-1.50,$67.50,$55502.00,63,$67.50
2024-03-27,17:40:00,18424.75,SELL,3,0.02h,Break Even,$-1.50,$66.00,$55500.50,63,$66.00
2024-03-27,17:46:00,18431.25,BUY,3,0.02h,Break Even,$-1.50,$64.50,$55499.00,63,$64.50
2024-03-27,18:01:00,18428.0,SELL,3,0.02h,Stop Loss,$-9.00,$55.50,$55490.00,63,$55.50
2024-03-27,18:02:00,18434.25,BUY,3,0.02h,Stop Loss,$-9.00,$46.50,$55481.00,63,$46.50
2024-03-27,18:03:00,18427.25,SELL,3,0.02h,Break Even,$-1.50,$45.00,$55479.50,63,$45.00
2024-03-27,18:17:00,18435.5,BUY,3,0.02h,Stop Loss,$36.00,$81.00,$55515.50,63,$81.00
2024-03-27,18:38:00,18434.75,SELL,3,0.02h,Break Even,$-1.50,$79.50,$55514.00,63,$79.50
2024-03-27,19:08:00,18431.5,BUY,3,0.02h,Break Even,$-1.50,$78.00,$55512.50,63,$78.00
2024-03-27,19:10:00,18420.75,SELL,3,0.02h,Stop Loss,$72.00,$150.00,$55584.50,63,$150.00
2024-03-27,19:28:00,18424.75,BUY,3,0.02h,Stop Loss,$96.00,$246.00,$55680.50,63,$246.00
2024-03-27,20:37:00,18513.0,SELL,3,0.07h,Break Even,$-1.50,$244.50,$55679.00,63,$244.50
2024-03-27,23:27:00,18492.25,BUY,3,0.03h,Stop Loss,$-9.00,$235.50,$55670.00,63,$235.50
2024-03-27,23:33:00,18486.25,SELL,3,0.02h,Stop Loss,$-9.00,$226.50,$55661.00,63,$226.50
,,,,,,,,,,,
2024-03-28,00:06:00,18487.5,BUY,3,0.02h,Break Even,$-1.50,$-1.50,$55659.50,64,$-1.50
2024-03-28,00:47:00,18497.25,SELL,3,0.05h,Break Even,$-1.50,$-3.00,$55658.00,64,$-3.00
2024-03-28,00:56:00,18499.75,BUY,3,0.02h,Stop Loss,$-9.00,$-12.00,$55649.00,64,$-12.00
2024-03-28,01:07:00,18495.5,SELL,3,0.02h,Break Even,$-1.50,$-13.50,$55647.50,64,$-13.50
2024-03-28,01:24:00,18498.0,BUY,3,0.02h,Stop Loss,$-9.00,$-22.50,$55638.50,64,$-22.50
2024-03-28,01:29:00,18493.5,SELL,3,0.02h,Stop Loss,$4.50,$-18.00,$55643.00,64,$-18.00
2024-03-28,02:14:00,18490.5,BUY,3,0.02h,Break Even,$-1.50,$-19.50,$55641.50,64,$-19.50
2024-03-28,02:35:00,18487.75,SELL,3,0.02h,Break Even,$-1.50,$-21.00,$55640.00,64,$-21.00
2024-03-28,02:49:00,18490.25,BUY,3,0.03h,Stop Loss,$-9.00,$-30.00,$55631.00,64,$-30.00
2024-03-28,02:54:00,18488.5,SELL,3,0.03h,Stop Loss,$-9.00,$-39.00,$55622.00,64,$-39.00
2024-03-28,03:02:00,18492.25,BUY,3,0.02h,Stop Loss,$-9.00,$-48.00,$55613.00,64,$-48.00
2024-03-28,03:48:00,18492.5,SELL,3,0.03h,Break Even,$-1.50,$-49.50,$55611.50,64,$-49.50
2024-03-28,04:08:00,18495.5,BUY,3,0.12h,Stop Loss,$-9.00,$-58.50,$55602.50,64,$-58.50
2024-03-28,05:15:00,18500.75,SELL,3,0.02h,Stop Loss,$-9.00,$-67.50,$55593.50,64,$-67.50
2024-03-28,05:38:00,18500.25,BUY,3,0.02h,Break Even,$-1.50,$-69.00,$55592.00,64,$-69.00
2024-03-28,06:05:00,18500.75,SELL,3,0.02h,Stop Loss,$-9.00,$-78.00,$55583.00,64,$-78.00
2024-03-28,06:07:00,18503.25,BUY,3,0.02h,Stop Loss,$-9.00,$-87.00,$55574.00,64,$-87.00
2024-03-28,06:08:00,18501.0,SELL,3,0.02h,Round Number,$3.00,$-84.00,$55577.00,64,$-84.00
2024-03-28,06:53:00,18495.25,BUY,3,0.02h,Stop Loss,$-9.00,$-93.00,$55568.00,64,$-93.00
2024-03-28,07:03:00,18491.0,SELL,3,0.02h,Break Even,$-1.50,$-94.50,$55566.50,64,$-94.50
2024-03-28,07:30:00,18490.0,BUY,3,0.03h,Break Even,$-1.50,$-96.00,$55565.00,64,$-96.00
2024-03-28,08:06:00,18491.5,SELL,3,0.02h,Stop Loss,$-9.00,$-105.00,$55556.00,64,$-105.00
2024-03-28,08:32:00,18497.5,BUY,3,0.02h,Break Even,$-1.50,$-106.50,$55554.50,64,$-106.50
2024-03-28,08:34:00,18488.25,SELL,3,0.02h,Stop Loss,$-9.00,$-115.50,$55545.50,64,$-115.50
2024-03-28,08:39:00,18495.5,BUY,3,0.02h,Break Even,$-1.50,$-117.00,$55544.00,64,$-117.00
2024-03-28,08:48:00,18490.5,SELL,3,0.02h,Stop Loss,$-9.00,$-126.00,$55535.00,64,$-126.00
2024-03-28,09:12:00,18491.25,BUY,3,0.02h,Stop Loss,$-9.00,$-135.00,$55526.00,64,$-135.00
2024-03-28,09:16:00,18483.0,SELL,3,0.02h,Stop Loss,$10.50,$-124.50,$55536.50,64,$-124.50
2024-03-28,09:52:00,18470.25,BUY,3,0.02h,Break Even,$-1.50,$-126.00,$55535.00,64,$-126.00
2024-03-28,10:44:00,18494.25,SELL,3,0.02h,Break Even,$-1.50,$-127.50,$55533.50,64,$-127.50
2024-03-28,10:51:00,18500.5,BUY,3,0.02h,Stop Loss,$-9.00,$-136.50,$55524.50,64,$-136.50
2024-03-28,11:00:00,18488.5,SELL,3,0.02h,Stop Loss,$-9.00,$-145.50,$55515.50,64,$-145.50
2024-03-28,11:05:00,18498.5,BUY,3,0.02h,Break Even,$-1.50,$-147.00,$55514.00,64,$-147.00
2024-03-28,11:15:00,18493.25,SELL,3,0.02h,Stop Loss,$-9.00,$-156.00,$55505.00,64,$-156.00
2024-03-28,11:25:00,18498.5,BUY,3,0.02h,Stop Loss,$-9.00,$-165.00,$55496.00,64,$-165.00
2024-03-28,11:31:00,18491.25,SELL,3,0.02h,Stop Loss,$45.00,$-120.00,$55541.00,64,$-120.00
2024-03-28,11:55:00,18487.75,BUY,3,0.02h,Break Even,$-1.50,$-121.50,$55539.50,64,$-121.50
2024-03-28,12:37:00,18485.0,SELL,3,0.02h,Stop Loss,$-9.00,$-130.50,$55530.50,64,$-130.50
2024-03-28,12:58:00,18499.25,BUY,3,0.02h,Break Even,$-1.50,$-132.00,$55529.00,64,$-132.00
2024-03-28,13:30:00,18500.0,SELL,3,0.02h,Stop Loss,$96.00,$-36.00,$55625.00,64,$-36.00
2024-03-28,13:42:00,18501.75,BUY,3,0.02h,Stop Loss,$22.50,$-13.50,$55647.50,64,$-13.50
2024-03-28,14:09:00,18505.0,SELL,3,0.02h,Stop Loss,$18.00,$4.50,$55665.50,64,$4.50
2024-03-28,14:36:00,18506.25,BUY,3,0.02h,Stop Loss,$31.50,$36.00,$55697.00,64,$36.00
2024-03-28,15:04:00,18498.75,SELL,3,0.02h,Stop Loss,$-9.00,$27.00,$55688.00,64,$27.00
2024-03-28,15:06:00,18514.0,BUY,3,0.02h,Break Even,$-1.50,$25.50,$55686.50,64,$25.50
2024-03-28,15:08:00,18494.25,SELL,3,0.02h,Stop Loss,$3.00,$28.50,$55689.50,64,$28.50
2024-03-28,15:19:00,18503.25,BUY,3,0.02h,Stop Loss,$16.50,$45.00,$55706.00,64,$45.00
2024-03-28,15:37:00,18500.25,SELL,3,0.02h,Stop Loss,$-9.00,$36.00,$55697.00,64,$36.00
2024-03-28,15:51:00,18508.0,BUY,3,0.02h,Stop Loss,$3.00,$39.00,$55700.00,64,$39.00
2024-03-28,16:06:00,18496.75,SELL,3,0.02h,Stop Loss,$79.50,$118.50,$55779.50,64,$118.50
2024-03-28,17:39:00,18470.75,BUY,3,0.02h,Stop Loss,$3.00,$121.50,$55782.50,64,$121.50
2024-03-28,18:01:00,18467.0,SELL,3,0.02h,Stop Loss,$94.50,$216.00,$55877.00,64,$216.00
2024-03-28,18:09:00,18474.0,BUY,3,0.02h,Stop Loss,$-9.00,$207.00,$55868.00,64,$207.00
2024-03-28,18:24:00,18467.5,SELL,3,0.02h,Break Even,$-1.50,$205.50,$55866.50,64,$205.50
2024-03-28,18:29:00,18472.75,BUY,3,0.02h,Break Even,$-1.50,$204.00,$55865.00,64,$204.00
2024-03-28,18:38:00,18468.0,SELL,3,0.02h,Break Even,$-1.50,$202.50,$55863.50,64,$202.50
2024-03-28,18:51:00,18471.25,BUY,3,0.02h,Break Even,$-1.50,$201.00,$55862.00,64,$201.00
2024-03-28,19:37:00,18494.5,SELL,3,0.02h,Stop Loss,$15.00,$216.00,$55877.00,64,$216.00
2024-03-28,20:58:00,18461.25,BUY,3,0.02h,Break Even,$-1.50,$214.50,$55875.50,64,$214.50
,,,,,,,,,,,
2024-04-01,00:59:00,18594.0,SELL,3,0.02h,Stop Loss,$-9.00,$-9.00,$55866.50,65,$-9.00
2024-04-01,03:30:00,18571.25,BUY,3,0.02h,Stop Loss,$7.50,$-1.50,$55874.00,65,$-1.50
2024-04-01,04:21:00,18581.5,SELL,3,0.07h,Stop Loss,$-9.00,$-10.50,$55865.00,65,$-10.50
2024-04-01,04:30:00,18585.75,BUY,3,0.07h,Break Even,$-1.50,$-12.00,$55863.50,65,$-12.00
2024-04-01,05:05:00,18585.0,SELL,3,0.02h,Stop Loss,$-9.00,$-21.00,$55854.50,65,$-21.00
2024-04-01,05:12:00,18590.0,BUY,3,0.02h,Break Even,$-1.50,$-22.50,$55853.00,65,$-22.50
2024-04-01,05:15:00,18585.25,SELL,3,0.02h,Break Even,$-1.50,$-24.00,$55851.50,65,$-24.00
2024-04-01,06:09:00,18580.5,BUY,3,0.02h,Break Even,$-1.50,$-25.50,$55850.00,65,$-25.50
2024-04-01,06:20:00,18575.5,SELL,3,0.02h,Break Even,$-1.50,$-27.00,$55848.50,65,$-27.00
2024-04-01,06:30:00,18577.5,BUY,3,0.02h,Break Even,$-1.50,$-28.50,$55847.00,65,$-28.50
2024-04-01,06:38:00,18576.75,SELL,3,0.02h,Break Even,$-1.50,$-30.00,$55845.50,65,$-30.00
2024-04-01,07:03:00,18575.0,BUY,3,0.02h,Stop Loss,$-9.00,$-39.00,$55836.50,65,$-39.00
2024-04-01,07:56:00,18594.0,SELL,3,0.02h,Stop Loss,$-9.00,$-48.00,$55827.50,65,$-48.00
2024-04-01,07:59:00,18596.5,BUY,3,0.02h,Break Even,$-1.50,$-49.50,$55826.00,65,$-49.50
2024-04-01,08:02:00,18590.5,SELL,3,0.02h,Stop Loss,$-9.00,$-58.50,$55817.00,65,$-58.50
2024-04-01,08:29:00,18576.0,BUY,3,0.02h,Stop Loss,$-9.00,$-67.50,$55808.00,65,$-67.50
2024-04-01,08:49:00,18574.0,SELL,3,0.02h,Stop Loss,$-9.00,$-76.50,$55799.00,65,$-76.50
2024-04-01,08:55:00,18578.25,BUY,3,0.02h,Break Even,$-1.50,$-78.00,$55797.50,65,$-78.00
2024-04-01,09:08:00,18575.0,SELL,3,0.02h,Break Even,$-1.50,$-79.50,$55796.00,65,$-79.50
2024-04-01,09:52:00,18567.75,BUY,3,0.02h,Break Even,$-1.50,$-81.00,$55794.50,65,$-81.00
2024-04-01,10:42:00,18574.75,SELL,3,0.02h,Break Even,$-1.50,$-82.50,$55793.00,65,$-82.50
2024-04-01,10:56:00,18578.5,BUY,3,0.02h,Stop Loss,$-9.00,$-91.50,$55784.00,65,$-91.50
2024-04-01,11:02:00,18569.75,SELL,3,0.02h,Stop Loss,$12.00,$-79.50,$55796.00,65,$-79.50
2024-04-01,11:51:00,18543.5,BUY,3,0.02h,Stop Loss,$-9.00,$-88.50,$55787.00,65,$-88.50
2024-04-01,11:54:00,18538.5,SELL,3,0.02h,Break Even,$-1.50,$-90.00,$55785.50,65,$-90.00
2024-04-01,11:56:00,18542.5,BUY,3,0.02h,Stop Loss,$-9.00,$-99.00,$55776.50,65,$-99.00
2024-04-01,11:58:00,18539.75,SELL,3,0.02h,Stop Loss,$-9.00,$-108.00,$55767.50,65,$-108.00
2024-04-01,12:42:00,18514.25,BUY,3,0.02h,Stop Loss,$4.50,$-103.50,$55772.00,65,$-103.50
2024-04-01,13:01:00,18511.0,SELL,3,0.02h,Stop Loss,$25.50,$-78.00,$55797.50,65,$-78.00
2024-04-01,13:33:00,18515.5,BUY,3,0.02h,Stop Loss,$123.00,$45.00,$55920.50,65,$45.00
2024-04-01,14:05:00,18550.75,SELL,3,0.02h,Stop Loss,$4.50,$49.50,$55925.00,65,$49.50
2024-04-01,14:14:00,18584.75,BUY,3,0.02h,Break Even,$-1.50,$48.00,$55923.50,65,$48.00
2024-04-01,14:17:00,18574.5,SELL,3,0.02h,Stop Loss,$39.00,$87.00,$55962.50,65,$87.00
2024-04-01,15:30:00,18470.75,BUY,3,0.02h,Stop Loss,$-9.00,$78.00,$55953.50,65,$78.00
2024-04-01,15:40:00,18453.5,SELL,3,0.02h,Break Even,$-1.50,$76.50,$55952.00,65,$76.50
2024-04-01,15:50:00,18468.5,BUY,3,0.02h,Stop Loss,$-9.00,$67.50,$55943.00,65,$67.50
2024-04-01,15:52:00,18448.5,SELL,3,0.02h,Stop Loss,$28.50,$96.00,$55971.50,65,$96.00
2024-04-01,16:07:00,18455.25,BUY,3,0.02h,Stop Loss,$21.00,$117.00,$55992.50,65,$117.00
2024-04-01,16:58:00,18478.0,SELL,3,0.02h,Stop Loss,$15.00,$132.00,$56007.50,65,$132.00
2024-04-01,17:39:00,18452.5,BUY,3,0.02h,Stop Loss,$-9.00,$123.00,$55998.50,65,$123.00
2024-04-01,18:13:00,18454.0,SELL,3,0.02h,Break Even,$-1.50,$121.50,$55997.00,65,$121.50
2024-04-01,18:19:00,18463.0,BUY,3,0.02h,Break Even,$-1.50,$120.00,$55995.50,65,$120.00
2024-04-01,18:58:00,18468.5,SELL,3,0.02h,Stop Loss,$13.50,$133.50,$56009.00,65,$133.50
2024-04-01,19:07:00,18482.5,BUY,3,0.02h,Break Even,$-1.50,$132.00,$56007.50,65,$132.00
2024-04-01,19:27:00,18468.25,SELL,3,0.02h,Break Even,$-1.50,$130.50,$56006.00,65,$130.50
2024-04-01,19:34:00,18479.0,BUY,3,0.02h,Break Even,$-1.50,$129.00,$56004.50,65,$129.00
2024-04-01,19:36:00,18464.75,SELL,3,0.02h,Stop Loss,$21.00,$150.00,$56025.50,65,$150.00
2024-04-01,19:44:00,18478.5,BUY,3,0.02h,Break Even,$-1.50,$148.50,$56024.00,65,$148.50
2024-04-01,20:28:00,18494.75,SELL,3,0.02h,Stop Loss,$-9.00,$139.50,$56015.00,65,$139.50
2024-04-01,20:39:00,18496.75,BUY,3,0.02h,Stop Loss,$-9.00,$130.50,$56006.00,65,$130.50
2024-04-01,23:00:00,18477.5,SELL,3,0.02h,Stop Loss,$-9.00,$121.50,$55997.00,65,$121.50
2024-04-01,23:59:00,18470.0,BUY,3,0.03h,Break Even,$-1.50,$120.00,$55995.50,65,$120.00
,,,,,,,,,,,
2024-04-02,00:02:00,18463.5,SELL,3,0.02h,Stop Loss,$-9.00,$-9.00,$55986.50,66,$-9.00
2024-04-02,00:30:00,18469.0,BUY,3,0.02h,Stop Loss,$6.00,$-3.00,$55992.50,66,$-3.00
2024-04-02,00:59:00,18464.25,SELL,3,0.02h,Stop Loss,$-9.00,$-12.00,$55983.50,66,$-12.00
2024-04-02,01:21:00,18471.25,BUY,3,0.02h,Break Even,$-1.50,$-13.50,$55982.00,66,$-13.50
2024-04-02,01:42:00,18467.0,SELL,3,0.02h,Stop Loss,$-9.00,$-22.50,$55973.00,66,$-22.50
2024-04-02,01:45:00,18472.0,BUY,3,0.02h,Break Even,$-1.50,$-24.00,$55971.50,66,$-24.00
2024-04-02,01:56:00,18467.75,SELL,3,0.03h,Stop Loss,$-9.00,$-33.00,$55962.50,66,$-33.00
2024-04-02,02:01:00,18472.0,BUY,3,0.02h,Stop Loss,$-9.00,$-42.00,$55953.50,66,$-42.00
2024-04-02,02:03:00,18469.25,SELL,3,0.02h,Stop Loss,$-9.00,$-51.00,$55944.50,66,$-51.00
2024-04-02,02:06:00,18471.5,BUY,3,0.02h,Stop Loss,$-9.00,$-60.00,$55935.50,66,$-60.00
2024-04-02,02:10:00,18467.75,SELL,3,0.02h,Stop Loss,$-9.00,$-69.00,$55926.50,66,$-69.00
2024-04-02,02:18:00,18472.75,BUY,3,0.02h,Break Even,$-1.50,$-70.50,$55925.00,66,$-70.50
2024-04-02,03:35:00,18484.0,SELL,3,0.02h,Stop Loss,$-9.00,$-79.50,$55916.00,66,$-79.50
2024-04-02,03:37:00,18488.5,BUY,3,0.02h,Break Even,$-1.50,$-81.00,$55914.50,66,$-81.00
2024-04-02,03:43:00,18481.0,SELL,3,0.02h,Break Even,$-1.50,$-82.50,$55913.00,66,$-82.50
2024-04-02,04:39:00,18475.25,BUY,3,0.08h,Break Even,$-1.50,$-84.00,$55911.50,66,$-84.00
2024-04-02,05:03:00,18472.25,SELL,3,0.02h,Stop Loss,$-9.00,$-93.00,$55902.50,66,$-93.00
2024-04-02,05:49:00,18466.25,BUY,3,0.03h,Break Even,$-1.50,$-94.50,$55901.00,66,$-94.50
2024-04-02,06:58:00,18482.0,SELL,3,0.02h,Stop Loss,$-9.00,$-103.50,$55892.00,66,$-103.50
2024-04-02,07:04:00,18488.0,BUY,3,0.02h,Stop Loss,$6.00,$-97.50,$55898.00,66,$-97.50
2024-04-02,07:20:00,18482.25,SELL,3,0.02h,Break Even,$-1.50,$-99.00,$55896.50,66,$-99.00
2024-04-02,07:44:00,18472.5,BUY,3,0.02h,Stop Loss,$-9.00,$-108.00,$55887.50,66,$-108.00
2024-04-02,07:53:00,18463.75,SELL,3,0.02h,Stop Loss,$-9.00,$-117.00,$55878.50,66,$-117.00
2024-04-02,07:57:00,18472.5,BUY,3,0.02h,Stop Loss,$-9.00,$-126.00,$55869.50,66,$-126.00
2024-04-02,08:00:00,18464.25,SELL,3,0.02h,Stop Loss,$-9.00,$-135.00,$55860.50,66,$-135.00
2024-04-02,08:01:00,18475.0,BUY,3,0.02h,Stop Loss,$24.00,$-111.00,$55884.50,66,$-111.00
2024-04-02,08:39:00,18492.75,SELL,3,0.02h,Break Even,$-1.50,$-112.50,$55883.00,66,$-112.50
2024-04-02,09:08:00,18485.0,BUY,3,0.02h,Break Even,$-1.50,$-114.00,$55881.50,66,$-114.00
2024-04-02,09:20:00,18475.5,SELL,3,0.02h,Stop Loss,$-9.00,$-123.00,$55872.50,66,$-123.00
2024-04-02,09:23:00,18483.0,BUY,3,0.02h,Break Even,$-1.50,$-124.50,$55871.00,66,$-124.50
2024-04-02,09:31:00,18478.0,SELL,3,0.02h,Break Even,$-1.50,$-126.00,$55869.50,66,$-126.00
2024-04-02,09:45:00,18483.25,BUY,3,0.02h,Stop Loss,$-9.00,$-135.00,$55860.50,66,$-135.00
2024-04-02,09:48:00,18477.5,SELL,3,0.02h,Stop Loss,$15.00,$-120.00,$55875.50,66,$-120.00
2024-04-02,10:22:00,18461.0,BUY,3,0.02h,Stop Loss,$-9.00,$-129.00,$55866.50,66,$-129.00
2024-04-02,10:28:00,18454.0,SELL,3,0.02h,Break Even,$-1.50,$-130.50,$55865.00,66,$-130.50
2024-04-02,10:34:00,18457.25,BUY,3,0.02h,Stop Loss,$-9.00,$-139.50,$55856.00,66,$-139.50
2024-04-02,10:38:00,18455.0,SELL,3,0.02h,Stop Loss,$19.50,$-120.00,$55875.50,66,$-120.00
2024-04-02,11:04:00,18442.0,BUY,3,0.02h,Stop Loss,$-9.00,$-129.00,$55866.50,66,$-129.00
2024-04-02,11:08:00,18434.25,SELL,3,0.02h,Stop Loss,$3.00,$-126.00,$55869.50,66,$-126.00
2024-04-02,12:28:00,18407.5,BUY,3,0.02h,Break Even,$-1.50,$-127.50,$55868.00,66,$-127.50
2024-04-02,12:36:00,18395.25,SELL,3,0.02h,Stop Loss,$22.50,$-105.00,$55890.50,66,$-105.00
2024-04-02,14:04:00,18266.0,BUY,3,0.02h,Stop Loss,$37.50,$-67.50,$55928.00,66,$-67.50
2024-04-02,14:09:00,18243.75,SELL,3,0.02h,Stop Loss,$6.00,$-61.50,$55934.00,66,$-61.50
2024-04-02,14:26:00,18245.5,BUY,3,0.02h,Break Even,$-1.50,$-63.00,$55932.50,66,$-63.00
2024-04-02,14:49:00,18225.5,SELL,3,0.02h,Stop Loss,$22.50,$-40.50,$55955.00,66,$-40.50
2024-04-02,15:09:00,18233.75,BUY,3,0.02h,Stop Loss,$3.00,$-37.50,$55958.00,66,$-37.50
2024-04-02,15:46:00,18258.75,SELL,3,0.02h,Stop Loss,$12.00,$-25.50,$55970.00,66,$-25.50
2024-04-02,16:25:00,18241.75,BUY,3,0.02h,Break Even,$-1.50,$-27.00,$55968.50,66,$-27.00
2024-04-02,17:18:00,18277.25,SELL,3,0.02h,Stop Loss,$-9.00,$-36.00,$55959.50,66,$-36.00
2024-04-02,17:47:00,18283.5,BUY,3,0.02h,Break Even,$-1.50,$-37.50,$55958.00,66,$-37.50
2024-04-02,18:00:00,18277.5,SELL,3,0.02h,Stop Loss,$-9.00,$-46.50,$55949.00,66,$-46.50
2024-04-02,18:09:00,18288.75,BUY,3,0.02h,Break Even,$-1.50,$-48.00,$55947.50,66,$-48.00
2024-04-02,18:32:00,18285.5,SELL,3,0.02h,Break Even,$-1.50,$-49.50,$55946.00,66,$-49.50
2024-04-02,18:34:00,18287.5,BUY,3,0.02h,Break Even,$-1.50,$-51.00,$55944.50,66,$-51.00
2024-04-02,18:36:00,18283.0,SELL,3,0.02h,Stop Loss,$24.00,$-27.00,$55968.50,66,$-27.00
2024-04-02,18:44:00,18289.25,BUY,3,0.02h,Stop Loss,$-9.00,$-36.00,$55959.50,66,$-36.00
2024-04-02,18:46:00,18275.5,SELL,3,0.02h,Stop Loss,$25.50,$-10.50,$55985.00,66,$-10.50
2024-04-02,18:56:00,18285.75,BUY,3,0.02h,Stop Loss,$-9.00,$-19.50,$55976.00,66,$-19.50
2024-04-02,18:57:00,18280.0,SELL,3,0.02h,Stop Loss,$-9.00,$-28.50,$55967.00,66,$-28.50
2024-04-02,19:03:00,18286.25,BUY,3,0.02h,Stop Loss,$24.00,$-4.50,$55991.00,66,$-4.50
2024-04-02,19:18:00,18281.0,SELL,3,0.02h,Break Even,$-1.50,$-6.00,$55989.50,66,$-6.00
2024-04-02,19:25:00,18301.75,BUY,3,0.02h,Stop Loss,$10.50,$4.50,$56000.00,66,$4.50
2024-04-02,20:56:00,18341.75,SELL,3,0.02h,Stop Loss,$-9.00,$-4.50,$55991.00,66,$-4.50
2024-04-02,23:28:00,18332.25,BUY,3,0.02h,Stop Loss,$-9.00,$-13.50,$55982.00,66,$-13.50
2024-04-02,23:42:00,18328.75,SELL,3,0.03h,Stop Loss,$-9.00,$-22.50,$55973.00,66,$-22.50
,,,,,,,,,,,
2024-04-03,00:35:00,18315.0,BUY,3,0.02h,Stop Loss,$-9.00,$-9.00,$55964.00,67,$-9.00
2024-04-03,00:40:00,18312.5,SELL,3,0.02h,Stop Loss,$-9.00,$-18.00,$55955.00,67,$-18.00
2024-04-03,00:41:00,18314.5,BUY,3,0.02h,Stop Loss,$-9.00,$-27.00,$55946.00,67,$-27.00
2024-04-03,00:42:00,18312.75,SELL,3,0.02h,Stop Loss,$6.00,$-21.00,$55952.00,67,$-21.00
2024-04-03,00:56:00,18312.75,BUY,3,0.02h,Stop Loss,$-9.00,$-30.00,$55943.00,67,$-30.00
2024-04-03,01:01:00,18307.5,SELL,3,0.02h,Stop Loss,$-9.00,$-39.00,$55934.00,67,$-39.00
2024-04-03,01:26:00,18306.0,BUY,3,0.02h,Break Even,$-1.50,$-40.50,$55932.50,67,$-40.50
2024-04-03,01:49:00,18302.75,SELL,3,0.02h,Break Even,$-1.50,$-42.00,$55931.00,67,$-42.00
2024-04-03,01:55:00,18305.5,BUY,3,0.02h,Stop Loss,$-9.00,$-51.00,$55922.00,67,$-51.00
2024-04-03,01:57:00,18302.5,SELL,3,0.02h,Stop Loss,$7.50,$-43.50,$55929.50,67,$-43.50
2024-04-03,02:25:00,18302.75,BUY,3,0.02h,Break Even,$-1.50,$-45.00,$55928.00,67,$-45.00
2024-04-03,02:48:00,18300.5,SELL,3,0.02h,Stop Loss,$-9.00,$-54.00,$55919.00,67,$-54.00
2024-04-03,03:06:00,18301.5,BUY,3,0.02h,Stop Loss,$-9.00,$-63.00,$55910.00,67,$-63.00
2024-04-03,03:27:00,18300.5,SELL,3,0.02h,Stop Loss,$-9.00,$-72.00,$55901.00,67,$-72.00
2024-04-03,03:31:00,18304.25,BUY,3,0.02h,Break Even,$-1.50,$-73.50,$55899.50,67,$-73.50
2024-04-03,04:12:00,18307.25,SELL,3,0.02h,Stop Loss,$-9.00,$-82.50,$55890.50,67,$-82.50
2024-04-03,04:55:00,18301.0,BUY,3,0.02h,Stop Loss,$-9.00,$-91.50,$55881.50,67,$-91.50
2024-04-03,04:58:00,18297.75,SELL,3,0.02h,Stop Loss,$-9.00,$-100.50,$55872.50,67,$-100.50
2024-04-03,05:05:00,18300.0,BUY,3,0.02h,Break Even,$-1.50,$-102.00,$55871.00,67,$-102.00
2024-04-03,05:06:00,18295.5,SELL,3,0.02h,Stop Loss,$10.50,$-91.50,$55881.50,67,$-91.50
2024-04-03,06:12:00,18281.75,BUY,3,0.02h,Break Even,$-1.50,$-93.00,$55880.00,67,$-93.00
2024-04-03,06:33:00,18277.0,SELL,3,0.02h,Stop Loss,$-9.00,$-102.00,$55871.00,67,$-102.00
2024-04-03,06:42:00,18284.75,BUY,3,0.02h,Stop Loss,$-9.00,$-111.00,$55862.00,67,$-111.00
2024-04-03,07:06:00,18271.25,SELL,3,0.02h,Break Even,$-1.50,$-112.50,$55860.50,67,$-112.50
2024-04-03,07:16:00,18287.0,BUY,3,0.02h,Stop Loss,$-9.00,$-121.50,$55851.50,67,$-121.50
2024-04-03,07:21:00,18276.0,SELL,3,0.02h,Break Even,$-1.50,$-123.00,$55850.00,67,$-123.00
2024-04-03,07:23:00,18284.75,BUY,3,0.02h,Break Even,$-1.50,$-124.50,$55848.50,67,$-124.50
2024-04-03,07:31:00,18273.75,SELL,3,0.02h,Break Even,$-1.50,$-126.00,$55847.00,67,$-126.00
2024-04-03,07:38:00,18287.0,BUY,3,0.02h,Stop Loss,$7.50,$-118.50,$55854.50,67,$-118.50
2024-04-03,07:52:00,18277.0,SELL,3,0.02h,Break Even,$-1.50,$-120.00,$55853.00,67,$-120.00
2024-04-03,08:08:00,18285.5,BUY,3,0.02h,Stop Loss,$-9.00,$-129.00,$55844.00,67,$-129.00
2024-04-03,08:12:00,18276.25,SELL,3,0.02h,Break Even,$-1.50,$-130.50,$55842.50,67,$-130.50
2024-04-03,08:15:00,18283.5,BUY,3,0.02h,Stop Loss,$3.00,$-127.50,$55845.50,67,$-127.50
2024-04-03,09:01:00,18290.25,SELL,3,0.02h,Break Even,$-1.50,$-129.00,$55844.00,67,$-129.00
2024-04-03,09:14:00,18295.5,BUY,3,0.02h,Stop Loss,$-9.00,$-138.00,$55835.00,67,$-138.00
2024-04-03,09:22:00,18288.75,SELL,3,0.02h,Break Even,$-1.50,$-139.50,$55833.50,67,$-139.50
2024-04-03,09:42:00,18286.25,BUY,3,0.03h,Stop Loss,$-9.00,$-148.50,$55824.50,67,$-148.50
2024-04-03,09:48:00,18281.25,SELL,3,0.02h,Stop Loss,$4.50,$-144.00,$55829.00,67,$-144.00
2024-04-03,10:20:00,18276.5,BUY,3,0.02h,Break Even,$-1.50,$-145.50,$55827.50,67,$-145.50
2024-04-03,10:26:00,18267.5,SELL,3,0.02h,Stop Loss,$-9.00,$-154.50,$55818.50,67,$-154.50
2024-04-03,10:50:00,18269.5,BUY,3,0.02h,Break Even,$-1.50,$-156.00,$55817.00,67,$-156.00
2024-04-03,11:45:00,18289.0,SELL,3,0.02h,Stop Loss,$-9.00,$-165.00,$55808.00,67,$-165.00
2024-04-03,11:54:00,18309.0,BUY,3,0.02h,Stop Loss,$-9.00,$-174.00,$55799.00,67,$-174.00
2024-04-03,12:17:00,18297.25,SELL,3,0.02h,Stop Loss,$-9.00,$-183.00,$55790.00,67,$-183.00
2024-04-03,13:04:00,18273.75,BUY,3,0.02h,Stop Loss,$4.50,$-178.50,$55794.50,67,$-178.50
2024-04-03,13:12:00,18260.25,SELL,3,0.02h,Stop Loss,$13.50,$-165.00,$55808.00,67,$-165.00
2024-04-03,13:34:00,18264.75,BUY,3,0.02h,Stop Loss,$30.00,$-135.00,$55838.00,67,$-135.00
2024-04-03,15:41:00,18437.0,SELL,3,0.02h,Stop Loss,$-9.00,$-144.00,$55829.00,67,$-144.00
2024-04-03,15:43:00,18446.0,BUY,3,0.02h,Break Even,$-1.50,$-145.50,$55827.50,67,$-145.50
2024-04-03,15:46:00,18433.25,SELL,3,0.02h,Stop Loss,$-9.00,$-154.50,$55818.50,67,$-154.50
2024-04-03,16:20:00,18415.25,BUY,3,0.02h,Stop Loss,$13.50,$-141.00,$55832.00,67,$-141.00
2024-04-03,16:39:00,18374.75,SELL,3,0.02h,Break Even,$-1.50,$-142.50,$55830.50,67,$-142.50
2024-04-03,16:46:00,18419.25,BUY,3,0.02h,Break Even,$-1.50,$-144.00,$55829.00,67,$-144.00
2024-04-03,17:03:00,18410.0,SELL,3,0.02h,Break Even,$-1.50,$-145.50,$55827.50,67,$-145.50
2024-04-03,17:23:00,18419.25,BUY,3,0.02h,Stop Loss,$10.50,$-135.00,$55838.00,67,$-135.00
2024-04-03,17:39:00,18414.5,SELL,3,0.02h,Stop Loss,$19.50,$-115.50,$55857.50,67,$-115.50
2024-04-03,17:48:00,18421.0,BUY,3,0.02h,Stop Loss,$3.00,$-112.50,$55860.50,67,$-112.50
2024-04-03,17:59:00,18415.25,SELL,3,0.02h,Stop Loss,$-9.00,$-121.50,$55851.50,67,$-121.50
2024-04-03,18:08:00,18427.5,BUY,3,0.02h,Break Even,$-1.50,$-123.00,$55850.00,67,$-123.00
2024-04-03,18:17:00,18415.75,SELL,3,0.02h,Stop Loss,$13.50,$-109.50,$55863.50,67,$-109.50
2024-04-03,18:39:00,18422.0,BUY,3,0.02h,Stop Loss,$-9.00,$-118.50,$55854.50,67,$-118.50
2024-04-03,18:47:00,18408.5,SELL,3,0.02h,Stop Loss,$-9.00,$-127.50,$55845.50,67,$-127.50
2024-04-03,19:39:00,18362.25,BUY,3,0.02h,Break Even,$-1.50,$-129.00,$55844.00,67,$-129.00
2024-04-03,20:59:00,18390.25,SELL,3,0.02h,Break Even,$-1.50,$-130.50,$55842.50,67,$-130.50
2024-04-03,23:10:00,18394.25,BUY,3,0.10h,Stop Loss,$25.50,$-105.00,$55868.00,67,$-105.00
,,,,,,,,,,,
2024-04-04,00:04:00,18430.5,SELL,3,0.02h,Stop Loss,$-9.00,$-9.00,$55859.00,68,$-9.00
2024-04-04,00:21:00,18438.5,BUY,3,0.03h,Break Even,$-1.50,$-10.50,$55857.50,68,$-10.50
2024-04-04,00:34:00,18432.5,SELL,3,0.02h,Stop Loss,$-9.00,$-19.50,$55848.50,68,$-19.50
2024-04-04,00:39:00,18441.0,BUY,3,0.02h,Stop Loss,$-9.00,$-28.50,$55839.50,68,$-28.50
2024-04-04,00:46:00,18435.75,SELL,3,0.02h,Stop Loss,$-9.00,$-37.50,$55830.50,68,$-37.50
2024-04-04,00:48:00,18439.5,BUY,3,0.03h,Break Even,$-1.50,$-39.00,$55829.00,68,$-39.00
2024-04-04,00:56:00,18437.0,SELL,3,0.02h,Stop Loss,$-9.00,$-48.00,$55820.00,68,$-48.00
2024-04-04,00:57:00,18439.25,BUY,3,0.02h,Stop Loss,$-9.00,$-57.00,$55811.00,68,$-57.00
2024-04-04,00:59:00,18437.5,SELL,3,0.02h,Stop Loss,$-9.00,$-66.00,$55802.00,68,$-66.00
2024-04-04,01:01:00,18439.0,BUY,3,0.02h,Stop Loss,$-9.00,$-75.00,$55793.00,68,$-75.00
2024-04-04,01:02:00,18436.5,SELL,3,0.02h,Stop Loss,$-9.00,$-84.00,$55784.00,68,$-84.00
2024-04-04,01:16:00,18440.25,BUY,3,0.02h,Stop Loss,$-9.00,$-93.00,$55775.00,68,$-93.00
2024-04-04,01:45:00,18437.25,SELL,3,0.02h,Stop Loss,$-9.00,$-102.00,$55766.00,68,$-102.00
2024-04-04,01:48:00,18445.0,BUY,3,0.02h,Stop Loss,$-9.00,$-111.00,$55757.00,68,$-111.00
2024-04-04,01:50:00,18440.5,SELL,3,0.02h,Stop Loss,$-9.00,$-120.00,$55748.00,68,$-120.00
2024-04-04,01:55:00,18443.5,BUY,3,0.02h,Stop Loss,$-9.00,$-129.00,$55739.00,68,$-129.00
2024-04-04,01:58:00,18441.0,SELL,3,0.02h,Stop Loss,$-9.00,$-138.00,$55730.00,68,$-138.00
2024-04-04,01:59:00,18441.75,BUY,3,0.02h,Stop Loss,$-9.00,$-147.00,$55721.00,68,$-147.00
2024-04-04,02:00:00,18440.5,SELL,3,0.02h,Stop Loss,$-9.00,$-156.00,$55712.00,68,$-156.00
2024-04-04,02:04:00,18444.25,BUY,3,0.02h,Break Even,$-1.50,$-157.50,$55710.50,68,$-157.50
2024-04-04,02:20:00,18441.5,SELL,3,0.02h,Stop Loss,$-9.00,$-166.50,$55701.50,68,$-166.50
2024-04-04,02:29:00,18445.0,BUY,3,0.02h,Stop Loss,$-9.00,$-175.50,$55692.50,68,$-175.50
2024-04-04,02:57:00,18445.75,SELL,3,0.07h,Stop Loss,$-9.00,$-184.50,$55683.50,68,$-184.50
2024-04-04,03:12:00,18451.5,BUY,3,0.02h,Stop Loss,$-9.00,$-193.50,$55674.50,68,$-193.50
2024-04-04,03:32:00,18447.25,SELL,3,0.02h,Stop Loss,$-9.00,$-202.50,$55665.50,68,$-202.50
2024-04-04,03:48:00,18449.5,BUY,3,0.02h,Stop Loss,$-9.00,$-211.50,$55656.50,68,$-211.50
2024-04-04,04:52:00,18455.0,SELL,3,0.05h,Break Even,$-1.50,$-213.00,$55655.00,68,$-213.00
2024-04-04,06:46:00,18429.25,BUY,3,0.02h,Stop Loss,$-9.00,$-222.00,$55646.00,68,$-222.00
2024-04-04,06:52:00,18423.25,SELL,3,0.02h,Break Even,$-1.50,$-223.50,$55644.50,68,$-223.50
2024-04-04,07:15:00,18428.5,BUY,3,0.02h,Stop Loss,$24.00,$-199.50,$55668.50,68,$-199.50
2024-04-04,07:55:00,18435.5,SELL,3,0.02h,Break Even,$-1.50,$-201.00,$55667.00,68,$-201.00
2024-04-04,07:59:00,18440.0,BUY,3,0.02h,Stop Loss,$-9.00,$-210.00,$55658.00,68,$-210.00
2024-04-04,08:42:00,18448.75,SELL,3,0.02h,Stop Loss,$-9.00,$-219.00,$55649.00,68,$-219.00
2024-04-04,09:16:00,18451.25,BUY,3,0.02h,Break Even,$-1.50,$-220.50,$55647.50,68,$-220.50
2024-04-04,09:40:00,18451.0,SELL,3,0.02h,Stop Loss,$-9.00,$-229.50,$55638.50,68,$-229.50
2024-04-04,09:45:00,18457.5,BUY,3,0.02h,Break Even,$-1.50,$-231.00,$55637.00,68,$-231.00
2024-04-04,09:52:00,18452.5,SELL,3,0.02h,Stop Loss,$-9.00,$-240.00,$55628.00,68,$-240.00
2024-04-04,09:54:00,18455.25,BUY,3,0.02h,Break Even,$-1.50,$-241.50,$55626.50,68,$-241.50
2024-04-04,10:03:00,18451.25,SELL,3,0.02h,Break Even,$-1.50,$-243.00,$55625.00,68,$-243.00
2024-04-04,10:13:00,18456.25,BUY,3,0.03h,Break Even,$-1.50,$-244.50,$55623.50,68,$-244.50
2024-04-04,10:32:00,18453.0,SELL,3,0.02h,Stop Loss,$3.00,$-241.50,$55626.50,68,$-241.50
2024-04-04,10:53:00,18448.75,BUY,3,0.02h,Stop Loss,$10.50,$-231.00,$55637.00,68,$-231.00
2024-04-04,11:24:00,18453.25,SELL,3,0.02h,Stop Loss,$4.50,$-226.50,$55641.50,68,$-226.50
2024-04-04,11:57:00,18452.5,BUY,3,0.02h,Stop Loss,$-9.00,$-235.50,$55632.50,68,$-235.50
2024-04-04,12:02:00,18444.5,SELL,3,0.02h,Break Even,$-1.50,$-237.00,$55631.00,68,$-237.00
2024-04-04,12:08:00,18456.0,BUY,3,0.02h,Break Even,$-1.50,$-238.50,$55629.50,68,$-238.50
2024-04-04,12:11:00,18446.25,SELL,3,0.02h,Stop Loss,$-9.00,$-247.50,$55620.50,68,$-247.50
2024-04-04,12:15:00,18454.5,BUY,3,0.02h,Stop Loss,$-9.00,$-256.50,$55611.50,68,$-256.50
2024-04-04,12:20:00,18447.5,SELL,3,0.02h,Break Even,$-1.50,$-258.00,$55610.00,68,$-258.00
2024-04-04,12:27:00,18453.75,BUY,3,0.02h,Break Even,$-1.50,$-259.50,$55608.50,68,$-259.50
2024-04-04,13:44:00,18541.25,SELL,3,0.02h,Stop Loss,$34.50,$-225.00,$55643.00,68,$-225.00
2024-04-04,15:02:00,18503.75,BUY,3,0.02h,Break Even,$-1.50,$-226.50,$55641.50,68,$-226.50
2024-04-04,15:13:00,18486.0,SELL,3,0.02h,Break Even,$-1.50,$-228.00,$55640.00,68,$-228.00
2024-04-04,15:30:00,18501.75,BUY,3,0.02h,Stop Loss,$19.50,$-208.50,$55659.50,68,$-208.50
2024-04-04,17:02:00,18550.5,SELL,3,0.02h,Stop Loss,$13.50,$-195.00,$55673.00,68,$-195.00
2024-04-04,20:42:00,18072.0,BUY,3,0.02h,Break Even,$-1.50,$-196.50,$55671.50,68,$-196.50
2024-04-04,23:29:00,18086.25,SELL,3,0.02h,Stop Loss,$-9.00,$-205.50,$55662.50,68,$-205.50
2024-04-04,23:31:00,18097.75,BUY,3,0.02h,Break Even,$-1.50,$-207.00,$55661.00,68,$-207.00
2024-04-04,23:44:00,18090.5,SELL,3,0.02h,Stop Loss,$-9.00,$-216.00,$55652.00,68,$-216.00
2024-04-04,23:51:00,18097.0,BUY,3,0.02h,Break Even,$-1.50,$-217.50,$55650.50,68,$-217.50
2024-04-04,23:55:00,18094.5,SELL,3,0.02h,Break Even,$-1.50,$-219.00,$55649.00,68,$-219.00
,,,,,,,,,,,
2024-04-05,00:09:00,18098.75,BUY,3,0.02h,Stop Loss,$3.00,$3.00,$55652.00,69,$3.00
2024-04-05,00:22:00,18090.0,SELL,3,0.02h,Stop Loss,$-9.00,$-6.00,$55643.00,69,$-6.00
2024-04-05,00:53:00,18095.5,BUY,3,0.02h,Stop Loss,$-9.00,$-15.00,$55634.00,69,$-15.00
2024-04-05,01:22:00,18090.25,SELL,3,0.02h,Break Even,$-1.50,$-16.50,$55632.50,69,$-16.50
2024-04-05,02:12:00,18079.75,BUY,3,0.02h,Break Even,$-1.50,$-18.00,$55631.00,69,$-18.00
2024-04-05,02:27:00,18074.0,SELL,3,0.02h,Stop Loss,$-9.00,$-27.00,$55622.00,69,$-27.00
2024-04-05,02:31:00,18079.75,BUY,3,0.02h,Break Even,$-1.50,$-28.50,$55620.50,69,$-28.50
2024-04-05,03:29:00,18088.0,SELL,3,0.02h,Stop Loss,$-9.00,$-37.50,$55611.50,69,$-37.50
2024-04-05,03:32:00,18092.5,BUY,3,0.02h,Stop Loss,$15.00,$-22.50,$55626.50,69,$-22.50
2024-04-05,04:21:00,18100.75,SELL,3,0.02h,Stop Loss,$-9.00,$-31.50,$55617.50,69,$-31.50
2024-04-05,04:32:00,18106.5,BUY,3,0.02h,Stop Loss,$-9.00,$-40.50,$55608.50,69,$-40.50
2024-04-05,05:22:00,18110.0,SELL,3,0.02h,Stop Loss,$-9.00,$-49.50,$55599.50,69,$-49.50
2024-04-05,05:45:00,18113.25,BUY,3,0.02h,Stop Loss,$7.50,$-42.00,$55607.00,69,$-42.00
2024-04-05,05:59:00,18109.0,SELL,3,0.02h,Stop Loss,$-9.00,$-51.00,$55598.00,69,$-51.00
2024-04-05,06:01:00,18116.25,BUY,3,0.02h,Stop Loss,$12.00,$-39.00,$55610.00,69,$-39.00
2024-04-05,06:14:00,18108.25,SELL,3,0.02h,Stop Loss,$-9.00,$-48.00,$55601.00,69,$-48.00
2024-04-05,06:30:00,18117.25,BUY,3,0.02h,Break Even,$-1.50,$-49.50,$55599.50,69,$-49.50
2024-04-05,06:46:00,18116.25,SELL,3,0.02h,Stop Loss,$3.00,$-46.50,$55602.50,69,$-46.50
2024-04-05,06:59:00,18122.5,BUY,3,0.02h,Break Even,$-1.50,$-48.00,$55601.00,69,$-48.00
2024-04-05,07:04:00,18112.25,SELL,3,0.02h,Break Even,$-1.50,$-49.50,$55599.50,69,$-49.50
2024-04-05,07:12:00,18122.0,BUY,3,0.02h,Stop Loss,$-9.00,$-58.50,$55590.50,69,$-58.50
2024-04-05,07:43:00,18119.75,SELL,3,0.02h,Stop Loss,$-9.00,$-67.50,$55581.50,69,$-67.50
2024-04-05,07:55:00,18135.0,BUY,3,0.02h,Break Even,$-1.50,$-69.00,$55580.00,69,$-69.00
2024-04-05,08:13:00,18127.25,SELL,3,0.02h,Break Even,$-1.50,$-70.50,$55578.50,69,$-70.50
2024-04-05,08:29:00,18135.25,BUY,3,0.02h,Break Even,$-1.50,$-72.00,$55577.00,69,$-72.00
2024-04-05,08:45:00,18133.5,SELL,3,0.02h,Stop Loss,$9.00,$-63.00,$55586.00,69,$-63.00
2024-04-05,09:02:00,18137.5,BUY,3,0.02h,Break Even,$-1.50,$-64.50,$55584.50,69,$-64.50
2024-04-05,09:21:00,18132.0,SELL,3,0.02h,Stop Loss,$-9.00,$-73.50,$55575.50,69,$-73.50
2024-04-05,09:22:00,18138.25,BUY,3,0.02h,Stop Loss,$-9.00,$-82.50,$55566.50,69,$-82.50
2024-04-05,09:25:00,18131.0,SELL,3,0.02h,Break Even,$-1.50,$-84.00,$55565.00,69,$-84.00
2024-04-05,09:41:00,18133.25,BUY,3,0.02h,Stop Loss,$-9.00,$-93.00,$55556.00,69,$-93.00
2024-04-05,09:42:00,18130.5,SELL,3,0.02h,Break Even,$-1.50,$-94.50,$55554.50,69,$-94.50
2024-04-05,09:51:00,18139.25,BUY,3,0.02h,Stop Loss,$-9.00,$-103.50,$55545.50,69,$-103.50
2024-04-05,10:05:00,18133.0,SELL,3,0.02h,Stop Loss,$-9.00,$-112.50,$55536.50,69,$-112.50
2024-04-05,10:38:00,18138.25,BUY,3,0.02h,Break Even,$-1.50,$-114.00,$55535.00,69,$-114.00
2024-04-05,11:14:00,18135.75,SELL,3,0.02h,Stop Loss,$-9.00,$-123.00,$55526.00,69,$-123.00
2024-04-05,11:20:00,18139.75,BUY,3,0.02h,Break Even,$-1.50,$-124.50,$55524.50,69,$-124.50
2024-04-05,11:27:00,18137.0,SELL,3,0.02h,Break Even,$-1.50,$-126.00,$55523.00,69,$-126.00
2024-04-05,11:32:00,18140.0,BUY,3,0.02h,Stop Loss,$-9.00,$-135.00,$55514.00,69,$-135.00
2024-04-05,11:34:00,18136.75,SELL,3,0.02h,Stop Loss,$-9.00,$-144.00,$55505.00,69,$-144.00
2024-04-05,11:35:00,18138.75,BUY,3,0.02h,Stop Loss,$13.50,$-130.50,$55518.50,69,$-130.50
2024-04-05,11:57:00,18146.25,SELL,3,0.02h,Break Even,$-1.50,$-132.00,$55517.00,69,$-132.00
2024-04-05,12:05:00,18158.5,BUY,3,0.02h,Break Even,$-1.50,$-133.50,$55515.50,69,$-133.50
2024-04-05,12:09:00,18150.0,SELL,3,0.02h,Stop Loss,$9.00,$-124.50,$55524.50,69,$-124.50
2024-04-05,12:30:00,18153.75,BUY,3,0.02h,Stop Loss,$-9.00,$-133.50,$55515.50,69,$-133.50
2024-04-05,12:31:00,18109.75,SELL,3,0.02h,Stop Loss,$127.50,$-6.00,$55643.00,69,$-6.00
2024-04-05,12:41:00,18148.25,BUY,3,0.02h,Stop Loss,$36.00,$30.00,$55679.00,69,$30.00
2024-04-05,12:58:00,18138.5,SELL,3,0.02h,Stop Loss,$42.00,$72.00,$55721.00,69,$72.00
2024-04-05,13:01:00,18161.75,BUY,3,0.02h,Stop Loss,$28.50,$100.50,$55749.50,69,$100.50
2024-04-05,13:05:00,18143.25,SELL,3,0.02h,Stop Loss,$30.00,$130.50,$55779.50,69,$130.50
2024-04-05,13:28:00,18143.0,BUY,3,0.02h,Stop Loss,$24.00,$154.50,$55803.50,69,$154.50
2024-04-05,13:37:00,18127.75,SELL,3,0.02h,Stop Loss,$97.50,$252.00,$55901.00,69,$252.00
2024-04-05,13:43:00,18170.5,BUY,3,0.02h,Stop Loss,$49.50,$301.50,$55950.50,69,$301.50
2024-04-05,14:28:00,18187.75,SELL,3,0.02h,Stop Loss,$-9.00,$292.50,$55941.50,69,$292.50
2024-04-05,14:35:00,18218.75,BUY,3,0.02h,Break Even,$-1.50,$291.00,$55940.00,69,$291.00
2024-04-05,14:36:00,18211.75,SELL,3,0.02h,Break Even,$-1.50,$289.50,$55938.50,69,$289.50
2024-04-05,14:37:00,18218.25,BUY,3,0.02h,Stop Loss,$34.50,$324.00,$55973.00,69,$324.00
2024-04-05,15:15:00,18272.0,SELL,3,0.02h,Stop Loss,$105.00,$429.00,$56078.00,69,$429.00
2024-04-05,15:30:00,18282.75,BUY,3,0.02h,Break Even,$-1.50,$427.50,$56076.50,69,$427.50
2024-04-05,16:30:00,18355.75,SELL,3,0.02h,Stop Loss,$3.00,$430.50,$56079.50,69,$430.50
2024-04-05,16:40:00,18371.75,BUY,3,0.02h,Stop Loss,$-9.00,$421.50,$56070.50,69,$421.50
2024-04-05,16:50:00,18356.25,SELL,3,0.02h,Stop Loss,$-9.00,$412.50,$56061.50,69,$412.50
2024-04-05,16:51:00,18364.5,BUY,3,0.02h,Stop Loss,$10.50,$423.00,$56072.00,69,$423.00
2024-04-05,17:09:00,18357.5,SELL,3,0.02h,Break Even,$-1.50,$421.50,$56070.50,69,$421.50
2024-04-05,17:25:00,18369.25,BUY,3,0.02h,Break Even,$-1.50,$420.00,$56069.00,69,$420.00
2024-04-05,17:26:00,18363.0,SELL,3,0.02h,Break Even,$-1.50,$418.50,$56067.50,69,$418.50
2024-04-05,17:30:00,18369.0,BUY,3,0.02h,Stop Loss,$21.00,$439.50,$56088.50,69,$439.50
2024-04-05,17:41:00,18362.0,SELL,3,0.02h,Stop Loss,$60.00,$499.50,$56148.50,69,$499.50
2024-04-05,18:14:00,18318.75,BUY,3,0.02h,Break Even,$-1.50,$498.00,$56147.00,69,$498.00
2024-04-05,18:26:00,18303.25,SELL,3,0.02h,Stop Loss,$-9.00,$489.00,$56138.00,69,$489.00
2024-04-05,18:41:00,18310.5,BUY,3,0.02h,Stop Loss,$-9.00,$480.00,$56129.00,69,$480.00
2024-04-05,18:42:00,18296.25,SELL,3,0.02h,Stop Loss,$13.50,$493.50,$56142.50,69,$493.50
2024-04-05,19:06:00,18293.5,BUY,3,0.02h,Stop Loss,$6.00,$499.50,$56148.50,69,$499.50
2024-04-05,19:28:00,18281.25,SELL,3,0.02h,Stop Loss,$-9.00,$490.50,$56139.50,69,$490.50
2024-04-05,19:29:00,18291.75,BUY,3,0.02h,Stop Loss,$-9.00,$481.50,$56130.50,69,$481.50
2024-04-05,20:01:00,18286.25,SELL,3,0.02h,Break Even,$-1.50,$480.00,$56129.00,69,$480.00
2024-04-05,20:27:00,18296.5,BUY,3,0.02h,Break Even,$-1.50,$478.50,$56127.50,69,$478.50
,,,,,,,,,,,
2024-04-08,00:22:00,18304.75,SELL,3,0.02h,Stop Loss,$-9.00,$-9.00,$56118.50,70,$-9.00
2024-04-08,00:53:00,18296.0,BUY,3,0.03h,Stop Loss,$-9.00,$-18.00,$56109.50,70,$-18.00
2024-04-08,01:53:00,18317.5,SELL,3,0.02h,Break Even,$-1.50,$-19.50,$56108.00,70,$-19.50
2024-04-08,02:12:00,18324.5,BUY,3,0.02h,Stop Loss,$-9.00,$-28.50,$56099.00,70,$-28.50
2024-04-08,02:23:00,18318.75,SELL,3,0.02h,Break Even,$-1.50,$-30.00,$56097.50,70,$-30.00
2024-04-08,02:31:00,18323.5,BUY,3,0.02h,Break Even,$-1.50,$-31.50,$56096.00,70,$-31.50
2024-04-08,02:41:00,18320.0,SELL,3,0.02h,Break Even,$-1.50,$-33.00,$56094.50,70,$-33.00
2024-04-08,02:46:00,18322.5,BUY,3,0.02h,Stop Loss,$-9.00,$-42.00,$56085.50,70,$-42.00
2024-04-08,02:48:00,18321.5,SELL,3,0.02h,Break Even,$-1.50,$-43.50,$56084.00,70,$-43.50
2024-04-08,02:55:00,18323.5,BUY,3,0.02h,Stop Loss,$-9.00,$-52.50,$56075.00,70,$-52.50
2024-04-08,03:09:00,18320.25,SELL,3,0.02h,Stop Loss,$-9.00,$-61.50,$56066.00,70,$-61.50
2024-04-08,04:04:00,18287.0,BUY,3,0.02h,Stop Loss,$-9.00,$-70.50,$56057.00,70,$-70.50
2024-04-08,04:40:00,18289.5,SELL,3,0.02h,Stop Loss,$-9.00,$-79.50,$56048.00,70,$-79.50
2024-04-08,04:43:00,18292.75,BUY,3,0.02h,Break Even,$-1.50,$-81.00,$56046.50,70,$-81.00
2024-04-08,04:50:00,18288.5,SELL,3,0.02h,Stop Loss,$-9.00,$-90.00,$56037.50,70,$-90.00
2024-04-08,05:02:00,18295.5,BUY,3,0.02h,Break Even,$-1.50,$-91.50,$56036.00,70,$-91.50
2024-04-08,05:33:00,18299.0,SELL,3,0.02h,Break Even,$-1.50,$-93.00,$56034.50,70,$-93.00
2024-04-08,05:43:00,18305.5,BUY,3,0.02h,Stop Loss,$-9.00,$-102.00,$56025.50,70,$-102.00
2024-04-08,05:47:00,18291.5,SELL,3,0.02h,Stop Loss,$-9.00,$-111.00,$56016.50,70,$-111.00
2024-04-08,06:01:00,18307.5,BUY,3,0.02h,Stop Loss,$6.00,$-105.00,$56022.50,70,$-105.00
2024-04-08,06:16:00,18290.75,SELL,3,0.02h,Stop Loss,$12.00,$-93.00,$56034.50,70,$-93.00
2024-04-08,06:34:00,18297.0,BUY,3,0.02h,Stop Loss,$-9.00,$-102.00,$56025.50,70,$-102.00
2024-04-08,06:35:00,18293.75,SELL,3,0.03h,Stop Loss,$-9.00,$-111.00,$56016.50,70,$-111.00
2024-04-08,07:13:00,18294.75,BUY,3,0.02h,Stop Loss,$25.50,$-85.50,$56042.00,70,$-85.50
2024-04-08,08:06:00,18320.5,SELL,3,0.02h,Break Even,$-1.50,$-87.00,$56040.50,70,$-87.00
2024-04-08,08:40:00,18299.75,BUY,3,0.02h,Break Even,$-1.50,$-88.50,$56039.00,70,$-88.50
2024-04-08,08:48:00,18283.0,SELL,3,0.02h,Stop Loss,$-9.00,$-97.50,$56030.00,70,$-97.50
2024-04-08,09:06:00,18290.5,BUY,3,0.02h,Stop Loss,$6.00,$-91.50,$56036.00,70,$-91.50
2024-04-08,09:08:00,18275.25,SELL,3,0.02h,Stop Loss,$9.00,$-82.50,$56045.00,70,$-82.50
2024-04-08,09:15:00,18283.25,BUY,3,0.02h,Stop Loss,$-9.00,$-91.50,$56036.00,70,$-91.50
2024-04-08,09:16:00,18276.75,SELL,3,0.02h,Break Even,$-1.50,$-93.00,$56034.50,70,$-93.00
2024-04-08,09:18:00,18286.75,BUY,3,0.02h,Break Even,$-1.50,$-94.50,$56033.00,70,$-94.50
2024-04-08,09:41:00,18292.0,SELL,3,0.02h,Stop Loss,$-9.00,$-103.50,$56024.00,70,$-103.50
2024-04-08,09:42:00,18299.25,BUY,3,0.02h,Break Even,$-1.50,$-105.00,$56022.50,70,$-105.00
2024-04-08,10:05:00,18299.25,SELL,3,0.02h,Break Even,$-1.50,$-106.50,$56021.00,70,$-106.50
2024-04-08,10:26:00,18295.0,BUY,3,0.02h,Break Even,$-1.50,$-108.00,$56019.50,70,$-108.00
2024-04-08,10:38:00,18287.75,SELL,3,0.02h,Break Even,$-1.50,$-109.50,$56018.00,70,$-109.50
2024-04-08,10:47:00,18297.75,BUY,3,0.02h,Stop Loss,$6.00,$-103.50,$56024.00,70,$-103.50
2024-04-08,11:16:00,18303.25,SELL,3,0.02h,Stop Loss,$-9.00,$-112.50,$56015.00,70,$-112.50
2024-04-08,11:22:00,18311.5,BUY,3,0.02h,Stop Loss,$9.00,$-103.50,$56024.00,70,$-103.50
2024-04-08,11:28:00,18306.25,SELL,3,0.02h,Break Even,$-1.50,$-105.00,$56022.50,70,$-105.00
2024-04-08,11:54:00,18305.75,BUY,3,0.02h,Break Even,$-1.50,$-106.50,$56021.00,70,$-106.50
2024-04-08,12:03:00,18294.5,SELL,3,0.02h,Stop Loss,$-9.00,$-115.50,$56012.00,70,$-115.50
2024-04-08,12:04:00,18299.75,BUY,3,0.02h,Stop Loss,$13.50,$-102.00,$56025.50,70,$-102.00
2024-04-08,12:06:00,18295.75,SELL,3,0.02h,Stop Loss,$-9.00,$-111.00,$56016.50,70,$-111.00
2024-04-08,12:14:00,18306.75,BUY,3,0.02h,Stop Loss,$6.00,$-105.00,$56022.50,70,$-105.00
2024-04-08,13:27:00,18346.0,SELL,3,0.02h,Stop Loss,$7.50,$-97.50,$56030.00,70,$-97.50
2024-04-08,13:59:00,18300.5,BUY,3,0.02h,Stop Loss,$16.50,$-81.00,$56046.50,70,$-81.00
2024-04-08,14:08:00,18283.25,SELL,3,0.02h,Stop Loss,$-9.00,$-90.00,$56037.50,70,$-90.00
2024-04-08,14:09:00,18307.25,BUY,3,0.02h,Stop Loss,$12.00,$-78.00,$56049.50,70,$-78.00
2024-04-08,15:03:00,18331.5,SELL,3,0.02h,Break Even,$-1.50,$-79.50,$56048.00,70,$-79.50
2024-04-08,16:32:00,18291.25,BUY,3,0.02h,Stop Loss,$6.00,$-73.50,$56054.00,70,$-73.50
2024-04-08,17:15:00,18302.0,SELL,3,0.02h,Break Even,$-1.50,$-75.00,$56052.50,70,$-75.00
2024-04-08,17:30:00,18311.5,BUY,3,0.02h,Stop Loss,$-9.00,$-84.00,$56043.50,70,$-84.00
2024-04-08,17:37:00,18291.0,SELL,3,0.02h,Stop Loss,$-9.00,$-93.00,$56034.50,70,$-93.00
2024-04-08,17:58:00,18303.5,BUY,3,0.02h,Stop Loss,$13.50,$-79.50,$56048.00,70,$-79.50
2024-04-08,18:32:00,18308.0,SELL,3,0.02h,Stop Loss,$-9.00,$-88.50,$56039.00,70,$-88.50
2024-04-08,18:56:00,18306.5,BUY,3,0.02h,Stop Loss,$12.00,$-76.50,$56051.00,70,$-76.50
2024-04-08,19:08:00,18292.5,SELL,3,0.02h,Break Even,$-1.50,$-78.00,$56049.50,70,$-78.00
2024-04-08,19:13:00,18308.25,BUY,3,0.02h,Stop Loss,$4.50,$-73.50,$56054.00,70,$-73.50
2024-04-08,19:23:00,18301.75,SELL,3,0.02h,Break Even,$-1.50,$-75.00,$56052.50,70,$-75.00
2024-04-08,19:30:00,18315.5,BUY,3,0.02h,Stop Loss,$3.00,$-72.00,$56055.50,70,$-72.00
2024-04-08,19:43:00,18302.75,SELL,3,0.02h,Stop Loss,$46.50,$-25.50,$56102.00,70,$-25.50
2024-04-08,20:04:00,18311.25,BUY,3,0.02h,Stop Loss,$-9.00,$-34.50,$56093.00,70,$-34.50
2024-04-08,20:30:00,18308.25,SELL,3,0.03h,Stop Loss,$4.50,$-30.00,$56097.50,70,$-30.00
2024-04-08,20:42:00,18310.25,BUY,3,0.05h,Stop Loss,$-9.00,$-39.00,$56088.50,70,$-39.00
2024-04-08,23:19:00,18309.75,SELL,3,0.02h,Stop Loss,$-9.00,$-48.00,$56079.50,70,$-48.00
2024-04-08,23:33:00,18313.5,BUY,3,0.02h,Stop Loss,$-9.00,$-57.00,$56070.50,70,$-57.00
2024-04-08,23:44:00,18306.5,SELL,3,0.02h,Stop Loss,$-9.00,$-66.00,$56061.50,70,$-66.00
,,,,,,,,,,,
2024-04-09,01:03:00,18297.0,BUY,3,0.02h,Break Even,$-1.50,$-1.50,$56060.00,71,$-1.50
2024-04-09,01:08:00,18294.0,SELL,3,0.02h,Stop Loss,$-9.00,$-10.50,$56051.00,71,$-10.50
2024-04-09,01:22:00,18297.25,BUY,3,0.02h,Stop Loss,$-9.00,$-19.50,$56042.00,71,$-19.50
2024-04-09,01:43:00,18296.0,SELL,3,0.02h,Break Even,$-1.50,$-21.00,$56040.50,71,$-21.00
2024-04-09,02:19:00,18294.25,BUY,3,0.03h,Break Even,$-1.50,$-22.50,$56039.00,71,$-22.50
2024-04-09,02:38:00,18291.5,SELL,3,0.02h,Break Even,$-1.50,$-24.00,$56037.50,71,$-24.00
2024-04-09,02:55:00,18294.0,BUY,3,0.05h,Stop Loss,$-9.00,$-33.00,$56028.50,71,$-33.00
2024-04-09,05:25:00,18316.75,SELL,3,0.03h,Break Even,$-1.50,$-34.50,$56027.00,71,$-34.50
2024-04-09,05:49:00,18317.5,BUY,3,0.05h,Break Even,$-1.50,$-36.00,$56025.50,71,$-36.00
2024-04-09,05:57:00,18312.25,SELL,3,0.02h,Stop Loss,$-9.00,$-45.00,$56016.50,71,$-45.00
2024-04-09,06:12:00,18316.75,BUY,3,0.02h,Break Even,$-1.50,$-46.50,$56015.00,71,$-46.50
2024-04-09,06:17:00,18312.5,SELL,3,0.02h,Stop Loss,$-9.00,$-55.50,$56006.00,71,$-55.50
2024-04-09,06:19:00,18316.5,BUY,3,0.02h,Stop Loss,$-9.00,$-64.50,$55997.00,71,$-64.50
2024-04-09,06:42:00,18316.0,SELL,3,0.02h,Stop Loss,$-9.00,$-73.50,$55988.00,71,$-73.50
2024-04-09,06:51:00,18319.75,BUY,3,0.02h,Stop Loss,$-9.00,$-82.50,$55979.00,71,$-82.50
2024-04-09,06:52:00,18318.5,SELL,3,0.07h,Stop Loss,$-9.00,$-91.50,$55970.00,71,$-91.50
2024-04-09,07:16:00,18320.75,BUY,3,0.02h,Stop Loss,$-9.00,$-100.50,$55961.00,71,$-100.50
2024-04-09,07:36:00,18316.0,SELL,3,0.02h,Stop Loss,$45.00,$-55.50,$56006.00,71,$-55.50
2024-04-09,08:14:00,18291.0,BUY,3,0.02h,Stop Loss,$-9.00,$-64.50,$55997.00,71,$-64.50
2024-04-09,08:46:00,18300.5,SELL,3,0.02h,Stop Loss,$10.50,$-54.00,$56007.50,71,$-54.00
2024-04-09,08:55:00,18304.25,BUY,3,0.02h,Stop Loss,$-9.00,$-63.00,$55998.50,71,$-63.00
2024-04-09,09:11:00,18298.75,SELL,3,0.02h,Break Even,$-1.50,$-64.50,$55997.00,71,$-64.50
2024-04-09,09:15:00,18304.5,BUY,3,0.02h,Break Even,$-1.50,$-66.00,$55995.50,71,$-66.00
2024-04-09,09:40:00,18311.75,SELL,3,0.02h,Stop Loss,$-9.00,$-75.00,$55986.50,71,$-75.00
2024-04-09,09:42:00,18316.0,BUY,3,0.02h,Stop Loss,$-9.00,$-84.00,$55977.50,71,$-84.00
2024-04-09,09:43:00,18313.5,SELL,3,0.02h,Stop Loss,$-9.00,$-93.00,$55968.50,71,$-93.00
2024-04-09,09:44:00,18319.75,BUY,3,0.02h,Stop Loss,$-9.00,$-102.00,$55959.50,71,$-102.00
2024-04-09,10:10:00,18320.25,SELL,3,0.02h,Stop Loss,$-9.00,$-111.00,$55950.50,71,$-111.00
2024-04-09,10:20:00,18324.0,BUY,3,0.02h,Break Even,$-1.50,$-112.50,$55949.00,71,$-112.50
2024-04-09,10:22:00,18320.0,SELL,3,0.02h,Stop Loss,$-9.00,$-121.50,$55940.00,71,$-121.50
2024-04-09,10:57:00,18282.0,BUY,3,0.02h,Break Even,$-1.50,$-123.00,$55938.50,71,$-123.00
2024-04-09,13:07:00,18356.25,SELL,3,0.02h,Break Even,$-1.50,$-124.50,$55937.00,71,$-124.50
2024-04-09,13:15:00,18369.75,BUY,3,0.02h,Stop Loss,$4.50,$-120.00,$55941.50,71,$-120.00
2024-04-09,13:36:00,18368.5,SELL,3,0.02h,Stop Loss,$27.00,$-93.00,$55968.50,71,$-93.00
2024-04-09,13:40:00,18390.25,BUY,3,0.02h,Stop Loss,$46.50,$-46.50,$56015.00,71,$-46.50
2024-04-09,13:49:00,18365.5,SELL,3,0.02h,Stop Loss,$94.50,$48.00,$56109.50,71,$48.00
2024-04-09,14:17:00,18362.5,BUY,3,0.02h,Stop Loss,$24.00,$72.00,$56133.50,71,$72.00
2024-04-09,14:21:00,18349.25,SELL,3,0.02h,Stop Loss,$-9.00,$63.00,$56124.50,71,$63.00
2024-04-09,14:23:00,18358.0,BUY,3,0.02h,Stop Loss,$7.50,$70.50,$56132.00,71,$70.50
2024-04-09,14:26:00,18346.5,SELL,3,0.02h,Stop Loss,$66.00,$136.50,$56198.00,71,$136.50
2024-04-09,15:05:00,18215.75,BUY,3,0.02h,Stop Loss,$34.50,$171.00,$56232.50,71,$171.00
2024-04-09,15:33:00,18221.75,SELL,3,0.02h,Stop Loss,$9.00,$180.00,$56241.50,71,$180.00
2024-04-09,15:43:00,18235.25,BUY,3,0.02h,Stop Loss,$94.50,$274.50,$56336.00,71,$274.50
2024-04-09,16:51:00,18288.5,SELL,3,0.02h,Stop Loss,$19.50,$294.00,$56355.50,71,$294.00
2024-04-09,17:08:00,18285.25,BUY,3,0.02h,Break Even,$-1.50,$292.50,$56354.00,71,$292.50
2024-04-09,17:17:00,18270.25,SELL,3,0.02h,Stop Loss,$-9.00,$283.50,$56345.00,71,$283.50
2024-04-09,17:22:00,18289.25,BUY,3,0.02h,Stop Loss,$21.00,$304.50,$56366.00,71,$304.50
2024-04-09,17:29:00,18272.25,SELL,3,0.02h,Stop Loss,$-9.00,$295.50,$56357.00,71,$295.50
2024-04-09,17:40:00,18288.25,BUY,3,0.02h,Stop Loss,$18.00,$313.50,$56375.00,71,$313.50
2024-04-09,17:43:00,18264.5,SELL,3,0.02h,Stop Loss,$-9.00,$304.50,$56366.00,71,$304.50
2024-04-09,18:13:00,18271.75,BUY,3,0.02h,Stop Loss,$-9.00,$295.50,$56357.00,71,$295.50
2024-04-09,18:30:00,18260.5,SELL,3,0.02h,Stop Loss,$58.50,$354.00,$56415.50,71,$354.00
2024-04-09,18:57:00,18259.75,BUY,3,0.02h,Stop Loss,$-9.00,$345.00,$56406.50,71,$345.00
2024-04-09,19:00:00,18252.25,SELL,3,0.02h,Stop Loss,$60.00,$405.00,$56466.50,71,$405.00
2024-04-09,19:20:00,18255.25,BUY,3,0.02h,Stop Loss,$12.00,$417.00,$56478.50,71,$417.00
2024-04-09,20:46:00,18383.25,SELL,3,0.02h,Break Even,$-1.50,$415.50,$56477.00,71,$415.50
2024-04-09,23:40:00,18375.0,BUY,3,0.02h,Stop Loss,$-9.00,$406.50,$56468.00,71,$406.50
2024-04-09,23:41:00,18373.0,SELL,3,0.10h,Break Even,$-1.50,$405.00,$56466.50,71,$405.00
,,,,,,,,,,,
2024-04-10,00:06:00,18373.5,BUY,3,0.02h,Stop Loss,$-9.00,$-9.00,$56457.50,72,$-9.00
2024-04-10,01:14:00,18378.25,SELL,3,0.02h,Stop Loss,$-9.00,$-18.00,$56448.50,72,$-18.00
2024-04-10,01:16:00,18382.75,BUY,3,0.02h,Break Even,$-1.50,$-19.50,$56447.00,72,$-19.50
2024-04-10,01:17:00,18379.75,SELL,3,0.02h,Break Even,$-1.50,$-21.00,$56445.50,72,$-21.00
2024-04-10,01:50:00,18375.0,BUY,3,0.23h,Stop Loss,$15.00,$-6.00,$56460.50,72,$-6.00
2024-04-10,02:11:00,18374.75,SELL,3,0.05h,Break Even,$-1.50,$-7.50,$56459.00,72,$-7.50
2024-04-10,02:21:00,18378.0,BUY,3,0.02h,Stop Loss,$-9.00,$-16.50,$56450.00,72,$-16.50
2024-04-10,02:49:00,18378.0,SELL,3,0.02h,Break Even,$-1.50,$-18.00,$56448.50,72,$-18.00
2024-04-10,02:59:00,18380.75,BUY,3,0.05h,Stop Loss,$-9.00,$-27.00,$56439.50,72,$-27.00
2024-04-10,03:37:00,18379.75,SELL,3,0.02h,Break Even,$-1.50,$-28.50,$56438.00,72,$-28.50
2024-04-10,04:02:00,18380.0,BUY,3,0.02h,Stop Loss,$-9.00,$-37.50,$56429.00,72,$-37.50
2024-04-10,04:54:00,18382.25,SELL,3,0.12h,Break Even,$-1.50,$-39.00,$56427.50,72,$-39.00
2024-04-10,05:05:00,18384.0,BUY,3,0.02h,Stop Loss,$-9.00,$-48.00,$56418.50,72,$-48.00
2024-04-10,05:08:00,18381.75,SELL,3,0.03h,Stop Loss,$-9.00,$-57.00,$56409.50,72,$-57.00
2024-04-10,05:12:00,18383.75,BUY,3,0.03h,Stop Loss,$-9.00,$-66.00,$56400.50,72,$-66.00
2024-04-10,05:21:00,18382.5,SELL,3,0.03h,Break Even,$-1.50,$-67.50,$56399.00,72,$-67.50
2024-04-10,05:31:00,18388.25,BUY,3,0.02h,Break Even,$-1.50,$-69.00,$56397.50,72,$-69.00
2024-04-10,05:44:00,18381.75,SELL,3,0.02h,Break Even,$-1.50,$-70.50,$56396.00,72,$-70.50
2024-04-10,06:09:00,18378.5,BUY,3,0.02h,Stop Loss,$-9.00,$-79.50,$56387.00,72,$-79.50
2024-04-10,06:17:00,18372.5,SELL,3,0.02h,Break Even,$-1.50,$-81.00,$56385.50,72,$-81.00
2024-04-10,06:26:00,18378.75,BUY,3,0.02h,Break Even,$-1.50,$-82.50,$56384.00,72,$-82.50
2024-04-10,06:37:00,18376.0,SELL,3,0.02h,Break Even,$-1.50,$-84.00,$56382.50,72,$-84.00
2024-04-10,06:38:00,18377.75,BUY,3,0.02h,Stop Loss,$-9.00,$-93.00,$56373.50,72,$-93.00
2024-04-10,06:41:00,18374.75,SELL,3,0.02h,Stop Loss,$-9.00,$-102.00,$56364.50,72,$-102.00
2024-04-10,06:46:00,18379.5,BUY,3,0.02h,Stop Loss,$-9.00,$-111.00,$56355.50,72,$-111.00
2024-04-10,06:58:00,18376.5,SELL,3,0.02h,Stop Loss,$-9.00,$-120.00,$56346.50,72,$-120.00
2024-04-10,07:02:00,18384.0,BUY,3,0.02h,Break Even,$-1.50,$-121.50,$56345.00,72,$-121.50
2024-04-10,07:08:00,18376.75,SELL,3,0.02h,Break Even,$-1.50,$-123.00,$56343.50,72,$-123.00
2024-04-10,07:11:00,18381.5,BUY,3,0.02h,Stop Loss,$-9.00,$-132.00,$56334.50,72,$-132.00
2024-04-10,07:12:00,18377.0,SELL,3,0.03h,Stop Loss,$-9.00,$-141.00,$56325.50,72,$-141.00
2024-04-10,07:14:00,18378.5,BUY,3,0.02h,Stop Loss,$6.00,$-135.00,$56331.50,72,$-135.00
2024-04-10,07:23:00,18375.75,SELL,3,0.02h,Stop Loss,$-9.00,$-144.00,$56322.50,72,$-144.00
2024-04-10,07:28:00,18384.0,BUY,3,0.02h,Stop Loss,$4.50,$-139.50,$56327.00,72,$-139.50
2024-04-10,07:41:00,18382.0,SELL,3,0.02h,Stop Loss,$-9.00,$-148.50,$56318.00,72,$-148.50
2024-04-10,07:42:00,18385.75,BUY,3,0.02h,Break Even,$-1.50,$-150.00,$56316.50,72,$-150.00
2024-04-10,08:05:00,18389.75,SELL,3,0.02h,Stop Loss,$-9.00,$-159.00,$56307.50,72,$-159.00
2024-04-10,08:06:00,18392.0,BUY,3,0.02h,Stop Loss,$-9.00,$-168.00,$56298.50,72,$-168.00
2024-04-10,08:08:00,18388.25,SELL,3,0.02h,Stop Loss,$25.50,$-142.50,$56324.00,72,$-142.50
2024-04-10,08:19:00,18390.5,BUY,3,0.02h,Break Even,$-1.50,$-144.00,$56322.50,72,$-144.00
2024-04-10,08:24:00,18387.25,SELL,3,0.02h,Stop Loss,$4.50,$-139.50,$56327.00,72,$-139.50
2024-04-10,08:29:00,18391.5,BUY,3,0.02h,Stop Loss,$-9.00,$-148.50,$56318.00,72,$-148.50
2024-04-10,08:48:00,18390.5,SELL,3,0.02h,Stop Loss,$-9.00,$-157.50,$56309.00,72,$-157.50
2024-04-10,08:49:00,18393.0,BUY,3,0.02h,Break Even,$-1.50,$-159.00,$56307.50,72,$-159.00
2024-04-10,09:07:00,18393.25,SELL,3,0.02h,Stop Loss,$-9.00,$-168.00,$56298.50,72,$-168.00
2024-04-10,10:36:00,18358.5,BUY,3,0.02h,Break Even,$-1.50,$-169.50,$56297.00,72,$-169.50
2024-04-10,11:26:00,18368.0,SELL,3,0.02h,Stop Loss,$-9.00,$-178.50,$56288.00,72,$-178.50
2024-04-10,11:33:00,18373.25,BUY,3,0.02h,Break Even,$-1.50,$-180.00,$56286.50,72,$-180.00
2024-04-10,11:56:00,18371.75,SELL,3,0.02h,Stop Loss,$-9.00,$-189.00,$56277.50,72,$-189.00
2024-04-10,12:01:00,18383.25,BUY,3,0.02h,Stop Loss,$9.00,$-180.00,$56286.50,72,$-180.00
2024-04-10,12:21:00,18381.0,SELL,3,0.02h,Stop Loss,$-9.00,$-189.00,$56277.50,72,$-189.00
2024-04-10,12:30:00,18424.0,BUY,3,0.02h,Stop Loss,$67.50,$-121.50,$56345.00,72,$-121.50
2024-04-10,12:31:00,18167.25,SELL,3,0.02h,Stop Loss,$285.00,$163.50,$56630.00,72,$163.50
2024-04-10,13:19:00,18129.25,BUY,3,0.02h,Stop Loss,$-9.00,$154.50,$56621.00,72,$154.50
2024-04-10,13:49:00,18139.5,SELL,3,0.02h,Stop Loss,$109.50,$264.00,$56730.50,72,$264.00
2024-04-10,13:52:00,18176.0,BUY,3,0.02h,Break Even,$-1.50,$262.50,$56729.00,72,$262.50
2024-04-10,14:07:00,18152.25,SELL,3,0.02h,Stop Loss,$-9.00,$253.50,$56720.00,72,$253.50
2024-04-10,14:08:00,18167.25,BUY,3,0.02h,Stop Loss,$85.50,$339.00,$56805.50,72,$339.00
2024-04-10,14:16:00,18151.75,SELL,3,0.02h,Break Even,$-1.50,$337.50,$56804.00,72,$337.50
2024-04-10,14:19:00,18184.0,BUY,3,0.02h,Stop Loss,$120.00,$457.50,$56924.00,72,$457.50
2024-04-10,14:50:00,18186.25,SELL,3,0.02h,Break Even,$-1.50,$456.00,$56922.50,72,$456.00
2024-04-10,15:27:00,18158.75,BUY,3,0.02h,Stop Loss,$73.50,$529.50,$56996.00,72,$529.50
2024-04-10,15:38:00,18144.0,SELL,3,0.02h,Stop Loss,$9.00,$538.50,$57005.00,72,$538.50
2024-04-10,16:04:00,18157.5,BUY,3,0.02h,Stop Loss,$18.00,$556.50,$57023.00,72,$556.50
2024-04-10,16:13:00,18136.0,SELL,3,0.02h,Stop Loss,$15.00,$571.50,$57038.00,72,$571.50
2024-04-10,16:27:00,18149.5,BUY,3,0.02h,Stop Loss,$21.00,$592.50,$57059.00,72,$592.50
2024-04-10,17:05:00,18143.75,SELL,3,0.02h,Stop Loss,$52.50,$645.00,$57111.50,72,$645.00
2024-04-10,17:21:00,18179.25,BUY,3,0.02h,Stop Loss,$100.50,$745.50,$57212.00,72,$745.50
2024-04-10,17:34:00,18139.75,SELL,3,0.02h,Stop Loss,$40.50,$786.00,$57252.50,72,$786.00
2024-04-10,17:57:00,18186.75,BUY,3,0.02h,Stop Loss,$99.00,$885.00,$57351.50,72,$885.00
2024-04-10,18:20:00,18159.75,SELL,3,0.02h,Stop Loss,$-9.00,$876.00,$57342.50,72,$876.00
2024-04-10,18:21:00,18173.75,BUY,3,0.02h,Stop Loss,$15.00,$891.00,$57357.50,72,$891.00
2024-04-10,18:23:00,18153.25,SELL,3,0.02h,Stop Loss,$69.00,$960.00,$57426.50,72,$960.00
2024-04-10,18:40:00,18171.0,BUY,3,0.02h,Break Even,$-1.50,$958.50,$57425.00,72,$958.50
2024-04-10,18:56:00,18142.25,SELL,3,0.02h,Stop Loss,$37.50,$996.00,$57462.50,72,$996.00
2024-04-10,19:13:00,18152.0,BUY,3,0.02h,Stop Loss,$94.50,$1090.50,$57557.00,72,$1090.50
2024-04-10,19:34:00,18153.0,SELL,3,0.02h,Stop Loss,$-9.00,$1081.50,$57548.00,72,$1081.50
2024-04-10,19:43:00,18195.0,BUY,3,0.02h,Stop Loss,$30.00,$1111.50,$57578.00,72,$1111.50
2024-04-10,20:02:00,18171.5,SELL,3,0.02h,Stop Loss,$12.00,$1123.50,$57590.00,72,$1123.50
2024-04-10,20:39:00,18173.5,BUY,3,0.03h,Break Even,$-1.50,$1122.00,$57588.50,72,$1122.00
2024-04-10,23:02:00,18161.5,SELL,3,0.02h,Stop Loss,$-9.00,$1113.00,$57579.50,72,$1113.00
2024-04-10,23:39:00,18160.5,BUY,3,0.02h,Stop Loss,$-9.00,$1104.00,$57570.50,72,$1104.00
2024-04-10,23:56:00,18155.0,SELL,3,0.02h,Stop Loss,$-9.00,$1095.00,$57561.50,72,$1095.00
,,,,,,,,,,,
2024-04-11,00:01:00,18161.25,BUY,3,0.02h,Break Even,$-1.50,$-1.50,$57560.00,73,$-1.50
2024-04-11,00:09:00,18152.75,SELL,3,0.02h,Break Even,$-1.50,$-3.00,$57558.50,73,$-3.00
2024-04-11,00:15:00,18160.25,BUY,3,0.02h,Break Even,$-1.50,$-4.50,$57557.00,73,$-4.50
2024-04-11,00:44:00,18164.5,SELL,3,0.02h,Stop Loss,$6.00,$1.50,$57563.00,73,$1.50
2024-04-11,01:02:00,18165.5,BUY,3,0.02h,Break Even,$-1.50,$0.00,$57561.50,73,$0.00
2024-04-11,01:21:00,18164.0,SELL,3,0.02h,Stop Loss,$-9.00,$-9.00,$57552.50,73,$-9.00
2024-04-11,01:36:00,18169.0,BUY,3,0.02h,Break Even,$-1.50,$-10.50,$57551.00,73,$-10.50
2024-04-11,02:42:00,18188.0,SELL,3,0.02h,Stop Loss,$-9.00,$-19.50,$57542.00,73,$-19.50
2024-04-11,02:43:00,18189.25,BUY,3,0.02h,Break Even,$-1.50,$-21.00,$57540.50,73,$-21.00
2024-04-11,02:56:00,18188.0,SELL,3,0.02h,Stop Loss,$-9.00,$-30.00,$57531.50,73,$-30.00
2024-04-11,03:10:00,18194.75,BUY,3,0.02h,Stop Loss,$-9.00,$-39.00,$57522.50,73,$-39.00
2024-04-11,03:55:00,18195.75,SELL,3,0.02h,Break Even,$-1.50,$-40.50,$57521.00,73,$-40.50
2024-04-11,04:00:00,18199.0,BUY,3,0.02h,Stop Loss,$-9.00,$-49.50,$57512.00,73,$-49.50
2024-04-11,04:12:00,18196.75,SELL,3,0.02h,Stop Loss,$-9.00,$-58.50,$57503.00,73,$-58.50
2024-04-11,04:21:00,18199.25,BUY,3,0.03h,Break Even,$-1.50,$-60.00,$57501.50,73,$-60.00
2024-04-11,05:33:00,18204.5,SELL,3,0.02h,Stop Loss,$-9.00,$-69.00,$57492.50,73,$-69.00
2024-04-11,05:51:00,18207.5,BUY,3,0.02h,Break Even,$-1.50,$-70.50,$57491.00,73,$-70.50
2024-04-11,06:00:00,18203.75,SELL,3,0.02h,Break Even,$-1.50,$-72.00,$57489.50,73,$-72.00
2024-04-11,06:21:00,18205.0,BUY,3,0.02h,Stop Loss,$3.00,$-69.00,$57492.50,73,$-69.00
2024-04-11,06:43:00,18199.75,SELL,3,0.02h,Stop Loss,$-9.00,$-78.00,$57483.50,73,$-78.00
2024-04-11,07:06:00,18203.5,BUY,3,0.02h,Stop Loss,$13.50,$-64.50,$57497.00,73,$-64.50
2024-04-11,07:19:00,18196.5,SELL,3,0.02h,Stop Loss,$-9.00,$-73.50,$57488.00,73,$-73.50
2024-04-11,07:23:00,18208.5,BUY,3,0.02h,Stop Loss,$-9.00,$-82.50,$57479.00,73,$-82.50
2024-04-11,07:24:00,18203.0,SELL,3,0.02h,Stop Loss,$12.00,$-70.50,$57491.00,73,$-70.50
2024-04-11,07:33:00,18207.25,BUY,3,0.02h,Stop Loss,$6.00,$-64.50,$57497.00,73,$-64.50
2024-04-11,07:37:00,18199.5,SELL,3,0.02h,Break Even,$-1.50,$-66.00,$57495.50,73,$-66.00
2024-04-11,07:59:00,18202.5,BUY,3,0.02h,Stop Loss,$-9.00,$-75.00,$57486.50,73,$-75.00
2024-04-11,08:16:00,18196.5,SELL,3,0.02h,Stop Loss,$-9.00,$-84.00,$57477.50,73,$-84.00
2024-04-11,08:19:00,18201.75,BUY,3,0.02h,Break Even,$-1.50,$-85.50,$57476.00,73,$-85.50
2024-04-11,08:25:00,18193.75,SELL,3,0.02h,Break Even,$-1.50,$-87.00,$57474.50,73,$-87.00
2024-04-11,08:44:00,18198.0,BUY,3,0.02h,Stop Loss,$-9.00,$-96.00,$57465.50,73,$-96.00
2024-04-11,08:46:00,18194.0,SELL,3,0.02h,Stop Loss,$13.50,$-82.50,$57479.00,73,$-82.50
2024-04-11,09:34:00,18165.25,BUY,3,0.02h,Stop Loss,$-9.00,$-91.50,$57470.00,73,$-91.50
2024-04-11,09:50:00,18159.0,SELL,3,0.02h,Break Even,$-1.50,$-93.00,$57468.50,73,$-93.00
2024-04-11,10:26:00,18153.75,BUY,3,0.02h,Break Even,$-1.50,$-94.50,$57467.00,73,$-94.50
2024-04-11,11:04:00,18158.25,SELL,3,0.02h,Stop Loss,$-9.00,$-103.50,$57458.00,73,$-103.50
2024-04-11,12:08:00,18135.5,BUY,3,0.02h,Break Even,$-1.50,$-105.00,$57456.50,73,$-105.00
2024-04-11,12:23:00,18127.5,SELL,3,0.02h,Stop Loss,$27.00,$-78.00,$57483.50,73,$-78.00
2024-04-11,12:31:00,18205.75,BUY,3,0.02h,Stop Loss,$34.50,$-43.50,$57518.00,73,$-43.50
2024-04-11,13:32:00,18231.75,SELL,3,0.02h,Stop Loss,$19.50,$-24.00,$57537.50,73,$-24.00
2024-04-11,13:53:00,18270.75,BUY,3,0.02h,Break Even,$-1.50,$-25.50,$57536.00,73,$-25.50
2024-04-11,14:02:00,18230.0,SELL,3,0.02h,Stop Loss,$7.50,$-18.00,$57543.50,73,$-18.00
2024-04-11,14:32:00,18238.75,BUY,3,0.02h,Break Even,$-1.50,$-19.50,$57542.00,73,$-19.50
2024-04-11,15:29:00,18246.75,SELL,3,0.02h,Break Even,$-1.50,$-21.00,$57540.50,73,$-21.00
2024-04-11,15:36:00,18259.5,BUY,3,0.02h,Break Even,$-1.50,$-22.50,$57539.00,73,$-22.50
2024-04-11,16:31:00,18295.75,SELL,3,0.02h,Stop Loss,$-9.00,$-31.50,$57530.00,73,$-31.50
2024-04-11,16:36:00,18307.75,BUY,3,0.02h,Break Even,$-1.50,$-33.00,$57528.50,73,$-33.00
2024-04-11,16:38:00,18302.5,SELL,3,0.02h,Stop Loss,$-9.00,$-42.00,$57519.50,73,$-42.00
2024-04-11,16:43:00,18310.0,BUY,3,0.02h,Stop Loss,$7.50,$-34.50,$57527.00,73,$-34.50
2024-04-11,18:52:00,18493.75,SELL,3,0.02h,Stop Loss,$28.50,$-6.00,$57555.50,73,$-6.00
2024-04-11,19:06:00,18501.5,BUY,3,0.02h,Break Even,$-1.50,$-7.50,$57554.00,73,$-7.50
2024-04-11,19:20:00,18488.0,SELL,3,0.02h,Break Even,$-1.50,$-9.00,$57552.50,73,$-9.00
2024-04-11,19:23:00,18502.25,BUY,3,0.02h,Stop Loss,$-9.00,$-18.00,$57543.50,73,$-18.00
2024-04-11,19:52:00,18499.0,SELL,3,0.02h,Stop Loss,$9.00,$-9.00,$57552.50,73,$-9.00
2024-04-11,20:27:00,18493.25,BUY,3,0.02h,Stop Loss,$-9.00,$-18.00,$57543.50,73,$-18.00
2024-04-11,20:41:00,18489.0,SELL,3,0.02h,Stop Loss,$-9.00,$-27.00,$57534.50,73,$-27.00
2024-04-11,23:01:00,18494.75,BUY,3,0.03h,Stop Loss,$4.50,$-22.50,$57539.00,73,$-22.50
2024-04-11,23:32:00,18491.0,SELL,3,0.02h,Stop Loss,$-9.00,$-31.50,$57530.00,73,$-31.50
,,,,,,,,,,,
2024-04-12,00:26:00,18485.5,BUY,3,0.02h,Break Even,$-1.50,$-1.50,$57528.50,74,$-1.50
2024-04-12,00:59:00,18493.0,SELL,3,0.03h,Break Even,$-1.50,$-3.00,$57527.00,74,$-3.00
2024-04-12,01:20:00,18491.0,BUY,3,0.02h,Break Even,$-1.50,$-4.50,$57525.50,74,$-4.50
2024-04-12,01:44:00,18487.75,SELL,3,0.02h,Break Even,$-1.50,$-6.00,$57524.00,74,$-6.00
2024-04-12,01:49:00,18495.5,BUY,3,0.02h,Break Even,$-1.50,$-7.50,$57522.50,74,$-7.50
2024-04-12,02:08:00,18492.0,SELL,3,0.02h,Stop Loss,$-9.00,$-16.50,$57513.50,74,$-16.50
2024-04-12,02:14:00,18496.25,BUY,3,0.02h,Stop Loss,$-9.00,$-25.50,$57504.50,74,$-25.50
2024-04-12,02:17:00,18491.5,SELL,3,0.02h,Stop Loss,$-9.00,$-34.50,$57495.50,74,$-34.50
2024-04-12,02:41:00,18494.5,BUY,3,0.02h,Stop Loss,$-9.00,$-43.50,$57486.50,74,$-43.50
2024-04-12,02:48:00,18491.75,SELL,3,0.02h,Break Even,$-1.50,$-45.00,$57485.00,74,$-45.00
2024-04-12,02:56:00,18493.25,BUY,3,0.08h,Stop Loss,$-9.00,$-54.00,$57476.00,74,$-54.00
2024-04-12,03:02:00,18492.25,SELL,3,0.02h,Stop Loss,$-9.00,$-63.00,$57467.00,74,$-63.00
2024-04-12,03:03:00,18494.0,BUY,3,0.03h,Stop Loss,$-9.00,$-72.00,$57458.00,74,$-72.00
2024-04-12,03:07:00,18492.25,SELL,3,0.05h,Break Even,$-1.50,$-73.50,$57456.50,74,$-73.50
2024-04-12,03:13:00,18493.75,BUY,3,0.02h,Stop Loss,$-9.00,$-82.50,$57447.50,74,$-82.50
2024-04-12,03:35:00,18494.0,SELL,3,0.02h,Stop Loss,$-9.00,$-91.50,$57438.50,74,$-91.50
2024-04-12,04:13:00,18491.25,BUY,3,0.13h,Stop Loss,$-9.00,$-100.50,$57429.50,74,$-100.50
2024-04-12,04:38:00,18489.25,SELL,3,0.05h,Break Even,$-1.50,$-102.00,$57428.00,74,$-102.00
2024-04-12,04:57:00,18489.25,BUY,3,0.03h,Stop Loss,$-9.00,$-111.00,$57419.00,74,$-111.00
2024-04-12,05:00:00,18486.0,SELL,3,0.02h,Stop Loss,$-9.00,$-120.00,$57410.00,74,$-120.00
2024-04-12,05:10:00,18490.0,BUY,3,0.02h,Stop Loss,$-9.00,$-129.00,$57401.00,74,$-129.00
2024-04-12,05:34:00,18490.0,SELL,3,0.02h,Break Even,$-1.50,$-130.50,$57399.50,74,$-130.50
2024-04-12,05:45:00,18493.75,BUY,3,0.02h,Stop Loss,$-9.00,$-139.50,$57390.50,74,$-139.50
2024-04-12,06:01:00,18485.75,SELL,3,0.02h,Break Even,$-1.50,$-141.00,$57389.00,74,$-141.00
2024-04-12,06:09:00,18495.0,BUY,3,0.02h,Stop Loss,$-9.00,$-150.00,$57380.00,74,$-150.00
2024-04-12,06:13:00,18487.25,SELL,3,0.02h,Break Even,$-1.50,$-151.50,$57378.50,74,$-151.50
2024-04-12,06:18:00,18492.75,BUY,3,0.02h,Break Even,$-1.50,$-153.00,$57377.00,74,$-153.00
2024-04-12,06:57:00,18496.75,SELL,3,0.02h,Break Even,$-1.50,$-154.50,$57375.50,74,$-154.50
2024-04-12,08:20:00,18473.25,BUY,3,0.02h,Stop Loss,$-9.00,$-163.50,$57366.50,74,$-163.50
2024-04-12,08:36:00,18465.5,SELL,3,0.02h,Stop Loss,$-9.00,$-172.50,$57357.50,74,$-172.50
2024-04-12,10:19:00,18420.5,BUY,3,0.02h,Stop Loss,$7.50,$-165.00,$57365.00,74,$-165.00
2024-04-12,10:24:00,18414.0,SELL,3,0.02h,Stop Loss,$-9.00,$-174.00,$57356.00,74,$-174.00
2024-04-12,10:27:00,18420.0,BUY,3,0.02h,Stop Loss,$-9.00,$-183.00,$57347.00,74,$-183.00
2024-04-12,10:28:00,18416.0,SELL,3,0.02h,Stop Loss,$3.00,$-180.00,$57350.00,74,$-180.00
2024-04-12,11:30:00,18389.25,BUY,3,0.02h,Stop Loss,$4.50,$-175.50,$57354.50,74,$-175.50
2024-04-12,12:14:00,18411.0,SELL,3,0.02h,Stop Loss,$46.50,$-129.00,$57401.00,74,$-129.00
2024-04-12,13:33:00,18320.5,BUY,3,0.02h,Stop Loss,$18.00,$-111.00,$57419.00,74,$-111.00
2024-04-12,13:39:00,18296.25,SELL,3,0.02h,Stop Loss,$-9.00,$-120.00,$57410.00,74,$-120.00
2024-04-12,13:40:00,18306.0,BUY,3,0.02h,Stop Loss,$4.50,$-115.50,$57414.50,74,$-115.50
2024-04-12,14:04:00,18292.0,SELL,3,0.02h,Break Even,$-1.50,$-117.00,$57413.00,74,$-117.00
2024-04-12,14:24:00,18303.25,BUY,3,0.02h,Break Even,$-1.50,$-118.50,$57411.50,74,$-118.50
2024-04-12,14:26:00,18291.0,SELL,3,0.02h,Stop Loss,$30.00,$-88.50,$57441.50,74,$-88.50
2024-04-12,15:18:00,18230.5,BUY,3,0.02h,Stop Loss,$72.00,$-16.50,$57513.50,74,$-16.50
2024-04-12,15:57:00,18254.25,SELL,3,0.02h,Stop Loss,$-9.00,$-25.50,$57504.50,74,$-25.50
2024-04-12,17:14:00,18169.25,BUY,3,0.02h,Stop Loss,$6.00,$-19.50,$57510.50,74,$-19.50
2024-04-12,17:22:00,18145.5,SELL,3,0.02h,Stop Loss,$30.00,$10.50,$57540.50,74,$10.50
2024-04-12,17:43:00,18160.5,BUY,3,0.02h,Stop Loss,$27.00,$37.50,$57567.50,74,$37.50
2024-04-12,18:02:00,18148.0,SELL,3,0.02h,Stop Loss,$9.00,$46.50,$57576.50,74,$46.50
2024-04-12,18:07:00,18168.5,BUY,3,0.02h,Stop Loss,$45.00,$91.50,$57621.50,74,$91.50
2024-04-12,18:26:00,18162.5,SELL,3,0.02h,Break Even,$-1.50,$90.00,$57620.00,74,$90.00
2024-04-12,19:25:00,18147.75,BUY,3,0.02h,Stop Loss,$28.50,$118.50,$57648.50,74,$118.50
2024-04-12,20:48:00,18185.25,SELL,3,0.02h,Break Even,$-1.50,$117.00,$57647.00,74,$117.00
,,,,,,,,,,,
2024-04-15,00:00:00,18237.75,BUY,3,0.02h,Stop Loss,$40.50,$40.50,$57687.50,75,$40.50
2024-04-15,00:21:00,18196.0,SELL,3,0.02h,Break Even,$-1.50,$39.00,$57686.00,75,$39.00
2024-04-15,00:27:00,18226.25,BUY,3,0.02h,Break Even,$-1.50,$37.50,$57684.50,75,$37.50
2024-04-15,00:54:00,18225.0,SELL,3,0.02h,Stop Loss,$-9.00,$28.50,$57675.50,75,$28.50
2024-04-15,01:35:00,18216.75,BUY,3,0.02h,Stop Loss,$-9.00,$19.50,$57666.50,75,$19.50
2024-04-15,01:48:00,18206.0,SELL,3,0.02h,Stop Loss,$-9.00,$10.50,$57657.50,75,$10.50
2024-04-15,01:51:00,18218.75,BUY,3,0.02h,Stop Loss,$22.50,$33.00,$57680.00,75,$33.00
2024-04-15,02:30:00,18226.0,SELL,3,0.02h,Stop Loss,$-9.00,$24.00,$57671.00,75,$24.00
2024-04-15,02:31:00,18228.0,BUY,3,0.02h,Stop Loss,$-9.00,$15.00,$57662.00,75,$15.00
2024-04-15,02:32:00,18226.75,SELL,3,0.02h,Stop Loss,$3.00,$18.00,$57665.00,75,$18.00
2024-04-15,02:43:00,18229.25,BUY,3,0.02h,Stop Loss,$-9.00,$9.00,$57656.00,75,$9.00
2024-04-15,02:45:00,18224.0,SELL,3,0.02h,Break Even,$-1.50,$7.50,$57654.50,75,$7.50
2024-04-15,03:24:00,18221.25,BUY,3,0.02h,Stop Loss,$-9.00,$-1.50,$57645.50,75,$-1.50
2024-04-15,04:00:00,18230.25,SELL,3,0.02h,Stop Loss,$-9.00,$-10.50,$57636.50,75,$-10.50
2024-04-15,04:04:00,18235.25,BUY,3,0.02h,Stop Loss,$-9.00,$-19.50,$57627.50,75,$-19.50
2024-04-15,04:10:00,18231.5,SELL,3,0.02h,Break Even,$-1.50,$-21.00,$57626.00,75,$-21.00
2024-04-15,04:25:00,18233.75,BUY,3,0.02h,Break Even,$-1.50,$-22.50,$57624.50,75,$-22.50
2024-04-15,04:28:00,18230.5,SELL,3,0.02h,Break Even,$-1.50,$-24.00,$57623.00,75,$-24.00
2024-04-15,04:37:00,18233.0,BUY,3,0.02h,Stop Loss,$-9.00,$-33.00,$57614.00,75,$-33.00
2024-04-15,05:31:00,18250.25,SELL,3,0.02h,Stop Loss,$-9.00,$-42.00,$57605.00,75,$-42.00
2024-04-15,05:54:00,18253.5,BUY,3,0.02h,Stop Loss,$6.00,$-36.00,$57611.00,75,$-36.00
2024-04-15,06:06:00,18246.0,SELL,3,0.02h,Stop Loss,$-9.00,$-45.00,$57602.00,75,$-45.00
2024-04-15,06:12:00,18257.25,BUY,3,0.02h,Break Even,$-1.50,$-46.50,$57600.50,75,$-46.50
2024-04-15,06:56:00,18265.0,SELL,3,0.02h,Stop Loss,$-9.00,$-55.50,$57591.50,75,$-55.50
2024-04-15,06:58:00,18268.75,BUY,3,0.02h,Break Even,$-1.50,$-57.00,$57590.00,75,$-57.00
2024-04-15,07:00:00,18260.5,SELL,3,0.02h,Stop Loss,$-9.00,$-66.00,$57581.00,75,$-66.00
2024-04-15,07:01:00,18272.0,BUY,3,0.02h,Stop Loss,$28.50,$-37.50,$57609.50,75,$-37.50
2024-04-15,07:16:00,18262.25,SELL,3,0.02h,Stop Loss,$18.00,$-19.50,$57627.50,75,$-19.50
2024-04-15,07:21:00,18276.5,BUY,3,0.02h,Stop Loss,$-9.00,$-28.50,$57618.50,75,$-28.50
2024-04-15,07:22:00,18268.5,SELL,3,0.02h,Stop Loss,$52.50,$24.00,$57671.00,75,$24.00
2024-04-15,07:41:00,18267.75,BUY,3,0.02h,Stop Loss,$-9.00,$15.00,$57662.00,75,$15.00
2024-04-15,07:45:00,18253.75,SELL,3,0.02h,Stop Loss,$33.00,$48.00,$57695.00,75,$48.00
2024-04-15,07:51:00,18267.5,BUY,3,0.02h,Stop Loss,$9.00,$57.00,$57704.00,75,$57.00
2024-04-15,08:27:00,18275.25,SELL,3,0.02h,Stop Loss,$15.00,$72.00,$57719.00,75,$72.00
2024-04-15,08:36:00,18281.75,BUY,3,0.02h,Break Even,$-1.50,$70.50,$57717.50,75,$70.50
2024-04-15,08:59:00,18275.75,SELL,3,0.02h,Break Even,$-1.50,$69.00,$57716.00,75,$69.00
2024-04-15,09:01:00,18281.75,BUY,3,0.02h,Break Even,$-1.50,$67.50,$57714.50,75,$67.50
2024-04-15,09:15:00,18276.0,SELL,3,0.02h,Stop Loss,$-9.00,$58.50,$57705.50,75,$58.50
2024-04-15,09:42:00,18275.25,BUY,3,0.02h,Break Even,$-1.50,$57.00,$57704.00,75,$57.00
2024-04-15,09:54:00,18266.0,SELL,3,0.02h,Stop Loss,$-9.00,$48.00,$57695.00,75,$48.00
2024-04-15,10:05:00,18274.0,BUY,3,0.02h,Break Even,$-1.50,$46.50,$57693.50,75,$46.50
2024-04-15,10:24:00,18271.25,SELL,3,0.02h,Break Even,$-1.50,$45.00,$57692.00,75,$45.00
2024-04-15,10:35:00,18276.0,BUY,3,0.02h,Stop Loss,$-9.00,$36.00,$57683.00,75,$36.00
2024-04-15,11:04:00,18272.75,SELL,3,0.02h,Stop Loss,$-9.00,$27.00,$57674.00,75,$27.00
2024-04-15,11:12:00,18281.25,BUY,3,0.02h,Break Even,$-1.50,$25.50,$57672.50,75,$25.50
2024-04-15,11:56:00,18285.5,SELL,3,0.02h,Break Even,$-1.50,$24.00,$57671.00,75,$24.00
2024-04-15,12:04:00,18293.5,BUY,3,0.02h,Stop Loss,$-9.00,$15.00,$57662.00,75,$15.00
2024-04-15,12:32:00,18280.75,SELL,3,0.02h,Stop Loss,$-9.00,$6.00,$57653.00,75,$6.00
2024-04-15,12:35:00,18311.0,BUY,3,0.02h,Stop Loss,$115.50,$121.50,$57768.50,75,$121.50
2024-04-15,13:30:00,18335.5,SELL,3,0.02h,Stop Loss,$198.00,$319.50,$57966.50,75,$319.50
2024-04-15,13:54:00,18322.0,BUY,3,0.02h,Break Even,$-1.50,$318.00,$57965.00,75,$318.00
2024-04-15,14:06:00,18297.25,SELL,3,0.02h,Stop Loss,$39.00,$357.00,$58004.00,75,$357.00
2024-04-15,15:29:00,18193.0,BUY,3,0.02h,Break Even,$-1.50,$355.50,$58002.50,75,$355.50
2024-04-15,15:48:00,18185.25,SELL,3,0.02h,Break Even,$-1.50,$354.00,$58001.00,75,$354.00
2024-04-15,15:52:00,18206.0,BUY,3,0.02h,Stop Loss,$34.50,$388.50,$58035.50,75,$388.50
2024-04-15,16:17:00,18204.0,SELL,3,0.02h,Stop Loss,$37.50,$426.00,$58073.00,75,$426.00
2024-04-15,17:05:00,18110.75,BUY,3,0.02h,Stop Loss,$52.50,$478.50,$58125.50,75,$478.50
2024-04-15,17:15:00,18099.25,SELL,3,0.02h,Stop Loss,$15.00,$493.50,$58140.50,75,$493.50
2024-04-15,18:28:00,17905.0,BUY,3,0.02h,Break Even,$-1.50,$492.00,$58139.00,75,$492.00
2024-04-15,18:30:00,17891.75,SELL,3,0.02h,Stop Loss,$18.00,$510.00,$58157.00,75,$510.00
2024-04-15,18:31:00,17902.5,BUY,3,0.02h,Stop Loss,$21.00,$531.00,$58178.00,75,$531.00
2024-04-15,18:46:00,17893.75,SELL,3,0.02h,Stop Loss,$-9.00,$522.00,$58169.00,75,$522.00
2024-04-15,19:25:00,17878.75,BUY,3,0.02h,Stop Loss,$15.00,$537.00,$58184.00,75,$537.00
2024-04-15,19:29:00,17864.25,SELL,3,0.02h,Stop Loss,$22.50,$559.50,$58206.50,75,$559.50
2024-04-15,19:32:00,17883.75,BUY,3,0.02h,Stop Loss,$25.50,$585.00,$58232.00,75,$585.00
2024-04-15,20:01:00,17864.25,SELL,3,0.02h,Stop Loss,$7.50,$592.50,$58239.50,75,$592.50
2024-04-15,20:54:00,17862.5,BUY,3,0.02h,Break Even,$-1.50,$591.00,$58238.00,75,$591.00
2024-04-15,23:17:00,17858.5,SELL,3,0.02h,Stop Loss,$57.00,$648.00,$58295.00,75,$648.00
2024-04-15,23:29:00,17869.0,BUY,3,0.02h,Stop Loss,$-9.00,$639.00,$58286.00,75,$639.00
2024-04-15,23:31:00,17865.75,SELL,3,0.02h,Break Even,$-1.50,$637.50,$58284.50,75,$637.50
2024-04-15,23:32:00,17870.75,BUY,3,0.02h,Break Even,$-1.50,$636.00,$58283.00,75,$636.00
2024-04-15,23:57:00,17870.25,SELL,3,0.02h,Break Even,$-1.50,$634.50,$58281.50,75,$634.50
,,,,,,,,,,,
2024-04-16,00:03:00,17879.0,BUY,3,0.02h,Stop Loss,$30.00,$30.00,$58311.50,76,$30.00
2024-04-16,00:24:00,17876.0,SELL,3,0.02h,Stop Loss,$-9.00,$21.00,$58302.50,76,$21.00
2024-04-16,00:28:00,17885.25,BUY,3,0.02h,Stop Loss,$7.50,$28.50,$58310.00,76,$28.50
2024-04-16,00:40:00,17882.5,SELL,3,0.02h,Stop Loss,$-9.00,$19.50,$58301.00,76,$19.50
2024-04-16,00:41:00,17889.25,BUY,3,0.02h,Break Even,$-1.50,$18.00,$58299.50,76,$18.00
2024-04-16,00:52:00,17883.5,SELL,3,0.02h,Break Even,$-1.50,$16.50,$58298.00,76,$16.50
2024-04-16,01:27:00,17873.5,BUY,3,0.02h,Stop Loss,$-9.00,$7.50,$58289.00,76,$7.50
2024-04-16,01:28:00,17869.5,SELL,3,0.02h,Stop Loss,$-9.00,$-1.50,$58280.00,76,$-1.50
2024-04-16,01:29:00,17870.75,BUY,3,0.02h,Break Even,$-1.50,$-3.00,$58278.50,76,$-3.00
2024-04-16,01:30:00,17870.0,SELL,3,0.02h,Stop Loss,$-9.00,$-12.00,$58269.50,76,$-12.00
2024-04-16,01:31:00,17874.0,BUY,3,0.02h,Stop Loss,$-9.00,$-21.00,$58260.50,76,$-21.00
2024-04-16,01:44:00,17868.0,SELL,3,0.02h,Stop Loss,$-9.00,$-30.00,$58251.50,76,$-30.00
2024-04-16,01:45:00,17873.5,BUY,3,0.02h,Stop Loss,$10.50,$-19.50,$58262.00,76,$-19.50
2024-04-16,01:58:00,17870.5,SELL,3,0.02h,Break Even,$-1.50,$-21.00,$58260.50,76,$-21.00
2024-04-16,02:56:00,17835.0,BUY,3,0.02h,Break Even,$-1.50,$-22.50,$58259.00,76,$-22.50
2024-04-16,03:05:00,17828.75,SELL,3,0.02h,Stop Loss,$3.00,$-19.50,$58262.00,76,$-19.50
2024-04-16,03:22:00,17834.75,BUY,3,0.02h,Stop Loss,$-9.00,$-28.50,$58253.00,76,$-28.50
2024-04-16,03:32:00,17827.5,SELL,3,0.02h,Break Even,$-1.50,$-30.00,$58251.50,76,$-30.00
2024-04-16,03:48:00,17834.5,BUY,3,0.02h,Break Even,$-1.50,$-31.50,$58250.00,76,$-31.50
2024-04-16,04:18:00,17836.5,SELL,3,0.02h,Stop Loss,$-9.00,$-40.50,$58241.00,76,$-40.50
2024-04-16,04:39:00,17845.0,BUY,3,0.02h,Stop Loss,$-9.00,$-49.50,$58232.00,76,$-49.50
2024-04-16,04:46:00,17832.5,SELL,3,0.02h,Stop Loss,$-9.00,$-58.50,$58223.00,76,$-58.50
2024-04-16,04:50:00,17841.25,BUY,3,0.02h,Break Even,$-1.50,$-60.00,$58221.50,76,$-60.00
2024-04-16,05:50:00,17865.5,SELL,3,0.02h,Stop Loss,$-9.00,$-69.00,$58212.50,76,$-69.00
2024-04-16,05:52:00,17869.75,BUY,3,0.02h,Stop Loss,$-9.00,$-78.00,$58203.50,76,$-78.00
2024-04-16,06:00:00,17863.25,SELL,3,0.02h,Break Even,$-1.50,$-79.50,$58202.00,76,$-79.50
2024-04-16,06:45:00,17849.0,BUY,3,0.02h,Break Even,$-1.50,$-81.00,$58200.50,76,$-81.00
2024-04-16,06:54:00,17844.0,SELL,3,0.02h,Stop Loss,$-9.00,$-90.00,$58191.50,76,$-90.00
2024-04-16,07:02:00,17854.25,BUY,3,0.02h,Stop Loss,$-9.00,$-99.00,$58182.50,76,$-99.00
2024-04-16,07:36:00,17859.25,SELL,3,0.02h,Break Even,$-1.50,$-100.50,$58181.00,76,$-100.50
2024-04-16,07:39:00,17868.5,BUY,3,0.02h,Stop Loss,$7.50,$-93.00,$58188.50,76,$-93.00
2024-04-16,07:48:00,17855.25,SELL,3,0.02h,Stop Loss,$7.50,$-85.50,$58196.00,76,$-85.50
2024-04-16,07:58:00,17865.5,BUY,3,0.02h,Stop Loss,$33.00,$-52.50,$58229.00,76,$-52.50
2024-04-16,08:21:00,17860.75,SELL,3,0.02h,Break Even,$-1.50,$-54.00,$58227.50,76,$-54.00
2024-04-16,08:36:00,17876.75,BUY,3,0.02h,Break Even,$-1.50,$-55.50,$58226.00,76,$-55.50
2024-04-16,08:44:00,17862.25,SELL,3,0.02h,Break Even,$-1.50,$-57.00,$58224.50,76,$-57.00
2024-04-16,08:57:00,17874.75,BUY,3,0.02h,Stop Loss,$-9.00,$-66.00,$58215.50,76,$-66.00
2024-04-16,09:02:00,17862.5,SELL,3,0.02h,Break Even,$-1.50,$-67.50,$58214.00,76,$-67.50
2024-04-16,09:06:00,17872.25,BUY,3,0.02h,Break Even,$-1.50,$-69.00,$58212.50,76,$-69.00
2024-04-16,09:15:00,17865.5,SELL,3,0.02h,Stop Loss,$4.50,$-64.50,$58217.00,76,$-64.50
2024-04-16,10:34:00,17832.5,BUY,3,0.02h,Stop Loss,$48.00,$-16.50,$58265.00,76,$-16.50
2024-04-16,12:05:00,17896.5,SELL,3,0.02h,Stop Loss,$10.50,$-6.00,$58275.50,76,$-6.00
2024-04-16,12:33:00,17896.0,BUY,3,0.02h,Stop Loss,$-9.00,$-15.00,$58266.50,76,$-15.00
2024-04-16,12:58:00,17894.75,SELL,3,0.02h,Break Even,$-1.50,$-16.50,$58265.00,76,$-16.50
2024-04-16,13:55:00,17867.25,BUY,3,0.02h,Stop Loss,$39.00,$22.50,$58304.00,76,$22.50
2024-04-16,14:25:00,17887.0,SELL,3,0.02h,Stop Loss,$24.00,$46.50,$58328.00,76,$46.50
2024-04-16,14:51:00,17868.75,BUY,3,0.02h,Break Even,$-1.50,$45.00,$58326.50,76,$45.00
2024-04-16,14:52:00,17864.0,SELL,3,0.02h,Stop Loss,$-9.00,$36.00,$58317.50,76,$36.00
2024-04-16,14:53:00,17872.25,BUY,3,0.02h,Stop Loss,$43.50,$79.50,$58361.00,76,$79.50
2024-04-16,15:01:00,17861.25,SELL,3,0.02h,Stop Loss,$39.00,$118.50,$58400.00,76,$118.50
2024-04-16,15:04:00,17878.25,BUY,3,0.02h,Stop Loss,$7.50,$126.00,$58407.50,76,$126.00
2024-04-16,15:40:00,17884.75,SELL,3,0.02h,Stop Loss,$-9.00,$117.00,$58398.50,76,$117.00
2024-04-16,15:43:00,17904.25,BUY,3,0.02h,Break Even,$-1.50,$115.50,$58397.00,76,$115.50
2024-04-16,16:01:00,17877.0,SELL,3,0.02h,Stop Loss,$60.00,$175.50,$58457.00,76,$175.50
2024-04-16,16:12:00,17906.5,BUY,3,0.02h,Break Even,$-1.50,$174.00,$58455.50,76,$174.00
2024-04-16,16:34:00,17904.75,SELL,3,0.02h,Stop Loss,$19.50,$193.50,$58475.00,76,$193.50
2024-04-16,16:42:00,17917.25,BUY,3,0.02h,Break Even,$-1.50,$192.00,$58473.50,76,$192.00
2024-04-16,16:45:00,17897.5,SELL,3,0.02h,Stop Loss,$-9.00,$183.00,$58464.50,76,$183.00
2024-04-16,16:48:00,17913.75,BUY,3,0.02h,Stop Loss,$33.00,$216.00,$58497.50,76,$216.00
2024-04-16,17:02:00,17902.25,SELL,3,0.02h,Stop Loss,$22.50,$238.50,$58520.00,76,$238.50
2024-04-16,17:10:00,17916.5,BUY,3,0.02h,Stop Loss,$3.00,$241.50,$58523.00,76,$241.50
2024-04-16,17:31:00,17847.25,SELL,3,0.02h,Stop Loss,$73.50,$315.00,$58596.50,76,$315.00
2024-04-16,17:44:00,17905.75,BUY,3,0.02h,Break Even,$-1.50,$313.50,$58595.00,76,$313.50
2024-04-16,17:48:00,17881.25,SELL,3,0.02h,Stop Loss,$42.00,$355.50,$58637.00,76,$355.50
2024-04-16,18:05:00,17904.75,BUY,3,0.02h,Stop Loss,$22.50,$378.00,$58659.50,76,$378.00
2024-04-16,18:19:00,17884.75,SELL,3,0.02h,Break Even,$-1.50,$376.50,$58658.00,76,$376.50
2024-04-16,18:39:00,17891.75,BUY,3,0.02h,Stop Loss,$25.50,$402.00,$58683.50,76,$402.00
2024-04-16,19:17:00,17912.75,SELL,3,0.02h,Break Even,$-1.50,$400.50,$58682.00,76,$400.50
2024-04-16,19:23:00,17933.5,BUY,3,0.02h,Stop Loss,$39.00,$439.50,$58721.00,76,$439.50
2024-04-16,19:34:00,17915.25,SELL,3,0.02h,Stop Loss,$132.00,$571.50,$58853.00,76,$571.50
2024-04-16,20:33:00,17887.25,BUY,3,0.02h,Stop Loss,$-9.00,$562.50,$58844.00,76,$562.50
,,,,,,,,,,,
2024-04-17,00:05:00,17925.0,SELL,3,0.02h,Break Even,$-1.50,$-1.50,$58842.50,77,$-1.50
2024-04-17,00:51:00,17908.0,BUY,3,0.02h,Break Even,$-1.50,$-3.00,$58841.00,77,$-3.00
2024-04-17,01:36:00,17912.75,SELL,3,0.02h,Stop Loss,$-9.00,$-12.00,$58832.00,77,$-12.00
2024-04-17,01:52:00,17919.5,BUY,3,0.02h,Stop Loss,$12.00,$0.00,$58844.00,77,$0.00
2024-04-17,03:10:00,17928.0,SELL,3,0.02h,Break Even,$-1.50,$-1.50,$58842.50,77,$-1.50
2024-04-17,03:13:00,17931.75,BUY,3,0.05h,Stop Loss,$-9.00,$-10.50,$58833.50,77,$-10.50
2024-04-17,03:21:00,17928.0,SELL,3,0.02h,Stop Loss,$-9.00,$-19.50,$58824.50,77,$-19.50
2024-04-17,03:27:00,17933.75,BUY,3,0.03h,Stop Loss,$-9.00,$-28.50,$58815.50,77,$-28.50
2024-04-17,03:34:00,17928.5,SELL,3,0.02h,Stop Loss,$-9.00,$-37.50,$58806.50,77,$-37.50
2024-04-17,03:42:00,17932.75,BUY,3,0.02h,Stop Loss,$-9.00,$-46.50,$58797.50,77,$-46.50
2024-04-17,03:45:00,17927.75,SELL,3,0.03h,Stop Loss,$-9.00,$-55.50,$58788.50,77,$-55.50
2024-04-17,03:52:00,17931.75,BUY,3,0.03h,Break Even,$-1.50,$-57.00,$58787.00,77,$-57.00
2024-04-17,03:59:00,17929.25,SELL,3,0.03h,Stop Loss,$-9.00,$-66.00,$58778.00,77,$-66.00
2024-04-17,04:01:00,17931.5,BUY,3,0.03h,Stop Loss,$-9.00,$-75.00,$58769.00,77,$-75.00
2024-04-17,04:04:00,17929.5,SELL,3,0.02h,Break Even,$-1.50,$-76.50,$58767.50,77,$-76.50
2024-04-17,04:22:00,17933.0,BUY,3,0.02h,Stop Loss,$-9.00,$-85.50,$58758.50,77,$-85.50
2024-04-17,04:30:00,17929.5,SELL,3,0.02h,Break Even,$-1.50,$-87.00,$58757.00,77,$-87.00
2024-04-17,04:50:00,17930.0,BUY,3,0.02h,Break Even,$-1.50,$-88.50,$58755.50,77,$-88.50
2024-04-17,05:01:00,17915.25,SELL,3,0.02h,Stop Loss,$15.00,$-73.50,$58770.50,77,$-73.50
2024-04-17,06:29:00,17830.75,BUY,3,0.02h,Break Even,$-1.50,$-75.00,$58769.00,77,$-75.00
2024-04-17,06:58:00,17831.25,SELL,3,0.02h,Stop Loss,$4.50,$-70.50,$58773.50,77,$-70.50
2024-04-17,07:04:00,17844.75,BUY,3,0.02h,Stop Loss,$42.00,$-28.50,$58815.50,77,$-28.50
2024-04-17,07:34:00,17844.75,SELL,3,0.02h,Stop Loss,$19.50,$-9.00,$58835.00,77,$-9.00
2024-04-17,07:43:00,17858.75,BUY,3,0.02h,Stop Loss,$30.00,$21.00,$58865.00,77,$21.00
2024-04-17,08:10:00,17866.0,SELL,3,0.02h,Break Even,$-1.50,$19.50,$58863.50,77,$19.50
2024-04-17,08:13:00,17879.5,BUY,3,0.02h,Stop Loss,$6.00,$25.50,$58869.50,77,$25.50
2024-04-17,09:01:00,17893.75,SELL,3,0.02h,Stop Loss,$45.00,$70.50,$58914.50,77,$70.50
2024-04-17,09:33:00,17903.75,BUY,3,0.02h,Stop Loss,$-9.00,$61.50,$58905.50,77,$61.50
2024-04-17,09:35:00,17894.0,SELL,3,0.02h,Stop Loss,$-9.00,$52.50,$58896.50,77,$52.50
2024-04-17,09:37:00,17899.5,BUY,3,0.02h,Stop Loss,$-9.00,$43.50,$58887.50,77,$43.50
2024-04-17,10:54:00,17926.75,SELL,3,0.02h,Stop Loss,$-9.00,$34.50,$58878.50,77,$34.50
2024-04-17,11:07:00,17934.25,BUY,3,0.02h,Break Even,$-1.50,$33.00,$58877.00,77,$33.00
2024-04-17,11:16:00,17928.25,SELL,3,0.02h,Stop Loss,$15.00,$48.00,$58892.00,77,$48.00
2024-04-17,11:35:00,17926.5,BUY,3,0.02h,Stop Loss,$-9.00,$39.00,$58883.00,77,$39.00
2024-04-17,11:38:00,17919.0,SELL,3,0.02h,Stop Loss,$-9.00,$30.00,$58874.00,77,$30.00
2024-04-17,11:49:00,17924.75,BUY,3,0.02h,Stop Loss,$-9.00,$21.00,$58865.00,77,$21.00
2024-04-17,11:52:00,17914.75,SELL,3,0.02h,Stop Loss,$-9.00,$12.00,$58856.00,77,$12.00
2024-04-17,12:17:00,17923.25,BUY,3,0.02h,Stop Loss,$4.50,$16.50,$58860.50,77,$16.50
2024-04-17,12:26:00,17899.25,SELL,3,0.02h,Stop Loss,$-9.00,$7.50,$58851.50,77,$7.50
2024-04-17,12:34:00,17916.5,BUY,3,0.02h,Stop Loss,$-9.00,$-1.50,$58842.50,77,$-1.50
2024-04-17,13:33:00,17945.75,SELL,3,0.02h,Stop Loss,$39.00,$37.50,$58881.50,77,$37.50
2024-04-17,14:49:00,17858.25,BUY,3,0.02h,Stop Loss,$-9.00,$28.50,$58872.50,77,$28.50
2024-04-17,14:52:00,17811.0,SELL,3,0.02h,Stop Loss,$133.50,$162.00,$59006.00,77,$162.00
2024-04-17,15:04:00,17839.25,BUY,3,0.02h,Stop Loss,$48.00,$210.00,$59054.00,77,$210.00
2024-04-17,15:11:00,17815.75,SELL,3,0.02h,Break Even,$-1.50,$208.50,$59052.50,77,$208.50
2024-04-17,17:04:00,17668.75,BUY,3,0.02h,Break Even,$-1.50,$207.00,$59051.00,77,$207.00
2024-04-17,17:48:00,17704.5,SELL,3,0.02h,Stop Loss,$9.00,$216.00,$59060.00,77,$216.00
2024-04-17,17:49:00,17712.25,BUY,3,0.02h,Stop Loss,$52.50,$268.50,$59112.50,77,$268.50
2024-04-17,18:12:00,17712.75,SELL,3,0.02h,Stop Loss,$-9.00,$259.50,$59103.50,77,$259.50
2024-04-17,18:42:00,17741.25,BUY,3,0.02h,Stop Loss,$178.50,$438.00,$59282.00,77,$438.00
2024-04-17,18:55:00,17706.5,SELL,3,0.02h,Stop Loss,$75.00,$513.00,$59357.00,77,$513.00
2024-04-17,19:45:00,17686.25,BUY,3,0.02h,Stop Loss,$-9.00,$504.00,$59348.00,77,$504.00
2024-04-17,19:59:00,17678.0,SELL,3,0.02h,Stop Loss,$147.00,$651.00,$59495.00,77,$651.00
2024-04-17,20:30:00,17664.25,BUY,3,0.02h,Stop Loss,$-9.00,$642.00,$59486.00,77,$642.00
2024-04-17,20:44:00,17661.0,SELL,3,0.02h,Stop Loss,$-9.00,$633.00,$59477.00,77,$633.00
2024-04-17,20:59:00,17665.0,BUY,3,0.02h,Stop Loss,$-9.00,$624.00,$59468.00,77,$624.00
2024-04-17,23:26:00,17677.5,SELL,3,0.02h,Break Even,$-1.50,$622.50,$59466.50,77,$622.50
2024-04-17,23:32:00,17680.5,BUY,3,0.02h,Break Even,$-1.50,$621.00,$59465.00,77,$621.00
,,,,,,,,,,,
2024-04-18,00:05:00,17680.75,SELL,3,0.02h,Stop Loss,$-9.00,$-9.00,$59456.00,78,$-9.00
2024-04-18,00:06:00,17685.5,BUY,3,0.02h,Stop Loss,$-9.00,$-18.00,$59447.00,78,$-18.00
2024-04-18,00:09:00,17681.75,SELL,3,0.02h,Stop Loss,$-9.00,$-27.00,$59438.00,78,$-27.00
2024-04-18,00:10:00,17686.0,BUY,3,0.02h,Stop Loss,$-9.00,$-36.00,$59429.00,78,$-36.00
2024-04-18,00:47:00,17691.0,SELL,3,0.03h,Break Even,$-1.50,$-37.50,$59427.50,78,$-37.50
2024-04-18,01:00:00,17695.75,BUY,3,0.02h,Break Even,$-1.50,$-39.00,$59426.00,78,$-39.00
2024-04-18,01:33:00,17694.5,SELL,3,0.02h,Break Even,$-1.50,$-40.50,$59424.50,78,$-40.50
2024-04-18,01:50:00,17698.0,BUY,3,0.02h,Break Even,$-1.50,$-42.00,$59423.00,78,$-42.00
2024-04-18,01:52:00,17697.0,SELL,3,0.02h,Stop Loss,$-9.00,$-51.00,$59414.00,78,$-51.00
2024-04-18,01:53:00,17697.5,BUY,3,0.02h,Stop Loss,$-9.00,$-60.00,$59405.00,78,$-60.00
2024-04-18,01:54:00,17695.5,SELL,3,0.03h,Stop Loss,$-9.00,$-69.00,$59396.00,78,$-69.00
2024-04-18,01:57:00,17699.0,BUY,3,0.02h,Break Even,$-1.50,$-70.50,$59394.50,78,$-70.50
2024-04-18,03:50:00,17725.5,SELL,3,0.02h,Stop Loss,$-9.00,$-79.50,$59385.50,78,$-79.50
2024-04-18,03:56:00,17729.25,BUY,3,0.07h,Break Even,$-1.50,$-81.00,$59384.00,78,$-81.00
2024-04-18,04:02:00,17727.25,SELL,3,0.05h,Stop Loss,$-9.00,$-90.00,$59375.00,78,$-90.00
2024-04-18,04:06:00,17729.5,BUY,3,0.02h,Stop Loss,$-9.00,$-99.00,$59366.00,78,$-99.00
2024-04-18,04:11:00,17728.0,SELL,3,0.02h,Stop Loss,$-9.00,$-108.00,$59357.00,78,$-108.00
2024-04-18,04:12:00,17728.75,BUY,3,0.02h,Break Even,$-1.50,$-109.50,$59355.50,78,$-109.50
2024-04-18,04:18:00,17728.0,SELL,3,0.02h,Stop Loss,$-9.00,$-118.50,$59346.50,78,$-118.50
2024-04-18,04:20:00,17729.0,BUY,3,0.02h,Stop Loss,$-9.00,$-127.50,$59337.50,78,$-127.50
2024-04-18,04:44:00,17730.75,SELL,3,0.02h,Break Even,$-1.50,$-129.00,$59336.00,78,$-129.00
2024-04-18,05:24:00,17726.25,BUY,3,0.02h,Break Even,$-1.50,$-130.50,$59334.50,78,$-130.50
2024-04-18,06:37:00,17756.75,SELL,3,0.02h,Stop Loss,$-9.00,$-139.50,$59325.50,78,$-139.50
2024-04-18,06:48:00,17763.75,BUY,3,0.02h,Break Even,$-1.50,$-141.00,$59324.00,78,$-141.00
2024-04-18,06:55:00,17760.25,SELL,3,0.02h,Stop Loss,$13.50,$-127.50,$59337.50,78,$-127.50
2024-04-18,07:00:00,17763.75,BUY,3,0.02h,Break Even,$-1.50,$-129.00,$59336.00,78,$-129.00
2024-04-18,07:03:00,17758.5,SELL,3,0.02h,Break Even,$-1.50,$-130.50,$59334.50,78,$-130.50
2024-04-18,07:27:00,17754.5,BUY,3,0.02h,Stop Loss,$-9.00,$-139.50,$59325.50,78,$-139.50
2024-04-18,07:34:00,17740.25,SELL,3,0.02h,Break Even,$-1.50,$-141.00,$59324.00,78,$-141.00
2024-04-18,07:50:00,17750.0,BUY,3,0.02h,Break Even,$-1.50,$-142.50,$59322.50,78,$-142.50
2024-04-18,08:07:00,17744.0,SELL,3,0.02h,Stop Loss,$27.00,$-115.50,$59349.50,78,$-115.50
2024-04-18,08:35:00,17729.5,BUY,3,0.02h,Break Even,$-1.50,$-117.00,$59348.00,78,$-117.00
2024-04-18,08:37:00,17727.25,SELL,3,0.02h,Stop Loss,$13.50,$-103.50,$59361.50,78,$-103.50
2024-04-18,08:50:00,17729.0,BUY,3,0.02h,Break Even,$-1.50,$-105.00,$59360.00,78,$-105.00
2024-04-18,08:56:00,17719.25,SELL,3,0.02h,Stop Loss,$13.50,$-91.50,$59373.50,78,$-91.50
2024-04-18,09:05:00,17729.75,BUY,3,0.02h,Stop Loss,$-9.00,$-100.50,$59364.50,78,$-100.50
2024-04-18,09:17:00,17717.5,SELL,3,0.02h,Stop Loss,$-9.00,$-109.50,$59355.50,78,$-109.50
2024-04-18,09:47:00,17703.75,BUY,3,0.02h,Stop Loss,$-9.00,$-118.50,$59346.50,78,$-118.50
2024-04-18,10:13:00,17690.75,SELL,3,0.02h,Stop Loss,$-9.00,$-127.50,$59337.50,78,$-127.50
2024-04-18,10:25:00,17706.5,BUY,3,0.02h,Stop Loss,$10.50,$-117.00,$59348.00,78,$-117.00
2024-04-18,10:57:00,17707.25,SELL,3,0.02h,Break Even,$-1.50,$-118.50,$59346.50,78,$-118.50
2024-04-18,11:06:00,17713.25,BUY,3,0.02h,Stop Loss,$7.50,$-111.00,$59354.00,78,$-111.00
2024-04-18,11:13:00,17704.0,SELL,3,0.02h,Stop Loss,$12.00,$-99.00,$59366.00,78,$-99.00
2024-04-18,11:24:00,17711.25,BUY,3,0.02h,Stop Loss,$-9.00,$-108.00,$59357.00,78,$-108.00
2024-04-18,11:25:00,17706.75,SELL,3,0.02h,Stop Loss,$-9.00,$-117.00,$59348.00,78,$-117.00
2024-04-18,11:26:00,17709.5,BUY,3,0.02h,Stop Loss,$-9.00,$-126.00,$59339.00,78,$-126.00
2024-04-18,11:54:00,17713.75,SELL,3,0.02h,Break Even,$-1.50,$-127.50,$59337.50,78,$-127.50
2024-04-18,12:38:00,17703.75,BUY,3,0.02h,Break Even,$-1.50,$-129.00,$59336.00,78,$-129.00
2024-04-18,12:44:00,17687.0,SELL,3,0.02h,Stop Loss,$9.00,$-120.00,$59345.00,78,$-120.00
2024-04-18,13:06:00,17694.5,BUY,3,0.02h,Stop Loss,$-9.00,$-129.00,$59336.00,78,$-129.00
2024-04-18,13:08:00,17682.75,SELL,3,0.02h,Stop Loss,$-9.00,$-138.00,$59327.00,78,$-138.00
2024-04-18,13:12:00,17689.5,BUY,3,0.02h,Break Even,$-1.50,$-139.50,$59325.50,78,$-139.50
2024-04-18,13:17:00,17679.25,SELL,3,0.02h,Stop Loss,$21.00,$-118.50,$59346.50,78,$-118.50
2024-04-18,14:10:00,17642.0,BUY,3,0.02h,Stop Loss,$37.50,$-81.00,$59384.00,78,$-81.00
2024-04-18,15:31:00,17697.5,SELL,3,0.02h,Stop Loss,$-9.00,$-90.00,$59375.00,78,$-90.00
2024-04-18,16:03:00,17700.0,BUY,3,0.02h,Break Even,$-1.50,$-91.50,$59373.50,78,$-91.50
2024-04-18,16:04:00,17695.5,SELL,3,0.02h,Stop Loss,$24.00,$-67.50,$59397.50,78,$-67.50
2024-04-18,17:50:00,17571.25,BUY,3,0.02h,Stop Loss,$-9.00,$-76.50,$59388.50,78,$-76.50
2024-04-18,17:51:00,17563.75,SELL,3,0.02h,Stop Loss,$22.50,$-54.00,$59411.00,78,$-54.00
2024-04-18,18:17:00,17565.0,BUY,3,0.02h,Stop Loss,$43.50,$-10.50,$59454.50,78,$-10.50
2024-04-18,18:32:00,17550.0,SELL,3,0.02h,Stop Loss,$46.50,$36.00,$59501.00,78,$36.00
2024-04-18,18:50:00,17558.25,BUY,3,0.02h,Stop Loss,$-9.00,$27.00,$59492.00,78,$27.00
2024-04-18,18:51:00,17547.0,SELL,3,0.02h,Stop Loss,$70.50,$97.50,$59562.50,78,$97.50
2024-04-18,19:03:00,17571.25,BUY,3,0.02h,Stop Loss,$-9.00,$88.50,$59553.50,78,$88.50
2024-04-18,19:21:00,17556.5,SELL,3,0.02h,Stop Loss,$25.50,$114.00,$59579.00,78,$114.00
2024-04-18,19:30:00,17562.25,BUY,3,0.02h,Stop Loss,$13.50,$127.50,$59592.50,78,$127.50
2024-04-18,19:55:00,17537.5,SELL,3,0.02h,Stop Loss,$28.50,$156.00,$59621.00,78,$156.00
2024-04-18,20:59:00,17531.25,BUY,3,0.02h,Stop Loss,$-9.00,$147.00,$59612.00,78,$147.00
2024-04-18,23:01:00,17518.75,SELL,3,0.02h,Stop Loss,$-9.00,$138.00,$59603.00,78,$138.00
,,,,,,,,,,,
2024-04-19,00:47:00,17460.5,BUY,3,0.02h,Stop Loss,$-9.00,$-9.00,$59594.00,79,$-9.00
2024-04-19,00:51:00,17453.75,SELL,3,0.02h,Stop Loss,$18.00,$9.00,$59612.00,79,$9.00
2024-04-19,01:56:00,17302.0,BUY,3,0.02h,Stop Loss,$-9.00,$0.00,$59603.00,79,$0.00
2024-04-19,01:57:00,17278.25,SELL,3,0.02h,Stop Loss,$40.50,$40.50,$59643.50,79,$40.50
2024-04-19,02:27:00,17260.25,BUY,3,0.02h,Stop Loss,$19.50,$60.00,$59663.00,79,$60.00
2024-04-19,04:53:00,17371.25,SELL,3,0.02h,Break Even,$-1.50,$58.50,$59661.50,79,$58.50
2024-04-19,05:06:00,17384.25,BUY,3,0.02h,Break Even,$-1.50,$57.00,$59660.00,79,$57.00
2024-04-19,05:16:00,17368.75,SELL,3,0.02h,Break Even,$-1.50,$55.50,$59658.50,79,$55.50
2024-04-19,05:26:00,17384.0,BUY,3,0.02h,Stop Loss,$-9.00,$46.50,$59649.50,79,$46.50
2024-04-19,05:34:00,17362.5,SELL,3,0.02h,Break Even,$-1.50,$45.00,$59648.00,79,$45.00
2024-04-19,05:42:00,17377.0,BUY,3,0.02h,Stop Loss,$15.00,$60.00,$59663.00,79,$60.00
2024-04-19,06:01:00,17360.25,SELL,3,0.02h,Stop Loss,$16.50,$76.50,$59679.50,79,$76.50
2024-04-19,06:11:00,17379.5,BUY,3,0.02h,Stop Loss,$94.50,$171.00,$59774.00,79,$171.00
2024-04-19,07:32:00,17426.75,SELL,3,0.02h,Stop Loss,$54.00,$225.00,$59828.00,79,$225.00
2024-04-19,07:58:00,17432.75,BUY,3,0.02h,Break Even,$-1.50,$223.50,$59826.50,79,$223.50
2024-04-19,08:08:00,17410.25,SELL,3,0.02h,Stop Loss,$22.50,$246.00,$59849.00,79,$246.00
2024-04-19,08:20:00,17439.5,BUY,3,0.02h,Break Even,$-1.50,$244.50,$59847.50,79,$244.50
2024-04-19,08:35:00,17414.25,SELL,3,0.02h,Stop Loss,$34.50,$279.00,$59882.00,79,$279.00
2024-04-19,08:54:00,17419.25,BUY,3,0.02h,Stop Loss,$-9.00,$270.00,$59873.00,79,$270.00
2024-04-19,09:52:00,17436.5,SELL,3,0.02h,Break Even,$-1.50,$268.50,$59871.50,79,$268.50
2024-04-19,10:06:00,17457.5,BUY,3,0.02h,Break Even,$-1.50,$267.00,$59870.00,79,$267.00
2024-04-19,10:17:00,17437.75,SELL,3,0.02h,Stop Loss,$-9.00,$258.00,$59861.00,79,$258.00
2024-04-19,10:58:00,17435.75,BUY,3,0.02h,Stop Loss,$42.00,$300.00,$59903.00,79,$300.00
2024-04-19,11:53:00,17477.0,SELL,3,0.02h,Stop Loss,$9.00,$309.00,$59912.00,79,$309.00
2024-04-19,11:57:00,17489.0,BUY,3,0.02h,Stop Loss,$-9.00,$300.00,$59903.00,79,$300.00
2024-04-19,12:46:00,17518.25,SELL,3,0.02h,Stop Loss,$16.50,$316.50,$59919.50,79,$316.50
2024-04-19,13:46:00,17492.25,BUY,3,0.02h,Stop Loss,$123.00,$439.50,$60042.50,79,$439.50
2024-04-19,13:51:00,17449.0,SELL,3,0.02h,Stop Loss,$39.00,$478.50,$60081.50,79,$478.50
2024-04-19,14:47:00,17396.25,BUY,3,0.02h,Stop Loss,$39.00,$517.50,$60120.50,79,$517.50
2024-04-19,15:01:00,17378.0,SELL,3,0.02h,Stop Loss,$12.00,$529.50,$60132.50,79,$529.50
2024-04-19,15:48:00,17346.25,BUY,3,0.02h,Stop Loss,$10.50,$540.00,$60143.00,79,$540.00
2024-04-19,15:52:00,17325.25,SELL,3,0.02h,Break Even,$-1.50,$538.50,$60141.50,79,$538.50
2024-04-19,16:46:00,17246.75,BUY,3,0.02h,Stop Loss,$46.50,$585.00,$60188.00,79,$585.00
2024-04-19,17:29:00,17274.25,SELL,3,0.02h,Stop Loss,$85.50,$670.50,$60273.50,79,$670.50
2024-04-19,17:48:00,17284.75,BUY,3,0.02h,Stop Loss,$13.50,$684.00,$60287.00,79,$684.00
2024-04-19,18:01:00,17268.5,SELL,3,0.02h,Stop Loss,$108.00,$792.00,$60395.00,79,$792.00
2024-04-19,19:12:00,17174.5,BUY,3,0.02h,Stop Loss,$48.00,$840.00,$60443.00,79,$840.00
2024-04-19,19:36:00,17154.75,SELL,3,0.02h,Stop Loss,$106.50,$946.50,$60549.50,79,$946.50
2024-04-19,19:55:00,17183.25,BUY,3,0.02h,Break Even,$-1.50,$945.00,$60548.00,79,$945.00
2024-04-19,20:40:00,17174.5,SELL,3,0.02h,Stop Loss,$-9.00,$936.00,$60539.00,79,$936.00
2024-04-19,20:58:00,17180.75,BUY,3,0.02h,Stop Loss,$-9.00,$927.00,$60530.00,79,$927.00
,,,,,,,,,,,
2024-04-22,00:34:00,17252.0,SELL,3,0.02h,Stop Loss,$-9.00,$-9.00,$60521.00,80,$-9.00
2024-04-22,01:10:00,17241.75,BUY,3,0.02h,Stop Loss,$55.50,$46.50,$60576.50,80,$46.50
2024-04-22,01:28:00,17232.75,SELL,3,0.02h,Stop Loss,$-9.00,$37.50,$60567.50,80,$37.50
2024-04-22,01:29:00,17237.75,BUY,3,0.02h,Stop Loss,$-9.00,$28.50,$60558.50,80,$28.50
2024-04-22,01:30:00,17233.25,SELL,3,0.02h,Stop Loss,$19.50,$48.00,$60578.00,80,$48.00
2024-04-22,01:48:00,17238.25,BUY,3,0.02h,Break Even,$-1.50,$46.50,$60576.50,80,$46.50
2024-04-22,02:38:00,17244.5,SELL,3,0.02h,Stop Loss,$4.50,$51.00,$60581.00,80,$51.00
2024-04-22,03:03:00,17244.25,BUY,3,0.02h,Break Even,$-1.50,$49.50,$60579.50,80,$49.50
2024-04-22,03:32:00,17244.0,SELL,3,0.02h,Stop Loss,$12.00,$61.50,$60591.50,80,$61.50
2024-04-22,03:53:00,17243.5,BUY,3,0.02h,Stop Loss,$-9.00,$52.50,$60582.50,80,$52.50
2024-04-22,03:56:00,17241.0,SELL,3,0.02h,Stop Loss,$-9.00,$43.50,$60573.50,80,$43.50
2024-04-22,04:13:00,17243.0,BUY,3,0.02h,Stop Loss,$-9.00,$34.50,$60564.50,80,$34.50
2024-04-22,05:09:00,17259.5,SELL,3,0.02h,Break Even,$-1.50,$33.00,$60563.00,80,$33.00
2024-04-22,05:24:00,17266.0,BUY,3,0.02h,Break Even,$-1.50,$31.50,$60561.50,80,$31.50
2024-04-22,06:34:00,17287.75,SELL,3,0.02h,Break Even,$-1.50,$30.00,$60560.00,80,$30.00
2024-04-22,06:45:00,17294.5,BUY,3,0.02h,Stop Loss,$12.00,$42.00,$60572.00,80,$42.00
2024-04-22,07:05:00,17294.75,SELL,3,0.02h,Break Even,$-1.50,$40.50,$60570.50,80,$40.50
2024-04-22,07:53:00,17266.5,BUY,3,0.02h,Break Even,$-1.50,$39.00,$60569.00,80,$39.00
2024-04-22,07:55:00,17260.25,SELL,3,0.02h,Break Even,$-1.50,$37.50,$60567.50,80,$37.50
2024-04-22,08:21:00,17260.75,BUY,3,0.02h,Stop Loss,$-9.00,$28.50,$60558.50,80,$28.50
2024-04-22,08:44:00,17250.0,SELL,3,0.02h,Break Even,$-1.50,$27.00,$60557.00,80,$27.00
2024-04-22,08:51:00,17264.25,BUY,3,0.02h,Break Even,$-1.50,$25.50,$60555.50,80,$25.50
2024-04-22,09:39:00,17277.25,SELL,3,0.02h,Stop Loss,$-9.00,$16.50,$60546.50,80,$16.50
2024-04-22,09:41:00,17289.25,BUY,3,0.02h,Break Even,$-1.50,$15.00,$60545.00,80,$15.00
2024-04-22,10:31:00,17295.75,SELL,3,0.02h,Stop Loss,$16.50,$31.50,$60561.50,80,$31.50
2024-04-22,11:16:00,17285.5,BUY,3,0.02h,Stop Loss,$-9.00,$22.50,$60552.50,80,$22.50
2024-04-22,11:32:00,17275.75,SELL,3,0.02h,Break Even,$-1.50,$21.00,$60551.00,80,$21.00
2024-04-22,11:36:00,17282.75,BUY,3,0.02h,Stop Loss,$3.00,$24.00,$60554.00,80,$24.00
2024-04-22,11:57:00,17282.0,SELL,3,0.02h,Break Even,$-1.50,$22.50,$60552.50,80,$22.50
2024-04-22,12:37:00,17271.25,BUY,3,0.02h,Stop Loss,$22.50,$45.00,$60575.00,80,$45.00
2024-04-22,13:25:00,17295.0,SELL,3,0.02h,Stop Loss,$31.50,$76.50,$60606.50,80,$76.50
2024-04-22,13:47:00,17298.5,BUY,3,0.02h,Stop Loss,$6.00,$82.50,$60612.50,80,$82.50
2024-04-22,14:01:00,17296.75,SELL,3,0.02h,Stop Loss,$-9.00,$73.50,$60603.50,80,$73.50
2024-04-22,14:02:00,17307.75,BUY,3,0.02h,Stop Loss,$16.50,$90.00,$60620.00,80,$90.00
2024-04-22,14:03:00,17295.25,SELL,3,0.02h,Stop Loss,$33.00,$123.00,$60653.00,80,$123.00
2024-04-22,15:27:00,17193.25,BUY,3,0.02h,Break Even,$-1.50,$121.50,$60651.50,80,$121.50
2024-04-22,16:31:00,17247.25,SELL,3,0.02h,Stop Loss,$34.50,$156.00,$60686.00,80,$156.00
2024-04-22,16:48:00,17268.0,BUY,3,0.02h,Break Even,$-1.50,$154.50,$60684.50,80,$154.50
2024-04-22,18:42:00,17413.25,SELL,3,0.02h,Stop Loss,$40.50,$195.00,$60725.00,80,$195.00
2024-04-22,19:10:00,17407.5,BUY,3,0.02h,Break Even,$-1.50,$193.50,$60723.50,80,$193.50
2024-04-22,19:12:00,17399.25,SELL,3,0.02h,Stop Loss,$-9.00,$184.50,$60714.50,80,$184.50
2024-04-22,19:13:00,17409.25,BUY,3,0.02h,Break Even,$-1.50,$183.00,$60713.00,80,$183.00
2024-04-22,19:21:00,17384.25,SELL,3,0.02h,Stop Loss,$21.00,$204.00,$60734.00,80,$204.00
2024-04-22,20:31:00,17338.5,BUY,3,0.02h,Stop Loss,$3.00,$207.00,$60737.00,80,$207.00
2024-04-22,20:49:00,17335.0,SELL,3,0.02h,Stop Loss,$-9.00,$198.00,$60728.00,80,$198.00
2024-04-22,20:53:00,17341.75,BUY,3,0.02h,Stop Loss,$-9.00,$189.00,$60719.00,80,$189.00
2024-04-22,23:04:00,17338.25,SELL,3,0.02h,Stop Loss,$-9.00,$180.00,$60710.00,80,$180.00
2024-04-22,23:07:00,17342.0,BUY,3,0.02h,Stop Loss,$-9.00,$171.00,$60701.00,80,$171.00
2024-04-22,23:08:00,17338.0,SELL,3,0.02h,Break Even,$-1.50,$169.50,$60699.50,80,$169.50
2024-04-22,23:48:00,17321.75,BUY,3,0.02h,Stop Loss,$4.50,$174.00,$60704.00,80,$174.00
2024-04-22,23:57:00,17319.25,SELL,3,0.03h,Break Even,$-1.50,$172.50,$60702.50,80,$172.50
,,,,,,,,,,,
2024-04-23,00:01:00,17326.5,BUY,3,0.02h,Stop Loss,$-9.00,$-9.00,$60693.50,81,$-9.00
2024-04-23,00:14:00,17317.25,SELL,3,0.02h,Stop Loss,$-9.00,$-18.00,$60684.50,81,$-18.00
2024-04-23,00:21:00,17331.75,BUY,3,0.02h,Stop Loss,$-9.00,$-27.00,$60675.50,81,$-27.00
2024-04-23,00:24:00,17322.25,SELL,3,0.02h,Stop Loss,$-9.00,$-36.00,$60666.50,81,$-36.00
2024-04-23,00:25:00,17326.25,BUY,3,0.02h,Break Even,$-1.50,$-37.50,$60665.00,81,$-37.50
2024-04-23,01:05:00,17326.5,SELL,3,0.02h,Break Even,$-1.50,$-39.00,$60663.50,81,$-39.00
2024-04-23,01:35:00,17327.0,BUY,3,0.02h,Stop Loss,$15.00,$-24.00,$60678.50,81,$-24.00
2024-04-23,01:39:00,17317.5,SELL,3,0.02h,Break Even,$-1.50,$-25.50,$60677.00,81,$-25.50
2024-04-23,02:09:00,17311.5,BUY,3,0.02h,Stop Loss,$6.00,$-19.50,$60683.00,81,$-19.50
2024-04-23,03:05:00,17320.5,SELL,3,0.02h,Stop Loss,$-9.00,$-28.50,$60674.00,81,$-28.50
2024-04-23,03:13:00,17329.0,BUY,3,0.02h,Stop Loss,$-9.00,$-37.50,$60665.00,81,$-37.50
2024-04-23,03:55:00,17330.5,SELL,3,0.02h,Break Even,$-1.50,$-39.00,$60663.50,81,$-39.00
2024-04-23,04:01:00,17332.75,BUY,3,0.02h,Stop Loss,$-9.00,$-48.00,$60654.50,81,$-48.00
2024-04-23,04:30:00,17333.25,SELL,3,0.02h,Stop Loss,$-9.00,$-57.00,$60645.50,81,$-57.00
2024-04-23,05:01:00,17333.0,BUY,3,0.02h,Stop Loss,$-9.00,$-66.00,$60636.50,81,$-66.00
2024-04-23,05:03:00,17327.5,SELL,3,0.02h,Stop Loss,$-9.00,$-75.00,$60627.50,81,$-75.00
2024-04-23,05:25:00,17331.25,BUY,3,0.02h,Stop Loss,$-9.00,$-84.00,$60618.50,81,$-84.00
2024-04-23,05:31:00,17324.5,SELL,3,0.02h,Break Even,$-1.50,$-85.50,$60617.00,81,$-85.50
2024-04-23,05:46:00,17326.75,BUY,3,0.02h,Stop Loss,$-9.00,$-94.50,$60608.00,81,$-94.50
2024-04-23,06:05:00,17323.5,SELL,3,0.02h,Stop Loss,$-9.00,$-103.50,$60599.00,81,$-103.50
2024-04-23,06:13:00,17330.25,BUY,3,0.02h,Stop Loss,$-9.00,$-112.50,$60590.00,81,$-112.50
2024-04-23,06:15:00,17329.0,SELL,3,0.02h,Break Even,$-1.50,$-114.00,$60588.50,81,$-114.00
2024-04-23,06:37:00,17332.0,BUY,3,0.02h,Stop Loss,$-9.00,$-123.00,$60579.50,81,$-123.00
2024-04-23,07:18:00,17349.0,SELL,3,0.02h,Stop Loss,$-9.00,$-132.00,$60570.50,81,$-132.00
2024-04-23,07:22:00,17359.25,BUY,3,0.02h,Stop Loss,$15.00,$-117.00,$60585.50,81,$-117.00
2024-04-23,07:40:00,17356.5,SELL,3,0.02h,Stop Loss,$6.00,$-111.00,$60591.50,81,$-111.00
2024-04-23,07:52:00,17358.25,BUY,3,0.02h,Break Even,$-1.50,$-112.50,$60590.00,81,$-112.50
2024-04-23,08:34:00,17375.25,SELL,3,0.02h,Break Even,$-1.50,$-114.00,$60588.50,81,$-114.00
2024-04-23,08:54:00,17385.75,BUY,3,0.02h,Break Even,$-1.50,$-115.50,$60587.00,81,$-115.50
2024-04-23,09:22:00,17381.0,SELL,3,0.02h,Stop Loss,$-9.00,$-124.50,$60578.00,81,$-124.50
2024-04-23,09:27:00,17393.5,BUY,3,0.02h,Break Even,$-1.50,$-126.00,$60576.50,81,$-126.00
2024-04-23,09:33:00,17380.75,SELL,3,0.02h,Stop Loss,$31.50,$-94.50,$60608.00,81,$-94.50
2024-04-23,10:03:00,17382.25,BUY,3,0.02h,Break Even,$-1.50,$-96.00,$60606.50,81,$-96.00
2024-04-23,10:07:00,17373.25,SELL,3,0.02h,Break Even,$-1.50,$-97.50,$60605.00,81,$-97.50
2024-04-23,10:11:00,17380.5,BUY,3,0.02h,Stop Loss,$15.00,$-82.50,$60620.00,81,$-82.50
2024-04-23,11:21:00,17405.0,SELL,3,0.02h,Stop Loss,$-9.00,$-91.50,$60611.00,81,$-91.50
2024-04-23,12:27:00,17387.0,BUY,3,0.02h,Stop Loss,$-9.00,$-100.50,$60602.00,81,$-100.50
2024-04-23,14:52:00,17562.0,SELL,3,0.02h,Stop Loss,$-9.00,$-109.50,$60593.00,81,$-109.50
2024-04-23,14:55:00,17576.75,BUY,3,0.02h,Stop Loss,$36.00,$-73.50,$60629.00,81,$-73.50
2024-04-23,15:03:00,17544.0,SELL,3,0.02h,Break Even,$-1.50,$-75.00,$60627.50,81,$-75.00
2024-04-23,15:14:00,17579.0,BUY,3,0.02h,Stop Loss,$10.50,$-64.50,$60638.00,81,$-64.50
2024-04-23,15:45:00,17583.5,SELL,3,0.02h,Stop Loss,$40.50,$-24.00,$60678.50,81,$-24.00
2024-04-23,16:06:00,17584.25,BUY,3,0.02h,Break Even,$-1.50,$-25.50,$60677.00,81,$-25.50
2024-04-23,16:54:00,17598.5,SELL,3,0.02h,Stop Loss,$4.50,$-21.00,$60681.50,81,$-21.00
2024-04-23,17:08:00,17611.75,BUY,3,0.02h,Stop Loss,$-9.00,$-30.00,$60672.50,81,$-30.00
2024-04-23,17:12:00,17595.0,SELL,3,0.02h,Stop Loss,$61.50,$31.50,$60734.00,81,$31.50
2024-04-23,17:24:00,17596.25,BUY,3,0.02h,Break Even,$-1.50,$30.00,$60732.50,81,$30.00
2024-04-23,17:26:00,17587.75,SELL,3,0.02h,Stop Loss,$-9.00,$21.00,$60723.50,81,$21.00
2024-04-23,17:29:00,17596.75,BUY,3,0.02h,Stop Loss,$3.00,$24.00,$60726.50,81,$24.00
2024-04-23,18:52:00,17634.5,SELL,3,0.02h,Break Even,$-1.50,$22.50,$60725.00,81,$22.50
2024-04-23,19:38:00,17630.25,BUY,3,0.02h,Break Even,$-1.50,$21.00,$60723.50,81,$21.00
2024-04-23,19:42:00,17626.75,SELL,3,0.02h,Stop Loss,$37.50,$58.50,$60761.00,81,$58.50
2024-04-23,20:05:00,17641.0,BUY,3,0.02h,Stop Loss,$10.50,$69.00,$60771.50,81,$69.00
,,,,,,,,,,,
2024-04-24,00:03:00,17687.0,SELL,3,0.02h,Stop Loss,$-9.00,$-9.00,$60762.50,82,$-9.00
2024-04-24,00:19:00,17702.5,BUY,3,0.02h,Stop Loss,$-9.00,$-18.00,$60753.50,82,$-18.00
2024-04-24,01:10:00,17709.75,SELL,3,0.02h,Stop Loss,$-9.00,$-27.00,$60744.50,82,$-27.00
2024-04-24,01:17:00,17718.0,BUY,3,0.02h,Break Even,$-1.50,$-28.50,$60743.00,82,$-28.50
2024-04-24,01:33:00,17710.0,SELL,3,0.02h,Stop Loss,$-9.00,$-37.50,$60734.00,82,$-37.50
2024-04-24,01:46:00,17723.5,BUY,3,0.02h,Break Even,$-1.50,$-39.00,$60732.50,82,$-39.00
2024-04-24,02:45:00,17730.0,SELL,3,0.02h,Stop Loss,$-9.00,$-48.00,$60723.50,82,$-48.00
2024-04-24,02:46:00,17731.75,BUY,3,0.02h,Stop Loss,$-9.00,$-57.00,$60714.50,82,$-57.00
2024-04-24,02:47:00,17729.5,SELL,3,0.02h,Stop Loss,$-9.00,$-66.00,$60705.50,82,$-66.00
2024-04-24,02:50:00,17733.25,BUY,3,0.02h,Stop Loss,$-9.00,$-75.00,$60696.50,82,$-75.00
2024-04-24,02:52:00,17730.25,SELL,3,0.02h,Break Even,$-1.50,$-76.50,$60695.00,82,$-76.50
2024-04-24,03:04:00,17742.0,BUY,3,0.02h,Break Even,$-1.50,$-78.00,$60693.50,82,$-78.00
2024-04-24,03:24:00,17734.0,SELL,3,0.02h,Stop Loss,$-9.00,$-87.00,$60684.50,82,$-87.00
2024-04-24,03:25:00,17735.5,BUY,3,0.02h,Break Even,$-1.50,$-88.50,$60683.00,82,$-88.50
2024-04-24,03:26:00,17735.0,SELL,3,0.02h,Break Even,$-1.50,$-90.00,$60681.50,82,$-90.00
2024-04-24,03:32:00,17735.75,BUY,3,0.03h,Stop Loss,$-9.00,$-99.00,$60672.50,82,$-99.00
2024-04-24,03:37:00,17733.5,SELL,3,0.02h,Stop Loss,$-9.00,$-108.00,$60663.50,82,$-108.00
2024-04-24,03:39:00,17735.75,BUY,3,0.02h,Break Even,$-1.50,$-109.50,$60662.00,82,$-109.50
2024-04-24,03:50:00,17733.25,SELL,3,0.02h,Break Even,$-1.50,$-111.00,$60660.50,82,$-111.00
2024-04-24,04:45:00,17730.25,BUY,3,0.02h,Stop Loss,$-9.00,$-120.00,$60651.50,82,$-120.00
2024-04-24,04:51:00,17726.5,SELL,3,0.02h,Stop Loss,$-9.00,$-129.00,$60642.50,82,$-129.00
2024-04-24,04:57:00,17730.75,BUY,3,0.02h,Stop Loss,$-9.00,$-138.00,$60633.50,82,$-138.00
2024-04-24,05:03:00,17727.5,SELL,3,0.03h,Stop Loss,$-9.00,$-147.00,$60624.50,82,$-147.00
2024-04-24,05:05:00,17730.0,BUY,3,0.02h,Stop Loss,$-9.00,$-156.00,$60615.50,82,$-156.00
2024-04-24,05:33:00,17732.0,SELL,3,0.02h,Break Even,$-1.50,$-157.50,$60614.00,82,$-157.50
2024-04-24,05:39:00,17735.5,BUY,3,0.02h,Stop Loss,$-9.00,$-166.50,$60605.00,82,$-166.50
2024-04-24,05:41:00,17732.25,SELL,3,0.03h,Stop Loss,$-9.00,$-175.50,$60596.00,82,$-175.50
2024-04-24,05:43:00,17735.5,BUY,3,0.02h,Stop Loss,$4.50,$-171.00,$60600.50,82,$-171.00
2024-04-24,06:03:00,17733.0,SELL,3,0.02h,Break Even,$-1.50,$-172.50,$60599.00,82,$-172.50
2024-04-24,06:19:00,17739.75,BUY,3,0.02h,Break Even,$-1.50,$-174.00,$60597.50,82,$-174.00
2024-04-24,06:31:00,17731.75,SELL,3,0.02h,Break Even,$-1.50,$-175.50,$60596.00,82,$-175.50
2024-04-24,06:38:00,17736.5,BUY,3,0.02h,Stop Loss,$-9.00,$-184.50,$60587.00,82,$-184.50
2024-04-24,06:39:00,17730.0,SELL,3,0.02h,Stop Loss,$-9.00,$-193.50,$60578.00,82,$-193.50
2024-04-24,07:05:00,17734.75,BUY,3,0.02h,Stop Loss,$4.50,$-189.00,$60582.50,82,$-189.00
2024-04-24,07:10:00,17727.75,SELL,3,0.02h,Stop Loss,$13.50,$-175.50,$60596.00,82,$-175.50
2024-04-24,07:33:00,17728.0,BUY,3,0.02h,Break Even,$-1.50,$-177.00,$60594.50,82,$-177.00
2024-04-24,07:43:00,17713.75,SELL,3,0.02h,Break Even,$-1.50,$-178.50,$60593.00,82,$-178.50
2024-04-24,07:53:00,17726.75,BUY,3,0.02h,Break Even,$-1.50,$-180.00,$60591.50,82,$-180.00
2024-04-24,08:02:00,17719.75,SELL,3,0.02h,Stop Loss,$-9.00,$-189.00,$60582.50,82,$-189.00
2024-04-24,08:46:00,17714.5,BUY,3,0.02h,Stop Loss,$9.00,$-180.00,$60591.50,82,$-180.00
2024-04-24,08:51:00,17707.0,SELL,3,0.02h,Break Even,$-1.50,$-181.50,$60590.00,82,$-181.50
2024-04-24,09:11:00,17706.0,BUY,3,0.02h,Stop Loss,$-9.00,$-190.50,$60581.00,82,$-190.50
2024-04-24,09:13:00,17700.75,SELL,3,0.02h,Break Even,$-1.50,$-192.00,$60579.50,82,$-192.00
2024-04-24,09:20:00,17707.75,BUY,3,0.02h,Stop Loss,$-9.00,$-201.00,$60570.50,82,$-201.00
2024-04-24,09:22:00,17698.5,SELL,3,0.02h,Break Even,$-1.50,$-202.50,$60569.00,82,$-202.50
2024-04-24,10:04:00,17690.0,BUY,3,0.02h,Stop Loss,$15.00,$-187.50,$60584.00,82,$-187.50
2024-04-24,10:41:00,17695.25,SELL,3,0.02h,Break Even,$-1.50,$-189.00,$60582.50,82,$-189.00
2024-04-24,10:56:00,17703.75,BUY,3,0.02h,Stop Loss,$-9.00,$-198.00,$60573.50,82,$-198.00
2024-04-24,10:58:00,17697.5,SELL,3,0.02h,Stop Loss,$-9.00,$-207.00,$60564.50,82,$-207.00
2024-04-24,11:07:00,17701.75,BUY,3,0.02h,Break Even,$-1.50,$-208.50,$60563.00,82,$-208.50
2024-04-24,11:22:00,17696.75,SELL,3,0.02h,Stop Loss,$-9.00,$-217.50,$60554.00,82,$-217.50
2024-04-24,11:25:00,17712.25,BUY,3,0.02h,Stop Loss,$-9.00,$-226.50,$60545.00,82,$-226.50
2024-04-24,11:51:00,17710.75,SELL,3,0.02h,Stop Loss,$-9.00,$-235.50,$60536.00,82,$-235.50
2024-04-24,11:54:00,17718.25,BUY,3,0.02h,Stop Loss,$12.00,$-223.50,$60548.00,82,$-223.50
2024-04-24,12:42:00,17727.5,SELL,3,0.02h,Stop Loss,$18.00,$-205.50,$60566.00,82,$-205.50
2024-04-24,13:25:00,17705.25,BUY,3,0.02h,Stop Loss,$48.00,$-157.50,$60614.00,82,$-157.50
2024-04-24,13:57:00,17716.75,SELL,3,0.02h,Break Even,$-1.50,$-159.00,$60612.50,82,$-159.00
2024-04-24,14:08:00,17768.75,BUY,3,0.02h,Stop Loss,$22.50,$-136.50,$60635.00,82,$-136.50
2024-04-24,14:14:00,17740.75,SELL,3,0.02h,Stop Loss,$117.00,$-19.50,$60752.00,82,$-19.50
2024-04-24,15:33:00,17669.5,BUY,3,0.02h,Stop Loss,$7.50,$-12.00,$60759.50,82,$-12.00
2024-04-24,15:44:00,17639.25,SELL,3,0.02h,Stop Loss,$75.00,$63.00,$60834.50,82,$63.00
2024-04-24,16:53:00,17603.5,BUY,3,0.02h,Stop Loss,$9.00,$72.00,$60843.50,82,$72.00
2024-04-24,18:06:00,17668.25,SELL,3,0.02h,Break Even,$-1.50,$70.50,$60842.00,82,$70.50
2024-04-24,19:11:00,17637.5,BUY,3,0.02h,Stop Loss,$34.50,$105.00,$60876.50,82,$105.00
2024-04-24,20:01:00,17665.25,SELL,3,0.02h,Stop Loss,$16.50,$121.50,$60893.00,82,$121.50
2024-04-24,20:02:00,17672.5,BUY,3,0.02h,Break Even,$-1.50,$120.00,$60891.50,82,$120.00
2024-04-24,20:03:00,17666.75,SELL,3,0.02h,Stop Loss,$30.00,$150.00,$60921.50,82,$150.00
2024-04-24,20:55:00,17517.0,BUY,3,0.02h,Break Even,$-1.50,$148.50,$60920.00,82,$148.50
2024-04-24,20:59:00,17502.5,SELL,3,0.02h,Break Even,$-1.50,$147.00,$60918.50,82,$147.00
,,,,,,,,,,,
2024-04-25,00:02:00,17474.5,BUY,3,0.02h,Stop Loss,$18.00,$18.00,$60936.50,83,$18.00
2024-04-25,00:13:00,17458.5,SELL,3,0.02h,Stop Loss,$-9.00,$9.00,$60927.50,83,$9.00
2024-04-25,00:30:00,17472.25,BUY,3,0.02h,Break Even,$-1.50,$7.50,$60926.00,83,$7.50
2024-04-25,01:10:00,17482.75,SELL,3,0.02h,Stop Loss,$-9.00,$-1.50,$60917.00,83,$-1.50
2024-04-25,01:29:00,17485.5,BUY,3,0.02h,Break Even,$-1.50,$-3.00,$60915.50,83,$-3.00
2024-04-25,01:36:00,17480.0,SELL,3,0.02h,Break Even,$-1.50,$-4.50,$60914.00,83,$-4.50
2024-04-25,02:30:00,17467.0,BUY,3,0.02h,Break Even,$-1.50,$-6.00,$60912.50,83,$-6.00
2024-04-25,02:42:00,17464.25,SELL,3,0.02h,Break Even,$-1.50,$-7.50,$60911.00,83,$-7.50
2024-04-25,03:03:00,17464.25,BUY,3,0.02h,Stop Loss,$-9.00,$-16.50,$60902.00,83,$-16.50
2024-04-25,03:04:00,17463.0,SELL,3,0.02h,Stop Loss,$-9.00,$-25.50,$60893.00,83,$-25.50
2024-04-25,03:24:00,17463.0,BUY,3,0.02h,Stop Loss,$-9.00,$-34.50,$60884.00,83,$-34.50
2024-04-25,03:33:00,17460.75,SELL,3,0.02h,Break Even,$-1.50,$-36.00,$60882.50,83,$-36.00
2024-04-25,04:32:00,17459.75,BUY,3,0.10h,Break Even,$-1.50,$-37.50,$60881.00,83,$-37.50
2024-04-25,04:47:00,17457.25,SELL,3,0.02h,Stop Loss,$10.50,$-27.00,$60891.50,83,$-27.00
2024-04-25,05:37:00,17436.75,BUY,3,0.02h,Stop Loss,$-9.00,$-36.00,$60882.50,83,$-36.00
2024-04-25,05:53:00,17427.25,SELL,3,0.02h,Break Even,$-1.50,$-37.50,$60881.00,83,$-37.50
2024-04-25,06:11:00,17431.25,BUY,3,0.02h,Stop Loss,$-9.00,$-46.50,$60872.00,83,$-46.50
2024-04-25,06:26:00,17422.0,SELL,3,0.02h,Stop Loss,$-9.00,$-55.50,$60863.00,83,$-55.50
2024-04-25,06:42:00,17428.75,BUY,3,0.02h,Stop Loss,$3.00,$-52.50,$60866.00,83,$-52.50
2024-04-25,07:23:00,17439.25,SELL,3,0.02h,Stop Loss,$15.00,$-37.50,$60881.00,83,$-37.50
2024-04-25,07:35:00,17453.5,BUY,3,0.02h,Stop Loss,$3.00,$-34.50,$60884.00,83,$-34.50
2024-04-25,08:30:00,17476.0,SELL,3,0.02h,Break Even,$-1.50,$-36.00,$60882.50,83,$-36.00
2024-04-25,08:34:00,17488.25,BUY,3,0.02h,Stop Loss,$16.50,$-19.50,$60899.00,83,$-19.50
2024-04-25,08:59:00,17491.25,SELL,3,0.02h,Stop Loss,$-9.00,$-28.50,$60890.00,83,$-28.50
2024-04-25,09:04:00,17502.75,BUY,3,0.02h,Break Even,$-1.50,$-30.00,$60888.50,83,$-30.00
2024-04-25,09:57:00,17511.75,SELL,3,0.02h,Break Even,$-1.50,$-31.50,$60887.00,83,$-31.50
2024-04-25,10:04:00,17520.75,BUY,3,0.02h,Stop Loss,$-9.00,$-40.50,$60878.00,83,$-40.50
2024-04-25,10:06:00,17512.5,SELL,3,0.02h,Break Even,$-1.50,$-42.00,$60876.50,83,$-42.00
2024-04-25,10:27:00,17512.5,BUY,3,0.02h,Stop Loss,$-9.00,$-51.00,$60867.50,83,$-51.00
2024-04-25,10:42:00,17503.25,SELL,3,0.02h,Stop Loss,$21.00,$-30.00,$60888.50,83,$-30.00
2024-04-25,11:18:00,17492.75,BUY,3,0.02h,Break Even,$-1.50,$-31.50,$60887.00,83,$-31.50
2024-04-25,11:28:00,17476.25,SELL,3,0.02h,Stop Loss,$-9.00,$-40.50,$60878.00,83,$-40.50
2024-04-25,11:45:00,17489.5,BUY,3,0.02h,Break Even,$-1.50,$-42.00,$60876.50,83,$-42.00
2024-04-25,12:05:00,17483.75,SELL,3,0.02h,Stop Loss,$33.00,$-9.00,$60909.50,83,$-9.00
2024-04-25,13:44:00,17368.5,BUY,3,0.02h,Stop Loss,$22.50,$13.50,$60932.00,83,$13.50
2024-04-25,14:01:00,17342.0,SELL,3,0.02h,Stop Loss,$46.50,$60.00,$60978.50,83,$60.00
2024-04-25,14:06:00,17370.0,BUY,3,0.02h,Stop Loss,$73.50,$133.50,$61052.00,83,$133.50
2024-04-25,14:35:00,17382.5,SELL,3,0.02h,Break Even,$-1.50,$132.00,$61050.50,83,$132.00
2024-04-25,15:06:00,17378.0,BUY,3,0.02h,Stop Loss,$16.50,$148.50,$61067.00,83,$148.50
2024-04-25,15:18:00,17362.0,SELL,3,0.02h,Stop Loss,$18.00,$166.50,$61085.00,83,$166.50
2024-04-25,15:27:00,17380.75,BUY,3,0.02h,Stop Loss,$13.50,$180.00,$61098.50,83,$180.00
2024-04-25,15:49:00,17371.75,SELL,3,0.02h,Stop Loss,$12.00,$192.00,$61110.50,83,$192.00
2024-04-25,15:55:00,17394.0,BUY,3,0.02h,Stop Loss,$27.00,$219.00,$61137.50,83,$219.00
2024-04-25,17:21:00,17484.25,SELL,3,0.02h,Stop Loss,$37.50,$256.50,$61175.00,83,$256.50
2024-04-25,17:31:00,17502.0,BUY,3,0.02h,Break Even,$-1.50,$255.00,$61173.50,83,$255.00
2024-04-25,18:26:00,17557.75,SELL,3,0.02h,Break Even,$-1.50,$253.50,$61172.00,83,$253.50
2024-04-25,19:01:00,17534.0,BUY,3,0.02h,Stop Loss,$18.00,$271.50,$61190.00,83,$271.50
2024-04-25,19:38:00,17570.0,SELL,3,0.02h,Stop Loss,$40.50,$312.00,$61230.50,83,$312.00
2024-04-25,20:00:00,17569.25,BUY,3,0.02h,Stop Loss,$313.50,$625.50,$61544.00,83,$625.50
2024-04-25,23:01:00,17772.25,SELL,3,0.02h,Stop Loss,$30.00,$655.50,$61574.00,83,$655.50
2024-04-25,23:49:00,17765.0,BUY,3,0.02h,Break Even,$-1.50,$654.00,$61572.50,83,$654.00
2024-04-25,23:56:00,17755.25,SELL,3,0.02h,Stop Loss,$-9.00,$645.00,$61563.50,83,$645.00
,,,,,,,,,,,
2024-04-26,00:27:00,17759.5,BUY,3,0.02h,Stop Loss,$-9.00,$-9.00,$61554.50,84,$-9.00
2024-04-26,00:43:00,17752.5,SELL,3,0.02h,Break Even,$-1.50,$-10.50,$61553.00,84,$-10.50
2024-04-26,00:54:00,17756.0,BUY,3,0.02h,Stop Loss,$-9.00,$-19.50,$61544.00,84,$-19.50
2024-04-26,01:02:00,17753.75,SELL,3,0.02h,Stop Loss,$-9.00,$-28.50,$61535.00,84,$-28.50
2024-04-26,01:17:00,17760.75,BUY,3,0.02h,Break Even,$-1.50,$-30.00,$61533.50,84,$-30.00
2024-04-26,01:53:00,17770.75,SELL,3,0.02h,Stop Loss,$-9.00,$-39.00,$61524.50,84,$-39.00
2024-04-26,01:54:00,17772.25,BUY,3,0.02h,Break Even,$-1.50,$-40.50,$61523.00,84,$-40.50
2024-04-26,01:56:00,17771.0,SELL,3,0.02h,Break Even,$-1.50,$-42.00,$61521.50,84,$-42.00
2024-04-26,02:02:00,17772.0,BUY,3,0.02h,Break Even,$-1.50,$-43.50,$61520.00,84,$-43.50
2024-04-26,02:21:00,17770.0,SELL,3,0.05h,Stop Loss,$3.00,$-40.50,$61523.00,84,$-40.50
2024-04-26,02:35:00,17771.75,BUY,3,0.05h,Stop Loss,$-9.00,$-49.50,$61514.00,84,$-49.50
2024-04-26,02:39:00,17770.0,SELL,3,0.07h,Stop Loss,$3.00,$-46.50,$61517.00,84,$-46.50
2024-04-26,03:04:00,17764.0,BUY,3,0.03h,Break Even,$-1.50,$-48.00,$61515.50,84,$-48.00
2024-04-26,03:12:00,17762.0,SELL,3,0.02h,Stop Loss,$-9.00,$-57.00,$61506.50,84,$-57.00
2024-04-26,03:14:00,17764.5,BUY,3,0.02h,Stop Loss,$-9.00,$-66.00,$61497.50,84,$-66.00
2024-04-26,03:41:00,17769.25,SELL,3,0.02h,Stop Loss,$-9.00,$-75.00,$61488.50,84,$-75.00
2024-04-26,04:19:00,17767.25,BUY,3,0.02h,Stop Loss,$-9.00,$-84.00,$61479.50,84,$-84.00
2024-04-26,04:20:00,17764.5,SELL,3,0.02h,Stop Loss,$-9.00,$-93.00,$61470.50,84,$-93.00
2024-04-26,04:25:00,17769.0,BUY,3,0.02h,Break Even,$-1.50,$-94.50,$61469.00,84,$-94.50
2024-04-26,04:53:00,17768.25,SELL,3,0.05h,Stop Loss,$3.00,$-91.50,$61472.00,84,$-91.50
2024-04-26,05:38:00,17763.75,BUY,3,0.02h,Break Even,$-1.50,$-93.00,$61470.50,84,$-93.00
2024-04-26,06:11:00,17766.25,SELL,3,0.02h,Break Even,$-1.50,$-94.50,$61469.00,84,$-94.50
2024-04-26,06:22:00,17769.5,BUY,3,0.02h,Stop Loss,$3.00,$-91.50,$61472.00,84,$-91.50
2024-04-26,06:54:00,17777.0,SELL,3,0.02h,Break Even,$-1.50,$-93.00,$61470.50,84,$-93.00
2024-04-26,07:37:00,17756.5,BUY,3,0.02h,Stop Loss,$13.50,$-79.50,$61484.00,84,$-79.50
2024-04-26,08:01:00,17753.25,SELL,3,0.02h,Break Even,$-1.50,$-81.00,$61482.50,84,$-81.00
2024-04-26,09:35:00,17730.0,BUY,3,0.02h,Stop Loss,$-9.00,$-90.00,$61473.50,84,$-90.00
2024-04-26,09:59:00,17726.25,SELL,3,0.02h,Stop Loss,$-9.00,$-99.00,$61464.50,84,$-99.00
2024-04-26,10:09:00,17734.25,BUY,3,0.02h,Stop Loss,$-9.00,$-108.00,$61455.50,84,$-108.00
2024-04-26,10:50:00,17737.5,SELL,3,0.02h,Stop Loss,$-9.00,$-117.00,$61446.50,84,$-117.00
2024-04-26,11:06:00,17738.0,BUY,3,0.02h,Stop Loss,$15.00,$-102.00,$61461.50,84,$-102.00
2024-04-26,11:32:00,17746.75,SELL,3,0.02h,Stop Loss,$-9.00,$-111.00,$61452.50,84,$-111.00
2024-04-26,11:54:00,17750.0,BUY,3,0.02h,Stop Loss,$-9.00,$-120.00,$61443.50,84,$-120.00
2024-04-26,12:00:00,17743.5,SELL,3,0.02h,Stop Loss,$12.00,$-108.00,$61455.50,84,$-108.00
2024-04-26,12:31:00,17795.5,BUY,3,0.02h,Stop Loss,$79.50,$-28.50,$61535.00,84,$-28.50
2024-04-26,12:43:00,17732.75,SELL,3,0.02h,Break Even,$-1.50,$-30.00,$61533.50,84,$-30.00
2024-04-26,12:45:00,17754.0,BUY,3,0.02h,Break Even,$-1.50,$-31.50,$61532.00,84,$-31.50
2024-04-26,12:47:00,17735.75,SELL,3,0.02h,Break Even,$-1.50,$-33.00,$61530.50,84,$-33.00
2024-04-26,13:02:00,17742.5,BUY,3,0.02h,Stop Loss,$18.00,$-15.00,$61548.50,84,$-15.00
2024-04-26,13:07:00,17717.0,SELL,3,0.02h,Stop Loss,$-9.00,$-24.00,$61539.50,84,$-24.00
2024-04-26,13:36:00,17734.5,BUY,3,0.02h,Stop Loss,$7.50,$-16.50,$61547.00,84,$-16.50
2024-04-26,14:31:00,17788.25,SELL,3,0.02h,Break Even,$-1.50,$-18.00,$61545.50,84,$-18.00
2024-04-26,14:36:00,17828.75,BUY,3,0.02h,Break Even,$-1.50,$-19.50,$61544.00,84,$-19.50
2024-04-26,15:13:00,17825.25,SELL,3,0.02h,Stop Loss,$9.00,$-10.50,$61553.00,84,$-10.50
2024-04-26,15:44:00,17849.75,BUY,3,0.02h,Stop Loss,$55.50,$45.00,$61608.50,84,$45.00
2024-04-26,16:01:00,17831.75,SELL,3,0.02h,Break Even,$-1.50,$43.50,$61607.00,84,$43.50
2024-04-26,16:26:00,17851.0,BUY,3,0.02h,Stop Loss,$-9.00,$34.50,$61598.00,84,$34.50
2024-04-26,16:32:00,17835.75,SELL,3,0.02h,Stop Loss,$-9.00,$25.50,$61589.00,84,$25.50
2024-04-26,16:35:00,17854.5,BUY,3,0.02h,Break Even,$-1.50,$24.00,$61587.50,84,$24.00
2024-04-26,17:41:00,17876.75,SELL,3,0.02h,Stop Loss,$69.00,$93.00,$61656.50,84,$93.00
2024-04-26,17:49:00,17892.0,BUY,3,0.02h,Stop Loss,$15.00,$108.00,$61671.50,84,$108.00
2024-04-26,17:57:00,17884.25,SELL,3,0.02h,Stop Loss,$13.50,$121.50,$61685.00,84,$121.50
2024-04-26,18:59:00,17861.25,BUY,3,0.02h,Stop Loss,$21.00,$142.50,$61706.00,84,$142.50
2024-04-26,19:42:00,17872.75,SELL,3,0.02h,Stop Loss,$-9.00,$133.50,$61697.00,84,$133.50
2024-04-26,20:42:00,17838.25,BUY,3,0.02h,Stop Loss,$-9.00,$124.50,$61688.00,84,$124.50
2024-04-26,20:44:00,17836.5,SELL,3,0.03h,Break Even,$-1.50,$123.00,$61686.50,84,$123.00
2024-04-26,20:49:00,17839.0,BUY,3,0.02h,Break Even,$-1.50,$121.50,$61685.00,84,$121.50
,,,,,,,,,,,
2024-04-29,00:30:00,17878.25,SELL,3,0.02h,Stop Loss,$-9.00,$-9.00,$61676.00,85,$-9.00
2024-04-29,00:31:00,17879.5,BUY,3,0.02h,Break Even,$-1.50,$-10.50,$61674.50,85,$-10.50
2024-04-29,01:03:00,17881.0,SELL,3,0.02h,Break Even,$-1.50,$-12.00,$61673.00,85,$-12.00
2024-04-29,01:08:00,17887.25,BUY,3,0.02h,Break Even,$-1.50,$-13.50,$61671.50,85,$-13.50
2024-04-29,01:22:00,17885.0,SELL,3,0.02h,Break Even,$-1.50,$-15.00,$61670.00,85,$-15.00
2024-04-29,01:24:00,17887.0,BUY,3,0.02h,Break Even,$-1.50,$-16.50,$61668.50,85,$-16.50
2024-04-29,02:23:00,17895.75,SELL,3,0.02h,Break Even,$-1.50,$-18.00,$61667.00,85,$-18.00
2024-04-29,02:36:00,17900.5,BUY,3,0.02h,Break Even,$-1.50,$-19.50,$61665.50,85,$-19.50
2024-04-29,03:01:00,17900.75,SELL,3,0.02h,Stop Loss,$-9.00,$-28.50,$61656.50,85,$-28.50
2024-04-29,03:11:00,17904.75,BUY,3,0.02h,Stop Loss,$-9.00,$-37.50,$61647.50,85,$-37.50
2024-04-29,03:32:00,17903.5,SELL,3,0.05h,Break Even,$-1.50,$-39.00,$61646.00,85,$-39.00
2024-04-29,03:38:00,17905.5,BUY,3,0.02h,Break Even,$-1.50,$-40.50,$61644.50,85,$-40.50
2024-04-29,03:49:00,17903.0,SELL,3,0.02h,Stop Loss,$-9.00,$-49.50,$61635.50,85,$-49.50
2024-04-29,04:12:00,17906.0,BUY,3,0.02h,Stop Loss,$7.50,$-42.00,$61643.00,85,$-42.00
2024-04-29,05:03:00,17906.75,SELL,3,0.02h,Stop Loss,$-9.00,$-51.00,$61634.00,85,$-51.00
2024-04-29,05:13:00,17911.75,BUY,3,0.02h,Stop Loss,$-9.00,$-60.00,$61625.00,85,$-60.00
2024-04-29,05:14:00,17908.0,SELL,3,0.02h,Stop Loss,$-9.00,$-69.00,$61616.00,85,$-69.00
2024-04-29,05:16:00,17909.75,BUY,3,0.02h,Stop Loss,$-9.00,$-78.00,$61607.00,85,$-78.00
2024-04-29,05:17:00,17907.25,SELL,3,0.02h,Stop Loss,$-9.00,$-87.00,$61598.00,85,$-87.00
2024-04-29,05:22:00,17909.5,BUY,3,0.02h,Break Even,$-1.50,$-88.50,$61596.50,85,$-88.50
2024-04-29,06:03:00,17907.25,SELL,3,0.02h,Break Even,$-1.50,$-90.00,$61595.00,85,$-90.00
2024-04-29,07:13:00,17899.0,BUY,3,0.02h,Break Even,$-1.50,$-91.50,$61593.50,85,$-91.50
2024-04-29,07:15:00,17892.75,SELL,3,0.02h,Stop Loss,$-9.00,$-100.50,$61584.50,85,$-100.50
2024-04-29,07:24:00,17897.75,BUY,3,0.02h,Stop Loss,$-9.00,$-109.50,$61575.50,85,$-109.50
2024-04-29,07:26:00,17892.0,SELL,3,0.02h,Stop Loss,$-9.00,$-118.50,$61566.50,85,$-118.50
2024-04-29,07:39:00,17897.25,BUY,3,0.02h,Stop Loss,$-9.00,$-127.50,$61557.50,85,$-127.50
2024-04-29,07:45:00,17892.0,SELL,3,0.02h,Stop Loss,$27.00,$-100.50,$61584.50,85,$-100.50
2024-04-29,07:52:00,17899.75,BUY,3,0.02h,Break Even,$-1.50,$-102.00,$61583.00,85,$-102.00
2024-04-29,08:29:00,17901.25,SELL,3,0.02h,Stop Loss,$-9.00,$-111.00,$61574.00,85,$-111.00
2024-04-29,09:08:00,17901.5,BUY,3,0.02h,Stop Loss,$-9.00,$-120.00,$61565.00,85,$-120.00
2024-04-29,09:16:00,17894.75,SELL,3,0.02h,Stop Loss,$-9.00,$-129.00,$61556.00,85,$-129.00
2024-04-29,09:42:00,17890.5,BUY,3,0.02h,Stop Loss,$-9.00,$-138.00,$61547.00,85,$-138.00
2024-04-29,09:44:00,17886.0,SELL,3,0.02h,Stop Loss,$-9.00,$-147.00,$61538.00,85,$-147.00
2024-04-29,10:13:00,17882.75,BUY,3,0.02h,Stop Loss,$-9.00,$-156.00,$61529.00,85,$-156.00
2024-04-29,11:04:00,17894.0,SELL,3,0.02h,Stop Loss,$-9.00,$-165.00,$61520.00,85,$-165.00
2024-04-29,11:26:00,17900.75,BUY,3,0.02h,Break Even,$-1.50,$-166.50,$61518.50,85,$-166.50
2024-04-29,12:03:00,17907.25,SELL,3,0.02h,Break Even,$-1.50,$-168.00,$61517.00,85,$-168.00
2024-04-29,12:09:00,17918.0,BUY,3,0.02h,Stop Loss,$6.00,$-162.00,$61523.00,85,$-162.00
2024-04-29,12:30:00,17912.75,SELL,3,0.02h,Stop Loss,$24.00,$-138.00,$61547.00,85,$-138.00
2024-04-29,12:44:00,17921.0,BUY,3,0.02h,Stop Loss,$-9.00,$-147.00,$61538.00,85,$-147.00
2024-04-29,13:09:00,17915.0,SELL,3,0.02h,Break Even,$-1.50,$-148.50,$61536.50,85,$-148.50
2024-04-29,13:31:00,17915.0,BUY,3,0.02h,Stop Loss,$133.50,$-15.00,$61670.00,85,$-15.00
2024-04-29,13:40:00,17896.5,SELL,3,0.02h,Stop Loss,$126.00,$111.00,$61796.00,85,$111.00
2024-04-29,14:05:00,17872.25,BUY,3,0.02h,Break Even,$-1.50,$109.50,$61794.50,85,$109.50
2024-04-29,14:40:00,17877.0,SELL,3,0.02h,Stop Loss,$-9.00,$100.50,$61785.50,85,$100.50
2024-04-29,15:20:00,17888.0,BUY,3,0.02h,Stop Loss,$-9.00,$91.50,$61776.50,85,$91.50
2024-04-29,15:23:00,17876.75,SELL,3,0.02h,Stop Loss,$22.50,$114.00,$61799.00,85,$114.00
2024-04-29,15:45:00,17883.25,BUY,3,0.02h,Stop Loss,$-9.00,$105.00,$61790.00,85,$105.00
2024-04-29,16:42:00,17888.25,SELL,3,0.02h,Stop Loss,$-9.00,$96.00,$61781.00,85,$96.00
2024-04-29,16:44:00,17904.5,BUY,3,0.02h,Stop Loss,$12.00,$108.00,$61793.00,85,$108.00
2024-04-29,16:49:00,17898.75,SELL,3,0.02h,Break Even,$-1.50,$106.50,$61791.50,85,$106.50
2024-04-29,17:18:00,17895.75,BUY,3,0.02h,Break Even,$-1.50,$105.00,$61790.00,85,$105.00
2024-04-29,17:54:00,17916.0,SELL,3,0.02h,Break Even,$-1.50,$103.50,$61788.50,85,$103.50
2024-04-29,18:47:00,17881.5,BUY,3,0.02h,Stop Loss,$4.50,$108.00,$61793.00,85,$108.00
2024-04-29,19:01:00,17852.5,SELL,3,0.02h,Stop Loss,$60.00,$168.00,$61853.00,85,$168.00
2024-04-29,19:23:00,17850.75,BUY,3,0.02h,Stop Loss,$-9.00,$159.00,$61844.00,85,$159.00
2024-04-29,20:46:00,17913.75,SELL,3,0.02h,Break Even,$-1.50,$157.50,$61842.50,85,$157.50
2024-04-29,23:34:00,17909.0,BUY,3,0.03h,Stop Loss,$-9.00,$148.50,$61833.50,85,$148.50
,,,,,,,,,,,
2024-04-30,00:01:00,17906.25,SELL,3,0.02h,Break Even,$-1.50,$-1.50,$61832.00,86,$-1.50
2024-04-30,00:21:00,17905.25,BUY,3,0.02h,Stop Loss,$-9.00,$-10.50,$61823.00,86,$-10.50
2024-04-30,00:59:00,17906.25,SELL,3,0.02h,Break Even,$-1.50,$-12.00,$61821.50,86,$-12.00
2024-04-30,01:14:00,17911.25,BUY,3,0.05h,Stop Loss,$-9.00,$-21.00,$61812.50,86,$-21.00
2024-04-30,01:56:00,17910.25,SELL,3,0.02h,Stop Loss,$-9.00,$-30.00,$61803.50,86,$-30.00
2024-04-30,02:10:00,17913.75,BUY,3,0.02h,Stop Loss,$-9.00,$-39.00,$61794.50,86,$-39.00
2024-04-30,02:18:00,17911.25,SELL,3,0.03h,Stop Loss,$-9.00,$-48.00,$61785.50,86,$-48.00
2024-04-30,02:21:00,17914.75,BUY,3,0.03h,Stop Loss,$-9.00,$-57.00,$61776.50,86,$-57.00
2024-04-30,02:49:00,17913.0,SELL,3,0.02h,Break Even,$-1.50,$-58.50,$61775.00,86,$-58.50
2024-04-30,03:26:00,17911.5,BUY,3,0.03h,Stop Loss,$-9.00,$-67.50,$61766.00,86,$-67.50
2024-04-30,03:46:00,17910.25,SELL,3,0.03h,Stop Loss,$-9.00,$-76.50,$61757.00,86,$-76.50
2024-04-30,03:58:00,17911.75,BUY,3,0.02h,Stop Loss,$-9.00,$-85.50,$61748.00,86,$-85.50
2024-04-30,04:02:00,17911.0,SELL,3,0.05h,Stop Loss,$-9.00,$-94.50,$61739.00,86,$-94.50
2024-04-30,04:05:00,17911.5,BUY,3,0.12h,Stop Loss,$-9.00,$-103.50,$61730.00,86,$-103.50
2024-04-30,04:12:00,17910.5,SELL,3,0.03h,Break Even,$-1.50,$-105.00,$61728.50,86,$-105.00
2024-04-30,05:57:00,17886.25,BUY,3,0.02h,Stop Loss,$18.00,$-87.00,$61746.50,86,$-87.00
2024-04-30,06:49:00,17899.5,SELL,3,0.02h,Stop Loss,$-9.00,$-96.00,$61737.50,86,$-96.00
2024-04-30,06:54:00,17905.5,BUY,3,0.02h,Stop Loss,$-9.00,$-105.00,$61728.50,86,$-105.00
2024-04-30,06:57:00,17902.0,SELL,3,0.02h,Stop Loss,$-9.00,$-114.00,$61719.50,86,$-114.00
2024-04-30,07:29:00,17894.75,BUY,3,0.02h,Stop Loss,$-9.00,$-123.00,$61710.50,86,$-123.00
2024-04-30,07:56:00,17895.25,SELL,3,0.02h,Stop Loss,$-9.00,$-132.00,$61701.50,86,$-132.00
2024-04-30,08:02:00,17902.25,BUY,3,0.02h,Break Even,$-1.50,$-133.50,$61700.00,86,$-133.50
2024-04-30,08:06:00,17894.5,SELL,3,0.02h,Stop Loss,$-9.00,$-142.50,$61691.00,86,$-142.50
2024-04-30,08:33:00,17893.0,BUY,3,0.02h,Stop Loss,$-9.00,$-151.50,$61682.00,86,$-151.50
2024-04-30,08:35:00,17887.75,SELL,3,0.02h,Stop Loss,$-9.00,$-160.50,$61673.00,86,$-160.50
2024-04-30,08:36:00,17890.5,BUY,3,0.02h,Break Even,$-1.50,$-162.00,$61671.50,86,$-162.00
2024-04-30,08:38:00,17889.5,SELL,3,0.02h,Break Even,$-1.50,$-163.50,$61670.00,86,$-163.50
2024-04-30,09:24:00,17876.25,BUY,3,0.02h,Stop Loss,$30.00,$-133.50,$61700.00,86,$-133.50
2024-04-30,09:52:00,17875.25,SELL,3,0.02h,Stop Loss,$4.50,$-129.00,$61704.50,86,$-129.00
2024-04-30,10:23:00,17877.5,BUY,3,0.02h,Break Even,$-1.50,$-130.50,$61703.00,86,$-130.50
2024-04-30,11:05:00,17878.5,SELL,3,0.02h,Break Even,$-1.50,$-132.00,$61701.50,86,$-132.00
2024-04-30,11:12:00,17891.0,BUY,3,0.02h,Break Even,$-1.50,$-133.50,$61700.00,86,$-133.50
2024-04-30,11:21:00,17882.5,SELL,3,0.02h,Stop Loss,$6.00,$-127.50,$61706.00,86,$-127.50
2024-04-30,11:46:00,17884.0,BUY,3,0.02h,Stop Loss,$-9.00,$-136.50,$61697.00,86,$-136.50
2024-04-30,11:51:00,17876.25,SELL,3,0.02h,Stop Loss,$-9.00,$-145.50,$61688.00,86,$-145.50
2024-04-30,11:53:00,17881.0,BUY,3,0.02h,Break Even,$-1.50,$-147.00,$61686.50,86,$-147.00
2024-04-30,11:59:00,17875.5,SELL,3,0.02h,Break Even,$-1.50,$-148.50,$61685.00,86,$-148.50
2024-04-30,12:03:00,17885.25,BUY,3,0.02h,Stop Loss,$-9.00,$-157.50,$61676.00,86,$-157.50
2024-04-30,12:07:00,17878.0,SELL,3,0.02h,Break Even,$-1.50,$-159.00,$61674.50,86,$-159.00
2024-04-30,12:18:00,17880.25,BUY,3,0.02h,Break Even,$-1.50,$-160.50,$61673.00,86,$-160.50
2024-04-30,12:31:00,17808.75,SELL,3,0.02h,Stop Loss,$88.50,$-72.00,$61761.50,86,$-72.00
2024-04-30,12:56:00,17834.5,BUY,3,0.02h,Stop Loss,$-9.00,$-81.00,$61752.50,86,$-81.00
2024-04-30,12:58:00,17822.0,SELL,3,0.02h,Stop Loss,$3.00,$-78.00,$61755.50,86,$-78.00
2024-04-30,13:09:00,17829.25,BUY,3,0.02h,Break Even,$-1.50,$-79.50,$61754.00,86,$-79.50
2024-04-30,13:10:00,17820.75,SELL,3,0.02h,Stop Loss,$-9.00,$-88.50,$61745.00,86,$-88.50
2024-04-30,13:11:00,17832.5,BUY,3,0.02h,Break Even,$-1.50,$-90.00,$61743.50,86,$-90.00
2024-04-30,14:13:00,17846.5,SELL,3,0.02h,Stop Loss,$-9.00,$-99.00,$61734.50,86,$-99.00
2024-04-30,14:16:00,17872.5,BUY,3,0.02h,Break Even,$-1.50,$-100.50,$61733.00,86,$-100.50
2024-04-30,14:22:00,17858.5,SELL,3,0.02h,Stop Loss,$-9.00,$-109.50,$61724.00,86,$-109.50
2024-04-30,14:43:00,17862.75,BUY,3,0.02h,Stop Loss,$-9.00,$-118.50,$61715.00,86,$-118.50
2024-04-30,14:55:00,17841.0,SELL,3,0.02h,Stop Loss,$10.50,$-108.00,$61725.50,86,$-108.00
2024-04-30,15:58:00,17765.5,BUY,3,0.02h,Stop Loss,$-9.00,$-117.00,$61716.50,86,$-117.00
2024-04-30,16:06:00,17746.75,SELL,3,0.02h,Break Even,$-1.50,$-118.50,$61715.00,86,$-118.50
2024-04-30,16:12:00,17760.5,BUY,3,0.02h,Stop Loss,$-9.00,$-127.50,$61706.00,86,$-127.50
2024-04-30,16:32:00,17743.75,SELL,3,0.02h,Stop Loss,$60.00,$-67.50,$61766.00,86,$-67.50
2024-04-30,17:04:00,17717.25,BUY,3,0.02h,Stop Loss,$-9.00,$-76.50,$61757.00,86,$-76.50
2024-04-30,17:12:00,17695.0,SELL,3,0.02h,Stop Loss,$97.50,$21.00,$61854.50,86,$21.00
2024-04-30,17:25:00,17702.5,BUY,3,0.02h,Stop Loss,$28.50,$49.50,$61883.00,86,$49.50
2024-04-30,18:14:00,17717.5,SELL,3,0.02h,Stop Loss,$-9.00,$40.50,$61874.00,86,$40.50
2024-04-30,18:39:00,17719.25,BUY,3,0.02h,Stop Loss,$-9.00,$31.50,$61865.00,86,$31.50
2024-04-30,18:46:00,17704.0,SELL,3,0.02h,Stop Loss,$16.50,$48.00,$61881.50,86,$48.00
2024-04-30,19:07:00,17695.5,BUY,3,0.02h,Stop Loss,$27.00,$75.00,$61908.50,86,$75.00
2024-04-30,19:17:00,17686.75,SELL,3,0.02h,Stop Loss,$39.00,$114.00,$61947.50,86,$114.00
2024-04-30,19:32:00,17692.75,BUY,3,0.02h,Stop Loss,$30.00,$144.00,$61977.50,86,$144.00
2024-04-30,19:45:00,17683.75,SELL,3,0.02h,Stop Loss,$-9.00,$135.00,$61968.50,86,$135.00
2024-04-30,19:49:00,17695.0,BUY,3,0.02h,Stop Loss,$60.00,$195.00,$62028.50,86,$195.00
2024-04-30,19:52:00,17664.0,SELL,3,0.02h,Stop Loss,$61.50,$256.50,$62090.00,86,$256.50
2024-04-30,23:47:00,17499.75,BUY,3,0.02h,Stop Loss,$-9.00,$247.50,$62081.00,86,$247.50
,,,,,,,,,,,
2024-05-01,00:20:00,17503.25,SELL,3,0.02h,Stop Loss,$-9.00,$-9.00,$62072.00,87,$-9.00
2024-05-01,00:30:00,17509.25,BUY,3,0.02h,Stop Loss,$-9.00,$-18.00,$62063.00,87,$-18.00
2024-05-01,00:31:00,17506.25,SELL,3,0.02h,Stop Loss,$-9.00,$-27.00,$62054.00,87,$-27.00
2024-05-01,00:35:00,17509.75,BUY,3,0.02h,Stop Loss,$-9.00,$-36.00,$62045.00,87,$-36.00
2024-05-01,00:36:00,17503.75,SELL,3,0.02h,Break Even,$-1.50,$-37.50,$62043.50,87,$-37.50
2024-05-01,00:53:00,17512.25,BUY,3,0.02h,Stop Loss,$-9.00,$-46.50,$62034.50,87,$-46.50
2024-05-01,01:21:00,17510.5,SELL,3,0.02h,Stop Loss,$-9.00,$-55.50,$62025.50,87,$-55.50
2024-05-01,01:50:00,17509.5,BUY,3,0.02h,Stop Loss,$-9.00,$-64.50,$62016.50,87,$-64.50
2024-05-01,02:05:00,17508.5,SELL,3,0.02h,Break Even,$-1.50,$-66.00,$62015.00,87,$-66.00
2024-05-01,02:22:00,17509.5,BUY,3,0.02h,Stop Loss,$-9.00,$-75.00,$62006.00,87,$-75.00
2024-05-01,03:48:00,17518.75,SELL,3,0.02h,Stop Loss,$-9.00,$-84.00,$61997.00,87,$-84.00
2024-05-01,03:49:00,17521.75,BUY,3,0.02h,Stop Loss,$-9.00,$-93.00,$61988.00,87,$-93.00
2024-05-01,03:51:00,17521.0,SELL,3,0.02h,Stop Loss,$-9.00,$-102.00,$61979.00,87,$-102.00
2024-05-01,03:52:00,17522.0,BUY,3,0.03h,Stop Loss,$3.00,$-99.00,$61982.00,87,$-99.00
2024-05-01,04:14:00,17523.75,SELL,3,0.05h,Stop Loss,$-9.00,$-108.00,$61973.00,87,$-108.00
2024-05-01,04:37:00,17524.75,BUY,3,0.02h,Stop Loss,$-9.00,$-117.00,$61964.00,87,$-117.00
2024-05-01,05:06:00,17525.5,SELL,3,0.02h,Stop Loss,$-9.00,$-126.00,$61955.00,87,$-126.00
2024-05-01,05:08:00,17527.25,BUY,3,0.02h,Stop Loss,$-9.00,$-135.00,$61946.00,87,$-135.00
2024-05-01,05:10:00,17523.5,SELL,3,0.02h,Stop Loss,$-9.00,$-144.00,$61937.00,87,$-144.00
2024-05-01,06:03:00,17516.75,BUY,3,0.02h,Stop Loss,$-9.00,$-153.00,$61928.00,87,$-153.00
2024-05-01,06:04:00,17511.25,SELL,3,0.02h,Break Even,$-1.50,$-154.50,$61926.50,87,$-154.50
2024-05-01,07:00:00,17486.0,BUY,3,0.02h,Break Even,$-1.50,$-156.00,$61925.00,87,$-156.00
2024-05-01,07:36:00,17483.5,SELL,3,0.02h,Stop Loss,$22.50,$-133.50,$61947.50,87,$-133.50
2024-05-01,08:06:00,17483.0,BUY,3,0.02h,Break Even,$-1.50,$-135.00,$61946.00,87,$-135.00
2024-05-01,08:37:00,17471.5,SELL,3,0.02h,Break Even,$-1.50,$-136.50,$61944.50,87,$-136.50
2024-05-01,08:57:00,17477.0,BUY,3,0.02h,Break Even,$-1.50,$-138.00,$61943.00,87,$-138.00
2024-05-01,09:05:00,17461.5,SELL,3,0.02h,Stop Loss,$-9.00,$-147.00,$61934.00,87,$-147.00
2024-05-01,09:50:00,17440.25,BUY,3,0.02h,Stop Loss,$-9.00,$-156.00,$61925.00,87,$-156.00
2024-05-01,10:05:00,17430.0,SELL,3,0.02h,Break Even,$-1.50,$-157.50,$61923.50,87,$-157.50
2024-05-01,10:39:00,17433.25,BUY,3,0.02h,Break Even,$-1.50,$-159.00,$61922.00,87,$-159.00
2024-05-01,11:33:00,17458.25,SELL,3,0.02h,Break Even,$-1.50,$-160.50,$61920.50,87,$-160.50
2024-05-01,12:06:00,17454.0,BUY,3,0.02h,Stop Loss,$9.00,$-151.50,$61929.50,87,$-151.50
2024-05-01,13:30:00,17500.25,SELL,3,0.02h,Stop Loss,$67.50,$-84.00,$61997.00,87,$-84.00
2024-05-01,13:31:00,17512.5,BUY,3,0.02h,Stop Loss,$-9.00,$-93.00,$61988.00,87,$-93.00
2024-05-01,13:32:00,17487.5,SELL,3,0.02h,Stop Loss,$39.00,$-54.00,$62027.00,87,$-54.00
2024-05-01,14:28:00,17477.0,BUY,3,0.02h,Stop Loss,$16.50,$-37.50,$62043.50,87,$-37.50
2024-05-01,15:04:00,17476.25,SELL,3,0.02h,Stop Loss,$13.50,$-24.00,$62057.00,87,$-24.00
2024-05-01,15:34:00,17455.0,BUY,3,0.02h,Stop Loss,$34.50,$10.50,$62091.50,87,$10.50
2024-05-01,15:52:00,17438.5,SELL,3,0.02h,Stop Loss,$10.50,$21.00,$62102.00,87,$21.00
2024-05-01,16:13:00,17455.25,BUY,3,0.02h,Stop Loss,$9.00,$30.00,$62111.00,87,$30.00
2024-05-01,16:40:00,17445.5,SELL,3,0.02h,Stop Loss,$34.50,$64.50,$62145.50,87,$64.50
2024-05-01,17:24:00,17449.0,BUY,3,0.02h,Stop Loss,$-9.00,$55.50,$62136.50,87,$55.50
2024-05-01,19:22:00,17702.0,SELL,3,0.02h,Stop Loss,$142.50,$198.00,$62279.00,87,$198.00
2024-05-01,19:27:00,17748.5,BUY,3,0.02h,Stop Loss,$72.00,$270.00,$62351.00,87,$270.00
2024-05-01,19:30:00,17717.75,SELL,3,0.02h,Stop Loss,$198.00,$468.00,$62549.00,87,$468.00
2024-05-01,20:47:00,17470.5,BUY,3,0.02h,Stop Loss,$-9.00,$459.00,$62540.00,87,$459.00
,,,,,,,,,,,
2024-05-02,00:15:00,17525.5,SELL,3,0.02h,Stop Loss,$-9.00,$-9.00,$62531.00,88,$-9.00
2024-05-02,00:36:00,17528.5,BUY,3,0.02h,Stop Loss,$-9.00,$-18.00,$62522.00,88,$-18.00
2024-05-02,01:03:00,17532.75,SELL,3,0.02h,Stop Loss,$-9.00,$-27.00,$62513.00,88,$-27.00
2024-05-02,01:05:00,17541.0,BUY,3,0.02h,Break Even,$-1.50,$-28.50,$62511.50,88,$-28.50
2024-05-02,01:29:00,17537.25,SELL,3,0.02h,Stop Loss,$-9.00,$-37.50,$62502.50,88,$-37.50
2024-05-02,01:55:00,17536.5,BUY,3,0.02h,Stop Loss,$-9.00,$-46.50,$62493.50,88,$-46.50
2024-05-02,02:35:00,17543.25,SELL,3,0.02h,Stop Loss,$-9.00,$-55.50,$62484.50,88,$-55.50
2024-05-02,02:39:00,17547.0,BUY,3,0.02h,Break Even,$-1.50,$-57.00,$62483.00,88,$-57.00
2024-05-02,03:23:00,17552.75,SELL,3,0.02h,Break Even,$-1.50,$-58.50,$62481.50,88,$-58.50
2024-05-02,03:29:00,17558.5,BUY,3,0.02h,Stop Loss,$-9.00,$-67.50,$62472.50,88,$-67.50
2024-05-02,03:34:00,17551.75,SELL,3,0.02h,Stop Loss,$-9.00,$-76.50,$62463.50,88,$-76.50
2024-05-02,03:57:00,17550.25,BUY,3,0.03h,Stop Loss,$-9.00,$-85.50,$62454.50,88,$-85.50
2024-05-02,03:59:00,17549.75,SELL,3,0.02h,Break Even,$-1.50,$-87.00,$62453.00,88,$-87.00
2024-05-02,04:06:00,17550.25,BUY,3,0.03h,Break Even,$-1.50,$-88.50,$62451.50,88,$-88.50
2024-05-02,04:19:00,17550.0,SELL,3,0.02h,Stop Loss,$-9.00,$-97.50,$62442.50,88,$-97.50
2024-05-02,04:43:00,17550.25,BUY,3,0.05h,Stop Loss,$-9.00,$-106.50,$62433.50,88,$-106.50
2024-05-02,04:51:00,17547.25,SELL,3,0.02h,Stop Loss,$-9.00,$-115.50,$62424.50,88,$-115.50
2024-05-02,04:57:00,17549.75,BUY,3,0.03h,Break Even,$-1.50,$-117.00,$62423.00,88,$-117.00
2024-05-02,05:10:00,17547.5,SELL,3,0.02h,Break Even,$-1.50,$-118.50,$62421.50,88,$-118.50
2024-05-02,05:16:00,17551.5,BUY,3,0.02h,Break Even,$-1.50,$-120.00,$62420.00,88,$-120.00
2024-05-02,05:20:00,17549.0,SELL,3,0.02h,Stop Loss,$-9.00,$-129.00,$62411.00,88,$-129.00
2024-05-02,05:21:00,17551.0,BUY,3,0.02h,Stop Loss,$-9.00,$-138.00,$62402.00,88,$-138.00
2024-05-02,05:22:00,17547.5,SELL,3,0.02h,Break Even,$-1.50,$-139.50,$62400.50,88,$-139.50
2024-05-02,05:44:00,17558.0,BUY,3,0.02h,Break Even,$-1.50,$-141.00,$62399.00,88,$-141.00
2024-05-02,05:51:00,17541.0,SELL,3,0.02h,Stop Loss,$-9.00,$-150.00,$62390.00,88,$-150.00
2024-05-02,06:20:00,17550.0,BUY,3,0.02h,Break Even,$-1.50,$-151.50,$62388.50,88,$-151.50
2024-05-02,06:40:00,17539.75,SELL,3,0.02h,Stop Loss,$-9.00,$-160.50,$62379.50,88,$-160.50
2024-05-02,07:07:00,17543.5,BUY,3,0.02h,Stop Loss,$-9.00,$-169.50,$62370.50,88,$-169.50
2024-05-02,08:34:00,17581.75,SELL,3,0.02h,Stop Loss,$-9.00,$-178.50,$62361.50,88,$-178.50
2024-05-02,09:17:00,17575.75,BUY,3,0.02h,Stop Loss,$-9.00,$-187.50,$62352.50,88,$-187.50
2024-05-02,09:47:00,17575.0,SELL,3,0.02h,Stop Loss,$-9.00,$-196.50,$62343.50,88,$-196.50
2024-05-02,09:48:00,17579.5,BUY,3,0.02h,Break Even,$-1.50,$-198.00,$62342.00,88,$-198.00
2024-05-02,10:17:00,17579.25,SELL,3,0.02h,Stop Loss,$-9.00,$-207.00,$62333.00,88,$-207.00
2024-05-02,10:33:00,17588.75,BUY,3,0.02h,Break Even,$-1.50,$-208.50,$62331.50,88,$-208.50
2024-05-02,11:26:00,17597.5,SELL,3,0.02h,Break Even,$-1.50,$-210.00,$62330.00,88,$-210.00
2024-05-02,12:10:00,17585.75,BUY,3,0.02h,Stop Loss,$10.50,$-199.50,$62340.50,88,$-199.50
2024-05-02,12:25:00,17582.5,SELL,3,0.02h,Stop Loss,$-9.00,$-208.50,$62331.50,88,$-208.50
2024-05-02,12:26:00,17585.75,BUY,3,0.02h,Break Even,$-1.50,$-210.00,$62330.00,88,$-210.00
2024-05-02,12:29:00,17579.5,SELL,3,0.02h,Break Even,$-1.50,$-211.50,$62328.50,88,$-211.50
2024-05-02,12:34:00,17592.25,BUY,3,0.02h,Stop Loss,$-9.00,$-220.50,$62319.50,88,$-220.50
2024-05-02,12:55:00,17587.5,SELL,3,0.02h,Break Even,$-1.50,$-222.00,$62318.00,88,$-222.00
2024-05-02,13:26:00,17582.5,BUY,3,0.02h,Stop Loss,$9.00,$-213.00,$62327.00,88,$-213.00
2024-05-02,13:32:00,17557.75,SELL,3,0.02h,Break Even,$-1.50,$-214.50,$62325.50,88,$-214.50
2024-05-02,14:25:00,17497.25,BUY,3,0.02h,Stop Loss,$61.50,$-153.00,$62387.00,88,$-153.00
2024-05-02,14:43:00,17460.75,SELL,3,0.02h,Stop Loss,$55.50,$-97.50,$62442.50,88,$-97.50
2024-05-02,14:51:00,17491.0,BUY,3,0.02h,Stop Loss,$25.50,$-72.00,$62468.00,88,$-72.00
2024-05-02,15:28:00,17519.0,SELL,3,0.02h,Stop Loss,$12.00,$-60.00,$62480.00,88,$-60.00
2024-05-02,15:48:00,17527.75,BUY,3,0.02h,Stop Loss,$-9.00,$-69.00,$62471.00,88,$-69.00
2024-05-02,16:12:00,17531.5,SELL,3,0.02h,Stop Loss,$15.00,$-54.00,$62486.00,88,$-54.00
2024-05-02,16:29:00,17538.75,BUY,3,0.02h,Break Even,$-1.50,$-55.50,$62484.50,88,$-55.50
2024-05-02,16:31:00,17515.5,SELL,3,0.02h,Stop Loss,$39.00,$-16.50,$62523.50,88,$-16.50
2024-05-02,16:45:00,17529.25,BUY,3,0.02h,Break Even,$-1.50,$-18.00,$62522.00,88,$-18.00
2024-05-02,16:58:00,17517.25,SELL,3,0.02h,Stop Loss,$-9.00,$-27.00,$62513.00,88,$-27.00
2024-05-02,17:01:00,17536.25,BUY,3,0.02h,Stop Loss,$7.50,$-19.50,$62520.50,88,$-19.50
2024-05-02,19:34:00,17651.5,SELL,3,0.02h,Stop Loss,$15.00,$-4.50,$62535.50,88,$-4.50
2024-05-02,20:01:00,17675.25,BUY,3,0.02h,Stop Loss,$16.50,$12.00,$62552.00,88,$12.00
2024-05-02,20:18:00,17650.25,SELL,3,0.02h,Break Even,$-1.50,$10.50,$62550.50,88,$10.50
2024-05-02,20:29:00,17662.25,BUY,3,0.02h,Break Even,$-1.50,$9.00,$62549.00,88,$9.00
2024-05-02,23:45:00,17747.0,SELL,3,0.02h,Break Even,$-1.50,$7.50,$62547.50,88,$7.50
2024-05-02,23:47:00,17749.25,BUY,3,0.02h,Stop Loss,$-9.00,$-1.50,$62538.50,88,$-1.50
,,,,,,,,,,,
2024-05-03,00:03:00,17744.5,SELL,3,0.02h,Break Even,$-1.50,$-1.50,$62537.00,89,$-1.50
2024-05-03,00:26:00,17747.75,BUY,3,0.02h,Break Even,$-1.50,$-3.00,$62535.50,89,$-3.00
2024-05-03,01:58:00,17772.5,SELL,3,0.02h,Stop Loss,$-9.00,$-12.00,$62526.50,89,$-12.00
2024-05-03,03:06:00,17765.25,BUY,3,0.02h,Stop Loss,$-9.00,$-21.00,$62517.50,89,$-21.00
2024-05-03,03:09:00,17761.0,SELL,3,0.02h,Stop Loss,$-9.00,$-30.00,$62508.50,89,$-30.00
2024-05-03,03:33:00,17762.25,BUY,3,0.02h,Stop Loss,$-9.00,$-39.00,$62499.50,89,$-39.00
2024-05-03,03:52:00,17762.25,SELL,3,0.02h,Break Even,$-1.50,$-40.50,$62498.00,89,$-40.50
2024-05-03,04:02:00,17766.25,BUY,3,0.02h,Stop Loss,$-9.00,$-49.50,$62489.00,89,$-49.50
2024-05-03,04:07:00,17761.0,SELL,3,0.07h,Break Even,$-1.50,$-51.00,$62487.50,89,$-51.00
2024-05-03,05:25:00,17752.75,BUY,3,0.02h,Stop Loss,$-9.00,$-60.00,$62478.50,89,$-60.00
2024-05-03,05:59:00,17754.0,SELL,3,0.02h,Stop Loss,$-9.00,$-69.00,$62469.50,89,$-69.00
2024-05-03,06:00:00,17756.25,BUY,3,0.02h,Stop Loss,$-9.00,$-78.00,$62460.50,89,$-78.00
2024-05-03,06:01:00,17755.0,SELL,3,0.02h,Stop Loss,$6.00,$-72.00,$62466.50,89,$-72.00
2024-05-03,06:16:00,17752.0,BUY,3,0.02h,Stop Loss,$-9.00,$-81.00,$62457.50,89,$-81.00
2024-05-03,06:17:00,17743.0,SELL,3,0.02h,Stop Loss,$9.00,$-72.00,$62466.50,89,$-72.00
2024-05-03,07:15:00,17735.0,BUY,3,0.02h,Break Even,$-1.50,$-73.50,$62465.00,89,$-73.50
2024-05-03,07:19:00,17729.5,SELL,3,0.02h,Stop Loss,$28.50,$-45.00,$62493.50,89,$-45.00
2024-05-03,07:44:00,17730.0,BUY,3,0.02h,Stop Loss,$-9.00,$-54.00,$62484.50,89,$-54.00
2024-05-03,08:22:00,17745.0,SELL,3,0.02h,Break Even,$-1.50,$-55.50,$62483.00,89,$-55.50
2024-05-03,08:23:00,17745.25,BUY,3,0.02h,Break Even,$-1.50,$-57.00,$62481.50,89,$-57.00
2024-05-03,09:03:00,17757.5,SELL,3,0.02h,Stop Loss,$-9.00,$-66.00,$62472.50,89,$-66.00
2024-05-03,09:04:00,17760.75,BUY,3,0.02h,Stop Loss,$-9.00,$-75.00,$62463.50,89,$-75.00
2024-05-03,09:07:00,17758.75,SELL,3,0.02h,Break Even,$-1.50,$-76.50,$62462.00,89,$-76.50
2024-05-03,09:11:00,17762.5,BUY,3,0.02h,Stop Loss,$-9.00,$-85.50,$62453.00,89,$-85.50
2024-05-03,09:13:00,17758.0,SELL,3,0.02h,Break Even,$-1.50,$-87.00,$62451.50,89,$-87.00
2024-05-03,09:38:00,17758.25,BUY,3,0.02h,Break Even,$-1.50,$-88.50,$62450.00,89,$-88.50
2024-05-03,10:36:00,17766.25,SELL,3,0.02h,Break Even,$-1.50,$-90.00,$62448.50,89,$-90.00
2024-05-03,11:16:00,17761.25,BUY,3,0.02h,Stop Loss,$-9.00,$-99.00,$62439.50,89,$-99.00
2024-05-03,11:40:00,17757.0,SELL,3,0.02h,Stop Loss,$-9.00,$-108.00,$62430.50,89,$-108.00
2024-05-03,12:05:00,17759.25,BUY,3,0.02h,Stop Loss,$-9.00,$-117.00,$62421.50,89,$-117.00
2024-05-03,12:30:00,17745.0,SELL,3,0.02h,Break Even,$-1.50,$-118.50,$62420.00,89,$-118.50
2024-05-03,12:31:00,17898.75,BUY,3,0.02h,Stop Loss,$90.00,$-28.50,$62510.00,89,$-28.50
2024-05-03,14:04:00,17949.0,SELL,3,0.02h,Stop Loss,$85.50,$57.00,$62595.50,89,$57.00
2024-05-03,14:32:00,17941.5,BUY,3,0.02h,Stop Loss,$42.00,$99.00,$62637.50,89,$99.00
2024-05-03,14:33:00,17931.0,SELL,3,0.02h,Stop Loss,$16.50,$115.50,$62654.00,89,$115.50
2024-05-03,14:37:00,17950.0,BUY,3,0.02h,Stop Loss,$6.00,$121.50,$62660.00,89,$121.50
2024-05-03,14:55:00,17938.75,SELL,3,0.02h,Stop Loss,$-9.00,$112.50,$62651.00,89,$112.50
2024-05-03,15:23:00,17943.25,BUY,3,0.02h,Stop Loss,$-9.00,$103.50,$62642.00,89,$103.50
2024-05-03,16:19:00,17987.25,SELL,3,0.02h,Stop Loss,$9.00,$112.50,$62651.00,89,$112.50
2024-05-03,16:25:00,17990.75,BUY,3,0.02h,Stop Loss,$10.50,$123.00,$62661.50,89,$123.00
2024-05-03,16:33:00,17985.5,SELL,3,0.02h,Stop Loss,$-9.00,$114.00,$62652.50,89,$114.00
2024-05-03,16:37:00,17993.0,BUY,3,0.02h,Break Even,$-1.50,$112.50,$62651.00,89,$112.50
2024-05-03,16:51:00,17987.0,SELL,3,0.02h,Stop Loss,$9.00,$121.50,$62660.00,89,$121.50
2024-05-03,17:09:00,17989.25,BUY,3,0.02h,Stop Loss,$-9.00,$112.50,$62651.00,89,$112.50
2024-05-03,17:32:00,17983.25,SELL,3,0.02h,Stop Loss,$76.50,$189.00,$62727.50,89,$189.00
2024-05-03,17:42:00,17997.75,BUY,3,0.02h,Stop Loss,$-9.00,$180.00,$62718.50,89,$180.00
2024-05-03,17:44:00,17980.0,SELL,3,0.02h,Break Even,$-1.50,$178.50,$62717.00,89,$178.50
2024-05-03,17:50:00,17989.0,BUY,3,0.02h,Break Even,$-1.50,$177.00,$62715.50,89,$177.00
2024-05-03,18:42:00,18017.0,SELL,3,0.02h,Stop Loss,$-9.00,$168.00,$62706.50,89,$168.00
2024-05-03,18:43:00,18020.75,BUY,3,0.02h,Stop Loss,$-9.00,$159.00,$62697.50,89,$159.00
2024-05-03,18:45:00,18012.5,SELL,3,0.02h,Stop Loss,$-9.00,$150.00,$62688.50,89,$150.00
2024-05-03,18:54:00,18020.25,BUY,3,0.02h,Stop Loss,$-9.00,$141.00,$62679.50,89,$141.00
2024-05-03,18:55:00,18014.0,SELL,3,0.02h,Stop Loss,$87.00,$228.00,$62766.50,89,$228.00
2024-05-03,19:07:00,18022.5,BUY,3,0.02h,Stop Loss,$-9.00,$219.00,$62757.50,89,$219.00
2024-05-03,19:19:00,18010.25,SELL,3,0.02h,Break Even,$-1.50,$217.50,$62756.00,89,$217.50
2024-05-03,19:30:00,18016.25,BUY,3,0.02h,Stop Loss,$-9.00,$208.50,$62747.00,89,$208.50
2024-05-03,19:31:00,18008.75,SELL,3,0.02h,Break Even,$-1.50,$207.00,$62745.50,89,$207.00
2024-05-03,20:02:00,18017.75,BUY,3,0.02h,Stop Loss,$-9.00,$198.00,$62736.50,89,$198.00
2024-05-03,20:49:00,18021.0,SELL,3,0.02h,Break Even,$-1.50,$196.50,$62735.00,89,$196.50
2024-05-03,20:58:00,18023.25,BUY,3,0.02h,Stop Loss,$-9.00,$187.50,$62726.00,89,$187.50
,,,,,,,,,,,
2024-05-06,00:00:00,18004.5,SELL,3,0.02h,Break Even,$-1.50,$-1.50,$62724.50,90,$-1.50
2024-05-06,00:45:00,18003.0,BUY,3,0.02h,Stop Loss,$-9.00,$-10.50,$62715.50,90,$-10.50
2024-05-06,01:45:00,18007.0,SELL,3,0.02h,Break Even,$-1.50,$-12.00,$62714.00,90,$-12.00
2024-05-06,01:58:00,18009.5,BUY,3,0.02h,Break Even,$-1.50,$-13.50,$62712.50,90,$-13.50
2024-05-06,02:23:00,18008.25,SELL,3,0.02h,Stop Loss,$-9.00,$-22.50,$62703.50,90,$-22.50
2024-05-06,02:29:00,18010.75,BUY,3,0.03h,Stop Loss,$-9.00,$-31.50,$62694.50,90,$-31.50
2024-05-06,02:31:00,18007.75,SELL,3,0.02h,Break Even,$-1.50,$-33.00,$62693.00,90,$-33.00
2024-05-06,03:37:00,18005.0,BUY,3,0.02h,Stop Loss,$-9.00,$-42.00,$62684.00,90,$-42.00
2024-05-06,04:02:00,18003.75,SELL,3,0.02h,Break Even,$-1.50,$-43.50,$62682.50,90,$-43.50
2024-05-06,05:13:00,17998.0,BUY,3,0.02h,Stop Loss,$-9.00,$-52.50,$62673.50,90,$-52.50
2024-05-06,05:17:00,17993.0,SELL,3,0.02h,Stop Loss,$-9.00,$-61.50,$62664.50,90,$-61.50
2024-05-06,05:39:00,17993.5,BUY,3,0.02h,Break Even,$-1.50,$-63.00,$62663.00,90,$-63.00
2024-05-06,05:59:00,17993.0,SELL,3,0.02h,Stop Loss,$-9.00,$-72.00,$62654.00,90,$-72.00
2024-05-06,06:00:00,17995.75,BUY,3,0.02h,Break Even,$-1.50,$-73.50,$62652.50,90,$-73.50
2024-05-06,07:24:00,18013.5,SELL,3,0.02h,Stop Loss,$-9.00,$-82.50,$62643.50,90,$-82.50
2024-05-06,07:39:00,18022.5,BUY,3,0.02h,Stop Loss,$-9.00,$-91.50,$62634.50,90,$-91.50
2024-05-06,07:51:00,18008.5,SELL,3,0.02h,Stop Loss,$-9.00,$-100.50,$62625.50,90,$-100.50
2024-05-06,08:12:00,18015.5,BUY,3,0.02h,Break Even,$-1.50,$-102.00,$62624.00,90,$-102.00
2024-05-06,08:51:00,18026.75,SELL,3,0.02h,Stop Loss,$-9.00,$-111.00,$62615.00,90,$-111.00
2024-05-06,08:53:00,18028.25,BUY,3,0.02h,Stop Loss,$-9.00,$-120.00,$62606.00,90,$-120.00
2024-05-06,08:54:00,18025.25,SELL,3,0.02h,Stop Loss,$-9.00,$-129.00,$62597.00,90,$-129.00
2024-05-06,09:03:00,18030.5,BUY,3,0.02h,Break Even,$-1.50,$-130.50,$62595.50,90,$-130.50
2024-05-06,10:36:00,18043.0,SELL,3,0.02h,Break Even,$-1.50,$-132.00,$62594.00,90,$-132.00
2024-05-06,10:45:00,18052.25,BUY,3,0.02h,Stop Loss,$-9.00,$-141.00,$62585.00,90,$-141.00
2024-05-06,10:48:00,18047.75,SELL,3,0.02h,Break Even,$-1.50,$-142.50,$62583.50,90,$-142.50
2024-05-06,10:57:00,18050.5,BUY,3,0.02h,Break Even,$-1.50,$-144.00,$62582.00,90,$-144.00
2024-05-06,11:04:00,18042.75,SELL,3,0.02h,Stop Loss,$-9.00,$-153.00,$62573.00,90,$-153.00
2024-05-06,11:29:00,18046.5,BUY,3,0.02h,Stop Loss,$-9.00,$-162.00,$62564.00,90,$-162.00
2024-05-06,11:50:00,18041.75,SELL,3,0.02h,Stop Loss,$12.00,$-150.00,$62576.00,90,$-150.00
2024-05-06,12:07:00,18047.25,BUY,3,0.02h,Stop Loss,$-9.00,$-159.00,$62567.00,90,$-159.00
2024-05-06,12:47:00,18056.75,SELL,3,0.02h,Stop Loss,$-9.00,$-168.00,$62558.00,90,$-168.00
2024-05-06,12:53:00,18062.0,BUY,3,0.02h,Stop Loss,$-9.00,$-177.00,$62549.00,90,$-177.00
2024-05-06,12:54:00,18060.75,SELL,3,0.02h,Break Even,$-1.50,$-178.50,$62547.50,90,$-178.50
2024-05-06,13:04:00,18063.75,BUY,3,0.02h,Stop Loss,$-9.00,$-187.50,$62538.50,90,$-187.50
2024-05-06,13:07:00,18057.25,SELL,3,0.02h,Stop Loss,$-9.00,$-196.50,$62529.50,90,$-196.50
2024-05-06,13:12:00,18062.75,BUY,3,0.02h,Stop Loss,$-9.00,$-205.50,$62520.50,90,$-205.50
2024-05-06,13:14:00,18055.0,SELL,3,0.02h,Stop Loss,$-9.00,$-214.50,$62511.50,90,$-214.50
2024-05-06,13:19:00,18064.75,BUY,3,0.02h,Stop Loss,$-9.00,$-223.50,$62502.50,90,$-223.50
2024-05-06,13:32:00,18056.0,SELL,3,0.02h,Stop Loss,$60.00,$-163.50,$62562.50,90,$-163.50
2024-05-06,13:36:00,18076.75,BUY,3,0.02h,Stop Loss,$18.00,$-145.50,$62580.50,90,$-145.50
2024-05-06,14:14:00,18091.75,SELL,3,0.02h,Break Even,$-1.50,$-147.00,$62579.00,90,$-147.00
2024-05-06,14:16:00,18099.5,BUY,3,0.02h,Break Even,$-1.50,$-148.50,$62577.50,90,$-148.50
2024-05-06,14:17:00,18097.25,SELL,3,0.02h,Stop Loss,$52.50,$-96.00,$62630.00,90,$-96.00
2024-05-06,14:25:00,18100.5,BUY,3,0.02h,Stop Loss,$18.00,$-78.00,$62648.00,90,$-78.00
2024-05-06,14:30:00,18094.25,SELL,3,0.02h,Stop Loss,$-9.00,$-87.00,$62639.00,90,$-87.00
2024-05-06,14:39:00,18102.25,BUY,3,0.02h,Stop Loss,$-9.00,$-96.00,$62630.00,90,$-96.00
2024-05-06,14:48:00,18091.0,SELL,3,0.02h,Stop Loss,$-9.00,$-105.00,$62621.00,90,$-105.00
2024-05-06,14:52:00,18100.5,BUY,3,0.02h,Stop Loss,$22.50,$-82.50,$62643.50,90,$-82.50
2024-05-06,14:59:00,18095.0,SELL,3,0.02h,Break Even,$-1.50,$-84.00,$62642.00,90,$-84.00
2024-05-06,15:12:00,18096.5,BUY,3,0.02h,Break Even,$-1.50,$-85.50,$62640.50,90,$-85.50
2024-05-06,15:14:00,18087.0,SELL,3,0.02h,Stop Loss,$4.50,$-81.00,$62645.00,90,$-81.00
2024-05-06,15:24:00,18101.25,BUY,3,0.02h,Stop Loss,$-9.00,$-90.00,$62636.00,90,$-90.00
2024-05-06,16:02:00,18103.25,SELL,3,0.02h,Stop Loss,$3.00,$-87.00,$62639.00,90,$-87.00
2024-05-06,16:34:00,18096.5,BUY,3,0.02h,Break Even,$-1.50,$-88.50,$62637.50,90,$-88.50
2024-05-06,16:55:00,18099.0,SELL,3,0.02h,Break Even,$-1.50,$-90.00,$62636.00,90,$-90.00
2024-05-06,16:57:00,18104.5,BUY,3,0.02h,Stop Loss,$18.00,$-72.00,$62654.00,90,$-72.00
2024-05-06,17:12:00,18096.0,SELL,3,0.02h,Stop Loss,$-9.00,$-81.00,$62645.00,90,$-81.00
2024-05-06,17:25:00,18111.75,BUY,3,0.02h,Stop Loss,$-9.00,$-90.00,$62636.00,90,$-90.00
2024-05-06,18:23:00,18131.0,SELL,3,0.02h,Stop Loss,$-9.00,$-99.00,$62627.00,90,$-99.00
2024-05-06,18:24:00,18135.25,BUY,3,0.02h,Stop Loss,$19.50,$-79.50,$62646.50,90,$-79.50
2024-05-06,18:42:00,18133.75,SELL,3,0.02h,Break Even,$-1.50,$-81.00,$62645.00,90,$-81.00
2024-05-06,18:48:00,18142.75,BUY,3,0.02h,Stop Loss,$3.00,$-78.00,$62648.00,90,$-78.00
2024-05-06,19:14:00,18137.5,SELL,3,0.02h,Stop Loss,$-9.00,$-87.00,$62639.00,90,$-87.00
2024-05-06,19:23:00,18145.25,BUY,3,0.02h,Stop Loss,$-9.00,$-96.00,$62630.00,90,$-96.00
2024-05-06,19:31:00,18136.5,SELL,3,0.02h,Stop Loss,$10.50,$-85.50,$62640.50,90,$-85.50
2024-05-06,19:38:00,18149.75,BUY,3,0.02h,Stop Loss,$-9.00,$-94.50,$62631.50,90,$-94.50
2024-05-06,20:56:00,18183.5,SELL,3,0.02h,Stop Loss,$-9.00,$-103.50,$62622.50,90,$-103.50
2024-05-06,23:00:00,18192.25,BUY,3,0.02h,Break Even,$-1.50,$-105.00,$62621.00,90,$-105.00
2024-05-06,23:14:00,18185.0,SELL,3,0.02h,Stop Loss,$-9.00,$-114.00,$62612.00,90,$-114.00
2024-05-06,23:51:00,18186.25,BUY,3,0.02h,Stop Loss,$-9.00,$-123.00,$62603.00,90,$-123.00
2024-05-06,23:52:00,18184.25,SELL,3,0.08h,Stop Loss,$7.50,$-115.50,$62610.50,90,$-115.50
,,,,,,,,,,,
2024-05-07,00:01:00,18187.25,BUY,3,0.02h,Stop Loss,$-9.00,$-9.00,$62601.50,91,$-9.00
2024-05-07,00:03:00,18183.0,SELL,3,0.02h,Break Even,$-1.50,$-10.50,$62600.00,91,$-10.50
2024-05-07,00:08:00,18186.75,BUY,3,0.02h,Break Even,$-1.50,$-12.00,$62598.50,91,$-12.00
2024-05-07,00:15:00,18182.0,SELL,3,0.02h,Stop Loss,$-9.00,$-21.00,$62589.50,91,$-21.00
2024-05-07,01:30:00,18174.5,BUY,3,0.02h,Stop Loss,$-9.00,$-30.00,$62580.50,91,$-30.00
2024-05-07,01:31:00,18173.5,SELL,3,0.02h,Break Even,$-1.50,$-31.50,$62579.00,91,$-31.50
2024-05-07,01:40:00,18175.75,BUY,3,0.02h,Stop Loss,$24.00,$-7.50,$62603.00,91,$-7.50
2024-05-07,02:20:00,18177.75,SELL,3,0.02h,Stop Loss,$-9.00,$-16.50,$62594.00,91,$-16.50
2024-05-07,02:29:00,18183.5,BUY,3,0.03h,Break Even,$-1.50,$-18.00,$62592.50,91,$-18.00
2024-05-07,02:54:00,18180.5,SELL,3,0.02h,Break Even,$-1.50,$-19.50,$62591.00,91,$-19.50
2024-05-07,03:10:00,18181.75,BUY,3,0.13h,Break Even,$-1.50,$-21.00,$62589.50,91,$-21.00
2024-05-07,04:09:00,18185.0,SELL,3,0.10h,Stop Loss,$-9.00,$-30.00,$62580.50,91,$-30.00
2024-05-07,04:35:00,18185.5,BUY,3,0.02h,Stop Loss,$-9.00,$-39.00,$62571.50,91,$-39.00
2024-05-07,04:38:00,18181.5,SELL,3,0.05h,Stop Loss,$-9.00,$-48.00,$62562.50,91,$-48.00
2024-05-07,04:46:00,18184.0,BUY,3,0.10h,Break Even,$-1.50,$-49.50,$62561.00,91,$-49.50
2024-05-07,05:02:00,18183.0,SELL,3,0.02h,Stop Loss,$-9.00,$-58.50,$62552.00,91,$-58.50
2024-05-07,05:04:00,18184.5,BUY,3,0.02h,Stop Loss,$-9.00,$-67.50,$62543.00,91,$-67.50
2024-05-07,05:05:00,18183.0,SELL,3,0.02h,Stop Loss,$-9.00,$-76.50,$62534.00,91,$-76.50
2024-05-07,05:07:00,18185.0,BUY,3,0.03h,Stop Loss,$-9.00,$-85.50,$62525.00,91,$-85.50
2024-05-07,05:10:00,18183.5,SELL,3,0.03h,Break Even,$-1.50,$-87.00,$62523.50,91,$-87.00
2024-05-07,05:16:00,18184.5,BUY,3,0.02h,Break Even,$-1.50,$-88.50,$62522.00,91,$-88.50
2024-05-07,05:32:00,18183.75,SELL,3,0.02h,Break Even,$-1.50,$-90.00,$62520.50,91,$-90.00
2024-05-07,06:03:00,18186.25,BUY,3,0.02h,Stop Loss,$-9.00,$-99.00,$62511.50,91,$-99.00
2024-05-07,06:24:00,18182.75,SELL,3,0.02h,Break Even,$-1.50,$-100.50,$62510.00,91,$-100.50
2024-05-07,06:52:00,18182.75,BUY,3,0.02h,Stop Loss,$-9.00,$-109.50,$62501.00,91,$-109.50
2024-05-07,07:21:00,18183.5,SELL,3,0.02h,Stop Loss,$-9.00,$-118.50,$62492.00,91,$-118.50
2024-05-07,08:20:00,18170.75,BUY,3,0.02h,Break Even,$-1.50,$-120.00,$62490.50,91,$-120.00
2024-05-07,09:23:00,18189.0,SELL,3,0.02h,Break Even,$-1.50,$-121.50,$62489.00,91,$-121.50
2024-05-07,10:03:00,18176.25,BUY,3,0.02h,Stop Loss,$-9.00,$-130.50,$62480.00,91,$-130.50
2024-05-07,10:10:00,18171.25,SELL,3,0.02h,Stop Loss,$-9.00,$-139.50,$62471.00,91,$-139.50
2024-05-07,10:35:00,18170.75,BUY,3,0.02h,Stop Loss,$-9.00,$-148.50,$62462.00,91,$-148.50
2024-05-07,10:47:00,18168.75,SELL,3,0.02h,Stop Loss,$-9.00,$-157.50,$62453.00,91,$-157.50
2024-05-07,10:50:00,18172.75,BUY,3,0.02h,Break Even,$-1.50,$-159.00,$62451.50,91,$-159.00
2024-05-07,11:10:00,18172.25,SELL,3,0.02h,Break Even,$-1.50,$-160.50,$62450.00,91,$-160.50
2024-05-07,11:58:00,18161.75,BUY,3,0.02h,Break Even,$-1.50,$-162.00,$62448.50,91,$-162.00
2024-05-07,12:29:00,18164.75,SELL,3,0.02h,Stop Loss,$6.00,$-156.00,$62454.50,91,$-156.00
2024-05-07,12:40:00,18171.0,BUY,3,0.02h,Break Even,$-1.50,$-157.50,$62453.00,91,$-157.50
2024-05-07,13:52:00,18200.75,SELL,3,0.02h,Stop Loss,$7.50,$-150.00,$62460.50,91,$-150.00
2024-05-07,14:14:00,18208.75,BUY,3,0.02h,Stop Loss,$40.50,$-109.50,$62501.00,91,$-109.50
2024-05-07,14:24:00,18191.5,SELL,3,0.02h,Stop Loss,$12.00,$-97.50,$62513.00,91,$-97.50
2024-05-07,14:39:00,18205.0,BUY,3,0.02h,Break Even,$-1.50,$-99.00,$62511.50,91,$-99.00
2024-05-07,15:34:00,18236.75,SELL,3,0.02h,Break Even,$-1.50,$-100.50,$62510.00,91,$-100.50
2024-05-07,15:45:00,18252.5,BUY,3,0.02h,Stop Loss,$-9.00,$-109.50,$62501.00,91,$-109.50
2024-05-07,16:23:00,18251.0,SELL,3,0.02h,Break Even,$-1.50,$-111.00,$62499.50,91,$-111.00
2024-05-07,16:25:00,18257.5,BUY,3,0.02h,Break Even,$-1.50,$-112.50,$62498.00,91,$-112.50
2024-05-07,16:32:00,18250.5,SELL,3,0.02h,Break Even,$-1.50,$-114.00,$62496.50,91,$-114.00
2024-05-07,16:44:00,18258.25,BUY,3,0.02h,Stop Loss,$-9.00,$-123.00,$62487.50,91,$-123.00
2024-05-07,16:46:00,18245.75,SELL,3,0.02h,Break Even,$-1.50,$-124.50,$62486.00,91,$-124.50
2024-05-07,17:09:00,18244.75,BUY,3,0.02h,Break Even,$-1.50,$-126.00,$62484.50,91,$-126.00
2024-05-07,17:18:00,18240.0,SELL,3,0.02h,Stop Loss,$9.00,$-117.00,$62493.50,91,$-117.00
2024-05-07,17:21:00,18247.75,BUY,3,0.02h,Stop Loss,$3.00,$-114.00,$62496.50,91,$-114.00
2024-05-07,17:41:00,18240.75,SELL,3,0.02h,Stop Loss,$-9.00,$-123.00,$62487.50,91,$-123.00
2024-05-07,18:45:00,18191.5,BUY,3,0.02h,Stop Loss,$-9.00,$-132.00,$62478.50,91,$-132.00
2024-05-07,19:19:00,18186.5,SELL,3,0.02h,Stop Loss,$-9.00,$-141.00,$62469.50,91,$-141.00
2024-05-07,19:22:00,18201.25,BUY,3,0.02h,Stop Loss,$-9.00,$-150.00,$62460.50,91,$-150.00
2024-05-07,19:33:00,18192.0,SELL,3,0.02h,Break Even,$-1.50,$-151.50,$62459.00,91,$-151.50
2024-05-07,19:37:00,18201.5,BUY,3,0.02h,Break Even,$-1.50,$-153.00,$62457.50,91,$-153.00
2024-05-07,19:39:00,18195.0,SELL,3,0.02h,Break Even,$-1.50,$-154.50,$62456.00,91,$-154.50
2024-05-07,19:40:00,18202.25,BUY,3,0.02h,Break Even,$-1.50,$-156.00,$62454.50,91,$-156.00
2024-05-07,19:43:00,18193.25,SELL,3,0.02h,Break Even,$-1.50,$-157.50,$62453.00,91,$-157.50
2024-05-07,19:49:00,18201.5,BUY,3,0.02h,Stop Loss,$7.50,$-150.00,$62460.50,91,$-150.00
2024-05-07,20:03:00,18199.5,SELL,3,0.02h,Stop Loss,$-9.00,$-159.00,$62451.50,91,$-159.00
2024-05-07,20:06:00,18208.5,BUY,3,0.02h,Break Even,$-1.50,$-160.50,$62450.00,91,$-160.50
2024-05-07,20:31:00,18207.0,SELL,3,0.02h,Break Even,$-1.50,$-162.00,$62448.50,91,$-162.00
2024-05-07,23:07:00,18204.25,BUY,3,0.02h,Stop Loss,$4.50,$-157.50,$62453.00,91,$-157.50
2024-05-07,23:27:00,18202.25,SELL,3,0.05h,Stop Loss,$-9.00,$-166.50,$62444.00,91,$-166.50
2024-05-07,23:44:00,18204.25,BUY,3,0.03h,Stop Loss,$-9.00,$-175.50,$62435.00,91,$-175.50
,,,,,,,,,,,
2024-05-08,00:08:00,18202.5,SELL,3,0.02h,Stop Loss,$-9.00,$-9.00,$62426.00,92,$-9.00
2024-05-08,00:11:00,18206.0,BUY,3,0.02h,Stop Loss,$3.00,$-6.00,$62429.00,92,$-6.00
2024-05-08,00:35:00,18206.75,SELL,3,0.02h,Stop Loss,$-9.00,$-15.00,$62420.00,92,$-15.00
2024-05-08,00:54:00,18207.75,BUY,3,0.02h,Stop Loss,$-9.00,$-24.00,$62411.00,92,$-24.00
2024-05-08,01:24:00,18206.5,SELL,3,0.02h,Stop Loss,$-9.00,$-33.00,$62402.00,92,$-33.00
2024-05-08,01:44:00,18210.25,BUY,3,0.03h,Stop Loss,$-9.00,$-42.00,$62393.00,92,$-42.00
2024-05-08,01:47:00,18206.75,SELL,3,0.02h,Stop Loss,$-9.00,$-51.00,$62384.00,92,$-51.00
2024-05-08,02:04:00,18207.75,BUY,3,0.02h,Stop Loss,$-9.00,$-60.00,$62375.00,92,$-60.00
2024-05-08,02:08:00,18204.5,SELL,3,0.02h,Break Even,$-1.50,$-61.50,$62373.50,92,$-61.50
2024-05-08,02:57:00,18201.75,BUY,3,0.02h,Stop Loss,$-9.00,$-70.50,$62364.50,92,$-70.50
2024-05-08,03:09:00,18199.25,SELL,3,0.03h,Stop Loss,$-9.00,$-79.50,$62355.50,92,$-79.50
2024-05-08,03:18:00,18201.25,BUY,3,0.03h,Stop Loss,$-9.00,$-88.50,$62346.50,92,$-88.50
2024-05-08,03:20:00,18199.25,SELL,3,0.02h,Stop Loss,$-9.00,$-97.50,$62337.50,92,$-97.50
2024-05-08,03:43:00,18200.25,BUY,3,0.02h,Break Even,$-1.50,$-99.00,$62336.00,92,$-99.00
2024-05-08,03:52:00,18196.5,SELL,3,0.02h,Stop Loss,$-9.00,$-108.00,$62327.00,92,$-108.00
2024-05-08,05:34:00,18187.75,BUY,3,0.07h,Break Even,$-1.50,$-109.50,$62325.50,92,$-109.50
2024-05-08,06:19:00,18192.25,SELL,3,0.02h,Break Even,$-1.50,$-111.00,$62324.00,92,$-111.00
2024-05-08,06:32:00,18194.25,BUY,3,0.05h,Stop Loss,$13.50,$-97.50,$62337.50,92,$-97.50
2024-05-08,07:00:00,18197.5,SELL,3,0.02h,Break Even,$-1.50,$-99.00,$62336.00,92,$-99.00
2024-05-08,07:01:00,18200.25,BUY,3,0.02h,Stop Loss,$19.50,$-79.50,$62355.50,92,$-79.50
2024-05-08,07:40:00,18205.0,SELL,3,0.02h,Stop Loss,$-9.00,$-88.50,$62346.50,92,$-88.50
2024-05-08,08:15:00,18204.5,BUY,3,0.02h,Break Even,$-1.50,$-90.00,$62345.00,92,$-90.00
2024-05-08,08:37:00,18202.0,SELL,3,0.02h,Break Even,$-1.50,$-91.50,$62343.50,92,$-91.50
2024-05-08,09:15:00,18197.25,BUY,3,0.02h,Stop Loss,$-9.00,$-100.50,$62334.50,92,$-100.50
2024-05-08,09:16:00,18195.0,SELL,3,0.02h,Break Even,$-1.50,$-102.00,$62333.00,92,$-102.00
2024-05-08,09:38:00,18195.0,BUY,3,0.03h,Stop Loss,$4.50,$-97.50,$62337.50,92,$-97.50
2024-05-08,10:00:00,18194.0,SELL,3,0.02h,Stop Loss,$33.00,$-64.50,$62370.50,92,$-64.50
2024-05-08,10:26:00,18193.25,BUY,3,0.02h,Break Even,$-1.50,$-66.00,$62369.00,92,$-66.00
2024-05-08,10:36:00,18184.0,SELL,3,0.02h,Stop Loss,$6.00,$-60.00,$62375.00,92,$-60.00
2024-05-08,10:48:00,18192.75,BUY,3,0.02h,Stop Loss,$-9.00,$-69.00,$62366.00,92,$-69.00
2024-05-08,10:49:00,18189.25,SELL,3,0.02h,Stop Loss,$-9.00,$-78.00,$62357.00,92,$-78.00
2024-05-08,10:53:00,18192.0,BUY,3,0.02h,Break Even,$-1.50,$-79.50,$62355.50,92,$-79.50
2024-05-08,10:57:00,18185.75,SELL,3,0.02h,Stop Loss,$-9.00,$-88.50,$62346.50,92,$-88.50
2024-05-08,11:48:00,18165.75,BUY,3,0.02h,Stop Loss,$-9.00,$-97.50,$62337.50,92,$-97.50
2024-05-08,11:56:00,18152.5,SELL,3,0.02h,Break Even,$-1.50,$-99.00,$62336.00,92,$-99.00
2024-05-08,13:18:00,18091.0,BUY,3,0.02h,Stop Loss,$-9.00,$-108.00,$62327.00,92,$-108.00
2024-05-08,13:19:00,18088.25,SELL,3,0.02h,Break Even,$-1.50,$-109.50,$62325.50,92,$-109.50
2024-05-08,13:28:00,18092.25,BUY,3,0.02h,Break Even,$-1.50,$-111.00,$62324.00,92,$-111.00
2024-05-08,13:30:00,18083.25,SELL,3,0.02h,Stop Loss,$4.50,$-106.50,$62328.50,92,$-106.50
2024-05-08,13:31:00,18097.25,BUY,3,0.02h,Stop Loss,$48.00,$-58.50,$62376.50,92,$-58.50
2024-05-08,15:06:00,18208.0,SELL,3,0.02h,Break Even,$-1.50,$-60.00,$62375.00,92,$-60.00
2024-05-08,16:19:00,18182.75,BUY,3,0.02h,Stop Loss,$21.00,$-39.00,$62396.00,92,$-39.00
2024-05-08,16:36:00,18160.25,SELL,3,0.02h,Stop Loss,$10.50,$-28.50,$62406.50,92,$-28.50
2024-05-08,16:50:00,18176.0,BUY,3,0.02h,Stop Loss,$-9.00,$-37.50,$62397.50,92,$-37.50
2024-05-08,16:51:00,18169.75,SELL,3,0.02h,Break Even,$-1.50,$-39.00,$62396.00,92,$-39.00
2024-05-08,17:44:00,18159.75,BUY,3,0.02h,Stop Loss,$25.50,$-13.50,$62421.50,92,$-13.50
2024-05-08,18:27:00,18176.5,SELL,3,0.02h,Stop Loss,$-9.00,$-22.50,$62412.50,92,$-22.50
2024-05-08,18:29:00,18186.0,BUY,3,0.02h,Stop Loss,$-9.00,$-31.50,$62403.50,92,$-31.50
2024-05-08,18:42:00,18176.5,SELL,3,0.02h,Break Even,$-1.50,$-33.00,$62402.00,92,$-33.00
2024-05-08,19:18:00,18180.25,BUY,3,0.02h,Break Even,$-1.50,$-34.50,$62400.50,92,$-34.50
2024-05-08,20:01:00,18178.0,SELL,3,0.02h,Stop Loss,$-9.00,$-43.50,$62391.50,92,$-43.50
2024-05-08,20:55:00,18161.0,BUY,3,0.02h,Break Even,$-1.50,$-45.00,$62390.00,92,$-45.00
2024-05-08,23:50:00,18165.25,SELL,3,0.07h,Stop Loss,$10.50,$-34.50,$62400.50,92,$-34.50
,,,,,,,,,,,
2024-05-09,00:28:00,18162.75,BUY,3,0.02h,Stop Loss,$-9.00,$-9.00,$62391.50,93,$-9.00
2024-05-09,00:30:00,18160.75,SELL,3,0.02h,Stop Loss,$-9.00,$-18.00,$62382.50,93,$-18.00
2024-05-09,00:31:00,18163.75,BUY,3,0.03h,Stop Loss,$-9.00,$-27.00,$62373.50,93,$-27.00
2024-05-09,01:05:00,18167.0,SELL,3,0.02h,Stop Loss,$-9.00,$-36.00,$62364.50,93,$-36.00
2024-05-09,01:06:00,18168.5,BUY,3,0.02h,Stop Loss,$-9.00,$-45.00,$62355.50,93,$-45.00
2024-05-09,01:08:00,18166.0,SELL,3,0.03h,Stop Loss,$3.00,$-42.00,$62358.50,93,$-42.00
2024-05-09,01:37:00,18162.5,BUY,3,0.02h,Break Even,$-1.50,$-43.50,$62357.00,93,$-43.50
2024-05-09,02:12:00,18168.25,SELL,3,0.05h,Break Even,$-1.50,$-45.00,$62355.50,93,$-45.00
2024-05-09,03:00:00,18164.25,BUY,3,0.02h,Stop Loss,$-9.00,$-54.00,$62346.50,93,$-54.00
2024-05-09,03:05:00,18162.25,SELL,3,0.02h,Stop Loss,$-9.00,$-63.00,$62337.50,93,$-63.00
2024-05-09,03:09:00,18163.75,BUY,3,0.08h,Break Even,$-1.50,$-64.50,$62336.00,93,$-64.50
2024-05-09,03:32:00,18163.5,SELL,3,0.02h,Break Even,$-1.50,$-66.00,$62334.50,93,$-66.00
2024-05-09,05:19:00,18153.25,BUY,3,0.02h,Stop Loss,$-9.00,$-75.00,$62325.50,93,$-75.00
2024-05-09,05:22:00,18150.25,SELL,3,0.02h,Break Even,$-1.50,$-76.50,$62324.00,93,$-76.50
2024-05-09,05:43:00,18152.0,BUY,3,0.02h,Stop Loss,$-9.00,$-85.50,$62315.00,93,$-85.50
2024-05-09,06:00:00,18149.25,SELL,3,0.02h,Break Even,$-1.50,$-87.00,$62313.50,93,$-87.00
2024-05-09,06:47:00,18145.5,BUY,3,0.07h,Break Even,$-1.50,$-88.50,$62312.00,93,$-88.50
2024-05-09,06:56:00,18141.75,SELL,3,0.07h,Stop Loss,$4.50,$-84.00,$62316.50,93,$-84.00
2024-05-09,07:04:00,18150.25,BUY,3,0.02h,Stop Loss,$-9.00,$-93.00,$62307.50,93,$-93.00
2024-05-09,07:25:00,18144.0,SELL,3,0.02h,Stop Loss,$3.00,$-90.00,$62310.50,93,$-90.00
2024-05-09,08:11:00,18138.75,BUY,3,0.02h,Stop Loss,$12.00,$-78.00,$62322.50,93,$-78.00
2024-05-09,08:31:00,18131.25,SELL,3,0.02h,Stop Loss,$-9.00,$-87.00,$62313.50,93,$-87.00
2024-05-09,09:34:00,18125.75,BUY,3,0.02h,Stop Loss,$-9.00,$-96.00,$62304.50,93,$-96.00
2024-05-09,10:45:00,18142.75,SELL,3,0.02h,Stop Loss,$-9.00,$-105.00,$62295.50,93,$-105.00
2024-05-09,11:16:00,18146.25,BUY,3,0.02h,Stop Loss,$7.50,$-97.50,$62303.00,93,$-97.50
2024-05-09,11:25:00,18131.25,SELL,3,0.02h,Stop Loss,$12.00,$-85.50,$62315.00,93,$-85.50
2024-05-09,11:36:00,18143.5,BUY,3,0.02h,Stop Loss,$9.00,$-76.50,$62324.00,93,$-76.50
2024-05-09,12:03:00,18146.0,SELL,3,0.02h,Stop Loss,$-9.00,$-85.50,$62315.00,93,$-85.50
2024-05-09,12:24:00,18158.75,BUY,3,0.02h,Break Even,$-1.50,$-87.00,$62313.50,93,$-87.00
2024-05-09,13:23:00,18196.75,SELL,3,0.02h,Break Even,$-1.50,$-88.50,$62312.00,93,$-88.50
2024-05-09,14:01:00,18160.5,BUY,3,0.02h,Stop Loss,$15.00,$-73.50,$62327.00,93,$-73.50
2024-05-09,14:17:00,18148.5,SELL,3,0.02h,Stop Loss,$7.50,$-66.00,$62334.50,93,$-66.00
2024-05-09,14:26:00,18160.5,BUY,3,0.02h,Stop Loss,$24.00,$-42.00,$62358.50,93,$-42.00
2024-05-09,14:30:00,18151.25,SELL,3,0.02h,Stop Loss,$-9.00,$-51.00,$62349.50,93,$-51.00
2024-05-09,14:31:00,18166.25,BUY,3,0.02h,Stop Loss,$24.00,$-27.00,$62373.50,93,$-27.00
2024-05-09,15:42:00,18212.0,SELL,3,0.02h,Stop Loss,$-9.00,$-36.00,$62364.50,93,$-36.00
2024-05-09,16:15:00,18199.25,BUY,3,0.02h,Break Even,$-1.50,$-37.50,$62363.00,93,$-37.50
2024-05-09,16:34:00,18185.5,SELL,3,0.02h,Stop Loss,$10.50,$-27.00,$62373.50,93,$-27.00
2024-05-09,16:38:00,18205.5,BUY,3,0.02h,Break Even,$-1.50,$-28.50,$62372.00,93,$-28.50
2024-05-09,17:20:00,18215.25,SELL,3,0.02h,Stop Loss,$141.00,$112.50,$62513.00,93,$112.50
2024-05-09,17:31:00,18215.75,BUY,3,0.02h,Break Even,$-1.50,$111.00,$62511.50,93,$111.00
2024-05-09,17:38:00,18212.5,SELL,3,0.02h,Stop Loss,$-9.00,$102.00,$62502.50,93,$102.00
2024-05-09,17:39:00,18215.0,BUY,3,0.02h,Stop Loss,$-9.00,$93.00,$62493.50,93,$93.00
2024-05-09,17:42:00,18213.0,SELL,3,0.02h,Break Even,$-1.50,$91.50,$62492.00,93,$91.50
2024-05-09,17:45:00,18218.25,BUY,3,0.02h,Stop Loss,$12.00,$103.50,$62504.00,93,$103.50
2024-05-09,17:49:00,18209.25,SELL,3,0.02h,Stop Loss,$-9.00,$94.50,$62495.00,93,$94.50
2024-05-09,18:28:00,18213.75,BUY,3,0.02h,Stop Loss,$3.00,$97.50,$62498.00,93,$97.50
2024-05-09,19:11:00,18222.5,SELL,3,0.02h,Stop Loss,$13.50,$111.00,$62511.50,93,$111.00
2024-05-09,19:54:00,18211.5,BUY,3,0.02h,Break Even,$-1.50,$109.50,$62510.00,93,$109.50
2024-05-09,19:56:00,18201.5,SELL,3,0.02h,Stop Loss,$7.50,$117.00,$62517.50,93,$117.00
2024-05-09,20:00:00,18215.75,BUY,3,0.02h,Stop Loss,$-9.00,$108.00,$62508.50,93,$108.00
2024-05-09,20:37:00,18228.0,SELL,3,0.03h,Break Even,$-1.50,$106.50,$62507.00,93,$106.50
2024-05-09,20:40:00,18230.0,BUY,3,0.05h,Break Even,$-1.50,$105.00,$62505.50,93,$105.00
2024-05-09,20:52:00,18228.25,SELL,3,0.02h,Break Even,$-1.50,$103.50,$62504.00,93,$103.50
2024-05-09,23:02:00,18233.0,BUY,3,0.02h,Stop Loss,$4.50,$108.00,$62508.50,93,$108.00
2024-05-09,23:35:00,18233.0,SELL,3,0.02h,Stop Loss,$-9.00,$99.00,$62499.50,93,$99.00
2024-05-09,23:40:00,18234.75,BUY,3,0.02h,Break Even,$-1.50,$97.50,$62498.00,93,$97.50
2024-05-09,23:52:00,18234.0,SELL,3,0.05h,Stop Loss,$-9.00,$88.50,$62489.00,93,$88.50
,,,,,,,,,,,
2024-05-10,00:47:00,18229.0,BUY,3,0.02h,Stop Loss,$-9.00,$-9.00,$62480.00,94,$-9.00
2024-05-10,01:13:00,18229.0,SELL,3,0.02h,Break Even,$-1.50,$-10.50,$62478.50,94,$-10.50
2024-05-10,02:49:00,18219.25,BUY,3,0.03h,Stop Loss,$-9.00,$-19.50,$62469.50,94,$-19.50
2024-05-10,03:36:00,18218.75,SELL,3,0.02h,Stop Loss,$-9.00,$-28.50,$62460.50,94,$-28.50
2024-05-10,04:04:00,18218.5,BUY,3,0.03h,Stop Loss,$-9.00,$-37.50,$62451.50,94,$-37.50
2024-05-10,04:07:00,18217.0,SELL,3,0.10h,Break Even,$-1.50,$-39.00,$62450.00,94,$-39.00
2024-05-10,04:20:00,18218.0,BUY,3,0.02h,Stop Loss,$-9.00,$-48.00,$62441.00,94,$-48.00
2024-05-10,05:16:00,18225.75,SELL,3,0.02h,Stop Loss,$-9.00,$-57.00,$62432.00,94,$-57.00
2024-05-10,05:17:00,18229.75,BUY,3,0.02h,Break Even,$-1.50,$-58.50,$62430.50,94,$-58.50
2024-05-10,05:28:00,18227.5,SELL,3,0.02h,Stop Loss,$-9.00,$-67.50,$62421.50,94,$-67.50
2024-05-10,05:33:00,18229.5,BUY,3,0.02h,Stop Loss,$-9.00,$-76.50,$62412.50,94,$-76.50
2024-05-10,05:56:00,18230.0,SELL,3,0.02h,Break Even,$-1.50,$-78.00,$62411.00,94,$-78.00
2024-05-10,06:22:00,18228.25,BUY,3,0.03h,Break Even,$-1.50,$-79.50,$62409.50,94,$-79.50
2024-05-10,07:19:00,18254.0,SELL,3,0.02h,Break Even,$-1.50,$-81.00,$62408.00,94,$-81.00
2024-05-10,07:26:00,18261.75,BUY,3,0.02h,Stop Loss,$-9.00,$-90.00,$62399.00,94,$-90.00
2024-05-10,07:32:00,18254.0,SELL,3,0.02h,Stop Loss,$-9.00,$-99.00,$62390.00,94,$-99.00
2024-05-10,07:41:00,18258.0,BUY,3,0.02h,Stop Loss,$-9.00,$-108.00,$62381.00,94,$-108.00
2024-05-10,07:44:00,18256.25,SELL,3,0.02h,Stop Loss,$-9.00,$-117.00,$62372.00,94,$-117.00
2024-05-10,07:45:00,18257.0,BUY,3,0.02h,Break Even,$-1.50,$-118.50,$62370.50,94,$-118.50
2024-05-10,07:47:00,18252.75,SELL,3,0.02h,Stop Loss,$10.50,$-108.00,$62381.00,94,$-108.00
2024-05-10,08:14:00,18251.0,BUY,3,0.02h,Break Even,$-1.50,$-109.50,$62379.50,94,$-109.50
2024-05-10,09:29:00,18290.25,SELL,3,0.02h,Stop Loss,$-9.00,$-118.50,$62370.50,94,$-118.50
2024-05-10,09:32:00,18294.5,BUY,3,0.02h,Stop Loss,$3.00,$-115.50,$62373.50,94,$-115.50
2024-05-10,10:03:00,18296.0,SELL,3,0.02h,Break Even,$-1.50,$-117.00,$62372.00,94,$-117.00
2024-05-10,10:34:00,18297.5,BUY,3,0.02h,Stop Loss,$-9.00,$-126.00,$62363.00,94,$-126.00
2024-05-10,10:50:00,18292.5,SELL,3,0.02h,Stop Loss,$-9.00,$-135.00,$62354.00,94,$-135.00
2024-05-10,11:08:00,18297.5,BUY,3,0.02h,Stop Loss,$-9.00,$-144.00,$62345.00,94,$-144.00
2024-05-10,11:13:00,18286.25,SELL,3,0.02h,Break Even,$-1.50,$-145.50,$62343.50,94,$-145.50
2024-05-10,11:33:00,18289.5,BUY,3,0.02h,Break Even,$-1.50,$-147.00,$62342.00,94,$-147.00
2024-05-10,11:42:00,18284.5,SELL,3,0.02h,Break Even,$-1.50,$-148.50,$62340.50,94,$-148.50
2024-05-10,12:02:00,18285.25,BUY,3,0.02h,Break Even,$-1.50,$-150.00,$62339.00,94,$-150.00
2024-05-10,12:04:00,18282.5,SELL,3,0.02h,Stop Loss,$-9.00,$-159.00,$62330.00,94,$-159.00
2024-05-10,12:15:00,18289.5,BUY,3,0.02h,Stop Loss,$-9.00,$-168.00,$62321.00,94,$-168.00
2024-05-10,12:36:00,18282.0,SELL,3,0.02h,Stop Loss,$-9.00,$-177.00,$62312.00,94,$-177.00
2024-05-10,13:11:00,18269.75,BUY,3,0.02h,Stop Loss,$-9.00,$-186.00,$62303.00,94,$-186.00
2024-05-10,14:02:00,18293.75,SELL,3,0.02h,Break Even,$-1.50,$-187.50,$62301.50,94,$-187.50
2024-05-10,15:16:00,18232.0,BUY,3,0.02h,Break Even,$-1.50,$-189.00,$62300.00,94,$-189.00
2024-05-10,15:38:00,18215.0,SELL,3,0.02h,Stop Loss,$-9.00,$-198.00,$62291.00,94,$-198.00
2024-05-10,15:53:00,18227.5,BUY,3,0.02h,Stop Loss,$27.00,$-171.00,$62318.00,94,$-171.00
2024-05-10,16:05:00,18214.0,SELL,3,0.02h,Stop Loss,$-9.00,$-180.00,$62309.00,94,$-180.00
2024-05-10,16:11:00,18227.75,BUY,3,0.02h,Break Even,$-1.50,$-181.50,$62307.50,94,$-181.50
2024-05-10,16:37:00,18226.25,SELL,3,0.02h,Stop Loss,$4.50,$-177.00,$62312.00,94,$-177.00
2024-05-10,16:49:00,18246.5,BUY,3,0.02h,Stop Loss,$10.50,$-166.50,$62322.50,94,$-166.50
2024-05-10,17:06:00,18235.75,SELL,3,0.02h,Break Even,$-1.50,$-168.00,$62321.00,94,$-168.00
2024-05-10,17:38:00,18231.75,BUY,3,0.02h,Break Even,$-1.50,$-169.50,$62319.50,94,$-169.50
2024-05-10,17:39:00,18225.0,SELL,3,0.02h,Stop Loss,$-9.00,$-178.50,$62310.50,94,$-178.50
2024-05-10,17:53:00,18235.25,BUY,3,0.02h,Break Even,$-1.50,$-180.00,$62309.00,94,$-180.00
2024-05-10,18:28:00,18247.25,SELL,3,0.02h,Stop Loss,$-9.00,$-189.00,$62300.00,94,$-189.00
2024-05-10,18:49:00,18248.25,BUY,3,0.02h,Stop Loss,$-9.00,$-198.00,$62291.00,94,$-198.00
2024-05-10,19:45:00,18250.75,SELL,3,0.02h,Break Even,$-1.50,$-199.50,$62289.50,94,$-199.50
2024-05-10,19:55:00,18265.0,BUY,3,0.02h,Break Even,$-1.50,$-201.00,$62288.00,94,$-201.00
2024-05-10,20:02:00,18248.5,SELL,3,0.02h,Break Even,$-1.50,$-202.50,$62286.50,94,$-202.50
,,,,,,,,,,,
2024-05-13,00:00:00,18245.75,BUY,3,0.02h,Stop Loss,$-9.00,$-9.00,$62277.50,95,$-9.00
2024-05-13,00:23:00,18243.25,SELL,3,0.02h,Stop Loss,$-9.00,$-18.00,$62268.50,95,$-18.00
2024-05-13,00:41:00,18245.75,BUY,3,0.10h,Break Even,$-1.50,$-19.50,$62267.00,95,$-19.50
2024-05-13,01:24:00,18254.75,SELL,3,0.03h,Stop Loss,$-9.00,$-28.50,$62258.00,95,$-28.50
2024-05-13,01:31:00,18257.5,BUY,3,0.02h,Stop Loss,$-9.00,$-37.50,$62249.00,95,$-37.50
2024-05-13,01:57:00,18257.0,SELL,3,0.02h,Stop Loss,$-9.00,$-46.50,$62240.00,95,$-46.50
2024-05-13,02:00:00,18260.0,BUY,3,0.02h,Break Even,$-1.50,$-48.00,$62238.50,95,$-48.00
2024-05-13,02:06:00,18258.0,SELL,3,0.07h,Stop Loss,$-9.00,$-57.00,$62229.50,95,$-57.00
2024-05-13,02:13:00,18259.25,BUY,3,0.02h,Stop Loss,$-9.00,$-66.00,$62220.50,95,$-66.00
2024-05-13,02:15:00,18258.25,SELL,3,0.03h,Stop Loss,$-9.00,$-75.00,$62211.50,95,$-75.00
2024-05-13,02:30:00,18257.5,SELL,3,0.13h,Break Even,$-1.50,$-76.50,$62210.00,95,$-76.50
2024-05-13,02:49:00,18259.0,BUY,3,0.02h,Stop Loss,$-9.00,$-85.50,$62201.00,95,$-85.50
2024-05-13,02:51:00,18256.75,SELL,3,0.03h,Break Even,$-1.50,$-87.00,$62199.50,95,$-87.00
2024-05-13,03:21:00,18256.25,BUY,3,0.02h,Stop Loss,$84.00,$-3.00,$62283.50,95,$-3.00
2024-05-13,04:15:00,18275.5,SELL,3,0.02h,Break Even,$-1.50,$-4.50,$62282.00,95,$-4.50
2024-05-13,04:32:00,18279.5,BUY,3,0.02h,Stop Loss,$-9.00,$-13.50,$62273.00,95,$-13.50
2024-05-13,06:10:00,18294.25,SELL,3,0.02h,Stop Loss,$-9.00,$-22.50,$62264.00,95,$-22.50
2024-05-13,06:30:00,18297.0,BUY,3,0.02h,Break Even,$-1.50,$-24.00,$62262.50,95,$-24.00
2024-05-13,06:46:00,18293.75,SELL,3,0.02h,Stop Loss,$-9.00,$-33.00,$62253.50,95,$-33.00
2024-05-13,06:47:00,18296.5,BUY,3,0.02h,Stop Loss,$-9.00,$-42.00,$62244.50,95,$-42.00
2024-05-13,06:49:00,18293.75,SELL,3,0.03h,Stop Loss,$-9.00,$-51.00,$62235.50,95,$-51.00
2024-05-13,07:08:00,18294.0,BUY,3,0.03h,Break Even,$-1.50,$-52.50,$62234.00,95,$-52.50
2024-05-13,07:16:00,18290.0,SELL,3,0.02h,Break Even,$-1.50,$-54.00,$62232.50,95,$-54.00
2024-05-13,07:52:00,18289.5,BUY,3,0.02h,Stop Loss,$-9.00,$-63.00,$62223.50,95,$-63.00
2024-05-13,08:07:00,18281.75,SELL,3,0.02h,Stop Loss,$7.50,$-55.50,$62231.00,95,$-55.50
2024-05-13,08:14:00,18292.0,BUY,3,0.02h,Stop Loss,$-9.00,$-64.50,$62222.00,95,$-64.50
2024-05-13,08:16:00,18284.75,SELL,3,0.02h,Stop Loss,$21.00,$-43.50,$62243.00,95,$-43.50
2024-05-13,08:30:00,18288.25,BUY,3,0.02h,Stop Loss,$-9.00,$-52.50,$62234.00,95,$-52.50
2024-05-13,08:36:00,18281.5,SELL,3,0.02h,Break Even,$-1.50,$-54.00,$62232.50,95,$-54.00
2024-05-13,08:58:00,18282.25,BUY,3,0.02h,Stop Loss,$-9.00,$-63.00,$62223.50,95,$-63.00
2024-05-13,09:01:00,18277.0,SELL,3,0.02h,Stop Loss,$-9.00,$-72.00,$62214.50,95,$-72.00
2024-05-13,09:04:00,18281.5,BUY,3,0.02h,Break Even,$-1.50,$-73.50,$62213.00,95,$-73.50
2024-05-13,09:54:00,18294.0,SELL,3,0.02h,Stop Loss,$9.00,$-64.50,$62222.00,95,$-64.50
2024-05-13,10:15:00,18292.75,BUY,3,0.02h,Stop Loss,$-9.00,$-73.50,$62213.00,95,$-73.50
2024-05-13,10:25:00,18289.0,SELL,3,0.02h,Break Even,$-1.50,$-75.00,$62211.50,95,$-75.00
2024-05-13,10:28:00,18292.75,BUY,3,0.03h,Break Even,$-1.50,$-76.50,$62210.00,95,$-76.50
2024-05-13,11:36:00,18307.0,SELL,3,0.02h,Stop Loss,$-9.00,$-85.50,$62201.00,95,$-85.50
2024-05-13,11:44:00,18314.0,BUY,3,0.02h,Break Even,$-1.50,$-87.00,$62199.50,95,$-87.00
2024-05-13,12:14:00,18315.25,SELL,3,0.02h,Break Even,$-1.50,$-88.50,$62198.00,95,$-88.50
2024-05-13,12:37:00,18311.25,BUY,3,0.02h,Break Even,$-1.50,$-90.00,$62196.50,95,$-90.00
2024-05-13,13:03:00,18312.25,SELL,3,0.02h,Stop Loss,$22.50,$-67.50,$62219.00,95,$-67.50
2024-05-13,13:14:00,18321.5,BUY,3,0.02h,Break Even,$-1.50,$-69.00,$62217.50,95,$-69.00
2024-05-13,13:34:00,18310.5,SELL,3,0.02h,Stop Loss,$91.50,$22.50,$62309.00,95,$22.50
2024-05-13,14:04:00,18293.25,BUY,3,0.02h,Stop Loss,$18.00,$40.50,$62327.00,95,$40.50
2024-05-13,14:33:00,18288.25,SELL,3,0.02h,Stop Loss,$-9.00,$31.50,$62318.00,95,$31.50
2024-05-13,14:50:00,18300.25,BUY,3,0.02h,Break Even,$-1.50,$30.00,$62316.50,95,$30.00
2024-05-13,15:01:00,18289.5,SELL,3,0.02h,Stop Loss,$-9.00,$21.00,$62307.50,95,$21.00
2024-05-13,15:10:00,18296.5,BUY,3,0.02h,Stop Loss,$37.50,$58.50,$62345.00,95,$58.50
2024-05-13,15:22:00,18287.0,SELL,3,0.02h,Stop Loss,$9.00,$67.50,$62354.00,95,$67.50
2024-05-13,15:53:00,18289.0,BUY,3,0.02h,Break Even,$-1.50,$66.00,$62352.50,95,$66.00
2024-05-13,16:43:00,18297.25,SELL,3,0.02h,Stop Loss,$-9.00,$57.00,$62343.50,95,$57.00
2024-05-13,17:21:00,18285.75,BUY,3,0.02h,Stop Loss,$30.00,$87.00,$62373.50,95,$87.00
2024-05-13,17:39:00,18279.25,SELL,3,0.02h,Break Even,$-1.50,$85.50,$62372.00,95,$85.50
2024-05-13,17:59:00,18285.0,BUY,3,0.02h,Stop Loss,$-9.00,$76.50,$62363.00,95,$76.50
2024-05-13,18:02:00,18272.5,SELL,3,0.02h,Stop Loss,$3.00,$79.50,$62366.00,95,$79.50
2024-05-13,18:14:00,18279.0,BUY,3,0.02h,Stop Loss,$-9.00,$70.50,$62357.00,95,$70.50
2024-05-13,18:17:00,18274.0,SELL,3,0.02h,Break Even,$-1.50,$69.00,$62355.50,95,$69.00
2024-05-13,18:18:00,18279.0,BUY,3,0.02h,Break Even,$-1.50,$67.50,$62354.00,95,$67.50
2024-05-13,18:34:00,18278.0,SELL,3,0.02h,Stop Loss,$-9.00,$58.50,$62345.00,95,$58.50
2024-05-13,18:35:00,18284.5,BUY,3,0.02h,Break Even,$-1.50,$57.00,$62343.50,95,$57.00
2024-05-13,18:50:00,18278.0,SELL,3,0.02h,Break Even,$-1.50,$55.50,$62342.00,95,$55.50
2024-05-13,19:00:00,18288.0,BUY,3,0.02h,Stop Loss,$-9.00,$46.50,$62333.00,95,$46.50
2024-05-13,19:25:00,18282.0,SELL,3,0.02h,Break Even,$-1.50,$45.00,$62331.50,95,$45.00
2024-05-13,19:34:00,18290.75,BUY,3,0.02h,Break Even,$-1.50,$43.50,$62330.00,95,$43.50
2024-05-13,19:50:00,18287.5,SELL,3,0.02h,Stop Loss,$-9.00,$34.50,$62321.00,95,$34.50
2024-05-13,19:53:00,18298.5,BUY,3,0.02h,Break Even,$-1.50,$33.00,$62319.50,95,$33.00
2024-05-13,19:57:00,18285.5,SELL,3,0.02h,Stop Loss,$-9.00,$24.00,$62310.50,95,$24.00
2024-05-13,20:01:00,18295.75,BUY,3,0.02h,Stop Loss,$6.00,$30.00,$62316.50,95,$30.00
2024-05-13,20:09:00,18288.0,SELL,3,0.02h,Break Even,$-1.50,$28.50,$62315.00,95,$28.50
2024-05-13,20:27:00,18290.25,BUY,3,0.07h,Break Even,$-1.50,$27.00,$62313.50,95,$27.00
2024-05-13,20:41:00,18289.5,SELL,3,0.02h,Break Even,$-1.50,$25.50,$62312.00,95,$25.50
2024-05-13,23:20:00,18283.25,BUY,3,0.03h,Stop Loss,$-9.00,$16.50,$62303.00,95,$16.50
,,,,,,,,,,,
2024-05-14,00:00:00,18284.0,SELL,3,0.02h,Break Even,$-1.50,$-1.50,$62301.50,96,$-1.50
2024-05-14,00:10:00,18286.0,BUY,3,0.02h,Stop Loss,$-9.00,$-10.50,$62292.50,96,$-10.50
2024-05-14,00:34:00,18285.75,SELL,3,0.10h,Break Even,$-1.50,$-12.00,$62291.00,96,$-12.00
2024-05-14,01:39:00,18275.0,BUY,3,0.02h,Stop Loss,$-9.00,$-21.00,$62282.00,96,$-21.00
2024-05-14,01:40:00,18272.75,SELL,3,0.02h,Break Even,$-1.50,$-22.50,$62280.50,96,$-22.50
2024-05-14,01:47:00,18274.0,BUY,3,0.02h,Stop Loss,$-9.00,$-31.50,$62271.50,96,$-31.50
2024-05-14,02:13:00,18274.75,SELL,3,0.05h,Stop Loss,$-9.00,$-40.50,$62262.50,96,$-40.50
2024-05-14,02:34:00,18275.75,BUY,3,0.03h,Stop Loss,$-9.00,$-49.50,$62253.50,96,$-49.50
2024-05-14,02:36:00,18274.5,SELL,3,0.05h,Stop Loss,$-9.00,$-58.50,$62244.50,96,$-58.50
2024-05-14,02:40:00,18276.25,BUY,3,0.10h,Break Even,$-1.50,$-60.00,$62243.00,96,$-60.00
2024-05-14,02:51:00,18274.75,SELL,3,0.07h,Break Even,$-1.50,$-61.50,$62241.50,96,$-61.50
2024-05-14,03:47:00,18267.25,BUY,3,0.02h,Stop Loss,$-9.00,$-70.50,$62232.50,96,$-70.50
2024-05-14,03:49:00,18265.75,SELL,3,0.02h,Stop Loss,$-9.00,$-79.50,$62223.50,96,$-79.50
2024-05-14,03:51:00,18267.5,BUY,3,0.03h,Stop Loss,$-9.00,$-88.50,$62214.50,96,$-88.50
2024-05-14,03:54:00,18264.75,SELL,3,0.02h,Break Even,$-1.50,$-90.00,$62213.00,96,$-90.00
2024-05-14,04:10:00,18267.75,BUY,3,0.03h,Stop Loss,$-9.00,$-99.00,$62204.00,96,$-99.00
2024-05-14,04:53:00,18269.5,SELL,3,0.12h,Stop Loss,$-9.00,$-108.00,$62195.00,96,$-108.00
2024-05-14,05:05:00,18271.75,BUY,3,0.02h,Break Even,$-1.50,$-109.50,$62193.50,96,$-109.50
2024-05-14,05:52:00,18277.5,SELL,3,0.05h,Stop Loss,$-9.00,$-118.50,$62184.50,96,$-118.50
2024-05-14,05:58:00,18280.25,BUY,3,0.02h,Break Even,$-1.50,$-120.00,$62183.00,96,$-120.00
2024-05-14,07:04:00,18288.25,SELL,3,0.02h,Stop Loss,$-9.00,$-129.00,$62174.00,96,$-129.00
2024-05-14,07:09:00,18291.5,BUY,3,0.02h,Stop Loss,$-9.00,$-138.00,$62165.00,96,$-138.00
2024-05-14,07:10:00,18287.0,SELL,3,0.02h,Stop Loss,$-9.00,$-147.00,$62156.00,96,$-147.00
2024-05-14,07:13:00,18290.5,BUY,3,0.02h,Break Even,$-1.50,$-148.50,$62154.50,96,$-148.50
2024-05-14,07:34:00,18288.0,SELL,3,0.02h,Stop Loss,$-9.00,$-157.50,$62145.50,96,$-157.50
2024-05-14,07:43:00,18294.25,BUY,3,0.02h,Break Even,$-1.50,$-159.00,$62144.00,96,$-159.00
2024-05-14,07:51:00,18291.0,SELL,3,0.03h,Stop Loss,$-9.00,$-168.00,$62135.00,96,$-168.00
2024-05-14,08:05:00,18294.25,BUY,3,0.02h,Stop Loss,$-9.00,$-177.00,$62126.00,96,$-177.00
2024-05-14,09:18:00,18301.0,SELL,3,0.02h,Stop Loss,$-9.00,$-186.00,$62117.00,96,$-186.00
2024-05-14,09:53:00,18297.25,BUY,3,0.02h,Stop Loss,$-9.00,$-195.00,$62108.00,96,$-195.00
2024-05-14,10:16:00,18294.0,SELL,3,0.02h,Break Even,$-1.50,$-196.50,$62106.50,96,$-196.50
2024-05-14,10:29:00,18298.0,BUY,3,0.02h,Stop Loss,$-9.00,$-205.50,$62097.50,96,$-205.50
2024-05-14,10:32:00,18294.0,SELL,3,0.02h,Stop Loss,$-9.00,$-214.50,$62088.50,96,$-214.50
2024-05-14,10:44:00,18297.0,BUY,3,0.02h,Break Even,$-1.50,$-216.00,$62087.00,96,$-216.00
2024-05-14,11:09:00,18293.25,SELL,3,0.02h,Stop Loss,$-9.00,$-225.00,$62078.00,96,$-225.00
2024-05-14,11:23:00,18298.5,BUY,3,0.02h,Stop Loss,$-9.00,$-234.00,$62069.00,96,$-234.00
2024-05-14,11:24:00,18295.0,SELL,3,0.02h,Stop Loss,$-9.00,$-243.00,$62060.00,96,$-243.00
2024-05-14,11:48:00,18290.5,BUY,3,0.02h,Break Even,$-1.50,$-244.50,$62058.50,96,$-244.50
2024-05-14,11:57:00,18287.75,SELL,3,0.02h,Break Even,$-1.50,$-246.00,$62057.00,96,$-246.00
2024-05-14,12:06:00,18293.5,BUY,3,0.02h,Stop Loss,$-9.00,$-255.00,$62048.00,96,$-255.00
2024-05-14,12:31:00,18221.0,SELL,3,0.02h,Stop Loss,$97.50,$-157.50,$62145.50,96,$-157.50
2024-05-14,12:54:00,18269.25,BUY,3,0.02h,Break Even,$-1.50,$-159.00,$62144.00,96,$-159.00
2024-05-14,13:01:00,18252.5,SELL,3,0.02h,Break Even,$-1.50,$-160.50,$62142.50,96,$-160.50
2024-05-14,13:10:00,18265.0,BUY,3,0.02h,Stop Loss,$16.50,$-144.00,$62159.00,96,$-144.00
2024-05-14,14:00:00,18290.0,SELL,3,0.02h,Stop Loss,$7.50,$-136.50,$62166.50,96,$-136.50
2024-05-14,14:12:00,18307.25,BUY,3,0.02h,Stop Loss,$25.50,$-111.00,$62192.00,96,$-111.00
2024-05-14,14:18:00,18286.0,SELL,3,0.02h,Stop Loss,$27.00,$-84.00,$62219.00,96,$-84.00
2024-05-14,14:23:00,18313.5,BUY,3,0.02h,Stop Loss,$108.00,$24.00,$62327.00,96,$24.00
2024-05-14,14:39:00,18302.5,SELL,3,0.02h,Stop Loss,$12.00,$36.00,$62339.00,96,$36.00
2024-05-14,14:58:00,18324.75,BUY,3,0.02h,Stop Loss,$60.00,$96.00,$62399.00,96,$96.00
2024-05-14,15:34:00,18337.5,SELL,3,0.02h,Stop Loss,$9.00,$105.00,$62408.00,96,$105.00
2024-05-14,16:10:00,18328.25,BUY,3,0.02h,Stop Loss,$-9.00,$96.00,$62399.00,96,$96.00
2024-05-14,16:18:00,18318.75,SELL,3,0.02h,Break Even,$-1.50,$94.50,$62397.50,96,$94.50
2024-05-14,16:55:00,18311.75,BUY,3,0.02h,Break Even,$-1.50,$93.00,$62396.00,96,$93.00
2024-05-14,17:07:00,18302.75,SELL,3,0.02h,Break Even,$-1.50,$91.50,$62394.50,96,$91.50
2024-05-14,17:23:00,18313.5,BUY,3,0.02h,Stop Loss,$3.00,$94.50,$62397.50,96,$94.50
2024-05-14,19:50:00,18413.0,SELL,3,0.02h,Stop Loss,$-9.00,$85.50,$62388.50,96,$85.50
2024-05-14,19:52:00,18424.5,BUY,3,0.02h,Stop Loss,$9.00,$94.50,$62397.50,96,$94.50
2024-05-14,20:01:00,18412.25,SELL,3,0.02h,Break Even,$-1.50,$93.00,$62396.00,96,$93.00
2024-05-14,20:51:00,18410.0,BUY,3,0.02h,Stop Loss,$-9.00,$84.00,$62387.00,96,$84.00
2024-05-14,23:28:00,18418.25,SELL,3,0.03h,Stop Loss,$-9.00,$75.00,$62378.00,96,$75.00
2024-05-14,23:58:00,18418.0,BUY,3,0.05h,Break Even,$-1.50,$73.50,$62376.50,96,$73.50
,,,,,,,,,,,
2024-05-15,00:01:00,18419.25,BUY,3,0.02h,Stop Loss,$-9.00,$-9.00,$62367.50,97,$-9.00
2024-05-15,00:25:00,18419.25,SELL,3,0.03h,Stop Loss,$-9.00,$-18.00,$62358.50,97,$-18.00
2024-05-15,01:04:00,18411.5,BUY,3,0.02h,Stop Loss,$-9.00,$-27.00,$62349.50,97,$-27.00
2024-05-15,02:13:00,18420.25,SELL,3,0.05h,Stop Loss,$-9.00,$-36.00,$62340.50,97,$-36.00
2024-05-15,02:25:00,18421.25,BUY,3,0.22h,Stop Loss,$13.50,$-22.50,$62354.00,97,$-22.50
2024-05-15,02:57:00,18426.5,SELL,3,0.02h,Stop Loss,$-9.00,$-31.50,$62345.00,97,$-31.50
2024-05-15,02:59:00,18427.5,BUY,3,0.03h,Stop Loss,$-9.00,$-40.50,$62336.00,97,$-40.50
2024-05-15,03:38:00,18427.0,SELL,3,0.02h,Stop Loss,$-9.00,$-49.50,$62327.00,97,$-49.50
2024-05-15,05:14:00,18413.5,BUY,3,0.02h,Stop Loss,$-9.00,$-58.50,$62318.00,97,$-58.50
2024-05-15,05:20:00,18411.25,SELL,3,0.02h,Stop Loss,$-9.00,$-67.50,$62309.00,97,$-67.50
2024-05-15,05:22:00,18412.25,BUY,3,0.05h,Stop Loss,$7.50,$-60.00,$62316.50,97,$-60.00
2024-05-15,05:39:00,18412.25,SELL,3,0.05h,Break Even,$-1.50,$-61.50,$62315.00,97,$-61.50
2024-05-15,05:52:00,18412.75,BUY,3,0.03h,Stop Loss,$-9.00,$-70.50,$62306.00,97,$-70.50
2024-05-15,06:03:00,18405.5,SELL,3,0.02h,Stop Loss,$-9.00,$-79.50,$62297.00,97,$-79.50
2024-05-15,06:11:00,18416.0,BUY,3,0.02h,Break Even,$-1.50,$-81.00,$62295.50,97,$-81.00
2024-05-15,06:25:00,18411.75,SELL,3,0.02h,Stop Loss,$-9.00,$-90.00,$62286.50,97,$-90.00
2024-05-15,06:52:00,18413.5,BUY,3,0.08h,Break Even,$-1.50,$-91.50,$62285.00,97,$-91.50
2024-05-15,07:11:00,18410.5,SELL,3,0.02h,Break Even,$-1.50,$-93.00,$62283.50,97,$-93.00
2024-05-15,07:57:00,18404.25,BUY,3,0.02h,Break Even,$-1.50,$-94.50,$62282.00,97,$-94.50
2024-05-15,08:20:00,18402.0,SELL,3,0.02h,Break Even,$-1.50,$-96.00,$62280.50,97,$-96.00
2024-05-15,08:28:00,18404.25,BUY,3,0.02h,Break Even,$-1.50,$-97.50,$62279.00,97,$-97.50
2024-05-15,09:22:00,18413.5,SELL,3,0.02h,Break Even,$-1.50,$-99.00,$62277.50,97,$-99.00
2024-05-15,09:37:00,18413.0,BUY,3,0.02h,Stop Loss,$-9.00,$-108.00,$62268.50,97,$-108.00
2024-05-15,09:38:00,18412.25,SELL,3,0.02h,Stop Loss,$-9.00,$-117.00,$62259.50,97,$-117.00
2024-05-15,09:39:00,18414.25,BUY,3,0.02h,Break Even,$-1.50,$-118.50,$62258.00,97,$-118.50
2024-05-15,09:57:00,18412.5,SELL,3,0.02h,Stop Loss,$-9.00,$-127.50,$62249.00,97,$-127.50
2024-05-15,10:24:00,18413.0,BUY,3,0.02h,Stop Loss,$-9.00,$-136.50,$62240.00,97,$-136.50
2024-05-15,10:32:00,18410.0,SELL,3,0.02h,Stop Loss,$-9.00,$-145.50,$62231.00,97,$-145.50
2024-05-15,11:03:00,18411.75,BUY,3,0.02h,Stop Loss,$-9.00,$-154.50,$62222.00,97,$-154.50
2024-05-15,11:41:00,18410.5,SELL,3,0.02h,Stop Loss,$-9.00,$-163.50,$62213.00,97,$-163.50
2024-05-15,11:53:00,18415.25,BUY,3,0.02h,Break Even,$-1.50,$-165.00,$62211.50,97,$-165.00
2024-05-15,11:58:00,18411.5,SELL,3,0.02h,Stop Loss,$-9.00,$-174.00,$62202.50,97,$-174.00
2024-05-15,12:31:00,18523.25,BUY,3,0.02h,Stop Loss,$121.50,$-52.50,$62324.00,97,$-52.50
2024-05-15,13:22:00,18501.25,SELL,3,0.02h,Stop Loss,$-9.00,$-61.50,$62315.00,97,$-61.50
2024-05-15,13:25:00,18510.25,BUY,3,0.02h,Stop Loss,$-9.00,$-70.50,$62306.00,97,$-70.50
2024-05-15,13:26:00,18500.0,SELL,3,0.02h,Break Even,$-1.50,$-72.00,$62304.50,97,$-72.00
2024-05-15,13:29:00,18509.0,BUY,3,0.02h,Stop Loss,$-9.00,$-81.00,$62295.50,97,$-81.00
2024-05-15,13:46:00,18504.5,SELL,3,0.02h,Stop Loss,$87.00,$6.00,$62382.50,97,$6.00
2024-05-15,14:04:00,18505.75,BUY,3,0.02h,Stop Loss,$22.50,$28.50,$62405.00,97,$28.50
2024-05-15,16:01:00,18582.75,SELL,3,0.02h,Stop Loss,$-9.00,$19.50,$62396.00,97,$19.50
2024-05-15,16:12:00,18601.0,BUY,3,0.02h,Stop Loss,$-9.00,$10.50,$62387.00,97,$10.50
2024-05-15,18:29:00,18683.0,SELL,3,0.02h,Stop Loss,$-9.00,$1.50,$62378.00,97,$1.50
2024-05-15,18:41:00,18689.75,BUY,3,0.02h,Stop Loss,$-9.00,$-7.50,$62369.00,97,$-7.50
2024-05-15,18:45:00,18680.5,SELL,3,0.02h,Stop Loss,$3.00,$-4.50,$62372.00,97,$-4.50
2024-05-15,18:55:00,18687.75,BUY,3,0.02h,Stop Loss,$-9.00,$-13.50,$62363.00,97,$-13.50
2024-05-15,19:03:00,18681.5,SELL,3,0.02h,Break Even,$-1.50,$-15.00,$62361.50,97,$-15.00
2024-05-15,19:06:00,18687.5,BUY,3,0.02h,Stop Loss,$-9.00,$-24.00,$62352.50,97,$-24.00
2024-05-15,19:34:00,18688.5,SELL,3,0.02h,Break Even,$-1.50,$-25.50,$62351.00,97,$-25.50
2024-05-15,19:57:00,18695.5,BUY,3,0.02h,Stop Loss,$12.00,$-13.50,$62363.00,97,$-13.50
2024-05-15,20:01:00,18681.5,SELL,3,0.02h,Stop Loss,$16.50,$3.00,$62379.50,97,$3.00
2024-05-15,20:31:00,18686.0,BUY,3,0.02h,Break Even,$-1.50,$1.50,$62378.00,97,$1.50
2024-05-15,20:51:00,18684.75,SELL,3,0.02h,Break Even,$-1.50,$0.00,$62376.50,97,$0.00
2024-05-15,20:57:00,18692.25,BUY,3,2.05h,Stop Loss,$45.00,$45.00,$62421.50,97,$45.00
,,,,,,,,,,,
2024-05-16,00:29:00,18724.5,SELL,3,0.02h,Break Even,$-1.50,$-1.50,$62420.00,98,$-1.50
2024-05-16,00:55:00,18722.25,BUY,3,0.02h,Break Even,$-1.50,$-3.00,$62418.50,98,$-3.00
2024-05-16,01:11:00,18722.5,SELL,3,0.03h,Stop Loss,$-9.00,$-12.00,$62409.50,98,$-12.00
2024-05-16,01:17:00,18724.5,BUY,3,0.02h,Stop Loss,$-9.00,$-21.00,$62400.50,98,$-21.00
2024-05-16,01:18:00,18723.5,SELL,3,0.02h,Stop Loss,$-9.00,$-30.00,$62391.50,98,$-30.00
2024-05-16,01:19:00,18724.25,BUY,3,0.02h,Stop Loss,$-9.00,$-39.00,$62382.50,98,$-39.00
2024-05-16,01:20:00,18722.0,SELL,3,0.02h,Stop Loss,$-9.00,$-48.00,$62373.50,98,$-48.00
2024-05-16,01:23:00,18726.25,BUY,3,0.02h,Break Even,$-1.50,$-49.50,$62372.00,98,$-49.50
2024-05-16,01:40:00,18724.25,SELL,3,0.03h,Stop Loss,$-9.00,$-58.50,$62363.00,98,$-58.50
2024-05-16,02:24:00,18722.25,BUY,3,0.02h,Stop Loss,$-9.00,$-67.50,$62354.00,98,$-67.50
2024-05-16,03:49:00,18731.5,SELL,3,0.02h,Stop Loss,$-9.00,$-76.50,$62345.00,98,$-76.50
2024-05-16,03:54:00,18733.75,BUY,3,0.02h,Stop Loss,$-9.00,$-85.50,$62336.00,98,$-85.50
2024-05-16,03:57:00,18731.5,SELL,3,0.03h,Stop Loss,$-9.00,$-94.50,$62327.00,98,$-94.50
2024-05-16,05:26:00,18724.5,BUY,3,0.02h,Break Even,$-1.50,$-96.00,$62325.50,98,$-96.00
2024-05-16,05:55:00,18727.0,SELL,3,0.03h,Break Even,$-1.50,$-97.50,$62324.00,98,$-97.50
2024-05-16,06:40:00,18721.5,BUY,3,0.02h,Break Even,$-1.50,$-99.00,$62322.50,98,$-99.00
2024-05-16,06:58:00,18716.25,SELL,3,0.03h,Break Even,$-1.50,$-100.50,$62321.00,98,$-100.50
2024-05-16,07:05:00,18723.0,BUY,3,0.02h,Stop Loss,$-9.00,$-109.50,$62312.00,98,$-109.50
2024-05-16,07:42:00,18723.5,SELL,3,0.03h,Stop Loss,$-9.00,$-118.50,$62303.00,98,$-118.50
2024-05-16,07:46:00,18727.5,BUY,3,0.02h,Stop Loss,$-9.00,$-127.50,$62294.00,98,$-127.50
2024-05-16,07:48:00,18723.25,SELL,3,0.02h,Stop Loss,$-9.00,$-136.50,$62285.00,98,$-136.50
2024-05-16,07:58:00,18726.5,BUY,3,0.02h,Break Even,$-1.50,$-138.00,$62283.50,98,$-138.00
2024-05-16,08:10:00,18720.0,SELL,3,0.02h,Break Even,$-1.50,$-139.50,$62282.00,98,$-139.50
2024-05-16,08:36:00,18719.25,BUY,3,0.02h,Break Even,$-1.50,$-141.00,$62280.50,98,$-141.00
2024-05-16,08:59:00,18720.0,SELL,3,0.03h,Stop Loss,$-9.00,$-150.00,$62271.50,98,$-150.00
2024-05-16,09:08:00,18722.0,BUY,3,0.02h,Break Even,$-1.50,$-151.50,$62270.00,98,$-151.50
2024-05-16,09:13:00,18721.25,SELL,3,0.03h,Break Even,$-1.50,$-153.00,$62268.50,98,$-153.00
2024-05-16,09:16:00,18725.0,BUY,3,0.02h,Break Even,$-1.50,$-154.50,$62267.00,98,$-154.50
2024-05-16,09:29:00,18721.5,SELL,3,0.02h,Stop Loss,$-9.00,$-163.50,$62258.00,98,$-163.50
2024-05-16,09:41:00,18723.5,BUY,3,0.03h,Stop Loss,$-9.00,$-172.50,$62249.00,98,$-172.50
2024-05-16,09:57:00,18721.5,SELL,3,0.02h,Stop Loss,$-9.00,$-181.50,$62240.00,98,$-181.50
2024-05-16,10:44:00,18721.0,BUY,3,0.02h,Break Even,$-1.50,$-183.00,$62238.50,98,$-183.00
2024-05-16,11:04:00,18718.25,SELL,3,0.02h,Stop Loss,$-9.00,$-192.00,$62229.50,98,$-192.00
2024-05-16,11:20:00,18720.75,BUY,3,0.02h,Stop Loss,$-9.00,$-201.00,$62220.50,98,$-201.00
2024-05-16,11:22:00,18718.25,SELL,3,0.02h,Stop Loss,$-9.00,$-210.00,$62211.50,98,$-210.00
2024-05-16,11:29:00,18720.25,BUY,3,0.02h,Stop Loss,$6.00,$-204.00,$62217.50,98,$-204.00
2024-05-16,11:34:00,18714.5,SELL,3,0.02h,Stop Loss,$-9.00,$-213.00,$62208.50,98,$-213.00
2024-05-16,11:48:00,18718.5,BUY,3,0.02h,Break Even,$-1.50,$-214.50,$62207.00,98,$-214.50
2024-05-16,11:57:00,18716.25,SELL,3,0.02h,Stop Loss,$-9.00,$-223.50,$62198.00,98,$-223.50
2024-05-16,11:58:00,18718.25,BUY,3,0.02h,Stop Loss,$-9.00,$-232.50,$62189.00,98,$-232.50
2024-05-16,11:59:00,18715.5,SELL,3,0.02h,Stop Loss,$-9.00,$-241.50,$62180.00,98,$-241.50
2024-05-16,12:22:00,18719.25,BUY,3,0.02h,Stop Loss,$-9.00,$-250.50,$62171.00,98,$-250.50
2024-05-16,12:32:00,18711.5,SELL,3,0.02h,Stop Loss,$48.00,$-202.50,$62219.00,98,$-202.50
2024-05-16,13:39:00,18692.75,BUY,3,0.02h,Break Even,$-1.50,$-204.00,$62217.50,98,$-204.00
2024-05-16,14:07:00,18691.0,SELL,3,0.02h,Stop Loss,$84.00,$-120.00,$62301.50,98,$-120.00
2024-05-16,14:19:00,18702.75,BUY,3,0.02h,Stop Loss,$15.00,$-105.00,$62316.50,98,$-105.00
2024-05-16,15:17:00,18732.0,SELL,3,0.02h,Stop Loss,$6.00,$-99.00,$62322.50,98,$-99.00
2024-05-16,15:31:00,18744.25,BUY,3,0.02h,Break Even,$-1.50,$-100.50,$62321.00,98,$-100.50
2024-05-16,15:41:00,18734.25,SELL,3,0.02h,Break Even,$-1.50,$-102.00,$62319.50,98,$-102.00
2024-05-16,15:53:00,18742.0,BUY,3,0.02h,Stop Loss,$3.00,$-99.00,$62322.50,98,$-99.00
2024-05-16,16:01:00,18731.75,SELL,3,0.02h,Stop Loss,$108.00,$9.00,$62430.50,98,$9.00
2024-05-16,16:46:00,18727.0,BUY,3,0.02h,Break Even,$-1.50,$7.50,$62429.00,98,$7.50
2024-05-16,17:05:00,18724.0,SELL,3,0.02h,Break Even,$-1.50,$6.00,$62427.50,98,$6.00
2024-05-16,17:09:00,18732.0,BUY,3,0.02h,Break Even,$-1.50,$4.50,$62426.00,98,$4.50
2024-05-16,17:21:00,18719.5,SELL,3,0.02h,Stop Loss,$132.00,$136.50,$62558.00,98,$136.50
2024-05-16,17:55:00,18706.25,BUY,3,0.02h,Break Even,$-1.50,$135.00,$62556.50,98,$135.00
2024-05-16,18:07:00,18688.5,SELL,3,0.02h,Stop Loss,$18.00,$153.00,$62574.50,98,$153.00
2024-05-16,18:35:00,18685.0,BUY,3,0.02h,Stop Loss,$7.50,$160.50,$62582.00,98,$160.50
2024-05-16,18:58:00,18687.0,SELL,3,0.02h,Stop Loss,$-9.00,$151.50,$62573.00,98,$151.50
2024-05-16,19:00:00,18695.25,BUY,3,0.02h,Break Even,$-1.50,$150.00,$62571.50,98,$150.00
2024-05-16,19:19:00,18690.0,SELL,3,0.02h,Stop Loss,$-9.00,$141.00,$62562.50,98,$141.00
2024-05-16,19:55:00,18687.5,BUY,3,0.02h,Stop Loss,$-9.00,$132.00,$62553.50,98,$132.00
2024-05-16,19:57:00,18665.0,SELL,3,0.02h,Break Even,$-1.50,$130.50,$62552.00,98,$130.50
2024-05-16,20:45:00,18642.0,BUY,3,0.02h,Stop Loss,$-9.00,$121.50,$62543.00,98,$121.50
2024-05-16,20:53:00,18639.0,SELL,3,0.03h,Break Even,$-1.50,$120.00,$62541.50,98,$120.00
2024-05-16,23:00:00,18651.25,BUY,3,0.02h,Stop Loss,$-9.00,$111.00,$62532.50,98,$111.00
2024-05-16,23:49:00,18650.0,SELL,3,0.02h,Break Even,$-1.50,$109.50,$62531.00,98,$109.50
,,,,,,,,,,,
2024-05-17,00:02:00,18653.5,BUY,3,0.02h,Stop Loss,$-9.00,$-9.00,$62522.00,99,$-9.00
2024-05-17,00:14:00,18649.25,SELL,3,0.02h,Stop Loss,$-9.00,$-18.00,$62513.00,99,$-18.00
2024-05-17,00:24:00,18652.5,BUY,3,0.02h,Stop Loss,$-9.00,$-27.00,$62504.00,99,$-27.00
2024-05-17,00:26:00,18650.5,SELL,3,0.03h,Break Even,$-1.50,$-28.50,$62502.50,99,$-28.50
2024-05-17,00:36:00,18652.5,BUY,3,0.02h,Stop Loss,$-9.00,$-37.50,$62493.50,99,$-37.50
2024-05-17,02:02:00,18662.25,SELL,3,0.03h,Break Even,$-1.50,$-39.00,$62492.00,99,$-39.00
2024-05-17,03:27:00,18650.25,BUY,3,0.03h,Stop Loss,$-9.00,$-48.00,$62483.00,99,$-48.00
2024-05-17,04:04:00,18649.5,SELL,3,0.18h,Break Even,$-1.50,$-49.50,$62481.50,99,$-49.50
2024-05-17,04:18:00,18650.75,BUY,3,0.53h,Stop Loss,$31.50,$-18.00,$62513.00,99,$-18.00
2024-05-17,05:26:00,18660.0,SELL,3,0.02h,Break Even,$-1.50,$-19.50,$62511.50,99,$-19.50
2024-05-17,05:41:00,18659.75,BUY,3,0.02h,Stop Loss,$-9.00,$-28.50,$62502.50,99,$-28.50
2024-05-17,06:42:00,18665.5,SELL,3,0.02h,Break Even,$-1.50,$-30.00,$62501.00,99,$-30.00
2024-05-17,07:44:00,18656.5,BUY,3,0.02h,Break Even,$-1.50,$-31.50,$62499.50,99,$-31.50
2024-05-17,07:53:00,18652.25,SELL,3,0.02h,Break Even,$-1.50,$-33.00,$62498.00,99,$-33.00
2024-05-17,08:44:00,18629.0,BUY,3,0.02h,Break Even,$-1.50,$-34.50,$62496.50,99,$-34.50
2024-05-17,10:09:00,18648.75,SELL,3,0.02h,Stop Loss,$-9.00,$-43.50,$62487.50,99,$-43.50
2024-05-17,10:22:00,18658.0,BUY,3,0.02h,Stop Loss,$-9.00,$-52.50,$62478.50,99,$-52.50
2024-05-17,11:09:00,18658.25,SELL,3,0.02h,Stop Loss,$-9.00,$-61.50,$62469.50,99,$-61.50
2024-05-17,11:19:00,18663.5,BUY,3,0.02h,Break Even,$-1.50,$-63.00,$62468.00,99,$-63.00
2024-05-17,11:57:00,18667.0,SELL,3,0.02h,Break Even,$-1.50,$-64.50,$62466.50,99,$-64.50
2024-05-17,12:09:00,18670.75,BUY,3,0.02h,Stop Loss,$15.00,$-49.50,$62481.50,99,$-49.50
2024-05-17,12:17:00,18666.0,SELL,3,0.02h,Break Even,$-1.50,$-51.00,$62480.00,99,$-51.00
2024-05-17,12:22:00,18674.5,BUY,3,0.02h,Stop Loss,$19.50,$-31.50,$62499.50,99,$-31.50
2024-05-17,13:05:00,18677.75,SELL,3,0.02h,Break Even,$-1.50,$-33.00,$62498.00,99,$-33.00
2024-05-17,14:06:00,18645.5,BUY,3,0.02h,Stop Loss,$-9.00,$-42.00,$62489.00,99,$-42.00
2024-05-17,14:07:00,18635.0,SELL,3,0.02h,Stop Loss,$13.50,$-28.50,$62502.50,99,$-28.50
2024-05-17,14:22:00,18646.75,BUY,3,0.02h,Stop Loss,$4.50,$-24.00,$62507.00,99,$-24.00
2024-05-17,15:01:00,18658.5,SELL,3,0.02h,Stop Loss,$10.50,$-13.50,$62517.50,99,$-13.50
2024-05-17,15:30:00,18654.75,BUY,3,0.02h,Stop Loss,$-9.00,$-22.50,$62508.50,99,$-22.50
2024-05-17,15:32:00,18647.0,SELL,3,0.02h,Stop Loss,$7.50,$-15.00,$62516.00,99,$-15.00
2024-05-17,15:56:00,18646.0,BUY,3,0.02h,Break Even,$-1.50,$-16.50,$62514.50,99,$-16.50
2024-05-17,16:13:00,18643.25,SELL,3,0.02h,Break Even,$-1.50,$-18.00,$62513.00,99,$-18.00
2024-05-17,16:55:00,18637.75,BUY,3,0.02h,Break Even,$-1.50,$-19.50,$62511.50,99,$-19.50
2024-05-17,17:07:00,18630.0,SELL,3,0.02h,Stop Loss,$-9.00,$-28.50,$62502.50,99,$-28.50
2024-05-17,17:43:00,18626.0,BUY,3,0.02h,Break Even,$-1.50,$-30.00,$62501.00,99,$-30.00
2024-05-17,17:48:00,18620.0,SELL,3,0.02h,Stop Loss,$-9.00,$-39.00,$62492.00,99,$-39.00
2024-05-17,18:39:00,18581.25,BUY,3,0.02h,Stop Loss,$6.00,$-33.00,$62498.00,99,$-33.00
2024-05-17,18:45:00,18577.0,SELL,3,0.02h,Stop Loss,$-9.00,$-42.00,$62489.00,99,$-42.00
2024-05-17,18:49:00,18585.75,BUY,3,0.02h,Stop Loss,$21.00,$-21.00,$62510.00,99,$-21.00
2024-05-17,19:47:00,18626.5,SELL,3,0.02h,Break Even,$-1.50,$-22.50,$62508.50,99,$-22.50
2024-05-17,19:53:00,18631.0,BUY,3,0.02h,Break Even,$-1.50,$-24.00,$62507.00,99,$-24.00
2024-05-17,19:57:00,18625.0,SELL,3,0.02h,Stop Loss,$16.50,$-7.50,$62523.50,99,$-7.50
2024-05-17,20:00:00,18638.5,BUY,3,0.02h,Break Even,$-1.50,$-9.00,$62522.00,99,$-9.00
2024-05-17,20:01:00,18623.25,SELL,3,0.02h,Break Even,$-1.50,$-10.50,$62520.50,99,$-10.50
2024-05-17,20:19:00,18628.75,BUY,3,0.02h,Break Even,$-1.50,$-12.00,$62519.00,99,$-12.00
,,,,,,,,,,,
2024-05-20,00:59:00,18666.5,SELL,3,0.03h,Break Even,$-1.50,$-1.50,$62517.50,100,$-1.50
2024-05-20,01:24:00,18668.25,BUY,3,0.02h,Break Even,$-1.50,$-3.00,$62516.00,100,$-3.00
2024-05-20,01:31:00,18662.5,SELL,3,0.02h,Stop Loss,$-9.00,$-12.00,$62507.00,100,$-12.00
2024-05-20,01:46:00,18664.75,BUY,3,0.03h,Break Even,$-1.50,$-13.50,$62505.50,100,$-13.50
2024-05-20,02:04:00,18664.25,SELL,3,0.02h,Stop Loss,$-9.00,$-22.50,$62496.50,100,$-22.50
2024-05-20,02:05:00,18666.0,BUY,3,0.02h,Stop Loss,$-9.00,$-31.50,$62487.50,100,$-31.50
2024-05-20,02:06:00,18660.0,SELL,3,0.02h,Stop Loss,$-9.00,$-40.50,$62478.50,100,$-40.50
2024-05-20,02:19:00,18665.5,BUY,3,0.02h,Stop Loss,$-9.00,$-49.50,$62469.50,100,$-49.50
2024-05-20,03:11:00,18672.75,SELL,3,0.05h,Stop Loss,$-9.00,$-58.50,$62460.50,100,$-58.50
2024-05-20,03:14:00,18674.75,BUY,3,0.03h,Stop Loss,$-9.00,$-67.50,$62451.50,100,$-67.50
2024-05-20,03:33:00,18674.0,SELL,3,0.03h,Stop Loss,$-9.00,$-76.50,$62442.50,100,$-76.50
2024-05-20,04:08:00,18673.0,BUY,3,0.07h,Stop Loss,$-9.00,$-85.50,$62433.50,100,$-85.50
2024-05-20,04:16:00,18670.5,SELL,3,0.03h,Stop Loss,$-9.00,$-94.50,$62424.50,100,$-94.50
2024-05-20,04:19:00,18672.0,BUY,3,0.08h,Stop Loss,$-9.00,$-103.50,$62415.50,100,$-103.50
2024-05-20,04:25:00,18670.75,SELL,3,0.05h,Stop Loss,$-9.00,$-112.50,$62406.50,100,$-112.50
2024-05-20,04:49:00,18671.0,BUY,3,0.05h,Stop Loss,$-9.00,$-121.50,$62397.50,100,$-121.50
2024-05-20,04:57:00,18669.5,SELL,3,0.02h,Stop Loss,$-9.00,$-130.50,$62388.50,100,$-130.50
2024-05-20,04:58:00,18670.5,BUY,3,0.03h,Break Even,$-1.50,$-132.00,$62387.00,100,$-132.00
2024-05-20,05:33:00,18672.75,SELL,3,0.02h,Stop Loss,$-9.00,$-141.00,$62378.00,100,$-141.00
2024-05-20,05:37:00,18676.25,BUY,3,0.08h,Break Even,$-1.50,$-142.50,$62376.50,100,$-142.50
2024-05-20,05:50:00,18674.75,SELL,3,0.02h,Stop Loss,$-9.00,$-151.50,$62367.50,100,$-151.50
2024-05-20,05:59:00,18676.5,BUY,3,0.03h,Stop Loss,$-9.00,$-160.50,$62358.50,100,$-160.50
2024-05-20,06:01:00,18672.5,SELL,3,0.02h,Stop Loss,$9.00,$-151.50,$62367.50,100,$-151.50
2024-05-20,06:37:00,18668.25,BUY,3,0.02h,Break Even,$-1.50,$-153.00,$62366.00,100,$-153.00
2024-05-20,06:55:00,18668.5,SELL,3,0.02h,Break Even,$-1.50,$-154.50,$62364.50,100,$-154.50
2024-05-20,07:19:00,18666.5,BUY,3,0.03h,Break Even,$-1.50,$-156.00,$62363.00,100,$-156.00
2024-05-20,07:27:00,18661.25,SELL,3,0.02h,Break Even,$-1.50,$-157.50,$62361.50,100,$-157.50
2024-05-20,07:45:00,18664.75,BUY,3,0.02h,Stop Loss,$-9.00,$-166.50,$62352.50,100,$-166.50
2024-05-20,07:59:00,18661.75,SELL,3,0.02h,Break Even,$-1.50,$-168.00,$62351.00,100,$-168.00
2024-05-20,08:03:00,18665.0,BUY,3,0.02h,Stop Loss,$4.50,$-163.50,$62355.50,100,$-163.50
2024-05-20,08:32:00,18665.0,SELL,3,0.02h,Stop Loss,$-9.00,$-172.50,$62346.50,100,$-172.50
2024-05-20,09:00:00,18661.25,BUY,3,0.02h,Stop Loss,$-9.00,$-181.50,$62337.50,100,$-181.50
2024-05-20,09:04:00,18659.5,SELL,3,0.02h,Stop Loss,$-9.00,$-190.50,$62328.50,100,$-190.50
2024-05-20,09:27:00,18660.5,BUY,3,0.02h,Stop Loss,$-9.00,$-199.50,$62319.50,100,$-199.50
2024-05-20,10:19:00,18668.5,SELL,3,0.02h,Stop Loss,$-9.00,$-208.50,$62310.50,100,$-208.50
2024-05-20,10:38:00,18670.0,BUY,3,0.02h,Stop Loss,$-9.00,$-217.50,$62301.50,100,$-217.50
2024-05-20,11:11:00,18670.5,SELL,3,0.02h,Break Even,$-1.50,$-219.00,$62300.00,100,$-219.00
2024-05-20,11:24:00,18675.5,BUY,3,0.02h,Stop Loss,$9.00,$-210.00,$62309.00,100,$-210.00
2024-05-20,11:51:00,18681.25,SELL,3,0.02h,Break Even,$-1.50,$-211.50,$62307.50,100,$-211.50
2024-05-20,12:16:00,18684.75,BUY,3,0.02h,Break Even,$-1.50,$-213.00,$62306.00,100,$-213.00
2024-05-20,12:23:00,18674.25,SELL,3,0.02h,Stop Loss,$-9.00,$-222.00,$62297.00,100,$-222.00
2024-05-20,13:17:00,18654.0,BUY,3,0.02h,Stop Loss,$-9.00,$-231.00,$62288.00,100,$-231.00
2024-05-20,13:26:00,18645.25,SELL,3,0.02h,Stop Loss,$13.50,$-217.50,$62301.50,100,$-217.50
2024-05-20,13:33:00,18665.5,BUY,3,0.02h,Stop Loss,$73.50,$-144.00,$62375.00,100,$-144.00
2024-05-20,14:58:00,18742.5,SELL,3,0.02h,Stop Loss,$10.50,$-133.50,$62385.50,100,$-133.50
2024-05-20,15:26:00,18752.5,BUY,3,0.02h,Stop Loss,$-9.00,$-142.50,$62376.50,100,$-142.50
2024-05-20,15:44:00,18740.5,SELL,3,0.02h,Break Even,$-1.50,$-144.00,$62375.00,100,$-144.00
2024-05-20,16:03:00,18748.5,BUY,3,0.02h,Stop Loss,$-9.00,$-153.00,$62366.00,100,$-153.00
2024-05-20,16:16:00,18745.5,SELL,3,0.02h,Stop Loss,$4.50,$-148.50,$62370.50,100,$-148.50
2024-05-20,16:19:00,18752.0,BUY,3,0.02h,Stop Loss,$-9.00,$-157.50,$62361.50,100,$-157.50
2024-05-20,16:25:00,18746.25,SELL,3,0.02h,Break Even,$-1.50,$-159.00,$62360.00,100,$-159.00
2024-05-20,16:33:00,18752.5,BUY,3,0.02h,Stop Loss,$-9.00,$-168.00,$62351.00,100,$-168.00
2024-05-20,17:21:00,18776.25,SELL,3,0.02h,Stop Loss,$15.00,$-153.00,$62366.00,100,$-153.00
2024-05-20,18:28:00,18745.25,BUY,3,0.02h,Break Even,$-1.50,$-154.50,$62364.50,100,$-154.50
2024-05-20,18:59:00,18752.75,SELL,3,0.02h,Stop Loss,$10.50,$-144.00,$62375.00,100,$-144.00
2024-05-20,19:06:00,18760.0,BUY,3,0.02h,Stop Loss,$-9.00,$-153.00,$62366.00,100,$-153.00
2024-05-20,19:37:00,18765.25,SELL,3,0.02h,Break Even,$-1.50,$-154.50,$62364.50,100,$-154.50
2024-05-20,20:02:00,18773.0,BUY,3,0.02h,Stop Loss,$-9.00,$-163.50,$62355.50,100,$-163.50
2024-05-20,20:07:00,18748.5,SELL,3,0.02h,Break Even,$-1.50,$-165.00,$62354.00,100,$-165.00
2024-05-20,20:35:00,18748.75,BUY,3,0.02h,Break Even,$-1.50,$-166.50,$62352.50,100,$-166.50
2024-05-20,20:46:00,18744.25,SELL,3,0.02h,Break Even,$-1.50,$-168.00,$62351.00,100,$-168.00
2024-05-20,20:55:00,18748.0,BUY,3,0.02h,Stop Loss,$-9.00,$-177.00,$62342.00,100,$-177.00
2024-05-20,21:00:00,18745.5,SELL,3,2.05h,Break Even,$-1.50,$-178.50,$62340.50,100,$-178.50
2024-05-20,23:07:00,18748.25,BUY,3,0.02h,Stop Loss,$-9.00,$-187.50,$62331.50,100,$-187.50
2024-05-20,23:30:00,18747.5,SELL,3,0.03h,Break Even,$-1.50,$-189.00,$62330.00,100,$-189.00
2024-05-20,23:38:00,18749.25,BUY,3,0.03h,Stop Loss,$-9.00,$-198.00,$62321.00,100,$-198.00
2024-05-20,23:42:00,18747.0,SELL,3,0.08h,Stop Loss,$-9.00,$-207.00,$62312.00,100,$-207.00
2024-05-20,23:48:00,18748.25,BUY,3,0.07h,Break Even,$-1.50,$-208.50,$62310.50,100,$-208.50
,,,,,,,,,,,
2024-05-21,00:29:00,18750.5,SELL,3,0.02h,Stop Loss,$-9.00,$-9.00,$62301.50,101,$-9.00
2024-05-21,00:35:00,18754.5,BUY,3,0.08h,Break Even,$-1.50,$-10.50,$62300.00,101,$-10.50
2024-05-21,01:02:00,18753.0,SELL,3,0.03h,Break Even,$-1.50,$-12.00,$62298.50,101,$-12.00
2024-05-21,01:43:00,18751.5,BUY,3,0.02h,Stop Loss,$-9.00,$-21.00,$62289.50,101,$-21.00
2024-05-21,01:50:00,18749.5,SELL,3,0.03h,Stop Loss,$-9.00,$-30.00,$62280.50,101,$-30.00
2024-05-21,02:24:00,18750.75,BUY,3,0.02h,Stop Loss,$-9.00,$-39.00,$62271.50,101,$-39.00
2024-05-21,02:39:00,18747.75,SELL,3,0.05h,Stop Loss,$-9.00,$-48.00,$62262.50,101,$-48.00
2024-05-21,03:02:00,18749.75,BUY,3,0.03h,Break Even,$-1.50,$-49.50,$62261.00,101,$-49.50
2024-05-21,03:40:00,18750.25,SELL,3,0.12h,Break Even,$-1.50,$-51.00,$62259.50,101,$-51.00
2024-05-21,03:53:00,18752.0,BUY,3,0.03h,Stop Loss,$-9.00,$-60.00,$62250.50,101,$-60.00
2024-05-21,04:51:00,18752.75,SELL,3,0.02h,Stop Loss,$-9.00,$-69.00,$62241.50,101,$-69.00
2024-05-21,05:07:00,18756.5,BUY,3,0.02h,Stop Loss,$-9.00,$-78.00,$62232.50,101,$-78.00
2024-05-21,05:20:00,18752.75,SELL,3,0.07h,Break Even,$-1.50,$-79.50,$62231.00,101,$-79.50
2024-05-21,05:48:00,18753.25,BUY,3,0.03h,Stop Loss,$-9.00,$-88.50,$62222.00,101,$-88.50
2024-05-21,05:52:00,18749.5,SELL,3,0.10h,Break Even,$-1.50,$-90.00,$62220.50,101,$-90.00
2024-05-21,06:06:00,18751.25,BUY,3,0.02h,Stop Loss,$-9.00,$-99.00,$62211.50,101,$-99.00
2024-05-21,06:20:00,18749.25,SELL,3,0.02h,Stop Loss,$-9.00,$-108.00,$62202.50,101,$-108.00
2024-05-21,06:34:00,18751.0,BUY,3,0.02h,Stop Loss,$-9.00,$-117.00,$62193.50,101,$-117.00
2024-05-21,06:35:00,18750.25,SELL,3,0.18h,Break Even,$-1.50,$-118.50,$62192.00,101,$-118.50
2024-05-21,07:08:00,18747.5,BUY,3,0.02h,Break Even,$-1.50,$-120.00,$62190.50,101,$-120.00
2024-05-21,07:40:00,18751.25,SELL,3,0.02h,Stop Loss,$-9.00,$-129.00,$62181.50,101,$-129.00
2024-05-21,07:41:00,18755.75,BUY,3,0.02h,Stop Loss,$-9.00,$-138.00,$62172.50,101,$-138.00
2024-05-21,07:59:00,18755.25,SELL,3,0.02h,Stop Loss,$-9.00,$-147.00,$62163.50,101,$-147.00
2024-05-21,08:56:00,18743.0,BUY,3,0.02h,Stop Loss,$-9.00,$-156.00,$62154.50,101,$-156.00
2024-05-21,09:01:00,18741.0,SELL,3,0.02h,Break Even,$-1.50,$-157.50,$62153.00,101,$-157.50
2024-05-21,09:11:00,18743.25,BUY,3,0.02h,Break Even,$-1.50,$-159.00,$62151.50,101,$-159.00
2024-05-21,09:19:00,18739.75,SELL,3,0.02h,Break Even,$-1.50,$-160.50,$62150.00,101,$-160.50
2024-05-21,09:50:00,18735.25,BUY,3,0.02h,Stop Loss,$-9.00,$-169.50,$62141.00,101,$-169.50
2024-05-21,09:51:00,18734.0,SELL,3,0.03h,Stop Loss,$-9.00,$-178.50,$62132.00,101,$-178.50
2024-05-21,09:53:00,18735.5,BUY,3,0.03h,Stop Loss,$-9.00,$-187.50,$62123.00,101,$-187.50
2024-05-21,11:23:00,18751.75,SELL,3,0.02h,Break Even,$-1.50,$-189.00,$62121.50,101,$-189.00
2024-05-21,11:37:00,18756.25,BUY,3,0.02h,Stop Loss,$-9.00,$-198.00,$62112.50,101,$-198.00
2024-05-21,11:42:00,18751.0,SELL,3,0.02h,Break Even,$-1.50,$-199.50,$62111.00,101,$-199.50
2024-05-21,13:37:00,18712.5,BUY,3,0.02h,Stop Loss,$-9.00,$-208.50,$62102.00,101,$-208.50
2024-05-21,13:47:00,18685.0,SELL,3,0.02h,Stop Loss,$-9.00,$-217.50,$62093.00,101,$-217.50
2024-05-21,13:53:00,18712.5,BUY,3,0.02h,Stop Loss,$9.00,$-208.50,$62102.00,101,$-208.50
2024-05-21,15:33:00,18748.0,SELL,3,0.02h,Stop Loss,$-9.00,$-217.50,$62093.00,101,$-217.50
2024-05-21,16:07:00,18748.25,BUY,3,0.02h,Break Even,$-1.50,$-219.00,$62091.50,101,$-219.00
2024-05-21,16:36:00,18757.75,SELL,3,0.02h,Break Even,$-1.50,$-220.50,$62090.00,101,$-220.50
2024-05-21,17:28:00,18751.5,BUY,3,0.02h,Stop Loss,$10.50,$-210.00,$62100.50,101,$-210.00
2024-05-21,18:18:00,18767.5,SELL,3,0.02h,Stop Loss,$-9.00,$-219.00,$62091.50,101,$-219.00
2024-05-21,18:53:00,18768.25,BUY,3,0.02h,Stop Loss,$-9.00,$-228.00,$62082.50,101,$-228.00
2024-05-21,19:28:00,18769.75,SELL,3,0.02h,Stop Loss,$-9.00,$-237.00,$62073.50,101,$-237.00
2024-05-21,19:32:00,18781.25,BUY,3,0.02h,Break Even,$-1.50,$-238.50,$62072.00,101,$-238.50
2024-05-21,19:51:00,18781.0,SELL,3,0.02h,Break Even,$-1.50,$-240.00,$62070.50,101,$-240.00
2024-05-21,19:53:00,18791.25,BUY,3,0.02h,Break Even,$-1.50,$-241.50,$62069.00,101,$-241.50
2024-05-21,20:57:00,18803.5,SELL,3,0.02h,Break Even,$-1.50,$-243.00,$62067.50,101,$-243.00
2024-05-21,23:01:00,18811.25,BUY,3,0.02h,Stop Loss,$-9.00,$-252.00,$62058.50,101,$-252.00
2024-05-21,23:44:00,18812.25,SELL,3,0.03h,Stop Loss,$-9.00,$-261.00,$62049.50,101,$-261.00
2024-05-21,23:52:00,18813.25,BUY,3,0.13h,Break Even,$-1.50,$-262.50,$62048.00,101,$-262.50
,,,,,,,,,,,
2024-05-22,00:02:00,18811.25,SELL,3,0.02h,Stop Loss,$-9.00,$-9.00,$62039.00,102,$-9.00
2024-05-22,00:23:00,18813.0,BUY,3,0.03h,Stop Loss,$-9.00,$-18.00,$62030.00,102,$-18.00
2024-05-22,00:45:00,18813.75,SELL,3,0.02h,Stop Loss,$-9.00,$-27.00,$62021.00,102,$-27.00
2024-05-22,00:46:00,18814.75,BUY,3,0.02h,Break Even,$-1.50,$-28.50,$62019.50,102,$-28.50
2024-05-22,00:52:00,18812.75,SELL,3,0.13h,Stop Loss,$10.50,$-18.00,$62030.00,102,$-18.00
2024-05-22,01:38:00,18810.5,BUY,3,0.05h,Break Even,$-1.50,$-19.50,$62028.50,102,$-19.50
2024-05-22,02:19:00,18816.25,SELL,3,0.10h,Break Even,$-1.50,$-21.00,$62027.00,102,$-21.00
2024-05-22,03:48:00,18810.25,BUY,3,0.18h,Stop Loss,$-9.00,$-30.00,$62018.00,102,$-30.00
2024-05-22,04:35:00,18811.0,SELL,3,0.32h,Break Even,$-1.50,$-31.50,$62016.50,102,$-31.50
2024-05-22,04:58:00,18810.75,BUY,3,0.02h,Stop Loss,$-9.00,$-40.50,$62007.50,102,$-40.50
2024-05-22,05:00:00,18808.75,SELL,3,0.02h,Stop Loss,$-9.00,$-49.50,$61998.50,102,$-49.50
2024-05-22,05:04:00,18810.75,BUY,3,0.03h,Stop Loss,$-9.00,$-58.50,$61989.50,102,$-58.50
2024-05-22,05:08:00,18809.5,SELL,3,0.03h,Stop Loss,$-9.00,$-67.50,$61980.50,102,$-67.50
2024-05-22,05:10:00,18810.5,BUY,3,0.40h,Stop Loss,$6.00,$-61.50,$61986.50,102,$-61.50
2024-05-22,06:04:00,18812.25,SELL,3,0.02h,Break Even,$-1.50,$-63.00,$61985.00,102,$-63.00
2024-05-22,06:42:00,18806.5,BUY,3,0.03h,Stop Loss,$-9.00,$-72.00,$61976.00,102,$-72.00
2024-05-22,06:57:00,18804.75,SELL,3,0.02h,Stop Loss,$-9.00,$-81.00,$61967.00,102,$-81.00
2024-05-22,07:23:00,18805.5,BUY,3,0.02h,Break Even,$-1.50,$-82.50,$61965.50,102,$-82.50
2024-05-22,07:28:00,18797.5,SELL,3,0.03h,Stop Loss,$7.50,$-75.00,$61973.00,102,$-75.00
2024-05-22,07:44:00,18799.5,BUY,3,0.02h,Break Even,$-1.50,$-76.50,$61971.50,102,$-76.50
2024-05-22,08:25:00,18801.25,SELL,3,0.02h,Round Number,$4.50,$-72.00,$61976.00,102,$-72.00
2024-05-22,09:08:00,18798.0,BUY,3,0.02h,Stop Loss,$-9.00,$-81.00,$61967.00,102,$-81.00
2024-05-22,09:14:00,18793.25,SELL,3,0.02h,Stop Loss,$-9.00,$-90.00,$61958.00,102,$-90.00
2024-05-22,10:04:00,18781.5,BUY,3,0.02h,Stop Loss,$-9.00,$-99.00,$61949.00,102,$-99.00
2024-05-22,10:13:00,18777.25,SELL,3,0.02h,Stop Loss,$-9.00,$-108.00,$61940.00,102,$-108.00
2024-05-22,10:16:00,18779.0,BUY,3,0.02h,Break Even,$-1.50,$-109.50,$61938.50,102,$-109.50
2024-05-22,10:17:00,18778.25,SELL,3,0.03h,Break Even,$-1.50,$-111.00,$61937.00,102,$-111.00
2024-05-22,10:48:00,18768.75,BUY,3,0.02h,Stop Loss,$-9.00,$-120.00,$61928.00,102,$-120.00
2024-05-22,11:41:00,18801.0,SELL,3,0.02h,Stop Loss,$-9.00,$-129.00,$61919.00,102,$-129.00
2024-05-22,12:24:00,18795.25,BUY,3,0.02h,Break Even,$-1.50,$-130.50,$61917.50,102,$-130.50
2024-05-22,12:28:00,18791.75,SELL,3,0.02h,Stop Loss,$-9.00,$-139.50,$61908.50,102,$-139.50
2024-05-22,12:40:00,18796.5,BUY,3,0.02h,Stop Loss,$-9.00,$-148.50,$61899.50,102,$-148.50
2024-05-22,13:10:00,18795.5,SELL,3,0.02h,Break Even,$-1.50,$-150.00,$61898.00,102,$-150.00
2024-05-22,13:19:00,18807.0,BUY,3,0.02h,Break Even,$-1.50,$-151.50,$61896.50,102,$-151.50
2024-05-22,13:42:00,18799.0,SELL,3,0.02h,Stop Loss,$7.50,$-144.00,$61904.00,102,$-144.00
2024-05-22,13:47:00,18816.5,BUY,3,0.02h,Break Even,$-1.50,$-145.50,$61902.50,102,$-145.50
2024-05-22,14:09:00,18811.25,SELL,3,0.02h,Stop Loss,$-9.00,$-154.50,$61893.50,102,$-154.50
2024-05-22,14:15:00,18825.0,BUY,3,0.02h,Stop Loss,$3.00,$-151.50,$61896.50,102,$-151.50
2024-05-22,14:23:00,18806.25,SELL,3,0.02h,Stop Loss,$-9.00,$-160.50,$61887.50,102,$-160.50
2024-05-22,14:42:00,18816.5,BUY,3,0.02h,Stop Loss,$10.50,$-150.00,$61898.00,102,$-150.00
2024-05-22,14:44:00,18808.75,SELL,3,0.02h,Stop Loss,$22.50,$-127.50,$61920.50,102,$-127.50
2024-05-22,14:58:00,18818.75,BUY,3,0.02h,Stop Loss,$6.00,$-121.50,$61926.50,102,$-121.50
2024-05-22,15:42:00,18831.5,SELL,3,0.03h,Break Even,$-1.50,$-123.00,$61925.00,102,$-123.00
2024-05-22,16:09:00,18828.0,BUY,3,0.02h,Stop Loss,$-9.00,$-132.00,$61916.00,102,$-132.00
2024-05-22,16:27:00,18823.0,SELL,3,0.02h,Break Even,$-1.50,$-133.50,$61914.50,102,$-133.50
2024-05-22,17:07:00,18809.25,BUY,3,0.02h,Break Even,$-1.50,$-135.00,$61913.00,102,$-135.00
2024-05-22,17:33:00,18810.75,SELL,3,0.02h,Stop Loss,$10.50,$-124.50,$61923.50,102,$-124.50
2024-05-22,18:49:00,18721.75,BUY,3,0.02h,Stop Loss,$51.00,$-73.50,$61974.50,102,$-73.50
2024-05-22,19:20:00,18702.25,SELL,3,0.02h,Stop Loss,$-9.00,$-82.50,$61965.50,102,$-82.50
2024-05-22,19:25:00,18737.5,BUY,3,0.02h,Break Even,$-1.50,$-84.00,$61964.00,102,$-84.00
2024-05-22,19:47:00,18745.0,SELL,3,0.02h,Break Even,$-1.50,$-85.50,$61962.50,102,$-85.50
2024-05-22,19:57:00,18762.25,BUY,3,0.02h,Stop Loss,$36.00,$-49.50,$61998.50,102,$-49.50
2024-05-22,20:34:00,18800.25,SELL,3,0.02h,Stop Loss,$186.00,$136.50,$62184.50,102,$136.50
2024-05-22,20:45:00,18821.0,BUY,3,0.02h,Stop Loss,$15.00,$151.50,$62199.50,102,$151.50
,,,,,,,,,,,
2024-05-23,00:07:00,18870.75,SELL,3,0.02h,Stop Loss,$-9.00,$-9.00,$62190.50,103,$-9.00
2024-05-23,00:55:00,18866.5,BUY,3,0.07h,Stop Loss,$-9.00,$-18.00,$62181.50,103,$-18.00
2024-05-23,04:37:00,18965.0,SELL,3,0.05h,Stop Loss,$-9.00,$-27.00,$62172.50,103,$-27.00
2024-05-23,05:46:00,18955.0,BUY,3,0.02h,Stop Loss,$-9.00,$-36.00,$62163.50,103,$-36.00
2024-05-23,05:48:00,18950.25,SELL,3,0.02h,Stop Loss,$-9.00,$-45.00,$62154.50,103,$-45.00
2024-05-23,06:48:00,18942.5,BUY,3,0.02h,Stop Loss,$-9.00,$-54.00,$62145.50,103,$-54.00
2024-05-23,07:32:00,18941.0,SELL,3,0.02h,Stop Loss,$-9.00,$-63.00,$62136.50,103,$-63.00
2024-05-23,08:06:00,18942.0,BUY,3,0.02h,Stop Loss,$6.00,$-57.00,$62142.50,103,$-57.00
2024-05-23,08:26:00,18940.75,SELL,3,0.02h,Stop Loss,$-9.00,$-66.00,$62133.50,103,$-66.00
2024-05-23,08:27:00,18946.0,BUY,3,0.02h,Stop Loss,$-9.00,$-75.00,$62124.50,103,$-75.00
2024-05-23,08:41:00,18940.25,SELL,3,0.02h,Break Even,$-1.50,$-76.50,$62123.00,103,$-76.50
2024-05-23,09:13:00,18938.75,BUY,3,0.03h,Stop Loss,$-9.00,$-85.50,$62114.00,103,$-85.50
2024-05-23,09:58:00,18946.25,SELL,3,0.02h,Stop Loss,$-9.00,$-94.50,$62105.00,103,$-94.50
2024-05-23,10:21:00,18948.5,BUY,3,0.02h,Stop Loss,$-9.00,$-103.50,$62096.00,103,$-103.50
2024-05-23,12:58:00,19007.5,SELL,3,0.02h,Break Even,$-1.50,$-105.00,$62094.50,103,$-105.00
2024-05-23,14:13:00,18898.0,BUY,3,0.02h,Stop Loss,$13.50,$-91.50,$62108.00,103,$-91.50
2024-05-23,14:23:00,18864.0,SELL,3,0.02h,Stop Loss,$-9.00,$-100.50,$62099.00,103,$-100.50
2024-05-23,14:32:00,18888.0,BUY,3,0.02h,Stop Loss,$103.50,$3.00,$62202.50,103,$3.00
2024-05-23,14:47:00,18885.75,SELL,3,0.02h,Stop Loss,$66.00,$69.00,$62268.50,103,$69.00
2024-05-23,15:09:00,18870.5,BUY,3,0.02h,Stop Loss,$100.50,$169.50,$62369.00,103,$169.50
2024-05-23,16:09:00,18910.0,SELL,3,0.02h,Stop Loss,$21.00,$190.50,$62390.00,103,$190.50
2024-05-23,16:24:00,18913.5,BUY,3,0.02h,Stop Loss,$10.50,$201.00,$62400.50,103,$201.00
2024-05-23,16:43:00,18909.0,SELL,3,0.02h,Stop Loss,$36.00,$237.00,$62436.50,103,$237.00
2024-05-23,19:18:00,18654.5,BUY,3,0.02h,Stop Loss,$10.50,$247.50,$62447.00,103,$247.50
2024-05-23,20:26:00,18689.25,SELL,3,0.07h,Stop Loss,$-9.00,$238.50,$62438.00,103,$238.50
2024-05-23,23:00:00,18693.75,BUY,3,0.02h,Break Even,$-1.50,$237.00,$62436.50,103,$237.00
2024-05-23,23:45:00,18704.75,SELL,3,0.02h,Stop Loss,$-9.00,$228.00,$62427.50,103,$228.00
,,,,,,,,,,,
2024-05-24,00:21:00,18706.25,BUY,3,0.02h,Break Even,$-1.50,$-1.50,$62426.00,104,$-1.50
2024-05-24,01:09:00,18714.75,SELL,3,0.02h,Stop Loss,$-9.00,$-10.50,$62417.00,104,$-10.50
2024-05-24,01:15:00,18720.5,BUY,3,0.02h,Stop Loss,$-9.00,$-19.50,$62408.00,104,$-19.50
2024-05-24,01:34:00,18720.0,SELL,3,0.02h,Stop Loss,$-9.00,$-28.50,$62399.00,104,$-28.50
2024-05-24,01:40:00,18726.75,BUY,3,0.02h,Stop Loss,$-9.00,$-37.50,$62390.00,104,$-37.50
2024-05-24,02:05:00,18723.0,SELL,3,0.02h,Stop Loss,$-9.00,$-46.50,$62381.00,104,$-46.50
2024-05-24,02:24:00,18728.0,BUY,3,0.02h,Break Even,$-1.50,$-48.00,$62379.50,104,$-48.00
2024-05-24,02:42:00,18722.75,SELL,3,0.02h,Break Even,$-1.50,$-49.50,$62378.00,104,$-49.50
2024-05-24,02:49:00,18726.75,BUY,3,0.05h,Stop Loss,$-9.00,$-58.50,$62369.00,104,$-58.50
2024-05-24,03:01:00,18722.0,SELL,3,0.03h,Stop Loss,$-9.00,$-67.50,$62360.00,104,$-67.50
2024-05-24,03:24:00,18723.25,BUY,3,0.02h,Stop Loss,$-9.00,$-76.50,$62351.00,104,$-76.50
2024-05-24,03:28:00,18721.75,SELL,3,0.13h,Stop Loss,$4.50,$-72.00,$62355.50,104,$-72.00
2024-05-24,04:14:00,18715.5,BUY,3,0.02h,Break Even,$-1.50,$-73.50,$62354.00,104,$-73.50
2024-05-24,04:24:00,18711.75,SELL,3,0.05h,Break Even,$-1.50,$-75.00,$62352.50,104,$-75.00
2024-05-24,04:48:00,18712.25,BUY,3,0.02h,Stop Loss,$3.00,$-72.00,$62355.50,104,$-72.00
2024-05-24,05:21:00,18711.5,SELL,3,0.02h,Stop Loss,$-9.00,$-81.00,$62346.50,104,$-81.00
2024-05-24,05:23:00,18713.5,BUY,3,0.02h,Stop Loss,$-9.00,$-90.00,$62337.50,104,$-90.00
2024-05-24,05:36:00,18710.0,SELL,3,0.03h,Stop Loss,$13.50,$-76.50,$62351.00,104,$-76.50
2024-05-24,06:01:00,18709.5,BUY,3,0.02h,Stop Loss,$-9.00,$-85.50,$62342.00,104,$-85.50
2024-05-24,06:02:00,18701.75,SELL,3,0.02h,Stop Loss,$-9.00,$-94.50,$62333.00,104,$-94.50
2024-05-24,06:32:00,18702.25,BUY,3,0.02h,Stop Loss,$-9.00,$-103.50,$62324.00,104,$-103.50
2024-05-24,06:33:00,18699.25,SELL,3,0.02h,Stop Loss,$-9.00,$-112.50,$62315.00,104,$-112.50
2024-05-24,07:03:00,18703.75,BUY,3,0.02h,Break Even,$-1.50,$-114.00,$62313.50,104,$-114.00
2024-05-24,07:11:00,18687.0,SELL,3,0.02h,Break Even,$-1.50,$-115.50,$62312.00,104,$-115.50
2024-05-24,07:26:00,18696.25,BUY,3,0.02h,Stop Loss,$4.50,$-111.00,$62316.50,104,$-111.00
2024-05-24,07:35:00,18689.25,SELL,3,0.02h,Stop Loss,$-9.00,$-120.00,$62307.50,104,$-120.00
2024-05-24,07:38:00,18700.25,BUY,3,0.02h,Stop Loss,$-9.00,$-129.00,$62298.50,104,$-129.00
2024-05-24,09:24:00,18737.75,SELL,3,0.02h,Break Even,$-1.50,$-130.50,$62297.00,104,$-130.50
2024-05-24,09:57:00,18731.25,BUY,3,0.02h,Break Even,$-1.50,$-132.00,$62295.50,104,$-132.00
2024-05-24,11:23:00,18745.5,SELL,3,0.02h,Stop Loss,$-9.00,$-141.00,$62286.50,104,$-141.00
2024-05-24,11:46:00,18746.0,BUY,3,0.02h,Break Even,$-1.50,$-142.50,$62285.00,104,$-142.50
2024-05-24,11:47:00,18743.75,SELL,3,0.02h,Stop Loss,$-9.00,$-151.50,$62276.00,104,$-151.50
2024-05-24,11:49:00,18748.5,BUY,3,0.02h,Break Even,$-1.50,$-153.00,$62274.50,104,$-153.00
2024-05-24,12:07:00,18747.25,SELL,3,0.02h,Stop Loss,$-9.00,$-162.00,$62265.50,104,$-162.00
2024-05-24,12:33:00,18752.75,BUY,3,0.02h,Stop Loss,$-9.00,$-171.00,$62256.50,104,$-171.00
2024-05-24,12:55:00,18745.75,SELL,3,0.02h,Break Even,$-1.50,$-172.50,$62255.00,104,$-172.50
2024-05-24,13:02:00,18766.0,BUY,3,0.02h,Break Even,$-1.50,$-174.00,$62253.50,104,$-174.00
2024-05-24,13:07:00,18751.0,SELL,3,0.02h,Break Even,$-1.50,$-175.50,$62252.00,104,$-175.50
2024-05-24,13:29:00,18761.0,BUY,3,0.02h,Stop Loss,$33.00,$-142.50,$62285.00,104,$-142.50
2024-05-24,13:41:00,18745.0,SELL,3,0.02h,Stop Loss,$6.00,$-136.50,$62291.00,104,$-136.50
2024-05-24,13:43:00,18759.5,BUY,3,0.02h,Stop Loss,$51.00,$-85.50,$62342.00,104,$-85.50
2024-05-24,13:53:00,18748.5,SELL,3,0.02h,Stop Loss,$46.50,$-39.00,$62388.50,104,$-39.00
2024-05-24,14:01:00,18792.25,BUY,3,0.02h,Stop Loss,$13.50,$-25.50,$62402.00,104,$-25.50
2024-05-24,15:39:00,18893.0,SELL,3,0.02h,Stop Loss,$31.50,$6.00,$62433.50,104,$6.00
2024-05-24,15:45:00,18906.5,BUY,3,0.02h,Stop Loss,$-9.00,$-3.00,$62424.50,104,$-3.00
2024-05-24,15:46:00,18900.0,SELL,3,0.02h,Stop Loss,$9.00,$6.00,$62433.50,104,$6.00
2024-05-24,16:08:00,18900.75,BUY,3,0.02h,Break Even,$-1.50,$4.50,$62432.00,104,$4.50
2024-05-24,16:09:00,18893.5,SELL,3,0.02h,Stop Loss,$-9.00,$-4.50,$62423.00,104,$-4.50
2024-05-24,16:11:00,18900.5,BUY,3,0.02h,Stop Loss,$6.00,$1.50,$62429.00,104,$1.50
2024-05-24,16:37:00,18894.75,SELL,3,0.02h,Stop Loss,$-9.00,$-7.50,$62420.00,104,$-7.50
2024-05-24,16:55:00,18909.0,BUY,3,0.02h,Stop Loss,$-9.00,$-16.50,$62411.00,104,$-16.50
2024-05-24,16:57:00,18889.75,SELL,3,0.02h,Stop Loss,$3.00,$-13.50,$62414.00,104,$-13.50
2024-05-24,17:21:00,18889.25,BUY,3,0.02h,Stop Loss,$-9.00,$-22.50,$62405.00,104,$-22.50
2024-05-24,17:22:00,18885.75,SELL,3,0.02h,Stop Loss,$-9.00,$-31.50,$62396.00,104,$-31.50
2024-05-24,17:23:00,18891.25,BUY,3,0.02h,Stop Loss,$-9.00,$-40.50,$62387.00,104,$-40.50
2024-05-24,17:34:00,18882.5,SELL,3,0.02h,Break Even,$-1.50,$-42.00,$62385.50,104,$-42.00
2024-05-24,17:52:00,18895.75,BUY,3,0.02h,Stop Loss,$-9.00,$-51.00,$62376.50,104,$-51.00
2024-05-24,18:24:00,18903.25,SELL,3,0.02h,Stop Loss,$33.00,$-18.00,$62409.50,104,$-18.00
2024-05-24,19:28:00,18869.5,BUY,3,0.02h,Stop Loss,$-9.00,$-27.00,$62400.50,104,$-27.00
2024-05-24,19:30:00,18862.25,SELL,3,0.02h,Stop Loss,$13.50,$-13.50,$62414.00,104,$-13.50
2024-05-24,19:32:00,18872.5,BUY,3,0.02h,Stop Loss,$-9.00,$-22.50,$62405.00,104,$-22.50
2024-05-24,19:46:00,18866.5,SELL,3,0.02h,Break Even,$-1.50,$-24.00,$62403.50,104,$-24.00
2024-05-24,20:00:00,18874.0,BUY,3,0.02h,Stop Loss,$18.00,$-6.00,$62421.50,104,$-6.00
2024-05-24,20:21:00,18867.25,SELL,3,0.02h,Stop Loss,$-9.00,$-15.00,$62412.50,104,$-15.00
2024-05-24,20:26:00,18870.25,BUY,3,0.02h,Stop Loss,$-9.00,$-24.00,$62403.50,104,$-24.00
2024-05-24,20:29:00,18868.0,SELL,3,0.03h,Break Even,$-1.50,$-25.50,$62402.00,104,$-25.50
2024-05-24,20:35:00,18871.0,BUY,3,0.02h,Stop Loss,$-9.00,$-34.50,$62393.00,104,$-34.50
,,,,,,,,,,,
2024-05-27,00:00:00,18836.5,SELL,3,0.02h,Break Even,$-1.50,$-1.50,$62391.50,105,$-1.50
2024-05-27,00:38:00,18845.0,BUY,3,0.03h,Break Even,$-1.50,$-3.00,$62390.00,105,$-3.00
2024-05-27,01:19:00,18846.25,SELL,3,0.02h,Break Even,$-1.50,$-4.50,$62388.50,105,$-4.50
2024-05-27,01:31:00,18852.5,BUY,3,0.02h,Stop Loss,$-9.00,$-13.50,$62379.50,105,$-13.50
2024-05-27,02:06:00,18851.25,SELL,3,0.02h,Stop Loss,$-9.00,$-22.50,$62370.50,105,$-22.50
2024-05-27,02:07:00,18852.5,BUY,3,0.02h,Stop Loss,$-9.00,$-31.50,$62361.50,105,$-31.50
2024-05-27,02:08:00,18850.5,SELL,3,0.02h,Break Even,$-1.50,$-33.00,$62360.00,105,$-33.00
2024-05-27,02:41:00,18849.5,BUY,3,0.02h,Break Even,$-1.50,$-34.50,$62358.50,105,$-34.50
2024-05-27,03:43:00,18852.25,SELL,3,0.05h,Stop Loss,$-9.00,$-43.50,$62349.50,105,$-43.50
2024-05-27,04:14:00,18854.0,BUY,3,0.02h,Stop Loss,$-9.00,$-52.50,$62340.50,105,$-52.50
2024-05-27,05:29:00,18862.5,SELL,3,0.02h,Stop Loss,$-9.00,$-61.50,$62331.50,105,$-61.50
2024-05-27,05:32:00,18864.75,BUY,3,0.02h,Stop Loss,$-9.00,$-70.50,$62322.50,105,$-70.50
2024-05-27,05:34:00,18863.0,SELL,3,0.05h,Stop Loss,$-9.00,$-79.50,$62313.50,105,$-79.50
2024-05-27,05:37:00,18864.0,BUY,3,0.02h,Stop Loss,$-9.00,$-88.50,$62304.50,105,$-88.50
2024-05-27,05:38:00,18863.0,SELL,3,0.05h,Stop Loss,$-9.00,$-97.50,$62295.50,105,$-97.50
2024-05-27,05:41:00,18864.75,BUY,3,0.07h,Break Even,$-1.50,$-99.00,$62294.00,105,$-99.00
2024-05-27,06:04:00,18862.0,SELL,3,0.02h,Stop Loss,$-9.00,$-108.00,$62285.00,105,$-108.00
2024-05-27,06:16:00,18865.0,BUY,3,0.02h,Break Even,$-1.50,$-109.50,$62283.50,105,$-109.50
2024-05-27,07:02:00,18875.25,SELL,3,0.02h,Stop Loss,$-9.00,$-118.50,$62274.50,105,$-118.50
2024-05-27,07:08:00,18884.25,BUY,3,0.02h,Stop Loss,$-9.00,$-127.50,$62265.50,105,$-127.50
2024-05-27,07:10:00,18880.75,SELL,3,0.02h,Break Even,$-1.50,$-129.00,$62264.00,105,$-129.00
2024-05-27,07:21:00,18882.0,BUY,3,0.02h,Break Even,$-1.50,$-130.50,$62262.50,105,$-130.50
2024-05-27,07:27:00,18876.0,SELL,3,0.02h,Stop Loss,$-9.00,$-139.50,$62253.50,105,$-139.50
2024-05-27,08:04:00,18876.25,BUY,3,0.05h,Stop Loss,$-9.00,$-148.50,$62244.50,105,$-148.50
2024-05-27,08:12:00,18872.5,SELL,3,0.02h,Break Even,$-1.50,$-150.00,$62243.00,105,$-150.00
2024-05-27,08:26:00,18873.25,BUY,3,0.02h,Stop Loss,$-9.00,$-159.00,$62234.00,105,$-159.00
2024-05-27,08:55:00,18872.75,SELL,3,0.03h,Stop Loss,$-9.00,$-168.00,$62225.00,105,$-168.00
2024-05-27,08:58:00,18877.0,BUY,3,0.02h,Stop Loss,$-9.00,$-177.00,$62216.00,105,$-177.00
2024-05-27,09:26:00,18879.0,SELL,3,0.02h,Stop Loss,$-9.00,$-186.00,$62207.00,105,$-186.00
2024-05-27,09:27:00,18880.75,BUY,3,0.02h,Stop Loss,$-9.00,$-195.00,$62198.00,105,$-195.00
2024-05-27,09:28:00,18878.75,SELL,3,0.02h,Stop Loss,$-9.00,$-204.00,$62189.00,105,$-204.00
2024-05-27,09:29:00,18880.5,BUY,3,0.02h,Stop Loss,$-9.00,$-213.00,$62180.00,105,$-213.00
2024-05-27,09:31:00,18878.25,SELL,3,0.02h,Stop Loss,$-9.00,$-222.00,$62171.00,105,$-222.00
2024-05-27,09:41:00,18881.75,BUY,3,0.02h,Stop Loss,$-9.00,$-231.00,$62162.00,105,$-231.00
2024-05-27,09:48:00,18874.0,SELL,3,0.02h,Stop Loss,$-9.00,$-240.00,$62153.00,105,$-240.00
2024-05-27,10:10:00,18877.5,BUY,3,0.03h,Break Even,$-1.50,$-241.50,$62151.50,105,$-241.50
2024-05-27,10:18:00,18874.0,SELL,3,0.02h,Stop Loss,$13.50,$-228.00,$62165.00,105,$-228.00
2024-05-27,10:29:00,18876.25,BUY,3,0.02h,Stop Loss,$-9.00,$-237.00,$62156.00,105,$-237.00
2024-05-27,10:30:00,18873.25,SELL,3,0.02h,Break Even,$-1.50,$-238.50,$62154.50,105,$-238.50
2024-05-27,10:33:00,18875.5,BUY,3,0.02h,Stop Loss,$-9.00,$-247.50,$62145.50,105,$-247.50
2024-05-27,10:59:00,18873.75,SELL,3,0.02h,Stop Loss,$-9.00,$-256.50,$62136.50,105,$-256.50
2024-05-27,11:15:00,18877.5,BUY,3,0.02h,Stop Loss,$-9.00,$-265.50,$62127.50,105,$-265.50
2024-05-27,11:18:00,18874.75,SELL,3,0.02h,Break Even,$-1.50,$-267.00,$62126.00,105,$-267.00
2024-05-27,11:30:00,18876.0,BUY,3,0.02h,Break Even,$-1.50,$-268.50,$62124.50,105,$-268.50
2024-05-27,11:36:00,18874.75,SELL,3,0.02h,Stop Loss,$-9.00,$-277.50,$62115.50,105,$-277.50
2024-05-27,11:37:00,18875.5,BUY,3,0.02h,Stop Loss,$-9.00,$-286.50,$62106.50,105,$-286.50
2024-05-27,11:38:00,18874.25,SELL,3,0.03h,Stop Loss,$-9.00,$-295.50,$62097.50,105,$-295.50
2024-05-27,11:40:00,18876.75,BUY,3,0.02h,Stop Loss,$-9.00,$-304.50,$62088.50,105,$-304.50
2024-05-27,12:13:00,18877.25,SELL,3,0.02h,Stop Loss,$-9.00,$-313.50,$62079.50,105,$-313.50
2024-05-27,12:28:00,18879.0,BUY,3,0.05h,Stop Loss,$-9.00,$-322.50,$62070.50,105,$-322.50
2024-05-27,12:37:00,18875.0,SELL,3,0.02h,Break Even,$-1.50,$-324.00,$62069.00,105,$-324.00
2024-05-27,13:10:00,18875.25,BUY,3,0.02h,Break Even,$-1.50,$-325.50,$62067.50,105,$-325.50
2024-05-27,13:53:00,18890.0,SELL,3,0.02h,Stop Loss,$13.50,$-312.00,$62081.00,105,$-312.00
2024-05-27,14:35:00,18884.0,BUY,3,0.02h,Stop Loss,$4.50,$-307.50,$62085.50,105,$-307.50
2024-05-27,16:12:00,18934.75,SELL,3,0.02h,Stop Loss,$-9.00,$-316.50,$62076.50,105,$-316.50
2024-05-27,16:14:00,18939.75,BUY,3,0.02h,Stop Loss,$-9.00,$-325.50,$62067.50,105,$-325.50
2024-05-27,16:41:00,18943.25,SELL,3,0.02h,Stop Loss,$-9.00,$-334.50,$62058.50,105,$-334.50
2024-05-27,16:42:00,18945.5,BUY,3,0.02h,Stop Loss,$-9.00,$-343.50,$62049.50,105,$-343.50
2024-05-27,16:43:00,18942.0,SELL,3,0.02h,Stop Loss,$-9.00,$-352.50,$62040.50,105,$-352.50
2024-05-27,16:47:00,18951.0,BUY,3,0.02h,Stop Loss,$-9.00,$-361.50,$62031.50,105,$-361.50
2024-05-27,23:00:00,18917.0,SELL,3,0.02h,Stop Loss,$4.50,$-357.00,$62036.00,105,$-357.00
,,,,,,,,,,,
2024-05-28,00:40:00,18897.0,BUY,3,0.02h,Break Even,$-1.50,$-1.50,$62034.50,106,$-1.50
2024-05-28,00:48:00,18893.75,SELL,3,0.02h,Stop Loss,$-9.00,$-10.50,$62025.50,106,$-10.50
2024-05-28,00:58:00,18896.75,BUY,3,0.02h,Stop Loss,$-9.00,$-19.50,$62016.50,106,$-19.50
2024-05-28,02:14:00,18911.25,SELL,3,0.02h,Stop Loss,$-9.00,$-28.50,$62007.50,106,$-28.50
2024-05-28,02:15:00,18915.75,BUY,3,0.02h,Stop Loss,$-9.00,$-37.50,$61998.50,106,$-37.50
2024-05-28,02:29:00,18912.0,SELL,3,0.15h,Break Even,$-1.50,$-39.00,$61997.00,106,$-39.00
2024-05-28,02:43:00,18914.25,BUY,3,0.03h,Stop Loss,$-9.00,$-48.00,$61988.00,106,$-48.00
2024-05-28,04:35:00,18928.5,SELL,3,0.07h,Stop Loss,$-9.00,$-57.00,$61979.00,106,$-57.00
2024-05-28,05:17:00,18923.0,BUY,3,0.02h,Stop Loss,$-9.00,$-66.00,$61970.00,106,$-66.00
2024-05-28,05:18:00,18922.0,SELL,3,0.02h,Break Even,$-1.50,$-67.50,$61968.50,106,$-67.50
2024-05-28,05:25:00,18923.0,BUY,3,0.05h,Stop Loss,$-9.00,$-76.50,$61959.50,106,$-76.50
2024-05-28,05:30:00,18921.75,SELL,3,0.10h,Stop Loss,$13.50,$-63.00,$61973.00,106,$-63.00
2024-05-28,05:45:00,18922.75,BUY,3,0.02h,Stop Loss,$-9.00,$-72.00,$61964.00,106,$-72.00
2024-05-28,06:01:00,18915.75,SELL,3,0.02h,Stop Loss,$22.50,$-49.50,$61986.50,106,$-49.50
2024-05-28,06:24:00,18917.25,BUY,3,0.02h,Break Even,$-1.50,$-51.00,$61985.00,106,$-51.00
2024-05-28,07:14:00,18928.75,SELL,3,0.02h,Stop Loss,$52.50,$1.50,$62037.50,106,$1.50
2024-05-28,07:46:00,18924.25,BUY,3,0.02h,Stop Loss,$-9.00,$-7.50,$62028.50,106,$-7.50
2024-05-28,07:54:00,18920.0,SELL,3,0.02h,Stop Loss,$-9.00,$-16.50,$62019.50,106,$-16.50
2024-05-28,08:01:00,18927.5,BUY,3,0.02h,Break Even,$-1.50,$-18.00,$62018.00,106,$-18.00
2024-05-28,09:08:00,18969.5,SELL,3,0.02h,Stop Loss,$-9.00,$-27.00,$62009.00,106,$-27.00
2024-05-28,09:25:00,18975.5,BUY,3,0.02h,Stop Loss,$-9.00,$-36.00,$62000.00,106,$-36.00
2024-05-28,09:28:00,18970.0,SELL,3,0.02h,Stop Loss,$-9.00,$-45.00,$61991.00,106,$-45.00
2024-05-28,09:46:00,18972.25,BUY,3,0.02h,Stop Loss,$-9.00,$-54.00,$61982.00,106,$-54.00
2024-05-28,10:01:00,18969.25,SELL,3,0.02h,Break Even,$-1.50,$-55.50,$61980.50,106,$-55.50
2024-05-28,11:14:00,18926.0,BUY,3,0.02h,Stop Loss,$15.00,$-40.50,$61995.50,106,$-40.50
2024-05-28,11:22:00,18914.5,SELL,3,0.02h,Stop Loss,$-9.00,$-49.50,$61986.50,106,$-49.50
2024-05-28,11:51:00,18924.5,BUY,3,0.02h,Stop Loss,$-9.00,$-58.50,$61977.50,106,$-58.50
2024-05-28,12:18:00,18917.25,SELL,3,0.02h,Break Even,$-1.50,$-60.00,$61976.00,106,$-60.00
2024-05-28,12:27:00,18927.25,BUY,3,0.02h,Stop Loss,$-9.00,$-69.00,$61967.00,106,$-69.00
2024-05-28,12:29:00,18924.25,SELL,3,0.02h,Break Even,$-1.50,$-70.50,$61965.50,106,$-70.50
2024-05-28,12:41:00,18925.0,BUY,3,0.02h,Stop Loss,$-9.00,$-79.50,$61956.50,106,$-79.50
2024-05-28,12:42:00,18921.5,SELL,3,0.02h,Stop Loss,$4.50,$-75.00,$61961.00,106,$-75.00
2024-05-28,13:01:00,18919.25,BUY,3,0.02h,Stop Loss,$-9.00,$-84.00,$61952.00,106,$-84.00
2024-05-28,13:02:00,18913.75,SELL,3,0.02h,Stop Loss,$7.50,$-76.50,$61959.50,106,$-76.50
2024-05-28,13:13:00,18916.0,BUY,3,0.02h,Stop Loss,$12.00,$-64.50,$61971.50,106,$-64.50
2024-05-28,13:35:00,18911.0,SELL,3,0.02h,Stop Loss,$4.50,$-60.00,$61976.00,106,$-60.00
2024-05-28,14:06:00,18880.5,BUY,3,0.02h,Stop Loss,$57.00,$-3.00,$62033.00,106,$-3.00
2024-05-28,14:39:00,18885.75,SELL,3,0.02h,Stop Loss,$16.50,$13.50,$62049.50,106,$13.50
2024-05-28,14:43:00,18901.0,BUY,3,0.02h,Stop Loss,$9.00,$22.50,$62058.50,106,$22.50
2024-05-28,15:07:00,18904.5,SELL,3,0.02h,Stop Loss,$-9.00,$13.50,$62049.50,106,$13.50
2024-05-28,15:13:00,18917.25,BUY,3,0.02h,Break Even,$-1.50,$12.00,$62048.00,106,$12.00
2024-05-28,15:17:00,18904.75,SELL,3,0.02h,Stop Loss,$-9.00,$3.00,$62039.00,106,$3.00
2024-05-28,15:20:00,18917.0,BUY,3,0.02h,Break Even,$-1.50,$1.50,$62037.50,106,$1.50
2024-05-28,15:57:00,18921.25,SELL,3,0.02h,Stop Loss,$-9.00,$-7.50,$62028.50,106,$-7.50
2024-05-28,16:02:00,18929.5,BUY,3,0.02h,Stop Loss,$-9.00,$-16.50,$62019.50,106,$-16.50
2024-05-28,16:06:00,18920.25,SELL,3,0.02h,Stop Loss,$3.00,$-13.50,$62022.50,106,$-13.50
2024-05-28,16:14:00,18931.0,BUY,3,0.02h,Stop Loss,$9.00,$-4.50,$62031.50,106,$-4.50
2024-05-28,16:18:00,18915.75,SELL,3,0.02h,Break Even,$-1.50,$-6.00,$62030.00,106,$-6.00
2024-05-28,16:37:00,18926.75,BUY,3,0.02h,Stop Loss,$-9.00,$-15.00,$62021.00,106,$-15.00
2024-05-28,16:59:00,18922.5,SELL,3,0.02h,Break Even,$-1.50,$-16.50,$62019.50,106,$-16.50
2024-05-28,17:15:00,18926.5,BUY,3,0.02h,Stop Loss,$-9.00,$-25.50,$62010.50,106,$-25.50
2024-05-28,17:16:00,18921.5,SELL,3,0.02h,Stop Loss,$3.00,$-22.50,$62013.50,106,$-22.50
2024-05-28,17:19:00,18927.25,BUY,3,0.02h,Stop Loss,$7.50,$-15.00,$62021.00,106,$-15.00
2024-05-28,17:23:00,18919.25,SELL,3,0.02h,Break Even,$-1.50,$-16.50,$62019.50,106,$-16.50
2024-05-28,17:26:00,18925.0,BUY,3,0.02h,Stop Loss,$-9.00,$-25.50,$62010.50,106,$-25.50
2024-05-28,17:27:00,18921.5,SELL,3,0.02h,Stop Loss,$-9.00,$-34.50,$62001.50,106,$-34.50
2024-05-28,17:28:00,18927.25,BUY,3,0.02h,Stop Loss,$-9.00,$-43.50,$61992.50,106,$-43.50
2024-05-28,17:48:00,18926.5,SELL,3,0.02h,Stop Loss,$15.00,$-28.50,$62007.50,106,$-28.50
2024-05-28,18:09:00,18916.5,BUY,3,0.02h,Break Even,$-1.50,$-30.00,$62006.00,106,$-30.00
2024-05-28,18:18:00,18903.0,SELL,3,0.02h,Stop Loss,$30.00,$0.00,$62036.00,106,$0.00
2024-05-28,18:58:00,18861.0,BUY,3,0.02h,Stop Loss,$34.50,$34.50,$62070.50,106,$34.50
2024-05-28,19:48:00,18883.75,SELL,3,0.02h,Stop Loss,$40.50,$75.00,$62111.00,106,$75.00
2024-05-28,19:54:00,18900.5,BUY,3,0.02h,Stop Loss,$3.00,$78.00,$62114.00,106,$78.00
2024-05-28,23:01:00,18941.5,SELL,3,0.32h,Break Even,$-1.50,$76.50,$62112.50,106,$76.50
2024-05-28,23:24:00,18945.25,BUY,3,0.03h,Break Even,$-1.50,$75.00,$62111.00,106,$75.00
2024-05-28,23:47:00,18944.0,SELL,3,0.05h,Break Even,$-1.50,$73.50,$62109.50,106,$73.50
,,,,,,,,,,,
2024-05-29,01:19:00,18911.75,BUY,3,0.03h,Stop Loss,$-9.00,$-9.00,$62100.50,107,$-9.00
2024-05-29,01:21:00,18907.75,SELL,3,0.02h,Break Even,$-1.50,$-10.50,$62099.00,107,$-10.50
2024-05-29,01:26:00,18916.0,BUY,3,0.02h,Break Even,$-1.50,$-12.00,$62097.50,107,$-12.00
2024-05-29,01:37:00,18904.5,SELL,3,0.02h,Stop Loss,$-9.00,$-21.00,$62088.50,107,$-21.00
2024-05-29,01:50:00,18911.0,BUY,3,0.02h,Stop Loss,$-9.00,$-30.00,$62079.50,107,$-30.00
2024-05-29,02:03:00,18908.75,SELL,3,0.03h,Break Even,$-1.50,$-31.50,$62078.00,107,$-31.50
2024-05-29,02:14:00,18912.0,BUY,3,0.05h,Break Even,$-1.50,$-33.00,$62076.50,107,$-33.00
2024-05-29,02:23:00,18908.25,SELL,3,0.03h,Stop Loss,$-9.00,$-42.00,$62067.50,107,$-42.00
2024-05-29,02:26:00,18911.5,BUY,3,0.02h,Stop Loss,$-9.00,$-51.00,$62058.50,107,$-51.00
2024-05-29,02:34:00,18907.5,SELL,3,0.02h,Stop Loss,$-9.00,$-60.00,$62049.50,107,$-60.00
2024-05-29,03:48:00,18884.5,BUY,3,0.02h,Stop Loss,$-9.00,$-69.00,$62040.50,107,$-69.00
2024-05-29,04:52:00,18891.25,SELL,3,0.02h,Break Even,$-1.50,$-70.50,$62039.00,107,$-70.50
2024-05-29,04:58:00,18897.0,BUY,3,0.02h,Stop Loss,$-9.00,$-79.50,$62030.00,107,$-79.50
2024-05-29,05:20:00,18894.25,SELL,3,0.02h,Stop Loss,$-9.00,$-88.50,$62021.00,107,$-88.50
2024-05-29,06:28:00,18865.75,BUY,3,0.03h,Break Even,$-1.50,$-90.00,$62019.50,107,$-90.00
2024-05-29,07:10:00,18863.5,SELL,3,0.02h,Stop Loss,$22.50,$-67.50,$62042.00,107,$-67.50
2024-05-29,07:15:00,18879.75,BUY,3,0.02h,Stop Loss,$7.50,$-60.00,$62049.50,107,$-60.00
2024-05-29,07:30:00,18872.5,SELL,3,0.02h,Stop Loss,$10.50,$-49.50,$62060.00,107,$-49.50
2024-05-29,08:03:00,18867.5,BUY,3,0.02h,Stop Loss,$21.00,$-28.50,$62081.00,107,$-28.50
2024-05-29,08:09:00,18843.25,SELL,3,0.02h,Stop Loss,$19.50,$-9.00,$62100.50,107,$-9.00
2024-05-29,08:56:00,18827.25,BUY,3,0.02h,Stop Loss,$6.00,$-3.00,$62106.50,107,$-3.00
2024-05-29,09:05:00,18816.25,SELL,3,0.02h,Break Even,$-1.50,$-4.50,$62105.00,107,$-4.50
2024-05-29,09:42:00,18813.25,BUY,3,0.02h,Break Even,$-1.50,$-6.00,$62103.50,107,$-6.00
2024-05-29,10:33:00,18823.5,SELL,3,0.02h,Break Even,$-1.50,$-7.50,$62102.00,107,$-7.50
2024-05-29,10:35:00,18827.75,BUY,3,0.02h,Stop Loss,$-9.00,$-16.50,$62093.00,107,$-16.50
2024-05-29,10:38:00,18823.25,SELL,3,0.02h,Stop Loss,$9.00,$-7.50,$62102.00,107,$-7.50
2024-05-29,11:12:00,18819.5,BUY,3,0.02h,Stop Loss,$-9.00,$-16.50,$62093.00,107,$-16.50
2024-05-29,11:14:00,18806.5,SELL,3,0.02h,Break Even,$-1.50,$-18.00,$62091.50,107,$-18.00
2024-05-29,11:35:00,18810.5,BUY,3,0.02h,Break Even,$-1.50,$-19.50,$62090.00,107,$-19.50
2024-05-29,12:04:00,18812.0,SELL,3,0.02h,Stop Loss,$12.00,$-7.50,$62102.00,107,$-7.50
2024-05-29,12:09:00,18823.75,BUY,3,0.02h,Break Even,$-1.50,$-9.00,$62100.50,107,$-9.00
2024-05-29,12:25:00,18816.75,SELL,3,0.02h,Break Even,$-1.50,$-10.50,$62099.00,107,$-10.50
2024-05-29,13:31:00,18797.75,BUY,3,0.02h,Stop Loss,$24.00,$13.50,$62123.00,107,$13.50
2024-05-29,15:04:00,18858.75,SELL,3,0.02h,Break Even,$-1.50,$12.00,$62121.50,107,$12.00
2024-05-29,15:27:00,18854.25,BUY,3,0.02h,Stop Loss,$9.00,$21.00,$62130.50,107,$21.00
2024-05-29,15:33:00,18840.0,SELL,3,0.02h,Stop Loss,$30.00,$51.00,$62160.50,107,$51.00
2024-05-29,15:55:00,18849.0,BUY,3,0.02h,Stop Loss,$13.50,$64.50,$62174.00,107,$64.50
2024-05-29,16:10:00,18841.25,SELL,3,0.02h,Stop Loss,$79.50,$144.00,$62253.50,107,$144.00
2024-05-29,16:22:00,18845.0,BUY,3,0.02h,Stop Loss,$15.00,$159.00,$62268.50,107,$159.00
2024-05-29,17:03:00,18852.25,SELL,3,0.02h,Stop Loss,$12.00,$171.00,$62280.50,107,$171.00
2024-05-29,17:31:00,18851.0,BUY,3,0.02h,Break Even,$-1.50,$169.50,$62279.00,107,$169.50
2024-05-29,17:34:00,18842.25,SELL,3,0.02h,Stop Loss,$27.00,$196.50,$62306.00,107,$196.50
2024-05-29,17:52:00,18849.5,BUY,3,0.02h,Stop Loss,$57.00,$253.50,$62363.00,107,$253.50
2024-05-29,18:21:00,18850.75,SELL,3,0.02h,Stop Loss,$-9.00,$244.50,$62354.00,107,$244.50
2024-05-29,19:16:00,18836.0,BUY,3,0.02h,Break Even,$-1.50,$243.00,$62352.50,107,$243.00
2024-05-29,19:45:00,18836.75,SELL,3,0.02h,Stop Loss,$10.50,$253.50,$62363.00,107,$253.50
2024-05-29,23:47:00,18723.25,BUY,3,0.02h,Stop Loss,$-9.00,$244.50,$62354.00,107,$244.50
,,,,,,,,,,,
2024-05-30,00:35:00,18725.0,SELL,3,0.02h,Stop Loss,$7.50,$7.50,$62361.50,108,$7.50
2024-05-30,01:07:00,18717.5,BUY,3,0.03h,Break Even,$-1.50,$6.00,$62360.00,108,$6.00
2024-05-30,01:20:00,18715.25,SELL,3,0.02h,Stop Loss,$-9.00,$-3.00,$62351.00,108,$-3.00
2024-05-30,01:39:00,18719.0,BUY,3,0.03h,Break Even,$-1.50,$-4.50,$62349.50,108,$-4.50
2024-05-30,01:56:00,18714.5,SELL,3,0.02h,Stop Loss,$10.50,$6.00,$62360.00,108,$6.00
2024-05-30,03:47:00,18685.75,BUY,3,0.02h,Break Even,$-1.50,$4.50,$62358.50,108,$4.50
2024-05-30,04:02:00,18682.5,SELL,3,0.02h,Stop Loss,$-9.00,$-4.50,$62349.50,108,$-4.50
2024-05-30,04:28:00,18684.0,BUY,3,0.02h,Stop Loss,$-9.00,$-13.50,$62340.50,108,$-13.50
2024-05-30,04:30:00,18682.25,SELL,3,0.02h,Stop Loss,$-9.00,$-22.50,$62331.50,108,$-22.50
2024-05-30,04:32:00,18684.5,BUY,3,0.02h,Break Even,$-1.50,$-24.00,$62330.00,108,$-24.00
2024-05-30,04:36:00,18677.0,SELL,3,0.02h,Stop Loss,$-9.00,$-33.00,$62321.00,108,$-33.00
2024-05-30,04:58:00,18677.75,BUY,3,0.02h,Break Even,$-1.50,$-34.50,$62319.50,108,$-34.50
2024-05-30,05:05:00,18671.25,SELL,3,0.02h,Stop Loss,$-9.00,$-43.50,$62310.50,108,$-43.50
2024-05-30,05:35:00,18671.0,BUY,3,0.02h,Stop Loss,$-9.00,$-52.50,$62301.50,108,$-52.50
2024-05-30,05:38:00,18668.0,SELL,3,0.02h,Stop Loss,$12.00,$-40.50,$62313.50,108,$-40.50
2024-05-30,05:56:00,18670.75,BUY,3,0.02h,Break Even,$-1.50,$-42.00,$62312.00,108,$-42.00
2024-05-30,06:34:00,18668.25,SELL,3,0.02h,Stop Loss,$-9.00,$-51.00,$62303.00,108,$-51.00
2024-05-30,07:03:00,18675.25,BUY,3,0.02h,Break Even,$-1.50,$-52.50,$62301.50,108,$-52.50
2024-05-30,09:23:00,18726.5,SELL,3,0.02h,Break Even,$-1.50,$-54.00,$62300.00,108,$-54.00
2024-05-30,09:52:00,18729.75,BUY,3,0.02h,Stop Loss,$3.00,$-51.00,$62303.00,108,$-51.00
2024-05-30,10:08:00,18726.5,SELL,3,0.02h,Break Even,$-1.50,$-52.50,$62301.50,108,$-52.50
2024-05-30,10:26:00,18723.5,BUY,3,0.02h,Break Even,$-1.50,$-54.00,$62300.00,108,$-54.00
2024-05-30,11:10:00,18747.5,SELL,3,0.02h,Break Even,$-1.50,$-55.50,$62298.50,108,$-55.50
2024-05-30,11:26:00,18749.0,BUY,3,0.02h,Break Even,$-1.50,$-57.00,$62297.00,108,$-57.00
2024-05-30,11:56:00,18742.75,SELL,3,0.02h,Stop Loss,$-9.00,$-66.00,$62288.00,108,$-66.00
2024-05-30,12:11:00,18750.75,BUY,3,0.02h,Stop Loss,$-9.00,$-75.00,$62279.00,108,$-75.00
2024-05-30,12:27:00,18747.25,SELL,3,0.02h,Stop Loss,$-9.00,$-84.00,$62270.00,108,$-84.00
2024-05-30,12:31:00,18772.5,BUY,3,0.02h,Stop Loss,$39.00,$-45.00,$62309.00,108,$-45.00
2024-05-30,12:56:00,18768.75,SELL,3,0.02h,Stop Loss,$27.00,$-18.00,$62336.00,108,$-18.00
2024-05-30,13:25:00,18766.0,BUY,3,0.02h,Break Even,$-1.50,$-19.50,$62334.50,108,$-19.50
2024-05-30,13:33:00,18758.0,SELL,3,0.02h,Stop Loss,$76.50,$57.00,$62411.00,108,$57.00
2024-05-30,14:07:00,18746.5,BUY,3,0.02h,Break Even,$-1.50,$55.50,$62409.50,108,$55.50
2024-05-30,14:11:00,18725.5,SELL,3,0.02h,Stop Loss,$132.00,$187.50,$62541.50,108,$187.50
2024-05-30,15:23:00,18657.0,BUY,3,0.02h,Stop Loss,$4.50,$192.00,$62546.00,108,$192.00
2024-05-30,15:59:00,18675.0,SELL,3,0.02h,Stop Loss,$27.00,$219.00,$62573.00,108,$219.00
2024-05-30,16:05:00,18692.75,BUY,3,0.02h,Stop Loss,$21.00,$240.00,$62594.00,108,$240.00
2024-05-30,16:30:00,18686.0,SELL,3,0.02h,Stop Loss,$4.50,$244.50,$62598.50,108,$244.50
2024-05-30,16:34:00,18696.0,BUY,3,0.02h,Stop Loss,$12.00,$256.50,$62610.50,108,$256.50
2024-05-30,16:44:00,18689.0,SELL,3,0.02h,Stop Loss,$-9.00,$247.50,$62601.50,108,$247.50
2024-05-30,16:54:00,18698.5,BUY,3,0.02h,Stop Loss,$9.00,$256.50,$62610.50,108,$256.50
2024-05-30,16:58:00,18688.5,SELL,3,0.02h,Stop Loss,$-9.00,$247.50,$62601.50,108,$247.50
2024-05-30,17:00:00,18696.5,BUY,3,0.02h,Stop Loss,$-9.00,$238.50,$62592.50,108,$238.50
2024-05-30,17:49:00,18706.75,SELL,3,0.02h,Stop Loss,$3.00,$241.50,$62595.50,108,$241.50
2024-05-30,19:16:00,18670.0,BUY,3,0.02h,Break Even,$-1.50,$240.00,$62594.00,108,$240.00
2024-05-30,19:19:00,18664.5,SELL,3,0.02h,Stop Loss,$37.50,$277.50,$62631.50,108,$277.50
2024-05-30,20:28:00,18581.0,BUY,3,0.02h,Stop Loss,$48.00,$325.50,$62679.50,108,$325.50
2024-05-30,20:54:00,18584.25,SELL,3,0.02h,Stop Loss,$-9.00,$316.50,$62670.50,108,$316.50
2024-05-30,20:59:00,18591.5,BUY,3,0.02h,Stop Loss,$16.50,$333.00,$62687.00,108,$333.00
2024-05-30,23:00:00,18570.25,SELL,3,0.02h,Break Even,$-1.50,$331.50,$62685.50,108,$331.50
2024-05-30,23:33:00,18577.75,BUY,3,0.02h,Stop Loss,$-9.00,$322.50,$62676.50,108,$322.50
2024-05-30,23:39:00,18568.75,SELL,3,0.02h,Break Even,$-1.50,$321.00,$62675.00,108,$321.00
,,,,,,,,,,,
2024-05-31,00:58:00,18518.5,BUY,3,0.02h,Stop Loss,$18.00,$18.00,$62693.00,109,$18.00
2024-05-31,01:49:00,18539.5,SELL,3,0.02h,Stop Loss,$-9.00,$9.00,$62684.00,109,$9.00
2024-05-31,01:52:00,18544.25,BUY,3,0.02h,Stop Loss,$43.50,$52.50,$62727.50,109,$52.50
2024-05-31,02:33:00,18553.25,SELL,3,0.02h,Break Even,$-1.50,$51.00,$62726.00,109,$51.00
2024-05-31,03:21:00,18539.5,BUY,3,0.02h,Break Even,$-1.50,$49.50,$62724.50,109,$49.50
2024-05-31,04:08:00,18558.0,SELL,3,0.03h,Break Even,$-1.50,$48.00,$62723.00,109,$48.00
2024-05-31,04:52:00,18553.5,BUY,3,0.03h,Stop Loss,$-9.00,$39.00,$62714.00,109,$39.00
2024-05-31,05:27:00,18553.5,SELL,3,0.02h,Break Even,$-1.50,$37.50,$62712.50,109,$37.50
2024-05-31,06:10:00,18548.5,BUY,3,0.02h,Stop Loss,$-9.00,$28.50,$62703.50,109,$28.50
2024-05-31,06:21:00,18541.0,SELL,3,0.02h,Stop Loss,$-9.00,$19.50,$62694.50,109,$19.50
2024-05-31,06:32:00,18547.5,BUY,3,0.02h,Break Even,$-1.50,$18.00,$62693.00,109,$18.00
2024-05-31,07:03:00,18549.25,SELL,3,0.02h,Break Even,$-1.50,$16.50,$62691.50,109,$16.50
2024-05-31,07:10:00,18554.75,BUY,3,0.02h,Stop Loss,$-9.00,$7.50,$62682.50,109,$7.50
2024-05-31,07:17:00,18546.5,SELL,3,0.02h,Break Even,$-1.50,$6.00,$62681.00,109,$6.00
2024-05-31,08:04:00,18530.25,BUY,3,0.02h,Break Even,$-1.50,$4.50,$62679.50,109,$4.50
2024-05-31,08:46:00,18559.75,SELL,3,0.02h,Stop Loss,$-9.00,$-4.50,$62670.50,109,$-4.50
2024-05-31,09:30:00,18542.5,BUY,3,0.02h,Stop Loss,$12.00,$7.50,$62682.50,109,$7.50
2024-05-31,09:44:00,18535.5,SELL,3,0.02h,Stop Loss,$-9.00,$-1.50,$62673.50,109,$-1.50
2024-05-31,09:48:00,18542.5,BUY,3,0.02h,Stop Loss,$-9.00,$-10.50,$62664.50,109,$-10.50
2024-05-31,09:49:00,18536.5,SELL,3,0.02h,Break Even,$-1.50,$-12.00,$62663.00,109,$-12.00
2024-05-31,09:52:00,18542.0,BUY,3,0.02h,Break Even,$-1.50,$-13.50,$62661.50,109,$-13.50
2024-05-31,10:09:00,18537.75,SELL,3,0.02h,Stop Loss,$6.00,$-7.50,$62667.50,109,$-7.50
2024-05-31,10:42:00,18525.75,BUY,3,0.02h,Break Even,$-1.50,$-9.00,$62666.00,109,$-9.00
2024-05-31,10:49:00,18512.75,SELL,3,0.02h,Stop Loss,$-9.00,$-18.00,$62657.00,109,$-18.00
2024-05-31,11:02:00,18521.75,BUY,3,0.02h,Break Even,$-1.50,$-19.50,$62655.50,109,$-19.50
2024-05-31,13:07:00,18638.25,SELL,3,0.02h,Stop Loss,$10.50,$-9.00,$62666.00,109,$-9.00
2024-05-31,13:44:00,18627.25,BUY,3,0.02h,Break Even,$-1.50,$-10.50,$62664.50,109,$-10.50
2024-05-31,13:46:00,18589.25,SELL,3,0.02h,Stop Loss,$73.50,$63.00,$62738.00,109,$63.00
2024-05-31,16:41:00,18279.5,BUY,3,0.02h,Stop Loss,$24.00,$87.00,$62762.00,109,$87.00
2024-05-31,17:43:00,18334.5,SELL,3,0.02h,Break Even,$-1.50,$85.50,$62760.50,109,$85.50
2024-05-31,17:46:00,18354.25,BUY,3,0.02h,Break Even,$-1.50,$84.00,$62759.00,109,$84.00
2024-05-31,17:55:00,18340.0,SELL,3,0.02h,Stop Loss,$-9.00,$75.00,$62750.00,109,$75.00
2024-05-31,18:19:00,18339.75,BUY,3,0.02h,Break Even,$-1.50,$73.50,$62748.50,109,$73.50
2024-05-31,18:24:00,18335.75,SELL,3,0.02h,Stop Loss,$7.50,$81.00,$62756.00,109,$81.00
2024-05-31,18:42:00,18335.5,BUY,3,0.02h,Stop Loss,$6.00,$87.00,$62762.00,109,$87.00
2024-05-31,20:50:00,18576.5,SELL,3,0.02h,Break Even,$-1.50,$85.50,$62760.50,109,$85.50
,,,,,,,,,,,
2024-06-03,00:00:00,18592.0,BUY,3,0.02h,Stop Loss,$9.00,$9.00,$62769.50,110,$9.00
2024-06-03,00:45:00,18631.75,SELL,3,0.02h,Stop Loss,$-9.00,$0.00,$62760.50,110,$0.00
2024-06-03,00:54:00,18637.5,BUY,3,0.02h,Break Even,$-1.50,$-1.50,$62759.00,110,$-1.50
2024-06-03,01:00:00,18632.75,SELL,3,0.02h,Stop Loss,$-9.00,$-10.50,$62750.00,110,$-10.50
2024-06-03,01:01:00,18637.25,BUY,3,0.02h,Stop Loss,$15.00,$4.50,$62765.00,110,$4.50
2024-06-03,01:08:00,18632.5,SELL,3,0.02h,Stop Loss,$10.50,$15.00,$62775.50,110,$15.00
2024-06-03,01:42:00,18626.5,BUY,3,0.02h,Break Even,$-1.50,$13.50,$62774.00,110,$13.50
2024-06-03,03:01:00,18644.25,SELL,3,0.02h,Stop Loss,$-9.00,$4.50,$62765.00,110,$4.50
2024-06-03,03:06:00,18646.25,BUY,3,0.02h,Break Even,$-1.50,$3.00,$62763.50,110,$3.00
2024-06-03,03:20:00,18644.75,SELL,3,0.02h,Break Even,$-1.50,$1.50,$62762.00,110,$1.50
2024-06-03,03:49:00,18643.5,BUY,3,0.02h,Stop Loss,$-9.00,$-7.50,$62753.00,110,$-7.50
2024-06-03,03:50:00,18641.75,SELL,3,0.03h,Stop Loss,$-9.00,$-16.50,$62744.00,110,$-16.50
2024-06-03,03:52:00,18643.5,BUY,3,0.02h,Stop Loss,$-9.00,$-25.50,$62735.00,110,$-25.50
2024-06-03,03:55:00,18640.75,SELL,3,0.02h,Stop Loss,$-9.00,$-34.50,$62726.00,110,$-34.50
2024-06-03,04:02:00,18644.25,BUY,3,0.02h,Stop Loss,$-9.00,$-43.50,$62717.00,110,$-43.50
2024-06-03,04:20:00,18642.0,SELL,3,0.02h,Stop Loss,$-9.00,$-52.50,$62708.00,110,$-52.50
2024-06-03,04:22:00,18644.25,BUY,3,0.02h,Break Even,$-1.50,$-54.00,$62706.50,110,$-54.00
2024-06-03,05:01:00,18645.75,SELL,3,0.02h,Break Even,$-1.50,$-55.50,$62705.00,110,$-55.50
2024-06-03,05:03:00,18650.25,BUY,3,0.02h,Stop Loss,$-9.00,$-64.50,$62696.00,110,$-64.50
2024-06-03,05:05:00,18643.75,SELL,3,0.02h,Break Even,$-1.50,$-66.00,$62694.50,110,$-66.00
2024-06-03,05:15:00,18649.0,BUY,3,0.02h,Break Even,$-1.50,$-67.50,$62693.00,110,$-67.50
2024-06-03,05:29:00,18647.75,SELL,3,0.02h,Break Even,$-1.50,$-69.00,$62691.50,110,$-69.00
2024-06-03,06:07:00,18646.75,BUY,3,0.02h,Stop Loss,$-9.00,$-78.00,$62682.50,110,$-78.00
2024-06-03,06:09:00,18644.75,SELL,3,0.02h,Stop Loss,$22.50,$-55.50,$62705.00,110,$-55.50
2024-06-03,06:22:00,18647.25,BUY,3,0.02h,Break Even,$-1.50,$-57.00,$62703.50,110,$-57.00
2024-06-03,07:02:00,18659.75,SELL,3,0.02h,Break Even,$-1.50,$-58.50,$62702.00,110,$-58.50
2024-06-03,07:08:00,18665.75,BUY,3,0.02h,Break Even,$-1.50,$-60.00,$62700.50,110,$-60.00
2024-06-03,07:15:00,18655.25,SELL,3,0.02h,Stop Loss,$40.50,$-19.50,$62741.00,110,$-19.50
2024-06-03,07:48:00,18647.25,BUY,3,0.02h,Break Even,$-1.50,$-21.00,$62739.50,110,$-21.00
2024-06-03,07:55:00,18629.5,SELL,3,0.02h,Break Even,$-1.50,$-22.50,$62738.00,110,$-22.50
2024-06-03,08:06:00,18644.5,BUY,3,0.02h,Stop Loss,$6.00,$-16.50,$62744.00,110,$-16.50
2024-06-03,08:44:00,18654.75,SELL,3,0.02h,Stop Loss,$-9.00,$-25.50,$62735.00,110,$-25.50
2024-06-03,08:51:00,18665.5,BUY,3,0.02h,Stop Loss,$12.00,$-13.50,$62747.00,110,$-13.50
2024-06-03,09:03:00,18659.0,SELL,3,0.02h,Break Even,$-1.50,$-15.00,$62745.50,110,$-15.00
2024-06-03,09:06:00,18670.25,BUY,3,0.02h,Stop Loss,$3.00,$-12.00,$62748.50,110,$-12.00
2024-06-03,09:18:00,18660.75,SELL,3,0.02h,Break Even,$-1.50,$-13.50,$62747.00,110,$-13.50
2024-06-03,09:30:00,18667.75,BUY,3,0.02h,Stop Loss,$-9.00,$-22.50,$62738.00,110,$-22.50
2024-06-03,09:41:00,18663.5,SELL,3,0.02h,Stop Loss,$-9.00,$-31.50,$62729.00,110,$-31.50
2024-06-03,09:58:00,18667.5,BUY,3,0.02h,Stop Loss,$-9.00,$-40.50,$62720.00,110,$-40.50
2024-06-03,10:43:00,18670.5,SELL,3,0.03h,Break Even,$-1.50,$-42.00,$62718.50,110,$-42.00
2024-06-03,11:10:00,18672.25,BUY,3,0.02h,Break Even,$-1.50,$-43.50,$62717.00,110,$-43.50
2024-06-03,11:27:00,18664.0,SELL,3,0.02h,Stop Loss,$6.00,$-37.50,$62723.00,110,$-37.50
2024-06-03,11:32:00,18686.25,BUY,3,0.02h,Stop Loss,$9.00,$-28.50,$62732.00,110,$-28.50
2024-06-03,12:34:00,18688.75,SELL,3,0.02h,Stop Loss,$31.50,$3.00,$62763.50,110,$3.00
2024-06-03,13:03:00,18692.75,BUY,3,0.02h,Break Even,$-1.50,$1.50,$62762.00,110,$1.50
2024-06-03,13:53:00,18679.5,SELL,3,0.02h,Break Even,$-1.50,$0.00,$62760.50,110,$0.00
2024-06-03,14:19:00,18690.0,BUY,3,0.02h,Stop Loss,$63.00,$63.00,$62823.50,110,$63.00
2024-06-03,14:23:00,18682.5,SELL,3,0.02h,Break Even,$-1.50,$61.50,$62822.00,110,$61.50
2024-06-03,14:24:00,18702.25,BUY,3,0.02h,Stop Loss,$22.50,$84.00,$62844.50,110,$84.00
2024-06-03,14:33:00,18678.0,SELL,3,0.02h,Break Even,$-1.50,$82.50,$62843.00,110,$82.50
2024-06-03,15:20:00,18604.75,BUY,3,0.02h,Stop Loss,$42.00,$124.50,$62885.00,110,$124.50
2024-06-03,15:47:00,18594.5,SELL,3,0.02h,Break Even,$-1.50,$123.00,$62883.50,110,$123.00
2024-06-03,15:55:00,18615.75,BUY,3,0.02h,Stop Loss,$-9.00,$114.00,$62874.50,110,$114.00
2024-06-03,15:56:00,18608.25,SELL,3,0.02h,Stop Loss,$49.50,$163.50,$62924.00,110,$163.50
2024-06-03,17:21:00,18498.5,BUY,3,0.02h,Stop Loss,$18.00,$181.50,$62942.00,110,$181.50
2024-06-03,18:14:00,18541.25,SELL,3,0.02h,Stop Loss,$67.50,$249.00,$63009.50,110,$249.00
2024-06-03,18:24:00,18568.0,BUY,3,0.02h,Stop Loss,$-9.00,$240.00,$63000.50,110,$240.00
2024-06-03,18:30:00,18538.0,SELL,3,0.02h,Break Even,$-1.50,$238.50,$62999.00,110,$238.50
2024-06-03,18:37:00,18562.75,BUY,3,0.02h,Stop Loss,$-9.00,$229.50,$62990.00,110,$229.50
2024-06-03,18:54:00,18550.25,SELL,3,0.02h,Stop Loss,$13.50,$243.00,$63003.50,110,$243.00
2024-06-03,19:03:00,18568.75,BUY,3,0.02h,Break Even,$-1.50,$241.50,$63002.00,110,$241.50
2024-06-03,19:40:00,18571.5,SELL,3,0.02h,Stop Loss,$18.00,$259.50,$63020.00,110,$259.50
2024-06-03,19:47:00,18598.5,BUY,3,0.02h,Stop Loss,$-9.00,$250.50,$63011.00,110,$250.50
2024-06-03,20:46:00,18662.0,SELL,3,0.02h,Stop Loss,$-9.00,$241.50,$63002.00,110,$241.50
2024-06-03,23:17:00,18663.25,BUY,3,0.02h,Break Even,$-1.50,$240.00,$63000.50,110,$240.00
2024-06-03,23:27:00,18661.25,SELL,3,0.18h,Stop Loss,$-9.00,$231.00,$62991.50,110,$231.00
,,,,,,,,,,,
2024-06-04,00:05:00,18658.5,BUY,3,0.02h,Stop Loss,$-9.00,$-9.00,$62982.50,111,$-9.00
2024-06-04,00:49:00,18665.25,SELL,3,0.02h,Stop Loss,$-9.00,$-18.00,$62973.50,111,$-18.00
2024-06-04,01:01:00,18671.5,BUY,3,0.02h,Stop Loss,$-9.00,$-27.00,$62964.50,111,$-27.00
2024-06-04,01:06:00,18667.0,SELL,3,0.02h,Break Even,$-1.50,$-28.50,$62963.00,111,$-28.50
2024-06-04,01:40:00,18665.5,BUY,3,0.02h,Break Even,$-1.50,$-30.00,$62961.50,111,$-30.00
2024-06-04,02:03:00,18664.0,SELL,3,0.02h,Stop Loss,$13.50,$-16.50,$62975.00,111,$-16.50
2024-06-04,03:16:00,18655.75,BUY,3,0.05h,Stop Loss,$-9.00,$-25.50,$62966.00,111,$-25.50
2024-06-04,03:20:00,18652.75,SELL,3,0.02h,Stop Loss,$-9.00,$-34.50,$62957.00,111,$-34.50
2024-06-04,03:45:00,18651.75,BUY,3,0.02h,Stop Loss,$-9.00,$-43.50,$62948.00,111,$-43.50
2024-06-04,04:08:00,18651.5,SELL,3,0.02h,Stop Loss,$-9.00,$-52.50,$62939.00,111,$-52.50
2024-06-04,04:09:00,18655.0,BUY,3,0.02h,Stop Loss,$-9.00,$-61.50,$62930.00,111,$-61.50
2024-06-04,04:45:00,18655.0,SELL,3,0.05h,Stop Loss,$6.00,$-55.50,$62936.00,111,$-55.50
2024-06-04,05:57:00,18645.75,BUY,3,0.02h,Break Even,$-1.50,$-57.00,$62934.50,111,$-57.00
2024-06-04,06:03:00,18640.25,SELL,3,0.02h,Break Even,$-1.50,$-58.50,$62933.00,111,$-58.50
2024-06-04,07:32:00,18589.25,BUY,3,0.02h,Stop Loss,$51.00,$-7.50,$62984.00,111,$-7.50
2024-06-04,08:04:00,18595.5,SELL,3,0.02h,Stop Loss,$63.00,$55.50,$63047.00,111,$55.50
2024-06-04,09:32:00,18551.0,BUY,3,0.02h,Break Even,$-1.50,$54.00,$63045.50,111,$54.00
2024-06-04,09:48:00,18535.25,SELL,3,0.02h,Stop Loss,$4.50,$58.50,$63050.00,111,$58.50
2024-06-04,10:01:00,18545.25,BUY,3,0.02h,Stop Loss,$4.50,$63.00,$63054.50,111,$63.00
2024-06-04,10:08:00,18536.0,SELL,3,0.02h,Stop Loss,$15.00,$78.00,$63069.50,111,$78.00
2024-06-04,10:15:00,18550.25,BUY,3,0.02h,Stop Loss,$13.50,$91.50,$63083.00,111,$91.50
2024-06-04,10:45:00,18553.0,SELL,3,0.02h,Stop Loss,$-9.00,$82.50,$63074.00,111,$82.50
2024-06-04,11:01:00,18565.0,BUY,3,0.02h,Stop Loss,$-9.00,$73.50,$63065.00,111,$73.50
2024-06-04,11:52:00,18579.25,SELL,3,0.02h,Break Even,$-1.50,$72.00,$63063.50,111,$72.00
2024-06-04,11:55:00,18590.75,BUY,3,0.02h,Stop Loss,$-9.00,$63.00,$63054.50,111,$63.00
2024-06-04,12:05:00,18568.75,SELL,3,0.02h,Break Even,$-1.50,$61.50,$63053.00,111,$61.50
2024-06-04,12:21:00,18584.0,BUY,3,0.02h,Break Even,$-1.50,$60.00,$63051.50,111,$60.00
2024-06-04,13:35:00,18594.25,SELL,3,0.02h,Stop Loss,$55.50,$115.50,$63107.00,111,$115.50
2024-06-04,14:02:00,18659.5,BUY,3,0.02h,Stop Loss,$-9.00,$106.50,$63098.00,111,$106.50
2024-06-04,14:07:00,18596.5,SELL,3,0.02h,Break Even,$-1.50,$105.00,$63096.50,111,$105.00
2024-06-04,14:29:00,18619.25,BUY,3,0.02h,Stop Loss,$4.50,$109.50,$63101.00,111,$109.50
2024-06-04,14:56:00,18621.0,SELL,3,0.02h,Stop Loss,$57.00,$166.50,$63158.00,111,$166.50
2024-06-04,15:21:00,18626.5,BUY,3,0.02h,Stop Loss,$34.50,$201.00,$63192.50,111,$201.00
2024-06-04,15:30:00,18601.5,SELL,3,0.02h,Stop Loss,$36.00,$237.00,$63228.50,111,$237.00
2024-06-04,15:55:00,18600.5,BUY,3,0.02h,Stop Loss,$6.00,$243.00,$63234.50,111,$243.00
2024-06-04,15:59:00,18592.0,SELL,3,0.02h,Stop Loss,$28.50,$271.50,$63263.00,111,$271.50
2024-06-04,16:26:00,18590.25,BUY,3,0.02h,Stop Loss,$12.00,$283.50,$63275.00,111,$283.50
2024-06-04,17:04:00,18616.5,SELL,3,0.02h,Break Even,$-1.50,$282.00,$63273.50,111,$282.00
2024-06-04,17:17:00,18628.75,BUY,3,0.02h,Stop Loss,$18.00,$300.00,$63291.50,111,$300.00
2024-06-04,17:27:00,18614.75,SELL,3,0.02h,Break Even,$-1.50,$298.50,$63290.00,111,$298.50
2024-06-04,17:29:00,18634.25,BUY,3,0.02h,Stop Loss,$28.50,$327.00,$63318.50,111,$327.00
2024-06-04,17:38:00,18622.25,SELL,3,0.02h,Break Even,$-1.50,$325.50,$63317.00,111,$325.50
2024-06-04,17:42:00,18631.5,BUY,3,0.02h,Stop Loss,$12.00,$337.50,$63329.00,111,$337.50
2024-06-04,17:44:00,18621.5,SELL,3,0.02h,Stop Loss,$7.50,$345.00,$63336.50,111,$345.00
2024-06-04,17:49:00,18628.5,BUY,3,0.02h,Break Even,$-1.50,$343.50,$63335.00,111,$343.50
2024-06-04,17:50:00,18625.25,SELL,3,0.02h,Stop Loss,$-9.00,$334.50,$63326.00,111,$334.50
2024-06-04,17:51:00,18630.25,BUY,3,0.02h,Stop Loss,$-9.00,$325.50,$63317.00,111,$325.50
2024-06-04,18:59:00,18712.25,SELL,3,0.02h,Break Even,$-1.50,$324.00,$63315.50,111,$324.00
2024-06-04,19:44:00,18682.75,BUY,3,0.02h,Stop Loss,$49.50,$373.50,$63365.00,111,$373.50
2024-06-04,23:26:00,18723.5,SELL,3,0.02h,Stop Loss,$-9.00,$364.50,$63356.00,111,$364.50
2024-06-04,23:35:00,18735.75,BUY,3,0.02h,Break Even,$-1.50,$363.00,$63354.50,111,$363.00
2024-06-04,23:45:00,18727.0,SELL,3,0.02h,Stop Loss,$-9.00,$354.00,$63345.50,111,$354.00
2024-06-04,23:50:00,18732.0,BUY,3,0.02h,Stop Loss,$-9.00,$345.00,$63336.50,111,$345.00
,,,,,,,,,,,
2024-06-05,00:52:00,18737.75,SELL,3,0.02h,Break Even,$-1.50,$-1.50,$63335.00,112,$-1.50
2024-06-05,01:42:00,18728.0,BUY,3,0.02h,Break Even,$-1.50,$-3.00,$63333.50,112,$-3.00
2024-06-05,02:48:00,18758.25,SELL,3,0.02h,Break Even,$-1.50,$-4.50,$63332.00,112,$-4.50
2024-06-05,03:18:00,18756.25,BUY,3,0.02h,Stop Loss,$-9.00,$-13.50,$63323.00,112,$-13.50
2024-06-05,03:51:00,18753.75,SELL,3,0.02h,Stop Loss,$-9.00,$-22.50,$63314.00,112,$-22.50
2024-06-05,04:31:00,18756.5,BUY,3,0.03h,Stop Loss,$-9.00,$-31.50,$63305.00,112,$-31.50
2024-06-05,05:20:00,18758.0,SELL,3,0.02h,Stop Loss,$-9.00,$-40.50,$63296.00,112,$-40.50
2024-06-05,05:22:00,18760.25,BUY,3,0.05h,Stop Loss,$-9.00,$-49.50,$63287.00,112,$-49.50
2024-06-05,05:37:00,18756.75,SELL,3,0.03h,Break Even,$-1.50,$-51.00,$63285.50,112,$-51.00
2024-06-05,07:24:00,18722.0,BUY,3,0.02h,Break Even,$-1.50,$-52.50,$63284.00,112,$-52.50
2024-06-05,07:45:00,18714.5,SELL,3,0.02h,Stop Loss,$-9.00,$-61.50,$63275.00,112,$-61.50
2024-06-05,07:51:00,18728.5,BUY,3,0.02h,Stop Loss,$-9.00,$-70.50,$63266.00,112,$-70.50
2024-06-05,08:22:00,18735.25,SELL,3,0.02h,Break Even,$-1.50,$-72.00,$63264.50,112,$-72.00
2024-06-05,08:32:00,18744.75,BUY,3,0.02h,Stop Loss,$-9.00,$-81.00,$63255.50,112,$-81.00
2024-06-05,09:35:00,18765.75,SELL,3,0.02h,Break Even,$-1.50,$-82.50,$63254.00,112,$-82.50
2024-06-05,09:46:00,18772.25,BUY,3,0.02h,Break Even,$-1.50,$-84.00,$63252.50,112,$-84.00
2024-06-05,10:29:00,18784.25,SELL,3,0.02h,Stop Loss,$-9.00,$-93.00,$63243.50,112,$-93.00
2024-06-05,10:35:00,18793.0,BUY,3,0.03h,Break Even,$-1.50,$-94.50,$63242.00,112,$-94.50
2024-06-05,10:44:00,18785.5,SELL,3,0.02h,Stop Loss,$33.00,$-61.50,$63275.00,112,$-61.50
2024-06-05,11:15:00,18782.25,BUY,3,0.02h,Stop Loss,$-9.00,$-70.50,$63266.00,112,$-70.50
2024-06-05,11:22:00,18770.75,SELL,3,0.02h,Stop Loss,$-9.00,$-79.50,$63257.00,112,$-79.50
2024-06-05,11:25:00,18780.75,BUY,3,0.02h,Stop Loss,$-9.00,$-88.50,$63248.00,112,$-88.50
2024-06-05,12:11:00,18803.25,SELL,3,0.02h,Stop Loss,$-9.00,$-97.50,$63239.00,112,$-97.50
2024-06-05,12:18:00,18811.5,BUY,3,0.02h,Stop Loss,$-9.00,$-106.50,$63230.00,112,$-106.50
2024-06-05,12:19:00,18792.25,SELL,3,0.02h,Break Even,$-1.50,$-108.00,$63228.50,112,$-108.00
2024-06-05,12:40:00,18806.75,BUY,3,0.02h,Stop Loss,$-9.00,$-117.00,$63219.50,112,$-117.00
2024-06-05,13:35:00,18833.75,SELL,3,0.02h,Stop Loss,$100.50,$-16.50,$63320.00,112,$-16.50
2024-06-05,13:46:00,18841.75,BUY,3,0.02h,Stop Loss,$4.50,$-12.00,$63324.50,112,$-12.00
2024-06-05,14:08:00,18831.75,SELL,3,0.02h,Stop Loss,$7.50,$-4.50,$63332.00,112,$-4.50
2024-06-05,14:22:00,18849.75,BUY,3,0.02h,Stop Loss,$13.50,$9.00,$63345.50,112,$9.00
2024-06-05,15:55:00,18969.0,SELL,3,0.02h,Stop Loss,$19.50,$28.50,$63365.00,112,$28.50
2024-06-05,16:12:00,18973.75,BUY,3,0.02h,Break Even,$-1.50,$27.00,$63363.50,112,$27.00
2024-06-05,16:16:00,18961.75,SELL,3,0.02h,Stop Loss,$-9.00,$18.00,$63354.50,112,$18.00
2024-06-05,16:21:00,18974.25,BUY,3,0.02h,Stop Loss,$-9.00,$9.00,$63345.50,112,$9.00
2024-06-05,17:21:00,18982.0,SELL,3,0.02h,Stop Loss,$6.00,$15.00,$63351.50,112,$15.00
2024-06-05,17:34:00,19009.25,BUY,3,0.02h,Stop Loss,$-9.00,$6.00,$63342.50,112,$6.00
2024-06-05,18:09:00,19013.25,SELL,3,0.02h,Stop Loss,$-9.00,$-3.00,$63333.50,112,$-3.00
2024-06-05,18:11:00,19019.5,BUY,3,0.02h,Break Even,$-1.50,$-4.50,$63332.00,112,$-4.50
2024-06-05,18:14:00,19009.75,SELL,3,0.02h,Break Even,$-1.50,$-6.00,$63330.50,112,$-6.00
2024-06-05,18:23:00,19019.25,BUY,3,0.02h,Break Even,$-1.50,$-7.50,$63329.00,112,$-7.50
2024-06-05,19:27:00,19035.75,SELL,3,0.02h,Stop Loss,$21.00,$13.50,$63350.00,112,$13.50
2024-06-05,19:38:00,19046.75,BUY,3,0.02h,Stop Loss,$9.00,$22.50,$63359.00,112,$22.50
2024-06-05,19:47:00,19036.25,SELL,3,0.02h,Stop Loss,$10.50,$33.00,$63369.50,112,$33.00
2024-06-05,19:53:00,19053.5,BUY,3,0.02h,Stop Loss,$31.50,$64.50,$63401.00,112,$64.50
2024-06-05,23:27:00,19093.75,SELL,3,0.02h,Break Even,$-1.50,$63.00,$63399.50,112,$63.00
,,,,,,,,,,,
2024-06-06,00:46:00,19082.75,BUY,3,0.02h,Break Even,$-1.50,$-1.50,$63398.00,113,$-1.50
2024-06-06,01:10:00,19081.25,SELL,3,0.02h,Break Even,$-1.50,$-3.00,$63396.50,113,$-3.00
2024-06-06,01:18:00,19086.5,BUY,3,0.02h,Stop Loss,$12.00,$9.00,$63408.50,113,$9.00
2024-06-06,02:07:00,19096.75,SELL,3,0.02h,Break Even,$-1.50,$7.50,$63407.00,113,$7.50
2024-06-06,02:16:00,19100.0,BUY,3,0.02h,Break Even,$-1.50,$6.00,$63405.50,113,$6.00
2024-06-06,02:29:00,19096.5,SELL,3,0.02h,Stop Loss,$-9.00,$-3.00,$63396.50,113,$-3.00
2024-06-06,02:39:00,19101.75,BUY,3,0.02h,Stop Loss,$-9.00,$-12.00,$63387.50,113,$-12.00
2024-06-06,02:42:00,19097.0,SELL,3,0.02h,Stop Loss,$-9.00,$-21.00,$63378.50,113,$-21.00
2024-06-06,02:47:00,19100.25,BUY,3,0.02h,Stop Loss,$-9.00,$-30.00,$63369.50,113,$-30.00
2024-06-06,02:48:00,19098.0,SELL,3,0.02h,Stop Loss,$-9.00,$-39.00,$63360.50,113,$-39.00
2024-06-06,03:05:00,19101.5,BUY,3,0.02h,Stop Loss,$-9.00,$-48.00,$63351.50,113,$-48.00
2024-06-06,03:44:00,19102.5,SELL,3,0.02h,Break Even,$-1.50,$-49.50,$63350.00,113,$-49.50
2024-06-06,04:33:00,19096.75,BUY,3,0.03h,Stop Loss,$-9.00,$-58.50,$63341.00,113,$-58.50
2024-06-06,04:36:00,19095.25,SELL,3,0.03h,Stop Loss,$-9.00,$-67.50,$63332.00,113,$-67.50
2024-06-06,04:38:00,19097.5,BUY,3,0.02h,Break Even,$-1.50,$-69.00,$63330.50,113,$-69.00
2024-06-06,05:02:00,19093.25,SELL,3,0.02h,Stop Loss,$-9.00,$-78.00,$63321.50,113,$-78.00
2024-06-06,06:29:00,19081.75,BUY,3,0.02h,Stop Loss,$-9.00,$-87.00,$63312.50,113,$-87.00
2024-06-06,06:32:00,19078.75,SELL,3,0.02h,Break Even,$-1.50,$-88.50,$63311.00,113,$-88.50
2024-06-06,06:46:00,19083.75,BUY,3,0.02h,Break Even,$-1.50,$-90.00,$63309.50,113,$-90.00
2024-06-06,07:08:00,19080.25,SELL,3,0.02h,Stop Loss,$-9.00,$-99.00,$63300.50,113,$-99.00
2024-06-06,07:11:00,19090.0,BUY,3,0.02h,Stop Loss,$25.50,$-73.50,$63326.00,113,$-73.50
2024-06-06,07:33:00,19089.0,SELL,3,0.02h,Break Even,$-1.50,$-75.00,$63324.50,113,$-75.00
2024-06-06,07:49:00,19093.25,BUY,3,0.02h,Stop Loss,$-9.00,$-84.00,$63315.50,113,$-84.00
2024-06-06,07:50:00,19090.0,SELL,3,0.02h,Break Even,$-1.50,$-85.50,$63314.00,113,$-85.50
2024-06-06,07:59:00,19092.0,BUY,3,0.02h,Break Even,$-1.50,$-87.00,$63312.50,113,$-87.00
2024-06-06,08:41:00,19100.5,SELL,3,0.02h,Stop Loss,$-9.00,$-96.00,$63303.50,113,$-96.00
2024-06-06,09:08:00,19100.0,BUY,3,0.02h,Stop Loss,$-9.00,$-105.00,$63294.50,113,$-105.00
2024-06-06,09:23:00,19094.25,SELL,3,0.02h,Stop Loss,$-9.00,$-114.00,$63285.50,113,$-114.00
2024-06-06,10:03:00,19088.5,BUY,3,0.02h,Stop Loss,$-9.00,$-123.00,$63276.50,113,$-123.00
2024-06-06,10:27:00,19086.0,SELL,3,0.02h,Break Even,$-1.50,$-124.50,$63275.00,113,$-124.50
2024-06-06,10:34:00,19093.25,BUY,3,0.02h,Stop Loss,$-9.00,$-133.50,$63266.00,113,$-133.50
2024-06-06,10:49:00,19085.25,SELL,3,0.02h,Stop Loss,$-9.00,$-142.50,$63257.00,113,$-142.50
2024-06-06,10:56:00,19093.0,BUY,3,0.03h,Stop Loss,$-9.00,$-151.50,$63248.00,113,$-151.50
2024-06-06,11:01:00,19089.25,SELL,3,0.02h,Break Even,$-1.50,$-153.00,$63246.50,113,$-153.00
2024-06-06,11:03:00,19095.5,BUY,3,0.02h,Stop Loss,$-9.00,$-162.00,$63237.50,113,$-162.00
2024-06-06,11:35:00,19093.5,SELL,3,0.02h,Stop Loss,$-9.00,$-171.00,$63228.50,113,$-171.00
2024-06-06,11:39:00,19096.75,BUY,3,0.03h,Stop Loss,$-9.00,$-180.00,$63219.50,113,$-180.00
2024-06-06,11:43:00,19092.0,SELL,3,0.02h,Stop Loss,$-9.00,$-189.00,$63210.50,113,$-189.00
2024-06-06,11:55:00,19097.0,BUY,3,0.02h,Stop Loss,$-9.00,$-198.00,$63201.50,113,$-198.00
2024-06-06,12:25:00,19097.5,SELL,3,0.02h,Stop Loss,$9.00,$-189.00,$63210.50,113,$-189.00
2024-06-06,12:53:00,19095.5,BUY,3,0.02h,Stop Loss,$-9.00,$-198.00,$63201.50,113,$-198.00
2024-06-06,13:46:00,19086.25,SELL,3,0.02h,Stop Loss,$93.00,$-105.00,$63294.50,113,$-105.00
2024-06-06,14:24:00,19082.25,BUY,3,0.02h,Stop Loss,$9.00,$-96.00,$63303.50,113,$-96.00
2024-06-06,14:53:00,19079.75,SELL,3,0.02h,Stop Loss,$-9.00,$-105.00,$63294.50,113,$-105.00
2024-06-06,14:56:00,19097.25,BUY,3,0.02h,Stop Loss,$-9.00,$-114.00,$63285.50,113,$-114.00
2024-06-06,15:00:00,19083.0,SELL,3,0.02h,Stop Loss,$30.00,$-84.00,$63315.50,113,$-84.00
2024-06-06,15:10:00,19090.75,BUY,3,0.02h,Break Even,$-1.50,$-85.50,$63314.00,113,$-85.50
2024-06-06,15:11:00,19087.75,SELL,3,0.02h,Stop Loss,$7.50,$-78.00,$63321.50,113,$-78.00
2024-06-06,15:54:00,19067.75,BUY,3,0.02h,Stop Loss,$7.50,$-70.50,$63329.00,113,$-70.50
2024-06-06,16:01:00,19062.0,SELL,3,0.02h,Stop Loss,$6.00,$-64.50,$63335.00,113,$-64.50
2024-06-06,16:05:00,19070.75,BUY,3,0.02h,Stop Loss,$13.50,$-51.00,$63348.50,113,$-51.00
2024-06-06,16:16:00,19056.25,SELL,3,0.02h,Stop Loss,$79.50,$28.50,$63428.00,113,$28.50
2024-06-06,16:55:00,19052.75,BUY,3,0.02h,Break Even,$-1.50,$27.00,$63426.50,113,$27.00
2024-06-06,17:49:00,19070.5,SELL,3,0.02h,Break Even,$-1.50,$25.50,$63425.00,113,$25.50
2024-06-06,17:56:00,19082.25,BUY,3,0.02h,Stop Loss,$-9.00,$16.50,$63416.00,113,$16.50
2024-06-06,17:57:00,19072.25,SELL,3,0.02h,Break Even,$-1.50,$15.00,$63414.50,113,$15.00
2024-06-06,18:35:00,19052.0,BUY,3,0.02h,Stop Loss,$10.50,$25.50,$63425.00,113,$25.50
2024-06-06,18:37:00,19045.75,SELL,3,0.02h,Stop Loss,$6.00,$31.50,$63431.00,113,$31.50
2024-06-06,18:41:00,19052.5,BUY,3,0.02h,Break Even,$-1.50,$30.00,$63429.50,113,$30.00
2024-06-06,19:14:00,19056.0,SELL,3,0.02h,Stop Loss,$27.00,$57.00,$63456.50,113,$57.00
2024-06-06,19:32:00,19061.25,BUY,3,0.02h,Stop Loss,$-9.00,$48.00,$63447.50,113,$48.00
2024-06-06,19:36:00,19051.5,SELL,3,0.02h,Break Even,$-1.50,$46.50,$63446.00,113,$46.50
2024-06-06,19:39:00,19060.0,BUY,3,0.02h,Stop Loss,$-9.00,$37.50,$63437.00,113,$37.50
2024-06-06,19:40:00,19055.0,SELL,3,0.02h,Stop Loss,$30.00,$67.50,$63467.00,113,$67.50
2024-06-06,19:49:00,19065.5,BUY,3,0.02h,Stop Loss,$28.50,$96.00,$63495.50,113,$96.00
2024-06-06,20:03:00,19047.75,SELL,3,0.02h,Break Even,$-1.50,$94.50,$63494.00,113,$94.50
2024-06-06,20:08:00,19064.25,BUY,3,0.02h,Break Even,$-1.50,$93.00,$63492.50,113,$93.00
2024-06-06,20:42:00,19063.5,SELL,3,0.02h,Stop Loss,$-9.00,$84.00,$63483.50,113,$84.00
2024-06-06,20:57:00,19066.75,BUY,3,0.02h,Stop Loss,$-9.00,$75.00,$63474.50,113,$75.00
2024-06-06,23:35:00,19075.75,SELL,3,0.03h,Stop Loss,$-9.00,$66.00,$63465.50,113,$66.00
,,,,,,,,,,,
2024-06-07,00:02:00,19076.5,BUY,3,0.02h,Stop Loss,$-9.00,$-9.00,$63456.50,114,$-9.00
2024-06-07,00:07:00,19067.75,SELL,3,0.02h,Stop Loss,$-9.00,$-18.00,$63447.50,114,$-18.00
2024-06-07,00:37:00,19073.5,BUY,3,0.02h,Stop Loss,$-9.00,$-27.00,$63438.50,114,$-27.00
2024-06-07,01:16:00,19077.5,SELL,3,0.02h,Stop Loss,$-9.00,$-36.00,$63429.50,114,$-36.00
2024-06-07,01:31:00,19080.0,BUY,3,0.02h,Stop Loss,$7.50,$-28.50,$63437.00,114,$-28.50
2024-06-07,02:00:00,19082.0,SELL,3,0.02h,Break Even,$-1.50,$-30.00,$63435.50,114,$-30.00
2024-06-07,02:15:00,19084.0,BUY,3,0.05h,Stop Loss,$-9.00,$-39.00,$63426.50,114,$-39.00
2024-06-07,02:37:00,19082.0,SELL,3,0.10h,Stop Loss,$-9.00,$-48.00,$63417.50,114,$-48.00
2024-06-07,02:48:00,19086.5,BUY,3,0.02h,Stop Loss,$-9.00,$-57.00,$63408.50,114,$-57.00
2024-06-07,03:11:00,19083.0,SELL,3,0.02h,Stop Loss,$-9.00,$-66.00,$63399.50,114,$-66.00
2024-06-07,03:36:00,19084.5,BUY,3,0.03h,Stop Loss,$-9.00,$-75.00,$63390.50,114,$-75.00
2024-06-07,03:42:00,19081.25,SELL,3,0.05h,Break Even,$-1.50,$-76.50,$63389.00,114,$-76.50
2024-06-07,04:02:00,19082.25,BUY,3,0.38h,Stop Loss,$15.00,$-61.50,$63404.00,114,$-61.50
2024-06-07,04:37:00,19083.25,SELL,3,0.02h,Stop Loss,$-9.00,$-70.50,$63395.00,114,$-70.50
2024-06-07,04:50:00,19087.75,BUY,3,0.40h,Stop Loss,$7.50,$-63.00,$63402.50,114,$-63.00
2024-06-07,05:18:00,19088.0,SELL,3,0.05h,Stop Loss,$-9.00,$-72.00,$63393.50,114,$-72.00
2024-06-07,05:25:00,19090.75,BUY,3,0.05h,Stop Loss,$4.50,$-67.50,$63398.00,114,$-67.50
2024-06-07,05:53:00,19094.0,SELL,3,0.05h,Break Even,$-1.50,$-69.00,$63396.50,114,$-69.00
2024-06-07,06:27:00,19093.0,BUY,3,0.02h,Stop Loss,$-9.00,$-78.00,$63387.50,114,$-78.00
2024-06-07,07:00:00,19090.25,SELL,3,0.02h,Stop Loss,$-9.00,$-87.00,$63378.50,114,$-87.00
2024-06-07,07:03:00,19102.25,BUY,3,0.02h,Stop Loss,$-9.00,$-96.00,$63369.50,114,$-96.00
2024-06-07,07:07:00,19092.5,SELL,3,0.02h,Stop Loss,$-9.00,$-105.00,$63360.50,114,$-105.00
2024-06-07,08:07:00,19081.0,BUY,3,0.02h,Stop Loss,$3.00,$-102.00,$63363.50,114,$-102.00
2024-06-07,08:24:00,19082.5,SELL,3,0.02h,Stop Loss,$-9.00,$-111.00,$63354.50,114,$-111.00
2024-06-07,08:29:00,19090.0,BUY,3,0.02h,Break Even,$-1.50,$-112.50,$63353.00,114,$-112.50
2024-06-07,08:50:00,19085.5,SELL,3,0.02h,Break Even,$-1.50,$-114.00,$63351.50,114,$-114.00
2024-06-07,09:30:00,19081.25,BUY,3,0.02h,Stop Loss,$-9.00,$-123.00,$63342.50,114,$-123.00
2024-06-07,09:54:00,19077.0,SELL,3,0.02h,Break Even,$-1.50,$-124.50,$63341.00,114,$-124.50
2024-06-07,10:06:00,19079.25,BUY,3,0.02h,Stop Loss,$-9.00,$-133.50,$63332.00,114,$-133.50
2024-06-07,10:07:00,19074.25,SELL,3,0.02h,Break Even,$-1.50,$-135.00,$63330.50,114,$-135.00
2024-06-07,10:32:00,19076.75,BUY,3,0.02h,Stop Loss,$-9.00,$-144.00,$63321.50,114,$-144.00
2024-06-07,10:45:00,19072.0,SELL,3,0.02h,Stop Loss,$27.00,$-117.00,$63348.50,114,$-117.00
2024-06-07,11:33:00,19071.0,BUY,3,0.02h,Break Even,$-1.50,$-118.50,$63347.00,114,$-118.50
2024-06-07,12:21:00,19089.75,SELL,3,0.02h,Break Even,$-1.50,$-120.00,$63345.50,114,$-120.00
2024-06-07,12:22:00,19092.25,BUY,3,0.02h,Break Even,$-1.50,$-121.50,$63344.00,114,$-121.50
2024-06-07,12:29:00,19089.0,SELL,3,0.02h,Stop Loss,$-9.00,$-130.50,$63335.00,114,$-130.50
2024-06-07,13:06:00,19025.25,BUY,3,0.02h,Stop Loss,$31.50,$-99.00,$63366.50,114,$-99.00
2024-06-07,13:35:00,18996.25,SELL,3,0.02h,Break Even,$-1.50,$-100.50,$63365.00,114,$-100.50
2024-06-07,13:46:00,19025.5,BUY,3,0.02h,Stop Loss,$24.00,$-76.50,$63389.00,114,$-76.50
2024-06-07,14:12:00,19028.5,SELL,3,0.02h,Break Even,$-1.50,$-78.00,$63387.50,114,$-78.00
2024-06-07,14:14:00,19041.5,BUY,3,0.02h,Stop Loss,$-9.00,$-87.00,$63378.50,114,$-87.00
2024-06-07,14:30:00,19038.5,SELL,3,0.02h,Stop Loss,$15.00,$-72.00,$63393.50,114,$-72.00
2024-06-07,14:33:00,19042.25,BUY,3,0.02h,Stop Loss,$4.50,$-67.50,$63398.00,114,$-67.50
2024-06-07,14:34:00,19036.0,SELL,3,0.02h,Stop Loss,$-9.00,$-76.50,$63389.00,114,$-76.50
2024-06-07,14:35:00,19046.75,BUY,3,0.02h,Stop Loss,$31.50,$-45.00,$63420.50,114,$-45.00
2024-06-07,15:01:00,19055.25,SELL,3,0.02h,Stop Loss,$21.00,$-24.00,$63441.50,114,$-24.00
2024-06-07,15:25:00,19061.75,BUY,3,0.02h,Stop Loss,$3.00,$-21.00,$63444.50,114,$-21.00
2024-06-07,16:43:00,19094.25,SELL,3,0.02h,Stop Loss,$-9.00,$-30.00,$63435.50,114,$-30.00
2024-06-07,16:53:00,19111.25,BUY,3,0.02h,Stop Loss,$18.00,$-12.00,$63453.50,114,$-12.00
2024-06-07,17:38:00,19122.25,SELL,3,0.02h,Stop Loss,$25.50,$13.50,$63479.00,114,$13.50
2024-06-07,17:52:00,19132.25,BUY,3,0.02h,Stop Loss,$6.00,$19.50,$63485.00,114,$19.50
2024-06-07,18:00:00,19115.0,SELL,3,0.02h,Stop Loss,$171.00,$190.50,$63656.00,114,$190.50
2024-06-07,18:32:00,19052.25,BUY,3,0.02h,Break Even,$-1.50,$189.00,$63654.50,114,$189.00
2024-06-07,19:01:00,19039.0,SELL,3,0.02h,Stop Loss,$3.00,$192.00,$63657.50,114,$192.00
2024-06-07,19:30:00,19047.5,BUY,3,0.02h,Stop Loss,$-9.00,$183.00,$63648.50,114,$183.00
2024-06-07,19:52:00,19037.5,SELL,3,0.02h,Stop Loss,$73.50,$256.50,$63722.00,114,$256.50
2024-06-07,19:59:00,19044.25,BUY,3,0.02h,Stop Loss,$19.50,$276.00,$63741.50,114,$276.00
2024-06-07,20:01:00,19039.5,SELL,3,0.02h,Stop Loss,$7.50,$283.50,$63749.00,114,$283.50
2024-06-07,20:50:00,19024.5,BUY,3,0.02h,Stop Loss,$9.00,$292.50,$63758.00,114,$292.50
,,,,,,,,,,,
2024-06-10,00:11:00,19019.75,SELL,3,0.02h,Stop Loss,$-9.00,$-9.00,$63749.00,115,$-9.00
2024-06-10,00:42:00,19026.5,BUY,3,0.02h,Stop Loss,$-9.00,$-18.00,$63740.00,115,$-18.00
2024-06-10,01:21:00,19027.5,SELL,3,0.02h,Stop Loss,$-9.00,$-27.00,$63731.00,115,$-27.00
2024-06-10,01:30:00,19032.0,BUY,3,0.05h,Stop Loss,$4.50,$-22.50,$63735.50,115,$-22.50
2024-06-10,02:29:00,19036.25,SELL,3,0.02h,Break Even,$-1.50,$-24.00,$63734.00,115,$-24.00
2024-06-10,02:43:00,19037.0,BUY,3,0.02h,Stop Loss,$-9.00,$-33.00,$63725.00,115,$-33.00
2024-06-10,02:45:00,19034.0,SELL,3,0.02h,Stop Loss,$-9.00,$-42.00,$63716.00,115,$-42.00
2024-06-10,02:48:00,19037.0,BUY,3,0.12h,Stop Loss,$4.50,$-37.50,$63720.50,115,$-37.50
2024-06-10,03:37:00,19044.0,SELL,3,0.05h,Stop Loss,$-9.00,$-46.50,$63711.50,115,$-46.50
2024-06-10,04:02:00,19044.5,BUY,3,0.02h,Stop Loss,$-9.00,$-55.50,$63702.50,115,$-55.50
2024-06-10,04:08:00,19040.25,SELL,3,0.05h,Stop Loss,$-9.00,$-64.50,$63693.50,115,$-64.50
2024-06-10,04:25:00,19044.0,BUY,3,0.02h,Stop Loss,$-9.00,$-73.50,$63684.50,115,$-73.50
2024-06-10,05:31:00,19045.0,SELL,3,0.02h,Break Even,$-1.50,$-75.00,$63683.00,115,$-75.00
2024-06-10,05:59:00,19044.25,BUY,3,0.02h,Break Even,$-1.50,$-76.50,$63681.50,115,$-76.50
2024-06-10,06:01:00,19039.75,SELL,3,0.02h,Stop Loss,$25.50,$-51.00,$63707.00,115,$-51.00
2024-06-10,07:08:00,19021.5,BUY,3,0.02h,Break Even,$-1.50,$-52.50,$63705.50,115,$-52.50
2024-06-10,07:13:00,19011.0,SELL,3,0.02h,Break Even,$-1.50,$-54.00,$63704.00,115,$-54.00
2024-06-10,07:34:00,19016.5,BUY,3,0.02h,Stop Loss,$-9.00,$-63.00,$63695.00,115,$-63.00
2024-06-10,07:39:00,19006.0,SELL,3,0.02h,Stop Loss,$7.50,$-55.50,$63702.50,115,$-55.50
2024-06-10,07:51:00,19010.25,BUY,3,0.02h,Break Even,$-1.50,$-57.00,$63701.00,115,$-57.00
2024-06-10,08:06:00,19009.25,SELL,3,0.02h,Stop Loss,$13.50,$-43.50,$63714.50,115,$-43.50
2024-06-10,08:12:00,19016.75,BUY,3,0.02h,Break Even,$-1.50,$-45.00,$63713.00,115,$-45.00
2024-06-10,08:17:00,19007.0,SELL,3,0.02h,Break Even,$-1.50,$-46.50,$63711.50,115,$-46.50
2024-06-10,08:27:00,19014.0,BUY,3,0.02h,Stop Loss,$-9.00,$-55.50,$63702.50,115,$-55.50
2024-06-10,08:28:00,19006.5,SELL,3,0.02h,Stop Loss,$-9.00,$-64.50,$63693.50,115,$-64.50
2024-06-10,08:32:00,19014.5,BUY,3,0.02h,Stop Loss,$-9.00,$-73.50,$63684.50,115,$-73.50
2024-06-10,08:40:00,19009.75,SELL,3,0.02h,Stop Loss,$-9.00,$-82.50,$63675.50,115,$-82.50
2024-06-10,09:34:00,18997.0,BUY,3,0.02h,Break Even,$-1.50,$-84.00,$63674.00,115,$-84.00
2024-06-10,10:16:00,18999.0,SELL,3,0.02h,Break Even,$-1.50,$-85.50,$63672.50,115,$-85.50
2024-06-10,10:20:00,19005.0,BUY,3,0.02h,Stop Loss,$-9.00,$-94.50,$63663.50,115,$-94.50
2024-06-10,10:56:00,19018.25,SELL,3,0.02h,Break Even,$-1.50,$-96.00,$63662.00,115,$-96.00
2024-06-10,11:08:00,19026.0,BUY,3,0.02h,Stop Loss,$-9.00,$-105.00,$63653.00,115,$-105.00
2024-06-10,11:55:00,19027.5,SELL,3,0.02h,Stop Loss,$-9.00,$-114.00,$63644.00,115,$-114.00
2024-06-10,12:10:00,19033.0,BUY,3,0.02h,Break Even,$-1.50,$-115.50,$63642.50,115,$-115.50
2024-06-10,12:15:00,19027.5,SELL,3,0.02h,Stop Loss,$-9.00,$-124.50,$63633.50,115,$-124.50
2024-06-10,12:19:00,19031.75,BUY,3,0.02h,Stop Loss,$-9.00,$-133.50,$63624.50,115,$-133.50
2024-06-10,12:20:00,19028.25,SELL,3,0.02h,Stop Loss,$-9.00,$-142.50,$63615.50,115,$-142.50
2024-06-10,12:21:00,19034.75,BUY,3,0.02h,Stop Loss,$-9.00,$-151.50,$63606.50,115,$-151.50
2024-06-10,12:24:00,19023.5,SELL,3,0.02h,Stop Loss,$-9.00,$-160.50,$63597.50,115,$-160.50
2024-06-10,13:33:00,19005.75,BUY,3,0.02h,Stop Loss,$-9.00,$-169.50,$63588.50,115,$-169.50
2024-06-10,13:48:00,18992.5,SELL,3,0.02h,Break Even,$-1.50,$-171.00,$63587.00,115,$-171.00
2024-06-10,14:09:00,19010.0,BUY,3,0.02h,Stop Loss,$18.00,$-153.00,$63605.00,115,$-153.00
2024-06-10,14:18:00,19001.25,SELL,3,0.02h,Break Even,$-1.50,$-154.50,$63603.50,115,$-154.50
2024-06-10,14:20:00,19009.0,BUY,3,0.02h,Stop Loss,$33.00,$-121.50,$63636.50,115,$-121.50
2024-06-10,16:02:00,19091.75,SELL,3,0.02h,Stop Loss,$-9.00,$-130.50,$63627.50,115,$-130.50
2024-06-10,16:12:00,19105.0,BUY,3,0.02h,Break Even,$-1.50,$-132.00,$63626.00,115,$-132.00
2024-06-10,16:32:00,19104.25,SELL,3,0.02h,Stop Loss,$30.00,$-102.00,$63656.00,115,$-102.00
2024-06-10,16:35:00,19109.5,BUY,3,0.02h,Stop Loss,$-9.00,$-111.00,$63647.00,115,$-111.00
2024-06-10,16:41:00,19104.5,SELL,3,0.02h,Stop Loss,$-9.00,$-120.00,$63638.00,115,$-120.00
2024-06-10,16:42:00,19109.5,BUY,3,0.02h,Break Even,$-1.50,$-121.50,$63636.50,115,$-121.50
2024-06-10,16:48:00,19100.25,SELL,3,0.02h,Stop Loss,$-9.00,$-130.50,$63627.50,115,$-130.50
2024-06-10,16:53:00,19109.5,BUY,3,0.02h,Stop Loss,$3.00,$-127.50,$63630.50,115,$-127.50
2024-06-10,17:01:00,19092.25,SELL,3,0.02h,Break Even,$-1.50,$-129.00,$63629.00,115,$-129.00
2024-06-10,17:47:00,19090.75,BUY,3,0.02h,Stop Loss,$-9.00,$-138.00,$63620.00,115,$-138.00
2024-06-10,18:11:00,19083.0,SELL,3,0.02h,Stop Loss,$4.50,$-133.50,$63624.50,115,$-133.50
2024-06-10,18:41:00,19071.5,BUY,3,0.02h,Stop Loss,$57.00,$-76.50,$63681.50,115,$-76.50
2024-06-10,19:34:00,19097.75,SELL,3,0.02h,Break Even,$-1.50,$-78.00,$63680.00,115,$-78.00
2024-06-10,19:42:00,19115.0,BUY,3,0.02h,Stop Loss,$-9.00,$-87.00,$63671.00,115,$-87.00
2024-06-10,19:46:00,19096.0,SELL,3,0.02h,Break Even,$-1.50,$-88.50,$63669.50,115,$-88.50
2024-06-10,20:00:00,19112.75,BUY,3,0.02h,Break Even,$-1.50,$-90.00,$63668.00,115,$-90.00
2024-06-10,20:02:00,19094.0,SELL,3,0.02h,Stop Loss,$-9.00,$-99.00,$63659.00,115,$-99.00
2024-06-10,20:27:00,19094.25,BUY,3,0.07h,Stop Loss,$-9.00,$-108.00,$63650.00,115,$-108.00
2024-06-10,23:02:00,19094.0,SELL,3,0.02h,Break Even,$-1.50,$-109.50,$63648.50,115,$-109.50
2024-06-10,23:49:00,19088.25,BUY,3,0.02h,Stop Loss,$-9.00,$-118.50,$63639.50,115,$-118.50
,,,,,,,,,,,
2024-06-11,00:07:00,19080.75,SELL,3,0.02h,Stop Loss,$-9.00,$-9.00,$63630.50,116,$-9.00
2024-06-11,00:21:00,19085.0,BUY,3,0.02h,Stop Loss,$4.50,$-4.50,$63635.00,116,$-4.50
2024-06-11,00:33:00,19080.25,SELL,3,0.02h,Stop Loss,$-9.00,$-13.50,$63626.00,116,$-13.50
2024-06-11,00:56:00,19082.75,BUY,3,0.02h,Break Even,$-1.50,$-15.00,$63624.50,116,$-15.00
2024-06-11,01:17:00,19079.0,SELL,3,0.02h,Stop Loss,$-9.00,$-24.00,$63615.50,116,$-24.00
2024-06-11,01:23:00,19085.0,BUY,3,0.02h,Break Even,$-1.50,$-25.50,$63614.00,116,$-25.50
2024-06-11,02:09:00,19091.75,SELL,3,0.03h,Break Even,$-1.50,$-27.00,$63612.50,116,$-27.00
2024-06-11,02:43:00,19090.0,BUY,3,0.02h,Stop Loss,$-9.00,$-36.00,$63603.50,116,$-36.00
2024-06-11,02:47:00,19087.5,SELL,3,0.05h,Break Even,$-1.50,$-37.50,$63602.00,116,$-37.50
2024-06-11,03:04:00,19089.75,BUY,3,0.02h,Break Even,$-1.50,$-39.00,$63600.50,116,$-39.00
2024-06-11,03:16:00,19086.5,SELL,3,0.02h,Break Even,$-1.50,$-40.50,$63599.00,116,$-40.50
2024-06-11,03:30:00,19088.25,BUY,3,0.02h,Stop Loss,$-9.00,$-49.50,$63590.00,116,$-49.50
2024-06-11,03:31:00,19087.25,SELL,3,0.12h,Stop Loss,$25.50,$-24.00,$63615.50,116,$-24.00
2024-06-11,03:49:00,19086.5,BUY,3,0.02h,Stop Loss,$-9.00,$-33.00,$63606.50,116,$-33.00
2024-06-11,04:40:00,19089.5,SELL,3,0.05h,Stop Loss,$-9.00,$-42.00,$63597.50,116,$-42.00
2024-06-11,05:03:00,19091.5,BUY,3,0.02h,Break Even,$-1.50,$-43.50,$63596.00,116,$-43.50
2024-06-11,05:28:00,19091.0,SELL,3,0.05h,Stop Loss,$-9.00,$-52.50,$63587.00,116,$-52.50
2024-06-11,05:43:00,19093.25,BUY,3,0.05h,Break Even,$-1.50,$-54.00,$63585.50,116,$-54.00
2024-06-11,06:36:00,19106.5,SELL,3,0.02h,Stop Loss,$-9.00,$-63.00,$63576.50,116,$-63.00
2024-06-11,07:36:00,19093.5,BUY,3,0.02h,Break Even,$-1.50,$-64.50,$63575.00,116,$-64.50
2024-06-11,08:09:00,19092.0,SELL,3,0.02h,Stop Loss,$13.50,$-51.00,$63588.50,116,$-51.00
2024-06-11,08:15:00,19097.5,BUY,3,0.02h,Stop Loss,$-9.00,$-60.00,$63579.50,116,$-60.00
2024-06-11,08:17:00,19095.25,SELL,3,0.02h,Break Even,$-1.50,$-61.50,$63578.00,116,$-61.50
2024-06-11,09:46:00,19065.0,BUY,3,0.02h,Stop Loss,$-9.00,$-70.50,$63569.00,116,$-70.50
2024-06-11,09:48:00,19059.75,SELL,3,0.02h,Break Even,$-1.50,$-72.00,$63567.50,116,$-72.00
2024-06-11,10:18:00,19053.0,BUY,3,0.02h,Break Even,$-1.50,$-73.50,$63566.00,116,$-73.50
2024-06-11,10:51:00,19058.5,SELL,3,0.02h,Stop Loss,$7.50,$-66.00,$63573.50,116,$-66.00
2024-06-11,11:00:00,19059.75,BUY,3,0.02h,Break Even,$-1.50,$-67.50,$63572.00,116,$-67.50
2024-06-11,11:02:00,19057.75,SELL,3,0.02h,Stop Loss,$-9.00,$-76.50,$63563.00,116,$-76.50
2024-06-11,11:35:00,19046.5,BUY,3,0.02h,Stop Loss,$-9.00,$-85.50,$63554.00,116,$-85.50
2024-06-11,12:32:00,19054.5,SELL,3,0.02h,Stop Loss,$-9.00,$-94.50,$63545.00,116,$-94.50
2024-06-11,12:44:00,19063.0,BUY,3,0.02h,Break Even,$-1.50,$-96.00,$63543.50,116,$-96.00
2024-06-11,12:54:00,19055.25,SELL,3,0.02h,Stop Loss,$19.50,$-76.50,$63563.00,116,$-76.50
2024-06-11,13:14:00,19058.5,BUY,3,0.02h,Break Even,$-1.50,$-78.00,$63561.50,116,$-78.00
2024-06-11,13:26:00,19050.0,SELL,3,0.02h,Stop Loss,$-9.00,$-87.00,$63552.50,116,$-87.00
2024-06-11,13:30:00,19057.5,BUY,3,0.02h,Stop Loss,$31.50,$-55.50,$63584.00,116,$-55.50
2024-06-11,13:32:00,19048.5,SELL,3,0.02h,Stop Loss,$-9.00,$-64.50,$63575.00,116,$-64.50
2024-06-11,13:33:00,19060.5,BUY,3,0.02h,Stop Loss,$75.00,$10.50,$63650.00,116,$10.50
2024-06-11,13:47:00,19048.25,SELL,3,0.02h,Stop Loss,$220.50,$231.00,$63870.50,116,$231.00
2024-06-11,14:05:00,19053.5,BUY,3,0.02h,Stop Loss,$58.50,$289.50,$63929.00,116,$289.50
2024-06-11,15:10:00,19107.0,SELL,3,0.02h,Stop Loss,$-9.00,$280.50,$63920.00,116,$280.50
2024-06-11,15:24:00,19115.25,BUY,3,0.02h,Break Even,$-1.50,$279.00,$63918.50,116,$279.00
2024-06-11,15:40:00,19111.25,SELL,3,0.02h,Stop Loss,$19.50,$298.50,$63938.00,116,$298.50
2024-06-11,16:13:00,19092.0,BUY,3,0.02h,Break Even,$-1.50,$297.00,$63936.50,116,$297.00
2024-06-11,16:24:00,19083.5,SELL,3,0.02h,Break Even,$-1.50,$295.50,$63935.00,116,$295.50
2024-06-11,16:26:00,19093.5,BUY,3,0.02h,Break Even,$-1.50,$294.00,$63933.50,116,$294.00
2024-06-11,16:59:00,19097.0,SELL,3,0.02h,Stop Loss,$16.50,$310.50,$63950.00,116,$310.50
2024-06-11,17:03:00,19113.25,BUY,3,0.02h,Stop Loss,$60.00,$370.50,$64010.00,116,$370.50
2024-06-11,17:25:00,19110.5,SELL,3,0.02h,Stop Loss,$-9.00,$361.50,$64001.00,116,$361.50
2024-06-11,17:33:00,19124.75,BUY,3,0.02h,Break Even,$-1.50,$360.00,$63999.50,116,$360.00
2024-06-11,18:54:00,19199.25,SELL,3,0.02h,Stop Loss,$-9.00,$351.00,$63990.50,116,$351.00
2024-06-11,19:03:00,19216.5,BUY,3,0.02h,Stop Loss,$15.00,$366.00,$64005.50,116,$366.00
2024-06-11,19:12:00,19201.75,SELL,3,0.02h,Stop Loss,$15.00,$381.00,$64020.50,116,$381.00
2024-06-11,19:42:00,19203.75,BUY,3,0.02h,Stop Loss,$-9.00,$372.00,$64011.50,116,$372.00
2024-06-11,20:39:00,19243.75,SELL,3,0.02h,Break Even,$-1.50,$370.50,$64010.00,116,$370.50
2024-06-11,20:58:00,19247.25,BUY,3,0.02h,Stop Loss,$-9.00,$361.50,$64001.00,116,$361.50
2024-06-11,23:35:00,19262.25,SELL,3,0.02h,Stop Loss,$-9.00,$352.50,$63992.00,116,$352.50
,,,,,,,,,,,
2024-06-12,01:04:00,19245.5,BUY,3,0.02h,Stop Loss,$-9.00,$-9.00,$63983.00,117,$-9.00
2024-06-12,02:00:00,19255.5,SELL,3,0.02h,Stop Loss,$-9.00,$-18.00,$63974.00,117,$-18.00
2024-06-12,02:32:00,19258.25,BUY,3,0.07h,Stop Loss,$-9.00,$-27.00,$63965.00,117,$-27.00
2024-06-12,02:39:00,19255.25,SELL,3,0.02h,Break Even,$-1.50,$-28.50,$63963.50,117,$-28.50
2024-06-12,02:47:00,19258.75,BUY,3,0.13h,Stop Loss,$-9.00,$-37.50,$63954.50,117,$-37.50
2024-06-12,03:00:00,19255.5,SELL,3,0.02h,Break Even,$-1.50,$-39.00,$63953.00,117,$-39.00
2024-06-12,03:21:00,19257.75,BUY,3,0.07h,Break Even,$-1.50,$-40.50,$63951.50,117,$-40.50
2024-06-12,04:13:00,19263.0,SELL,3,0.12h,Stop Loss,$-9.00,$-49.50,$63942.50,117,$-49.50
2024-06-12,05:15:00,19258.25,BUY,3,0.18h,Stop Loss,$3.00,$-46.50,$63945.50,117,$-46.50
2024-06-12,05:28:00,19256.0,SELL,3,0.05h,Stop Loss,$-9.00,$-55.50,$63936.50,117,$-55.50
2024-06-12,05:34:00,19258.75,BUY,3,0.03h,Stop Loss,$-9.00,$-64.50,$63927.50,117,$-64.50
2024-06-12,05:36:00,19257.5,SELL,3,0.03h,Stop Loss,$-9.00,$-73.50,$63918.50,117,$-73.50
2024-06-12,05:38:00,19259.75,BUY,3,0.02h,Stop Loss,$-9.00,$-82.50,$63909.50,117,$-82.50
2024-06-12,05:39:00,19256.25,SELL,3,0.02h,Stop Loss,$-9.00,$-91.50,$63900.50,117,$-91.50
2024-06-12,05:49:00,19260.5,BUY,3,0.02h,Stop Loss,$-9.00,$-100.50,$63891.50,117,$-100.50
2024-06-12,06:35:00,19267.0,SELL,3,0.02h,Stop Loss,$-9.00,$-109.50,$63882.50,117,$-109.50
2024-06-12,07:33:00,19251.75,BUY,3,0.02h,Stop Loss,$-9.00,$-118.50,$63873.50,117,$-118.50
2024-06-12,08:05:00,19249.0,SELL,3,0.02h,Break Even,$-1.50,$-120.00,$63872.00,117,$-120.00
2024-06-12,08:11:00,19258.0,BUY,3,0.02h,Break Even,$-1.50,$-121.50,$63870.50,117,$-121.50
2024-06-12,08:26:00,19250.75,SELL,3,0.02h,Stop Loss,$-9.00,$-130.50,$63861.50,117,$-130.50
2024-06-12,08:44:00,19255.0,BUY,3,0.07h,Stop Loss,$21.00,$-109.50,$63882.50,117,$-109.50
2024-06-12,10:01:00,19264.5,SELL,3,0.02h,Stop Loss,$-9.00,$-118.50,$63873.50,117,$-118.50
2024-06-12,10:12:00,19268.25,BUY,3,0.03h,Break Even,$-1.50,$-120.00,$63872.00,117,$-120.00
2024-06-12,10:23:00,19264.0,SELL,3,0.02h,Stop Loss,$-9.00,$-129.00,$63863.00,117,$-129.00
2024-06-12,10:38:00,19268.0,BUY,3,0.02h,Break Even,$-1.50,$-130.50,$63861.50,117,$-130.50
2024-06-12,11:02:00,19265.25,SELL,3,0.02h,Stop Loss,$-9.00,$-139.50,$63852.50,117,$-139.50
2024-06-12,11:07:00,19269.5,BUY,3,0.02h,Break Even,$-1.50,$-141.00,$63851.00,117,$-141.00
2024-06-12,11:36:00,19270.75,SELL,3,0.02h,Break Even,$-1.50,$-142.50,$63849.50,117,$-142.50
2024-06-12,12:02:00,19269.75,BUY,3,0.02h,Break Even,$-1.50,$-144.00,$63848.00,117,$-144.00
2024-06-12,12:07:00,19264.25,SELL,3,0.02h,Stop Loss,$-9.00,$-153.00,$63839.00,117,$-153.00
2024-06-12,12:09:00,19271.75,BUY,3,0.02h,Break Even,$-1.50,$-154.50,$63837.50,117,$-154.50
2024-06-12,12:21:00,19270.0,SELL,3,0.02h,Stop Loss,$-9.00,$-163.50,$63828.50,117,$-163.50
2024-06-12,12:30:00,19286.5,BUY,3,0.02h,Stop Loss,$1011.00,$847.50,$64839.50,117,$847.50
2024-06-12,13:24:00,19414.0,SELL,3,0.02h,Stop Loss,$-9.00,$838.50,$64830.50,117,$838.50
2024-06-12,13:35:00,19435.5,BUY,3,0.02h,Break Even,$-1.50,$837.00,$64829.00,117,$837.00
2024-06-12,14:44:00,19510.25,SELL,3,0.02h,Stop Loss,$61.50,$898.50,$64890.50,117,$898.50
2024-06-12,15:07:00,19522.5,BUY,3,0.02h,Break Even,$-1.50,$897.00,$64889.00,117,$897.00
2024-06-12,15:16:00,19503.5,SELL,3,0.02h,Stop Loss,$-9.00,$888.00,$64880.00,117,$888.00
2024-06-12,15:20:00,19523.5,BUY,3,0.02h,Stop Loss,$10.50,$898.50,$64890.50,117,$898.50
2024-06-12,15:45:00,19518.25,SELL,3,0.02h,Stop Loss,$15.00,$913.50,$64905.50,117,$913.50
2024-06-12,16:10:00,19519.75,BUY,3,0.02h,Break Even,$-1.50,$912.00,$64904.00,117,$912.00
2024-06-12,16:13:00,19509.75,SELL,3,0.02h,Stop Loss,$-9.00,$903.00,$64895.00,117,$903.00
2024-06-12,16:45:00,19511.0,BUY,3,0.02h,Stop Loss,$10.50,$913.50,$64905.50,117,$913.50
2024-06-12,16:57:00,19504.5,SELL,3,0.02h,Stop Loss,$-9.00,$904.50,$64896.50,117,$904.50
2024-06-12,17:00:00,19509.5,BUY,3,0.02h,Stop Loss,$13.50,$918.00,$64910.00,117,$918.00
2024-06-12,17:32:00,19505.25,SELL,3,0.02h,Stop Loss,$55.50,$973.50,$64965.50,117,$973.50
2024-06-12,17:56:00,19516.25,BUY,3,0.02h,Break Even,$-1.50,$972.00,$64964.00,117,$972.00
2024-06-12,18:01:00,19488.5,SELL,3,0.02h,Stop Loss,$84.00,$1056.00,$65048.00,117,$1056.00
2024-06-12,18:19:00,19516.0,BUY,3,0.02h,Stop Loss,$13.50,$1069.50,$65061.50,117,$1069.50
2024-06-12,18:36:00,19488.5,SELL,3,0.02h,Stop Loss,$40.50,$1110.00,$65102.00,117,$1110.00
2024-06-12,18:40:00,19540.0,BUY,3,0.02h,Break Even,$-1.50,$1108.50,$65100.50,117,$1108.50
2024-06-12,18:46:00,19495.0,SELL,3,0.02h,Stop Loss,$19.50,$1128.00,$65120.00,117,$1128.00
2024-06-12,18:59:00,19518.5,BUY,3,0.02h,Stop Loss,$31.50,$1159.50,$65151.50,117,$1159.50
2024-06-12,19:26:00,19494.25,SELL,3,0.02h,Stop Loss,$52.50,$1212.00,$65204.00,117,$1212.00
2024-06-12,19:52:00,19498.25,BUY,3,0.02h,Stop Loss,$64.50,$1276.50,$65268.50,117,$1276.50
2024-06-12,20:04:00,19468.25,SELL,3,0.02h,Stop Loss,$7.50,$1284.00,$65276.00,117,$1284.00
2024-06-12,20:16:00,19540.75,BUY,3,0.02h,Stop Loss,$72.00,$1356.00,$65348.00,117,$1356.00
2024-06-12,23:06:00,19583.25,SELL,3,0.02h,Stop Loss,$-9.00,$1347.00,$65339.00,117,$1347.00
2024-06-12,23:12:00,19596.75,BUY,3,0.02h,Break Even,$-1.50,$1345.50,$65337.50,117,$1345.50
2024-06-12,23:40:00,19595.25,SELL,3,0.02h,Stop Loss,$-9.00,$1336.50,$65328.50,117,$1336.50
2024-06-12,23:47:00,19597.25,BUY,3,0.03h,Stop Loss,$-9.00,$1327.50,$65319.50,117,$1327.50
,,,,,,,,,,,
2024-06-13,00:49:00,19613.0,SELL,3,0.02h,Stop Loss,$-9.00,$-9.00,$65310.50,118,$-9.00
2024-06-13,00:59:00,19617.25,BUY,3,0.02h,Stop Loss,$-9.00,$-18.00,$65301.50,118,$-18.00
2024-06-13,01:28:00,19617.75,SELL,3,0.03h,Stop Loss,$-9.00,$-27.00,$65292.50,118,$-27.00
2024-06-13,01:32:00,19622.0,BUY,3,0.02h,Break Even,$-1.50,$-28.50,$65291.00,118,$-28.50
2024-06-13,01:50:00,19619.0,SELL,3,0.02h,Stop Loss,$-9.00,$-37.50,$65282.00,118,$-37.50
2024-06-13,02:01:00,19622.0,BUY,3,0.02h,Stop Loss,$-9.00,$-46.50,$65273.00,118,$-46.50
2024-06-13,02:03:00,19617.5,SELL,3,0.02h,Stop Loss,$-9.00,$-55.50,$65264.00,118,$-55.50
2024-06-13,02:53:00,19616.5,BUY,3,0.02h,Stop Loss,$-9.00,$-64.50,$65255.00,118,$-64.50
2024-06-13,03:21:00,19626.0,SELL,3,0.02h,Stop Loss,$-9.00,$-73.50,$65246.00,118,$-73.50
2024-06-13,03:23:00,19888.25,BUY,3,0.05h,Break Even,$-1.50,$-75.00,$65244.50,118,$-75.00
2024-06-13,03:27:00,19630.25,SELL,3,0.02h,Break Even,$-1.50,$-76.50,$65243.00,118,$-76.50
2024-06-13,03:32:00,19892.5,BUY,3,0.02h,Break Even,$-1.50,$-78.00,$65241.50,118,$-78.00
2024-06-13,03:40:00,19631.5,SELL,3,0.02h,Stop Loss,$-9.00,$-87.00,$65232.50,118,$-87.00
2024-06-13,03:55:00,19896.5,BUY,3,0.02h,Stop Loss,$-9.00,$-96.00,$65223.50,118,$-96.00
2024-06-13,03:56:00,19637.25,SELL,3,0.03h,Stop Loss,$-9.00,$-105.00,$65214.50,118,$-105.00
2024-06-13,03:58:00,19898.0,BUY,3,0.03h,Stop Loss,$-9.00,$-114.00,$65205.50,118,$-114.00
2024-06-13,04:01:00,19635.75,SELL,3,0.02h,Stop Loss,$-9.00,$-123.00,$65196.50,118,$-123.00
2024-06-13,04:02:00,19896.5,BUY,3,0.03h,Stop Loss,$-9.00,$-132.00,$65187.50,118,$-132.00
2024-06-13,04:07:00,19638.0,SELL,3,0.02h,Break Even,$-1.50,$-133.50,$65186.00,118,$-133.50
2024-06-13,04:14:00,19897.25,BUY,3,0.02h,Stop Loss,$-9.00,$-142.50,$65177.00,118,$-142.50
2024-06-13,04:15:00,19637.0,SELL,3,0.05h,Stop Loss,$-9.00,$-151.50,$65168.00,118,$-151.50
2024-06-13,04:18:00,19898.5,BUY,3,0.03h,Stop Loss,$-9.00,$-160.50,$65159.00,118,$-160.50
2024-06-13,04:21:00,19635.25,SELL,3,0.02h,Stop Loss,$-9.00,$-169.50,$65150.00,118,$-169.50
2024-06-13,04:22:00,19896.25,BUY,3,0.05h,Break Even,$-1.50,$-171.00,$65148.50,118,$-171.00
2024-06-13,04:27:00,19634.0,SELL,3,0.02h,Stop Loss,$-9.00,$-180.00,$65139.50,118,$-180.00
2024-06-13,04:28:00,19895.75,BUY,3,0.02h,Stop Loss,$-9.00,$-189.00,$65130.50,118,$-189.00
2024-06-13,04:29:00,19634.75,SELL,3,0.02h,Stop Loss,$-9.00,$-198.00,$65121.50,118,$-198.00
2024-06-13,04:30:00,19894.75,BUY,3,0.02h,Stop Loss,$-9.00,$-207.00,$65112.50,118,$-207.00
2024-06-13,04:31:00,19634.25,SELL,3,0.02h,Stop Loss,$-9.00,$-216.00,$65103.50,118,$-216.00
2024-06-13,04:33:00,19896.25,BUY,3,0.03h,Stop Loss,$-9.00,$-225.00,$65094.50,118,$-225.00
2024-06-13,04:43:00,19632.5,SELL,3,0.02h,Stop Loss,$-9.00,$-234.00,$65085.50,118,$-234.00
2024-06-13,04:44:00,19896.0,BUY,3,0.02h,Stop Loss,$-9.00,$-243.00,$65076.50,118,$-243.00
2024-06-13,04:45:00,19633.75,SELL,3,0.02h,Stop Loss,$-9.00,$-252.00,$65067.50,118,$-252.00
2024-06-13,04:47:00,19898.75,BUY,3,0.02h,Stop Loss,$-9.00,$-261.00,$65058.50,118,$-261.00
2024-06-13,04:48:00,19637.25,SELL,3,0.03h,Stop Loss,$-9.00,$-270.00,$65049.50,118,$-270.00
2024-06-13,04:50:00,19899.0,BUY,3,0.05h,Stop Loss,$-9.00,$-279.00,$65040.50,118,$-279.00
2024-06-13,04:54:00,19639.0,SELL,3,0.02h,Stop Loss,$-9.00,$-288.00,$65031.50,118,$-288.00
2024-06-13,05:00:00,19900.0,BUY,3,0.02h,Stop Loss,$-9.00,$-297.00,$65022.50,118,$-297.00
2024-06-13,05:04:00,19631.25,SELL,3,0.02h,Stop Loss,$-9.00,$-306.00,$65013.50,118,$-306.00
2024-06-13,05:06:00,19892.75,BUY,3,0.03h,Stop Loss,$-9.00,$-315.00,$65004.50,118,$-315.00
2024-06-13,05:10:00,19633.5,SELL,3,0.05h,Stop Loss,$-9.00,$-324.00,$64995.50,118,$-324.00
2024-06-13,05:17:00,19884.75,BUY,3,0.02h,Stop Loss,$-9.00,$-333.00,$64986.50,118,$-333.00
2024-06-13,05:27:00,19623.0,SELL,3,0.02h,Stop Loss,$-9.00,$-342.00,$64977.50,118,$-342.00
2024-06-13,05:30:00,19885.25,BUY,3,0.02h,Stop Loss,$-9.00,$-351.00,$64968.50,118,$-351.00
2024-06-13,05:31:00,19622.0,SELL,3,0.02h,Stop Loss,$-9.00,$-360.00,$64959.50,118,$-360.00
2024-06-13,05:32:00,19882.0,BUY,3,0.02h,Stop Loss,$-9.00,$-369.00,$64950.50,118,$-369.00
2024-06-13,05:33:00,19622.0,SELL,3,0.03h,Stop Loss,$-9.00,$-378.00,$64941.50,118,$-378.00
2024-06-13,05:39:00,19887.5,BUY,3,0.02h,Stop Loss,$-9.00,$-387.00,$64932.50,118,$-387.00
2024-06-13,05:40:00,19626.25,SELL,3,0.02h,Stop Loss,$-9.00,$-396.00,$64923.50,118,$-396.00
2024-06-13,05:45:00,19886.5,BUY,3,0.02h,Stop Loss,$-9.00,$-405.00,$64914.50,118,$-405.00
2024-06-13,05:47:00,19626.5,SELL,3,0.02h,Stop Loss,$-9.00,$-414.00,$64905.50,118,$-414.00
2024-06-13,05:48:00,19888.25,BUY,3,0.02h,Stop Loss,$-9.00,$-423.00,$64896.50,118,$-423.00
2024-06-13,05:52:00,19624.5,SELL,3,0.02h,Stop Loss,$-9.00,$-432.00,$64887.50,118,$-432.00
2024-06-13,05:53:00,19888.75,BUY,3,0.03h,Stop Loss,$-9.00,$-441.00,$64878.50,118,$-441.00
2024-06-13,06:02:00,19626.75,SELL,3,0.02h,Stop Loss,$10.50,$-430.50,$64889.00,118,$-430.50
2024-06-13,06:10:00,19889.0,BUY,3,0.08h,Break Even,$-1.50,$-432.00,$64887.50,118,$-432.00
2024-06-13,06:22:00,19632.75,SELL,3,0.02h,Stop Loss,$-9.00,$-441.00,$64878.50,118,$-441.00
2024-06-13,06:23:00,19895.25,BUY,3,0.02h,Stop Loss,$-9.00,$-450.00,$64869.50,118,$-450.00
2024-06-13,06:24:00,19633.5,SELL,3,0.02h,Stop Loss,$-9.00,$-459.00,$64860.50,118,$-459.00
2024-06-13,06:25:00,19894.0,BUY,3,0.02h,Stop Loss,$-9.00,$-468.00,$64851.50,118,$-468.00
2024-06-13,06:27:00,19631.25,SELL,3,0.02h,Stop Loss,$-9.00,$-477.00,$64842.50,118,$-477.00
2024-06-13,06:32:00,19896.25,BUY,3,0.02h,Stop Loss,$-9.00,$-486.00,$64833.50,118,$-486.00
2024-06-13,06:44:00,19646.0,SELL,3,0.02h,Stop Loss,$-9.00,$-495.00,$64824.50,118,$-495.00
2024-06-13,06:45:00,19907.75,BUY,3,0.02h,Stop Loss,$-9.00,$-504.00,$64815.50,118,$-504.00
2024-06-13,06:47:00,19644.0,SELL,3,0.02h,Stop Loss,$-9.00,$-513.00,$64806.50,118,$-513.00
2024-06-13,06:48:00,19908.75,BUY,3,0.02h,Stop Loss,$-9.00,$-522.00,$64797.50,118,$-522.00
2024-06-13,06:49:00,19647.25,SELL,3,0.02h,Stop Loss,$-9.00,$-531.00,$64788.50,118,$-531.00
2024-06-13,06:53:00,19912.25,BUY,3,0.02h,Stop Loss,$-9.00,$-540.00,$64779.50,118,$-540.00
2024-06-13,06:55:00,19650.75,SELL,3,0.02h,Stop Loss,$-9.00,$-549.00,$64770.50,118,$-549.00
2024-06-13,06:57:00,19909.75,BUY,3,0.02h,Stop Loss,$-9.00,$-558.00,$64761.50,118,$-558.00
2024-06-13,06:58:00,19649.75,SELL,3,0.02h,Break Even,$-1.50,$-559.50,$64760.00,118,$-559.50
2024-06-13,07:02:00,19907.5,BUY,3,0.02h,Stop Loss,$-9.00,$-568.50,$64751.00,118,$-568.50
2024-06-13,07:03:00,19644.0,SELL,3,0.02h,Stop Loss,$-9.00,$-577.50,$64742.00,118,$-577.50
2024-06-13,07:04:00,19908.25,BUY,3,0.03h,Break Even,$-1.50,$-579.00,$64740.50,118,$-579.00
2024-06-13,07:06:00,19645.75,SELL,3,0.02h,Break Even,$-1.50,$-580.50,$64739.00,118,$-580.50
2024-06-13,07:12:00,19924.5,BUY,3,0.02h,Stop Loss,$-9.00,$-589.50,$64730.00,118,$-589.50
2024-06-13,07:22:00,19666.0,SELL,3,0.02h,Stop Loss,$-9.00,$-598.50,$64721.00,118,$-598.50
2024-06-13,07:26:00,19931.0,BUY,3,0.02h,Stop Loss,$-9.00,$-607.50,$64712.00,118,$-607.50
2024-06-13,07:28:00,19665.0,SELL,3,0.02h,Stop Loss,$-9.00,$-616.50,$64703.00,118,$-616.50
2024-06-13,07:29:00,19923.75,BUY,3,0.02h,Stop Loss,$4.50,$-612.00,$64707.50,118,$-612.00
2024-06-13,07:31:00,19661.75,SELL,3,0.02h,Stop Loss,$-9.00,$-621.00,$64698.50,118,$-621.00
2024-06-13,07:32:00,19924.25,BUY,3,0.02h,Break Even,$-1.50,$-622.50,$64697.00,118,$-622.50
2024-06-13,07:34:00,19660.5,SELL,3,0.02h,Stop Loss,$-9.00,$-631.50,$64688.00,118,$-631.50
2024-06-13,07:35:00,19926.0,BUY,3,0.02h,Stop Loss,$-9.00,$-640.50,$64679.00,118,$-640.50
2024-06-13,07:39:00,19639.5,SELL,3,0.02h,Break Even,$-1.50,$-642.00,$64677.50,118,$-642.00
2024-06-13,07:48:00,19911.5,BUY,3,0.02h,Stop Loss,$-9.00,$-651.00,$64668.50,118,$-651.00
2024-06-13,07:49:00,19649.25,SELL,3,0.02h,Stop Loss,$-9.00,$-660.00,$64659.50,118,$-660.00
2024-06-13,07:56:00,19915.75,BUY,3,0.02h,Break Even,$-1.50,$-661.50,$64658.00,118,$-661.50
2024-06-13,08:00:00,19655.0,SELL,3,0.02h,Stop Loss,$4.50,$-657.00,$64662.50,118,$-657.00
2024-06-13,08:04:00,19920.75,BUY,3,0.03h,Stop Loss,$7.50,$-649.50,$64670.00,118,$-649.50
2024-06-13,08:21:00,19637.75,SELL,3,0.02h,Break Even,$-1.50,$-651.00,$64668.50,118,$-651.00
2024-06-13,08:25:00,19902.5,BUY,3,0.03h,Break Even,$-1.50,$-652.50,$64667.00,118,$-652.50
2024-06-13,08:27:00,19640.5,SELL,3,0.02h,Stop Loss,$-9.00,$-661.50,$64658.00,118,$-661.50
2024-06-13,08:29:00,19906.75,BUY,3,0.02h,Stop Loss,$-9.00,$-670.50,$64649.00,118,$-670.50
2024-06-13,08:31:00,19635.25,SELL,3,0.02h,Stop Loss,$-9.00,$-679.50,$64640.00,118,$-679.50
2024-06-13,08:37:00,19909.25,BUY,3,0.02h,Stop Loss,$-9.00,$-688.50,$64631.00,118,$-688.50
2024-06-13,08:38:00,19640.5,SELL,3,0.02h,Break Even,$-1.50,$-690.00,$64629.50,118,$-690.00
2024-06-13,08:45:00,19902.0,BUY,3,0.02h,Stop Loss,$-9.00,$-699.00,$64620.50,118,$-699.00
2024-06-13,08:47:00,19628.5,SELL,3,0.02h,Stop Loss,$-9.00,$-708.00,$64611.50,118,$-708.00
2024-06-13,08:48:00,19899.25,BUY,3,0.02h,Stop Loss,$-9.00,$-717.00,$64602.50,118,$-717.00
2024-06-13,08:50:00,19632.5,SELL,3,0.02h,Break Even,$-1.50,$-718.50,$64601.00,118,$-718.50
2024-06-13,09:00:00,19905.25,BUY,3,0.02h,Stop Loss,$-9.00,$-727.50,$64592.00,118,$-727.50
2024-06-13,09:01:00,19643.0,SELL,3,0.02h,Break Even,$-1.50,$-729.00,$64590.50,118,$-729.00
2024-06-13,09:08:00,19909.5,BUY,3,0.02h,Stop Loss,$-9.00,$-738.00,$64581.50,118,$-738.00
2024-06-13,09:13:00,19639.25,SELL,3,0.02h,Break Even,$-1.50,$-739.50,$64580.00,118,$-739.50
2024-06-13,09:15:00,19903.75,BUY,3,0.02h,Stop Loss,$-9.00,$-748.50,$64571.00,118,$-748.50
2024-06-13,09:22:00,19631.5,SELL,3,0.02h,Break Even,$-1.50,$-750.00,$64569.50,118,$-750.00
2024-06-13,09:25:00,19892.25,BUY,3,0.02h,Stop Loss,$-9.00,$-759.00,$64560.50,118,$-759.00
2024-06-13,09:33:00,19618.0,SELL,3,0.02h,Break Even,$-1.50,$-760.50,$64559.00,118,$-760.50
2024-06-13,09:42:00,19862.75,BUY,3,0.02h,Stop Loss,$-9.00,$-769.50,$64550.00,118,$-769.50
2024-06-13,09:45:00,19593.5,SELL,3,0.02h,Break Even,$-1.50,$-771.00,$64548.50,118,$-771.00
2024-06-13,09:56:00,19857.75,BUY,3,0.02h,Stop Loss,$-9.00,$-780.00,$64539.50,118,$-780.00
2024-06-13,10:10:00,19603.5,SELL,3,0.02h,Stop Loss,$-9.00,$-789.00,$64530.50,118,$-789.00
2024-06-13,10:13:00,19868.75,BUY,3,0.02h,Stop Loss,$-9.00,$-798.00,$64521.50,118,$-798.00
2024-06-13,10:14:00,19604.25,SELL,3,0.02h,Stop Loss,$-9.00,$-807.00,$64512.50,118,$-807.00
2024-06-13,10:15:00,19868.25,BUY,3,0.02h,Stop Loss,$-9.00,$-816.00,$64503.50,118,$-816.00
2024-06-13,10:16:00,19602.5,SELL,3,0.02h,Stop Loss,$-9.00,$-825.00,$64494.50,118,$-825.00
2024-06-13,10:17:00,19866.25,BUY,3,0.02h,Stop Loss,$-9.00,$-834.00,$64485.50,118,$-834.00
2024-06-13,10:19:00,19592.5,SELL,3,0.02h,Stop Loss,$-9.00,$-843.00,$64476.50,118,$-843.00
2024-06-13,10:20:00,19853.5,BUY,3,0.02h,Stop Loss,$-9.00,$-852.00,$64467.50,118,$-852.00
2024-06-13,10:21:00,19597.25,SELL,3,0.02h,Break Even,$-1.50,$-853.50,$64466.00,118,$-853.50
2024-06-13,10:24:00,19862.5,BUY,3,0.03h,Break Even,$-1.50,$-855.00,$64464.50,118,$-855.00
2024-06-13,10:28:00,19608.5,SELL,3,0.02h,Stop Loss,$-9.00,$-864.00,$64455.50,118,$-864.00
2024-06-13,10:29:00,19875.5,BUY,3,0.02h,Stop Loss,$-9.00,$-873.00,$64446.50,118,$-873.00
2024-06-13,10:30:00,19611.25,SELL,3,0.02h,Stop Loss,$-9.00,$-882.00,$64437.50,118,$-882.00
2024-06-13,10:31:00,19871.25,BUY,3,0.02h,Break Even,$-1.50,$-883.50,$64436.00,118,$-883.50
2024-06-13,10:44:00,19608.0,SELL,3,0.02h,Break Even,$-1.50,$-885.00,$64434.50,118,$-885.00
2024-06-13,10:51:00,19863.0,BUY,3,0.02h,Stop Loss,$9.00,$-876.00,$64443.50,118,$-876.00
2024-06-13,10:54:00,19607.5,SELL,3,0.02h,Stop Loss,$-9.00,$-885.00,$64434.50,118,$-885.00
2024-06-13,10:55:00,19874.25,BUY,3,0.02h,Stop Loss,$-9.00,$-894.00,$64425.50,118,$-894.00
2024-06-13,10:56:00,19614.75,SELL,3,0.02h,Stop Loss,$-9.00,$-903.00,$64416.50,118,$-903.00
2024-06-13,11:05:00,19881.0,BUY,3,0.02h,Stop Loss,$-9.00,$-912.00,$64407.50,118,$-912.00
2024-06-13,11:06:00,19616.25,SELL,3,0.02h,Stop Loss,$-9.00,$-921.00,$64398.50,118,$-921.00
2024-06-13,11:10:00,19878.0,BUY,3,0.02h,Stop Loss,$-9.00,$-930.00,$64389.50,118,$-930.00
2024-06-13,11:11:00,19614.75,SELL,3,0.02h,Stop Loss,$-9.00,$-939.00,$64380.50,118,$-939.00
2024-06-13,11:12:00,19880.25,BUY,3,0.02h,Stop Loss,$24.00,$-915.00,$64404.50,118,$-915.00
2024-06-13,11:25:00,19618.0,SELL,3,0.02h,Break Even,$-1.50,$-916.50,$64403.00,118,$-916.50
2024-06-13,11:29:00,19878.5,BUY,3,0.02h,Stop Loss,$-9.00,$-925.50,$64394.00,118,$-925.50
2024-06-13,11:30:00,19616.75,SELL,3,0.02h,Stop Loss,$-9.00,$-934.50,$64385.00,118,$-934.50
2024-06-13,11:31:00,19875.0,BUY,3,0.05h,Stop Loss,$9.00,$-925.50,$64394.00,118,$-925.50
2024-06-13,11:34:00,19611.75,SELL,3,0.02h,Stop Loss,$-9.00,$-934.50,$64385.00,118,$-934.50
2024-06-13,11:35:00,19876.75,BUY,3,0.02h,Break Even,$-1.50,$-936.00,$64383.50,118,$-936.00
2024-06-13,11:37:00,19621.0,SELL,3,0.02h,Stop Loss,$-9.00,$-945.00,$64374.50,118,$-945.00
2024-06-13,11:38:00,19883.5,BUY,3,0.02h,Break Even,$-1.50,$-946.50,$64373.00,118,$-946.50
2024-06-13,11:41:00,19616.75,SELL,3,0.02h,Break Even,$-1.50,$-948.00,$64371.50,118,$-948.00
2024-06-13,11:58:00,19870.75,BUY,3,0.02h,Stop Loss,$-9.00,$-957.00,$64362.50,118,$-957.00
2024-06-13,11:59:00,19608.5,SELL,3,0.02h,Stop Loss,$-9.00,$-966.00,$64353.50,118,$-966.00
2024-06-13,12:00:00,19873.25,BUY,3,0.02h,Stop Loss,$-9.00,$-975.00,$64344.50,118,$-975.00
2024-06-13,12:11:00,19620.75,SELL,3,0.02h,Stop Loss,$-9.00,$-984.00,$64335.50,118,$-984.00
2024-06-13,12:12:00,19886.25,BUY,3,0.02h,Stop Loss,$-9.00,$-993.00,$64326.50,118,$-993.00
2024-06-13,12:13:00,19632.25,SELL,3,0.02h,Stop Loss,$-9.00,$-1002.00,$64317.50,118,$-1002.00
2024-06-13,12:14:00,19899.75,BUY,3,0.02h,Stop Loss,$-9.00,$-1011.00,$64308.50,118,$-1011.00
2024-06-13,12:15:00,19640.5,SELL,3,0.02h,Stop Loss,$12.00,$-999.00,$64320.50,118,$-999.00
2024-06-13,12:22:00,19900.5,BUY,3,0.02h,Stop Loss,$-9.00,$-1008.00,$64311.50,118,$-1008.00
2024-06-13,12:33:00,19683.0,SELL,3,0.02h,Stop Loss,$61.50,$-946.50,$64373.00,118,$-946.50
2024-06-13,12:43:00,19904.75,BUY,3,0.02h,Stop Loss,$-9.00,$-955.50,$64364.00,118,$-955.50
2024-06-13,12:44:00,19633.0,SELL,3,0.02h,Stop Loss,$-9.00,$-964.50,$64355.00,118,$-964.50
2024-06-13,12:45:00,19899.5,BUY,3,0.02h,Break Even,$-1.50,$-966.00,$64353.50,118,$-966.00
2024-06-13,12:53:00,19631.5,SELL,3,0.02h,Stop Loss,$-9.00,$-975.00,$64344.50,118,$-975.00
2024-06-13,12:54:00,19892.5,BUY,3,0.02h,Stop Loss,$-9.00,$-984.00,$64335.50,118,$-984.00
2024-06-13,12:55:00,19638.5,SELL,3,0.02h,Stop Loss,$30.00,$-954.00,$64365.50,118,$-954.00
2024-06-13,13:05:00,19882.75,BUY,3,0.02h,Stop Loss,$-9.00,$-963.00,$64356.50,118,$-963.00
2024-06-13,13:06:00,19620.5,SELL,3,0.02h,Break Even,$-1.50,$-964.50,$64355.00,118,$-964.50
2024-06-13,13:08:00,19886.5,BUY,3,0.02h,Stop Loss,$-9.00,$-973.50,$64346.00,118,$-973.50
2024-06-13,13:13:00,19625.75,SELL,3,0.02h,Stop Loss,$-9.00,$-982.50,$64337.00,118,$-982.50
2024-06-13,13:21:00,19896.5,BUY,3,0.02h,Stop Loss,$-9.00,$-991.50,$64328.00,118,$-991.50
2024-06-13,13:26:00,19640.25,SELL,3,0.02h,Stop Loss,$-9.00,$-1000.50,$64319.00,118,$-1000.50
2024-06-13,13:27:00,19900.5,BUY,3,0.02h,Stop Loss,$-9.00,$-1009.50,$64310.00,118,$-1009.50
2024-06-13,13:43:00,19639.0,SELL,3,0.02h,Break Even,$-1.50,$-1011.00,$64308.50,118,$-1011.00
2024-06-13,13:46:00,19905.5,BUY,3,0.02h,Stop Loss,$-9.00,$-1020.00,$64299.50,118,$-1020.00
2024-06-13,13:47:00,19641.0,SELL,3,0.02h,Stop Loss,$-9.00,$-1029.00,$64290.50,118,$-1029.00
2024-06-13,13:48:00,19911.0,BUY,3,0.02h,Stop Loss,$-9.00,$-1038.00,$64281.50,118,$-1038.00
2024-06-13,13:49:00,19647.25,SELL,3,0.02h,Stop Loss,$-9.00,$-1047.00,$64272.50,118,$-1047.00
2024-06-13,13:50:00,19915.0,BUY,3,0.02h,Stop Loss,$21.00,$-1026.00,$64293.50,118,$-1026.00
2024-06-13,13:52:00,19637.5,SELL,3,0.02h,Stop Loss,$-9.00,$-1035.00,$64284.50,118,$-1035.00
2024-06-13,13:53:00,19901.25,BUY,3,0.02h,Stop Loss,$-9.00,$-1044.00,$64275.50,118,$-1044.00
2024-06-13,13:54:00,19633.75,SELL,3,0.02h,Stop Loss,$6.00,$-1038.00,$64281.50,118,$-1038.00
2024-06-13,13:57:00,19898.0,BUY,3,0.02h,Stop Loss,$-9.00,$-1047.00,$64272.50,118,$-1047.00
2024-06-13,13:58:00,19622.75,SELL,3,0.02h,Stop Loss,$22.50,$-1024.50,$64295.00,118,$-1024.50
2024-06-13,14:06:00,19895.25,BUY,3,0.02h,Stop Loss,$25.50,$-999.00,$64320.50,118,$-999.00
2024-06-13,14:12:00,19606.25,SELL,3,0.02h,Stop Loss,$-9.00,$-1008.00,$64311.50,118,$-1008.00
2024-06-13,14:13:00,19866.0,BUY,3,0.02h,Stop Loss,$9.00,$-999.00,$64320.50,118,$-999.00
2024-06-13,14:15:00,19586.25,SELL,3,0.02h,Stop Loss,$-9.00,$-1008.00,$64311.50,118,$-1008.00
2024-06-13,14:16:00,19854.5,BUY,3,0.02h,Break Even,$-1.50,$-1009.50,$64310.00,118,$-1009.50
2024-06-13,14:18:00,19582.25,SELL,3,0.02h,Stop Loss,$15.00,$-994.50,$64325.00,118,$-994.50
2024-06-13,14:31:00,19843.5,BUY,3,0.02h,Break Even,$-1.50,$-996.00,$64323.50,118,$-996.00
2024-06-13,14:43:00,19582.5,SELL,3,0.02h,Stop Loss,$-9.00,$-1005.00,$64314.50,118,$-1005.00
2024-06-13,14:51:00,19842.0,BUY,3,0.02h,Stop Loss,$-9.00,$-1014.00,$64305.50,118,$-1014.00
2024-06-13,14:53:00,19566.5,SELL,3,0.02h,Break Even,$-1.50,$-1015.50,$64304.00,118,$-1015.50
2024-06-13,14:56:00,19830.5,BUY,3,0.02h,Break Even,$-1.50,$-1017.00,$64302.50,118,$-1017.00
2024-06-13,14:59:00,19556.0,SELL,3,0.02h,Stop Loss,$-9.00,$-1026.00,$64293.50,118,$-1026.00
2024-06-13,15:00:00,19815.5,BUY,3,0.02h,Stop Loss,$-9.00,$-1035.00,$64284.50,118,$-1035.00
2024-06-13,15:01:00,19565.0,SELL,3,0.02h,Break Even,$-1.50,$-1036.50,$64283.00,118,$-1036.50
2024-06-13,15:11:00,19850.0,BUY,3,0.02h,Stop Loss,$-9.00,$-1045.50,$64274.00,118,$-1045.50
2024-06-13,15:12:00,19590.5,SELL,3,0.02h,Stop Loss,$15.00,$-1030.50,$64289.00,118,$-1030.50
2024-06-13,15:26:00,19832.5,BUY,3,0.02h,Stop Loss,$-9.00,$-1039.50,$64280.00,118,$-1039.50
2024-06-13,15:27:00,19575.25,SELL,3,0.02h,Break Even,$-1.50,$-1041.00,$64278.50,118,$-1041.00
2024-06-13,15:30:00,19840.0,BUY,3,0.02h,Stop Loss,$36.00,$-1005.00,$64314.50,118,$-1005.00
2024-06-13,15:49:00,19599.25,SELL,3,0.02h,Stop Loss,$-9.00,$-1014.00,$64305.50,118,$-1014.00
2024-06-13,15:58:00,19854.25,BUY,3,0.02h,Break Even,$-1.50,$-1015.50,$64304.00,118,$-1015.50
2024-06-13,16:03:00,19560.25,SELL,3,0.02h,Stop Loss,$34.50,$-981.00,$64338.50,118,$-981.00
2024-06-13,16:06:00,19831.0,BUY,3,0.02h,Stop Loss,$16.50,$-964.50,$64355.00,118,$-964.50
2024-06-13,16:17:00,19542.0,SELL,3,0.02h,Stop Loss,$-9.00,$-973.50,$64346.00,118,$-973.50
2024-06-13,16:29:00,19768.5,BUY,3,0.02h,Break Even,$-1.50,$-975.00,$64344.50,118,$-975.00
2024-06-13,16:31:00,19517.5,SELL,3,0.02h,Break Even,$-1.50,$-976.50,$64343.00,118,$-976.50
2024-06-13,16:33:00,19794.75,BUY,3,0.02h,Stop Loss,$15.00,$-961.50,$64358.00,118,$-961.50
2024-06-13,16:38:00,19533.75,SELL,3,0.02h,Break Even,$-1.50,$-963.00,$64356.50,118,$-963.00
2024-06-13,16:45:00,19805.25,BUY,3,0.02h,Stop Loss,$-9.00,$-972.00,$64347.50,118,$-972.00
2024-06-13,16:46:00,19534.0,SELL,3,0.02h,Stop Loss,$-9.00,$-981.00,$64338.50,118,$-981.00
2024-06-13,16:47:00,19782.25,BUY,3,0.02h,Stop Loss,$-9.00,$-990.00,$64329.50,118,$-990.00
2024-06-13,16:57:00,19545.0,SELL,3,0.02h,Stop Loss,$19.50,$-970.50,$64349.00,118,$-970.50
2024-06-13,17:18:00,19827.25,BUY,3,0.02h,Stop Loss,$-9.00,$-979.50,$64340.00,118,$-979.50
2024-06-13,17:20:00,19563.0,SELL,3,0.02h,Stop Loss,$-9.00,$-988.50,$64331.00,118,$-988.50
2024-06-13,17:21:00,19823.0,BUY,3,0.02h,Stop Loss,$-9.00,$-997.50,$64322.00,118,$-997.50
2024-06-13,17:24:00,19565.25,SELL,3,0.02h,Stop Loss,$-9.00,$-1006.50,$64313.00,118,$-1006.50
2024-06-13,17:25:00,19830.75,BUY,3,0.02h,Stop Loss,$-9.00,$-1015.50,$64304.00,118,$-1015.50
2024-06-13,17:31:00,19569.75,SELL,3,0.02h,Break Even,$-1.50,$-1017.00,$64302.50,118,$-1017.00
2024-06-13,17:38:00,19813.75,BUY,3,0.02h,Stop Loss,$16.50,$-1000.50,$64319.00,118,$-1000.50
2024-06-13,17:44:00,19576.75,SELL,3,0.02h,Stop Loss,$-9.00,$-1009.50,$64310.00,118,$-1009.50
2024-06-13,17:45:00,19839.5,BUY,3,0.02h,Break Even,$-1.50,$-1011.00,$64308.50,118,$-1011.00
2024-06-13,18:15:00,19584.25,SELL,3,0.02h,Stop Loss,$-9.00,$-1020.00,$64299.50,118,$-1020.00
2024-06-13,18:16:00,19846.25,BUY,3,0.02h,Stop Loss,$6.00,$-1014.00,$64305.50,118,$-1014.00
2024-06-13,18:18:00,19589.75,SELL,3,0.02h,Stop Loss,$-9.00,$-1023.00,$64296.50,118,$-1023.00
2024-06-13,18:27:00,19843.25,BUY,3,0.02h,Stop Loss,$-9.00,$-1032.00,$64287.50,118,$-1032.00
2024-06-13,18:28:00,19583.75,SELL,3,0.02h,Break Even,$-1.50,$-1033.50,$64286.00,118,$-1033.50
2024-06-13,18:46:00,19858.75,BUY,3,0.02h,Stop Loss,$-9.00,$-1042.50,$64277.00,118,$-1042.50
2024-06-13,18:47:00,19596.75,SELL,3,0.02h,Stop Loss,$-9.00,$-1051.50,$64268.00,118,$-1051.50
2024-06-13,18:48:00,19854.0,BUY,3,0.02h,Stop Loss,$-9.00,$-1060.50,$64259.00,118,$-1060.50
2024-06-13,18:58:00,19602.75,SELL,3,0.02h,Break Even,$-1.50,$-1062.00,$64257.50,118,$-1062.00
2024-06-13,19:00:00,19861.0,BUY,3,0.02h,Stop Loss,$-9.00,$-1071.00,$64248.50,118,$-1071.00
2024-06-13,19:04:00,19603.75,SELL,3,0.02h,Break Even,$-1.50,$-1072.50,$64247.00,118,$-1072.50
2024-06-13,19:07:00,19868.0,BUY,3,0.02h,Stop Loss,$-9.00,$-1081.50,$64238.00,118,$-1081.50
2024-06-13,19:08:00,19614.0,SELL,3,0.02h,Stop Loss,$-9.00,$-1090.50,$64229.00,118,$-1090.50
2024-06-13,19:09:00,19876.0,BUY,3,0.02h,Break Even,$-1.50,$-1092.00,$64227.50,118,$-1092.00
2024-06-13,19:13:00,19603.25,SELL,3,0.02h,Stop Loss,$-9.00,$-1101.00,$64218.50,118,$-1101.00
2024-06-13,19:14:00,19864.25,BUY,3,0.02h,Stop Loss,$-9.00,$-1110.00,$64209.50,118,$-1110.00
2024-06-13,19:15:00,19595.5,SELL,3,0.02h,Stop Loss,$-9.00,$-1119.00,$64200.50,118,$-1119.00
2024-06-13,19:16:00,19850.5,BUY,3,0.02h,Break Even,$-1.50,$-1120.50,$64199.00,118,$-1120.50
2024-06-13,19:24:00,19606.75,SELL,3,0.02h,Stop Loss,$-9.00,$-1129.50,$64190.00,118,$-1129.50
2024-06-13,19:25:00,19864.5,BUY,3,0.02h,Stop Loss,$3.00,$-1126.50,$64193.00,118,$-1126.50
2024-06-13,19:29:00,19608.5,SELL,3,0.02h,Stop Loss,$-9.00,$-1135.50,$64184.00,118,$-1135.50
2024-06-13,19:30:00,19863.25,BUY,3,0.02h,Break Even,$-1.50,$-1137.00,$64182.50,118,$-1137.00
2024-06-13,19:32:00,19592.25,SELL,3,0.02h,Break Even,$-1.50,$-1138.50,$64181.00,118,$-1138.50
2024-06-13,19:35:00,19860.0,BUY,3,0.02h,Stop Loss,$-9.00,$-1147.50,$64172.00,118,$-1147.50
2024-06-13,19:37:00,19597.0,SELL,3,0.02h,Break Even,$-1.50,$-1149.00,$64170.50,118,$-1149.00
2024-06-13,19:41:00,19869.75,BUY,3,0.02h,Stop Loss,$-9.00,$-1158.00,$64161.50,118,$-1158.00
2024-06-13,19:42:00,19605.5,SELL,3,0.02h,Stop Loss,$-9.00,$-1167.00,$64152.50,118,$-1167.00
2024-06-13,19:43:00,19864.75,BUY,3,0.02h,Stop Loss,$-9.00,$-1176.00,$64143.50,118,$-1176.00
2024-06-13,19:44:00,19603.25,SELL,3,0.02h,Stop Loss,$-9.00,$-1185.00,$64134.50,118,$-1185.00
2024-06-13,19:45:00,19865.5,BUY,3,0.02h,Break Even,$-1.50,$-1186.50,$64133.00,118,$-1186.50
2024-06-13,19:58:00,19625.75,SELL,3,0.02h,Stop Loss,$19.50,$-1167.00,$64152.50,118,$-1167.00
2024-06-13,20:21:00,19872.75,BUY,3,0.03h,Break Even,$-1.50,$-1168.50,$64151.00,118,$-1168.50
2024-06-13,20:32:00,19612.75,SELL,3,0.02h,Break Even,$-1.50,$-1170.00,$64149.50,118,$-1170.00
2024-06-13,20:34:00,19873.25,BUY,3,0.02h,Stop Loss,$-9.00,$-1179.00,$64140.50,118,$-1179.00
2024-06-13,20:40:00,19603.0,SELL,3,0.02h,Stop Loss,$13.50,$-1165.50,$64154.00,118,$-1165.50
2024-06-13,20:45:00,19859.5,BUY,3,0.02h,Stop Loss,$-9.00,$-1174.50,$64145.00,118,$-1174.50
2024-06-13,20:46:00,19595.25,SELL,3,0.02h,Stop Loss,$-9.00,$-1183.50,$64136.00,118,$-1183.50
2024-06-13,20:52:00,19859.25,BUY,3,0.03h,Break Even,$-1.50,$-1185.00,$64134.50,118,$-1185.00
2024-06-13,20:56:00,19600.5,SELL,3,0.02h,Stop Loss,$-9.00,$-1194.00,$64125.50,118,$-1194.00
2024-06-13,20:57:00,19862.75,BUY,3,0.02h,Stop Loss,$-9.00,$-1203.00,$64116.50,118,$-1203.00
2024-06-13,20:58:00,19606.5,SELL,3,0.02h,Stop Loss,$-9.00,$-1212.00,$64107.50,118,$-1212.00
2024-06-13,20:59:00,19868.0,BUY,3,0.02h,Break Even,$-1.50,$-1213.50,$64106.00,118,$-1213.50
2024-06-13,23:01:00,19611.25,SELL,3,0.02h,Break Even,$-1.50,$-1215.00,$64104.50,118,$-1215.00
2024-06-13,23:07:00,19869.25,BUY,3,0.03h,Stop Loss,$-9.00,$-1224.00,$64095.50,118,$-1224.00
2024-06-13,23:18:00,19609.25,SELL,3,0.02h,Stop Loss,$-9.00,$-1233.00,$64086.50,118,$-1233.00
2024-06-13,23:19:00,19872.0,BUY,3,0.02h,Stop Loss,$-9.00,$-1242.00,$64077.50,118,$-1242.00
2024-06-13,23:20:00,19612.0,SELL,3,0.02h,Stop Loss,$-9.00,$-1251.00,$64068.50,118,$-1251.00
2024-06-13,23:32:00,19875.0,BUY,3,0.02h,Stop Loss,$-9.00,$-1260.00,$64059.50,118,$-1260.00
2024-06-13,23:33:00,19614.0,SELL,3,0.02h,Stop Loss,$-9.00,$-1269.00,$64050.50,118,$-1269.00
2024-06-13,23:34:00,19876.25,BUY,3,0.02h,Stop Loss,$-9.00,$-1278.00,$64041.50,118,$-1278.00
2024-06-13,23:54:00,19616.5,SELL,3,0.02h,Stop Loss,$-9.00,$-1287.00,$64032.50,118,$-1287.00
2024-06-13,23:55:00,19878.75,BUY,3,0.05h,Break Even,$-1.50,$-1288.50,$64031.00,118,$-1288.50
,,,,,,,,,,,
2024-06-14,00:00:00,19618.5,SELL,3,0.02h,Stop Loss,$-9.00,$-9.00,$64022.00,119,$-9.00
2024-06-14,00:01:00,19877.5,BUY,3,0.02h,Stop Loss,$12.00,$3.00,$64034.00,119,$3.00
2024-06-14,00:05:00,19623.25,SELL,3,0.02h,Stop Loss,$-9.00,$-6.00,$64025.00,119,$-6.00
2024-06-14,00:07:00,19882.0,BUY,3,0.02h,Stop Loss,$-9.00,$-15.00,$64016.00,119,$-15.00
2024-06-14,00:08:00,19621.25,SELL,3,0.02h,Break Even,$-1.50,$-16.50,$64014.50,119,$-16.50
2024-06-14,00:19:00,19877.0,BUY,3,0.02h,Stop Loss,$-9.00,$-25.50,$64005.50,119,$-25.50
2024-06-14,00:20:00,19617.25,SELL,3,0.02h,Stop Loss,$-9.00,$-34.50,$63996.50,119,$-34.50
2024-06-14,00:21:00,19881.0,BUY,3,0.02h,Stop Loss,$-9.00,$-43.50,$63987.50,119,$-43.50
2024-06-14,00:22:00,19620.75,SELL,3,0.02h,Stop Loss,$-9.00,$-52.50,$63978.50,119,$-52.50
2024-06-14,00:36:00,19880.25,BUY,3,0.02h,Stop Loss,$-9.00,$-61.50,$63969.50,119,$-61.50
2024-06-14,00:37:00,19617.5,SELL,3,0.02h,Stop Loss,$-9.00,$-70.50,$63960.50,119,$-70.50
2024-06-14,00:38:00,19880.75,BUY,3,0.03h,Stop Loss,$-9.00,$-79.50,$63951.50,119,$-79.50
2024-06-14,00:56:00,19617.5,SELL,3,0.07h,Break Even,$-1.50,$-81.00,$63950.00,119,$-81.00
2024-06-14,01:03:00,19877.0,BUY,3,0.02h,Stop Loss,$-9.00,$-90.00,$63941.00,119,$-90.00
2024-06-14,01:05:00,19614.0,SELL,3,0.02h,Stop Loss,$-9.00,$-99.00,$63932.00,119,$-99.00
2024-06-14,01:07:00,19875.75,BUY,3,0.02h,Stop Loss,$-9.00,$-108.00,$63923.00,119,$-108.00
2024-06-14,01:22:00,19616.0,SELL,3,0.02h,Stop Loss,$-9.00,$-117.00,$63914.00,119,$-117.00
2024-06-14,01:23:00,19875.25,BUY,3,0.17h,Stop Loss,$13.50,$-103.50,$63927.50,119,$-103.50
2024-06-14,01:33:00,19619.5,SELL,3,0.05h,Break Even,$-1.50,$-105.00,$63926.00,119,$-105.00
2024-06-14,02:00:00,19888.0,BUY,3,0.02h,Stop Loss,$-9.00,$-114.00,$63917.00,119,$-114.00
2024-06-14,02:10:00,19627.0,SELL,3,0.03h,Stop Loss,$-9.00,$-123.00,$63908.00,119,$-123.00
2024-06-14,02:19:00,19889.75,BUY,3,0.02h,Stop Loss,$-9.00,$-132.00,$63899.00,119,$-132.00
2024-06-14,02:27:00,19627.5,SELL,3,0.02h,Stop Loss,$-9.00,$-141.00,$63890.00,119,$-141.00
2024-06-14,02:35:00,19893.5,BUY,3,0.05h,Stop Loss,$-9.00,$-150.00,$63881.00,119,$-150.00
2024-06-14,02:39:00,19632.5,SELL,3,0.02h,Stop Loss,$-9.00,$-159.00,$63872.00,119,$-159.00
2024-06-14,02:40:00,19892.5,BUY,3,0.05h,Stop Loss,$-9.00,$-168.00,$63863.00,119,$-168.00
2024-06-14,02:45:00,19633.25,SELL,3,0.03h,Stop Loss,$-9.00,$-177.00,$63854.00,119,$-177.00
2024-06-14,02:47:00,19894.0,BUY,3,0.02h,Stop Loss,$6.00,$-171.00,$63860.00,119,$-171.00
2024-06-14,02:50:00,19634.25,SELL,3,0.02h,Break Even,$-1.50,$-172.50,$63858.50,119,$-172.50
2024-06-14,03:02:00,19893.75,BUY,3,0.02h,Stop Loss,$-9.00,$-181.50,$63849.50,119,$-181.50
2024-06-14,03:03:00,19633.5,SELL,3,0.07h,Stop Loss,$-9.00,$-190.50,$63840.50,119,$-190.50
2024-06-14,03:07:00,19897.0,BUY,3,0.02h,Stop Loss,$-9.00,$-199.50,$63831.50,119,$-199.50
2024-06-14,03:08:00,19634.75,SELL,3,0.02h,Stop Loss,$-9.00,$-208.50,$63822.50,119,$-208.50
2024-06-14,03:12:00,19895.0,BUY,3,0.02h,Stop Loss,$-9.00,$-217.50,$63813.50,119,$-217.50
2024-06-14,03:13:00,19636.5,SELL,3,0.03h,Stop Loss,$-9.00,$-226.50,$63804.50,119,$-226.50
2024-06-14,03:15:00,19897.0,BUY,3,0.03h,Stop Loss,$-9.00,$-235.50,$63795.50,119,$-235.50
2024-06-14,03:19:00,19638.0,SELL,3,0.02h,Stop Loss,$-9.00,$-244.50,$63786.50,119,$-244.50
2024-06-14,03:20:00,19898.25,BUY,3,0.02h,Break Even,$-1.50,$-246.00,$63785.00,119,$-246.00
2024-06-14,03:32:00,19637.75,SELL,3,0.02h,Stop Loss,$-9.00,$-255.00,$63776.00,119,$-255.00
2024-06-14,03:33:00,19897.0,BUY,3,0.02h,Stop Loss,$-9.00,$-264.00,$63767.00,119,$-264.00
2024-06-14,03:35:00,19637.5,SELL,3,0.02h,Stop Loss,$-9.00,$-273.00,$63758.00,119,$-273.00
2024-06-14,03:36:00,19898.25,BUY,3,0.02h,Stop Loss,$-9.00,$-282.00,$63749.00,119,$-282.00
2024-06-14,03:37:00,19638.5,SELL,3,0.02h,Stop Loss,$-9.00,$-291.00,$63740.00,119,$-291.00
2024-06-14,03:38:00,19899.5,BUY,3,0.02h,Break Even,$-1.50,$-292.50,$63738.50,119,$-292.50
2024-06-14,03:45:00,19643.0,SELL,3,0.02h,Stop Loss,$-9.00,$-301.50,$63729.50,119,$-301.50
2024-06-14,03:46:00,19905.25,BUY,3,0.07h,Stop Loss,$-9.00,$-310.50,$63720.50,119,$-310.50
2024-06-14,03:50:00,19641.5,SELL,3,0.02h,Stop Loss,$-9.00,$-319.50,$63711.50,119,$-319.50
2024-06-14,03:58:00,19903.0,BUY,3,0.02h,Stop Loss,$-9.00,$-328.50,$63702.50,119,$-328.50
2024-06-14,03:59:00,19641.0,SELL,3,0.03h,Break Even,$-1.50,$-330.00,$63701.00,119,$-330.00
2024-06-14,04:05:00,19898.25,BUY,3,0.02h,Stop Loss,$-9.00,$-339.00,$63692.00,119,$-339.00
2024-06-14,04:11:00,19633.5,SELL,3,0.02h,Stop Loss,$-9.00,$-348.00,$63683.00,119,$-348.00
2024-06-14,04:12:00,19895.75,BUY,3,0.02h,Stop Loss,$-9.00,$-357.00,$63674.00,119,$-357.00
2024-06-14,04:13:00,19634.75,SELL,3,0.02h,Stop Loss,$-9.00,$-366.00,$63665.00,119,$-366.00
2024-06-14,04:21:00,19895.0,BUY,3,0.02h,Stop Loss,$-9.00,$-375.00,$63656.00,119,$-375.00
2024-06-14,04:22:00,19632.25,SELL,3,0.02h,Stop Loss,$-9.00,$-384.00,$63647.00,119,$-384.00
2024-06-14,04:24:00,19896.25,BUY,3,0.02h,Stop Loss,$-9.00,$-393.00,$63638.00,119,$-393.00
2024-06-14,04:25:00,19634.25,SELL,3,0.03h,Stop Loss,$-9.00,$-402.00,$63629.00,119,$-402.00
2024-06-14,04:29:00,19898.75,BUY,3,0.02h,Stop Loss,$-9.00,$-411.00,$63620.00,119,$-411.00
2024-06-14,04:35:00,19631.75,SELL,3,0.02h,Stop Loss,$-9.00,$-420.00,$63611.00,119,$-420.00
2024-06-14,04:39:00,19897.25,BUY,3,0.03h,Stop Loss,$-9.00,$-429.00,$63602.00,119,$-429.00
2024-06-14,04:45:00,19636.5,SELL,3,0.03h,Stop Loss,$-9.00,$-438.00,$63593.00,119,$-438.00
2024-06-14,04:48:00,19898.0,BUY,3,0.02h,Stop Loss,$-9.00,$-447.00,$63584.00,119,$-447.00
2024-06-14,04:49:00,19634.75,SELL,3,0.02h,Stop Loss,$-9.00,$-456.00,$63575.00,119,$-456.00
2024-06-14,04:51:00,19898.0,BUY,3,0.02h,Stop Loss,$-9.00,$-465.00,$63566.00,119,$-465.00
2024-06-14,04:52:00,19637.0,SELL,3,0.05h,Stop Loss,$-9.00,$-474.00,$63557.00,119,$-474.00
2024-06-14,04:56:00,19898.5,BUY,3,0.03h,Stop Loss,$-9.00,$-483.00,$63548.00,119,$-483.00
2024-06-14,04:59:00,19637.0,SELL,3,0.02h,Stop Loss,$-9.00,$-492.00,$63539.00,119,$-492.00
2024-06-14,05:00:00,19898.25,BUY,3,0.05h,Stop Loss,$-9.00,$-501.00,$63530.00,119,$-501.00
2024-06-14,05:11:00,19638.5,SELL,3,0.02h,Stop Loss,$-9.00,$-510.00,$63521.00,119,$-510.00
2024-06-14,05:12:00,19899.0,BUY,3,0.02h,Stop Loss,$-9.00,$-519.00,$63512.00,119,$-519.00
2024-06-14,05:13:00,19637.5,SELL,3,0.02h,Stop Loss,$-9.00,$-528.00,$63503.00,119,$-528.00
2024-06-14,05:30:00,19899.75,BUY,3,0.02h,Stop Loss,$-9.00,$-537.00,$63494.00,119,$-537.00
2024-06-14,05:31:00,19639.25,SELL,3,0.02h,Stop Loss,$-9.00,$-546.00,$63485.00,119,$-546.00
2024-06-14,05:32:00,19899.75,BUY,3,0.02h,Stop Loss,$-9.00,$-555.00,$63476.00,119,$-555.00
2024-06-14,05:33:00,19640.75,SELL,3,0.02h,Stop Loss,$-9.00,$-564.00,$63467.00,119,$-564.00
2024-06-14,05:34:00,19901.25,BUY,3,0.05h,Stop Loss,$-9.00,$-573.00,$63458.00,119,$-573.00
2024-06-14,05:53:00,19643.75,SELL,3,0.02h,Stop Loss,$-9.00,$-582.00,$63449.00,119,$-582.00
2024-06-14,05:55:00,19905.25,BUY,3,0.03h,Stop Loss,$-9.00,$-591.00,$63440.00,119,$-591.00
2024-06-14,05:59:00,19645.5,SELL,3,0.02h,Stop Loss,$-9.00,$-600.00,$63431.00,119,$-600.00
2024-06-14,06:00:00,19906.5,BUY,3,0.02h,Stop Loss,$-9.00,$-609.00,$63422.00,119,$-609.00
2024-06-14,06:02:00,19643.25,SELL,3,0.02h,Stop Loss,$-9.00,$-618.00,$63413.00,119,$-618.00
2024-06-14,06:23:00,19913.5,BUY,3,0.02h,Break Even,$-1.50,$-619.50,$63411.50,119,$-619.50
2024-06-14,06:31:00,19649.0,SELL,3,0.02h,Stop Loss,$-9.00,$-628.50,$63402.50,119,$-628.50
2024-06-14,06:33:00,19909.75,BUY,3,0.03h,Stop Loss,$-9.00,$-637.50,$63393.50,119,$-637.50
2024-06-14,06:43:00,19642.0,SELL,3,0.02h,Stop Loss,$-9.00,$-646.50,$63384.50,119,$-646.50
2024-06-14,06:52:00,19885.5,BUY,3,0.02h,Break Even,$-1.50,$-648.00,$63383.00,119,$-648.00
2024-06-14,06:54:00,19630.0,SELL,3,0.02h,Stop Loss,$-9.00,$-657.00,$63374.00,119,$-657.00
2024-06-14,06:56:00,19889.0,BUY,3,0.02h,Stop Loss,$-9.00,$-666.00,$63365.00,119,$-666.00
2024-06-14,06:57:00,19630.0,SELL,3,0.02h,Stop Loss,$-9.00,$-675.00,$63356.00,119,$-675.00
2024-06-14,06:58:00,19891.5,BUY,3,0.02h,Stop Loss,$-9.00,$-684.00,$63347.00,119,$-684.00
2024-06-14,07:02:00,19630.25,SELL,3,0.02h,Stop Loss,$-9.00,$-693.00,$63338.00,119,$-693.00
2024-06-14,07:03:00,19887.75,BUY,3,0.03h,Stop Loss,$16.50,$-676.50,$63354.50,119,$-676.50
2024-06-14,07:08:00,19631.5,SELL,3,0.03h,Stop Loss,$15.00,$-661.50,$63369.50,119,$-661.50
2024-06-14,07:12:00,19884.0,BUY,3,0.02h,Stop Loss,$-9.00,$-670.50,$63360.50,119,$-670.50
2024-06-14,07:13:00,19617.0,SELL,3,0.02h,Stop Loss,$-9.00,$-679.50,$63351.50,119,$-679.50
2024-06-14,07:17:00,19879.0,BUY,3,0.02h,Stop Loss,$-9.00,$-688.50,$63342.50,119,$-688.50
2024-06-14,07:18:00,19616.75,SELL,3,0.02h,Stop Loss,$3.00,$-685.50,$63345.50,119,$-685.50
2024-06-14,07:25:00,19882.5,BUY,3,0.02h,Stop Loss,$6.00,$-679.50,$63351.50,119,$-679.50
2024-06-14,07:28:00,19636.75,SELL,3,0.02h,Stop Loss,$-9.00,$-688.50,$63342.50,119,$-688.50
2024-06-14,07:30:00,19904.75,BUY,3,0.02h,Stop Loss,$24.00,$-664.50,$63366.50,119,$-664.50
2024-06-14,07:47:00,19652.75,SELL,3,0.02h,Stop Loss,$-9.00,$-673.50,$63357.50,119,$-673.50
2024-06-14,07:48:00,19907.75,BUY,3,0.02h,Stop Loss,$-9.00,$-682.50,$63348.50,119,$-682.50
2024-06-14,07:53:00,19643.75,SELL,3,0.03h,Break Even,$-1.50,$-684.00,$63347.00,119,$-684.00
2024-06-14,08:08:00,19887.75,BUY,3,0.02h,Stop Loss,$-9.00,$-693.00,$63338.00,119,$-693.00
2024-06-14,08:09:00,19626.25,SELL,3,0.02h,Stop Loss,$-9.00,$-702.00,$63329.00,119,$-702.00
2024-06-14,08:10:00,19890.0,BUY,3,0.02h,Stop Loss,$-9.00,$-711.00,$63320.00,119,$-711.00
2024-06-14,08:12:00,19632.5,SELL,3,0.02h,Stop Loss,$-9.00,$-720.00,$63311.00,119,$-720.00
2024-06-14,08:13:00,19901.25,BUY,3,0.02h,Break Even,$-1.50,$-721.50,$63309.50,119,$-721.50
2024-06-14,08:17:00,19642.5,SELL,3,0.02h,Stop Loss,$-9.00,$-730.50,$63300.50,119,$-730.50
2024-06-14,08:18:00,19904.5,BUY,3,0.02h,Stop Loss,$-9.00,$-739.50,$63291.50,119,$-739.50
2024-06-14,08:25:00,19632.25,SELL,3,0.02h,Stop Loss,$-9.00,$-748.50,$63282.50,119,$-748.50
2024-06-14,08:26:00,19893.25,BUY,3,0.02h,Stop Loss,$-9.00,$-757.50,$63273.50,119,$-757.50
2024-06-14,08:27:00,19628.5,SELL,3,0.02h,Stop Loss,$-9.00,$-766.50,$63264.50,119,$-766.50
2024-06-14,08:33:00,19902.25,BUY,3,0.02h,Stop Loss,$-9.00,$-775.50,$63255.50,119,$-775.50
2024-06-14,08:34:00,19637.75,SELL,3,0.02h,Stop Loss,$-9.00,$-784.50,$63246.50,119,$-784.50
2024-06-14,08:35:00,19893.5,BUY,3,0.02h,Break Even,$-1.50,$-786.00,$63245.00,119,$-786.00
2024-06-14,08:38:00,19637.75,SELL,3,0.02h,Stop Loss,$-9.00,$-795.00,$63236.00,119,$-795.00
2024-06-14,08:39:00,19897.25,BUY,3,0.02h,Break Even,$-1.50,$-796.50,$63234.50,119,$-796.50
2024-06-14,08:44:00,19633.5,SELL,3,0.02h,Break Even,$-1.50,$-798.00,$63233.00,119,$-798.00
2024-06-14,08:50:00,19884.0,BUY,3,0.02h,Stop Loss,$13.50,$-784.50,$63246.50,119,$-784.50
2024-06-14,09:03:00,19622.5,SELL,3,0.02h,Stop Loss,$7.50,$-777.00,$63254.00,119,$-777.00
2024-06-14,09:12:00,19866.75,BUY,3,0.02h,Break Even,$-1.50,$-778.50,$63252.50,119,$-778.50
2024-06-14,09:18:00,19598.0,SELL,3,0.02h,Stop Loss,$-9.00,$-787.50,$63243.50,119,$-787.50
2024-06-14,09:19:00,19861.0,BUY,3,0.03h,Stop Loss,$36.00,$-751.50,$63279.50,119,$-751.50
2024-06-14,09:23:00,19608.75,SELL,3,0.02h,Stop Loss,$-9.00,$-760.50,$63270.50,119,$-760.50
2024-06-14,09:30:00,19865.0,BUY,3,0.02h,Stop Loss,$-9.00,$-769.50,$63261.50,119,$-769.50
2024-06-14,09:34:00,19593.0,SELL,3,0.02h,Stop Loss,$13.50,$-756.00,$63275.00,119,$-756.00
2024-06-14,09:47:00,19841.25,BUY,3,0.02h,Stop Loss,$-9.00,$-765.00,$63266.00,119,$-765.00
2024-06-14,09:48:00,19581.0,SELL,3,0.02h,Stop Loss,$-9.00,$-774.00,$63257.00,119,$-774.00
2024-06-14,09:49:00,19841.25,BUY,3,0.02h,Stop Loss,$-9.00,$-783.00,$63248.00,119,$-783.00
2024-06-14,09:50:00,19575.0,SELL,3,0.02h,Stop Loss,$9.00,$-774.00,$63257.00,119,$-774.00
2024-06-14,09:53:00,19836.25,BUY,3,0.02h,Break Even,$-1.50,$-775.50,$63255.50,119,$-775.50
2024-06-14,09:55:00,19569.5,SELL,3,0.02h,Stop Loss,$-9.00,$-784.50,$63246.50,119,$-784.50
2024-06-14,09:56:00,19833.5,BUY,3,0.02h,Stop Loss,$-9.00,$-793.50,$63237.50,119,$-793.50
2024-06-14,09:59:00,19558.5,SELL,3,0.02h,Break Even,$-1.50,$-795.00,$63236.00,119,$-795.00
2024-06-14,10:15:00,19798.5,BUY,3,0.02h,Stop Loss,$61.50,$-733.50,$63297.50,119,$-733.50
2024-06-14,10:18:00,19549.75,SELL,3,0.02h,Stop Loss,$-9.00,$-742.50,$63288.50,119,$-742.50
2024-06-14,10:19:00,19803.0,BUY,3,0.02h,Stop Loss,$-9.00,$-751.50,$63279.50,119,$-751.50
2024-06-14,10:20:00,19538.75,SELL,3,0.02h,Stop Loss,$-9.00,$-760.50,$63270.50,119,$-760.50
2024-06-14,10:21:00,19801.5,BUY,3,0.02h,Stop Loss,$-9.00,$-769.50,$63261.50,119,$-769.50
2024-06-14,10:22:00,19539.5,SELL,3,0.02h,Stop Loss,$36.00,$-733.50,$63297.50,119,$-733.50
2024-06-14,10:30:00,19803.75,BUY,3,0.02h,Stop Loss,$-9.00,$-742.50,$63288.50,119,$-742.50
2024-06-14,10:31:00,19547.25,SELL,3,0.02h,Stop Loss,$-9.00,$-751.50,$63279.50,119,$-751.50
2024-06-14,10:32:00,19814.0,BUY,3,0.02h,Stop Loss,$-9.00,$-760.50,$63270.50,119,$-760.50
2024-06-14,10:36:00,19557.25,SELL,3,0.02h,Stop Loss,$-9.00,$-769.50,$63261.50,119,$-769.50
2024-06-14,10:38:00,19821.25,BUY,3,0.02h,Stop Loss,$-9.00,$-778.50,$63252.50,119,$-778.50
2024-06-14,10:40:00,19556.5,SELL,3,0.02h,Stop Loss,$-9.00,$-787.50,$63243.50,119,$-787.50
2024-06-14,10:41:00,19812.25,BUY,3,0.02h,Stop Loss,$4.50,$-783.00,$63248.00,119,$-783.00
2024-06-14,10:48:00,19553.0,SELL,3,0.02h,Stop Loss,$-9.00,$-792.00,$63239.00,119,$-792.00
2024-06-14,10:49:00,19817.75,BUY,3,0.02h,Stop Loss,$-9.00,$-801.00,$63230.00,119,$-801.00
2024-06-14,10:57:00,19540.0,SELL,3,0.02h,Stop Loss,$-9.00,$-810.00,$63221.00,119,$-810.00
2024-06-14,10:58:00,19796.75,BUY,3,0.02h,Stop Loss,$-9.00,$-819.00,$63212.00,119,$-819.00
2024-06-14,10:59:00,19546.25,SELL,3,0.02h,Stop Loss,$-9.00,$-828.00,$63203.00,119,$-828.00
2024-06-14,11:00:00,19801.25,BUY,3,0.02h,Stop Loss,$7.50,$-820.50,$63210.50,119,$-820.50
2024-06-14,11:03:00,19524.0,SELL,3,0.02h,Break Even,$-1.50,$-822.00,$63209.00,119,$-822.00
2024-06-14,11:18:00,19780.75,BUY,3,0.02h,Stop Loss,$21.00,$-801.00,$63230.00,119,$-801.00
2024-06-14,11:20:00,19518.0,SELL,3,0.02h,Stop Loss,$-9.00,$-810.00,$63221.00,119,$-810.00
2024-06-14,11:36:00,19826.5,BUY,3,0.02h,Stop Loss,$-9.00,$-819.00,$63212.00,119,$-819.00
2024-06-14,11:53:00,19552.5,SELL,3,0.02h,Stop Loss,$-9.00,$-828.00,$63203.00,119,$-828.00
2024-06-14,11:54:00,19815.5,BUY,3,0.02h,Stop Loss,$-9.00,$-837.00,$63194.00,119,$-837.00
2024-06-14,12:00:00,19538.5,SELL,3,0.02h,Stop Loss,$12.00,$-825.00,$63206.00,119,$-825.00
2024-06-14,12:10:00,19806.5,BUY,3,0.02h,Stop Loss,$-9.00,$-834.00,$63197.00,119,$-834.00
2024-06-14,12:22:00,19556.5,SELL,3,0.02h,Stop Loss,$-9.00,$-843.00,$63188.00,119,$-843.00
2024-06-14,12:23:00,19825.0,BUY,3,0.02h,Stop Loss,$-9.00,$-852.00,$63179.00,119,$-852.00
2024-06-14,12:24:00,19563.75,SELL,3,0.02h,Stop Loss,$-9.00,$-861.00,$63170.00,119,$-861.00
2024-06-14,12:25:00,19830.5,BUY,3,0.02h,Break Even,$-1.50,$-862.50,$63168.50,119,$-862.50
2024-06-14,12:33:00,19555.5,SELL,3,0.02h,Break Even,$-1.50,$-864.00,$63167.00,119,$-864.00
2024-06-14,12:36:00,19817.75,BUY,3,0.02h,Stop Loss,$73.50,$-790.50,$63240.50,119,$-790.50
2024-06-14,12:38:00,19568.5,SELL,3,0.02h,Stop Loss,$13.50,$-777.00,$63254.00,119,$-777.00
2024-06-14,12:46:00,19833.0,BUY,3,0.02h,Stop Loss,$-9.00,$-786.00,$63245.00,119,$-786.00
2024-06-14,12:47:00,19567.75,SELL,3,0.02h,Stop Loss,$-9.00,$-795.00,$63236.00,119,$-795.00
2024-06-14,12:48:00,19828.0,BUY,3,0.02h,Break Even,$-1.50,$-796.50,$63234.50,119,$-796.50
2024-06-14,12:52:00,19557.75,SELL,3,0.02h,Stop Loss,$-9.00,$-805.50,$63225.50,119,$-805.50
2024-06-14,12:54:00,19819.5,BUY,3,0.02h,Stop Loss,$-9.00,$-814.50,$63216.50,119,$-814.50
2024-06-14,13:00:00,19561.25,SELL,3,0.02h,Stop Loss,$15.00,$-799.50,$63231.50,119,$-799.50
2024-06-14,13:11:00,19819.0,BUY,3,0.02h,Break Even,$-1.50,$-801.00,$63230.00,119,$-801.00
2024-06-14,13:15:00,19557.75,SELL,3,0.02h,Stop Loss,$-9.00,$-810.00,$63221.00,119,$-810.00
2024-06-14,13:16:00,19821.0,BUY,3,0.02h,Stop Loss,$-9.00,$-819.00,$63212.00,119,$-819.00
2024-06-14,13:17:00,19556.75,SELL,3,0.02h,Stop Loss,$-9.00,$-828.00,$63203.00,119,$-828.00
2024-06-14,13:18:00,19821.0,BUY,3,0.02h,Stop Loss,$-9.00,$-837.00,$63194.00,119,$-837.00
2024-06-14,13:24:00,19566.0,SELL,3,0.02h,Stop Loss,$-9.00,$-846.00,$63185.00,119,$-846.00
2024-06-14,13:25:00,19824.0,BUY,3,0.02h,Stop Loss,$15.00,$-831.00,$63200.00,119,$-831.00
2024-06-14,13:27:00,19567.5,SELL,3,0.02h,Stop Loss,$-9.00,$-840.00,$63191.00,119,$-840.00
2024-06-14,13:28:00,19826.25,BUY,3,0.02h,Stop Loss,$9.00,$-831.00,$63200.00,119,$-831.00
2024-06-14,13:42:00,19592.0,SELL,3,0.02h,Stop Loss,$-9.00,$-840.00,$63191.00,119,$-840.00
2024-06-14,13:43:00,19854.25,BUY,3,0.02h,Break Even,$-1.50,$-841.50,$63189.50,119,$-841.50
2024-06-14,13:45:00,19597.5,SELL,3,0.02h,Stop Loss,$-9.00,$-850.50,$63180.50,119,$-850.50
2024-06-14,13:53:00,19893.5,BUY,3,0.02h,Break Even,$-1.50,$-852.00,$63179.00,119,$-852.00
2024-06-14,13:59:00,19629.5,SELL,3,0.02h,Stop Loss,$-9.00,$-861.00,$63170.00,119,$-861.00
2024-06-14,14:03:00,19882.25,BUY,3,0.02h,Stop Loss,$-9.00,$-870.00,$63161.00,119,$-870.00
2024-06-14,14:04:00,19608.75,SELL,3,0.02h,Break Even,$-1.50,$-871.50,$63159.50,119,$-871.50
2024-06-14,14:08:00,19890.5,BUY,3,0.02h,Stop Loss,$-9.00,$-880.50,$63150.50,119,$-880.50
2024-06-14,14:09:00,19612.5,SELL,3,0.02h,Stop Loss,$-9.00,$-889.50,$63141.50,119,$-889.50
2024-06-14,14:10:00,19868.5,BUY,3,0.02h,Stop Loss,$31.50,$-858.00,$63173.00,119,$-858.00
2024-06-14,14:12:00,19605.5,SELL,3,0.02h,Stop Loss,$81.00,$-777.00,$63254.00,119,$-777.00
2024-06-14,14:18:00,19876.25,BUY,3,0.02h,Stop Loss,$-9.00,$-786.00,$63245.00,119,$-786.00
2024-06-14,14:19:00,19624.5,SELL,3,0.02h,Break Even,$-1.50,$-787.50,$63243.50,119,$-787.50
2024-06-14,14:21:00,19885.25,BUY,3,0.02h,Stop Loss,$103.50,$-684.00,$63347.00,119,$-684.00
2024-06-14,14:32:00,19620.5,SELL,3,0.02h,Stop Loss,$-9.00,$-693.00,$63338.00,119,$-693.00
2024-06-14,14:33:00,19863.75,BUY,3,0.02h,Stop Loss,$9.00,$-684.00,$63347.00,119,$-684.00
2024-06-14,14:37:00,19592.5,SELL,3,0.02h,Stop Loss,$63.00,$-621.00,$63410.00,119,$-621.00
2024-06-14,14:44:00,19862.0,BUY,3,0.02h,Stop Loss,$13.50,$-607.50,$63423.50,119,$-607.50
2024-06-14,14:46:00,19597.5,SELL,3,0.02h,Stop Loss,$-9.00,$-616.50,$63414.50,119,$-616.50
2024-06-14,14:47:00,19874.25,BUY,3,0.02h,Stop Loss,$28.50,$-588.00,$63443.00,119,$-588.00
2024-06-14,14:50:00,19619.25,SELL,3,0.02h,Stop Loss,$-9.00,$-597.00,$63434.00,119,$-597.00
2024-06-14,14:51:00,19891.25,BUY,3,0.02h,Stop Loss,$-9.00,$-606.00,$63425.00,119,$-606.00
2024-06-14,14:55:00,19630.75,SELL,3,0.02h,Break Even,$-1.50,$-607.50,$63423.50,119,$-607.50
2024-06-14,15:02:00,19873.5,BUY,3,0.02h,Stop Loss,$31.50,$-576.00,$63455.00,119,$-576.00
2024-06-14,15:09:00,19607.5,SELL,3,0.02h,Stop Loss,$34.50,$-541.50,$63489.50,119,$-541.50
2024-06-14,15:15:00,19884.5,BUY,3,0.02h,Stop Loss,$-9.00,$-550.50,$63480.50,119,$-550.50
2024-06-14,15:19:00,19619.25,SELL,3,0.02h,Break Even,$-1.50,$-552.00,$63479.00,119,$-552.00
2024-06-14,15:23:00,19875.0,BUY,3,0.02h,Stop Loss,$4.50,$-547.50,$63483.50,119,$-547.50
2024-06-14,15:25:00,19619.0,SELL,3,0.02h,Break Even,$-1.50,$-549.00,$63482.00,119,$-549.00
2024-06-14,15:44:00,19851.25,BUY,3,0.02h,Stop Loss,$-9.00,$-558.00,$63473.00,119,$-558.00
2024-06-14,15:56:00,19603.25,SELL,3,0.02h,Stop Loss,$-9.00,$-567.00,$63464.00,119,$-567.00
2024-06-14,15:57:00,19868.0,BUY,3,0.02h,Stop Loss,$-9.00,$-576.00,$63455.00,119,$-576.00
2024-06-14,16:04:00,19619.0,SELL,3,0.02h,Stop Loss,$-9.00,$-585.00,$63446.00,119,$-585.00
2024-06-14,16:05:00,19880.0,BUY,3,0.02h,Stop Loss,$9.00,$-576.00,$63455.00,119,$-576.00
2024-06-14,16:10:00,19621.75,SELL,3,0.02h,Stop Loss,$-9.00,$-585.00,$63446.00,119,$-585.00
2024-06-14,16:14:00,19894.75,BUY,3,0.02h,Break Even,$-1.50,$-586.50,$63444.50,119,$-586.50
2024-06-14,16:20:00,19618.75,SELL,3,0.02h,Stop Loss,$-9.00,$-595.50,$63435.50,119,$-595.50
2024-06-14,16:24:00,19885.75,BUY,3,0.02h,Stop Loss,$-9.00,$-604.50,$63426.50,119,$-604.50
2024-06-14,16:25:00,19622.25,SELL,3,0.02h,Stop Loss,$-9.00,$-613.50,$63417.50,119,$-613.50
2024-06-14,16:26:00,19876.25,BUY,3,0.02h,Stop Loss,$-9.00,$-622.50,$63408.50,119,$-622.50
2024-06-14,16:27:00,19616.75,SELL,3,0.02h,Stop Loss,$-9.00,$-631.50,$63399.50,119,$-631.50
2024-06-14,16:31:00,19872.75,BUY,3,0.02h,Stop Loss,$-9.00,$-640.50,$63390.50,119,$-640.50
2024-06-14,16:33:00,19603.0,SELL,3,0.02h,Stop Loss,$-9.00,$-649.50,$63381.50,119,$-649.50
2024-06-14,16:39:00,19887.25,BUY,3,0.02h,Stop Loss,$13.50,$-636.00,$63395.00,119,$-636.00
2024-06-14,16:43:00,19624.25,SELL,3,0.02h,Stop Loss,$-9.00,$-645.00,$63386.00,119,$-645.00
2024-06-14,16:48:00,19887.25,BUY,3,0.02h,Stop Loss,$-9.00,$-654.00,$63377.00,119,$-654.00
2024-06-14,16:56:00,19623.75,SELL,3,0.02h,Stop Loss,$-9.00,$-663.00,$63368.00,119,$-663.00
2024-06-14,16:58:00,19893.25,BUY,3,0.02h,Stop Loss,$-9.00,$-672.00,$63359.00,119,$-672.00
2024-06-14,16:59:00,19627.75,SELL,3,0.02h,Break Even,$-1.50,$-673.50,$63357.50,119,$-673.50
2024-06-14,17:05:00,19888.0,BUY,3,0.02h,Stop Loss,$-9.00,$-682.50,$63348.50,119,$-682.50
2024-06-14,17:06:00,19631.0,SELL,3,0.02h,Stop Loss,$-9.00,$-691.50,$63339.50,119,$-691.50
2024-06-14,17:09:00,19900.5,BUY,3,0.02h,Stop Loss,$-9.00,$-700.50,$63330.50,119,$-700.50
2024-06-14,17:10:00,19644.25,SELL,3,0.02h,Stop Loss,$-9.00,$-709.50,$63321.50,119,$-709.50
2024-06-14,17:11:00,19906.0,BUY,3,0.02h,Stop Loss,$-9.00,$-718.50,$63312.50,119,$-718.50
2024-06-14,17:20:00,19648.75,SELL,3,0.02h,Stop Loss,$-9.00,$-727.50,$63303.50,119,$-727.50
2024-06-14,17:25:00,19912.5,BUY,3,0.02h,Stop Loss,$-9.00,$-736.50,$63294.50,119,$-736.50
2024-06-14,17:26:00,19651.5,SELL,3,0.02h,Stop Loss,$-9.00,$-745.50,$63285.50,119,$-745.50
2024-06-14,17:27:00,19916.5,BUY,3,0.02h,Stop Loss,$-9.00,$-754.50,$63276.50,119,$-754.50
2024-06-14,17:28:00,19662.0,SELL,3,0.02h,Stop Loss,$-9.00,$-763.50,$63267.50,119,$-763.50
2024-06-14,17:29:00,19925.75,BUY,3,0.02h,Stop Loss,$-9.00,$-772.50,$63258.50,119,$-772.50
2024-06-14,17:30:00,19660.25,SELL,3,0.02h,Break Even,$-1.50,$-774.00,$63257.00,119,$-774.00
2024-06-14,17:35:00,19929.75,BUY,3,0.02h,Stop Loss,$-9.00,$-783.00,$63248.00,119,$-783.00
2024-06-14,17:39:00,19670.5,SELL,3,0.02h,Stop Loss,$-9.00,$-792.00,$63239.00,119,$-792.00
2024-06-14,17:41:00,19926.0,BUY,3,0.02h,Stop Loss,$-9.00,$-801.00,$63230.00,119,$-801.00
2024-06-14,17:44:00,19656.75,SELL,3,0.02h,Stop Loss,$-9.00,$-810.00,$63221.00,119,$-810.00
2024-06-14,17:49:00,19922.75,BUY,3,0.02h,Stop Loss,$-9.00,$-819.00,$63212.00,119,$-819.00
2024-06-14,17:51:00,19663.5,SELL,3,0.02h,Stop Loss,$-9.00,$-828.00,$63203.00,119,$-828.00
2024-06-14,17:52:00,19920.75,BUY,3,0.02h,Stop Loss,$-9.00,$-837.00,$63194.00,119,$-837.00
2024-06-14,17:53:00,19662.5,SELL,3,0.02h,Stop Loss,$-9.00,$-846.00,$63185.00,119,$-846.00
2024-06-14,17:54:00,19927.0,BUY,3,0.02h,Stop Loss,$-9.00,$-855.00,$63176.00,119,$-855.00
2024-06-14,17:56:00,19665.0,SELL,3,0.02h,Stop Loss,$42.00,$-813.00,$63218.00,119,$-813.00
2024-06-14,18:01:00,19907.0,BUY,3,0.02h,Stop Loss,$-9.00,$-822.00,$63209.00,119,$-822.00
2024-06-14,18:02:00,19652.5,SELL,3,0.02h,Stop Loss,$-9.00,$-831.00,$63200.00,119,$-831.00
2024-06-14,18:03:00,19910.75,BUY,3,0.02h,Stop Loss,$-9.00,$-840.00,$63191.00,119,$-840.00
2024-06-14,18:04:00,19647.0,SELL,3,0.02h,Stop Loss,$-9.00,$-849.00,$63182.00,119,$-849.00
2024-06-14,18:05:00,19913.0,BUY,3,0.02h,Stop Loss,$37.50,$-811.50,$63219.50,119,$-811.50
2024-06-14,18:09:00,19655.0,SELL,3,0.02h,Stop Loss,$-9.00,$-820.50,$63210.50,119,$-820.50
2024-06-14,18:10:00,19903.75,BUY,3,0.02h,Stop Loss,$-9.00,$-829.50,$63201.50,119,$-829.50
2024-06-14,18:11:00,19649.5,SELL,3,0.02h,Stop Loss,$10.50,$-819.00,$63212.00,119,$-819.00
2024-06-14,18:17:00,19893.5,BUY,3,0.02h,Stop Loss,$27.00,$-792.00,$63239.00,119,$-792.00
2024-06-14,18:19:00,19646.25,SELL,3,0.02h,Stop Loss,$-9.00,$-801.00,$63230.00,119,$-801.00
2024-06-14,18:20:00,19910.5,BUY,3,0.02h,Break Even,$-1.50,$-802.50,$63228.50,119,$-802.50
2024-06-14,18:25:00,19662.25,SELL,3,0.02h,Stop Loss,$-9.00,$-811.50,$63219.50,119,$-811.50
2024-06-14,18:27:00,19928.25,BUY,3,0.02h,Stop Loss,$-9.00,$-820.50,$63210.50,119,$-820.50
2024-06-14,18:28:00,19663.25,SELL,3,0.02h,Stop Loss,$10.50,$-810.00,$63221.00,119,$-810.00
2024-06-14,18:32:00,19911.75,BUY,3,0.02h,Stop Loss,$-9.00,$-819.00,$63212.00,119,$-819.00
2024-06-14,18:33:00,19654.75,SELL,3,0.02h,Stop Loss,$51.00,$-768.00,$63263.00,119,$-768.00
2024-06-14,18:35:00,19910.5,BUY,3,0.02h,Stop Loss,$-9.00,$-777.00,$63254.00,119,$-777.00
2024-06-14,18:36:00,19647.0,SELL,3,0.02h,Stop Loss,$-9.00,$-786.00,$63245.00,119,$-786.00
2024-06-14,18:37:00,19906.0,BUY,3,0.02h,Stop Loss,$-9.00,$-795.00,$63236.00,119,$-795.00
2024-06-14,18:38:00,19644.5,SELL,3,0.02h,Break Even,$-1.50,$-796.50,$63234.50,119,$-796.50
2024-06-14,18:42:00,19901.0,BUY,3,0.02h,Stop Loss,$-9.00,$-805.50,$63225.50,119,$-805.50
2024-06-14,18:43:00,19639.5,SELL,3,0.02h,Stop Loss,$24.00,$-781.50,$63249.50,119,$-781.50
2024-06-14,18:45:00,19913.5,BUY,3,0.02h,Stop Loss,$-9.00,$-790.50,$63240.50,119,$-790.50
2024-06-14,18:46:00,19655.5,SELL,3,0.02h,Stop Loss,$-9.00,$-799.50,$63231.50,119,$-799.50
2024-06-14,18:47:00,19909.25,BUY,3,0.02h,Stop Loss,$6.00,$-793.50,$63237.50,119,$-793.50
2024-06-14,18:57:00,19663.0,SELL,3,0.02h,Stop Loss,$75.00,$-718.50,$63312.50,119,$-718.50
2024-06-14,19:03:00,19925.75,BUY,3,0.02h,Break Even,$-1.50,$-720.00,$63311.00,119,$-720.00
2024-06-14,19:24:00,19673.75,SELL,3,0.02h,Break Even,$-1.50,$-721.50,$63309.50,119,$-721.50
2024-06-14,19:35:00,19927.0,BUY,3,0.02h,Stop Loss,$15.00,$-706.50,$63324.50,119,$-706.50
2024-06-14,19:40:00,19664.25,SELL,3,0.02h,Break Even,$-1.50,$-708.00,$63323.00,119,$-708.00
2024-06-14,19:43:00,19917.0,BUY,3,0.02h,Stop Loss,$-9.00,$-717.00,$63314.00,119,$-717.00
2024-06-14,19:44:00,19651.5,SELL,3,0.02h,Stop Loss,$-9.00,$-726.00,$63305.00,119,$-726.00
2024-06-14,19:46:00,19909.25,BUY,3,0.02h,Stop Loss,$31.50,$-694.50,$63336.50,119,$-694.50
2024-06-14,19:48:00,19655.5,SELL,3,0.02h,Stop Loss,$-9.00,$-703.50,$63327.50,119,$-703.50
2024-06-14,19:49:00,19916.5,BUY,3,0.02h,Stop Loss,$-9.00,$-712.50,$63318.50,119,$-712.50
2024-06-14,19:50:00,19655.75,SELL,3,0.02h,Stop Loss,$-9.00,$-721.50,$63309.50,119,$-721.50
2024-06-14,19:54:00,19912.5,BUY,3,0.02h,Break Even,$-1.50,$-723.00,$63308.00,119,$-723.00
2024-06-14,20:00:00,19687.5,SELL,3,0.02h,Stop Loss,$-9.00,$-732.00,$63299.00,119,$-732.00
2024-06-14,20:01:00,19943.5,BUY,3,0.02h,Stop Loss,$-9.00,$-741.00,$63290.00,119,$-741.00
2024-06-14,20:02:00,19687.75,SELL,3,0.02h,Stop Loss,$-9.00,$-750.00,$63281.00,119,$-750.00
2024-06-14,20:03:00,19945.75,BUY,3,0.02h,Break Even,$-1.50,$-751.50,$63279.50,119,$-751.50
2024-06-14,20:05:00,19685.0,SELL,3,0.02h,Stop Loss,$-9.00,$-760.50,$63270.50,119,$-760.50
2024-06-14,20:08:00,19947.0,BUY,3,0.02h,Break Even,$-1.50,$-762.00,$63269.00,119,$-762.00
2024-06-14,20:10:00,19686.0,SELL,3,0.02h,Break Even,$-1.50,$-763.50,$63267.50,119,$-763.50
2024-06-14,20:14:00,19948.75,BUY,3,0.02h,Stop Loss,$-9.00,$-772.50,$63258.50,119,$-772.50
2024-06-14,20:15:00,19686.25,SELL,3,0.02h,Stop Loss,$-9.00,$-781.50,$63249.50,119,$-781.50
2024-06-14,20:16:00,19947.5,BUY,3,0.02h,Stop Loss,$-9.00,$-790.50,$63240.50,119,$-790.50
2024-06-14,20:17:00,19688.25,SELL,3,0.02h,Stop Loss,$-9.00,$-799.50,$63231.50,119,$-799.50
2024-06-14,20:22:00,19951.25,BUY,3,0.02h,Stop Loss,$-9.00,$-808.50,$63222.50,119,$-808.50
2024-06-14,20:23:00,19690.75,SELL,3,0.03h,Stop Loss,$-9.00,$-817.50,$63213.50,119,$-817.50
2024-06-14,20:33:00,19953.75,BUY,3,0.10h,Stop Loss,$-9.00,$-826.50,$63204.50,119,$-826.50
2024-06-14,20:51:00,19689.0,SELL,3,0.02h,Stop Loss,$3.00,$-823.50,$63207.50,119,$-823.50
2024-06-14,20:54:00,19947.25,BUY,3,0.02h,Stop Loss,$-9.00,$-832.50,$63198.50,119,$-832.50
2024-06-14,20:55:00,19687.75,SELL,3,0.02h,Stop Loss,$-9.00,$-841.50,$63189.50,119,$-841.50
,,,,,,,,,,,
2024-06-17,00:00:00,19972.0,BUY,3,0.02h,Break Even,$-1.50,$-1.50,$63188.00,120,$-1.50
2024-06-17,00:02:00,19713.75,SELL,3,0.02h,Stop Loss,$-9.00,$-10.50,$63179.00,120,$-10.50
2024-06-17,00:07:00,19972.0,BUY,3,0.02h,Stop Loss,$-9.00,$-19.50,$63170.00,120,$-19.50
2024-06-17,00:08:00,19709.5,SELL,3,0.02h,Stop Loss,$-9.00,$-28.50,$63161.00,120,$-28.50
2024-06-17,00:09:00,19971.75,BUY,3,0.02h,Stop Loss,$-9.00,$-37.50,$63152.00,120,$-37.50
2024-06-17,00:11:00,19708.5,SELL,3,0.03h,Stop Loss,$7.50,$-30.00,$63159.50,120,$-30.00
2024-06-17,00:16:00,19971.0,BUY,3,0.02h,Stop Loss,$-9.00,$-39.00,$63150.50,120,$-39.00
2024-06-17,00:17:00,19711.75,SELL,3,0.02h,Break Even,$-1.50,$-40.50,$63149.00,120,$-40.50
2024-06-17,00:23:00,19971.5,BUY,3,0.03h,Stop Loss,$-9.00,$-49.50,$63140.00,120,$-49.50
2024-06-17,00:29:00,19712.25,SELL,3,0.02h,Stop Loss,$-9.00,$-58.50,$63131.00,120,$-58.50
2024-06-17,00:30:00,19971.25,BUY,3,0.02h,Break Even,$-1.50,$-60.00,$63129.50,120,$-60.00
2024-06-17,00:35:00,19711.75,SELL,3,0.02h,Stop Loss,$-9.00,$-69.00,$63120.50,120,$-69.00
2024-06-17,00:40:00,19964.0,BUY,3,0.02h,Break Even,$-1.50,$-70.50,$63119.00,120,$-70.50
2024-06-17,00:43:00,19705.25,SELL,3,0.02h,Stop Loss,$4.50,$-66.00,$63123.50,120,$-66.00
2024-06-17,00:46:00,19961.25,BUY,3,0.02h,Stop Loss,$-9.00,$-75.00,$63114.50,120,$-75.00
2024-06-17,00:47:00,19701.5,SELL,3,0.02h,Stop Loss,$-9.00,$-84.00,$63105.50,120,$-84.00
2024-06-17,00:48:00,19961.5,BUY,3,0.05h,Stop Loss,$-9.00,$-93.00,$63096.50,120,$-93.00
2024-06-17,00:52:00,19702.75,SELL,3,0.02h,Stop Loss,$-9.00,$-102.00,$63087.50,120,$-102.00
2024-06-17,00:53:00,19963.25,BUY,3,0.02h,Break Even,$-1.50,$-103.50,$63086.00,120,$-103.50
2024-06-17,00:57:00,19703.5,SELL,3,0.03h,Stop Loss,$-9.00,$-112.50,$63077.00,120,$-112.50
2024-06-17,01:00:00,19959.5,BUY,3,0.02h,Stop Loss,$-9.00,$-121.50,$63068.00,120,$-121.50
2024-06-17,01:08:00,19688.5,SELL,3,0.02h,Stop Loss,$-9.00,$-130.50,$63059.00,120,$-130.50
2024-06-17,01:11:00,19954.5,BUY,3,0.02h,Stop Loss,$-9.00,$-139.50,$63050.00,120,$-139.50
2024-06-17,01:13:00,19691.0,SELL,3,0.02h,Stop Loss,$-9.00,$-148.50,$63041.00,120,$-148.50
2024-06-17,01:14:00,19950.25,BUY,3,0.02h,Stop Loss,$-9.00,$-157.50,$63032.00,120,$-157.50
2024-06-17,01:15:00,19687.25,SELL,3,0.02h,Stop Loss,$-9.00,$-166.50,$63023.00,120,$-166.50
2024-06-17,01:17:00,19946.5,BUY,3,0.02h,Stop Loss,$-9.00,$-175.50,$63014.00,120,$-175.50
2024-06-17,01:18:00,19686.5,SELL,3,0.02h,Stop Loss,$-9.00,$-184.50,$63005.00,120,$-184.50
2024-06-17,01:23:00,19951.0,BUY,3,0.03h,Stop Loss,$-9.00,$-193.50,$62996.00,120,$-193.50
2024-06-17,01:25:00,19687.75,SELL,3,0.02h,Break Even,$-1.50,$-195.00,$62994.50,120,$-195.00
2024-06-17,01:31:00,19952.75,BUY,3,0.02h,Break Even,$-1.50,$-196.50,$62993.00,120,$-196.50
2024-06-17,01:39:00,19695.5,SELL,3,0.02h,Break Even,$-1.50,$-198.00,$62991.50,120,$-198.00
2024-06-17,01:43:00,19954.75,BUY,3,0.02h,Stop Loss,$-9.00,$-207.00,$62982.50,120,$-207.00
2024-06-17,01:44:00,19693.0,SELL,3,0.02h,Break Even,$-1.50,$-208.50,$62981.00,120,$-208.50
2024-06-17,01:48:00,19958.0,BUY,3,0.02h,Stop Loss,$-9.00,$-217.50,$62972.00,120,$-217.50
2024-06-17,01:56:00,19701.0,SELL,3,0.02h,Stop Loss,$-9.00,$-226.50,$62963.00,120,$-226.50
2024-06-17,01:57:00,19959.5,BUY,3,0.02h,Stop Loss,$-9.00,$-235.50,$62954.00,120,$-235.50
2024-06-17,02:01:00,19699.75,SELL,3,0.02h,Stop Loss,$-9.00,$-244.50,$62945.00,120,$-244.50
2024-06-17,02:09:00,19963.0,BUY,3,0.02h,Stop Loss,$-9.00,$-253.50,$62936.00,120,$-253.50
2024-06-17,02:12:00,19702.0,SELL,3,0.02h,Break Even,$-1.50,$-255.00,$62934.50,120,$-255.00
2024-06-17,02:16:00,19965.0,BUY,3,0.03h,Stop Loss,$-9.00,$-264.00,$62925.50,120,$-264.00
2024-06-17,02:25:00,19698.25,SELL,3,0.02h,Stop Loss,$-9.00,$-273.00,$62916.50,120,$-273.00
2024-06-17,02:26:00,19959.0,BUY,3,0.02h,Stop Loss,$-9.00,$-282.00,$62907.50,120,$-282.00
2024-06-17,02:27:00,19697.25,SELL,3,0.02h,Break Even,$-1.50,$-283.50,$62906.00,120,$-283.50
2024-06-17,02:34:00,19958.75,BUY,3,0.05h,Break Even,$-1.50,$-285.00,$62904.50,120,$-285.00
2024-06-17,02:39:00,19701.75,SELL,3,0.03h,Stop Loss,$-9.00,$-294.00,$62895.50,120,$-294.00
2024-06-17,02:52:00,19959.0,BUY,3,0.02h,Stop Loss,$-9.00,$-303.00,$62886.50,120,$-303.00
2024-06-17,03:56:00,19959.75,SELL,3,0.02h,Stop Loss,$-9.00,$-312.00,$62877.50,120,$-312.00
2024-06-17,04:03:00,19962.75,BUY,3,0.07h,Break Even,$-1.50,$-313.50,$62876.00,120,$-313.50
2024-06-17,04:12:00,19962.25,SELL,3,0.15h,Break Even,$-1.50,$-315.00,$62874.50,120,$-315.00
2024-06-17,05:15:00,19955.5,BUY,3,0.02h,Break Even,$-1.50,$-316.50,$62873.00,120,$-316.50
2024-06-17,05:54:00,19961.0,SELL,3,0.02h,Break Even,$-1.50,$-318.00,$62871.50,120,$-318.00
2024-06-17,06:24:00,19954.0,BUY,3,0.02h,Stop Loss,$13.50,$-304.50,$62885.00,120,$-304.50
2024-06-17,07:40:00,19977.5,SELL,3,0.02h,Break Even,$-1.50,$-306.00,$62883.50,120,$-306.00
2024-06-17,08:00:00,19982.0,BUY,3,0.02h,Break Even,$-1.50,$-307.50,$62882.00,120,$-307.50
2024-06-17,08:28:00,19989.25,SELL,3,0.02h,Stop Loss,$-9.00,$-316.50,$62873.00,120,$-316.50
2024-06-17,09:05:00,19980.0,BUY,3,0.02h,Stop Loss,$-9.00,$-325.50,$62864.00,120,$-325.50
2024-06-17,09:09:00,19965.5,SELL,3,0.02h,Break Even,$-1.50,$-327.00,$62862.50,120,$-327.00
2024-06-17,09:20:00,19975.0,BUY,3,0.02h,Stop Loss,$-9.00,$-336.00,$62853.50,120,$-336.00
2024-06-17,10:05:00,19973.75,SELL,3,0.02h,Stop Loss,$10.50,$-325.50,$62864.00,120,$-325.50
2024-06-17,10:43:00,19969.75,BUY,3,0.02h,Stop Loss,$-9.00,$-334.50,$62855.00,120,$-334.50
2024-06-17,10:57:00,19961.5,SELL,3,0.02h,Stop Loss,$-9.00,$-343.50,$62846.00,120,$-343.50
2024-06-17,11:01:00,19974.25,BUY,3,0.02h,Break Even,$-1.50,$-345.00,$62844.50,120,$-345.00
2024-06-17,11:36:00,19973.25,SELL,3,0.02h,Break Even,$-1.50,$-346.50,$62843.00,120,$-346.50
2024-06-17,11:40:00,19982.5,BUY,3,0.02h,Stop Loss,$-9.00,$-355.50,$62834.00,120,$-355.50
2024-06-17,11:56:00,19979.75,SELL,3,0.02h,Break Even,$-1.50,$-357.00,$62832.50,120,$-357.00
2024-06-17,12:10:00,19982.25,BUY,3,0.02h,Break Even,$-1.50,$-358.50,$62831.00,120,$-358.50
2024-06-17,12:19:00,19976.75,SELL,3,0.02h,Stop Loss,$-9.00,$-367.50,$62822.00,120,$-367.50
2024-06-17,13:29:00,19954.0,BUY,3,0.02h,Stop Loss,$12.00,$-355.50,$62834.00,120,$-355.50
2024-06-17,13:35:00,19940.25,SELL,3,0.02h,Stop Loss,$51.00,$-304.50,$62885.00,120,$-304.50
2024-06-17,13:42:00,19953.0,BUY,3,0.02h,Break Even,$-1.50,$-306.00,$62883.50,120,$-306.00
2024-06-17,13:43:00,19947.75,SELL,3,0.02h,Stop Loss,$40.50,$-265.50,$62924.00,120,$-265.50
2024-06-17,14:00:00,19954.5,BUY,3,0.02h,Break Even,$-1.50,$-267.00,$62922.50,120,$-267.00
2024-06-17,14:27:00,19946.5,SELL,3,0.02h,Stop Loss,$30.00,$-237.00,$62952.50,120,$-237.00
2024-06-17,14:36:00,19968.5,BUY,3,0.02h,Break Even,$-1.50,$-238.50,$62951.00,120,$-238.50
2024-06-17,14:51:00,19960.5,SELL,3,0.02h,Stop Loss,$19.50,$-219.00,$62970.50,120,$-219.00
2024-06-17,14:58:00,19973.0,BUY,3,0.02h,Break Even,$-1.50,$-220.50,$62969.00,120,$-220.50
2024-06-17,15:56:00,20002.25,SELL,3,0.02h,Stop Loss,$-9.00,$-229.50,$62960.00,120,$-229.50
2024-06-17,15:57:00,20014.0,BUY,3,0.02h,Break Even,$-1.50,$-231.00,$62958.50,120,$-231.00
2024-06-17,15:58:00,20009.5,SELL,3,0.02h,Stop Loss,$-9.00,$-240.00,$62949.50,120,$-240.00
2024-06-17,16:00:00,20015.0,BUY,3,0.02h,Stop Loss,$16.50,$-223.50,$62966.00,120,$-223.50
2024-06-17,18:19:00,20225.75,SELL,3,0.02h,Break Even,$-1.50,$-225.00,$62964.50,120,$-225.00
2024-06-17,18:30:00,20240.25,BUY,3,0.02h,Stop Loss,$9.00,$-216.00,$62973.50,120,$-216.00
2024-06-17,18:41:00,20234.25,SELL,3,0.02h,Break Even,$-1.50,$-217.50,$62972.00,120,$-217.50
2024-06-17,19:12:00,20236.75,BUY,3,0.02h,Break Even,$-1.50,$-219.00,$62970.50,120,$-219.00
2024-06-17,19:37:00,20239.75,SELL,3,0.02h,Break Even,$-1.50,$-220.50,$62969.00,120,$-220.50
2024-06-17,20:30:00,20181.75,BUY,3,0.02h,Stop Loss,$-9.00,$-229.50,$62960.00,120,$-229.50
2024-06-17,20:36:00,20179.75,SELL,3,0.02h,Stop Loss,$-9.00,$-238.50,$62951.00,120,$-238.50
2024-06-17,20:43:00,20183.25,BUY,3,0.03h,Break Even,$-1.50,$-240.00,$62949.50,120,$-240.00
2024-06-17,20:50:00,20178.75,SELL,3,0.02h,Stop Loss,$-9.00,$-249.00,$62940.50,120,$-249.00
2024-06-17,20:56:00,20182.75,BUY,3,0.05h,Break Even,$-1.50,$-250.50,$62939.00,120,$-250.50
2024-06-17,23:45:00,20203.25,SELL,3,0.02h,Break Even,$-1.50,$-252.00,$62937.50,120,$-252.00
2024-06-17,23:50:00,20205.75,BUY,3,0.02h,Stop Loss,$-9.00,$-261.00,$62928.50,120,$-261.00
2024-06-17,23:52:00,20203.5,SELL,3,0.02h,Stop Loss,$-9.00,$-270.00,$62919.50,120,$-270.00
2024-06-17,23:56:00,20206.0,BUY,3,0.02h,Break Even,$-1.50,$-271.50,$62918.00,120,$-271.50
,,,,,,,,,,,
2024-06-18,00:01:00,20200.0,SELL,3,0.02h,Stop Loss,$-9.00,$-9.00,$62909.00,121,$-9.00
2024-06-18,00:54:00,20187.25,BUY,3,0.03h,Stop Loss,$-9.00,$-18.00,$62900.00,121,$-18.00
2024-06-18,01:08:00,20172.5,SELL,3,0.02h,Stop Loss,$-9.00,$-27.00,$62891.00,121,$-27.00
2024-06-18,01:32:00,20179.25,BUY,3,0.02h,Break Even,$-1.50,$-28.50,$62889.50,121,$-28.50
2024-06-18,01:43:00,20173.0,SELL,3,0.02h,Break Even,$-1.50,$-30.00,$62888.00,121,$-30.00
2024-06-18,01:49:00,20176.0,BUY,3,0.02h,Stop Loss,$-9.00,$-39.00,$62879.00,121,$-39.00
2024-06-18,01:50:00,20171.25,SELL,3,0.02h,Break Even,$-1.50,$-40.50,$62877.50,121,$-40.50
2024-06-18,02:09:00,20173.25,BUY,3,0.02h,Stop Loss,$-9.00,$-49.50,$62868.50,121,$-49.50
2024-06-18,02:46:00,20174.5,SELL,3,0.02h,Break Even,$-1.50,$-51.00,$62867.00,121,$-51.00
2024-06-18,02:56:00,20177.5,BUY,3,0.02h,Break Even,$-1.50,$-52.50,$62865.50,121,$-52.50
2024-06-18,03:02:00,19910.75,SELL,3,0.03h,Stop Loss,$-9.00,$-61.50,$62856.50,121,$-61.50
2024-06-18,03:16:00,20186.0,BUY,3,0.02h,Stop Loss,$-9.00,$-70.50,$62847.50,121,$-70.50
2024-06-18,03:17:00,19916.5,SELL,3,0.02h,Stop Loss,$-9.00,$-79.50,$62838.50,121,$-79.50
2024-06-18,03:22:00,20191.25,BUY,3,0.02h,Stop Loss,$-9.00,$-88.50,$62829.50,121,$-88.50
2024-06-18,03:23:00,19920.5,SELL,3,0.02h,Stop Loss,$-9.00,$-97.50,$62820.50,121,$-97.50
2024-06-18,03:24:00,20192.25,BUY,3,0.02h,Stop Loss,$-9.00,$-106.50,$62811.50,121,$-106.50
2024-06-18,03:25:00,19922.75,SELL,3,0.02h,Stop Loss,$-9.00,$-115.50,$62802.50,121,$-115.50
2024-06-18,03:31:00,20188.75,BUY,3,0.02h,Stop Loss,$-9.00,$-124.50,$62793.50,121,$-124.50
2024-06-18,03:34:00,19913.5,SELL,3,0.02h,Stop Loss,$-9.00,$-133.50,$62784.50,121,$-133.50
2024-06-18,03:35:00,20183.25,BUY,3,0.02h,Stop Loss,$-9.00,$-142.50,$62775.50,121,$-142.50
2024-06-18,03:36:00,19913.5,SELL,3,0.02h,Stop Loss,$-9.00,$-151.50,$62766.50,121,$-151.50
2024-06-18,03:37:00,20183.25,BUY,3,0.02h,Stop Loss,$-9.00,$-160.50,$62757.50,121,$-160.50
2024-06-18,03:38:00,19912.25,SELL,3,0.02h,Stop Loss,$-9.00,$-169.50,$62748.50,121,$-169.50
2024-06-18,03:39:00,20182.5,BUY,3,0.02h,Break Even,$-1.50,$-171.00,$62747.00,121,$-171.00
2024-06-18,03:43:00,19914.0,SELL,3,0.05h,Break Even,$-1.50,$-172.50,$62745.50,121,$-172.50
2024-06-18,03:52:00,20182.75,BUY,3,0.02h,Stop Loss,$-9.00,$-181.50,$62736.50,121,$-181.50
2024-06-18,03:53:00,19913.5,SELL,3,0.05h,Break Even,$-1.50,$-183.00,$62735.00,121,$-183.00
2024-06-18,03:56:00,20182.5,BUY,3,0.02h,Stop Loss,$-9.00,$-192.00,$62726.00,121,$-192.00
2024-06-18,03:57:00,19911.75,SELL,3,0.02h,Stop Loss,$-9.00,$-201.00,$62717.00,121,$-201.00
2024-06-18,03:58:00,20183.25,BUY,3,0.03h,Break Even,$-1.50,$-202.50,$62715.50,121,$-202.50
2024-06-18,04:01:00,19913.0,SELL,3,0.03h,Stop Loss,$-9.00,$-211.50,$62706.50,121,$-211.50
2024-06-18,04:03:00,20185.25,BUY,3,0.02h,Stop Loss,$-9.00,$-220.50,$62697.50,121,$-220.50
2024-06-18,04:04:00,19916.0,SELL,3,0.02h,Stop Loss,$-9.00,$-229.50,$62688.50,121,$-229.50
2024-06-18,04:07:00,20186.0,BUY,3,0.02h,Stop Loss,$-9.00,$-238.50,$62679.50,121,$-238.50
2024-06-18,04:08:00,19914.75,SELL,3,0.03h,Stop Loss,$-9.00,$-247.50,$62670.50,121,$-247.50
2024-06-18,04:14:00,20184.5,BUY,3,0.02h,Stop Loss,$-9.00,$-256.50,$62661.50,121,$-256.50
2024-06-18,04:15:00,19914.0,SELL,3,0.03h,Break Even,$-1.50,$-258.00,$62660.00,121,$-258.00
2024-06-18,04:20:00,20182.5,BUY,3,0.02h,Stop Loss,$-9.00,$-267.00,$62651.00,121,$-267.00
2024-06-18,04:21:00,19912.0,SELL,3,0.05h,Stop Loss,$-9.00,$-276.00,$62642.00,121,$-276.00
2024-06-18,04:24:00,20183.0,BUY,3,0.02h,Stop Loss,$-9.00,$-285.00,$62633.00,121,$-285.00
2024-06-18,04:26:00,19911.0,SELL,3,0.03h,Stop Loss,$-9.00,$-294.00,$62624.00,121,$-294.00
2024-06-18,04:28:00,20179.75,BUY,3,0.02h,Stop Loss,$-9.00,$-303.00,$62615.00,121,$-303.00
2024-06-18,04:30:00,19908.5,SELL,3,0.02h,Stop Loss,$9.00,$-294.00,$62624.00,121,$-294.00
2024-06-18,04:35:00,20175.5,BUY,3,0.02h,Break Even,$-1.50,$-295.50,$62622.50,121,$-295.50
2024-06-18,04:42:00,19910.25,SELL,3,0.03h,Stop Loss,$-9.00,$-304.50,$62613.50,121,$-304.50
2024-06-18,04:44:00,20180.25,BUY,3,0.03h,Stop Loss,$-9.00,$-313.50,$62604.50,121,$-313.50
2024-06-18,04:54:00,19907.5,SELL,3,0.02h,Stop Loss,$-9.00,$-322.50,$62595.50,121,$-322.50
2024-06-18,04:55:00,20180.0,BUY,3,0.02h,Stop Loss,$-9.00,$-331.50,$62586.50,121,$-331.50
2024-06-18,04:56:00,19909.75,SELL,3,0.02h,Stop Loss,$-9.00,$-340.50,$62577.50,121,$-340.50
2024-06-18,04:57:00,20179.0,BUY,3,0.02h,Stop Loss,$-9.00,$-349.50,$62568.50,121,$-349.50
2024-06-18,04:58:00,19905.75,SELL,3,0.02h,Stop Loss,$-9.00,$-358.50,$62559.50,121,$-358.50
2024-06-18,05:02:00,20174.5,BUY,3,0.03h,Break Even,$-1.50,$-360.00,$62558.00,121,$-360.00
2024-06-18,05:08:00,19907.25,SELL,3,0.02h,Stop Loss,$-9.00,$-369.00,$62549.00,121,$-369.00
2024-06-18,05:12:00,20177.5,BUY,3,0.08h,Break Even,$-1.50,$-370.50,$62547.50,121,$-370.50
2024-06-18,05:31:00,19915.5,SELL,3,0.02h,Stop Loss,$-9.00,$-379.50,$62538.50,121,$-379.50
2024-06-18,05:32:00,20185.5,BUY,3,0.02h,Stop Loss,$-9.00,$-388.50,$62529.50,121,$-388.50
2024-06-18,05:33:00,19915.0,SELL,3,0.03h,Stop Loss,$-9.00,$-397.50,$62520.50,121,$-397.50
2024-06-18,05:46:00,20183.0,BUY,3,0.03h,Break Even,$-1.50,$-399.00,$62519.00,121,$-399.00
2024-06-18,05:54:00,19918.0,SELL,3,0.02h,Stop Loss,$-9.00,$-408.00,$62510.00,121,$-408.00
2024-06-18,05:57:00,20189.0,BUY,3,0.02h,Stop Loss,$-9.00,$-417.00,$62501.00,121,$-417.00
2024-06-18,05:58:00,19918.5,SELL,3,0.03h,Stop Loss,$-9.00,$-426.00,$62492.00,121,$-426.00
2024-06-18,06:12:00,20190.0,BUY,3,0.02h,Stop Loss,$-9.00,$-435.00,$62483.00,121,$-435.00
2024-06-18,06:13:00,19918.75,SELL,3,0.02h,Stop Loss,$-9.00,$-444.00,$62474.00,121,$-444.00
2024-06-18,06:14:00,20188.75,BUY,3,0.02h,Stop Loss,$-9.00,$-453.00,$62465.00,121,$-453.00
2024-06-18,06:19:00,19923.0,SELL,3,0.02h,Stop Loss,$-9.00,$-462.00,$62456.00,121,$-462.00
2024-06-18,06:20:00,20193.0,BUY,3,0.02h,Break Even,$-1.50,$-463.50,$62454.50,121,$-463.50
2024-06-18,06:30:00,19922.5,SELL,3,0.02h,Stop Loss,$-9.00,$-472.50,$62445.50,121,$-472.50
2024-06-18,06:35:00,20198.25,BUY,3,0.02h,Stop Loss,$-9.00,$-481.50,$62436.50,121,$-481.50
2024-06-18,06:36:00,19929.25,SELL,3,0.02h,Stop Loss,$-9.00,$-490.50,$62427.50,121,$-490.50
2024-06-18,06:37:00,20199.25,BUY,3,0.02h,Stop Loss,$-9.00,$-499.50,$62418.50,121,$-499.50
2024-06-18,06:38:00,19929.75,SELL,3,0.02h,Stop Loss,$-9.00,$-508.50,$62409.50,121,$-508.50
2024-06-18,06:39:00,20199.0,BUY,3,0.02h,Stop Loss,$-9.00,$-517.50,$62400.50,121,$-517.50
2024-06-18,06:46:00,19924.5,SELL,3,0.02h,Stop Loss,$-9.00,$-526.50,$62391.50,121,$-526.50
2024-06-18,06:47:00,20193.5,BUY,3,0.02h,Stop Loss,$-9.00,$-535.50,$62382.50,121,$-535.50
2024-06-18,06:48:00,19922.25,SELL,3,0.02h,Break Even,$-1.50,$-537.00,$62381.00,121,$-537.00
2024-06-18,06:57:00,20195.5,BUY,3,0.02h,Break Even,$-1.50,$-538.50,$62379.50,121,$-538.50
2024-06-18,07:03:00,19929.25,SELL,3,0.02h,Stop Loss,$15.00,$-523.50,$62394.50,121,$-523.50
2024-06-18,07:06:00,20192.0,BUY,3,0.02h,Break Even,$-1.50,$-525.00,$62393.00,121,$-525.00
2024-06-18,07:12:00,19931.0,SELL,3,0.03h,Break Even,$-1.50,$-526.50,$62391.50,121,$-526.50
2024-06-18,07:16:00,20200.5,BUY,3,0.02h,Stop Loss,$-9.00,$-535.50,$62382.50,121,$-535.50
2024-06-18,07:17:00,19926.5,SELL,3,0.02h,Stop Loss,$7.50,$-528.00,$62390.00,121,$-528.00
2024-06-18,07:21:00,20200.0,BUY,3,0.02h,Stop Loss,$-9.00,$-537.00,$62381.00,121,$-537.00
2024-06-18,07:22:00,19930.0,SELL,3,0.02h,Stop Loss,$-9.00,$-546.00,$62372.00,121,$-546.00
2024-06-18,07:23:00,20199.75,BUY,3,0.02h,Break Even,$-1.50,$-547.50,$62370.50,121,$-547.50
2024-06-18,07:29:00,19929.75,SELL,3,0.02h,Stop Loss,$-9.00,$-556.50,$62361.50,121,$-556.50
2024-06-18,07:30:00,20199.25,BUY,3,0.02h,Stop Loss,$12.00,$-544.50,$62373.50,121,$-544.50
2024-06-18,07:32:00,19931.75,SELL,3,0.02h,Stop Loss,$-9.00,$-553.50,$62364.50,121,$-553.50
2024-06-18,07:33:00,20208.25,BUY,3,0.02h,Stop Loss,$-9.00,$-562.50,$62355.50,121,$-562.50
2024-06-18,07:34:00,19934.0,SELL,3,0.02h,Stop Loss,$-9.00,$-571.50,$62346.50,121,$-571.50
2024-06-18,07:46:00,20214.5,BUY,3,0.02h,Stop Loss,$-9.00,$-580.50,$62337.50,121,$-580.50
2024-06-18,07:49:00,19939.0,SELL,3,0.03h,Break Even,$-1.50,$-582.00,$62336.00,121,$-582.00
2024-06-18,07:53:00,20207.0,BUY,3,0.02h,Break Even,$-1.50,$-583.50,$62334.50,121,$-583.50
2024-06-18,07:57:00,19930.25,SELL,3,0.02h,Stop Loss,$-9.00,$-592.50,$62325.50,121,$-592.50
2024-06-18,07:58:00,20202.25,BUY,3,0.02h,Stop Loss,$-9.00,$-601.50,$62316.50,121,$-601.50
2024-06-18,07:59:00,19930.75,SELL,3,0.02h,Stop Loss,$-9.00,$-610.50,$62307.50,121,$-610.50
2024-06-18,08:03:00,20211.75,BUY,3,0.02h,Stop Loss,$-9.00,$-619.50,$62298.50,121,$-619.50
2024-06-18,08:04:00,19943.0,SELL,3,0.02h,Break Even,$-1.50,$-621.00,$62297.00,121,$-621.00
2024-06-18,08:07:00,20217.0,BUY,3,0.02h,Stop Loss,$-9.00,$-630.00,$62288.00,121,$-630.00
2024-06-18,08:14:00,19948.5,SELL,3,0.02h,Stop Loss,$-9.00,$-639.00,$62279.00,121,$-639.00
2024-06-18,08:15:00,20219.25,BUY,3,0.02h,Stop Loss,$7.50,$-631.50,$62286.50,121,$-631.50
2024-06-18,08:18:00,19947.75,SELL,3,0.02h,Break Even,$-1.50,$-633.00,$62285.00,121,$-633.00
2024-06-18,08:25:00,20215.0,BUY,3,0.02h,Stop Loss,$-9.00,$-642.00,$62276.00,121,$-642.00
2024-06-18,08:26:00,19944.75,SELL,3,0.02h,Stop Loss,$-9.00,$-651.00,$62267.00,121,$-651.00
2024-06-18,08:27:00,20218.0,BUY,3,0.02h,Stop Loss,$-9.00,$-660.00,$62258.00,121,$-660.00
2024-06-18,08:28:00,19944.0,SELL,3,0.02h,Break Even,$-1.50,$-661.50,$62256.50,121,$-661.50
2024-06-18,08:35:00,20218.5,BUY,3,0.02h,Stop Loss,$-9.00,$-670.50,$62247.50,121,$-670.50
2024-06-18,08:36:00,19943.5,SELL,3,0.02h,Stop Loss,$-9.00,$-679.50,$62238.50,121,$-679.50
2024-06-18,08:37:00,20217.5,BUY,3,0.02h,Stop Loss,$-9.00,$-688.50,$62229.50,121,$-688.50
2024-06-18,08:39:00,19943.0,SELL,3,0.02h,Stop Loss,$-9.00,$-697.50,$62220.50,121,$-697.50
2024-06-18,08:40:00,20219.0,BUY,3,0.02h,Stop Loss,$-9.00,$-706.50,$62211.50,121,$-706.50
2024-06-18,08:42:00,19945.5,SELL,3,0.02h,Break Even,$-1.50,$-708.00,$62210.00,121,$-708.00
2024-06-18,08:47:00,20224.75,BUY,3,0.03h,Stop Loss,$-9.00,$-717.00,$62201.00,121,$-717.00
2024-06-18,09:00:00,19953.25,SELL,3,0.02h,Stop Loss,$-9.00,$-726.00,$62192.00,121,$-726.00
2024-06-18,09:01:00,20228.75,BUY,3,0.02h,Stop Loss,$-9.00,$-735.00,$62183.00,121,$-735.00
2024-06-18,09:02:00,19958.75,SELL,3,0.02h,Stop Loss,$-9.00,$-744.00,$62174.00,121,$-744.00
2024-06-18,09:07:00,20241.5,BUY,3,0.02h,Break Even,$-1.50,$-745.50,$62172.50,121,$-745.50
2024-06-18,09:19:00,19963.75,SELL,3,0.02h,Break Even,$-1.50,$-747.00,$62171.00,121,$-747.00
2024-06-18,09:22:00,20236.75,BUY,3,0.02h,Stop Loss,$-9.00,$-756.00,$62162.00,121,$-756.00
2024-06-18,09:24:00,19964.0,SELL,3,0.02h,Stop Loss,$3.00,$-753.00,$62165.00,121,$-753.00
2024-06-18,09:27:00,20229.0,BUY,3,0.02h,Stop Loss,$-9.00,$-762.00,$62156.00,121,$-762.00
2024-06-18,09:28:00,19951.5,SELL,3,0.02h,Stop Loss,$-9.00,$-771.00,$62147.00,121,$-771.00
2024-06-18,09:38:00,20232.25,BUY,3,0.02h,Stop Loss,$-9.00,$-780.00,$62138.00,121,$-780.00
2024-06-18,09:43:00,19957.75,SELL,3,0.02h,Break Even,$-1.50,$-781.50,$62136.50,121,$-781.50
2024-06-18,09:56:00,20238.75,BUY,3,0.02h,Stop Loss,$-9.00,$-790.50,$62127.50,121,$-790.50
2024-06-18,09:58:00,19960.5,SELL,3,0.02h,Stop Loss,$-9.00,$-799.50,$62118.50,121,$-799.50
2024-06-18,10:01:00,20235.75,BUY,3,0.02h,Break Even,$-1.50,$-801.00,$62117.00,121,$-801.00
2024-06-18,10:05:00,19954.75,SELL,3,0.02h,Stop Loss,$-9.00,$-810.00,$62108.00,121,$-810.00
2024-06-18,10:07:00,20231.25,BUY,3,0.02h,Stop Loss,$-9.00,$-819.00,$62099.00,121,$-819.00
2024-06-18,10:16:00,19956.75,SELL,3,0.02h,Stop Loss,$-9.00,$-828.00,$62090.00,121,$-828.00
2024-06-18,10:25:00,20233.0,BUY,3,0.02h,Break Even,$-1.50,$-829.50,$62088.50,121,$-829.50
2024-06-18,10:31:00,19968.5,SELL,3,0.02h,Break Even,$-1.50,$-831.00,$62087.00,121,$-831.00
2024-06-18,10:35:00,20235.75,BUY,3,0.02h,Stop Loss,$-9.00,$-840.00,$62078.00,121,$-840.00
2024-06-18,10:45:00,19956.0,SELL,3,0.02h,Stop Loss,$-9.00,$-849.00,$62069.00,121,$-849.00
2024-06-18,10:46:00,20228.75,BUY,3,0.02h,Stop Loss,$-9.00,$-858.00,$62060.00,121,$-858.00
2024-06-18,10:47:00,19954.5,SELL,3,0.02h,Stop Loss,$-9.00,$-867.00,$62051.00,121,$-867.00
2024-06-18,10:49:00,20233.25,BUY,3,0.02h,Break Even,$-1.50,$-868.50,$62049.50,121,$-868.50
2024-06-18,11:07:00,19954.0,SELL,3,0.02h,Stop Loss,$-9.00,$-877.50,$62040.50,121,$-877.50
2024-06-18,11:08:00,20227.75,BUY,3,0.02h,Stop Loss,$-9.00,$-886.50,$62031.50,121,$-886.50
2024-06-18,11:10:00,19949.0,SELL,3,0.02h,Stop Loss,$-9.00,$-895.50,$62022.50,121,$-895.50
2024-06-18,11:12:00,20223.5,BUY,3,0.02h,Stop Loss,$-9.00,$-904.50,$62013.50,121,$-904.50
2024-06-18,11:14:00,19945.5,SELL,3,0.02h,Stop Loss,$-9.00,$-913.50,$62004.50,121,$-913.50
2024-06-18,11:20:00,20218.0,BUY,3,0.02h,Stop Loss,$-9.00,$-922.50,$61995.50,121,$-922.50
2024-06-18,11:21:00,19942.25,SELL,3,0.02h,Stop Loss,$-9.00,$-931.50,$61986.50,121,$-931.50
2024-06-18,11:29:00,20219.25,BUY,3,0.02h,Stop Loss,$-9.00,$-940.50,$61977.50,121,$-940.50
2024-06-18,11:30:00,19946.75,SELL,3,0.02h,Stop Loss,$-9.00,$-949.50,$61968.50,121,$-949.50
2024-06-18,11:31:00,20220.5,BUY,3,0.02h,Stop Loss,$-9.00,$-958.50,$61959.50,121,$-958.50
2024-06-18,11:32:00,19946.5,SELL,3,0.02h,Stop Loss,$-9.00,$-967.50,$61950.50,121,$-967.50
2024-06-18,11:33:00,20221.5,BUY,3,0.02h,Stop Loss,$-9.00,$-976.50,$61941.50,121,$-976.50
2024-06-18,11:34:00,19949.0,SELL,3,0.02h,Stop Loss,$-9.00,$-985.50,$61932.50,121,$-985.50
2024-06-18,11:43:00,20214.0,BUY,3,0.02h,Break Even,$-1.50,$-987.00,$61931.00,121,$-987.00
2024-06-18,12:05:00,19949.75,SELL,3,0.02h,Stop Loss,$-9.00,$-996.00,$61922.00,121,$-996.00
2024-06-18,12:06:00,20231.5,BUY,3,0.02h,Break Even,$-1.50,$-997.50,$61920.50,121,$-997.50
2024-06-18,12:09:00,19957.5,SELL,3,0.02h,Break Even,$-1.50,$-999.00,$61919.00,121,$-999.00
2024-06-18,12:21:00,20230.5,BUY,3,0.02h,Stop Loss,$-9.00,$-1008.00,$61910.00,121,$-1008.00
2024-06-18,12:22:00,19955.5,SELL,3,0.02h,Stop Loss,$-9.00,$-1017.00,$61901.00,121,$-1017.00
2024-06-18,12:25:00,20238.0,BUY,3,0.02h,Stop Loss,$-9.00,$-1026.00,$61892.00,121,$-1026.00
2024-06-18,12:32:00,19959.0,SELL,3,0.02h,Stop Loss,$13.50,$-1012.50,$61905.50,121,$-1012.50
2024-06-18,12:43:00,20202.75,BUY,3,0.02h,Stop Loss,$-9.00,$-1021.50,$61896.50,121,$-1021.50
2024-06-18,13:02:00,19922.0,SELL,3,0.02h,Stop Loss,$-9.00,$-1030.50,$61887.50,121,$-1030.50
2024-06-18,13:03:00,20201.75,BUY,3,0.02h,Stop Loss,$-9.00,$-1039.50,$61878.50,121,$-1039.50
2024-06-18,13:06:00,19923.75,SELL,3,0.02h,Stop Loss,$-9.00,$-1048.50,$61869.50,121,$-1048.50
2024-06-18,13:17:00,20199.25,BUY,3,0.02h,Break Even,$-1.50,$-1050.00,$61868.00,121,$-1050.00
2024-06-18,13:19:00,19933.25,SELL,3,0.02h,Stop Loss,$-9.00,$-1059.00,$61859.00,121,$-1059.00
2024-06-18,13:20:00,20204.5,BUY,3,0.02h,Break Even,$-1.50,$-1060.50,$61857.50,121,$-1060.50
2024-06-18,13:23:00,19929.75,SELL,3,0.02h,Stop Loss,$-9.00,$-1069.50,$61848.50,121,$-1069.50
2024-06-18,13:24:00,20204.75,BUY,3,0.02h,Stop Loss,$-9.00,$-1078.50,$61839.50,121,$-1078.50
2024-06-18,13:28:00,19926.0,SELL,3,0.02h,Stop Loss,$-9.00,$-1087.50,$61830.50,121,$-1087.50
2024-06-18,13:36:00,20213.75,BUY,3,0.02h,Stop Loss,$-9.00,$-1096.50,$61821.50,121,$-1096.50
2024-06-18,13:41:00,19921.0,SELL,3,0.02h,Stop Loss,$-9.00,$-1105.50,$61812.50,121,$-1105.50
2024-06-18,13:42:00,20193.5,BUY,3,0.02h,Stop Loss,$-9.00,$-1114.50,$61803.50,121,$-1114.50
2024-06-18,13:43:00,19916.0,SELL,3,0.02h,Stop Loss,$-9.00,$-1123.50,$61794.50,121,$-1123.50
2024-06-18,13:44:00,20184.75,BUY,3,0.02h,Stop Loss,$40.50,$-1083.00,$61835.00,121,$-1083.00
2024-06-18,13:53:00,19894.0,SELL,3,0.02h,Stop Loss,$-9.00,$-1092.00,$61826.00,121,$-1092.00
2024-06-18,13:55:00,20183.5,BUY,3,0.02h,Break Even,$-1.50,$-1093.50,$61824.50,121,$-1093.50
2024-06-18,13:57:00,19916.5,SELL,3,0.02h,Stop Loss,$-9.00,$-1102.50,$61815.50,121,$-1102.50
2024-06-18,14:12:00,20208.75,BUY,3,0.02h,Stop Loss,$-9.00,$-1111.50,$61806.50,121,$-1111.50
2024-06-18,14:22:00,19909.5,SELL,3,0.02h,Stop Loss,$12.00,$-1099.50,$61818.50,121,$-1099.50
2024-06-18,14:27:00,20182.0,BUY,3,0.02h,Stop Loss,$-9.00,$-1108.50,$61809.50,121,$-1108.50
2024-06-18,14:28:00,19908.25,SELL,3,0.02h,Stop Loss,$-9.00,$-1117.50,$61800.50,121,$-1117.50
2024-06-18,14:30:00,20180.0,BUY,3,0.02h,Stop Loss,$10.50,$-1107.00,$61811.00,121,$-1107.00
2024-06-18,14:35:00,19919.5,SELL,3,0.02h,Stop Loss,$30.00,$-1077.00,$61841.00,121,$-1077.00
2024-06-18,14:40:00,20193.0,BUY,3,0.02h,Break Even,$-1.50,$-1078.50,$61839.50,121,$-1078.50
2024-06-18,14:44:00,19896.0,SELL,3,0.02h,Stop Loss,$-9.00,$-1087.50,$61830.50,121,$-1087.50
2024-06-18,14:45:00,20166.75,BUY,3,0.02h,Stop Loss,$-9.00,$-1096.50,$61821.50,121,$-1096.50
2024-06-18,14:51:00,19888.75,SELL,3,0.02h,Stop Loss,$-9.00,$-1105.50,$61812.50,121,$-1105.50
2024-06-18,14:52:00,20164.5,BUY,3,0.02h,Stop Loss,$-9.00,$-1114.50,$61803.50,121,$-1114.50
2024-06-18,14:53:00,19890.75,SELL,3,0.02h,Break Even,$-1.50,$-1116.00,$61802.00,121,$-1116.00
2024-06-18,15:00:00,20162.75,BUY,3,0.02h,Stop Loss,$30.00,$-1086.00,$61832.00,121,$-1086.00
2024-06-18,15:04:00,19889.5,SELL,3,0.02h,Stop Loss,$72.00,$-1014.00,$61904.00,121,$-1014.00
2024-06-18,15:12:00,20139.75,BUY,3,0.02h,Stop Loss,$-9.00,$-1023.00,$61895.00,121,$-1023.00
2024-06-18,15:13:00,19861.0,SELL,3,0.02h,Stop Loss,$-9.00,$-1032.00,$61886.00,121,$-1032.00
2024-06-18,15:14:00,20128.0,BUY,3,0.02h,Stop Loss,$-9.00,$-1041.00,$61877.00,121,$-1041.00
2024-06-18,15:15:00,19859.75,SELL,3,0.02h,Stop Loss,$-9.00,$-1050.00,$61868.00,121,$-1050.00
2024-06-18,15:17:00,20141.25,BUY,3,0.02h,Stop Loss,$4.50,$-1045.50,$61872.50,121,$-1045.50
2024-06-18,15:21:00,19879.0,SELL,3,0.02h,Break Even,$-1.50,$-1047.00,$61871.00,121,$-1047.00
2024-06-18,15:27:00,20153.5,BUY,3,0.02h,Stop Loss,$-9.00,$-1056.00,$61862.00,121,$-1056.00
2024-06-18,15:29:00,19879.0,SELL,3,0.02h,Break Even,$-1.50,$-1057.50,$61860.50,121,$-1057.50
2024-06-18,15:32:00,20156.75,BUY,3,0.02h,Break Even,$-1.50,$-1059.00,$61859.00,121,$-1059.00
2024-06-18,15:38:00,19889.25,SELL,3,0.02h,Break Even,$-1.50,$-1060.50,$61857.50,121,$-1060.50
2024-06-18,15:40:00,20164.0,BUY,3,0.02h,Stop Loss,$-9.00,$-1069.50,$61848.50,121,$-1069.50
2024-06-18,15:41:00,19894.5,SELL,3,0.02h,Stop Loss,$10.50,$-1059.00,$61859.00,121,$-1059.00
2024-06-18,15:44:00,20172.75,BUY,3,0.02h,Break Even,$-1.50,$-1060.50,$61857.50,121,$-1060.50
2024-06-18,15:52:00,19892.25,SELL,3,0.02h,Stop Loss,$-9.00,$-1069.50,$61848.50,121,$-1069.50
2024-06-18,16:02:00,20188.25,BUY,3,0.02h,Stop Loss,$-9.00,$-1078.50,$61839.50,121,$-1078.50
2024-06-18,16:06:00,19917.5,SELL,3,0.02h,Stop Loss,$-9.00,$-1087.50,$61830.50,121,$-1087.50
2024-06-18,16:07:00,20192.25,BUY,3,0.02h,Stop Loss,$-9.00,$-1096.50,$61821.50,121,$-1096.50
2024-06-18,16:19:00,19898.0,SELL,3,0.02h,Stop Loss,$-9.00,$-1105.50,$61812.50,121,$-1105.50
2024-06-18,16:20:00,20175.5,BUY,3,0.02h,Stop Loss,$-9.00,$-1114.50,$61803.50,121,$-1114.50
2024-06-18,16:24:00,19899.0,SELL,3,0.02h,Stop Loss,$-9.00,$-1123.50,$61794.50,121,$-1123.50
2024-06-18,16:25:00,20178.75,BUY,3,0.02h,Stop Loss,$7.50,$-1116.00,$61802.00,121,$-1116.00
2024-06-18,16:29:00,19899.5,SELL,3,0.02h,Stop Loss,$-9.00,$-1125.00,$61793.00,121,$-1125.00
2024-06-18,16:30:00,20177.0,BUY,3,0.02h,Break Even,$-1.50,$-1126.50,$61791.50,121,$-1126.50
2024-06-18,16:32:00,19901.0,SELL,3,0.02h,Stop Loss,$-9.00,$-1135.50,$61782.50,121,$-1135.50
2024-06-18,16:33:00,20179.0,BUY,3,0.02h,Break Even,$-1.50,$-1137.00,$61781.00,121,$-1137.00
2024-06-18,16:35:00,19901.75,SELL,3,0.02h,Stop Loss,$-9.00,$-1146.00,$61772.00,121,$-1146.00
2024-06-18,16:36:00,20181.0,BUY,3,0.02h,Break Even,$-1.50,$-1147.50,$61770.50,121,$-1147.50
2024-06-18,16:40:00,19902.5,SELL,3,0.02h,Break Even,$-1.50,$-1149.00,$61769.00,121,$-1149.00
2024-06-18,16:51:00,20180.5,BUY,3,0.02h,Stop Loss,$13.50,$-1135.50,$61782.50,121,$-1135.50
2024-06-18,17:00:00,19929.0,SELL,3,0.02h,Stop Loss,$-9.00,$-1144.50,$61773.50,121,$-1144.50
2024-06-18,17:01:00,20196.0,BUY,3,0.02h,Stop Loss,$-9.00,$-1153.50,$61764.50,121,$-1153.50
2024-06-18,17:02:00,19921.25,SELL,3,0.02h,Stop Loss,$39.00,$-1114.50,$61803.50,121,$-1114.50
2024-06-18,17:04:00,20196.0,BUY,3,0.02h,Stop Loss,$15.00,$-1099.50,$61818.50,121,$-1099.50
2024-06-18,17:21:00,19926.5,SELL,3,0.02h,Stop Loss,$-9.00,$-1108.50,$61809.50,121,$-1108.50
2024-06-18,17:22:00,20209.5,BUY,3,0.02h,Stop Loss,$-9.00,$-1117.50,$61800.50,121,$-1117.50
2024-06-18,17:23:00,19939.0,SELL,3,0.02h,Stop Loss,$-9.00,$-1126.50,$61791.50,121,$-1126.50
2024-06-18,17:25:00,20209.75,BUY,3,0.02h,Stop Loss,$-9.00,$-1135.50,$61782.50,121,$-1135.50
2024-06-18,17:30:00,19938.25,SELL,3,0.02h,Stop Loss,$-9.00,$-1144.50,$61773.50,121,$-1144.50
2024-06-18,17:31:00,20206.0,BUY,3,0.02h,Break Even,$-1.50,$-1146.00,$61772.00,121,$-1146.00
2024-06-18,17:33:00,19931.75,SELL,3,0.02h,Stop Loss,$-9.00,$-1155.00,$61763.00,121,$-1155.00
2024-06-18,17:37:00,20211.25,BUY,3,0.02h,Break Even,$-1.50,$-1156.50,$61761.50,121,$-1156.50
2024-06-18,17:40:00,19933.0,SELL,3,0.02h,Stop Loss,$-9.00,$-1165.50,$61752.50,121,$-1165.50
2024-06-18,17:47:00,20219.0,BUY,3,0.02h,Stop Loss,$-9.00,$-1174.50,$61743.50,121,$-1174.50
2024-06-18,17:48:00,19947.5,SELL,3,0.02h,Stop Loss,$-9.00,$-1183.50,$61734.50,121,$-1183.50
2024-06-18,17:49:00,20224.25,BUY,3,0.02h,Break Even,$-1.50,$-1185.00,$61733.00,121,$-1185.00
2024-06-18,17:54:00,19944.25,SELL,3,0.02h,Stop Loss,$16.50,$-1168.50,$61749.50,121,$-1168.50
2024-06-18,17:57:00,20213.25,BUY,3,0.02h,Stop Loss,$-9.00,$-1177.50,$61740.50,121,$-1177.50
2024-06-18,18:00:00,19927.0,SELL,3,0.02h,Stop Loss,$-9.00,$-1186.50,$61731.50,121,$-1186.50
2024-06-18,18:01:00,20205.75,BUY,3,0.02h,Stop Loss,$-9.00,$-1195.50,$61722.50,121,$-1195.50
2024-06-18,18:02:00,19916.0,SELL,3,0.02h,Stop Loss,$43.50,$-1152.00,$61766.00,121,$-1152.00
2024-06-18,18:12:00,20195.5,BUY,3,0.02h,Stop Loss,$25.50,$-1126.50,$61791.50,121,$-1126.50
2024-06-18,18:17:00,19915.0,SELL,3,0.02h,Stop Loss,$-9.00,$-1135.50,$61782.50,121,$-1135.50
2024-06-18,18:18:00,20188.25,BUY,3,0.02h,Stop Loss,$-9.00,$-1144.50,$61773.50,121,$-1144.50
2024-06-18,18:26:00,19900.75,SELL,3,0.02h,Stop Loss,$-9.00,$-1153.50,$61764.50,121,$-1153.50
2024-06-18,18:31:00,20191.75,BUY,3,0.02h,Stop Loss,$-9.00,$-1162.50,$61755.50,121,$-1162.50
2024-06-18,18:32:00,19910.5,SELL,3,0.02h,Stop Loss,$-9.00,$-1171.50,$61746.50,121,$-1171.50
2024-06-18,18:37:00,20182.0,BUY,3,0.02h,Stop Loss,$7.50,$-1164.00,$61754.00,121,$-1164.00
2024-06-18,18:41:00,19903.25,SELL,3,0.02h,Stop Loss,$-9.00,$-1173.00,$61745.00,121,$-1173.00
2024-06-18,18:43:00,20187.25,BUY,3,0.02h,Stop Loss,$-9.00,$-1182.00,$61736.00,121,$-1182.00
2024-06-18,18:45:00,19903.5,SELL,3,0.02h,Stop Loss,$-9.00,$-1191.00,$61727.00,121,$-1191.00
2024-06-18,18:46:00,20183.5,BUY,3,0.02h,Break Even,$-1.50,$-1192.50,$61725.50,121,$-1192.50
2024-06-18,18:50:00,19905.0,SELL,3,0.02h,Stop Loss,$-9.00,$-1201.50,$61716.50,121,$-1201.50
2024-06-18,19:00:00,20200.25,BUY,3,0.02h,Stop Loss,$-9.00,$-1210.50,$61707.50,121,$-1210.50
2024-06-18,19:01:00,19923.75,SELL,3,0.02h,Stop Loss,$-9.00,$-1219.50,$61698.50,121,$-1219.50
2024-06-18,19:02:00,20193.5,BUY,3,0.02h,Break Even,$-1.50,$-1221.00,$61697.00,121,$-1221.00
2024-06-18,19:17:00,19921.25,SELL,3,0.02h,Stop Loss,$6.00,$-1215.00,$61703.00,121,$-1215.00
2024-06-18,19:28:00,20199.25,BUY,3,0.02h,Stop Loss,$-9.00,$-1224.00,$61694.00,121,$-1224.00
2024-06-18,19:43:00,19914.5,SELL,3,0.02h,Stop Loss,$-9.00,$-1233.00,$61685.00,121,$-1233.00
2024-06-18,19:46:00,20182.75,BUY,3,0.02h,Stop Loss,$-9.00,$-1242.00,$61676.00,121,$-1242.00
2024-06-18,19:47:00,19905.25,SELL,3,0.02h,Stop Loss,$4.50,$-1237.50,$61680.50,121,$-1237.50
2024-06-18,19:55:00,20200.75,BUY,3,0.02h,Stop Loss,$-9.00,$-1246.50,$61671.50,121,$-1246.50
2024-06-18,19:56:00,19925.25,SELL,3,0.02h,Stop Loss,$-9.00,$-1255.50,$61662.50,121,$-1255.50
2024-06-18,19:57:00,20208.25,BUY,3,0.02h,Stop Loss,$-9.00,$-1264.50,$61653.50,121,$-1264.50
2024-06-18,19:58:00,19920.25,SELL,3,0.02h,Stop Loss,$-9.00,$-1273.50,$61644.50,121,$-1273.50
2024-06-18,19:59:00,20204.0,BUY,3,0.02h,Stop Loss,$-9.00,$-1282.50,$61635.50,121,$-1282.50
2024-06-18,20:00:00,19923.25,SELL,3,0.02h,Stop Loss,$25.50,$-1257.00,$61661.00,121,$-1257.00
2024-06-18,20:12:00,20205.0,BUY,3,0.02h,Break Even,$-1.50,$-1258.50,$61659.50,121,$-1258.50
2024-06-18,20:16:00,19930.0,SELL,3,0.02h,Stop Loss,$-9.00,$-1267.50,$61650.50,121,$-1267.50
2024-06-18,20:17:00,20208.0,BUY,3,0.02h,Stop Loss,$-9.00,$-1276.50,$61641.50,121,$-1276.50
2024-06-18,20:19:00,19928.75,SELL,3,0.02h,Stop Loss,$-9.00,$-1285.50,$61632.50,121,$-1285.50
2024-06-18,20:21:00,20207.0,BUY,3,0.02h,Stop Loss,$-9.00,$-1294.50,$61623.50,121,$-1294.50
2024-06-18,20:22:00,19930.25,SELL,3,0.03h,Break Even,$-1.50,$-1296.00,$61622.00,121,$-1296.00
2024-06-18,20:24:00,20205.0,BUY,3,0.02h,Stop Loss,$-9.00,$-1305.00,$61613.00,121,$-1305.00
2024-06-18,20:25:00,19929.75,SELL,3,0.02h,Stop Loss,$-9.00,$-1314.00,$61604.00,121,$-1314.00
2024-06-18,20:26:00,20206.25,BUY,3,0.02h,Stop Loss,$-9.00,$-1323.00,$61595.00,121,$-1323.00
2024-06-18,20:28:00,19929.75,SELL,3,0.02h,Stop Loss,$-9.00,$-1332.00,$61586.00,121,$-1332.00
2024-06-18,20:31:00,20207.25,BUY,3,0.02h,Stop Loss,$-9.00,$-1341.00,$61577.00,121,$-1341.00
2024-06-18,20:32:00,19931.0,SELL,3,0.02h,Stop Loss,$-9.00,$-1350.00,$61568.00,121,$-1350.00
2024-06-18,20:33:00,20206.5,BUY,3,0.02h,Stop Loss,$-9.00,$-1359.00,$61559.00,121,$-1359.00
2024-06-18,20:43:00,19928.5,SELL,3,0.02h,Stop Loss,$-9.00,$-1368.00,$61550.00,121,$-1368.00
2024-06-18,20:44:00,20204.75,BUY,3,0.02h,Stop Loss,$-9.00,$-1377.00,$61541.00,121,$-1377.00
2024-06-18,20:45:00,19928.75,SELL,3,0.02h,Break Even,$-1.50,$-1378.50,$61539.50,121,$-1378.50
2024-06-18,20:48:00,20203.0,BUY,3,0.03h,Stop Loss,$-9.00,$-1387.50,$61530.50,121,$-1387.50
2024-06-18,20:51:00,19928.25,SELL,3,0.02h,Break Even,$-1.50,$-1389.00,$61529.00,121,$-1389.00
2024-06-18,20:55:00,20204.75,BUY,3,0.02h,Stop Loss,$-9.00,$-1398.00,$61520.00,121,$-1398.00
2024-06-18,20:56:00,19928.25,SELL,3,0.02h,Stop Loss,$-9.00,$-1407.00,$61511.00,121,$-1407.00
2024-06-18,21:00:00,20209.25,BUY,3,2.02h,Stop Loss,$102.00,$-1305.00,$61613.00,121,$-1305.00
2024-06-18,23:02:00,19947.25,SELL,3,0.02h,Stop Loss,$-9.00,$-1314.00,$61604.00,121,$-1314.00
2024-06-18,23:11:00,20225.0,BUY,3,0.02h,Stop Loss,$-9.00,$-1323.00,$61595.00,121,$-1323.00
2024-06-18,23:13:00,19948.0,SELL,3,0.02h,Stop Loss,$-9.00,$-1332.00,$61586.00,121,$-1332.00
2024-06-18,23:14:00,20226.5,BUY,3,0.05h,Stop Loss,$-9.00,$-1341.00,$61577.00,121,$-1341.00
2024-06-18,23:21:00,19946.75,SELL,3,0.02h,Stop Loss,$-9.00,$-1350.00,$61568.00,121,$-1350.00
2024-06-18,23:22:00,20223.5,BUY,3,0.03h,Stop Loss,$-9.00,$-1359.00,$61559.00,121,$-1359.00
2024-06-18,23:33:00,19941.0,SELL,3,0.02h,Stop Loss,$-9.00,$-1368.00,$61550.00,121,$-1368.00
2024-06-18,23:42:00,20221.75,BUY,3,0.02h,Stop Loss,$-9.00,$-1377.00,$61541.00,121,$-1377.00
2024-06-18,23:43:00,19945.75,SELL,3,0.05h,Stop Loss,$-9.00,$-1386.00,$61532.00,121,$-1386.00
2024-06-18,23:48:00,20222.25,BUY,3,0.07h,Break Even,$-1.50,$-1387.50,$61530.50,121,$-1387.50
2024-06-18,23:58:00,19947.25,SELL,3,0.02h,Stop Loss,$-9.00,$-1396.50,$61521.50,121,$-1396.50
2024-06-18,23:59:00,20224.25,BUY,3,0.02h,Stop Loss,$-9.00,$-1405.50,$61512.50,121,$-1405.50
,,,,,,,,,,,
2024-06-19,00:01:00,19943.75,SELL,3,0.02h,Break Even,$-1.50,$-1.50,$61511.00,122,$-1.50
2024-06-19,00:13:00,20218.0,BUY,3,0.02h,Stop Loss,$-9.00,$-10.50,$61502.00,122,$-10.50
2024-06-19,00:16:00,19941.5,SELL,3,0.02h,Stop Loss,$-9.00,$-19.50,$61493.00,122,$-19.50
2024-06-19,00:17:00,20219.0,BUY,3,0.03h,Stop Loss,$-9.00,$-28.50,$61484.00,122,$-28.50
2024-06-19,00:22:00,19936.75,SELL,3,0.02h,Break Even,$-1.50,$-30.00,$61482.50,122,$-30.00
2024-06-19,00:26:00,20215.75,BUY,3,0.02h,Stop Loss,$-9.00,$-39.00,$61473.50,122,$-39.00
2024-06-19,00:30:00,19932.75,SELL,3,0.02h,Stop Loss,$-9.00,$-48.00,$61464.50,122,$-48.00
2024-06-19,00:31:00,20211.5,BUY,3,0.03h,Stop Loss,$-9.00,$-57.00,$61455.50,122,$-57.00
2024-06-19,00:33:00,19935.0,SELL,3,0.02h,Break Even,$-1.50,$-58.50,$61454.00,122,$-58.50
2024-06-19,00:38:00,20211.75,BUY,3,0.02h,Stop Loss,$-9.00,$-67.50,$61445.00,122,$-67.50
2024-06-19,00:43:00,19935.75,SELL,3,0.02h,Stop Loss,$-9.00,$-76.50,$61436.00,122,$-76.50
2024-06-19,00:44:00,20213.0,BUY,3,0.02h,Stop Loss,$-9.00,$-85.50,$61427.00,122,$-85.50
2024-06-19,00:45:00,19936.75,SELL,3,0.02h,Stop Loss,$-9.00,$-94.50,$61418.00,122,$-94.50
2024-06-19,00:50:00,20216.25,BUY,3,0.03h,Stop Loss,$-9.00,$-103.50,$61409.00,122,$-103.50
2024-06-19,00:54:00,19938.0,SELL,3,0.03h,Stop Loss,$-9.00,$-112.50,$61400.00,122,$-112.50
2024-06-19,00:58:00,20214.75,BUY,3,0.02h,Stop Loss,$-9.00,$-121.50,$61391.00,122,$-121.50
2024-06-19,00:59:00,19935.25,SELL,3,0.02h,Stop Loss,$-9.00,$-130.50,$61382.00,122,$-130.50
2024-06-19,01:00:00,20212.0,BUY,3,0.02h,Break Even,$-1.50,$-132.00,$61380.50,122,$-132.00
2024-06-19,01:05:00,19936.5,SELL,3,0.02h,Stop Loss,$-9.00,$-141.00,$61371.50,122,$-141.00
2024-06-19,01:06:00,20214.0,BUY,3,0.02h,Stop Loss,$-9.00,$-150.00,$61362.50,122,$-150.00
2024-06-19,01:17:00,19936.0,SELL,3,0.02h,Stop Loss,$-9.00,$-159.00,$61353.50,122,$-159.00
2024-06-19,01:18:00,20212.25,BUY,3,0.02h,Stop Loss,$-9.00,$-168.00,$61344.50,122,$-168.00
2024-06-19,01:19:00,19935.5,SELL,3,0.02h,Stop Loss,$-9.00,$-177.00,$61335.50,122,$-177.00
2024-06-19,01:29:00,20210.75,BUY,3,0.02h,Stop Loss,$-9.00,$-186.00,$61326.50,122,$-186.00
2024-06-19,01:30:00,19934.5,SELL,3,0.02h,Stop Loss,$-9.00,$-195.00,$61317.50,122,$-195.00
2024-06-19,01:31:00,20212.75,BUY,3,0.03h,Stop Loss,$-9.00,$-204.00,$61308.50,122,$-204.00
2024-06-19,01:43:00,19940.5,SELL,3,0.02h,Stop Loss,$-9.00,$-213.00,$61299.50,122,$-213.00
2024-06-19,01:47:00,20219.25,BUY,3,0.02h,Stop Loss,$-9.00,$-222.00,$61290.50,122,$-222.00
2024-06-19,01:49:00,19941.5,SELL,3,0.02h,Break Even,$-1.50,$-223.50,$61289.00,122,$-223.50
2024-06-19,02:00:00,20215.25,BUY,3,0.02h,Stop Loss,$-9.00,$-232.50,$61280.00,122,$-232.50
2024-06-19,02:01:00,19941.0,SELL,3,0.02h,Stop Loss,$-9.00,$-241.50,$61271.00,122,$-241.50
2024-06-19,02:02:00,20216.0,BUY,3,0.02h,Stop Loss,$-9.00,$-250.50,$61262.00,122,$-250.50
2024-06-19,02:05:00,19940.75,SELL,3,0.02h,Stop Loss,$-9.00,$-259.50,$61253.00,122,$-259.50
2024-06-19,02:06:00,20217.5,BUY,3,0.02h,Stop Loss,$-9.00,$-268.50,$61244.00,122,$-268.50
2024-06-19,02:07:00,19941.75,SELL,3,0.08h,Break Even,$-1.50,$-270.00,$61242.50,122,$-270.00
2024-06-19,02:13:00,20215.25,BUY,3,0.02h,Stop Loss,$-9.00,$-279.00,$61233.50,122,$-279.00
2024-06-19,02:14:00,19938.5,SELL,3,0.02h,Break Even,$-1.50,$-280.50,$61232.00,122,$-280.50
2024-06-19,02:17:00,20215.5,BUY,3,0.03h,Break Even,$-1.50,$-282.00,$61230.50,122,$-282.00
2024-06-19,02:22:00,19941.5,SELL,3,0.05h,Break Even,$-1.50,$-283.50,$61229.00,122,$-283.50
2024-06-19,02:25:00,20216.25,BUY,3,0.03h,Break Even,$-1.50,$-285.00,$61227.50,122,$-285.00
2024-06-19,02:29:00,19942.75,SELL,3,0.02h,Stop Loss,$-9.00,$-294.00,$61218.50,122,$-294.00
2024-06-19,02:36:00,20225.5,BUY,3,0.02h,Stop Loss,$-9.00,$-303.00,$61209.50,122,$-303.00
2024-06-19,02:37:00,19949.0,SELL,3,0.05h,Stop Loss,$-9.00,$-312.00,$61200.50,122,$-312.00
2024-06-19,02:40:00,20224.0,BUY,3,0.02h,Stop Loss,$-9.00,$-321.00,$61191.50,122,$-321.00
2024-06-19,02:41:00,19948.0,SELL,3,0.02h,Stop Loss,$-9.00,$-330.00,$61182.50,122,$-330.00
2024-06-19,02:42:00,20224.0,BUY,3,0.03h,Stop Loss,$-9.00,$-339.00,$61173.50,122,$-339.00
2024-06-19,02:58:00,19945.0,SELL,3,0.05h,Stop Loss,$-9.00,$-348.00,$61164.50,122,$-348.00
2024-06-19,03:03:00,20222.0,BUY,3,0.03h,Break Even,$-1.50,$-349.50,$61163.00,122,$-349.50
2024-06-19,03:25:00,19946.75,SELL,3,0.05h,Stop Loss,$-9.00,$-358.50,$61154.00,122,$-358.50
2024-06-19,03:31:00,20223.25,BUY,3,0.03h,Stop Loss,$-9.00,$-367.50,$61145.00,122,$-367.50
2024-06-19,03:33:00,19948.0,SELL,3,0.03h,Stop Loss,$-9.00,$-376.50,$61136.00,122,$-376.50
2024-06-19,03:41:00,20222.25,BUY,3,0.02h,Stop Loss,$-9.00,$-385.50,$61127.00,122,$-385.50
2024-06-19,03:44:00,19945.5,SELL,3,0.02h,Stop Loss,$-9.00,$-394.50,$61118.00,122,$-394.50
2024-06-19,03:45:00,20221.25,BUY,3,0.02h,Stop Loss,$-9.00,$-403.50,$61109.00,122,$-403.50
2024-06-19,03:47:00,19943.75,SELL,3,0.02h,Stop Loss,$-9.00,$-412.50,$61100.00,122,$-412.50
2024-06-19,03:56:00,20220.0,BUY,3,0.02h,Stop Loss,$-9.00,$-421.50,$61091.00,122,$-421.50
2024-06-19,03:58:00,19943.75,SELL,3,0.02h,Stop Loss,$-9.00,$-430.50,$61082.00,122,$-430.50
2024-06-19,03:59:00,20219.5,BUY,3,0.05h,Stop Loss,$-9.00,$-439.50,$61073.00,122,$-439.50
2024-06-19,04:02:00,19944.5,SELL,3,0.02h,Stop Loss,$-9.00,$-448.50,$61064.00,122,$-448.50
2024-06-19,04:03:00,20221.75,BUY,3,0.05h,Stop Loss,$-9.00,$-457.50,$61055.00,122,$-457.50
2024-06-19,04:06:00,19946.5,SELL,3,0.02h,Stop Loss,$-9.00,$-466.50,$61046.00,122,$-466.50
2024-06-19,04:07:00,20221.75,BUY,3,0.02h,Stop Loss,$-9.00,$-475.50,$61037.00,122,$-475.50
2024-06-19,04:08:00,19945.5,SELL,3,0.02h,Stop Loss,$-9.00,$-484.50,$61028.00,122,$-484.50
2024-06-19,04:12:00,20219.0,BUY,3,0.02h,Break Even,$-1.50,$-486.00,$61026.50,122,$-486.00
2024-06-19,04:15:00,19944.0,SELL,3,0.02h,Stop Loss,$-9.00,$-495.00,$61017.50,122,$-495.00
2024-06-19,04:16:00,20218.5,BUY,3,0.05h,Stop Loss,$-9.00,$-504.00,$61008.50,122,$-504.00
2024-06-19,04:22:00,19941.5,SELL,3,0.02h,Stop Loss,$-9.00,$-513.00,$60999.50,122,$-513.00
2024-06-19,04:42:00,20216.0,BUY,3,0.02h,Stop Loss,$-9.00,$-522.00,$60990.50,122,$-522.00
2024-06-19,04:43:00,19939.25,SELL,3,0.02h,Stop Loss,$-9.00,$-531.00,$60981.50,122,$-531.00
2024-06-19,04:48:00,20214.75,BUY,3,0.02h,Stop Loss,$-9.00,$-540.00,$60972.50,122,$-540.00
2024-06-19,04:55:00,19939.25,SELL,3,0.02h,Stop Loss,$-9.00,$-549.00,$60963.50,122,$-549.00
2024-06-19,04:56:00,20214.25,BUY,3,0.02h,Stop Loss,$-9.00,$-558.00,$60954.50,122,$-558.00
2024-06-19,04:57:00,19940.0,SELL,3,0.02h,Stop Loss,$-9.00,$-567.00,$60945.50,122,$-567.00
2024-06-19,04:58:00,20216.5,BUY,3,0.03h,Stop Loss,$-9.00,$-576.00,$60936.50,122,$-576.00
2024-06-19,05:14:00,19942.25,SELL,3,0.05h,Stop Loss,$-9.00,$-585.00,$60927.50,122,$-585.00
2024-06-19,05:19:00,20217.25,BUY,3,0.02h,Stop Loss,$-9.00,$-594.00,$60918.50,122,$-594.00
2024-06-19,05:20:00,19942.0,SELL,3,0.02h,Stop Loss,$-9.00,$-603.00,$60909.50,122,$-603.00
2024-06-19,05:21:00,20217.5,BUY,3,0.02h,Stop Loss,$-9.00,$-612.00,$60900.50,122,$-612.00
2024-06-19,05:31:00,19942.0,SELL,3,0.02h,Stop Loss,$-9.00,$-621.00,$60891.50,122,$-621.00
2024-06-19,05:32:00,20217.0,BUY,3,0.02h,Stop Loss,$-9.00,$-630.00,$60882.50,122,$-630.00
2024-06-19,05:33:00,19942.25,SELL,3,0.02h,Stop Loss,$-9.00,$-639.00,$60873.50,122,$-639.00
2024-06-19,05:38:00,20220.0,BUY,3,0.02h,Stop Loss,$-9.00,$-648.00,$60864.50,122,$-648.00
2024-06-19,05:39:00,19943.75,SELL,3,0.02h,Stop Loss,$-9.00,$-657.00,$60855.50,122,$-657.00
2024-06-19,05:43:00,20220.25,BUY,3,0.02h,Stop Loss,$-9.00,$-666.00,$60846.50,122,$-666.00
2024-06-19,05:46:00,19944.75,SELL,3,0.02h,Stop Loss,$-9.00,$-675.00,$60837.50,122,$-675.00
2024-06-19,05:47:00,20221.25,BUY,3,0.03h,Break Even,$-1.50,$-676.50,$60836.00,122,$-676.50
2024-06-19,05:53:00,19946.25,SELL,3,0.02h,Stop Loss,$-9.00,$-685.50,$60827.00,122,$-685.50
2024-06-19,06:13:00,20226.25,BUY,3,0.02h,Break Even,$-1.50,$-687.00,$60825.50,122,$-687.00
2024-06-19,06:17:00,19951.5,SELL,3,0.02h,Stop Loss,$-9.00,$-696.00,$60816.50,122,$-696.00
2024-06-19,06:22:00,20227.0,BUY,3,0.02h,Stop Loss,$-9.00,$-705.00,$60807.50,122,$-705.00
2024-06-19,06:24:00,19949.25,SELL,3,0.02h,Stop Loss,$-9.00,$-714.00,$60798.50,122,$-714.00
2024-06-19,06:25:00,20223.5,BUY,3,0.02h,Break Even,$-1.50,$-715.50,$60797.00,122,$-715.50
2024-06-19,06:34:00,19959.25,SELL,3,0.02h,Stop Loss,$-9.00,$-724.50,$60788.00,122,$-724.50
2024-06-19,06:40:00,20232.25,BUY,3,0.02h,Stop Loss,$-9.00,$-733.50,$60779.00,122,$-733.50
2024-06-19,06:48:00,19957.5,SELL,3,0.02h,Stop Loss,$-9.00,$-742.50,$60770.00,122,$-742.50
2024-06-19,06:53:00,20233.25,BUY,3,0.02h,Break Even,$-1.50,$-744.00,$60768.50,122,$-744.00
2024-06-19,06:58:00,19957.0,SELL,3,0.02h,Stop Loss,$-9.00,$-753.00,$60759.50,122,$-753.00
2024-06-19,07:00:00,20235.5,BUY,3,0.02h,Stop Loss,$-9.00,$-762.00,$60750.50,122,$-762.00
2024-06-19,07:01:00,19958.5,SELL,3,0.02h,Break Even,$-1.50,$-763.50,$60749.00,122,$-763.50
2024-06-19,07:11:00,20234.25,BUY,3,0.02h,Stop Loss,$-9.00,$-772.50,$60740.00,122,$-772.50
2024-06-19,07:12:00,19955.5,SELL,3,0.02h,Stop Loss,$-9.00,$-781.50,$60731.00,122,$-781.50
2024-06-19,07:13:00,20233.5,BUY,3,0.02h,Stop Loss,$-9.00,$-790.50,$60722.00,122,$-790.50
2024-06-19,07:23:00,19951.0,SELL,3,0.02h,Stop Loss,$-9.00,$-799.50,$60713.00,122,$-799.50
2024-06-19,07:33:00,20230.25,BUY,3,0.02h,Stop Loss,$-9.00,$-808.50,$60704.00,122,$-808.50
2024-06-19,07:48:00,19959.0,SELL,3,0.02h,Stop Loss,$-9.00,$-817.50,$60695.00,122,$-817.50
2024-06-19,07:49:00,20236.25,BUY,3,0.02h,Stop Loss,$-9.00,$-826.50,$60686.00,122,$-826.50
2024-06-19,07:50:00,19957.0,SELL,3,0.02h,Stop Loss,$-9.00,$-835.50,$60677.00,122,$-835.50
2024-06-19,07:51:00,20234.0,BUY,3,0.02h,Stop Loss,$-9.00,$-844.50,$60668.00,122,$-844.50
2024-06-19,07:56:00,19955.0,SELL,3,0.02h,Stop Loss,$-9.00,$-853.50,$60659.00,122,$-853.50
2024-06-19,08:09:00,20236.25,BUY,3,0.02h,Break Even,$-1.50,$-855.00,$60657.50,122,$-855.00
2024-06-19,08:14:00,19956.75,SELL,3,0.02h,Break Even,$-1.50,$-856.50,$60656.00,122,$-856.50
2024-06-19,08:23:00,20227.5,BUY,3,0.02h,Break Even,$-1.50,$-858.00,$60654.50,122,$-858.00
2024-06-19,08:28:00,19951.75,SELL,3,0.02h,Stop Loss,$-9.00,$-867.00,$60645.50,122,$-867.00
2024-06-19,08:29:00,20230.0,BUY,3,0.02h,Stop Loss,$-9.00,$-876.00,$60636.50,122,$-876.00
2024-06-19,08:37:00,19948.0,SELL,3,0.03h,Stop Loss,$-9.00,$-885.00,$60627.50,122,$-885.00
2024-06-19,08:42:00,20226.0,BUY,3,0.02h,Break Even,$-1.50,$-886.50,$60626.00,122,$-886.50
2024-06-19,08:44:00,19949.5,SELL,3,0.03h,Stop Loss,$-9.00,$-895.50,$60617.00,122,$-895.50
2024-06-19,08:46:00,20227.25,BUY,3,0.02h,Stop Loss,$-9.00,$-904.50,$60608.00,122,$-904.50
2024-06-19,08:48:00,19948.0,SELL,3,0.02h,Stop Loss,$-9.00,$-913.50,$60599.00,122,$-913.50
2024-06-19,08:49:00,20225.5,BUY,3,0.02h,Stop Loss,$-9.00,$-922.50,$60590.00,122,$-922.50
2024-06-19,08:53:00,19949.25,SELL,3,0.02h,Stop Loss,$-9.00,$-931.50,$60581.00,122,$-931.50
2024-06-19,08:54:00,20228.25,BUY,3,0.02h,Stop Loss,$-9.00,$-940.50,$60572.00,122,$-940.50
2024-06-19,08:56:00,19951.0,SELL,3,0.02h,Stop Loss,$-9.00,$-949.50,$60563.00,122,$-949.50
2024-06-19,09:02:00,20232.5,BUY,3,0.02h,Stop Loss,$-9.00,$-958.50,$60554.00,122,$-958.50
2024-06-19,09:05:00,19954.25,SELL,3,0.02h,Stop Loss,$-9.00,$-967.50,$60545.00,122,$-967.50
2024-06-19,09:08:00,20235.25,BUY,3,0.02h,Break Even,$-1.50,$-969.00,$60543.50,122,$-969.00
2024-06-19,09:12:00,19959.25,SELL,3,0.02h,Stop Loss,$-9.00,$-978.00,$60534.50,122,$-978.00
2024-06-19,09:17:00,20235.5,BUY,3,0.02h,Stop Loss,$-9.00,$-987.00,$60525.50,122,$-987.00
2024-06-19,09:21:00,19957.0,SELL,3,0.02h,Stop Loss,$-9.00,$-996.00,$60516.50,122,$-996.00
2024-06-19,09:23:00,20235.5,BUY,3,0.02h,Stop Loss,$-9.00,$-1005.00,$60507.50,122,$-1005.00
2024-06-19,09:30:00,19958.0,SELL,3,0.02h,Stop Loss,$-9.00,$-1014.00,$60498.50,122,$-1014.00
2024-06-19,09:31:00,20235.75,BUY,3,0.02h,Stop Loss,$-9.00,$-1023.00,$60489.50,122,$-1023.00
2024-06-19,09:35:00,19957.25,SELL,3,0.02h,Stop Loss,$-9.00,$-1032.00,$60480.50,122,$-1032.00
2024-06-19,09:37:00,20235.0,BUY,3,0.02h,Stop Loss,$-9.00,$-1041.00,$60471.50,122,$-1041.00
2024-06-19,09:39:00,19956.5,SELL,3,0.02h,Stop Loss,$-9.00,$-1050.00,$60462.50,122,$-1050.00
2024-06-19,09:40:00,20233.75,BUY,3,0.02h,Stop Loss,$-9.00,$-1059.00,$60453.50,122,$-1059.00
2024-06-19,09:57:00,19957.75,SELL,3,0.03h,Stop Loss,$-9.00,$-1068.00,$60444.50,122,$-1068.00
2024-06-19,10:08:00,20232.75,BUY,3,0.02h,Break Even,$-1.50,$-1069.50,$60443.00,122,$-1069.50
2024-06-19,10:16:00,19958.0,SELL,3,0.02h,Stop Loss,$-9.00,$-1078.50,$60434.00,122,$-1078.50
2024-06-19,10:30:00,20235.0,BUY,3,0.02h,Break Even,$-1.50,$-1080.00,$60432.50,122,$-1080.00
2024-06-19,10:37:00,19958.75,SELL,3,0.02h,Stop Loss,$-9.00,$-1089.00,$60423.50,122,$-1089.00
2024-06-19,10:38:00,20237.0,BUY,3,0.02h,Stop Loss,$-9.00,$-1098.00,$60414.50,122,$-1098.00
2024-06-19,10:39:00,19958.75,SELL,3,0.03h,Stop Loss,$-9.00,$-1107.00,$60405.50,122,$-1107.00
2024-06-19,10:48:00,20240.75,BUY,3,0.03h,Stop Loss,$-9.00,$-1116.00,$60396.50,122,$-1116.00
2024-06-19,10:51:00,19963.0,SELL,3,0.02h,Stop Loss,$-9.00,$-1125.00,$60387.50,122,$-1125.00
2024-06-19,10:52:00,20240.25,BUY,3,0.08h,Stop Loss,$3.00,$-1122.00,$60390.50,122,$-1122.00
2024-06-19,11:00:00,19965.25,SELL,3,0.02h,Stop Loss,$-9.00,$-1131.00,$60381.50,122,$-1131.00
2024-06-19,11:01:00,20243.75,BUY,3,0.02h,Stop Loss,$-9.00,$-1140.00,$60372.50,122,$-1140.00
2024-06-19,11:02:00,19965.5,SELL,3,0.02h,Stop Loss,$-9.00,$-1149.00,$60363.50,122,$-1149.00
2024-06-19,11:03:00,20243.5,BUY,3,0.02h,Break Even,$-1.50,$-1150.50,$60362.00,122,$-1150.50
2024-06-19,11:06:00,19965.0,SELL,3,0.02h,Break Even,$-1.50,$-1152.00,$60360.50,122,$-1152.00
2024-06-19,11:10:00,20239.75,BUY,3,0.02h,Stop Loss,$-9.00,$-1161.00,$60351.50,122,$-1161.00
2024-06-19,11:11:00,19963.5,SELL,3,0.02h,Stop Loss,$-9.00,$-1170.00,$60342.50,122,$-1170.00
2024-06-19,11:12:00,20241.0,BUY,3,0.02h,Break Even,$-1.50,$-1171.50,$60341.00,122,$-1171.50
2024-06-19,11:14:00,19966.0,SELL,3,0.02h,Break Even,$-1.50,$-1173.00,$60339.50,122,$-1173.00
2024-06-19,11:22:00,20240.5,BUY,3,0.02h,Break Even,$-1.50,$-1174.50,$60338.00,122,$-1174.50
2024-06-19,11:24:00,19964.75,SELL,3,0.02h,Stop Loss,$-9.00,$-1183.50,$60329.00,122,$-1183.50
2024-06-19,11:25:00,20243.0,BUY,3,0.02h,Break Even,$-1.50,$-1185.00,$60327.50,122,$-1185.00
2024-06-19,11:28:00,19965.25,SELL,3,0.02h,Stop Loss,$-9.00,$-1194.00,$60318.50,122,$-1194.00
2024-06-19,11:32:00,20244.25,BUY,3,0.02h,Stop Loss,$-9.00,$-1203.00,$60309.50,122,$-1203.00
2024-06-19,11:37:00,19966.75,SELL,3,0.07h,Stop Loss,$-9.00,$-1212.00,$60300.50,122,$-1212.00
2024-06-19,11:47:00,20240.5,BUY,3,0.03h,Stop Loss,$-9.00,$-1221.00,$60291.50,122,$-1221.00
2024-06-19,11:57:00,19960.0,SELL,3,0.02h,Break Even,$-1.50,$-1222.50,$60290.00,122,$-1222.50
2024-06-19,12:01:00,20235.25,BUY,3,0.03h,Stop Loss,$-9.00,$-1231.50,$60281.00,122,$-1231.50
2024-06-19,12:11:00,19959.5,SELL,3,0.05h,Stop Loss,$-9.00,$-1240.50,$60272.00,122,$-1240.50
2024-06-19,12:20:00,20234.25,BUY,3,0.03h,Stop Loss,$-9.00,$-1249.50,$60263.00,122,$-1249.50
2024-06-19,12:32:00,19956.5,SELL,3,0.02h,Stop Loss,$-9.00,$-1258.50,$60254.00,122,$-1258.50
2024-06-19,12:37:00,20235.5,BUY,3,0.02h,Stop Loss,$-9.00,$-1267.50,$60245.00,122,$-1267.50
2024-06-19,12:38:00,19960.0,SELL,3,0.02h,Stop Loss,$-9.00,$-1276.50,$60236.00,122,$-1276.50
2024-06-19,12:48:00,20241.5,BUY,3,0.02h,Stop Loss,$-9.00,$-1285.50,$60227.00,122,$-1285.50
2024-06-19,13:01:00,19965.25,SELL,3,0.02h,Stop Loss,$-9.00,$-1294.50,$60218.00,122,$-1294.50
2024-06-19,13:03:00,20243.0,BUY,3,0.02h,Stop Loss,$-9.00,$-1303.50,$60209.00,122,$-1303.50
2024-06-19,13:04:00,19968.5,SELL,3,0.02h,Stop Loss,$-9.00,$-1312.50,$60200.00,122,$-1312.50
2024-06-19,13:07:00,20248.25,BUY,3,0.02h,Break Even,$-1.50,$-1314.00,$60198.50,122,$-1314.00
2024-06-19,13:09:00,19972.0,SELL,3,0.02h,Stop Loss,$-9.00,$-1323.00,$60189.50,122,$-1323.00
2024-06-19,13:31:00,20250.25,BUY,3,0.02h,Stop Loss,$-9.00,$-1332.00,$60180.50,122,$-1332.00
2024-06-19,13:38:00,19963.75,SELL,3,0.02h,Stop Loss,$-9.00,$-1341.00,$60171.50,122,$-1341.00
2024-06-19,13:39:00,20237.0,BUY,3,0.02h,Stop Loss,$9.00,$-1332.00,$60180.50,122,$-1332.00
2024-06-19,13:52:00,19962.5,SELL,3,0.02h,Stop Loss,$-9.00,$-1341.00,$60171.50,122,$-1341.00
2024-06-19,13:57:00,20239.75,BUY,3,0.02h,Stop Loss,$-9.00,$-1350.00,$60162.50,122,$-1350.00
2024-06-19,14:06:00,19962.75,SELL,3,0.02h,Break Even,$-1.50,$-1351.50,$60161.00,122,$-1351.50
2024-06-19,14:12:00,20240.0,BUY,3,0.02h,Stop Loss,$-9.00,$-1360.50,$60152.00,122,$-1360.50
2024-06-19,14:13:00,19964.75,SELL,3,0.02h,Stop Loss,$-9.00,$-1369.50,$60143.00,122,$-1369.50
2024-06-19,14:15:00,20242.0,BUY,3,0.02h,Stop Loss,$-9.00,$-1378.50,$60134.00,122,$-1378.50
2024-06-19,14:16:00,19964.5,SELL,3,0.05h,Stop Loss,$-9.00,$-1387.50,$60125.00,122,$-1387.50
2024-06-19,14:26:00,20239.0,BUY,3,0.02h,Stop Loss,$-9.00,$-1396.50,$60116.00,122,$-1396.50
2024-06-19,14:37:00,19953.75,SELL,3,0.02h,Stop Loss,$-9.00,$-1405.50,$60107.00,122,$-1405.50
2024-06-19,14:38:00,20231.25,BUY,3,0.02h,Stop Loss,$-9.00,$-1414.50,$60098.00,122,$-1414.50
2024-06-19,14:39:00,19955.0,SELL,3,0.02h,Stop Loss,$-9.00,$-1423.50,$60089.00,122,$-1423.50
2024-06-19,14:40:00,20233.5,BUY,3,0.02h,Stop Loss,$-9.00,$-1432.50,$60080.00,122,$-1432.50
2024-06-19,14:41:00,19956.75,SELL,3,0.02h,Stop Loss,$-9.00,$-1441.50,$60071.00,122,$-1441.50
2024-06-19,14:44:00,20237.5,BUY,3,0.02h,Break Even,$-1.50,$-1443.00,$60069.50,122,$-1443.00
2024-06-19,14:53:00,19957.5,SELL,3,0.03h,Stop Loss,$-9.00,$-1452.00,$60060.50,122,$-1452.00
2024-06-19,14:58:00,20237.25,BUY,3,0.02h,Stop Loss,$-9.00,$-1461.00,$60051.50,122,$-1461.00
2024-06-19,15:02:00,19963.0,SELL,3,0.02h,Stop Loss,$-9.00,$-1470.00,$60042.50,122,$-1470.00
2024-06-19,15:12:00,20240.0,BUY,3,0.02h,Break Even,$-1.50,$-1471.50,$60041.00,122,$-1471.50
2024-06-19,15:28:00,19963.25,SELL,3,0.02h,Stop Loss,$-9.00,$-1480.50,$60032.00,122,$-1480.50
2024-06-19,15:30:00,20241.25,BUY,3,0.02h,Stop Loss,$-9.00,$-1489.50,$60023.00,122,$-1489.50
2024-06-19,15:31:00,19967.0,SELL,3,0.02h,Stop Loss,$-9.00,$-1498.50,$60014.00,122,$-1498.50
2024-06-19,15:32:00,20242.5,BUY,3,0.02h,Break Even,$-1.50,$-1500.00,$60012.50,122,$-1500.00
2024-06-19,15:37:00,19969.5,SELL,3,0.02h,Stop Loss,$-9.00,$-1509.00,$60003.50,122,$-1509.00
2024-06-19,15:42:00,20245.0,BUY,3,0.02h,Stop Loss,$-9.00,$-1518.00,$59994.50,122,$-1518.00
2024-06-19,15:43:00,19967.75,SELL,3,0.02h,Break Even,$-1.50,$-1519.50,$59993.00,122,$-1519.50
2024-06-19,15:53:00,20243.25,BUY,3,0.03h,Stop Loss,$-9.00,$-1528.50,$59984.00,122,$-1528.50
2024-06-19,15:56:00,19966.25,SELL,3,0.07h,Stop Loss,$-9.00,$-1537.50,$59975.00,122,$-1537.50
2024-06-19,16:05:00,20242.75,BUY,3,0.02h,Stop Loss,$-9.00,$-1546.50,$59966.00,122,$-1546.50
2024-06-19,16:06:00,19966.25,SELL,3,0.02h,Break Even,$-1.50,$-1548.00,$59964.50,122,$-1548.00
2024-06-19,16:10:00,20236.25,BUY,3,0.02h,Stop Loss,$-9.00,$-1557.00,$59955.50,122,$-1557.00
2024-06-19,16:20:00,19959.0,SELL,3,0.02h,Stop Loss,$-9.00,$-1566.00,$59946.50,122,$-1566.00
2024-06-19,16:21:00,20234.25,BUY,3,0.03h,Stop Loss,$-9.00,$-1575.00,$59937.50,122,$-1575.00
2024-06-19,16:25:00,19960.5,SELL,3,0.03h,Stop Loss,$-9.00,$-1584.00,$59928.50,122,$-1584.00
2024-06-19,16:33:00,20239.75,BUY,3,0.02h,Stop Loss,$-9.00,$-1593.00,$59919.50,122,$-1593.00
2024-06-19,16:34:00,19965.75,SELL,3,0.02h,Stop Loss,$-9.00,$-1602.00,$59910.50,122,$-1602.00
2024-06-19,16:35:00,20238.25,BUY,3,0.02h,Stop Loss,$-9.00,$-1611.00,$59901.50,122,$-1611.00
2024-06-19,16:41:00,19962.25,SELL,3,0.03h,Stop Loss,$-9.00,$-1620.00,$59892.50,122,$-1620.00
2024-06-19,16:44:00,20238.25,BUY,3,0.02h,Stop Loss,$-9.00,$-1629.00,$59883.50,122,$-1629.00
2024-06-19,16:56:00,19955.75,SELL,3,0.07h,Stop Loss,$12.00,$-1617.00,$59895.50,122,$-1617.00
2024-06-19,23:10:00,20231.0,BUY,3,0.03h,Stop Loss,$-9.00,$-1626.00,$59886.50,122,$-1626.00
2024-06-19,23:13:00,19957.25,SELL,3,0.02h,Stop Loss,$-9.00,$-1635.00,$59877.50,122,$-1635.00
2024-06-19,23:14:00,20233.5,BUY,3,0.02h,Stop Loss,$-9.00,$-1644.00,$59868.50,122,$-1644.00
2024-06-19,23:15:00,19957.0,SELL,3,0.05h,Break Even,$-1.50,$-1645.50,$59867.00,122,$-1645.50
2024-06-19,23:21:00,20233.0,BUY,3,0.02h,Stop Loss,$-9.00,$-1654.50,$59858.00,122,$-1654.50
2024-06-19,23:22:00,19957.5,SELL,3,0.10h,Stop Loss,$-9.00,$-1663.50,$59849.00,122,$-1663.50
2024-06-19,23:30:00,20234.5,BUY,3,0.02h,Stop Loss,$-9.00,$-1672.50,$59840.00,122,$-1672.50
2024-06-19,23:39:00,19959.25,SELL,3,0.03h,Stop Loss,$-9.00,$-1681.50,$59831.00,122,$-1681.50
2024-06-19,23:41:00,20234.25,BUY,3,0.02h,Stop Loss,$-9.00,$-1690.50,$59822.00,122,$-1690.50
2024-06-19,23:42:00,19958.25,SELL,3,0.02h,Stop Loss,$-9.00,$-1699.50,$59813.00,122,$-1699.50
2024-06-19,23:43:00,20235.0,BUY,3,0.03h,Stop Loss,$-9.00,$-1708.50,$59804.00,122,$-1708.50
2024-06-19,23:48:00,19956.25,SELL,3,0.03h,Stop Loss,$-9.00,$-1717.50,$59795.00,122,$-1717.50
2024-06-19,23:50:00,20232.25,BUY,3,0.02h,Stop Loss,$-9.00,$-1726.50,$59786.00,122,$-1726.50
2024-06-19,23:51:00,19958.25,SELL,3,0.05h,Stop Loss,$-9.00,$-1735.50,$59777.00,122,$-1735.50
2024-06-19,23:55:00,20233.5,BUY,3,0.15h,Break Even,$-1.50,$-1737.00,$59775.50,122,$-1737.00
,,,,,,,,,,,
2024-06-20,00:05:00,19962.25,SELL,3,0.03h,Stop Loss,$-9.00,$-9.00,$59766.50,123,$-9.00
2024-06-20,00:10:00,20239.5,BUY,3,0.02h,Stop Loss,$-9.00,$-18.00,$59757.50,123,$-18.00
2024-06-20,00:11:00,19963.0,SELL,3,0.02h,Stop Loss,$-9.00,$-27.00,$59748.50,123,$-27.00
2024-06-20,00:12:00,20240.0,BUY,3,0.02h,Stop Loss,$-9.00,$-36.00,$59739.50,123,$-36.00
2024-06-20,00:13:00,19964.0,SELL,3,0.05h,Stop Loss,$-9.00,$-45.00,$59730.50,123,$-45.00
2024-06-20,00:17:00,20241.25,BUY,3,0.07h,Break Even,$-1.50,$-46.50,$59729.00,123,$-46.50
2024-06-20,00:23:00,19965.25,SELL,3,0.03h,Stop Loss,$-9.00,$-55.50,$59720.00,123,$-55.50
2024-06-20,00:30:00,20243.25,BUY,3,0.02h,Stop Loss,$-9.00,$-64.50,$59711.00,123,$-64.50
2024-06-20,00:31:00,19968.0,SELL,3,0.05h,Break Even,$-1.50,$-66.00,$59709.50,123,$-66.00
2024-06-20,00:48:00,20247.75,BUY,3,0.02h,Stop Loss,$-9.00,$-75.00,$59700.50,123,$-75.00
2024-06-20,00:50:00,19973.5,SELL,3,0.03h,Stop Loss,$-9.00,$-84.00,$59691.50,123,$-84.00
2024-06-20,00:52:00,20252.25,BUY,3,0.02h,Break Even,$-1.50,$-85.50,$59690.00,123,$-85.50
2024-06-20,00:57:00,19975.75,SELL,3,0.02h,Stop Loss,$-9.00,$-94.50,$59681.00,123,$-94.50
2024-06-20,00:58:00,20252.5,BUY,3,0.02h,Stop Loss,$-9.00,$-103.50,$59672.00,123,$-103.50
2024-06-20,01:09:00,19974.25,SELL,3,0.02h,Stop Loss,$-9.00,$-112.50,$59663.00,123,$-112.50
2024-06-20,01:10:00,20251.0,BUY,3,0.02h,Stop Loss,$-9.00,$-121.50,$59654.00,123,$-121.50
2024-06-20,01:12:00,19973.25,SELL,3,0.02h,Stop Loss,$-9.00,$-130.50,$59645.00,123,$-130.50
2024-06-20,01:14:00,20253.0,BUY,3,0.02h,Stop Loss,$-9.00,$-139.50,$59636.00,123,$-139.50
2024-06-20,01:16:00,19973.25,SELL,3,0.02h,Stop Loss,$-9.00,$-148.50,$59627.00,123,$-148.50
2024-06-20,01:30:00,20260.0,BUY,3,0.03h,Stop Loss,$-9.00,$-157.50,$59618.00,123,$-157.50
2024-06-20,01:42:00,19987.0,SELL,3,0.02h,Stop Loss,$-9.00,$-166.50,$59609.00,123,$-166.50
2024-06-20,01:52:00,20263.5,BUY,3,0.03h,Stop Loss,$-9.00,$-175.50,$59600.00,123,$-175.50
2024-06-20,01:57:00,19985.25,SELL,3,0.02h,Stop Loss,$-9.00,$-184.50,$59591.00,123,$-184.50
2024-06-20,01:58:00,20264.0,BUY,3,0.02h,Stop Loss,$-9.00,$-193.50,$59582.00,123,$-193.50
2024-06-20,02:01:00,19982.25,SELL,3,0.08h,Stop Loss,$-9.00,$-202.50,$59573.00,123,$-202.50
2024-06-20,02:11:00,20261.0,BUY,3,0.02h,Stop Loss,$-9.00,$-211.50,$59564.00,123,$-211.50
2024-06-20,02:16:00,19983.5,SELL,3,0.02h,Stop Loss,$-9.00,$-220.50,$59555.00,123,$-220.50
2024-06-20,02:23:00,20263.25,BUY,3,0.05h,Stop Loss,$-9.00,$-229.50,$59546.00,123,$-229.50
2024-06-20,02:37:00,19983.0,SELL,3,0.02h,Stop Loss,$-9.00,$-238.50,$59537.00,123,$-238.50
2024-06-20,02:47:00,20257.5,BUY,3,0.03h,Stop Loss,$-9.00,$-247.50,$59528.00,123,$-247.50
2024-06-20,02:57:00,19983.75,SELL,3,0.02h,Stop Loss,$-9.00,$-256.50,$59519.00,123,$-256.50
2024-06-20,02:58:00,20261.5,BUY,3,0.02h,Stop Loss,$-9.00,$-265.50,$59510.00,123,$-265.50
2024-06-20,03:03:00,19984.25,SELL,3,0.03h,Stop Loss,$-9.00,$-274.50,$59501.00,123,$-274.50
2024-06-20,03:06:00,20264.5,BUY,3,0.02h,Stop Loss,$-9.00,$-283.50,$59492.00,123,$-283.50
2024-06-20,03:07:00,19987.75,SELL,3,0.03h,Stop Loss,$-9.00,$-292.50,$59483.00,123,$-292.50
2024-06-20,03:10:00,20262.75,BUY,3,0.05h,Stop Loss,$-9.00,$-301.50,$59474.00,123,$-301.50
2024-06-20,03:23:00,19985.5,SELL,3,0.03h,Stop Loss,$-9.00,$-310.50,$59465.00,123,$-310.50
2024-06-20,03:37:00,20261.75,BUY,3,0.05h,Stop Loss,$-9.00,$-319.50,$59456.00,123,$-319.50
2024-06-20,03:41:00,19986.75,SELL,3,0.02h,Stop Loss,$-9.00,$-328.50,$59447.00,123,$-328.50
2024-06-20,03:42:00,20263.75,BUY,3,0.05h,Break Even,$-1.50,$-330.00,$59445.50,123,$-330.00
2024-06-20,03:46:00,19997.25,SELL,3,0.02h,Stop Loss,$-9.00,$-339.00,$59436.50,123,$-339.00
2024-06-20,03:47:00,20273.0,BUY,3,0.02h,Stop Loss,$-9.00,$-348.00,$59427.50,123,$-348.00
2024-06-20,03:48:00,19996.75,SELL,3,0.02h,Break Even,$-1.50,$-349.50,$59426.00,123,$-349.50
2024-06-20,04:00:00,20290.0,BUY,3,0.02h,Stop Loss,$9.00,$-340.50,$59435.00,123,$-340.50
2024-06-20,04:12:00,20011.5,SELL,3,0.03h,Stop Loss,$-9.00,$-349.50,$59426.00,123,$-349.50
2024-06-20,04:20:00,20292.25,BUY,3,0.02h,Stop Loss,$-9.00,$-358.50,$59417.00,123,$-358.50
2024-06-20,04:23:00,20016.0,SELL,3,0.03h,Stop Loss,$-9.00,$-367.50,$59408.00,123,$-367.50
2024-06-20,04:25:00,20291.5,BUY,3,0.03h,Stop Loss,$-9.00,$-376.50,$59399.00,123,$-376.50
2024-06-20,04:30:00,20017.25,SELL,3,0.02h,Stop Loss,$-9.00,$-385.50,$59390.00,123,$-385.50
2024-06-20,04:31:00,20294.0,BUY,3,0.03h,Stop Loss,$-9.00,$-394.50,$59381.00,123,$-394.50
2024-06-20,04:38:00,20020.25,SELL,3,0.02h,Stop Loss,$-9.00,$-403.50,$59372.00,123,$-403.50
2024-06-20,04:39:00,20298.0,BUY,3,0.03h,Stop Loss,$-9.00,$-412.50,$59363.00,123,$-412.50
2024-06-20,04:42:00,20026.0,SELL,3,0.02h,Stop Loss,$-9.00,$-421.50,$59354.00,123,$-421.50
2024-06-20,04:44:00,20303.5,BUY,3,0.02h,Stop Loss,$-9.00,$-430.50,$59345.00,123,$-430.50
2024-06-20,04:45:00,20027.0,SELL,3,0.03h,Stop Loss,$-9.00,$-439.50,$59336.00,123,$-439.50
2024-06-20,04:47:00,20301.0,BUY,3,0.02h,Stop Loss,$-9.00,$-448.50,$59327.00,123,$-448.50
2024-06-20,04:52:00,20023.25,SELL,3,0.02h,Stop Loss,$-9.00,$-457.50,$59318.00,123,$-457.50
2024-06-20,04:54:00,20300.25,BUY,3,0.02h,Stop Loss,$-9.00,$-466.50,$59309.00,123,$-466.50
2024-06-20,04:55:00,20026.5,SELL,3,0.02h,Stop Loss,$-9.00,$-475.50,$59300.00,123,$-475.50
2024-06-20,04:56:00,20304.75,BUY,3,0.02h,Stop Loss,$-9.00,$-484.50,$59291.00,123,$-484.50
2024-06-20,04:57:00,20029.5,SELL,3,0.02h,Stop Loss,$-9.00,$-493.50,$59282.00,123,$-493.50
2024-06-20,04:58:00,20306.5,BUY,3,0.02h,Stop Loss,$-9.00,$-502.50,$59273.00,123,$-502.50
2024-06-20,04:59:00,20035.75,SELL,3,0.02h,Stop Loss,$7.50,$-495.00,$59280.50,123,$-495.00
2024-06-20,05:02:00,20313.0,BUY,3,0.02h,Break Even,$-1.50,$-496.50,$59279.00,123,$-496.50
2024-06-20,05:07:00,20049.5,SELL,3,0.02h,Break Even,$-1.50,$-498.00,$59277.50,123,$-498.00
2024-06-20,05:13:00,20323.75,BUY,3,0.02h,Break Even,$-1.50,$-499.50,$59276.00,123,$-499.50
2024-06-20,05:20:00,20044.0,SELL,3,0.02h,Stop Loss,$-9.00,$-508.50,$59267.00,123,$-508.50
2024-06-20,05:26:00,20324.25,BUY,3,0.02h,Stop Loss,$-9.00,$-517.50,$59258.00,123,$-517.50
2024-06-20,05:27:00,20047.0,SELL,3,0.02h,Stop Loss,$-9.00,$-526.50,$59249.00,123,$-526.50
2024-06-20,05:33:00,20324.5,BUY,3,0.02h,Break Even,$-1.50,$-528.00,$59247.50,123,$-528.00
2024-06-20,05:43:00,20052.5,SELL,3,0.02h,Stop Loss,$-9.00,$-537.00,$59238.50,123,$-537.00
2024-06-20,05:44:00,20327.25,BUY,3,0.02h,Break Even,$-1.50,$-538.50,$59237.00,123,$-538.50
2024-06-20,05:47:00,20051.75,SELL,3,0.02h,Stop Loss,$-9.00,$-547.50,$59228.00,123,$-547.50
2024-06-20,05:48:00,20329.0,BUY,3,0.02h,Stop Loss,$-9.00,$-556.50,$59219.00,123,$-556.50
2024-06-20,05:49:00,20053.75,SELL,3,0.02h,Stop Loss,$-9.00,$-565.50,$59210.00,123,$-565.50
2024-06-20,05:50:00,20329.75,BUY,3,0.02h,Stop Loss,$-9.00,$-574.50,$59201.00,123,$-574.50
2024-06-20,05:51:00,20053.75,SELL,3,0.02h,Break Even,$-1.50,$-576.00,$59199.50,123,$-576.00
2024-06-20,05:58:00,20326.0,BUY,3,0.02h,Stop Loss,$-9.00,$-585.00,$59190.50,123,$-585.00
2024-06-20,05:59:00,20052.25,SELL,3,0.02h,Stop Loss,$-9.00,$-594.00,$59181.50,123,$-594.00
2024-06-20,06:00:00,20327.25,BUY,3,0.02h,Stop Loss,$-9.00,$-603.00,$59172.50,123,$-603.00
2024-06-20,06:01:00,20046.25,SELL,3,0.02h,Stop Loss,$12.00,$-591.00,$59184.50,123,$-591.00
2024-06-20,06:03:00,20315.5,BUY,3,0.02h,Break Even,$-1.50,$-592.50,$59183.00,123,$-592.50
2024-06-20,06:06:00,20038.75,SELL,3,0.02h,Stop Loss,$-9.00,$-601.50,$59174.00,123,$-601.50
2024-06-20,06:08:00,20318.75,BUY,3,0.02h,Break Even,$-1.50,$-603.00,$59172.50,123,$-603.00
2024-06-20,06:18:00,20045.25,SELL,3,0.02h,Stop Loss,$-9.00,$-612.00,$59163.50,123,$-612.00
2024-06-20,06:19:00,20320.75,BUY,3,0.02h,Stop Loss,$-9.00,$-621.00,$59154.50,123,$-621.00
2024-06-20,06:23:00,20041.25,SELL,3,0.02h,Stop Loss,$-9.00,$-630.00,$59145.50,123,$-630.00
2024-06-20,06:25:00,20317.25,BUY,3,0.02h,Stop Loss,$-9.00,$-639.00,$59136.50,123,$-639.00
2024-06-20,06:26:00,20041.75,SELL,3,0.03h,Break Even,$-1.50,$-640.50,$59135.00,123,$-640.50
2024-06-20,06:33:00,20311.25,BUY,3,0.02h,Stop Loss,$-9.00,$-649.50,$59126.00,123,$-649.50
2024-06-20,06:42:00,20033.75,SELL,3,0.02h,Stop Loss,$-9.00,$-658.50,$59117.00,123,$-658.50
2024-06-20,06:51:00,20311.75,BUY,3,0.02h,Stop Loss,$-9.00,$-667.50,$59108.00,123,$-667.50
2024-06-20,06:52:00,20033.5,SELL,3,0.03h,Stop Loss,$-9.00,$-676.50,$59099.00,123,$-676.50
2024-06-20,06:54:00,20312.75,BUY,3,0.02h,Stop Loss,$-9.00,$-685.50,$59090.00,123,$-685.50
2024-06-20,06:55:00,20037.75,SELL,3,0.02h,Stop Loss,$-9.00,$-694.50,$59081.00,123,$-694.50
2024-06-20,06:56:00,20315.25,BUY,3,0.02h,Stop Loss,$-9.00,$-703.50,$59072.00,123,$-703.50
2024-06-20,06:57:00,20036.5,SELL,3,0.02h,Break Even,$-1.50,$-705.00,$59070.50,123,$-705.00
2024-06-20,07:00:00,20311.5,BUY,3,0.02h,Stop Loss,$-9.00,$-714.00,$59061.50,123,$-714.00
2024-06-20,07:01:00,20034.25,SELL,3,0.02h,Stop Loss,$-9.00,$-723.00,$59052.50,123,$-723.00
2024-06-20,07:02:00,20310.0,BUY,3,0.02h,Stop Loss,$-9.00,$-732.00,$59043.50,123,$-732.00
2024-06-20,07:03:00,20037.25,SELL,3,0.02h,Stop Loss,$-9.00,$-741.00,$59034.50,123,$-741.00
2024-06-20,07:05:00,20315.5,BUY,3,0.02h,Stop Loss,$-9.00,$-750.00,$59025.50,123,$-750.00
2024-06-20,07:06:00,20044.75,SELL,3,0.02h,Stop Loss,$-9.00,$-759.00,$59016.50,123,$-759.00
2024-06-20,07:08:00,20322.75,BUY,3,0.02h,Stop Loss,$-9.00,$-768.00,$59007.50,123,$-768.00
2024-06-20,07:09:00,20050.0,SELL,3,0.02h,Break Even,$-1.50,$-769.50,$59006.00,123,$-769.50
2024-06-20,07:14:00,20323.25,BUY,3,0.02h,Stop Loss,$-9.00,$-778.50,$58997.00,123,$-778.50
2024-06-20,07:15:00,20048.0,SELL,3,0.02h,Stop Loss,$-9.00,$-787.50,$58988.00,123,$-787.50
2024-06-20,07:18:00,20344.25,BUY,3,0.02h,Break Even,$-1.50,$-789.00,$58986.50,123,$-789.00
2024-06-20,07:28:00,20069.0,SELL,3,0.02h,Stop Loss,$-9.00,$-798.00,$58977.50,123,$-798.00
2024-06-20,07:29:00,20346.5,BUY,3,0.02h,Stop Loss,$-9.00,$-807.00,$58968.50,123,$-807.00
2024-06-20,07:30:00,20068.75,SELL,3,0.02h,Stop Loss,$-9.00,$-816.00,$58959.50,123,$-816.00
2024-06-20,07:32:00,20353.75,BUY,3,0.02h,Stop Loss,$-9.00,$-825.00,$58950.50,123,$-825.00
2024-06-20,07:33:00,20077.5,SELL,3,0.02h,Stop Loss,$-9.00,$-834.00,$58941.50,123,$-834.00
2024-06-20,07:34:00,20352.75,BUY,3,0.02h,Stop Loss,$-9.00,$-843.00,$58932.50,123,$-843.00
2024-06-20,07:41:00,20069.75,SELL,3,0.02h,Stop Loss,$-9.00,$-852.00,$58923.50,123,$-852.00
2024-06-20,07:42:00,20343.25,BUY,3,0.02h,Stop Loss,$6.00,$-846.00,$58929.50,123,$-846.00
2024-06-20,07:44:00,20069.0,SELL,3,0.02h,Break Even,$-1.50,$-847.50,$58928.00,123,$-847.50
2024-06-20,07:56:00,20335.25,BUY,3,0.02h,Stop Loss,$-9.00,$-856.50,$58919.00,123,$-856.50
2024-06-20,08:01:00,20061.25,SELL,3,0.02h,Stop Loss,$-9.00,$-865.50,$58910.00,123,$-865.50
2024-06-20,08:03:00,20338.5,BUY,3,0.02h,Stop Loss,$-9.00,$-874.50,$58901.00,123,$-874.50
2024-06-20,08:09:00,20051.5,SELL,3,0.02h,Stop Loss,$-9.00,$-883.50,$58892.00,123,$-883.50
2024-06-20,08:10:00,20334.25,BUY,3,0.02h,Stop Loss,$-9.00,$-892.50,$58883.00,123,$-892.50
2024-06-20,08:11:00,20055.0,SELL,3,0.02h,Stop Loss,$-9.00,$-901.50,$58874.00,123,$-901.50
2024-06-20,08:12:00,20331.0,BUY,3,0.02h,Stop Loss,$-9.00,$-910.50,$58865.00,123,$-910.50
2024-06-20,08:13:00,20042.75,SELL,3,0.02h,Stop Loss,$-9.00,$-919.50,$58856.00,123,$-919.50
2024-06-20,08:14:00,20326.75,BUY,3,0.02h,Stop Loss,$6.00,$-913.50,$58862.00,123,$-913.50
2024-06-20,08:16:00,20048.0,SELL,3,0.02h,Break Even,$-1.50,$-915.00,$58860.50,123,$-915.00
2024-06-20,08:22:00,20325.75,BUY,3,0.02h,Break Even,$-1.50,$-916.50,$58859.00,123,$-916.50
2024-06-20,08:27:00,20040.75,SELL,3,0.02h,Stop Loss,$-9.00,$-925.50,$58850.00,123,$-925.50
2024-06-20,08:30:00,20322.5,BUY,3,0.02h,Stop Loss,$-9.00,$-934.50,$58841.00,123,$-934.50
2024-06-20,08:38:00,20038.25,SELL,3,0.02h,Stop Loss,$-9.00,$-943.50,$58832.00,123,$-943.50
2024-06-20,08:43:00,20322.5,BUY,3,0.02h,Stop Loss,$-9.00,$-952.50,$58823.00,123,$-952.50
2024-06-20,08:44:00,20041.0,SELL,3,0.02h,Stop Loss,$-9.00,$-961.50,$58814.00,123,$-961.50
2024-06-20,08:45:00,20324.0,BUY,3,0.02h,Stop Loss,$-9.00,$-970.50,$58805.00,123,$-970.50
2024-06-20,08:46:00,20050.25,SELL,3,0.02h,Stop Loss,$4.50,$-966.00,$58809.50,123,$-966.00
2024-06-20,08:50:00,20320.75,BUY,3,0.02h,Stop Loss,$-9.00,$-975.00,$58800.50,123,$-975.00
2024-06-20,08:56:00,20049.25,SELL,3,0.03h,Stop Loss,$-9.00,$-984.00,$58791.50,123,$-984.00
2024-06-20,09:02:00,20328.25,BUY,3,0.02h,Break Even,$-1.50,$-985.50,$58790.00,123,$-985.50
2024-06-20,09:10:00,20047.0,SELL,3,0.02h,Stop Loss,$-9.00,$-994.50,$58781.00,123,$-994.50
2024-06-20,09:21:00,20316.5,BUY,3,0.02h,Break Even,$-1.50,$-996.00,$58779.50,123,$-996.00
2024-06-20,09:24:00,20043.0,SELL,3,0.02h,Stop Loss,$-9.00,$-1005.00,$58770.50,123,$-1005.00
2024-06-20,09:25:00,20324.0,BUY,3,0.02h,Stop Loss,$-9.00,$-1014.00,$58761.50,123,$-1014.00
2024-06-20,09:26:00,20043.0,SELL,3,0.02h,Stop Loss,$-9.00,$-1023.00,$58752.50,123,$-1023.00
2024-06-20,09:27:00,20325.75,BUY,3,0.02h,Stop Loss,$-9.00,$-1032.00,$58743.50,123,$-1032.00
2024-06-20,09:28:00,20044.5,SELL,3,0.02h,Stop Loss,$-9.00,$-1041.00,$58734.50,123,$-1041.00
2024-06-20,09:30:00,20324.0,BUY,3,0.02h,Stop Loss,$-9.00,$-1050.00,$58725.50,123,$-1050.00
2024-06-20,09:40:00,20038.0,SELL,3,0.02h,Break Even,$-1.50,$-1051.50,$58724.00,123,$-1051.50
2024-06-20,09:43:00,20316.5,BUY,3,0.02h,Stop Loss,$-9.00,$-1060.50,$58715.00,123,$-1060.50
2024-06-20,09:45:00,20034.25,SELL,3,0.02h,Stop Loss,$-9.00,$-1069.50,$58706.00,123,$-1069.50
2024-06-20,09:46:00,20311.5,BUY,3,0.02h,Stop Loss,$12.00,$-1057.50,$58718.00,123,$-1057.50
2024-06-20,09:54:00,20041.25,SELL,3,0.02h,Stop Loss,$-9.00,$-1066.50,$58709.00,123,$-1066.50
2024-06-20,09:55:00,20318.75,BUY,3,0.02h,Stop Loss,$3.00,$-1063.50,$58712.00,123,$-1063.50
2024-06-20,10:01:00,20044.25,SELL,3,0.02h,Stop Loss,$-9.00,$-1072.50,$58703.00,123,$-1072.50
2024-06-20,10:02:00,20320.75,BUY,3,0.02h,Stop Loss,$-9.00,$-1081.50,$58694.00,123,$-1081.50
2024-06-20,10:03:00,20043.25,SELL,3,0.03h,Stop Loss,$-9.00,$-1090.50,$58685.00,123,$-1090.50
2024-06-20,10:17:00,20324.75,BUY,3,0.02h,Stop Loss,$-9.00,$-1099.50,$58676.00,123,$-1099.50
2024-06-20,10:29:00,20051.5,SELL,3,0.02h,Break Even,$-1.50,$-1101.00,$58674.50,123,$-1101.00
2024-06-20,10:43:00,20333.0,BUY,3,0.02h,Stop Loss,$-9.00,$-1110.00,$58665.50,123,$-1110.00
2024-06-20,10:58:00,20046.5,SELL,3,0.02h,Break Even,$-1.50,$-1111.50,$58664.00,123,$-1111.50
2024-06-20,11:14:00,20320.0,BUY,3,0.02h,Break Even,$-1.50,$-1113.00,$58662.50,123,$-1113.00
2024-06-20,11:20:00,20040.5,SELL,3,0.02h,Stop Loss,$-9.00,$-1122.00,$58653.50,123,$-1122.00
2024-06-20,11:21:00,20312.5,BUY,3,0.02h,Stop Loss,$6.00,$-1116.00,$58659.50,123,$-1116.00
2024-06-20,11:24:00,20039.0,SELL,3,0.02h,Stop Loss,$-9.00,$-1125.00,$58650.50,123,$-1125.00
2024-06-20,11:27:00,20319.0,BUY,3,0.02h,Stop Loss,$-9.00,$-1134.00,$58641.50,123,$-1134.00
2024-06-20,11:38:00,20033.75,SELL,3,0.02h,Stop Loss,$-9.00,$-1143.00,$58632.50,123,$-1143.00
2024-06-20,11:40:00,20304.5,BUY,3,0.02h,Stop Loss,$10.50,$-1132.50,$58643.00,123,$-1132.50
2024-06-20,11:42:00,20031.75,SELL,3,0.02h,Stop Loss,$-9.00,$-1141.50,$58634.00,123,$-1141.50
2024-06-20,11:43:00,20308.5,BUY,3,0.02h,Stop Loss,$-9.00,$-1150.50,$58625.00,123,$-1150.50
2024-06-20,11:44:00,20035.75,SELL,3,0.02h,Stop Loss,$-9.00,$-1159.50,$58616.00,123,$-1159.50
2024-06-20,11:45:00,20310.0,BUY,3,0.02h,Stop Loss,$-9.00,$-1168.50,$58607.00,123,$-1168.50
2024-06-20,11:46:00,20030.0,SELL,3,0.02h,Stop Loss,$-9.00,$-1177.50,$58598.00,123,$-1177.50
2024-06-20,11:57:00,20300.0,BUY,3,0.02h,Stop Loss,$-9.00,$-1186.50,$58589.00,123,$-1186.50
2024-06-20,11:58:00,20026.75,SELL,3,0.02h,Stop Loss,$-9.00,$-1195.50,$58580.00,123,$-1195.50
2024-06-20,11:59:00,20300.0,BUY,3,0.02h,Stop Loss,$-9.00,$-1204.50,$58571.00,123,$-1204.50
2024-06-20,12:00:00,20020.75,SELL,3,0.02h,Stop Loss,$-9.00,$-1213.50,$58562.00,123,$-1213.50
2024-06-20,12:01:00,20295.75,BUY,3,0.02h,Stop Loss,$-9.00,$-1222.50,$58553.00,123,$-1222.50
2024-06-20,12:02:00,20022.75,SELL,3,0.02h,Stop Loss,$-9.00,$-1231.50,$58544.00,123,$-1231.50
2024-06-20,12:03:00,20301.75,BUY,3,0.02h,Stop Loss,$-9.00,$-1240.50,$58535.00,123,$-1240.50
2024-06-20,12:06:00,20024.75,SELL,3,0.02h,Stop Loss,$-9.00,$-1249.50,$58526.00,123,$-1249.50
2024-06-20,12:08:00,20297.25,BUY,3,0.02h,Stop Loss,$-9.00,$-1258.50,$58517.00,123,$-1258.50
2024-06-20,12:09:00,20019.25,SELL,3,0.03h,Stop Loss,$63.00,$-1195.50,$58580.00,123,$-1195.50
2024-06-20,12:13:00,20291.25,BUY,3,0.02h,Stop Loss,$-9.00,$-1204.50,$58571.00,123,$-1204.50
2024-06-20,12:14:00,20015.0,SELL,3,0.02h,Stop Loss,$-9.00,$-1213.50,$58562.00,123,$-1213.50
2024-06-20,12:15:00,20286.0,BUY,3,0.02h,Stop Loss,$-9.00,$-1222.50,$58553.00,123,$-1222.50
2024-06-20,12:16:00,20011.0,SELL,3,0.02h,Stop Loss,$-9.00,$-1231.50,$58544.00,123,$-1231.50
2024-06-20,12:18:00,20289.75,BUY,3,0.02h,Stop Loss,$-9.00,$-1240.50,$58535.00,123,$-1240.50
2024-06-20,12:24:00,20013.25,SELL,3,0.02h,Break Even,$-1.50,$-1242.00,$58533.50,123,$-1242.00
2024-06-20,12:40:00,20274.0,BUY,3,0.02h,Stop Loss,$-9.00,$-1251.00,$58524.50,123,$-1251.00
2024-06-20,12:41:00,19991.0,SELL,3,0.02h,Stop Loss,$-9.00,$-1260.00,$58515.50,123,$-1260.00
2024-06-20,12:42:00,20269.5,BUY,3,0.02h,Stop Loss,$-9.00,$-1269.00,$58506.50,123,$-1269.00
2024-06-20,12:43:00,19984.5,SELL,3,0.02h,Stop Loss,$-9.00,$-1278.00,$58497.50,123,$-1278.00
2024-06-20,12:46:00,20265.75,BUY,3,0.02h,Stop Loss,$22.50,$-1255.50,$58520.00,123,$-1255.50
2024-06-20,12:50:00,19997.75,SELL,3,0.02h,Break Even,$-1.50,$-1257.00,$58518.50,123,$-1257.00
2024-06-20,13:02:00,20263.75,BUY,3,0.02h,Stop Loss,$-9.00,$-1266.00,$58509.50,123,$-1266.00
2024-06-20,13:03:00,19991.0,SELL,3,0.02h,Break Even,$-1.50,$-1267.50,$58508.00,123,$-1267.50
2024-06-20,13:06:00,20265.5,BUY,3,0.02h,Stop Loss,$-9.00,$-1276.50,$58499.00,123,$-1276.50
2024-06-20,13:16:00,19979.25,SELL,3,0.02h,Stop Loss,$-9.00,$-1285.50,$58490.00,123,$-1285.50
2024-06-20,13:17:00,20250.5,BUY,3,0.02h,Stop Loss,$-9.00,$-1294.50,$58481.00,123,$-1294.50
2024-06-20,13:18:00,19974.0,SELL,3,0.02h,Stop Loss,$-9.00,$-1303.50,$58472.00,123,$-1303.50
2024-06-20,13:19:00,20254.0,BUY,3,0.02h,Stop Loss,$-9.00,$-1312.50,$58463.00,123,$-1312.50
2024-06-20,13:26:00,19977.25,SELL,3,0.02h,Stop Loss,$-9.00,$-1321.50,$58454.00,123,$-1321.50
2024-06-20,13:27:00,20251.75,BUY,3,0.02h,Stop Loss,$-9.00,$-1330.50,$58445.00,123,$-1330.50
2024-06-20,13:28:00,19972.5,SELL,3,0.02h,Stop Loss,$4.50,$-1326.00,$58449.50,123,$-1326.00
2024-06-20,13:38:00,20212.0,BUY,3,0.02h,Stop Loss,$-9.00,$-1335.00,$58440.50,123,$-1335.00
2024-06-20,13:39:00,19951.75,SELL,3,0.02h,Stop Loss,$-9.00,$-1344.00,$58431.50,123,$-1344.00
2024-06-20,13:40:00,20232.75,BUY,3,0.02h,Break Even,$-1.50,$-1345.50,$58430.00,123,$-1345.50
2024-06-20,13:43:00,19971.75,SELL,3,0.02h,Stop Loss,$19.50,$-1326.00,$58449.50,123,$-1326.00
2024-06-20,13:46:00,20259.25,BUY,3,0.02h,Stop Loss,$-9.00,$-1335.00,$58440.50,123,$-1335.00
2024-06-20,13:56:00,19966.0,SELL,3,0.02h,Stop Loss,$-9.00,$-1344.00,$58431.50,123,$-1344.00
2024-06-20,13:57:00,20228.5,BUY,3,0.02h,Stop Loss,$-9.00,$-1353.00,$58422.50,123,$-1353.00
2024-06-20,13:58:00,19964.25,SELL,3,0.02h,Stop Loss,$-9.00,$-1362.00,$58413.50,123,$-1362.00
2024-06-20,13:59:00,20231.25,BUY,3,0.02h,Stop Loss,$-9.00,$-1371.00,$58404.50,123,$-1371.00
2024-06-20,14:00:00,19961.25,SELL,3,0.02h,Stop Loss,$28.50,$-1342.50,$58433.00,123,$-1342.50
2024-06-20,14:06:00,20215.5,BUY,3,0.02h,Stop Loss,$-9.00,$-1351.50,$58424.00,123,$-1351.50
2024-06-20,14:07:00,19944.0,SELL,3,0.02h,Stop Loss,$36.00,$-1315.50,$58460.00,123,$-1315.50
2024-06-20,14:10:00,20191.5,BUY,3,0.02h,Stop Loss,$-9.00,$-1324.50,$58451.00,123,$-1324.50
2024-06-20,14:11:00,19906.75,SELL,3,0.02h,Stop Loss,$-9.00,$-1333.50,$58442.00,123,$-1333.50
2024-06-20,14:12:00,20165.75,BUY,3,0.02h,Stop Loss,$-9.00,$-1342.50,$58433.00,123,$-1342.50
2024-06-20,14:13:00,19884.75,SELL,3,0.02h,Stop Loss,$7.50,$-1335.00,$58440.50,123,$-1335.00
2024-06-20,14:21:00,20127.0,BUY,3,0.02h,Stop Loss,$63.00,$-1272.00,$58503.50,123,$-1272.00
2024-06-20,14:24:00,19886.5,SELL,3,0.02h,Stop Loss,$-9.00,$-1281.00,$58494.50,123,$-1281.00
2024-06-20,14:25:00,20144.75,BUY,3,0.02h,Stop Loss,$126.00,$-1155.00,$58620.50,123,$-1155.00
2024-06-20,14:31:00,19899.75,SELL,3,0.02h,Stop Loss,$-9.00,$-1164.00,$58611.50,123,$-1164.00
2024-06-20,14:37:00,20178.5,BUY,3,0.02h,Stop Loss,$51.00,$-1113.00,$58662.50,123,$-1113.00
2024-06-20,14:43:00,19913.25,SELL,3,0.02h,Stop Loss,$-9.00,$-1122.00,$58653.50,123,$-1122.00
2024-06-20,14:44:00,20190.0,BUY,3,0.02h,Stop Loss,$-9.00,$-1131.00,$58644.50,123,$-1131.00
2024-06-20,14:45:00,19915.25,SELL,3,0.02h,Break Even,$-1.50,$-1132.50,$58643.00,123,$-1132.50
2024-06-20,14:51:00,20187.5,BUY,3,0.02h,Stop Loss,$27.00,$-1105.50,$58670.00,123,$-1105.50
2024-06-20,15:06:00,19940.5,SELL,3,0.02h,Stop Loss,$-9.00,$-1114.50,$58661.00,123,$-1114.50
2024-06-20,15:08:00,20227.5,BUY,3,0.02h,Break Even,$-1.50,$-1116.00,$58659.50,123,$-1116.00
2024-06-20,15:10:00,19951.5,SELL,3,0.02h,Stop Loss,$-9.00,$-1125.00,$58650.50,123,$-1125.00
2024-06-20,15:11:00,20213.75,BUY,3,0.02h,Break Even,$-1.50,$-1126.50,$58649.00,123,$-1126.50
2024-06-20,15:13:00,19944.5,SELL,3,0.02h,Stop Loss,$27.00,$-1099.50,$58676.00,123,$-1099.50
2024-06-20,15:19:00,20202.5,BUY,3,0.02h,Stop Loss,$-9.00,$-1108.50,$58667.00,123,$-1108.50
2024-06-20,15:23:00,19916.5,SELL,3,0.02h,Break Even,$-1.50,$-1110.00,$58665.50,123,$-1110.00
2024-06-20,15:39:00,20198.5,BUY,3,0.02h,Stop Loss,$-9.00,$-1119.00,$58656.50,123,$-1119.00
2024-06-20,15:56:00,19911.0,SELL,3,0.02h,Stop Loss,$33.00,$-1086.00,$58689.50,123,$-1086.00
2024-06-20,16:16:00,20162.5,BUY,3,0.02h,Stop Loss,$-9.00,$-1095.00,$58680.50,123,$-1095.00
2024-06-20,16:19:00,19878.5,SELL,3,0.02h,Stop Loss,$-9.00,$-1104.00,$58671.50,123,$-1104.00
2024-06-20,16:20:00,20138.25,BUY,3,0.02h,Break Even,$-1.50,$-1105.50,$58670.00,123,$-1105.50
2024-06-20,16:23:00,19842.5,SELL,3,0.02h,Stop Loss,$72.00,$-1033.50,$58742.00,123,$-1033.50
2024-06-20,16:31:00,20039.0,BUY,3,0.02h,Stop Loss,$31.50,$-1002.00,$58773.50,123,$-1002.00
2024-06-20,16:33:00,19770.5,SELL,3,0.02h,Stop Loss,$-9.00,$-1011.00,$58764.50,123,$-1011.00
2024-06-20,16:35:00,20025.5,BUY,3,0.02h,Stop Loss,$109.50,$-901.50,$58874.00,123,$-901.50
2024-06-20,16:38:00,19752.75,SELL,3,0.02h,Stop Loss,$-9.00,$-910.50,$58865.00,123,$-910.50
2024-06-20,16:45:00,20059.5,BUY,3,0.02h,Stop Loss,$70.50,$-840.00,$58935.50,123,$-840.00
2024-06-20,16:47:00,19801.75,SELL,3,0.02h,Stop Loss,$-9.00,$-849.00,$58926.50,123,$-849.00
2024-06-20,16:48:00,20079.0,BUY,3,0.02h,Stop Loss,$-9.00,$-858.00,$58917.50,123,$-858.00
2024-06-20,16:57:00,19810.75,SELL,3,0.02h,Stop Loss,$28.50,$-829.50,$58946.00,123,$-829.50
2024-06-20,17:17:00,20045.0,BUY,3,0.02h,Stop Loss,$36.00,$-793.50,$58982.00,123,$-793.50
2024-06-20,17:26:00,19737.0,SELL,3,0.02h,Stop Loss,$-9.00,$-802.50,$58973.00,123,$-802.50
2024-06-20,17:27:00,20012.5,BUY,3,0.02h,Stop Loss,$25.50,$-777.00,$58998.50,123,$-777.00
2024-06-20,17:29:00,19737.0,SELL,3,0.02h,Stop Loss,$-9.00,$-786.00,$58989.50,123,$-786.00
2024-06-20,17:30:00,20006.5,BUY,3,0.02h,Stop Loss,$-9.00,$-795.00,$58980.50,123,$-795.00
2024-06-20,17:31:00,19747.5,SELL,3,0.02h,Stop Loss,$-9.00,$-804.00,$58971.50,123,$-804.00
2024-06-20,17:44:00,20005.75,BUY,3,0.02h,Stop Loss,$64.50,$-739.50,$59036.00,123,$-739.50
2024-06-20,17:55:00,19744.75,SELL,3,0.02h,Stop Loss,$-9.00,$-748.50,$59027.00,123,$-748.50
2024-06-20,18:06:00,20075.5,BUY,3,0.02h,Break Even,$-1.50,$-750.00,$59025.50,123,$-750.00
2024-06-20,18:15:00,19786.5,SELL,3,0.02h,Stop Loss,$-9.00,$-759.00,$59016.50,123,$-759.00
2024-06-20,18:16:00,20062.5,BUY,3,0.02h,Stop Loss,$10.50,$-748.50,$59027.00,123,$-748.50
2024-06-20,18:19:00,19794.0,SELL,3,0.02h,Stop Loss,$4.50,$-744.00,$59031.50,123,$-744.00
2024-06-20,18:23:00,20061.75,BUY,3,0.02h,Stop Loss,$13.50,$-730.50,$59045.00,123,$-730.50
2024-06-20,18:26:00,19795.75,SELL,3,0.02h,Stop Loss,$-9.00,$-739.50,$59036.00,123,$-739.50
2024-06-20,18:27:00,20052.75,BUY,3,0.02h,Stop Loss,$-9.00,$-748.50,$59027.00,123,$-748.50
2024-06-20,18:28:00,19797.5,SELL,3,0.02h,Stop Loss,$-9.00,$-757.50,$59018.00,123,$-757.50
2024-06-20,18:30:00,20068.5,BUY,3,0.02h,Break Even,$-1.50,$-759.00,$59016.50,123,$-759.00
2024-06-20,18:39:00,19767.0,SELL,3,0.02h,Stop Loss,$-9.00,$-768.00,$59007.50,123,$-768.00
2024-06-20,18:40:00,20042.5,BUY,3,0.02h,Stop Loss,$34.50,$-733.50,$59042.00,123,$-733.50
2024-06-20,18:45:00,19769.0,SELL,3,0.02h,Stop Loss,$-9.00,$-742.50,$59033.00,123,$-742.50
2024-06-20,18:48:00,20037.25,BUY,3,0.02h,Break Even,$-1.50,$-744.00,$59031.50,123,$-744.00
2024-06-20,18:52:00,19760.5,SELL,3,0.02h,Stop Loss,$-9.00,$-753.00,$59022.50,123,$-753.00
2024-06-20,18:53:00,20025.0,BUY,3,0.02h,Stop Loss,$28.50,$-724.50,$59051.00,123,$-724.50
2024-06-20,18:55:00,19759.5,SELL,3,0.02h,Stop Loss,$-9.00,$-733.50,$59042.00,123,$-733.50
2024-06-20,18:57:00,20033.75,BUY,3,0.02h,Stop Loss,$13.50,$-720.00,$59055.50,123,$-720.00
2024-06-20,19:03:00,19729.0,SELL,3,0.02h,Stop Loss,$73.50,$-646.50,$59129.00,123,$-646.50
2024-06-20,19:29:00,20021.25,BUY,3,0.02h,Stop Loss,$40.50,$-606.00,$59169.50,123,$-606.00
2024-06-20,19:40:00,19752.0,SELL,3,0.02h,Break Even,$-1.50,$-607.50,$59168.00,123,$-607.50
2024-06-20,19:42:00,20044.75,BUY,3,0.02h,Stop Loss,$-9.00,$-616.50,$59159.00,123,$-616.50
2024-06-20,19:44:00,19769.5,SELL,3,0.02h,Stop Loss,$-9.00,$-625.50,$59150.00,123,$-625.50
2024-06-20,19:48:00,20055.5,BUY,3,0.02h,Stop Loss,$-9.00,$-634.50,$59141.00,123,$-634.50
2024-06-20,19:58:00,19770.75,SELL,3,0.02h,Stop Loss,$24.00,$-610.50,$59165.00,123,$-610.50
2024-06-20,20:09:00,20046.25,BUY,3,0.02h,Stop Loss,$-9.00,$-619.50,$59156.00,123,$-619.50
2024-06-20,20:10:00,19779.25,SELL,3,0.02h,Stop Loss,$-9.00,$-628.50,$59147.00,123,$-628.50
2024-06-20,20:11:00,20047.75,BUY,3,0.02h,Stop Loss,$-9.00,$-637.50,$59138.00,123,$-637.50
2024-06-20,20:19:00,19778.25,SELL,3,0.02h,Stop Loss,$-9.00,$-646.50,$59129.00,123,$-646.50
2024-06-20,20:23:00,20046.25,BUY,3,0.02h,Stop Loss,$-9.00,$-655.50,$59120.00,123,$-655.50
2024-06-20,20:28:00,19772.5,SELL,3,0.02h,Stop Loss,$-9.00,$-664.50,$59111.00,123,$-664.50
2024-06-20,20:30:00,20046.0,BUY,3,0.02h,Stop Loss,$-9.00,$-673.50,$59102.00,123,$-673.50
2024-06-20,20:31:00,19781.25,SELL,3,0.02h,Stop Loss,$-9.00,$-682.50,$59093.00,123,$-682.50
2024-06-20,20:32:00,20047.75,BUY,3,0.02h,Stop Loss,$-9.00,$-691.50,$59084.00,123,$-691.50
2024-06-20,20:41:00,19782.0,SELL,3,0.02h,Break Even,$-1.50,$-693.00,$59082.50,123,$-693.00
2024-06-20,20:47:00,20050.0,BUY,3,0.02h,Stop Loss,$-9.00,$-702.00,$59073.50,123,$-702.00
2024-06-20,20:49:00,19782.0,SELL,3,0.02h,Break Even,$-1.50,$-703.50,$59072.00,123,$-703.50
2024-06-20,20:51:00,20052.0,BUY,3,0.02h,Stop Loss,$-9.00,$-712.50,$59063.00,123,$-712.50
2024-06-20,20:52:00,19782.0,SELL,3,0.02h,Stop Loss,$-9.00,$-721.50,$59054.00,123,$-721.50
2024-06-20,20:53:00,20053.0,BUY,3,0.02h,Stop Loss,$-9.00,$-730.50,$59045.00,123,$-730.50
2024-06-20,20:58:00,19782.75,SELL,3,0.03h,Stop Loss,$-9.00,$-739.50,$59036.00,123,$-739.50
2024-06-20,23:03:00,20063.0,BUY,3,0.02h,Break Even,$-1.50,$-741.00,$59034.50,123,$-741.00
2024-06-20,23:11:00,19793.25,SELL,3,0.02h,Stop Loss,$-9.00,$-750.00,$59025.50,123,$-750.00
2024-06-20,23:12:00,20065.0,BUY,3,0.05h,Stop Loss,$10.50,$-739.50,$59036.00,123,$-739.50
2024-06-20,23:17:00,19799.5,SELL,3,0.02h,Stop Loss,$-9.00,$-748.50,$59027.00,123,$-748.50
2024-06-20,23:18:00,20072.0,BUY,3,0.02h,Stop Loss,$-9.00,$-757.50,$59018.00,123,$-757.50
2024-06-20,23:19:00,19804.25,SELL,3,0.02h,Break Even,$-1.50,$-759.00,$59016.50,123,$-759.00
2024-06-20,23:21:00,20073.75,BUY,3,0.03h,Stop Loss,$-9.00,$-768.00,$59007.50,123,$-768.00
2024-06-20,23:23:00,19804.25,SELL,3,0.02h,Stop Loss,$-9.00,$-777.00,$58998.50,123,$-777.00
2024-06-20,23:27:00,20075.0,BUY,3,0.02h,Stop Loss,$-9.00,$-786.00,$58989.50,123,$-786.00
2024-06-20,23:28:00,19804.5,SELL,3,0.02h,Stop Loss,$-9.00,$-795.00,$58980.50,123,$-795.00
2024-06-20,23:29:00,20073.25,BUY,3,0.02h,Stop Loss,$-9.00,$-804.00,$58971.50,123,$-804.00
2024-06-20,23:30:00,19804.5,SELL,3,0.02h,Stop Loss,$-9.00,$-813.00,$58962.50,123,$-813.00
2024-06-20,23:31:00,20072.75,BUY,3,0.03h,Stop Loss,$-9.00,$-822.00,$58953.50,123,$-822.00
2024-06-20,23:35:00,19803.25,SELL,3,0.02h,Break Even,$-1.50,$-823.50,$58952.00,123,$-823.50
2024-06-20,23:45:00,20066.25,BUY,3,0.03h,Stop Loss,$-9.00,$-832.50,$58943.00,123,$-832.50
2024-06-20,23:48:00,19794.5,SELL,3,0.02h,Stop Loss,$-9.00,$-841.50,$58934.00,123,$-841.50
2024-06-20,23:49:00,20063.25,BUY,3,0.02h,Break Even,$-1.50,$-843.00,$58932.50,123,$-843.00
2024-06-20,23:59:00,19802.0,SELL,3,0.02h,Stop Loss,$-9.00,$-852.00,$58923.50,123,$-852.00
,,,,,,,,,,,
2024-06-21,00:00:00,20069.5,BUY,3,0.02h,Stop Loss,$-9.00,$-9.00,$58914.50,124,$-9.00
2024-06-21,00:01:00,19802.0,SELL,3,0.02h,Stop Loss,$-9.00,$-18.00,$58905.50,124,$-18.00
2024-06-21,00:02:00,20070.75,BUY,3,0.02h,Stop Loss,$-9.00,$-27.00,$58896.50,124,$-27.00
2024-06-21,00:10:00,19792.5,SELL,3,0.03h,Stop Loss,$-9.00,$-36.00,$58887.50,124,$-36.00
2024-06-21,00:15:00,20055.0,BUY,3,0.02h,Stop Loss,$10.50,$-25.50,$58898.00,124,$-25.50
2024-06-21,00:17:00,19792.0,SELL,3,0.02h,Stop Loss,$-9.00,$-34.50,$58889.00,124,$-34.50
2024-06-21,00:18:00,20055.5,BUY,3,0.02h,Stop Loss,$-9.00,$-43.50,$58880.00,124,$-43.50
2024-06-21,00:19:00,19783.25,SELL,3,0.02h,Stop Loss,$-9.00,$-52.50,$58871.00,124,$-52.50
2024-06-21,00:29:00,20049.5,BUY,3,0.02h,Break Even,$-1.50,$-54.00,$58869.50,124,$-54.00
2024-06-21,00:35:00,19785.75,SELL,3,0.02h,Stop Loss,$-9.00,$-63.00,$58860.50,124,$-63.00
2024-06-21,00:36:00,20053.25,BUY,3,0.02h,Stop Loss,$-9.00,$-72.00,$58851.50,124,$-72.00
2024-06-21,00:37:00,19783.75,SELL,3,0.02h,Stop Loss,$3.00,$-69.00,$58854.50,124,$-69.00
2024-06-21,00:47:00,20050.75,BUY,3,0.02h,Stop Loss,$-9.00,$-78.00,$58845.50,124,$-78.00
2024-06-21,00:50:00,19773.5,SELL,3,0.02h,Stop Loss,$-9.00,$-87.00,$58836.50,124,$-87.00
2024-06-21,00:51:00,20039.0,BUY,3,0.02h,Stop Loss,$10.50,$-76.50,$58847.00,124,$-76.50
2024-06-21,00:57:00,19772.0,SELL,3,0.02h,Stop Loss,$-9.00,$-85.50,$58838.00,124,$-85.50
2024-06-21,00:58:00,20038.0,BUY,3,0.02h,Stop Loss,$-9.00,$-94.50,$58829.00,124,$-94.50
2024-06-21,00:59:00,19769.25,SELL,3,0.02h,Stop Loss,$-9.00,$-103.50,$58820.00,124,$-103.50
2024-06-21,01:00:00,20035.25,BUY,3,0.02h,Stop Loss,$15.00,$-88.50,$58835.00,124,$-88.50
2024-06-21,01:11:00,19775.75,SELL,3,0.02h,Stop Loss,$-9.00,$-97.50,$58826.00,124,$-97.50
2024-06-21,01:15:00,20035.25,BUY,3,0.02h,Break Even,$-1.50,$-99.00,$58824.50,124,$-99.00
2024-06-21,01:19:00,19774.25,SELL,3,0.02h,Break Even,$-1.50,$-100.50,$58823.00,124,$-100.50
2024-06-21,01:32:00,20042.25,BUY,3,0.02h,Stop Loss,$-9.00,$-109.50,$58814.00,124,$-109.50
2024-06-21,01:58:00,19779.5,SELL,3,0.05h,Break Even,$-1.50,$-111.00,$58812.50,124,$-111.00
2024-06-21,02:07:00,20043.25,BUY,3,0.02h,Stop Loss,$-9.00,$-120.00,$58803.50,124,$-120.00
2024-06-21,02:22:00,19776.75,SELL,3,0.03h,Stop Loss,$-9.00,$-129.00,$58794.50,124,$-129.00
2024-06-21,02:29:00,20041.0,BUY,3,0.02h,Stop Loss,$-9.00,$-138.00,$58785.50,124,$-138.00
2024-06-21,02:31:00,19778.25,SELL,3,0.02h,Stop Loss,$-9.00,$-147.00,$58776.50,124,$-147.00
2024-06-21,02:33:00,20052.0,BUY,3,0.02h,Break Even,$-1.50,$-148.50,$58775.00,124,$-148.50
2024-06-21,02:37:00,19789.75,SELL,3,0.02h,Stop Loss,$3.00,$-145.50,$58778.00,124,$-145.50
2024-06-21,02:42:00,20053.5,BUY,3,0.02h,Break Even,$-1.50,$-147.00,$58776.50,124,$-147.00
2024-06-21,02:47:00,19788.25,SELL,3,0.02h,Stop Loss,$-9.00,$-156.00,$58767.50,124,$-156.00
2024-06-21,02:48:00,20055.25,BUY,3,0.02h,Stop Loss,$-9.00,$-165.00,$58758.50,124,$-165.00
2024-06-21,02:49:00,19791.5,SELL,3,0.02h,Stop Loss,$-9.00,$-174.00,$58749.50,124,$-174.00
2024-06-21,02:58:00,20057.75,BUY,3,0.02h,Stop Loss,$-9.00,$-183.00,$58740.50,124,$-183.00
2024-06-21,02:59:00,19791.25,SELL,3,0.02h,Stop Loss,$-9.00,$-192.00,$58731.50,124,$-192.00
2024-06-21,03:04:00,20060.0,BUY,3,0.03h,Stop Loss,$-9.00,$-201.00,$58722.50,124,$-201.00
2024-06-21,03:06:00,19794.75,SELL,3,0.07h,Break Even,$-1.50,$-202.50,$58721.00,124,$-202.50
2024-06-21,03:11:00,20057.0,BUY,3,0.10h,Stop Loss,$7.50,$-195.00,$58728.50,124,$-195.00
2024-06-21,03:18:00,19794.25,SELL,3,0.02h,Stop Loss,$-9.00,$-204.00,$58719.50,124,$-204.00
2024-06-21,03:19:00,20061.25,BUY,3,0.02h,Stop Loss,$-9.00,$-213.00,$58710.50,124,$-213.00
2024-06-21,03:20:00,19796.5,SELL,3,0.02h,Stop Loss,$-9.00,$-222.00,$58701.50,124,$-222.00
2024-06-21,03:21:00,20061.75,BUY,3,0.05h,Stop Loss,$-9.00,$-231.00,$58692.50,124,$-231.00
2024-06-21,03:29:00,19795.5,SELL,3,0.02h,Stop Loss,$-9.00,$-240.00,$58683.50,124,$-240.00
2024-06-21,03:31:00,20061.0,BUY,3,0.02h,Stop Loss,$-9.00,$-249.00,$58674.50,124,$-249.00
2024-06-21,03:32:00,19793.5,SELL,3,0.02h,Break Even,$-1.50,$-250.50,$58673.00,124,$-250.50
2024-06-21,03:35:00,20058.5,BUY,3,0.02h,Stop Loss,$-9.00,$-259.50,$58664.00,124,$-259.50
2024-06-21,03:37:00,19792.5,SELL,3,0.02h,Stop Loss,$-9.00,$-268.50,$58655.00,124,$-268.50
2024-06-21,03:38:00,20059.5,BUY,3,0.02h,Stop Loss,$-9.00,$-277.50,$58646.00,124,$-277.50
2024-06-21,03:41:00,19791.0,SELL,3,0.03h,Stop Loss,$-9.00,$-286.50,$58637.00,124,$-286.50
2024-06-21,04:12:00,20053.75,BUY,3,0.02h,Stop Loss,$-9.00,$-295.50,$58628.00,124,$-295.50
2024-06-21,04:13:00,19788.75,SELL,3,0.02h,Break Even,$-1.50,$-297.00,$58626.50,124,$-297.00
2024-06-21,04:16:00,20054.0,BUY,3,0.02h,Stop Loss,$-9.00,$-306.00,$58617.50,124,$-306.00
2024-06-21,04:31:00,19795.5,SELL,3,0.03h,Stop Loss,$6.00,$-300.00,$58623.50,124,$-300.00
2024-06-21,04:34:00,20059.5,BUY,3,0.07h,Break Even,$-1.50,$-301.50,$58622.00,124,$-301.50
2024-06-21,04:41:00,19797.0,SELL,3,0.03h,Break Even,$-1.50,$-303.00,$58620.50,124,$-303.00
2024-06-21,04:44:00,20063.0,BUY,3,0.02h,Stop Loss,$-9.00,$-312.00,$58611.50,124,$-312.00
2024-06-21,04:55:00,19802.75,SELL,3,0.02h,Stop Loss,$-9.00,$-321.00,$58602.50,124,$-321.00
2024-06-21,04:56:00,20067.75,BUY,3,0.02h,Stop Loss,$-9.00,$-330.00,$58593.50,124,$-330.00
2024-06-21,05:04:00,19801.5,SELL,3,0.03h,Stop Loss,$-9.00,$-339.00,$58584.50,124,$-339.00
2024-06-21,05:09:00,20070.5,BUY,3,0.02h,Break Even,$-1.50,$-340.50,$58583.00,124,$-340.50
2024-06-21,05:12:00,19807.75,SELL,3,0.05h,Stop Loss,$10.50,$-330.00,$58593.50,124,$-330.00
2024-06-21,05:21:00,20070.5,BUY,3,0.03h,Stop Loss,$7.50,$-322.50,$58601.00,124,$-322.50
2024-06-21,05:32:00,19809.0,SELL,3,0.02h,Stop Loss,$-9.00,$-331.50,$58592.00,124,$-331.50
2024-06-21,05:33:00,20074.75,BUY,3,0.02h,Stop Loss,$-9.00,$-340.50,$58583.00,124,$-340.50
2024-06-21,05:34:00,19809.0,SELL,3,0.03h,Stop Loss,$-9.00,$-349.50,$58574.00,124,$-349.50
2024-06-21,05:38:00,20074.25,BUY,3,0.02h,Break Even,$-1.50,$-351.00,$58572.50,124,$-351.00
2024-06-21,05:41:00,19809.75,SELL,3,0.02h,Stop Loss,$-9.00,$-360.00,$58563.50,124,$-360.00
2024-06-21,05:42:00,20072.5,BUY,3,0.02h,Stop Loss,$-9.00,$-369.00,$58554.50,124,$-369.00
2024-06-21,05:43:00,19805.25,SELL,3,0.02h,Stop Loss,$-9.00,$-378.00,$58545.50,124,$-378.00
2024-06-21,05:57:00,20071.0,BUY,3,0.02h,Break Even,$-1.50,$-379.50,$58544.00,124,$-379.50
2024-06-21,06:02:00,19811.25,SELL,3,0.02h,Stop Loss,$-9.00,$-388.50,$58535.00,124,$-388.50
2024-06-21,06:05:00,20075.5,BUY,3,0.02h,Stop Loss,$-9.00,$-397.50,$58526.00,124,$-397.50
2024-06-21,06:06:00,19810.75,SELL,3,0.02h,Stop Loss,$-9.00,$-406.50,$58517.00,124,$-406.50
2024-06-21,06:07:00,20076.75,BUY,3,0.02h,Stop Loss,$-9.00,$-415.50,$58508.00,124,$-415.50
2024-06-21,06:11:00,19815.75,SELL,3,0.02h,Stop Loss,$-9.00,$-424.50,$58499.00,124,$-424.50
2024-06-21,06:28:00,20076.75,BUY,3,0.02h,Stop Loss,$-9.00,$-433.50,$58490.00,124,$-433.50
2024-06-21,06:29:00,19811.25,SELL,3,0.03h,Stop Loss,$-9.00,$-442.50,$58481.00,124,$-442.50
2024-06-21,06:31:00,20077.5,BUY,3,0.02h,Break Even,$-1.50,$-444.00,$58479.50,124,$-444.00
2024-06-21,06:43:00,19810.75,SELL,3,0.02h,Stop Loss,$-9.00,$-453.00,$58470.50,124,$-453.00
2024-06-21,06:44:00,20078.25,BUY,3,0.02h,Stop Loss,$-9.00,$-462.00,$58461.50,124,$-462.00
2024-06-21,06:48:00,19812.75,SELL,3,0.05h,Break Even,$-1.50,$-463.50,$58460.00,124,$-463.50
2024-06-21,07:02:00,20066.5,BUY,3,0.02h,Stop Loss,$-9.00,$-472.50,$58451.00,124,$-472.50
2024-06-21,07:03:00,19791.25,SELL,3,0.02h,Stop Loss,$-9.00,$-481.50,$58442.00,124,$-481.50
2024-06-21,07:04:00,20049.5,BUY,3,0.02h,Stop Loss,$15.00,$-466.50,$58457.00,124,$-466.50
2024-06-21,07:07:00,19782.75,SELL,3,0.02h,Break Even,$-1.50,$-468.00,$58455.50,124,$-468.00
2024-06-21,07:15:00,20044.75,BUY,3,0.02h,Break Even,$-1.50,$-469.50,$58454.00,124,$-469.50
2024-06-21,07:18:00,19770.0,SELL,3,0.02h,Break Even,$-1.50,$-471.00,$58452.50,124,$-471.00
2024-06-21,07:20:00,20037.5,BUY,3,0.02h,Break Even,$-1.50,$-472.50,$58451.00,124,$-472.50
2024-06-21,07:22:00,19769.25,SELL,3,0.02h,Stop Loss,$-9.00,$-481.50,$58442.00,124,$-481.50
2024-06-21,07:23:00,20032.25,BUY,3,0.02h,Stop Loss,$-9.00,$-490.50,$58433.00,124,$-490.50
2024-06-21,07:24:00,19757.0,SELL,3,0.02h,Break Even,$-1.50,$-492.00,$58431.50,124,$-492.00
2024-06-21,07:33:00,20013.0,BUY,3,0.02h,Stop Loss,$6.00,$-486.00,$58437.50,124,$-486.00
2024-06-21,07:38:00,19740.75,SELL,3,0.02h,Stop Loss,$-9.00,$-495.00,$58428.50,124,$-495.00
2024-06-21,07:39:00,20014.5,BUY,3,0.02h,Stop Loss,$-9.00,$-504.00,$58419.50,124,$-504.00
2024-06-21,07:40:00,19756.75,SELL,3,0.02h,Stop Loss,$-9.00,$-513.00,$58410.50,124,$-513.00
2024-06-21,07:41:00,20032.5,BUY,3,0.02h,Stop Loss,$-9.00,$-522.00,$58401.50,124,$-522.00
2024-06-21,07:42:00,19776.25,SELL,3,0.02h,Stop Loss,$-9.00,$-531.00,$58392.50,124,$-531.00
2024-06-21,07:43:00,20037.75,BUY,3,0.02h,Break Even,$-1.50,$-532.50,$58391.00,124,$-532.50
2024-06-21,07:48:00,19774.5,SELL,3,0.02h,Stop Loss,$51.00,$-481.50,$58442.00,124,$-481.50
2024-06-21,07:54:00,20026.25,BUY,3,0.02h,Stop Loss,$-9.00,$-490.50,$58433.00,124,$-490.50
2024-06-21,07:55:00,19754.25,SELL,3,0.02h,Stop Loss,$-9.00,$-499.50,$58424.00,124,$-499.50
2024-06-21,08:02:00,20030.0,BUY,3,0.02h,Stop Loss,$-9.00,$-508.50,$58415.00,124,$-508.50
2024-06-21,08:03:00,19761.5,SELL,3,0.02h,Stop Loss,$-9.00,$-517.50,$58406.00,124,$-517.50
2024-06-21,08:15:00,19993.75,BUY,3,0.02h,Stop Loss,$13.50,$-504.00,$58419.50,124,$-504.00
2024-06-21,08:26:00,19716.0,SELL,3,0.02h,Stop Loss,$-9.00,$-513.00,$58410.50,124,$-513.00
2024-06-21,08:27:00,19986.5,BUY,3,0.02h,Stop Loss,$-9.00,$-522.00,$58401.50,124,$-522.00
2024-06-21,08:29:00,19713.25,SELL,3,0.02h,Break Even,$-1.50,$-523.50,$58400.00,124,$-523.50
2024-06-21,08:35:00,19979.75,BUY,3,0.02h,Stop Loss,$-9.00,$-532.50,$58391.00,124,$-532.50
2024-06-21,08:36:00,19711.75,SELL,3,0.02h,Stop Loss,$-9.00,$-541.50,$58382.00,124,$-541.50
2024-06-21,08:40:00,19960.5,BUY,3,0.02h,Break Even,$-1.50,$-543.00,$58380.50,124,$-543.00
2024-06-21,08:45:00,19714.5,SELL,3,0.02h,Stop Loss,$-9.00,$-552.00,$58371.50,124,$-552.00
2024-06-21,08:46:00,19977.0,BUY,3,0.02h,Break Even,$-1.50,$-553.50,$58370.00,124,$-553.50
2024-06-21,08:48:00,19718.75,SELL,3,0.02h,Stop Loss,$-9.00,$-562.50,$58361.00,124,$-562.50
2024-06-21,08:49:00,19985.25,BUY,3,0.02h,Break Even,$-1.50,$-564.00,$58359.50,124,$-564.00
2024-06-21,08:54:00,19709.75,SELL,3,0.02h,Stop Loss,$-9.00,$-573.00,$58350.50,124,$-573.00
2024-06-21,08:55:00,19969.75,BUY,3,0.02h,Break Even,$-1.50,$-574.50,$58349.00,124,$-574.50
2024-06-21,08:57:00,19703.0,SELL,3,0.02h,Stop Loss,$-9.00,$-583.50,$58340.00,124,$-583.50
2024-06-21,08:58:00,19968.25,BUY,3,0.02h,Stop Loss,$-9.00,$-592.50,$58331.00,124,$-592.50
2024-06-21,08:59:00,19708.75,SELL,3,0.02h,Stop Loss,$-9.00,$-601.50,$58322.00,124,$-601.50
2024-06-21,09:03:00,19985.25,BUY,3,0.02h,Stop Loss,$-9.00,$-610.50,$58313.00,124,$-610.50
2024-06-21,09:08:00,19726.25,SELL,3,0.03h,Break Even,$-1.50,$-612.00,$58311.50,124,$-612.00
2024-06-21,09:11:00,19982.25,BUY,3,0.02h,Stop Loss,$-9.00,$-621.00,$58302.50,124,$-621.00
2024-06-21,09:12:00,19725.0,SELL,3,0.02h,Break Even,$-1.50,$-622.50,$58301.00,124,$-622.50
2024-06-21,09:23:00,19994.0,BUY,3,0.02h,Break Even,$-1.50,$-624.00,$58299.50,124,$-624.00
2024-06-21,09:39:00,19747.0,SELL,3,0.02h,Break Even,$-1.50,$-625.50,$58298.00,124,$-625.50
2024-06-21,09:49:00,20007.75,BUY,3,0.02h,Stop Loss,$-9.00,$-634.50,$58289.00,124,$-634.50
2024-06-21,09:50:00,19748.25,SELL,3,0.02h,Stop Loss,$6.00,$-628.50,$58295.00,124,$-628.50
2024-06-21,09:52:00,20004.75,BUY,3,0.02h,Stop Loss,$-9.00,$-637.50,$58286.00,124,$-637.50
2024-06-21,09:53:00,19749.75,SELL,3,0.02h,Stop Loss,$-9.00,$-646.50,$58277.00,124,$-646.50
2024-06-21,09:55:00,20010.75,BUY,3,0.02h,Stop Loss,$-9.00,$-655.50,$58268.00,124,$-655.50
2024-06-21,09:56:00,19750.75,SELL,3,0.02h,Stop Loss,$-9.00,$-664.50,$58259.00,124,$-664.50
2024-06-21,09:57:00,20011.0,BUY,3,0.02h,Stop Loss,$-9.00,$-673.50,$58250.00,124,$-673.50
2024-06-21,09:58:00,19749.25,SELL,3,0.02h,Stop Loss,$12.00,$-661.50,$58262.00,124,$-661.50
2024-06-21,10:00:00,20008.25,BUY,3,0.02h,Stop Loss,$13.50,$-648.00,$58275.50,124,$-648.00
2024-06-21,10:04:00,19755.75,SELL,3,0.02h,Break Even,$-1.50,$-649.50,$58274.00,124,$-649.50
2024-06-21,10:11:00,20015.0,BUY,3,0.02h,Stop Loss,$-9.00,$-658.50,$58265.00,124,$-658.50
2024-06-21,10:12:00,19754.0,SELL,3,0.02h,Stop Loss,$-9.00,$-667.50,$58256.00,124,$-667.50
2024-06-21,10:13:00,20016.0,BUY,3,0.02h,Break Even,$-1.50,$-669.00,$58254.50,124,$-669.00
2024-06-21,10:20:00,19754.0,SELL,3,0.02h,Break Even,$-1.50,$-670.50,$58253.00,124,$-670.50
2024-06-21,10:23:00,20009.25,BUY,3,0.02h,Stop Loss,$18.00,$-652.50,$58271.00,124,$-652.50
2024-06-21,10:27:00,19740.75,SELL,3,0.03h,Break Even,$-1.50,$-654.00,$58269.50,124,$-654.00
2024-06-21,10:42:00,20013.5,BUY,3,0.02h,Stop Loss,$-9.00,$-663.00,$58260.50,124,$-663.00
2024-06-21,10:43:00,19751.75,SELL,3,0.03h,Break Even,$-1.50,$-664.50,$58259.00,124,$-664.50
2024-06-21,10:45:00,20017.25,BUY,3,0.02h,Stop Loss,$-9.00,$-673.50,$58250.00,124,$-673.50
2024-06-21,10:47:00,19748.5,SELL,3,0.02h,Stop Loss,$-9.00,$-682.50,$58241.00,124,$-682.50
2024-06-21,10:48:00,20013.0,BUY,3,0.02h,Stop Loss,$-9.00,$-691.50,$58232.00,124,$-691.50
2024-06-21,10:53:00,19744.5,SELL,3,0.03h,Break Even,$-1.50,$-693.00,$58230.50,124,$-693.00
2024-06-21,10:58:00,20013.5,BUY,3,0.02h,Stop Loss,$6.00,$-687.00,$58236.50,124,$-687.00
2024-06-21,11:01:00,19754.5,SELL,3,0.02h,Stop Loss,$-9.00,$-696.00,$58227.50,124,$-696.00
2024-06-21,11:02:00,20022.75,BUY,3,0.02h,Stop Loss,$-9.00,$-705.00,$58218.50,124,$-705.00
2024-06-21,11:04:00,19758.75,SELL,3,0.02h,Stop Loss,$-9.00,$-714.00,$58209.50,124,$-714.00
2024-06-21,11:07:00,20040.5,BUY,3,0.02h,Stop Loss,$-9.00,$-723.00,$58200.50,124,$-723.00
2024-06-21,11:09:00,19767.5,SELL,3,0.02h,Stop Loss,$-9.00,$-732.00,$58191.50,124,$-732.00
2024-06-21,11:10:00,20033.25,BUY,3,0.02h,Stop Loss,$-9.00,$-741.00,$58182.50,124,$-741.00
2024-06-21,11:17:00,19752.75,SELL,3,0.02h,Break Even,$-1.50,$-742.50,$58181.00,124,$-742.50
2024-06-21,11:20:00,20023.75,BUY,3,0.02h,Stop Loss,$-9.00,$-751.50,$58172.00,124,$-751.50
2024-06-21,11:21:00,19761.5,SELL,3,0.02h,Stop Loss,$-9.00,$-760.50,$58163.00,124,$-760.50
2024-06-21,11:23:00,20034.0,BUY,3,0.02h,Stop Loss,$-9.00,$-769.50,$58154.00,124,$-769.50
2024-06-21,11:24:00,19763.25,SELL,3,0.02h,Break Even,$-1.50,$-771.00,$58152.50,124,$-771.00
2024-06-21,11:26:00,20026.75,BUY,3,0.02h,Stop Loss,$3.00,$-768.00,$58155.50,124,$-768.00
2024-06-21,11:29:00,19764.75,SELL,3,0.02h,Stop Loss,$-9.00,$-777.00,$58146.50,124,$-777.00
2024-06-21,11:30:00,20029.5,BUY,3,0.02h,Stop Loss,$-9.00,$-786.00,$58137.50,124,$-786.00
2024-06-21,11:31:00,19760.0,SELL,3,0.02h,Stop Loss,$-9.00,$-795.00,$58128.50,124,$-795.00
2024-06-21,11:32:00,20021.75,BUY,3,0.02h,Stop Loss,$-9.00,$-804.00,$58119.50,124,$-804.00
2024-06-21,11:33:00,19758.25,SELL,3,0.02h,Stop Loss,$-9.00,$-813.00,$58110.50,124,$-813.00
2024-06-21,11:36:00,20022.5,BUY,3,0.02h,Break Even,$-1.50,$-814.50,$58109.00,124,$-814.50
2024-06-21,11:52:00,19734.0,SELL,3,0.02h,Break Even,$-1.50,$-816.00,$58107.50,124,$-816.00
2024-06-21,11:57:00,20006.75,BUY,3,0.02h,Stop Loss,$-9.00,$-825.00,$58098.50,124,$-825.00
2024-06-21,11:59:00,19731.5,SELL,3,0.02h,Stop Loss,$-9.00,$-834.00,$58089.50,124,$-834.00
2024-06-21,12:01:00,19982.75,BUY,3,0.02h,Stop Loss,$25.50,$-808.50,$58115.00,124,$-808.50
2024-06-21,12:04:00,19735.0,SELL,3,0.02h,Break Even,$-1.50,$-810.00,$58113.50,124,$-810.00
2024-06-21,12:11:00,19992.0,BUY,3,0.02h,Break Even,$-1.50,$-811.50,$58112.00,124,$-811.50
2024-06-21,12:14:00,19725.5,SELL,3,0.02h,Stop Loss,$-9.00,$-820.50,$58103.00,124,$-820.50
2024-06-21,12:15:00,19986.75,BUY,3,0.02h,Stop Loss,$-9.00,$-829.50,$58094.00,124,$-829.50
2024-06-21,12:19:00,19732.5,SELL,3,0.02h,Stop Loss,$-9.00,$-838.50,$58085.00,124,$-838.50
2024-06-21,12:20:00,19995.75,BUY,3,0.02h,Stop Loss,$-9.00,$-847.50,$58076.00,124,$-847.50
2024-06-21,12:21:00,19727.75,SELL,3,0.02h,Stop Loss,$-9.00,$-856.50,$58067.00,124,$-856.50
2024-06-21,12:34:00,20007.5,BUY,3,0.02h,Stop Loss,$24.00,$-832.50,$58091.00,124,$-832.50
2024-06-21,12:44:00,19762.0,SELL,3,0.02h,Break Even,$-1.50,$-834.00,$58089.50,124,$-834.00
2024-06-21,12:51:00,20030.75,BUY,3,0.02h,Stop Loss,$-9.00,$-843.00,$58080.50,124,$-843.00
2024-06-21,12:52:00,19764.75,SELL,3,0.02h,Break Even,$-1.50,$-844.50,$58079.00,124,$-844.50
2024-06-21,12:58:00,20032.25,BUY,3,0.02h,Break Even,$-1.50,$-846.00,$58077.50,124,$-846.00
2024-06-21,13:01:00,19767.75,SELL,3,0.02h,Break Even,$-1.50,$-847.50,$58076.00,124,$-847.50
2024-06-21,13:03:00,20026.0,BUY,3,0.02h,Stop Loss,$-9.00,$-856.50,$58067.00,124,$-856.50
2024-06-21,13:04:00,19752.0,SELL,3,0.02h,Stop Loss,$-9.00,$-865.50,$58058.00,124,$-865.50
2024-06-21,13:05:00,20022.0,BUY,3,0.02h,Stop Loss,$-9.00,$-874.50,$58049.00,124,$-874.50
2024-06-21,13:06:00,19747.0,SELL,3,0.02h,Stop Loss,$-9.00,$-883.50,$58040.00,124,$-883.50
2024-06-21,13:07:00,20015.75,BUY,3,0.02h,Stop Loss,$21.00,$-862.50,$58061.00,124,$-862.50
2024-06-21,13:18:00,19767.5,SELL,3,0.02h,Stop Loss,$-9.00,$-871.50,$58052.00,124,$-871.50
2024-06-21,13:19:00,20040.0,BUY,3,0.02h,Break Even,$-1.50,$-873.00,$58050.50,124,$-873.00
2024-06-21,13:21:00,19769.0,SELL,3,0.02h,Break Even,$-1.50,$-874.50,$58049.00,124,$-874.50
2024-06-21,13:25:00,20031.25,BUY,3,0.02h,Stop Loss,$-9.00,$-883.50,$58040.00,124,$-883.50
2024-06-21,13:26:00,19757.5,SELL,3,0.02h,Stop Loss,$-9.00,$-892.50,$58031.00,124,$-892.50
2024-06-21,13:32:00,19994.25,BUY,3,0.02h,Stop Loss,$144.00,$-748.50,$58175.00,124,$-748.50
2024-06-21,13:52:00,19929.25,SELL,3,0.02h,Stop Loss,$70.50,$-678.00,$58245.50,124,$-678.00
2024-06-21,14:03:00,19967.25,BUY,3,0.02h,Stop Loss,$9.00,$-669.00,$58254.50,124,$-669.00
2024-06-21,14:27:00,19965.75,SELL,3,0.02h,Stop Loss,$16.50,$-652.50,$58271.00,124,$-652.50
2024-06-21,14:47:00,19977.75,BUY,3,0.02h,Stop Loss,$46.50,$-606.00,$58317.50,124,$-606.00
2024-06-21,15:29:00,19994.5,SELL,3,0.02h,Stop Loss,$4.50,$-601.50,$58322.00,124,$-601.50
2024-06-21,15:43:00,20013.0,BUY,3,0.02h,Stop Loss,$6.00,$-595.50,$58328.00,124,$-595.50
2024-06-21,16:16:00,20043.75,SELL,3,0.02h,Break Even,$-1.50,$-597.00,$58326.50,124,$-597.00
2024-06-21,16:17:00,20053.75,BUY,3,0.02h,Stop Loss,$15.00,$-582.00,$58341.50,124,$-582.00
2024-06-21,16:25:00,20042.75,SELL,3,0.02h,Stop Loss,$12.00,$-570.00,$58353.50,124,$-570.00
2024-06-21,17:52:00,19977.75,BUY,3,0.02h,Stop Loss,$46.50,$-523.50,$58400.00,124,$-523.50
2024-06-21,18:00:00,19961.25,SELL,3,0.02h,Break Even,$-1.50,$-525.00,$58398.50,124,$-525.00
2024-06-21,18:12:00,19974.5,BUY,3,0.02h,Stop Loss,$18.00,$-507.00,$58416.50,124,$-507.00
2024-06-21,18:40:00,19982.25,SELL,3,0.02h,Break Even,$-1.50,$-508.50,$58415.00,124,$-508.50
2024-06-21,19:03:00,19989.75,BUY,3,0.02h,Stop Loss,$21.00,$-487.50,$58436.00,124,$-487.50
2024-06-21,19:31:00,19993.5,SELL,3,0.02h,Break Even,$-1.50,$-489.00,$58434.50,124,$-489.00
2024-06-21,19:35:00,20002.75,BUY,3,0.02h,Stop Loss,$6.00,$-483.00,$58440.50,124,$-483.00
2024-06-21,19:47:00,19992.0,SELL,3,0.02h,Stop Loss,$7.50,$-475.50,$58448.00,124,$-475.50
2024-06-21,19:55:00,20001.5,BUY,3,0.02h,Break Even,$-1.50,$-477.00,$58446.50,124,$-477.00
2024-06-21,19:56:00,19997.0,SELL,3,0.02h,Stop Loss,$33.00,$-444.00,$58479.50,124,$-444.00
2024-06-21,20:09:00,19998.5,BUY,3,0.02h,Stop Loss,$-9.00,$-453.00,$58470.50,124,$-453.00
2024-06-21,20:55:00,20006.5,SELL,3,0.05h,Stop Loss,$-9.00,$-462.00,$58461.50,124,$-462.00
2024-06-21,21:00:00,20009.0,BUY,3,51.00h,Stop Loss,$-9.00,$-471.00,$58452.50,124,$-471.00
,,,,,,,,,,,
2024-06-24,00:02:00,20003.0,SELL,3,0.02h,Stop Loss,$-9.00,$-9.00,$58443.50,125,$-9.00
2024-06-24,00:19:00,20008.0,BUY,3,0.02h,Stop Loss,$-9.00,$-18.00,$58434.50,125,$-18.00
2024-06-24,00:52:00,20011.75,SELL,3,0.02h,Stop Loss,$-9.00,$-27.00,$58425.50,125,$-27.00
2024-06-24,01:48:00,19953.0,BUY,3,0.02h,Stop Loss,$-9.00,$-36.00,$58416.50,125,$-36.00
2024-06-24,02:13:00,19947.0,SELL,3,0.02h,Stop Loss,$4.50,$-31.50,$58421.00,125,$-31.50
2024-06-24,02:19:00,19953.25,BUY,3,0.02h,Stop Loss,$-9.00,$-40.50,$58412.00,125,$-40.50
2024-06-24,02:20:00,19947.25,SELL,3,0.02h,Break Even,$-1.50,$-42.00,$58410.50,125,$-42.00
2024-06-24,02:26:00,19952.5,BUY,3,0.02h,Break Even,$-1.50,$-43.50,$58409.00,125,$-43.50
2024-06-24,02:48:00,19949.25,SELL,3,0.02h,Stop Loss,$-9.00,$-52.50,$58400.00,125,$-52.50
2024-06-24,03:04:00,19958.0,BUY,3,0.03h,Stop Loss,$-9.00,$-61.50,$58391.00,125,$-61.50
2024-06-24,03:51:00,19961.5,SELL,3,0.05h,Stop Loss,$-9.00,$-70.50,$58382.00,125,$-70.50
2024-06-24,04:11:00,19964.0,BUY,3,0.02h,Stop Loss,$-9.00,$-79.50,$58373.00,125,$-79.50
2024-06-24,04:12:00,19961.0,SELL,3,0.02h,Stop Loss,$-9.00,$-88.50,$58364.00,125,$-88.50
2024-06-24,04:14:00,19962.75,BUY,3,0.03h,Break Even,$-1.50,$-90.00,$58362.50,125,$-90.00
2024-06-24,04:20:00,19958.5,SELL,3,0.02h,Break Even,$-1.50,$-91.50,$58361.00,125,$-91.50
2024-06-24,04:40:00,19961.5,BUY,3,0.02h,Break Even,$-1.50,$-93.00,$58359.50,125,$-93.00
2024-06-24,06:43:00,19999.0,SELL,3,0.02h,Break Even,$-1.50,$-94.50,$58358.00,125,$-94.50
2024-06-24,07:04:00,20000.0,BUY,3,0.02h,Stop Loss,$15.00,$-79.50,$58373.00,125,$-79.50
2024-06-24,07:15:00,19996.75,SELL,3,0.02h,Stop Loss,$31.50,$-48.00,$58404.50,125,$-48.00
2024-06-24,07:30:00,19999.75,BUY,3,0.02h,Break Even,$-1.50,$-49.50,$58403.00,125,$-49.50
2024-06-24,08:05:00,20006.0,SELL,3,0.02h,Stop Loss,$-9.00,$-58.50,$58394.00,125,$-58.50
2024-06-24,08:08:00,20019.5,BUY,3,0.02h,Break Even,$-1.50,$-60.00,$58392.50,125,$-60.00
2024-06-24,08:34:00,20016.0,SELL,3,0.02h,Stop Loss,$16.50,$-43.50,$58409.00,125,$-43.50
2024-06-24,10:06:00,19962.25,BUY,3,0.02h,Break Even,$-1.50,$-45.00,$58407.50,125,$-45.00
2024-06-24,10:09:00,19954.75,SELL,3,0.02h,Break Even,$-1.50,$-46.50,$58406.00,125,$-46.50
2024-06-24,10:18:00,19963.75,BUY,3,0.02h,Stop Loss,$-9.00,$-55.50,$58397.00,125,$-55.50
2024-06-24,10:27:00,19953.0,SELL,3,0.02h,Break Even,$-1.50,$-57.00,$58395.50,125,$-57.00
2024-06-24,10:28:00,19960.0,BUY,3,0.02h,Stop Loss,$3.00,$-54.00,$58398.50,125,$-54.00
2024-06-24,11:25:00,19967.0,SELL,3,0.02h,Stop Loss,$15.00,$-39.00,$58413.50,125,$-39.00
2024-06-24,11:42:00,19973.5,BUY,3,0.02h,Break Even,$-1.50,$-40.50,$58412.00,125,$-40.50
2024-06-24,11:54:00,19962.25,SELL,3,0.02h,Stop Loss,$37.50,$-3.00,$58449.50,125,$-3.00
2024-06-24,12:22:00,19961.0,BUY,3,0.02h,Break Even,$-1.50,$-4.50,$58448.00,125,$-4.50
2024-06-24,12:36:00,19943.0,SELL,3,0.02h,Stop Loss,$22.50,$18.00,$58470.50,125,$18.00
2024-06-24,13:24:00,19925.5,BUY,3,0.02h,Break Even,$-1.50,$16.50,$58469.00,125,$16.50
2024-06-24,13:42:00,19907.25,SELL,3,0.02h,Stop Loss,$42.00,$58.50,$58511.00,125,$58.50
2024-06-24,13:56:00,19931.75,BUY,3,0.02h,Break Even,$-1.50,$57.00,$58509.50,125,$57.00
2024-06-24,14:22:00,19949.5,SELL,3,0.02h,Stop Loss,$3.00,$60.00,$58512.50,125,$60.00
2024-06-24,15:01:00,19897.75,BUY,3,0.02h,Break Even,$-1.50,$58.50,$58511.00,125,$58.50
2024-06-24,15:27:00,19882.5,SELL,3,0.02h,Stop Loss,$36.00,$94.50,$58547.00,125,$94.50
2024-06-24,15:36:00,19911.25,BUY,3,0.02h,Stop Loss,$-9.00,$85.50,$58538.00,125,$85.50
2024-06-24,15:37:00,19902.0,SELL,3,0.02h,Stop Loss,$-9.00,$76.50,$58529.00,125,$76.50
2024-06-24,15:38:00,19908.0,BUY,3,0.02h,Stop Loss,$51.00,$127.50,$58580.00,125,$127.50
2024-06-24,15:51:00,19900.25,SELL,3,0.02h,Stop Loss,$33.00,$160.50,$58613.00,125,$160.50
2024-06-24,16:00:00,19918.0,BUY,3,0.02h,Break Even,$-1.50,$159.00,$58611.50,125,$159.00
2024-06-24,16:08:00,19899.0,SELL,3,0.02h,Stop Loss,$24.00,$183.00,$58635.50,125,$183.00
2024-06-24,16:21:00,19902.75,BUY,3,0.02h,Stop Loss,$-9.00,$174.00,$58626.50,125,$174.00
2024-06-24,16:23:00,19896.75,SELL,3,0.02h,Break Even,$-1.50,$172.50,$58625.00,125,$172.50
2024-06-24,16:24:00,19903.0,BUY,3,0.02h,Break Even,$-1.50,$171.00,$58623.50,125,$171.00
2024-06-24,16:25:00,19898.0,SELL,3,0.02h,Break Even,$-1.50,$169.50,$58622.00,125,$169.50
2024-06-24,16:31:00,19907.25,BUY,3,0.02h,Break Even,$-1.50,$168.00,$58620.50,125,$168.00
2024-06-24,16:40:00,19896.75,SELL,3,0.02h,Stop Loss,$-9.00,$159.00,$58611.50,125,$159.00
2024-06-24,17:47:00,19821.75,BUY,3,0.02h,Stop Loss,$-9.00,$150.00,$58602.50,125,$150.00
2024-06-24,17:49:00,19815.0,SELL,3,0.02h,Stop Loss,$12.00,$162.00,$58614.50,125,$162.00
2024-06-24,17:57:00,19828.5,BUY,3,0.02h,Stop Loss,$-9.00,$153.00,$58605.50,125,$153.00
2024-06-24,17:59:00,19810.5,SELL,3,0.02h,Break Even,$-1.50,$151.50,$58604.00,125,$151.50
2024-06-24,18:40:00,19800.25,BUY,3,0.02h,Break Even,$-1.50,$150.00,$58602.50,125,$150.00
2024-06-24,19:22:00,19826.25,SELL,3,0.02h,Break Even,$-1.50,$148.50,$58601.00,125,$148.50
2024-06-24,20:44:00,19751.25,BUY,3,0.02h,Stop Loss,$-9.00,$139.50,$58592.00,125,$139.50
2024-06-24,20:53:00,19746.75,SELL,3,0.02h,Stop Loss,$-9.00,$130.50,$58583.00,125,$130.50
2024-06-24,21:00:00,19753.25,BUY,3,2.02h,Stop Loss,$27.00,$157.50,$58610.00,125,$157.50
2024-06-24,23:44:00,19764.0,SELL,3,0.02h,Stop Loss,$-9.00,$148.50,$58601.00,125,$148.50
2024-06-24,23:48:00,19768.25,BUY,3,0.02h,Stop Loss,$-9.00,$139.50,$58592.00,125,$139.50
,,,,,,,,,,,
2024-06-25,00:12:00,19769.0,SELL,3,0.02h,Stop Loss,$-9.00,$-9.00,$58583.00,126,$-9.00
2024-06-25,00:16:00,19772.75,BUY,3,0.02h,Stop Loss,$-9.00,$-18.00,$58574.00,126,$-18.00
2024-06-25,00:18:00,19769.75,SELL,3,0.02h,Break Even,$-1.50,$-19.50,$58572.50,126,$-19.50
2024-06-25,00:51:00,19764.0,BUY,3,0.02h,Stop Loss,$-9.00,$-28.50,$58563.50,126,$-28.50
2024-06-25,00:57:00,19759.25,SELL,3,0.02h,Break Even,$-1.50,$-30.00,$58562.00,126,$-30.00
2024-06-25,01:29:00,19758.0,BUY,3,0.02h,Stop Loss,$-9.00,$-39.00,$58553.00,126,$-39.00
2024-06-25,02:31:00,19778.25,SELL,3,0.02h,Stop Loss,$-9.00,$-48.00,$58544.00,126,$-48.00
2024-06-25,02:33:00,19782.25,BUY,3,0.02h,Stop Loss,$-9.00,$-57.00,$58535.00,126,$-57.00
2024-06-25,02:35:00,19779.25,SELL,3,0.02h,Stop Loss,$-9.00,$-66.00,$58526.00,126,$-66.00
2024-06-25,02:40:00,19782.0,BUY,3,0.02h,Stop Loss,$-9.00,$-75.00,$58517.00,126,$-75.00
2024-06-25,02:53:00,19780.5,SELL,3,0.02h,Stop Loss,$-9.00,$-84.00,$58508.00,126,$-84.00
2024-06-25,02:54:00,19782.75,BUY,3,0.02h,Stop Loss,$-9.00,$-93.00,$58499.00,126,$-93.00
2024-06-25,02:55:00,19781.0,SELL,3,0.03h,Stop Loss,$-9.00,$-102.00,$58490.00,126,$-102.00
2024-06-25,02:57:00,19781.25,SELL,3,0.05h,Break Even,$-1.50,$-103.50,$58488.50,126,$-103.50
2024-06-25,03:02:00,19782.5,BUY,3,0.07h,Break Even,$-1.50,$-105.00,$58487.00,126,$-105.00
2024-06-25,03:35:00,19788.0,SELL,3,0.02h,Stop Loss,$-9.00,$-114.00,$58478.00,126,$-114.00
2024-06-25,03:46:00,19790.5,BUY,3,0.02h,Break Even,$-1.50,$-115.50,$58476.50,126,$-115.50
2024-06-25,04:19:00,19792.75,SELL,3,0.05h,Break Even,$-1.50,$-117.00,$58475.00,126,$-117.00
2024-06-25,04:38:00,19795.75,BUY,3,0.02h,Stop Loss,$4.50,$-112.50,$58479.50,126,$-112.50
2024-06-25,05:52:00,19804.75,SELL,3,0.02h,Stop Loss,$-9.00,$-121.50,$58470.50,126,$-121.50
2024-06-25,05:53:00,19807.5,BUY,3,0.03h,Stop Loss,$-9.00,$-130.50,$58461.50,126,$-130.50
2024-06-25,06:00:00,19805.0,SELL,3,0.02h,Stop Loss,$4.50,$-126.00,$58466.00,126,$-126.00
2024-06-25,06:33:00,19794.5,BUY,3,0.02h,Break Even,$-1.50,$-127.50,$58464.50,126,$-127.50
2024-06-25,06:44:00,19787.75,SELL,3,0.02h,Stop Loss,$-9.00,$-136.50,$58455.50,126,$-136.50
2024-06-25,08:08:00,19755.75,BUY,3,0.02h,Break Even,$-1.50,$-138.00,$58454.00,126,$-138.00
2024-06-25,09:20:00,19814.5,SELL,3,0.02h,Stop Loss,$-9.00,$-147.00,$58445.00,126,$-147.00
2024-06-25,09:25:00,19825.0,BUY,3,0.02h,Stop Loss,$-9.00,$-156.00,$58436.00,126,$-156.00
2024-06-25,09:42:00,19822.75,SELL,3,0.02h,Break Even,$-1.50,$-157.50,$58434.50,126,$-157.50
2024-06-25,09:44:00,19830.5,BUY,3,0.02h,Break Even,$-1.50,$-159.00,$58433.00,126,$-159.00
2024-06-25,09:50:00,19825.25,SELL,3,0.02h,Stop Loss,$-9.00,$-168.00,$58424.00,126,$-168.00
2024-06-25,09:52:00,19833.0,BUY,3,0.02h,Stop Loss,$-9.00,$-177.00,$58415.00,126,$-177.00
2024-06-25,09:56:00,19823.5,SELL,3,0.02h,Stop Loss,$-9.00,$-186.00,$58406.00,126,$-186.00
2024-06-25,09:58:00,19833.75,BUY,3,0.02h,Break Even,$-1.50,$-187.50,$58404.50,126,$-187.50
2024-06-25,10:11:00,19828.25,SELL,3,0.02h,Stop Loss,$-9.00,$-196.50,$58395.50,126,$-196.50
2024-06-25,10:17:00,19837.5,BUY,3,0.02h,Stop Loss,$-9.00,$-205.50,$58386.50,126,$-205.50
2024-06-25,10:23:00,19828.5,SELL,3,0.02h,Stop Loss,$-9.00,$-214.50,$58377.50,126,$-214.50
2024-06-25,10:29:00,19834.5,BUY,3,0.02h,Stop Loss,$-9.00,$-223.50,$58368.50,126,$-223.50
2024-06-25,10:33:00,19830.5,SELL,3,0.02h,Stop Loss,$-9.00,$-232.50,$58359.50,126,$-232.50
2024-06-25,10:36:00,19833.75,BUY,3,0.02h,Break Even,$-1.50,$-234.00,$58358.00,126,$-234.00
2024-06-25,10:43:00,19827.0,SELL,3,0.02h,Stop Loss,$-9.00,$-243.00,$58349.00,126,$-243.00
2024-06-25,10:58:00,19833.25,BUY,3,0.02h,Stop Loss,$12.00,$-231.00,$58361.00,126,$-231.00
2024-06-25,11:05:00,19828.0,SELL,3,0.02h,Break Even,$-1.50,$-232.50,$58359.50,126,$-232.50
2024-06-25,11:12:00,19832.75,BUY,3,0.02h,Break Even,$-1.50,$-234.00,$58358.00,126,$-234.00
2024-06-25,11:26:00,19828.5,SELL,3,0.02h,Stop Loss,$-9.00,$-243.00,$58349.00,126,$-243.00
2024-06-25,12:03:00,19821.5,BUY,3,0.02h,Stop Loss,$-9.00,$-252.00,$58340.00,126,$-252.00
2024-06-25,12:32:00,19814.75,SELL,3,0.02h,Stop Loss,$16.50,$-235.50,$58356.50,126,$-235.50
2024-06-25,12:57:00,19827.75,BUY,3,0.02h,Stop Loss,$4.50,$-231.00,$58361.00,126,$-231.00
2024-06-25,13:28:00,19832.0,SELL,3,0.02h,Stop Loss,$27.00,$-204.00,$58388.00,126,$-204.00
2024-06-25,13:46:00,19836.75,BUY,3,0.02h,Stop Loss,$-9.00,$-213.00,$58379.00,126,$-213.00
2024-06-25,14:46:00,19871.75,SELL,3,0.02h,Stop Loss,$-9.00,$-222.00,$58370.00,126,$-222.00
2024-06-25,15:03:00,19889.75,BUY,3,0.02h,Stop Loss,$10.50,$-211.50,$58380.50,126,$-211.50
2024-06-25,16:12:00,19943.5,SELL,3,0.02h,Stop Loss,$25.50,$-186.00,$58406.00,126,$-186.00
2024-06-25,17:15:00,19887.25,BUY,3,0.02h,Stop Loss,$-9.00,$-195.00,$58397.00,126,$-195.00
2024-06-25,18:49:00,19920.5,SELL,3,0.02h,Break Even,$-1.50,$-196.50,$58395.50,126,$-196.50
2024-06-25,19:00:00,19950.0,BUY,3,0.02h,Stop Loss,$-9.00,$-205.50,$58386.50,126,$-205.50
2024-06-25,19:01:00,19939.75,SELL,3,0.02h,Stop Loss,$-9.00,$-214.50,$58377.50,126,$-214.50
2024-06-25,19:03:00,19945.75,BUY,3,0.02h,Break Even,$-1.50,$-216.00,$58376.00,126,$-216.00
2024-06-25,19:04:00,19941.25,SELL,3,0.02h,Stop Loss,$-9.00,$-225.00,$58367.00,126,$-225.00
2024-06-25,19:06:00,19947.25,BUY,3,0.02h,Break Even,$-1.50,$-226.50,$58365.50,126,$-226.50
2024-06-25,19:11:00,19938.0,SELL,3,0.02h,Break Even,$-1.50,$-228.00,$58364.00,126,$-228.00
2024-06-25,19:17:00,19950.75,BUY,3,0.02h,Stop Loss,$16.50,$-211.50,$58380.50,126,$-211.50
2024-06-25,19:46:00,19957.0,SELL,3,0.02h,Stop Loss,$9.00,$-202.50,$58389.50,126,$-202.50
2024-06-25,19:59:00,19973.0,BUY,3,0.02h,Stop Loss,$16.50,$-186.00,$58406.00,126,$-186.00
2024-06-25,23:22:00,19969.5,SELL,3,0.02h,Break Even,$-1.50,$-187.50,$58404.50,126,$-187.50
2024-06-25,23:30:00,19973.25,BUY,3,0.02h,Break Even,$-1.50,$-189.00,$58403.00,126,$-189.00
2024-06-25,23:37:00,19971.5,SELL,3,0.10h,Stop Loss,$7.50,$-181.50,$58410.50,126,$-181.50
,,,,,,,,,,,
2024-06-26,00:06:00,19969.0,BUY,3,0.02h,Stop Loss,$-9.00,$-9.00,$58401.50,127,$-9.00
2024-06-26,01:39:00,19991.5,SELL,3,0.02h,Stop Loss,$-9.00,$-18.00,$58392.50,127,$-18.00
2024-06-26,01:50:00,19996.75,BUY,3,0.02h,Stop Loss,$-9.00,$-27.00,$58383.50,127,$-27.00
2024-06-26,01:52:00,19993.0,SELL,3,0.02h,Stop Loss,$-9.00,$-36.00,$58374.50,127,$-36.00
2024-06-26,01:55:00,19996.0,BUY,3,0.02h,Stop Loss,$-9.00,$-45.00,$58365.50,127,$-45.00
2024-06-26,02:25:00,19999.25,SELL,3,0.03h,Stop Loss,$-9.00,$-54.00,$58356.50,127,$-54.00
2024-06-26,03:01:00,19998.75,BUY,3,0.02h,Round Number,$4.50,$-49.50,$58361.00,127,$-49.50
2024-06-26,03:20:00,19999.5,SELL,3,0.03h,Break Even,$-1.50,$-51.00,$58359.50,127,$-51.00
2024-06-26,04:00:00,19990.75,BUY,3,0.02h,Stop Loss,$-9.00,$-60.00,$58350.50,127,$-60.00
2024-06-26,04:02:00,19987.75,SELL,3,0.05h,Stop Loss,$-9.00,$-69.00,$58341.50,127,$-69.00
2024-06-26,04:27:00,19989.0,BUY,3,0.02h,Break Even,$-1.50,$-70.50,$58340.00,127,$-70.50
2024-06-26,06:07:00,20007.0,SELL,3,0.02h,Stop Loss,$-9.00,$-79.50,$58331.00,127,$-79.50
2024-06-26,06:15:00,20013.0,BUY,3,0.02h,Stop Loss,$-9.00,$-88.50,$58322.00,127,$-88.50
2024-06-26,06:17:00,20009.25,SELL,3,0.02h,Stop Loss,$-9.00,$-97.50,$58313.00,127,$-97.50
2024-06-26,06:20:00,20011.5,BUY,3,0.02h,Break Even,$-1.50,$-99.00,$58311.50,127,$-99.00
2024-06-26,06:59:00,20010.25,SELL,3,0.02h,Stop Loss,$-9.00,$-108.00,$58302.50,127,$-108.00
2024-06-26,07:20:00,20018.25,BUY,3,0.02h,Stop Loss,$-9.00,$-117.00,$58293.50,127,$-117.00
2024-06-26,08:18:00,20053.75,SELL,3,0.02h,Stop Loss,$13.50,$-103.50,$58307.00,127,$-103.50
2024-06-26,08:39:00,20054.5,BUY,3,0.02h,Break Even,$-1.50,$-105.00,$58305.50,127,$-105.00
2024-06-26,08:54:00,20052.25,SELL,3,0.02h,Break Even,$-1.50,$-106.50,$58304.00,127,$-106.50
2024-06-26,10:44:00,20016.75,BUY,3,0.02h,Stop Loss,$-9.00,$-115.50,$58295.00,127,$-115.50
2024-06-26,10:53:00,20009.75,SELL,3,0.02h,Stop Loss,$22.50,$-93.00,$58317.50,127,$-93.00
2024-06-26,11:16:00,20008.25,BUY,3,0.02h,Stop Loss,$-9.00,$-102.00,$58308.50,127,$-102.00
2024-06-26,11:25:00,19997.0,SELL,3,0.02h,Break Even,$-1.50,$-103.50,$58307.00,127,$-103.50
2024-06-26,11:58:00,19994.75,BUY,3,0.02h,Stop Loss,$16.50,$-87.00,$58323.50,127,$-87.00
2024-06-26,12:08:00,19986.75,SELL,3,0.02h,Break Even,$-1.50,$-88.50,$58322.00,127,$-88.50
2024-06-26,13:28:00,19929.25,BUY,3,0.02h,Break Even,$-1.50,$-90.00,$58320.50,127,$-90.00
2024-06-26,14:29:00,19956.25,SELL,3,0.02h,Stop Loss,$52.50,$-37.50,$58373.00,127,$-37.50
2024-06-26,14:46:00,19997.0,BUY,3,0.02h,Stop Loss,$40.50,$3.00,$58413.50,127,$3.00
2024-06-26,15:00:00,19974.75,SELL,3,0.02h,Stop Loss,$19.50,$22.50,$58433.00,127,$22.50
2024-06-26,15:23:00,19966.25,BUY,3,0.02h,Stop Loss,$30.00,$52.50,$58463.00,127,$52.50
2024-06-26,15:32:00,19951.0,SELL,3,0.02h,Break Even,$-1.50,$51.00,$58461.50,127,$51.00
2024-06-26,15:39:00,19966.75,BUY,3,0.02h,Break Even,$-1.50,$49.50,$58460.00,127,$49.50
2024-06-26,16:18:00,19998.75,SELL,3,0.02h,Break Even,$-1.50,$48.00,$58458.50,127,$48.00
2024-06-26,16:28:00,20013.25,BUY,3,0.02h,Stop Loss,$24.00,$72.00,$58482.50,127,$72.00
2024-06-26,16:38:00,19997.0,SELL,3,0.02h,Stop Loss,$42.00,$114.00,$58524.50,127,$114.00
2024-06-26,17:13:00,19978.75,BUY,3,0.02h,Stop Loss,$4.50,$118.50,$58529.00,127,$118.50
2024-06-26,17:20:00,19946.5,SELL,3,0.02h,Stop Loss,$46.50,$165.00,$58575.50,127,$165.00
2024-06-26,17:35:00,19969.25,BUY,3,0.02h,Stop Loss,$-9.00,$156.00,$58566.50,127,$156.00
2024-06-26,17:38:00,19958.0,SELL,3,0.02h,Stop Loss,$-9.00,$147.00,$58557.50,127,$147.00
2024-06-26,17:39:00,19966.5,BUY,3,0.02h,Stop Loss,$18.00,$165.00,$58575.50,127,$165.00
2024-06-26,18:05:00,19964.5,SELL,3,0.02h,Stop Loss,$22.50,$187.50,$58598.00,127,$187.50
2024-06-26,18:14:00,19972.0,BUY,3,0.02h,Break Even,$-1.50,$186.00,$58596.50,127,$186.00
2024-06-26,18:23:00,19964.25,SELL,3,0.02h,Stop Loss,$-9.00,$177.00,$58587.50,127,$177.00
2024-06-26,18:25:00,19976.5,BUY,3,0.02h,Break Even,$-1.50,$175.50,$58586.00,127,$175.50
2024-06-26,18:37:00,19963.75,SELL,3,0.02h,Break Even,$-1.50,$174.00,$58584.50,127,$174.00
2024-06-26,18:48:00,19972.75,BUY,3,0.02h,Stop Loss,$13.50,$187.50,$58598.00,127,$187.50
2024-06-26,18:56:00,19960.0,SELL,3,0.02h,Stop Loss,$39.00,$226.50,$58637.00,127,$226.50
2024-06-26,19:24:00,19948.25,BUY,3,0.02h,Break Even,$-1.50,$225.00,$58635.50,127,$225.00
2024-06-26,20:03:00,19926.75,SELL,3,0.02h,Stop Loss,$10.50,$235.50,$58646.00,127,$235.50
2024-06-26,20:44:00,19947.25,BUY,3,0.02h,Stop Loss,$-9.00,$226.50,$58637.00,127,$226.50
2024-06-26,20:51:00,19943.75,SELL,3,0.02h,Stop Loss,$-9.00,$217.50,$58628.00,127,$217.50
2024-06-26,20:55:00,19948.5,BUY,3,0.02h,Break Even,$-1.50,$216.00,$58626.50,127,$216.00
2024-06-26,23:00:00,19930.75,SELL,3,0.02h,Break Even,$-1.50,$214.50,$58625.00,127,$214.50
2024-06-26,23:48:00,19916.25,BUY,3,0.03h,Break Even,$-1.50,$213.00,$58623.50,127,$213.00
,,,,,,,,,,,
2024-06-27,00:08:00,19911.0,SELL,3,0.02h,Break Even,$-1.50,$-1.50,$58622.00,128,$-1.50
2024-06-27,01:01:00,19898.0,BUY,3,0.02h,Stop Loss,$21.00,$19.50,$58643.00,128,$19.50
2024-06-27,02:32:00,19924.5,SELL,3,0.02h,Stop Loss,$-9.00,$10.50,$58634.00,128,$10.50
2024-06-27,02:49:00,19926.75,BUY,3,0.02h,Stop Loss,$-9.00,$1.50,$58625.00,128,$1.50
2024-06-27,02:57:00,19923.5,SELL,3,0.02h,Stop Loss,$-9.00,$-7.50,$58616.00,128,$-7.50
2024-06-27,02:58:00,19925.0,BUY,3,0.03h,Stop Loss,$-9.00,$-16.50,$58607.00,128,$-16.50
2024-06-27,03:00:00,19924.0,SELL,3,0.02h,Stop Loss,$-9.00,$-25.50,$58598.00,128,$-25.50
2024-06-27,03:11:00,19926.0,BUY,3,0.02h,Stop Loss,$-9.00,$-34.50,$58589.00,128,$-34.50
2024-06-27,03:12:00,19922.5,SELL,3,0.02h,Stop Loss,$-9.00,$-43.50,$58580.00,128,$-43.50
2024-06-27,03:25:00,19925.0,BUY,3,0.03h,Break Even,$-1.50,$-45.00,$58578.50,128,$-45.00
2024-06-27,03:43:00,19923.5,SELL,3,0.10h,Stop Loss,$-9.00,$-54.00,$58569.50,128,$-54.00
2024-06-27,04:20:00,19920.75,BUY,3,0.03h,Break Even,$-1.50,$-55.50,$58568.00,128,$-55.50
2024-06-27,06:08:00,19952.5,SELL,3,0.02h,Break Even,$-1.50,$-57.00,$58566.50,128,$-57.00
2024-06-27,06:12:00,19959.75,BUY,3,0.02h,Stop Loss,$-9.00,$-66.00,$58557.50,128,$-66.00
2024-06-27,06:37:00,19955.25,SELL,3,0.02h,Break Even,$-1.50,$-67.50,$58556.00,128,$-67.50
2024-06-27,06:57:00,19954.0,BUY,3,0.02h,Break Even,$-1.50,$-69.00,$58554.50,128,$-69.00
2024-06-27,07:42:00,19959.25,SELL,3,0.02h,Stop Loss,$-9.00,$-78.00,$58545.50,128,$-78.00
2024-06-27,08:36:00,19951.5,BUY,3,0.02h,Stop Loss,$6.00,$-72.00,$58551.50,128,$-72.00
2024-06-27,09:08:00,19953.5,SELL,3,0.02h,Stop Loss,$-9.00,$-81.00,$58542.50,128,$-81.00
2024-06-27,09:10:00,19960.0,BUY,3,0.02h,Stop Loss,$-9.00,$-90.00,$58533.50,128,$-90.00
2024-06-27,10:51:00,19981.75,SELL,3,0.02h,Break Even,$-1.50,$-91.50,$58532.00,128,$-91.50
2024-06-27,11:30:00,19973.75,BUY,3,0.02h,Stop Loss,$6.00,$-85.50,$58538.00,128,$-85.50
2024-06-27,11:42:00,19970.0,SELL,3,0.02h,Break Even,$-1.50,$-87.00,$58536.50,128,$-87.00
2024-06-27,11:48:00,19979.0,BUY,3,0.02h,Stop Loss,$7.50,$-79.50,$58544.00,128,$-79.50
2024-06-27,12:06:00,19973.25,SELL,3,0.02h,Break Even,$-1.50,$-81.00,$58542.50,128,$-81.00
2024-06-27,12:13:00,19978.5,BUY,3,0.02h,Stop Loss,$-9.00,$-90.00,$58533.50,128,$-90.00
2024-06-27,12:14:00,19976.25,SELL,3,0.02h,Break Even,$-1.50,$-91.50,$58532.00,128,$-91.50
2024-06-27,12:18:00,19979.0,BUY,3,0.02h,Stop Loss,$-9.00,$-100.50,$58523.00,128,$-100.50
2024-06-27,12:20:00,19977.0,SELL,3,0.02h,Break Even,$-1.50,$-102.00,$58521.50,128,$-102.00
2024-06-27,12:33:00,19985.5,BUY,3,0.02h,Stop Loss,$12.00,$-90.00,$58533.50,128,$-90.00
2024-06-27,13:13:00,19992.0,SELL,3,0.02h,Break Even,$-1.50,$-91.50,$58532.00,128,$-91.50
2024-06-27,13:18:00,20000.0,BUY,3,0.02h,Stop Loss,$-9.00,$-100.50,$58523.00,128,$-100.50
2024-06-27,13:22:00,19993.5,SELL,3,0.02h,Break Even,$-1.50,$-102.00,$58521.50,128,$-102.00
2024-06-27,13:31:00,20015.75,BUY,3,0.02h,Stop Loss,$45.00,$-57.00,$58566.50,128,$-57.00
2024-06-27,13:54:00,20044.0,SELL,3,0.02h,Stop Loss,$-9.00,$-66.00,$58557.50,128,$-66.00
2024-06-27,14:01:00,20069.75,BUY,3,0.02h,Stop Loss,$39.00,$-27.00,$58596.50,128,$-27.00
2024-06-27,14:33:00,20062.0,SELL,3,0.02h,Stop Loss,$-9.00,$-36.00,$58587.50,128,$-36.00
2024-06-27,15:19:00,20032.25,BUY,3,0.02h,Break Even,$-1.50,$-37.50,$58586.00,128,$-37.50
2024-06-27,15:20:00,20023.25,SELL,3,0.02h,Stop Loss,$28.50,$-9.00,$58614.50,128,$-9.00
2024-06-27,15:57:00,19988.75,BUY,3,0.02h,Break Even,$-1.50,$-10.50,$58613.00,128,$-10.50
2024-06-27,17:00:00,20028.75,SELL,3,0.02h,Stop Loss,$-9.00,$-19.50,$58604.00,128,$-19.50
2024-06-27,17:04:00,20047.0,BUY,3,0.02h,Break Even,$-1.50,$-21.00,$58602.50,128,$-21.00
2024-06-27,17:14:00,20036.75,SELL,3,0.02h,Break Even,$-1.50,$-22.50,$58601.00,128,$-22.50
2024-06-27,17:27:00,20042.5,BUY,3,0.02h,Stop Loss,$12.00,$-10.50,$58613.00,128,$-10.50
2024-06-27,17:55:00,20050.0,SELL,3,0.02h,Stop Loss,$-9.00,$-19.50,$58604.00,128,$-19.50
2024-06-27,18:49:00,20020.5,BUY,3,0.02h,Stop Loss,$12.00,$-7.50,$58616.00,128,$-7.50
2024-06-27,19:35:00,20040.5,SELL,3,0.02h,Break Even,$-1.50,$-9.00,$58614.50,128,$-9.00
2024-06-27,19:42:00,20049.75,BUY,3,0.02h,Stop Loss,$-9.00,$-18.00,$58605.50,128,$-18.00
2024-06-27,19:43:00,20040.5,SELL,3,0.02h,Break Even,$-1.50,$-19.50,$58604.00,128,$-19.50
2024-06-27,20:01:00,20059.75,BUY,3,0.02h,Stop Loss,$3.00,$-16.50,$58607.00,128,$-16.50
2024-06-27,20:42:00,20067.0,SELL,3,0.02h,Break Even,$-1.50,$-18.00,$58605.50,128,$-18.00
2024-06-27,20:55:00,20069.0,BUY,3,0.02h,Stop Loss,$-9.00,$-27.00,$58596.50,128,$-27.00
2024-06-27,21:00:00,20067.25,SELL,3,2.00h,Stop Loss,$-9.00,$-36.00,$58587.50,128,$-36.00
2024-06-27,23:00:00,20083.0,BUY,3,0.02h,Stop Loss,$15.00,$-21.00,$58602.50,128,$-21.00
,,,,,,,,,,,
2024-06-28,00:43:00,20096.75,SELL,3,0.03h,Break Even,$-1.50,$-1.50,$58601.00,129,$-1.50
2024-06-28,01:23:00,20091.0,BUY,3,0.02h,Stop Loss,$13.50,$12.00,$58614.50,129,$12.00
2024-06-28,02:35:00,20132.0,SELL,3,0.02h,Stop Loss,$6.00,$18.00,$58620.50,129,$18.00
2024-06-28,02:49:00,20133.75,BUY,3,0.02h,Stop Loss,$-9.00,$9.00,$58611.50,129,$9.00
2024-06-28,03:33:00,20133.0,SELL,3,0.02h,Stop Loss,$-9.00,$0.00,$58602.50,129,$0.00
2024-06-28,03:35:00,20134.25,BUY,3,0.02h,Stop Loss,$-9.00,$-9.00,$58593.50,129,$-9.00
2024-06-28,03:37:00,20133.75,SELL,3,0.02h,Stop Loss,$-9.00,$-18.00,$58584.50,129,$-18.00
2024-06-28,03:38:00,20134.75,BUY,3,0.05h,Stop Loss,$-9.00,$-27.00,$58575.50,129,$-27.00
2024-06-28,03:42:00,20132.75,SELL,3,0.03h,Stop Loss,$4.50,$-22.50,$58580.00,129,$-22.50
2024-06-28,05:20:00,20108.5,BUY,3,0.02h,Stop Loss,$-9.00,$-31.50,$58571.00,129,$-31.50
2024-06-28,05:21:00,20107.5,SELL,3,0.02h,Stop Loss,$-9.00,$-40.50,$58562.00,129,$-40.50
2024-06-28,05:22:00,20109.75,BUY,3,0.05h,Break Even,$-1.50,$-42.00,$58560.50,129,$-42.00
2024-06-28,05:30:00,20105.25,SELL,3,0.02h,Stop Loss,$-9.00,$-51.00,$58551.50,129,$-51.00
2024-06-28,05:57:00,20109.5,BUY,3,0.02h,Stop Loss,$-9.00,$-60.00,$58542.50,129,$-60.00
2024-06-28,06:41:00,20120.25,SELL,3,0.02h,Stop Loss,$6.00,$-54.00,$58548.50,129,$-54.00
2024-06-28,07:12:00,20118.25,BUY,3,0.02h,Break Even,$-1.50,$-55.50,$58547.00,129,$-55.50
2024-06-28,07:14:00,20108.5,SELL,3,0.02h,Stop Loss,$-9.00,$-64.50,$58538.00,129,$-64.50
2024-06-28,07:24:00,20116.75,BUY,3,0.02h,Stop Loss,$-9.00,$-73.50,$58529.00,129,$-73.50
2024-06-28,07:38:00,20108.25,SELL,3,0.02h,Stop Loss,$-9.00,$-82.50,$58520.00,129,$-82.50
2024-06-28,07:43:00,20118.5,BUY,3,0.02h,Break Even,$-1.50,$-84.00,$58518.50,129,$-84.00
2024-06-28,07:48:00,20111.0,SELL,3,0.02h,Break Even,$-1.50,$-85.50,$58517.00,129,$-85.50
2024-06-28,08:23:00,20105.0,BUY,3,0.02h,Stop Loss,$-9.00,$-94.50,$58508.00,129,$-94.50
2024-06-28,08:50:00,20108.25,SELL,3,0.02h,Stop Loss,$-9.00,$-103.50,$58499.00,129,$-103.50
2024-06-28,08:54:00,20112.25,BUY,3,0.02h,Stop Loss,$-9.00,$-112.50,$58490.00,129,$-112.50
2024-06-28,08:57:00,20108.5,SELL,3,0.02h,Stop Loss,$-9.00,$-121.50,$58481.00,129,$-121.50
2024-06-28,08:58:00,20111.5,BUY,3,0.03h,Stop Loss,$4.50,$-117.00,$58485.50,129,$-117.00
2024-06-28,09:34:00,20115.5,SELL,3,0.02h,Stop Loss,$-9.00,$-126.00,$58476.50,129,$-126.00
2024-06-28,09:39:00,20125.25,BUY,3,0.02h,Stop Loss,$12.00,$-114.00,$58488.50,129,$-114.00
2024-06-28,10:04:00,20124.0,SELL,3,0.02h,Break Even,$-1.50,$-115.50,$58487.00,129,$-115.50
2024-06-28,10:07:00,20127.25,BUY,3,0.03h,Break Even,$-1.50,$-117.00,$58485.50,129,$-117.00
2024-06-28,10:17:00,20121.25,SELL,3,0.02h,Break Even,$-1.50,$-118.50,$58484.00,129,$-118.50
2024-06-28,10:25:00,20128.75,BUY,3,0.02h,Stop Loss,$-9.00,$-127.50,$58475.00,129,$-127.50
2024-06-28,10:26:00,20124.5,SELL,3,0.02h,Stop Loss,$-9.00,$-136.50,$58466.00,129,$-136.50
2024-06-28,10:27:00,20126.5,BUY,3,0.02h,Break Even,$-1.50,$-138.00,$58464.50,129,$-138.00
2024-06-28,10:33:00,20123.25,SELL,3,0.02h,Break Even,$-1.50,$-139.50,$58463.00,129,$-139.50
2024-06-28,10:44:00,20126.25,BUY,3,0.02h,Break Even,$-1.50,$-141.00,$58461.50,129,$-141.00
2024-06-28,11:01:00,20120.25,SELL,3,0.02h,Stop Loss,$-9.00,$-150.00,$58452.50,129,$-150.00
2024-06-28,11:16:00,20126.25,BUY,3,0.02h,Break Even,$-1.50,$-151.50,$58451.00,129,$-151.50
2024-06-28,11:23:00,20119.25,SELL,3,0.02h,Stop Loss,$-9.00,$-160.50,$58442.00,129,$-160.50
2024-06-28,11:34:00,20126.5,BUY,3,0.02h,Stop Loss,$-9.00,$-169.50,$58433.00,129,$-169.50
2024-06-28,11:50:00,20124.0,SELL,3,0.02h,Stop Loss,$-9.00,$-178.50,$58424.00,129,$-178.50
2024-06-28,11:59:00,20126.0,BUY,3,0.02h,Stop Loss,$-9.00,$-187.50,$58415.00,129,$-187.50
2024-06-28,12:03:00,20123.25,SELL,3,0.02h,Break Even,$-1.50,$-189.00,$58413.50,129,$-189.00
2024-06-28,12:08:00,20127.5,BUY,3,0.02h,Break Even,$-1.50,$-190.50,$58412.00,129,$-190.50
2024-06-28,12:37:00,20132.75,SELL,3,0.02h,Stop Loss,$7.50,$-183.00,$58419.50,129,$-183.00
2024-06-28,13:39:00,20087.5,BUY,3,0.02h,Stop Loss,$15.00,$-168.00,$58434.50,129,$-168.00
2024-06-28,14:37:00,20210.0,SELL,3,0.02h,Stop Loss,$36.00,$-132.00,$58470.50,129,$-132.00
2024-06-28,15:35:00,20120.5,BUY,3,0.02h,Stop Loss,$-9.00,$-141.00,$58461.50,129,$-141.00
2024-06-28,15:44:00,20101.0,SELL,3,0.02h,Stop Loss,$4.50,$-136.50,$58466.00,129,$-136.50
2024-06-28,15:51:00,20120.75,BUY,3,0.02h,Break Even,$-1.50,$-138.00,$58464.50,129,$-138.00
2024-06-28,15:59:00,20103.5,SELL,3,0.02h,Stop Loss,$-9.00,$-147.00,$58455.50,129,$-147.00
2024-06-28,16:02:00,20113.75,BUY,3,0.02h,Break Even,$-1.50,$-148.50,$58454.00,129,$-148.50
2024-06-28,16:03:00,20105.0,SELL,3,0.02h,Stop Loss,$27.00,$-121.50,$58481.00,129,$-121.50
2024-06-28,16:30:00,20070.75,BUY,3,0.02h,Stop Loss,$24.00,$-97.50,$58505.00,129,$-97.50
2024-06-28,16:34:00,20046.5,SELL,3,0.02h,Stop Loss,$66.00,$-31.50,$58571.00,129,$-31.50
2024-06-28,17:00:00,20036.5,BUY,3,0.02h,Stop Loss,$-9.00,$-40.50,$58562.00,129,$-40.50
2024-06-28,17:32:00,20046.25,SELL,3,0.02h,Break Even,$-1.50,$-42.00,$58560.50,129,$-42.00
2024-06-28,18:05:00,20058.25,BUY,3,0.02h,Stop Loss,$-9.00,$-51.00,$58551.50,129,$-51.00
2024-06-28,18:23:00,20014.0,SELL,3,0.02h,Stop Loss,$33.00,$-18.00,$58584.50,129,$-18.00
2024-06-28,19:44:00,20013.0,BUY,3,0.02h,Stop Loss,$9.00,$-9.00,$58593.50,129,$-9.00
2024-06-28,19:56:00,19966.75,SELL,3,0.02h,Stop Loss,$81.00,$72.00,$58674.50,129,$72.00
2024-06-28,20:20:00,19968.75,BUY,3,0.02h,Stop Loss,$-9.00,$63.00,$58665.50,129,$63.00
2024-06-28,20:35:00,19961.5,SELL,3,0.02h,Stop Loss,$-9.00,$54.00,$58656.50,129,$54.00
2024-06-28,20:44:00,19970.75,BUY,3,0.02h,Break Even,$-1.50,$52.50,$58655.00,129,$52.50
,,,,,,,,,,,
2024-07-01,00:00:00,19946.0,SELL,3,0.02h,Stop Loss,$7.50,$7.50,$58662.50,130,$7.50
2024-07-01,00:17:00,19965.25,BUY,3,0.02h,Break Even,$-1.50,$6.00,$58661.00,130,$6.00
2024-07-01,00:52:00,19971.5,SELL,3,0.03h,Stop Loss,$-9.00,$-3.00,$58652.00,130,$-3.00
2024-07-01,00:55:00,19974.75,BUY,3,0.02h,Stop Loss,$-9.00,$-12.00,$58643.00,130,$-12.00
2024-07-01,01:50:00,19982.5,SELL,3,0.02h,Stop Loss,$-9.00,$-21.00,$58634.00,130,$-21.00
2024-07-01,01:59:00,19988.75,BUY,3,0.02h,Break Even,$-1.50,$-22.50,$58632.50,130,$-22.50
2024-07-01,03:00:00,19996.75,SELL,3,0.02h,Stop Loss,$-9.00,$-31.50,$58623.50,130,$-31.50
2024-07-01,03:03:00,19998.75,BUY,3,0.03h,Round Number,$4.50,$-27.00,$58628.00,130,$-27.00
2024-07-01,03:10:00,19998.25,SELL,3,0.02h,Stop Loss,$-9.00,$-36.00,$58619.00,130,$-36.00
2024-07-01,03:11:00,20001.25,BUY,3,0.02h,Break Even,$-1.50,$-37.50,$58617.50,130,$-37.50
2024-07-01,03:17:00,19995.0,SELL,3,0.02h,Break Even,$-1.50,$-39.00,$58616.00,130,$-39.00
2024-07-01,03:42:00,19997.5,BUY,3,0.03h,Break Even,$-1.50,$-40.50,$58614.50,130,$-40.50
2024-07-01,04:01:00,19993.5,SELL,3,0.02h,Break Even,$-1.50,$-42.00,$58613.00,130,$-42.00
2024-07-01,04:23:00,19995.0,BUY,3,0.02h,Stop Loss,$-9.00,$-51.00,$58604.00,130,$-51.00
2024-07-01,04:29:00,19990.0,SELL,3,0.02h,Stop Loss,$-9.00,$-60.00,$58595.00,130,$-60.00
2024-07-01,05:06:00,19984.0,BUY,3,0.02h,Stop Loss,$3.00,$-57.00,$58598.00,130,$-57.00
2024-07-01,06:39:00,20008.0,SELL,3,0.02h,Stop Loss,$-9.00,$-66.00,$58589.00,130,$-66.00
2024-07-01,06:54:00,20011.5,BUY,3,0.02h,Break Even,$-1.50,$-67.50,$58587.50,130,$-67.50
2024-07-01,07:01:00,20005.75,SELL,3,0.02h,Stop Loss,$-9.00,$-76.50,$58578.50,130,$-76.50
2024-07-01,07:11:00,20015.5,BUY,3,0.02h,Stop Loss,$-9.00,$-85.50,$58569.50,130,$-85.50
2024-07-01,07:17:00,20002.75,SELL,3,0.02h,Stop Loss,$43.50,$-42.00,$58613.00,130,$-42.00
2024-07-01,08:06:00,19967.5,BUY,3,0.02h,Stop Loss,$19.50,$-22.50,$58632.50,130,$-22.50
2024-07-01,08:37:00,19961.75,SELL,3,0.02h,Stop Loss,$51.00,$28.50,$58683.50,130,$28.50
2024-07-01,09:34:00,19925.0,BUY,3,0.02h,Stop Loss,$6.00,$34.50,$58689.50,130,$34.50
2024-07-01,10:19:00,19937.25,SELL,3,0.02h,Break Even,$-1.50,$33.00,$58688.00,130,$33.00
2024-07-01,10:23:00,19945.25,BUY,3,0.02h,Stop Loss,$-9.00,$24.00,$58679.00,130,$24.00
2024-07-01,10:26:00,19937.0,SELL,3,0.02h,Stop Loss,$9.00,$33.00,$58688.00,130,$33.00
2024-07-01,10:43:00,19943.25,BUY,3,0.02h,Stop Loss,$-9.00,$24.00,$58679.00,130,$24.00
2024-07-01,11:51:00,19969.75,SELL,3,0.02h,Stop Loss,$-9.00,$15.00,$58670.00,130,$15.00
2024-07-01,11:52:00,19974.75,BUY,3,0.02h,Break Even,$-1.50,$13.50,$58668.50,130,$13.50
2024-07-01,11:55:00,19969.25,SELL,3,0.02h,Stop Loss,$-9.00,$4.50,$58659.50,130,$4.50
2024-07-01,11:57:00,19974.0,BUY,3,0.03h,Stop Loss,$7.50,$12.00,$58667.00,130,$12.00
2024-07-01,12:13:00,19974.0,SELL,3,0.02h,Break Even,$-1.50,$10.50,$58665.50,130,$10.50
2024-07-01,12:18:00,19978.5,BUY,3,0.02h,Break Even,$-1.50,$9.00,$58664.00,130,$9.00
2024-07-01,12:33:00,19974.25,SELL,3,0.02h,Stop Loss,$-9.00,$0.00,$58655.00,130,$0.00
2024-07-01,12:36:00,19981.5,BUY,3,0.02h,Stop Loss,$6.00,$6.00,$58661.00,130,$6.00
2024-07-01,12:37:00,19978.0,SELL,3,0.02h,Break Even,$-1.50,$4.50,$58659.50,130,$4.50
2024-07-01,12:53:00,19981.0,BUY,3,0.02h,Stop Loss,$10.50,$15.00,$58670.00,130,$15.00
2024-07-01,13:08:00,19965.75,SELL,3,0.02h,Break Even,$-1.50,$13.50,$58668.50,130,$13.50
2024-07-01,13:32:00,19976.5,BUY,3,0.02h,Break Even,$-1.50,$12.00,$58667.00,130,$12.00
2024-07-01,13:33:00,19946.25,SELL,3,0.02h,Stop Loss,$19.50,$31.50,$58686.50,130,$31.50
2024-07-01,14:04:00,19904.0,BUY,3,0.02h,Stop Loss,$66.00,$97.50,$58752.50,130,$97.50
2024-07-01,14:12:00,19853.25,SELL,3,0.02h,Stop Loss,$75.00,$172.50,$58827.50,130,$172.50
2024-07-01,14:22:00,19909.25,BUY,3,0.02h,Stop Loss,$160.50,$333.00,$58988.00,130,$333.00
2024-07-01,14:42:00,19877.0,SELL,3,0.02h,Stop Loss,$-9.00,$324.00,$58979.00,130,$324.00
2024-07-01,15:12:00,19926.5,BUY,3,0.02h,Break Even,$-1.50,$322.50,$58977.50,130,$322.50
2024-07-01,16:59:00,20006.0,SELL,3,0.02h,Break Even,$-1.50,$321.00,$58976.00,130,$321.00
2024-07-01,17:37:00,20008.5,BUY,3,0.02h,Break Even,$-1.50,$319.50,$58974.50,130,$319.50
2024-07-01,17:50:00,19995.75,SELL,3,0.02h,Stop Loss,$3.00,$322.50,$58977.50,130,$322.50
2024-07-01,18:08:00,20004.75,BUY,3,0.02h,Stop Loss,$31.50,$354.00,$59009.00,130,$354.00
2024-07-01,18:29:00,20006.5,SELL,3,0.02h,Break Even,$-1.50,$352.50,$59007.50,130,$352.50
2024-07-01,18:59:00,20017.0,BUY,3,0.02h,Stop Loss,$-9.00,$343.50,$58998.50,130,$343.50
2024-07-01,19:02:00,20008.25,SELL,3,0.02h,Stop Loss,$9.00,$352.50,$59007.50,130,$352.50
2024-07-01,19:06:00,20025.5,BUY,3,0.02h,Stop Loss,$16.50,$369.00,$59024.00,130,$369.00
2024-07-01,19:23:00,20018.5,SELL,3,0.02h,Break Even,$-1.50,$367.50,$59022.50,130,$367.50
2024-07-01,19:36:00,20031.25,BUY,3,0.02h,Break Even,$-1.50,$366.00,$59021.00,130,$366.00
2024-07-01,19:47:00,20012.5,SELL,3,0.02h,Stop Loss,$6.00,$372.00,$59027.00,130,$372.00
2024-07-01,19:51:00,20031.5,BUY,3,0.02h,Stop Loss,$37.50,$409.50,$59064.50,130,$409.50
2024-07-01,20:16:00,20041.0,SELL,3,0.02h,Stop Loss,$4.50,$414.00,$59069.00,130,$414.00
2024-07-01,20:26:00,20048.25,BUY,3,0.02h,Stop Loss,$-9.00,$405.00,$59060.00,130,$405.00
2024-07-01,20:27:00,20045.25,SELL,3,0.02h,Stop Loss,$-9.00,$396.00,$59051.00,130,$396.00
2024-07-01,20:28:00,20046.75,BUY,3,0.05h,Stop Loss,$-9.00,$387.00,$59042.00,130,$387.00
2024-07-01,20:44:00,20046.0,BUY,3,0.02h,Stop Loss,$-9.00,$378.00,$59033.00,130,$378.00
2024-07-01,20:46:00,20042.5,SELL,3,0.02h,Stop Loss,$-9.00,$369.00,$59024.00,130,$369.00
2024-07-01,23:59:00,20019.25,BUY,3,0.02h,Stop Loss,$-9.00,$360.00,$59015.00,130,$360.00
,,,,,,,,,,,
2024-07-02,00:10:00,20016.0,SELL,3,0.02h,Break Even,$-1.50,$-1.50,$59013.50,131,$-1.50
2024-07-02,01:00:00,19985.75,BUY,3,0.02h,Break Even,$-1.50,$-3.00,$59012.00,131,$-3.00
2024-07-02,01:07:00,19981.25,SELL,3,0.02h,Break Even,$-1.50,$-4.50,$59010.50,131,$-4.50
2024-07-02,01:11:00,19986.0,BUY,3,0.02h,Break Even,$-1.50,$-6.00,$59009.00,131,$-6.00
2024-07-02,01:16:00,19981.25,SELL,3,0.02h,Stop Loss,$-9.00,$-15.00,$59000.00,131,$-15.00
2024-07-02,01:18:00,19987.0,BUY,3,0.02h,Break Even,$-1.50,$-16.50,$58998.50,131,$-16.50
2024-07-02,01:55:00,19986.5,SELL,3,0.02h,Break Even,$-1.50,$-18.00,$58997.00,131,$-18.00
2024-07-02,02:15:00,19990.5,BUY,3,0.02h,Stop Loss,$-9.00,$-27.00,$58988.00,131,$-27.00
2024-07-02,02:17:00,19986.5,SELL,3,0.02h,Stop Loss,$-9.00,$-36.00,$58979.00,131,$-36.00
2024-07-02,02:19:00,19990.0,BUY,3,0.02h,Break Even,$-1.50,$-37.50,$58977.50,131,$-37.50
2024-07-02,02:26:00,19986.75,SELL,3,0.02h,Break Even,$-1.50,$-39.00,$58976.00,131,$-39.00
2024-07-02,03:01:00,19975.5,BUY,3,0.02h,Stop Loss,$-9.00,$-48.00,$58967.00,131,$-48.00
2024-07-02,03:09:00,19969.5,SELL,3,0.02h,Stop Loss,$6.00,$-42.00,$58973.00,131,$-42.00
2024-07-02,03:32:00,19971.0,BUY,3,0.02h,Break Even,$-1.50,$-43.50,$58971.50,131,$-43.50
2024-07-02,04:43:00,19982.75,SELL,3,0.02h,Break Even,$-1.50,$-45.00,$58970.00,131,$-45.00
2024-07-02,05:16:00,19985.25,BUY,3,0.02h,Stop Loss,$-9.00,$-54.00,$58961.00,131,$-54.00
2024-07-02,06:11:00,20006.25,SELL,3,0.02h,Stop Loss,$12.00,$-42.00,$58973.00,131,$-42.00
2024-07-02,07:54:00,19960.75,BUY,3,0.02h,Break Even,$-1.50,$-43.50,$58971.50,131,$-43.50
2024-07-02,08:24:00,19953.75,SELL,3,0.02h,Stop Loss,$4.50,$-39.00,$58976.00,131,$-39.00
2024-07-02,08:53:00,19960.75,BUY,3,0.02h,Stop Loss,$-9.00,$-48.00,$58967.00,131,$-48.00
2024-07-02,09:21:00,19950.5,SELL,3,0.02h,Break Even,$-1.50,$-49.50,$58965.50,131,$-49.50
2024-07-02,09:49:00,19956.75,BUY,3,0.02h,Break Even,$-1.50,$-51.00,$58964.00,131,$-51.00
2024-07-02,10:07:00,19952.75,SELL,3,0.02h,Break Even,$-1.50,$-52.50,$58962.50,131,$-52.50
2024-07-02,10:41:00,19955.75,BUY,3,0.02h,Break Even,$-1.50,$-54.00,$58961.00,131,$-54.00
2024-07-02,11:04:00,19954.5,SELL,3,0.02h,Stop Loss,$-9.00,$-63.00,$58952.00,131,$-63.00
2024-07-02,12:01:00,19935.0,BUY,3,0.02h,Break Even,$-1.50,$-64.50,$58950.50,131,$-64.50
2024-07-02,12:40:00,19946.25,SELL,3,0.02h,Stop Loss,$-9.00,$-73.50,$58941.50,131,$-73.50
2024-07-02,13:00:00,19946.25,BUY,3,0.02h,Stop Loss,$90.00,$16.50,$59031.50,131,$16.50
2024-07-02,14:11:00,20027.5,SELL,3,0.02h,Stop Loss,$12.00,$28.50,$59043.50,131,$28.50
2024-07-02,14:30:00,20058.5,BUY,3,0.02h,Stop Loss,$100.50,$129.00,$59144.00,131,$129.00
2024-07-02,15:21:00,20102.75,SELL,3,0.02h,Stop Loss,$88.50,$217.50,$59232.50,131,$217.50
2024-07-02,15:26:00,20124.0,BUY,3,0.02h,Break Even,$-1.50,$216.00,$59231.00,131,$216.00
2024-07-02,15:55:00,20126.5,SELL,3,0.02h,Stop Loss,$22.50,$238.50,$59253.50,131,$238.50
2024-07-02,16:29:00,20102.75,BUY,3,0.02h,Stop Loss,$19.50,$258.00,$59273.00,131,$258.00
2024-07-02,18:35:00,20211.25,SELL,3,0.02h,Stop Loss,$-9.00,$249.00,$59264.00,131,$249.00
2024-07-02,18:36:00,20217.5,BUY,3,0.02h,Stop Loss,$4.50,$253.50,$59268.50,131,$253.50
2024-07-02,18:37:00,20216.75,SELL,3,0.02h,Break Even,$-1.50,$252.00,$59267.00,131,$252.00
2024-07-02,18:38:00,20218.25,BUY,3,0.02h,Stop Loss,$12.00,$264.00,$59279.00,131,$264.00
2024-07-02,19:05:00,20221.25,SELL,3,0.02h,Stop Loss,$-9.00,$255.00,$59270.00,131,$255.00
2024-07-02,19:26:00,20224.75,BUY,3,0.02h,Stop Loss,$-9.00,$246.00,$59261.00,131,$246.00
2024-07-02,19:42:00,20218.25,SELL,3,0.02h,Break Even,$-1.50,$244.50,$59259.50,131,$244.50
2024-07-02,19:54:00,20231.5,BUY,3,0.02h,Stop Loss,$21.00,$265.50,$59280.50,131,$265.50
2024-07-02,20:38:00,20242.5,SELL,3,0.02h,Stop Loss,$7.50,$273.00,$59288.00,131,$273.00
2024-07-02,21:00:00,20240.25,BUY,3,2.17h,Stop Loss,$49.50,$322.50,$59337.50,131,$322.50
2024-07-02,23:22:00,20243.25,SELL,3,0.02h,Break Even,$-1.50,$321.00,$59336.00,131,$321.00
,,,,,,,,,,,
2024-07-03,00:02:00,20239.5,BUY,3,0.02h,Stop Loss,$-9.00,$-9.00,$59327.00,132,$-9.00
2024-07-03,00:59:00,20247.0,SELL,3,0.02h,Break Even,$-1.50,$-10.50,$59325.50,132,$-10.50
2024-07-03,01:28:00,20245.25,BUY,3,0.02h,Break Even,$-1.50,$-12.00,$59324.00,132,$-12.00
2024-07-03,01:34:00,20243.0,SELL,3,0.03h,Stop Loss,$-9.00,$-21.00,$59315.00,132,$-21.00
2024-07-03,02:01:00,20239.5,BUY,3,0.02h,Stop Loss,$-9.00,$-30.00,$59306.00,132,$-30.00
2024-07-03,02:40:00,20238.5,SELL,3,0.02h,Break Even,$-1.50,$-31.50,$59304.50,132,$-31.50
2024-07-03,03:00:00,20240.25,BUY,3,0.15h,Stop Loss,$18.00,$-13.50,$59322.50,132,$-13.50
2024-07-03,03:19:00,20237.5,SELL,3,0.02h,Stop Loss,$4.50,$-9.00,$59327.00,132,$-9.00
2024-07-03,03:44:00,20238.25,BUY,3,0.02h,Stop Loss,$-9.00,$-18.00,$59318.00,132,$-18.00
2024-07-03,03:54:00,20235.5,SELL,3,0.02h,Stop Loss,$-9.00,$-27.00,$59309.00,132,$-27.00
2024-07-03,04:06:00,20237.75,BUY,3,0.07h,Break Even,$-1.50,$-28.50,$59307.50,132,$-28.50
2024-07-03,04:55:00,20241.5,SELL,3,0.02h,Stop Loss,$-9.00,$-37.50,$59298.50,132,$-37.50
2024-07-03,04:58:00,20244.0,BUY,3,0.05h,Break Even,$-1.50,$-39.00,$59297.00,132,$-39.00
2024-07-03,05:18:00,20243.25,SELL,3,0.02h,Stop Loss,$-9.00,$-48.00,$59288.00,132,$-48.00
2024-07-03,05:19:00,20244.5,BUY,3,0.02h,Stop Loss,$-9.00,$-57.00,$59279.00,132,$-57.00
2024-07-03,05:20:00,20243.5,SELL,3,0.02h,Stop Loss,$-9.00,$-66.00,$59270.00,132,$-66.00
2024-07-03,05:21:00,20246.0,BUY,3,0.02h,Stop Loss,$-9.00,$-75.00,$59261.00,132,$-75.00
2024-07-03,05:29:00,20243.5,SELL,3,0.02h,Stop Loss,$-9.00,$-84.00,$59252.00,132,$-84.00
2024-07-03,05:30:00,20246.0,BUY,3,0.02h,Break Even,$-1.50,$-85.50,$59250.50,132,$-85.50
2024-07-03,05:48:00,20244.25,SELL,3,0.02h,Stop Loss,$-9.00,$-94.50,$59241.50,132,$-94.50
2024-07-03,06:00:00,20248.25,BUY,3,0.02h,Stop Loss,$10.50,$-84.00,$59252.00,132,$-84.00
2024-07-03,06:25:00,20248.75,SELL,3,0.02h,Break Even,$-1.50,$-85.50,$59250.50,132,$-85.50
2024-07-03,06:52:00,20250.5,BUY,3,0.02h,Stop Loss,$-9.00,$-94.50,$59241.50,132,$-94.50
2024-07-03,06:57:00,20241.0,SELL,3,0.02h,Stop Loss,$-9.00,$-103.50,$59232.50,132,$-103.50
2024-07-03,07:15:00,20246.0,BUY,3,0.02h,Break Even,$-1.50,$-105.00,$59231.00,132,$-105.00
2024-07-03,07:24:00,20240.75,SELL,3,0.02h,Stop Loss,$-9.00,$-114.00,$59222.00,132,$-114.00
2024-07-03,07:26:00,20244.75,BUY,3,0.02h,Break Even,$-1.50,$-115.50,$59220.50,132,$-115.50
2024-07-03,07:46:00,20237.5,SELL,3,0.02h,Break Even,$-1.50,$-117.00,$59219.00,132,$-117.00
2024-07-03,08:08:00,20246.25,BUY,3,0.02h,Stop Loss,$-9.00,$-126.00,$59210.00,132,$-126.00
2024-07-03,09:02:00,20265.5,SELL,3,0.02h,Stop Loss,$-9.00,$-135.00,$59201.00,132,$-135.00
2024-07-03,09:27:00,20264.75,BUY,3,0.02h,Break Even,$-1.50,$-136.50,$59199.50,132,$-136.50
2024-07-03,09:31:00,20258.5,SELL,3,0.02h,Break Even,$-1.50,$-138.00,$59198.00,132,$-138.00
2024-07-03,09:39:00,20265.25,BUY,3,0.02h,Break Even,$-1.50,$-139.50,$59196.50,132,$-139.50
2024-07-03,10:07:00,20265.5,SELL,3,0.02h,Break Even,$-1.50,$-141.00,$59195.00,132,$-141.00
2024-07-03,10:25:00,20268.5,BUY,3,0.02h,Break Even,$-1.50,$-142.50,$59193.50,132,$-142.50
2024-07-03,10:39:00,20265.5,SELL,3,0.02h,Stop Loss,$-9.00,$-151.50,$59184.50,132,$-151.50
2024-07-03,10:40:00,20267.0,BUY,3,0.02h,Stop Loss,$-9.00,$-160.50,$59175.50,132,$-160.50
2024-07-03,10:41:00,20265.0,SELL,3,0.02h,Stop Loss,$-9.00,$-169.50,$59166.50,132,$-169.50
2024-07-03,10:42:00,20268.25,BUY,3,0.02h,Stop Loss,$-9.00,$-178.50,$59157.50,132,$-178.50
2024-07-03,10:46:00,20262.25,SELL,3,0.02h,Stop Loss,$-9.00,$-187.50,$59148.50,132,$-187.50
2024-07-03,11:59:00,20251.75,BUY,3,0.02h,Stop Loss,$-9.00,$-196.50,$59139.50,132,$-196.50
2024-07-03,12:11:00,20240.5,SELL,3,0.02h,Break Even,$-1.50,$-198.00,$59138.00,132,$-198.00
2024-07-03,13:01:00,20221.75,BUY,3,0.02h,Break Even,$-1.50,$-199.50,$59136.50,132,$-199.50
2024-07-03,13:06:00,20211.5,SELL,3,0.02h,Stop Loss,$-9.00,$-208.50,$59127.50,132,$-208.50
2024-07-03,13:09:00,20221.5,BUY,3,0.02h,Stop Loss,$-9.00,$-217.50,$59118.50,132,$-217.50
2024-07-03,13:24:00,20212.5,SELL,3,0.02h,Break Even,$-1.50,$-219.00,$59117.00,132,$-219.00
2024-07-03,13:31:00,20242.5,BUY,3,0.02h,Stop Loss,$67.50,$-151.50,$59184.50,132,$-151.50
2024-07-03,14:26:00,20257.5,SELL,3,0.02h,Stop Loss,$60.00,$-91.50,$59244.50,132,$-91.50
2024-07-03,14:39:00,20281.0,BUY,3,0.02h,Stop Loss,$-9.00,$-100.50,$59235.50,132,$-100.50
2024-07-03,15:36:00,20334.5,SELL,3,0.02h,Break Even,$-1.50,$-102.00,$59234.00,132,$-102.00
2024-07-03,15:44:00,20343.75,BUY,3,0.02h,Stop Loss,$21.00,$-81.00,$59255.00,132,$-81.00
2024-07-03,16:41:00,20396.5,SELL,3,0.02h,Stop Loss,$3.00,$-78.00,$59258.00,132,$-78.00
2024-07-03,16:57:00,20406.75,BUY,3,0.02h,Stop Loss,$28.50,$-49.50,$59286.50,132,$-49.50
2024-07-03,23:01:00,20398.0,SELL,3,0.02h,Stop Loss,$-9.00,$-58.50,$59277.50,132,$-58.50
2024-07-03,23:28:00,20405.75,BUY,3,0.02h,Break Even,$-1.50,$-60.00,$59276.00,132,$-60.00
2024-07-03,23:45:00,20404.25,SELL,3,0.03h,Stop Loss,$-9.00,$-69.00,$59267.00,132,$-69.00
2024-07-03,23:48:00,20407.25,BUY,3,0.02h,Break Even,$-1.50,$-70.50,$59265.50,132,$-70.50
,,,,,,,,,,,
2024-07-04,00:00:00,20402.25,SELL,3,0.02h,Stop Loss,$-9.00,$-9.00,$59256.50,133,$-9.00
2024-07-04,00:36:00,20403.5,BUY,3,0.02h,Stop Loss,$-9.00,$-18.00,$59247.50,133,$-18.00
2024-07-04,00:58:00,20404.0,SELL,3,0.02h,Stop Loss,$-9.00,$-27.00,$59238.50,133,$-27.00
2024-07-04,01:02:00,20406.0,BUY,3,0.03h,Stop Loss,$-9.00,$-36.00,$59229.50,133,$-36.00
2024-07-04,01:04:00,20404.25,SELL,3,0.02h,Stop Loss,$-9.00,$-45.00,$59220.50,133,$-45.00
2024-07-04,01:07:00,20407.0,BUY,3,0.02h,Stop Loss,$-9.00,$-54.00,$59211.50,133,$-54.00
2024-07-04,01:09:00,20400.25,SELL,3,0.02h,Stop Loss,$-9.00,$-63.00,$59202.50,133,$-63.00
2024-07-04,01:29:00,20405.25,BUY,3,0.02h,Stop Loss,$-9.00,$-72.00,$59193.50,133,$-72.00
2024-07-04,01:58:00,20405.75,SELL,3,0.02h,Stop Loss,$-9.00,$-81.00,$59184.50,133,$-81.00
2024-07-04,02:34:00,20408.75,BUY,3,0.02h,Stop Loss,$-9.00,$-90.00,$59175.50,133,$-90.00
2024-07-04,02:42:00,20403.75,SELL,3,0.05h,Stop Loss,$-9.00,$-99.00,$59166.50,133,$-99.00
2024-07-04,02:49:00,20406.5,BUY,3,0.05h,Stop Loss,$-9.00,$-108.00,$59157.50,133,$-108.00
2024-07-04,02:56:00,20404.0,SELL,3,0.03h,Break Even,$-1.50,$-109.50,$59156.00,133,$-109.50
2024-07-04,03:31:00,20404.5,BUY,3,0.03h,Break Even,$-1.50,$-111.00,$59154.50,133,$-111.00
2024-07-04,03:46:00,20402.25,SELL,3,0.02h,Break Even,$-1.50,$-112.50,$59153.00,133,$-112.50
2024-07-04,04:04:00,20404.25,BUY,3,0.07h,Break Even,$-1.50,$-114.00,$59151.50,133,$-114.00
2024-07-04,04:27:00,20402.75,SELL,3,0.02h,Stop Loss,$-9.00,$-123.00,$59142.50,133,$-123.00
2024-07-04,04:31:00,20404.5,BUY,3,0.05h,Stop Loss,$-9.00,$-132.00,$59133.50,133,$-132.00
2024-07-04,04:34:00,20402.75,SELL,3,0.02h,Break Even,$-1.50,$-133.50,$59132.00,133,$-133.50
2024-07-04,04:57:00,20403.0,BUY,3,0.02h,Stop Loss,$-9.00,$-142.50,$59123.00,133,$-142.50
2024-07-04,05:05:00,20399.0,SELL,3,0.05h,Stop Loss,$-9.00,$-151.50,$59114.00,133,$-151.50
2024-07-04,05:14:00,20402.0,BUY,3,0.03h,Stop Loss,$-9.00,$-160.50,$59105.00,133,$-160.50
2024-07-04,05:28:00,20400.5,SELL,3,0.02h,Stop Loss,$-9.00,$-169.50,$59096.00,133,$-169.50
2024-07-04,05:30:00,20403.5,BUY,3,0.10h,Break Even,$-1.50,$-171.00,$59094.50,133,$-171.00
2024-07-04,06:10:00,20403.5,SELL,3,0.02h,Break Even,$-1.50,$-172.50,$59093.00,133,$-172.50
2024-07-04,06:37:00,20406.0,BUY,3,0.02h,Stop Loss,$-9.00,$-181.50,$59084.00,133,$-181.50
2024-07-04,07:07:00,20405.25,SELL,3,0.02h,Break Even,$-1.50,$-183.00,$59082.50,133,$-183.00
2024-07-04,07:08:00,20406.25,BUY,3,0.02h,Break Even,$-1.50,$-184.50,$59081.00,133,$-184.50
2024-07-04,07:12:00,20401.75,SELL,3,0.02h,Stop Loss,$-9.00,$-193.50,$59072.00,133,$-193.50
2024-07-04,07:22:00,20407.75,BUY,3,0.02h,Break Even,$-1.50,$-195.00,$59070.50,133,$-195.00
2024-07-04,07:30:00,20404.25,SELL,3,0.02h,Break Even,$-1.50,$-196.50,$59069.00,133,$-196.50
2024-07-04,07:51:00,20404.25,BUY,3,0.02h,Break Even,$-1.50,$-198.00,$59067.50,133,$-198.00
2024-07-04,08:09:00,20403.25,SELL,3,0.02h,Stop Loss,$-9.00,$-207.00,$59058.50,133,$-207.00
2024-07-04,08:30:00,20404.75,BUY,3,0.02h,Stop Loss,$-9.00,$-216.00,$59049.50,133,$-216.00
2024-07-04,08:41:00,20400.25,SELL,3,0.02h,Round Number,$-1.50,$-217.50,$59048.00,133,$-217.50
2024-07-04,08:46:00,20403.25,BUY,3,0.02h,Stop Loss,$-9.00,$-226.50,$59039.00,133,$-226.50
2024-07-04,08:49:00,20400.75,SELL,3,0.02h,Stop Loss,$-9.00,$-235.50,$59030.00,133,$-235.50
2024-07-04,08:52:00,20402.5,BUY,3,0.03h,Stop Loss,$-9.00,$-244.50,$59021.00,133,$-244.50
2024-07-04,08:54:00,20400.25,SELL,3,0.02h,Break Even,$-1.50,$-246.00,$59019.50,133,$-246.00
2024-07-04,09:13:00,20401.75,BUY,3,0.02h,Break Even,$-1.50,$-247.50,$59018.00,133,$-247.50
2024-07-04,09:27:00,20398.75,SELL,3,0.02h,Stop Loss,$-9.00,$-256.50,$59009.00,133,$-256.50
2024-07-04,09:35:00,20401.75,BUY,3,0.02h,Stop Loss,$-9.00,$-265.50,$59000.00,133,$-265.50
2024-07-04,09:37:00,20399.25,SELL,3,0.03h,Stop Loss,$-9.00,$-274.50,$58991.00,133,$-274.50
2024-07-04,09:40:00,20402.75,BUY,3,0.02h,Stop Loss,$-9.00,$-283.50,$58982.00,133,$-283.50
2024-07-04,09:56:00,20400.5,SELL,3,0.02h,Round Number,$0.00,$-283.50,$58982.00,133,$-283.50
2024-07-04,10:16:00,20402.5,BUY,3,0.02h,Stop Loss,$-9.00,$-292.50,$58973.00,133,$-292.50
2024-07-04,10:28:00,20400.25,SELL,3,0.02h,Round Number,$-1.50,$-294.00,$58971.50,133,$-294.00
2024-07-04,10:41:00,20402.0,BUY,3,0.02h,Break Even,$-1.50,$-295.50,$58970.00,133,$-295.50
2024-07-04,10:44:00,20399.5,SELL,3,0.03h,Stop Loss,$-9.00,$-304.50,$58961.00,133,$-304.50
2024-07-04,10:47:00,20401.5,BUY,3,0.05h,Break Even,$-1.50,$-306.00,$58959.50,133,$-306.00
2024-07-04,11:22:00,20403.5,SELL,3,0.02h,Stop Loss,$-9.00,$-315.00,$58950.50,133,$-315.00
2024-07-04,11:23:00,20404.5,BUY,3,0.12h,Stop Loss,$-9.00,$-324.00,$58941.50,133,$-324.00
2024-07-04,11:30:00,20403.75,SELL,3,0.02h,Break Even,$-1.50,$-325.50,$58940.00,133,$-325.50
2024-07-04,11:31:00,20404.75,BUY,3,0.07h,Break Even,$-1.50,$-327.00,$58938.50,133,$-327.00
2024-07-04,11:44:00,20404.25,SELL,3,0.03h,Stop Loss,$-9.00,$-336.00,$58929.50,133,$-336.00
2024-07-04,11:47:00,20405.0,BUY,3,0.05h,Stop Loss,$-9.00,$-345.00,$58920.50,133,$-345.00
2024-07-04,11:52:00,20404.0,SELL,3,0.03h,Stop Loss,$-9.00,$-354.00,$58911.50,133,$-354.00
2024-07-04,11:55:00,20404.75,BUY,3,0.08h,Stop Loss,$-9.00,$-363.00,$58902.50,133,$-363.00
2024-07-04,12:01:00,20403.25,SELL,3,0.03h,Break Even,$-1.50,$-364.50,$58901.00,133,$-364.50
2024-07-04,12:20:00,20405.0,BUY,3,0.02h,Stop Loss,$-9.00,$-373.50,$58892.00,133,$-373.50
2024-07-04,13:25:00,20406.5,SELL,3,0.02h,Stop Loss,$-9.00,$-382.50,$58883.00,133,$-382.50
2024-07-04,15:01:00,20378.5,BUY,3,0.02h,Break Even,$-1.50,$-384.00,$58881.50,133,$-384.00
2024-07-04,15:50:00,20386.5,SELL,3,0.02h,Break Even,$-1.50,$-385.50,$58880.00,133,$-385.50
2024-07-04,16:29:00,20383.0,BUY,3,0.02h,Stop Loss,$-9.00,$-394.50,$58871.00,133,$-394.50
2024-07-04,16:48:00,20380.5,SELL,3,0.02h,Stop Loss,$-9.00,$-403.50,$58862.00,133,$-403.50
2024-07-04,16:51:00,20384.0,BUY,3,0.02h,Stop Loss,$-9.00,$-412.50,$58853.00,133,$-412.50
2024-07-04,16:54:00,20379.75,SELL,3,0.02h,Stop Loss,$-9.00,$-421.50,$58844.00,133,$-421.50
2024-07-04,23:01:00,20384.0,BUY,3,0.02h,Break Even,$-1.50,$-423.00,$58842.50,133,$-423.00
2024-07-04,23:46:00,20391.25,SELL,3,0.02h,Stop Loss,$-9.00,$-432.00,$58833.50,133,$-432.00
2024-07-04,23:48:00,20393.0,BUY,3,0.03h,Stop Loss,$-9.00,$-441.00,$58824.50,133,$-441.00
2024-07-04,23:50:00,20391.0,SELL,3,0.02h,Stop Loss,$-9.00,$-450.00,$58815.50,133,$-450.00
2024-07-04,23:53:00,20393.0,BUY,3,0.03h,Break Even,$-1.50,$-451.50,$58814.00,133,$-451.50
2024-07-04,23:57:00,20392.0,SELL,3,0.07h,Break Even,$-1.50,$-453.00,$58812.50,133,$-453.00
,,,,,,,,,,,
2024-07-05,00:02:00,20395.0,BUY,3,0.02h,Break Even,$-1.50,$-1.50,$58811.00,134,$-1.50
2024-07-05,01:24:00,20404.25,SELL,3,0.02h,Stop Loss,$-9.00,$-10.50,$58802.00,134,$-10.50
2024-07-05,01:31:00,20406.75,BUY,3,0.02h,Break Even,$-1.50,$-12.00,$58800.50,134,$-12.00
2024-07-05,01:37:00,20402.5,SELL,3,0.02h,Stop Loss,$-9.00,$-21.00,$58791.50,134,$-21.00
2024-07-05,01:55:00,20407.0,BUY,3,0.02h,Stop Loss,$-9.00,$-30.00,$58782.50,134,$-30.00
2024-07-05,02:02:00,20402.25,SELL,3,0.02h,Stop Loss,$-9.00,$-39.00,$58773.50,134,$-39.00
2024-07-05,02:16:00,20406.0,BUY,3,0.07h,Break Even,$-1.50,$-40.50,$58772.00,134,$-40.50
2024-07-05,02:43:00,20406.75,SELL,3,0.02h,Stop Loss,$-9.00,$-49.50,$58763.00,134,$-49.50
2024-07-05,02:45:00,20408.25,BUY,3,0.02h,Stop Loss,$-9.00,$-58.50,$58754.00,134,$-58.50
2024-07-05,02:46:00,20407.5,SELL,3,0.02h,Break Even,$-1.50,$-60.00,$58752.50,134,$-60.00
2024-07-05,02:58:00,20408.5,BUY,3,0.07h,Stop Loss,$-9.00,$-69.00,$58743.50,134,$-69.00
2024-07-05,03:12:00,20405.75,SELL,3,0.02h,Break Even,$-1.50,$-70.50,$58742.00,134,$-70.50
2024-07-05,03:22:00,20410.0,BUY,3,0.03h,Break Even,$-1.50,$-72.00,$58740.50,134,$-72.00
2024-07-05,03:55:00,20412.25,SELL,3,0.03h,Stop Loss,$-9.00,$-81.00,$58731.50,134,$-81.00
2024-07-05,03:58:00,20414.0,BUY,3,0.03h,Break Even,$-1.50,$-82.50,$58730.00,134,$-82.50
2024-07-05,05:07:00,20419.0,SELL,3,0.02h,Stop Loss,$-9.00,$-91.50,$58721.00,134,$-91.50
2024-07-05,05:22:00,20421.0,BUY,3,0.13h,Stop Loss,$12.00,$-79.50,$58733.00,134,$-79.50
2024-07-05,05:41:00,20421.25,SELL,3,0.02h,Stop Loss,$-9.00,$-88.50,$58724.00,134,$-88.50
2024-07-05,05:43:00,20424.75,BUY,3,0.03h,Break Even,$-1.50,$-90.00,$58722.50,134,$-90.00
2024-07-05,06:54:00,20447.75,SELL,3,0.02h,Stop Loss,$6.00,$-84.00,$58728.50,134,$-84.00
2024-07-05,07:10:00,20449.5,BUY,3,0.02h,Break Even,$-1.50,$-85.50,$58727.00,134,$-85.50
2024-07-05,07:23:00,20440.75,SELL,3,0.02h,Stop Loss,$13.50,$-72.00,$58740.50,134,$-72.00
2024-07-05,07:48:00,20440.0,BUY,3,0.02h,Break Even,$-1.50,$-73.50,$58739.00,134,$-73.50
2024-07-05,08:04:00,20433.25,SELL,3,0.02h,Stop Loss,$-9.00,$-82.50,$58730.00,134,$-82.50
2024-07-05,08:06:00,20439.25,BUY,3,0.02h,Break Even,$-1.50,$-84.00,$58728.50,134,$-84.00
2024-07-05,08:28:00,20443.5,SELL,3,0.02h,Stop Loss,$-9.00,$-93.00,$58719.50,134,$-93.00
2024-07-05,09:22:00,20433.25,BUY,3,0.02h,Break Even,$-1.50,$-94.50,$58718.00,134,$-94.50
2024-07-05,09:47:00,20432.5,SELL,3,0.02h,Stop Loss,$-9.00,$-103.50,$58709.00,134,$-103.50
2024-07-05,09:55:00,20442.0,BUY,3,0.02h,Stop Loss,$-9.00,$-112.50,$58700.00,134,$-112.50
2024-07-05,10:00:00,20432.5,SELL,3,0.02h,Break Even,$-1.50,$-114.00,$58698.50,134,$-114.00
2024-07-05,10:18:00,20436.25,BUY,3,0.02h,Stop Loss,$-9.00,$-123.00,$58689.50,134,$-123.00
2024-07-05,11:02:00,20439.75,SELL,3,0.02h,Stop Loss,$-9.00,$-132.00,$58680.50,134,$-132.00
2024-07-05,11:03:00,20441.0,BUY,3,0.02h,Break Even,$-1.50,$-133.50,$58679.00,134,$-133.50
2024-07-05,11:23:00,20442.25,SELL,3,0.02h,Break Even,$-1.50,$-135.00,$58677.50,134,$-135.00
2024-07-05,12:07:00,20440.5,BUY,3,0.02h,Stop Loss,$-9.00,$-144.00,$58668.50,134,$-144.00
2024-07-05,12:13:00,20431.75,SELL,3,0.02h,Stop Loss,$13.50,$-130.50,$58682.00,134,$-130.50
2024-07-05,12:23:00,20439.25,BUY,3,0.02h,Break Even,$-1.50,$-132.00,$58680.50,134,$-132.00
2024-07-05,12:44:00,20444.75,SELL,3,0.02h,Break Even,$-1.50,$-133.50,$58679.00,134,$-133.50
2024-07-05,12:46:00,20450.0,BUY,3,0.02h,Stop Loss,$-9.00,$-142.50,$58670.00,134,$-142.50
2024-07-05,12:47:00,20442.75,SELL,3,0.02h,Stop Loss,$4.50,$-138.00,$58674.50,134,$-138.00
2024-07-05,13:21:00,20426.5,BUY,3,0.02h,Stop Loss,$24.00,$-114.00,$58698.50,134,$-114.00
2024-07-05,14:12:00,20467.25,SELL,3,0.02h,Break Even,$-1.50,$-115.50,$58697.00,134,$-115.50
2024-07-05,14:19:00,20507.75,BUY,3,0.02h,Stop Loss,$18.00,$-97.50,$58715.00,134,$-97.50
2024-07-05,15:02:00,20520.5,SELL,3,0.02h,Break Even,$-1.50,$-99.00,$58713.50,134,$-99.00
2024-07-05,15:08:00,20537.25,BUY,3,0.02h,Stop Loss,$40.50,$-58.50,$58754.00,134,$-58.50
2024-07-05,16:09:00,20582.75,SELL,3,0.02h,Stop Loss,$-9.00,$-67.50,$58745.00,134,$-67.50
2024-07-05,16:12:00,20594.25,BUY,3,0.02h,Stop Loss,$19.50,$-48.00,$58764.50,134,$-48.00
2024-07-05,16:36:00,20595.0,SELL,3,0.02h,Stop Loss,$-9.00,$-57.00,$58755.50,134,$-57.00
2024-07-05,17:15:00,20595.0,BUY,3,0.02h,Stop Loss,$7.50,$-49.50,$58763.00,134,$-49.50
2024-07-05,18:01:00,20621.75,SELL,3,0.02h,Stop Loss,$37.50,$-12.00,$58800.50,134,$-12.00
2024-07-05,18:14:00,20627.25,BUY,3,0.02h,Stop Loss,$-9.00,$-21.00,$58791.50,134,$-21.00
2024-07-05,18:24:00,20615.5,SELL,3,0.02h,Stop Loss,$30.00,$9.00,$58821.50,134,$9.00
2024-07-05,18:50:00,20612.5,BUY,3,0.02h,Stop Loss,$3.00,$12.00,$58824.50,134,$12.00
2024-07-05,19:33:00,20616.75,SELL,3,0.02h,Stop Loss,$-9.00,$3.00,$58815.50,134,$3.00
2024-07-05,19:35:00,20626.75,BUY,3,0.02h,Stop Loss,$-9.00,$-6.00,$58806.50,134,$-6.00
2024-07-05,20:01:00,20613.0,SELL,3,0.02h,Break Even,$-1.50,$-7.50,$58805.00,134,$-7.50
,,,,,,,,,,,
2024-07-08,00:27:00,20593.25,BUY,3,0.02h,Stop Loss,$12.00,$12.00,$58817.00,135,$12.00
2024-07-08,00:35:00,20590.75,SELL,3,0.03h,Break Even,$-1.50,$10.50,$58815.50,135,$10.50
2024-07-08,01:16:00,20590.75,BUY,3,0.02h,Stop Loss,$-9.00,$1.50,$58806.50,135,$1.50
2024-07-08,01:59:00,20594.0,SELL,3,0.02h,Break Even,$-1.50,$0.00,$58805.00,135,$0.00
2024-07-08,02:18:00,20598.25,BUY,3,0.02h,Break Even,$-1.50,$-1.50,$58803.50,135,$-1.50
2024-07-08,02:44:00,20598.0,SELL,3,0.02h,Stop Loss,$-9.00,$-10.50,$58794.50,135,$-10.50
2024-07-08,02:45:00,20600.0,BUY,3,0.02h,Break Even,$-1.50,$-12.00,$58793.00,135,$-12.00
2024-07-08,02:56:00,20597.25,SELL,3,0.02h,Stop Loss,$-9.00,$-21.00,$58784.00,135,$-21.00
2024-07-08,03:04:00,20600.25,BUY,3,0.03h,Stop Loss,$-9.00,$-30.00,$58775.00,135,$-30.00
2024-07-08,03:07:00,20597.25,SELL,3,0.02h,Break Even,$-1.50,$-31.50,$58773.50,135,$-31.50
2024-07-08,03:20:00,20599.5,BUY,3,0.02h,Round Number,$0.00,$-31.50,$58773.50,135,$-31.50
2024-07-08,03:28:00,20594.0,SELL,3,0.02h,Stop Loss,$-9.00,$-40.50,$58764.50,135,$-40.50
2024-07-08,03:34:00,20598.75,BUY,3,0.03h,Stop Loss,$-9.00,$-49.50,$58755.50,135,$-49.50
2024-07-08,03:37:00,20596.0,SELL,3,0.02h,Stop Loss,$-9.00,$-58.50,$58746.50,135,$-58.50
2024-07-08,03:40:00,20598.5,BUY,3,0.12h,Stop Loss,$-9.00,$-67.50,$58737.50,135,$-67.50
2024-07-08,03:53:00,20596.5,SELL,3,0.02h,Stop Loss,$-9.00,$-76.50,$58728.50,135,$-76.50
2024-07-08,04:20:00,20597.25,BUY,3,0.02h,Stop Loss,$-9.00,$-85.50,$58719.50,135,$-85.50
2024-07-08,04:22:00,20595.25,SELL,3,0.05h,Stop Loss,$-9.00,$-94.50,$58710.50,135,$-94.50
2024-07-08,05:32:00,20590.0,BUY,3,0.02h,Break Even,$-1.50,$-96.00,$58709.00,135,$-96.00
2024-07-08,05:51:00,20588.75,SELL,3,0.02h,Stop Loss,$6.00,$-90.00,$58715.00,135,$-90.00
2024-07-08,06:14:00,20589.0,BUY,3,0.02h,Stop Loss,$-9.00,$-99.00,$58706.00,135,$-99.00
2024-07-08,06:51:00,20593.0,SELL,3,0.02h,Stop Loss,$-9.00,$-108.00,$58697.00,135,$-108.00
2024-07-08,07:00:00,20598.5,BUY,3,0.02h,Stop Loss,$-9.00,$-117.00,$58688.00,135,$-117.00
2024-07-08,07:02:00,20594.5,SELL,3,0.02h,Stop Loss,$-9.00,$-126.00,$58679.00,135,$-126.00
2024-07-08,07:03:00,20597.0,BUY,3,0.02h,Stop Loss,$6.00,$-120.00,$58685.00,135,$-120.00
2024-07-08,07:10:00,20589.25,SELL,3,0.02h,Stop Loss,$-9.00,$-129.00,$58676.00,135,$-129.00
2024-07-08,07:15:00,20599.0,BUY,3,0.02h,Stop Loss,$-9.00,$-138.00,$58667.00,135,$-138.00
2024-07-08,07:36:00,20598.0,SELL,3,0.02h,Stop Loss,$-9.00,$-147.00,$58658.00,135,$-147.00
2024-07-08,07:38:00,20599.75,BUY,3,0.02h,Break Even,$-1.50,$-148.50,$58656.50,135,$-148.50
2024-07-08,08:18:00,20601.5,SELL,3,0.02h,Stop Loss,$-9.00,$-157.50,$58647.50,135,$-157.50
2024-07-08,08:21:00,20607.5,BUY,3,0.02h,Stop Loss,$-9.00,$-166.50,$58638.50,135,$-166.50
2024-07-08,08:43:00,20606.0,SELL,3,0.02h,Stop Loss,$-9.00,$-175.50,$58629.50,135,$-175.50
2024-07-08,08:45:00,20609.75,BUY,3,0.02h,Stop Loss,$-9.00,$-184.50,$58620.50,135,$-184.50
2024-07-08,08:51:00,20605.5,SELL,3,0.02h,Stop Loss,$-9.00,$-193.50,$58611.50,135,$-193.50
2024-07-08,09:09:00,20607.75,BUY,3,0.02h,Stop Loss,$-9.00,$-202.50,$58602.50,135,$-202.50
2024-07-08,09:41:00,20608.75,SELL,3,0.02h,Stop Loss,$-9.00,$-211.50,$58593.50,135,$-211.50
2024-07-08,09:45:00,20612.25,BUY,3,0.02h,Stop Loss,$-9.00,$-220.50,$58584.50,135,$-220.50
2024-07-08,10:01:00,20610.5,SELL,3,0.02h,Stop Loss,$-9.00,$-229.50,$58575.50,135,$-229.50
2024-07-08,10:09:00,20613.75,BUY,3,0.02h,Break Even,$-1.50,$-231.00,$58574.00,135,$-231.00
2024-07-08,10:27:00,20613.25,SELL,3,0.02h,Stop Loss,$-9.00,$-240.00,$58565.00,135,$-240.00
2024-07-08,10:44:00,20616.75,BUY,3,0.02h,Stop Loss,$-9.00,$-249.00,$58556.00,135,$-249.00
2024-07-08,10:48:00,20612.75,SELL,3,0.02h,Stop Loss,$-9.00,$-258.00,$58547.00,135,$-258.00
2024-07-08,10:50:00,20616.75,BUY,3,0.02h,Stop Loss,$-9.00,$-267.00,$58538.00,135,$-267.00
2024-07-08,10:57:00,20611.25,SELL,3,0.02h,Break Even,$-1.50,$-268.50,$58536.50,135,$-268.50
2024-07-08,11:08:00,20617.0,BUY,3,0.02h,Break Even,$-1.50,$-270.00,$58535.00,135,$-270.00
2024-07-08,12:42:00,20631.25,SELL,3,0.02h,Stop Loss,$-9.00,$-279.00,$58526.00,135,$-279.00
2024-07-08,13:06:00,20632.5,BUY,3,0.02h,Stop Loss,$-9.00,$-288.00,$58517.00,135,$-288.00
2024-07-08,13:31:00,20628.25,SELL,3,0.02h,Stop Loss,$43.50,$-244.50,$58560.50,135,$-244.50
2024-07-08,13:51:00,20646.5,BUY,3,0.02h,Stop Loss,$24.00,$-220.50,$58584.50,135,$-220.50
2024-07-08,14:01:00,20607.75,SELL,3,0.02h,Stop Loss,$46.50,$-174.00,$58631.00,135,$-174.00
2024-07-08,14:08:00,20633.75,BUY,3,0.02h,Stop Loss,$3.00,$-171.00,$58634.00,135,$-171.00
2024-07-08,14:21:00,20611.25,SELL,3,0.02h,Stop Loss,$12.00,$-159.00,$58646.00,135,$-159.00
2024-07-08,14:31:00,20631.75,BUY,3,0.02h,Stop Loss,$-9.00,$-168.00,$58637.00,135,$-168.00
2024-07-08,14:34:00,20615.0,SELL,3,0.02h,Break Even,$-1.50,$-169.50,$58635.50,135,$-169.50
2024-07-08,15:03:00,20618.5,BUY,3,0.02h,Stop Loss,$43.50,$-126.00,$58679.00,135,$-126.00
2024-07-08,16:04:00,20647.5,SELL,3,0.02h,Break Even,$-1.50,$-127.50,$58677.50,135,$-127.50
2024-07-08,16:49:00,20626.25,BUY,3,0.02h,Break Even,$-1.50,$-129.00,$58676.00,135,$-129.00
2024-07-08,17:52:00,20647.25,SELL,3,0.02h,Break Even,$-1.50,$-130.50,$58674.50,135,$-130.50
2024-07-08,18:21:00,20646.5,BUY,3,0.02h,Stop Loss,$-9.00,$-139.50,$58665.50,135,$-139.50
2024-07-08,18:33:00,20635.0,SELL,3,0.02h,Break Even,$-1.50,$-141.00,$58664.00,135,$-141.00
2024-07-08,18:55:00,20638.25,BUY,3,0.02h,Stop Loss,$21.00,$-120.00,$58685.00,135,$-120.00
2024-07-08,19:12:00,20633.25,SELL,3,0.02h,Break Even,$-1.50,$-121.50,$58683.50,135,$-121.50
2024-07-08,19:44:00,20633.5,BUY,3,0.02h,Stop Loss,$16.50,$-105.00,$58700.00,135,$-105.00
2024-07-08,20:35:00,20675.5,SELL,3,0.02h,Stop Loss,$-9.00,$-114.00,$58691.00,135,$-114.00
2024-07-08,20:43:00,20678.0,BUY,3,0.02h,Stop Loss,$-9.00,$-123.00,$58682.00,135,$-123.00
2024-07-08,20:44:00,20677.0,SELL,3,0.02h,Stop Loss,$-9.00,$-132.00,$58673.00,135,$-132.00
2024-07-08,20:46:00,20677.25,BUY,3,0.03h,Break Even,$-1.50,$-133.50,$58671.50,135,$-133.50
,,,,,,,,,,,
2024-07-09,00:26:00,20738.25,SELL,3,0.02h,Stop Loss,$-9.00,$-9.00,$58662.50,136,$-9.00
2024-07-09,00:47:00,20738.25,BUY,3,0.02h,Stop Loss,$-9.00,$-18.00,$58653.50,136,$-18.00
2024-07-09,00:50:00,20735.5,SELL,3,0.02h,Stop Loss,$4.50,$-13.50,$58658.00,136,$-13.50
2024-07-09,01:12:00,20733.25,BUY,3,0.02h,Break Even,$-1.50,$-15.00,$58656.50,136,$-15.00
2024-07-09,01:42:00,20729.5,SELL,3,0.02h,Stop Loss,$-9.00,$-24.00,$58647.50,136,$-24.00
2024-07-09,02:27:00,20712.25,BUY,3,0.02h,Stop Loss,$-9.00,$-33.00,$58638.50,136,$-33.00
2024-07-09,03:01:00,20715.0,SELL,3,0.02h,Stop Loss,$-9.00,$-42.00,$58629.50,136,$-42.00
2024-07-09,03:02:00,20718.5,BUY,3,0.02h,Break Even,$-1.50,$-43.50,$58628.00,136,$-43.50
2024-07-09,04:09:00,20731.25,SELL,3,0.02h,Stop Loss,$-9.00,$-52.50,$58619.00,136,$-52.50
2024-07-09,04:10:00,20734.75,BUY,3,0.03h,Stop Loss,$-9.00,$-61.50,$58610.00,136,$-61.50
2024-07-09,04:33:00,20731.25,SELL,3,0.02h,Break Even,$-1.50,$-63.00,$58608.50,136,$-63.00
2024-07-09,04:43:00,20736.0,BUY,3,0.02h,Break Even,$-1.50,$-64.50,$58607.00,136,$-64.50
2024-07-09,05:21:00,20733.75,SELL,3,0.02h,Stop Loss,$34.50,$-30.00,$58641.50,136,$-30.00
2024-07-09,05:44:00,20732.5,BUY,3,0.02h,Stop Loss,$-9.00,$-39.00,$58632.50,136,$-39.00
2024-07-09,05:50:00,20728.0,SELL,3,0.02h,Break Even,$-1.50,$-40.50,$58631.00,136,$-40.50
2024-07-09,06:23:00,20724.25,BUY,3,0.02h,Break Even,$-1.50,$-42.00,$58629.50,136,$-42.00
2024-07-09,06:34:00,20720.0,SELL,3,0.02h,Break Even,$-1.50,$-43.50,$58628.00,136,$-43.50
2024-07-09,06:45:00,20722.75,BUY,3,0.02h,Stop Loss,$-9.00,$-52.50,$58619.00,136,$-52.50
2024-07-09,06:47:00,20719.0,SELL,3,0.02h,Stop Loss,$-9.00,$-61.50,$58610.00,136,$-61.50
2024-07-09,06:49:00,20723.75,BUY,3,0.02h,Stop Loss,$-9.00,$-70.50,$58601.00,136,$-70.50
2024-07-09,07:02:00,20716.5,SELL,3,0.02h,Break Even,$-1.50,$-72.00,$58599.50,136,$-72.00
2024-07-09,07:22:00,20724.25,BUY,3,0.02h,Break Even,$-1.50,$-73.50,$58598.00,136,$-73.50
2024-07-09,08:02:00,20729.75,SELL,3,0.02h,Stop Loss,$-9.00,$-82.50,$58589.00,136,$-82.50
2024-07-09,08:08:00,20738.75,BUY,3,0.02h,Stop Loss,$-9.00,$-91.50,$58580.00,136,$-91.50
2024-07-09,08:12:00,20731.75,SELL,3,0.02h,Stop Loss,$-9.00,$-100.50,$58571.00,136,$-100.50
2024-07-09,08:13:00,20735.5,BUY,3,0.02h,Stop Loss,$-9.00,$-109.50,$58562.00,136,$-109.50
2024-07-09,08:15:00,20731.0,SELL,3,0.02h,Stop Loss,$-9.00,$-118.50,$58553.00,136,$-118.50
2024-07-09,08:16:00,20736.75,BUY,3,0.02h,Stop Loss,$3.00,$-115.50,$58556.00,136,$-115.50
2024-07-09,08:27:00,20727.0,SELL,3,0.02h,Break Even,$-1.50,$-117.00,$58554.50,136,$-117.00
2024-07-09,08:43:00,20733.75,BUY,3,0.02h,Break Even,$-1.50,$-118.50,$58553.00,136,$-118.50
2024-07-09,10:01:00,20737.5,SELL,3,0.02h,Stop Loss,$-9.00,$-127.50,$58544.00,136,$-127.50
2024-07-09,10:31:00,20740.25,BUY,3,0.02h,Break Even,$-1.50,$-129.00,$58542.50,136,$-129.00
2024-07-09,10:49:00,20736.75,SELL,3,0.02h,Stop Loss,$-9.00,$-138.00,$58533.50,136,$-138.00
2024-07-09,11:02:00,20741.75,BUY,3,0.02h,Break Even,$-1.50,$-139.50,$58532.00,136,$-139.50
2024-07-09,11:13:00,20733.5,SELL,3,0.02h,Stop Loss,$-9.00,$-148.50,$58523.00,136,$-148.50
2024-07-09,11:58:00,20726.75,BUY,3,0.02h,Stop Loss,$-9.00,$-157.50,$58514.00,136,$-157.50
2024-07-09,11:59:00,20723.75,SELL,3,0.02h,Stop Loss,$-9.00,$-166.50,$58505.00,136,$-166.50
2024-07-09,12:01:00,20728.25,BUY,3,0.02h,Break Even,$-1.50,$-168.00,$58503.50,136,$-168.00
2024-07-09,12:04:00,20722.25,SELL,3,0.02h,Stop Loss,$-9.00,$-177.00,$58494.50,136,$-177.00
2024-07-09,12:06:00,20728.25,BUY,3,0.02h,Break Even,$-1.50,$-178.50,$58493.00,136,$-178.50
2024-07-09,12:18:00,20723.25,SELL,3,0.02h,Break Even,$-1.50,$-180.00,$58491.50,136,$-180.00
2024-07-09,12:51:00,20719.0,BUY,3,0.02h,Break Even,$-1.50,$-181.50,$58490.00,136,$-181.50
2024-07-09,13:52:00,20726.5,SELL,3,0.02h,Break Even,$-1.50,$-183.00,$58488.50,136,$-183.00
2024-07-09,13:55:00,20739.25,BUY,3,0.02h,Break Even,$-1.50,$-184.50,$58487.00,136,$-184.50
2024-07-09,14:07:00,20720.0,SELL,3,0.02h,Break Even,$-1.50,$-186.00,$58485.50,136,$-186.00
2024-07-09,14:12:00,20753.25,BUY,3,0.02h,Stop Loss,$90.00,$-96.00,$58575.50,136,$-96.00
2024-07-09,14:25:00,20718.75,SELL,3,0.02h,Stop Loss,$37.50,$-58.50,$58613.00,136,$-58.50
2024-07-09,14:45:00,20728.5,BUY,3,0.02h,Stop Loss,$45.00,$-13.50,$58658.00,136,$-13.50
2024-07-09,14:56:00,20712.25,SELL,3,0.02h,Stop Loss,$48.00,$34.50,$58706.00,136,$34.50
2024-07-09,15:47:00,20698.75,BUY,3,0.02h,Stop Loss,$4.50,$39.00,$58710.50,136,$39.00
2024-07-09,16:27:00,20696.0,SELL,3,0.02h,Stop Loss,$-9.00,$30.00,$58701.50,136,$30.00
2024-07-09,17:03:00,20682.0,BUY,3,0.02h,Stop Loss,$31.50,$61.50,$58733.00,136,$61.50
2024-07-09,17:17:00,20663.25,SELL,3,0.02h,Stop Loss,$88.50,$150.00,$58821.50,136,$150.00
2024-07-09,17:39:00,20652.0,BUY,3,0.02h,Break Even,$-1.50,$148.50,$58820.00,136,$148.50
2024-07-09,17:48:00,20643.5,SELL,3,0.02h,Break Even,$-1.50,$147.00,$58818.50,136,$147.00
2024-07-09,17:52:00,20652.25,BUY,3,0.02h,Stop Loss,$18.00,$165.00,$58836.50,136,$165.00
2024-07-09,18:07:00,20650.5,SELL,3,0.02h,Stop Loss,$-9.00,$156.00,$58827.50,136,$156.00
2024-07-09,18:09:00,20656.75,BUY,3,0.02h,Stop Loss,$19.50,$175.50,$58847.00,136,$175.50
2024-07-09,18:28:00,20654.75,SELL,3,0.02h,Stop Loss,$13.50,$189.00,$58860.50,136,$189.00
2024-07-09,18:37:00,20664.5,BUY,3,0.02h,Break Even,$-1.50,$187.50,$58859.00,136,$187.50
2024-07-09,18:56:00,20660.25,SELL,3,0.02h,Stop Loss,$10.50,$198.00,$58869.50,136,$198.00
2024-07-09,19:00:00,20671.5,BUY,3,0.02h,Break Even,$-1.50,$196.50,$58868.00,136,$196.50
2024-07-09,19:22:00,20659.5,SELL,3,0.02h,Stop Loss,$3.00,$199.50,$58871.00,136,$199.50
2024-07-09,19:39:00,20667.0,BUY,3,0.02h,Stop Loss,$-9.00,$190.50,$58862.00,136,$190.50
2024-07-09,20:12:00,20673.25,SELL,3,0.03h,Stop Loss,$-9.00,$181.50,$58853.00,136,$181.50
2024-07-09,20:15:00,20675.0,BUY,3,0.02h,Break Even,$-1.50,$180.00,$58851.50,136,$180.00
2024-07-09,23:33:00,20696.0,SELL,3,0.02h,Stop Loss,$-9.00,$171.00,$58842.50,136,$171.00
2024-07-09,23:44:00,20700.75,BUY,3,0.02h,Stop Loss,$-9.00,$162.00,$58833.50,136,$162.00
2024-07-09,23:51:00,20697.5,SELL,3,0.12h,Break Even,$-1.50,$160.50,$58832.00,136,$160.50
,,,,,,,,,,,
2024-07-10,00:02:00,20699.0,BUY,3,0.02h,Break Even,$-1.50,$-1.50,$58830.50,137,$-1.50
2024-07-10,00:36:00,20701.5,SELL,3,0.02h,Stop Loss,$-9.00,$-10.50,$58821.50,137,$-10.50
2024-07-10,00:40:00,20704.25,BUY,3,0.02h,Break Even,$-1.50,$-12.00,$58820.00,137,$-12.00
2024-07-10,01:24:00,20707.25,SELL,3,0.03h,Break Even,$-1.50,$-13.50,$58818.50,137,$-13.50
2024-07-10,01:42:00,20708.75,BUY,3,0.07h,Stop Loss,$-9.00,$-22.50,$58809.50,137,$-22.50
2024-07-10,01:50:00,20704.25,SELL,3,0.02h,Stop Loss,$-9.00,$-31.50,$58800.50,137,$-31.50
2024-07-10,02:05:00,20707.25,BUY,3,0.03h,Stop Loss,$-9.00,$-40.50,$58791.50,137,$-40.50
2024-07-10,02:13:00,20705.0,SELL,3,0.05h,Stop Loss,$-9.00,$-49.50,$58782.50,137,$-49.50
2024-07-10,02:16:00,20706.0,BUY,3,0.03h,Break Even,$-1.50,$-51.00,$58781.00,137,$-51.00
2024-07-10,03:36:00,20712.25,SELL,3,0.02h,Stop Loss,$-9.00,$-60.00,$58772.00,137,$-60.00
2024-07-10,04:29:00,20708.75,BUY,3,0.03h,Break Even,$-1.50,$-61.50,$58770.50,137,$-61.50
2024-07-10,05:08:00,20711.0,SELL,3,0.03h,Break Even,$-1.50,$-63.00,$58769.00,137,$-63.00
2024-07-10,06:08:00,20702.25,BUY,3,0.02h,Stop Loss,$-9.00,$-72.00,$58760.00,137,$-72.00
2024-07-10,06:42:00,20702.25,SELL,3,0.05h,Stop Loss,$-9.00,$-81.00,$58751.00,137,$-81.00
2024-07-10,06:52:00,20708.5,BUY,3,0.02h,Stop Loss,$12.00,$-69.00,$58763.00,137,$-69.00
2024-07-10,06:59:00,20702.5,SELL,3,0.02h,Break Even,$-1.50,$-70.50,$58761.50,137,$-70.50
2024-07-10,07:11:00,20708.25,BUY,3,0.02h,Stop Loss,$-9.00,$-79.50,$58752.50,137,$-79.50
2024-07-10,07:17:00,20703.0,SELL,3,0.02h,Stop Loss,$-9.00,$-88.50,$58743.50,137,$-88.50
2024-07-10,07:18:00,20709.0,BUY,3,0.02h,Break Even,$-1.50,$-90.00,$58742.00,137,$-90.00
2024-07-10,09:32:00,20728.25,SELL,3,0.03h,Stop Loss,$-9.00,$-99.00,$58733.00,137,$-99.00
2024-07-10,09:36:00,20730.0,BUY,3,0.02h,Break Even,$-1.50,$-100.50,$58731.50,137,$-100.50
2024-07-10,09:41:00,20726.75,SELL,3,0.07h,Stop Loss,$13.50,$-87.00,$58745.00,137,$-87.00
2024-07-10,09:58:00,20728.0,BUY,3,0.02h,Break Even,$-1.50,$-88.50,$58743.50,137,$-88.50
2024-07-10,10:52:00,20736.0,SELL,3,0.02h,Stop Loss,$-9.00,$-97.50,$58734.50,137,$-97.50
2024-07-10,11:10:00,20740.25,BUY,3,0.02h,Stop Loss,$-9.00,$-106.50,$58725.50,137,$-106.50
2024-07-10,11:15:00,20735.25,SELL,3,0.02h,Break Even,$-1.50,$-108.00,$58724.00,137,$-108.00
2024-07-10,11:16:00,20738.25,BUY,3,0.03h,Stop Loss,$-9.00,$-117.00,$58715.00,137,$-117.00
2024-07-10,11:20:00,20735.75,SELL,3,0.03h,Stop Loss,$-9.00,$-126.00,$58706.00,137,$-126.00
2024-07-10,11:33:00,20737.5,BUY,3,0.03h,Stop Loss,$-9.00,$-135.00,$58697.00,137,$-135.00
2024-07-10,12:24:00,20755.75,SELL,3,0.02h,Stop Loss,$-9.00,$-144.00,$58688.00,137,$-144.00
2024-07-10,12:27:00,20761.0,BUY,3,0.02h,Stop Loss,$-9.00,$-153.00,$58679.00,137,$-153.00
2024-07-10,12:46:00,20756.25,SELL,3,0.02h,Break Even,$-1.50,$-154.50,$58677.50,137,$-154.50
2024-07-10,13:07:00,20758.5,BUY,3,0.02h,Break Even,$-1.50,$-156.00,$58676.00,137,$-156.00
2024-07-10,13:20:00,20755.5,SELL,3,0.02h,Stop Loss,$-9.00,$-165.00,$58667.00,137,$-165.00
2024-07-10,13:26:00,20765.0,BUY,3,0.02h,Stop Loss,$-9.00,$-174.00,$58658.00,137,$-174.00
2024-07-10,13:32:00,20752.5,SELL,3,0.02h,Stop Loss,$51.00,$-123.00,$58709.00,137,$-123.00
2024-07-10,13:46:00,20761.25,BUY,3,0.02h,Stop Loss,$-9.00,$-132.00,$58700.00,137,$-132.00
2024-07-10,14:21:00,20761.0,SELL,3,0.02h,Stop Loss,$13.50,$-118.50,$58713.50,137,$-118.50
2024-07-10,15:23:00,20735.0,BUY,3,0.02h,Stop Loss,$-9.00,$-127.50,$58704.50,137,$-127.50
2024-07-10,17:27:00,20848.25,SELL,3,0.02h,Stop Loss,$-9.00,$-136.50,$58695.50,137,$-136.50
2024-07-10,17:28:00,20857.75,BUY,3,0.02h,Stop Loss,$-9.00,$-145.50,$58686.50,137,$-145.50
2024-07-10,18:20:00,20867.0,SELL,3,0.02h,Stop Loss,$16.50,$-129.00,$58703.00,137,$-129.00
2024-07-10,18:36:00,20872.75,BUY,3,0.02h,Stop Loss,$-9.00,$-138.00,$58694.00,137,$-138.00
2024-07-10,18:42:00,20867.0,SELL,3,0.02h,Break Even,$-1.50,$-139.50,$58692.50,137,$-139.50
2024-07-10,18:44:00,20873.25,BUY,3,0.02h,Stop Loss,$-9.00,$-148.50,$58683.50,137,$-148.50
2024-07-10,19:02:00,20869.75,SELL,3,0.02h,Stop Loss,$15.00,$-133.50,$58698.50,137,$-133.50
2024-07-10,19:30:00,20870.0,BUY,3,0.02h,Stop Loss,$-9.00,$-142.50,$58689.50,137,$-142.50
2024-07-10,20:04:00,20884.0,SELL,3,0.02h,Stop Loss,$9.00,$-133.50,$58698.50,137,$-133.50
2024-07-10,20:20:00,20893.5,BUY,3,0.02h,Stop Loss,$-9.00,$-142.50,$58689.50,137,$-142.50
2024-07-10,20:47:00,20886.75,SELL,3,0.02h,Stop Loss,$-9.00,$-151.50,$58680.50,137,$-151.50
2024-07-10,20:55:00,20892.5,BUY,3,0.02h,Break Even,$-1.50,$-153.00,$58679.00,137,$-153.00
2024-07-10,23:01:00,20888.5,SELL,3,0.02h,Break Even,$-1.50,$-154.50,$58677.50,137,$-154.50
,,,,,,,,,,,
2024-07-11,00:08:00,20883.25,BUY,3,0.03h,Stop Loss,$-9.00,$-9.00,$58668.50,138,$-9.00
2024-07-11,00:15:00,20879.25,SELL,3,0.02h,Stop Loss,$-9.00,$-18.00,$58659.50,138,$-18.00
2024-07-11,01:29:00,20863.0,BUY,3,0.10h,Stop Loss,$13.50,$-4.50,$58673.00,138,$-4.50
2024-07-11,02:32:00,20876.75,SELL,3,0.02h,Stop Loss,$-9.00,$-13.50,$58664.00,138,$-13.50
2024-07-11,02:33:00,20880.0,BUY,3,0.03h,Stop Loss,$-9.00,$-22.50,$58655.00,138,$-22.50
2024-07-11,02:38:00,20876.0,SELL,3,0.02h,Stop Loss,$-9.00,$-31.50,$58646.00,138,$-31.50
2024-07-11,03:23:00,20873.5,BUY,3,0.03h,Break Even,$-1.50,$-33.00,$58644.50,138,$-33.00
2024-07-11,04:12:00,20880.25,SELL,3,0.02h,Stop Loss,$-9.00,$-42.00,$58635.50,138,$-42.00
2024-07-11,04:14:00,20883.25,BUY,3,0.02h,Stop Loss,$-9.00,$-51.00,$58626.50,138,$-51.00
2024-07-11,04:24:00,20880.75,SELL,3,0.02h,Stop Loss,$-9.00,$-60.00,$58617.50,138,$-60.00
2024-07-11,04:50:00,20881.0,BUY,3,0.15h,Stop Loss,$-9.00,$-69.00,$58608.50,138,$-69.00
2024-07-11,05:35:00,20883.0,SELL,3,0.02h,Stop Loss,$-9.00,$-78.00,$58599.50,138,$-78.00
2024-07-11,06:21:00,20878.75,BUY,3,0.02h,Stop Loss,$-9.00,$-87.00,$58590.50,138,$-87.00
2024-07-11,07:01:00,20878.0,SELL,3,0.02h,Break Even,$-1.50,$-88.50,$58589.00,138,$-88.50
2024-07-11,07:33:00,20880.75,BUY,3,0.02h,Break Even,$-1.50,$-90.00,$58587.50,138,$-90.00
2024-07-11,08:04:00,20881.75,SELL,3,0.02h,Stop Loss,$-9.00,$-99.00,$58578.50,138,$-99.00
2024-07-11,08:05:00,20884.5,BUY,3,0.02h,Break Even,$-1.50,$-100.50,$58577.00,138,$-100.50
2024-07-11,08:14:00,20880.25,SELL,3,0.02h,Stop Loss,$-9.00,$-109.50,$58568.00,138,$-109.50
2024-07-11,08:15:00,20884.5,BUY,3,0.02h,Break Even,$-1.50,$-111.00,$58566.50,138,$-111.00
2024-07-11,08:27:00,20879.25,SELL,3,0.02h,Stop Loss,$-9.00,$-120.00,$58557.50,138,$-120.00
2024-07-11,08:33:00,20890.25,BUY,3,0.02h,Stop Loss,$-9.00,$-129.00,$58548.50,138,$-129.00
2024-07-11,08:42:00,20882.25,SELL,3,0.02h,Break Even,$-1.50,$-130.50,$58547.00,138,$-130.50
2024-07-11,09:40:00,20879.5,BUY,3,0.03h,Break Even,$-1.50,$-132.00,$58545.50,138,$-132.00
2024-07-11,10:11:00,20880.0,SELL,3,0.02h,Break Even,$-1.50,$-133.50,$58544.00,138,$-133.50
2024-07-11,10:22:00,20883.5,BUY,3,0.02h,Stop Loss,$-9.00,$-142.50,$58535.00,138,$-142.50
2024-07-11,10:36:00,20879.0,SELL,3,0.02h,Stop Loss,$-9.00,$-151.50,$58526.00,138,$-151.50
2024-07-11,11:00:00,20881.25,BUY,3,0.02h,Break Even,$-1.50,$-153.00,$58524.50,138,$-153.00
2024-07-11,11:25:00,20880.5,SELL,3,0.02h,Stop Loss,$-9.00,$-162.00,$58515.50,138,$-162.00
2024-07-11,11:31:00,20883.5,BUY,3,0.03h,Break Even,$-1.50,$-163.50,$58514.00,138,$-163.50
2024-07-11,11:56:00,20883.5,SELL,3,0.02h,Break Even,$-1.50,$-165.00,$58512.50,138,$-165.00
2024-07-11,12:13:00,20882.75,BUY,3,0.02h,Stop Loss,$-9.00,$-174.00,$58503.50,138,$-174.00
2024-07-11,12:14:00,20881.0,SELL,3,0.02h,Break Even,$-1.50,$-175.50,$58502.00,138,$-175.50
2024-07-11,12:29:00,20882.5,BUY,3,0.02h,Stop Loss,$24.00,$-151.50,$58526.00,138,$-151.50
2024-07-11,12:52:00,20907.5,SELL,3,0.02h,Stop Loss,$105.00,$-46.50,$58631.00,138,$-46.50
2024-07-11,13:18:00,20914.0,BUY,3,0.02h,Break Even,$-1.50,$-48.00,$58629.50,138,$-48.00
2024-07-11,13:29:00,20895.5,SELL,3,0.02h,Stop Loss,$28.50,$-19.50,$58658.00,138,$-19.50
2024-07-11,16:11:00,20519.0,BUY,3,0.02h,Stop Loss,$18.00,$-1.50,$58676.00,138,$-1.50
2024-07-11,16:19:00,20481.5,SELL,3,0.02h,Stop Loss,$-9.00,$-10.50,$58667.00,138,$-10.50
2024-07-11,16:31:00,20510.0,BUY,3,0.02h,Stop Loss,$22.50,$12.00,$58689.50,138,$12.00
2024-07-11,16:48:00,20470.5,SELL,3,0.02h,Stop Loss,$88.50,$100.50,$58778.00,138,$100.50
2024-07-11,17:17:00,20474.25,BUY,3,0.02h,Break Even,$-1.50,$99.00,$58776.50,138,$99.00
2024-07-11,17:35:00,20459.5,SELL,3,0.02h,Stop Loss,$34.50,$133.50,$58811.00,138,$133.50
2024-07-11,18:17:00,20412.5,BUY,3,0.02h,Stop Loss,$-9.00,$124.50,$58802.00,138,$124.50
2024-07-11,19:22:00,20466.5,SELL,3,0.02h,Stop Loss,$12.00,$136.50,$58814.00,138,$136.50
2024-07-11,19:38:00,20481.25,BUY,3,0.02h,Stop Loss,$21.00,$157.50,$58835.00,138,$157.50
2024-07-11,19:45:00,20448.25,SELL,3,0.02h,Break Even,$-1.50,$156.00,$58833.50,138,$156.00
2024-07-11,19:50:00,20466.0,BUY,3,0.02h,Stop Loss,$48.00,$204.00,$58881.50,138,$204.00
2024-07-11,19:55:00,20447.0,SELL,3,0.02h,Stop Loss,$37.50,$241.50,$58919.00,138,$241.50
2024-07-11,20:31:00,20452.0,BUY,3,0.02h,Stop Loss,$-9.00,$232.50,$58910.00,138,$232.50
2024-07-11,20:39:00,20442.75,SELL,3,0.02h,Stop Loss,$-9.00,$223.50,$58901.00,138,$223.50
2024-07-11,20:40:00,20445.5,BUY,3,0.02h,Break Even,$-1.50,$222.00,$58899.50,138,$222.00
2024-07-11,20:43:00,20442.5,SELL,3,0.02h,Break Even,$-1.50,$220.50,$58898.00,138,$220.50
2024-07-11,20:45:00,20445.5,BUY,3,0.02h,Break Even,$-1.50,$219.00,$58896.50,138,$219.00
2024-07-11,20:46:00,20442.5,SELL,3,0.02h,Stop Loss,$3.00,$222.00,$58899.50,138,$222.00
2024-07-11,23:02:00,20446.25,BUY,3,0.02h,Stop Loss,$-9.00,$213.00,$58890.50,138,$213.00
2024-07-11,23:38:00,20447.25,SELL,3,0.02h,Stop Loss,$-9.00,$204.00,$58881.50,138,$204.00
,,,,,,,,,,,
2024-07-12,00:13:00,20434.25,BUY,3,0.02h,Stop Loss,$-9.00,$-9.00,$58872.50,139,$-9.00
2024-07-12,00:50:00,20438.75,SELL,3,0.02h,Break Even,$-1.50,$-10.50,$58871.00,139,$-10.50
2024-07-12,01:07:00,20442.0,BUY,3,0.02h,Stop Loss,$-9.00,$-19.50,$58862.00,139,$-19.50
2024-07-12,01:11:00,20436.75,SELL,3,0.02h,Stop Loss,$-9.00,$-28.50,$58853.00,139,$-28.50
2024-07-12,01:15:00,20440.25,BUY,3,0.03h,Stop Loss,$-9.00,$-37.50,$58844.00,139,$-37.50
2024-07-12,01:33:00,20436.25,SELL,3,0.03h,Stop Loss,$-9.00,$-46.50,$58835.00,139,$-46.50
2024-07-12,02:27:00,20428.75,BUY,3,0.02h,Break Even,$-1.50,$-48.00,$58833.50,139,$-48.00
2024-07-12,02:39:00,20425.0,SELL,3,0.02h,Stop Loss,$-9.00,$-57.00,$58824.50,139,$-57.00
2024-07-12,02:47:00,20429.0,BUY,3,0.02h,Break Even,$-1.50,$-58.50,$58823.00,139,$-58.50
2024-07-12,02:54:00,20424.0,SELL,3,0.02h,Break Even,$-1.50,$-60.00,$58821.50,139,$-60.00
2024-07-12,03:38:00,20419.25,BUY,3,0.02h,Break Even,$-1.50,$-61.50,$58820.00,139,$-61.50
2024-07-12,04:02:00,20419.5,SELL,3,0.02h,Stop Loss,$-9.00,$-70.50,$58811.00,139,$-70.50
2024-07-12,04:03:00,20422.25,BUY,3,0.02h,Stop Loss,$-9.00,$-79.50,$58802.00,139,$-79.50
2024-07-12,04:04:00,20419.25,SELL,3,0.02h,Stop Loss,$3.00,$-76.50,$58805.00,139,$-76.50
2024-07-12,04:13:00,20422.0,BUY,3,0.07h,Stop Loss,$7.50,$-69.00,$58812.50,139,$-69.00
2024-07-12,04:26:00,20419.0,SELL,3,0.02h,Break Even,$-1.50,$-70.50,$58811.00,139,$-70.50
2024-07-12,05:24:00,20401.25,BUY,3,0.02h,Stop Loss,$22.50,$-48.00,$58833.50,139,$-48.00
2024-07-12,06:15:00,20408.0,SELL,3,0.02h,Stop Loss,$3.00,$-45.00,$58836.50,139,$-45.00
2024-07-12,06:21:00,20422.25,BUY,3,0.02h,Break Even,$-1.50,$-46.50,$58835.00,139,$-46.50
2024-07-12,06:45:00,20423.25,SELL,3,0.02h,Break Even,$-1.50,$-48.00,$58833.50,139,$-48.00
2024-07-12,07:05:00,20429.0,BUY,3,0.02h,Break Even,$-1.50,$-49.50,$58832.00,139,$-49.50
2024-07-12,07:07:00,20421.25,SELL,3,0.02h,Stop Loss,$22.50,$-27.00,$58854.50,139,$-27.00
2024-07-12,07:50:00,20401.5,BUY,3,0.02h,Break Even,$-1.50,$-28.50,$58853.00,139,$-28.50
2024-07-12,08:55:00,20428.75,SELL,3,0.02h,Stop Loss,$-9.00,$-37.50,$58844.00,139,$-37.50
2024-07-12,08:56:00,20430.75,BUY,3,0.08h,Stop Loss,$22.50,$-15.00,$58866.50,139,$-15.00
2024-07-12,09:24:00,20429.5,SELL,3,0.02h,Break Even,$-1.50,$-16.50,$58865.00,139,$-16.50
2024-07-12,09:43:00,20436.75,BUY,3,0.02h,Break Even,$-1.50,$-18.00,$58863.50,139,$-18.00
2024-07-12,10:22:00,20436.75,SELL,3,0.02h,Stop Loss,$10.50,$-7.50,$58874.00,139,$-7.50
2024-07-12,10:59:00,20429.0,BUY,3,0.02h,Stop Loss,$-9.00,$-16.50,$58865.00,139,$-16.50
2024-07-12,11:05:00,20418.25,SELL,3,0.02h,Break Even,$-1.50,$-18.00,$58863.50,139,$-18.00
2024-07-12,11:19:00,20427.25,BUY,3,0.02h,Break Even,$-1.50,$-19.50,$58862.00,139,$-19.50
2024-07-12,11:52:00,20429.5,SELL,3,0.02h,Stop Loss,$-9.00,$-28.50,$58853.00,139,$-28.50
2024-07-12,11:56:00,20439.75,BUY,3,0.02h,Break Even,$-1.50,$-30.00,$58851.50,139,$-30.00
2024-07-12,12:04:00,20430.75,SELL,3,0.02h,Break Even,$-1.50,$-31.50,$58850.00,139,$-31.50
2024-07-12,12:35:00,20429.0,BUY,3,0.02h,Stop Loss,$-9.00,$-40.50,$58841.00,139,$-40.50
2024-07-12,13:19:00,20436.0,SELL,3,0.02h,Break Even,$-1.50,$-42.00,$58839.50,139,$-42.00
2024-07-12,13:31:00,20459.25,BUY,3,0.02h,Stop Loss,$49.50,$7.50,$58889.00,139,$7.50
2024-07-12,14:24:00,20536.75,SELL,3,0.02h,Break Even,$-1.50,$6.00,$58887.50,139,$6.00
2024-07-12,14:26:00,20558.75,BUY,3,0.02h,Break Even,$-1.50,$4.50,$58886.00,139,$4.50
2024-07-12,15:20:00,20634.75,SELL,3,0.02h,Stop Loss,$3.00,$7.50,$58889.00,139,$7.50
2024-07-12,15:30:00,20655.5,BUY,3,0.02h,Break Even,$-1.50,$6.00,$58887.50,139,$6.00
2024-07-12,15:35:00,20638.0,SELL,3,0.02h,Break Even,$-1.50,$4.50,$58886.00,139,$4.50
2024-07-12,15:40:00,20654.0,BUY,3,0.02h,Stop Loss,$21.00,$25.50,$58907.00,139,$25.50
2024-07-12,15:54:00,20647.75,SELL,3,0.02h,Stop Loss,$-9.00,$16.50,$58898.00,139,$16.50
2024-07-12,16:37:00,20606.5,BUY,3,0.02h,Break Even,$-1.50,$15.00,$58896.50,139,$15.00
2024-07-12,16:50:00,20589.75,SELL,3,0.02h,Stop Loss,$-9.00,$6.00,$58887.50,139,$6.00
2024-07-12,16:51:00,20597.0,BUY,3,0.02h,Stop Loss,$19.50,$25.50,$58907.00,139,$25.50
2024-07-12,18:08:00,20703.5,SELL,3,0.02h,Break Even,$-1.50,$24.00,$58905.50,139,$24.00
2024-07-12,18:41:00,20709.5,BUY,3,0.02h,Stop Loss,$-9.00,$15.00,$58896.50,139,$15.00
2024-07-12,18:53:00,20701.25,SELL,3,0.02h,Break Even,$-1.50,$13.50,$58895.00,139,$13.50
2024-07-12,18:58:00,20708.5,BUY,3,0.02h,Break Even,$-1.50,$12.00,$58893.50,139,$12.00
2024-07-12,19:05:00,20698.25,SELL,3,0.02h,Stop Loss,$-9.00,$3.00,$58884.50,139,$3.00
2024-07-12,20:42:00,20537.5,BUY,3,0.02h,Break Even,$-1.50,$1.50,$58883.00,139,$1.50
,,,,,,,,,,,
2024-07-15,01:30:00,20568.0,SELL,3,0.02h,Stop Loss,$-9.00,$-9.00,$58874.00,140,$-9.00
2024-07-15,01:37:00,20573.25,BUY,3,0.02h,Stop Loss,$-9.00,$-18.00,$58865.00,140,$-18.00
2024-07-15,01:38:00,20570.75,SELL,3,0.02h,Stop Loss,$-9.00,$-27.00,$58856.00,140,$-27.00
2024-07-15,01:40:00,20579.0,BUY,3,0.02h,Break Even,$-1.50,$-28.50,$58854.50,140,$-28.50
2024-07-15,01:50:00,20572.5,SELL,3,0.02h,Break Even,$-1.50,$-30.00,$58853.00,140,$-30.00
2024-07-15,02:05:00,20575.75,BUY,3,0.02h,Break Even,$-1.50,$-31.50,$58851.50,140,$-31.50
2024-07-15,02:15:00,20569.5,SELL,3,0.02h,Stop Loss,$3.00,$-28.50,$58854.50,140,$-28.50
2024-07-15,02:30:00,20573.75,BUY,3,0.03h,Stop Loss,$-9.00,$-37.50,$58845.50,140,$-37.50
2024-07-15,02:44:00,20568.25,SELL,3,0.02h,Stop Loss,$-9.00,$-46.50,$58836.50,140,$-46.50
2024-07-15,03:00:00,20572.5,BUY,3,0.02h,Stop Loss,$-9.00,$-55.50,$58827.50,140,$-55.50
2024-07-15,03:19:00,20572.0,SELL,3,0.05h,Stop Loss,$-9.00,$-64.50,$58818.50,140,$-64.50
2024-07-15,03:23:00,20576.25,BUY,3,0.03h,Stop Loss,$-9.00,$-73.50,$58809.50,140,$-73.50
2024-07-15,03:58:00,20574.25,SELL,3,0.03h,Stop Loss,$-9.00,$-82.50,$58800.50,140,$-82.50
2024-07-15,04:08:00,20577.75,BUY,3,0.02h,Break Even,$-1.50,$-84.00,$58799.00,140,$-84.00
2024-07-15,04:12:00,20573.5,SELL,3,0.02h,Stop Loss,$-9.00,$-93.00,$58790.00,140,$-93.00
2024-07-15,04:25:00,20577.0,BUY,3,0.02h,Stop Loss,$-9.00,$-102.00,$58781.00,140,$-102.00
2024-07-15,06:04:00,20598.75,SELL,3,0.02h,Stop Loss,$-9.00,$-111.00,$58772.00,140,$-111.00
2024-07-15,06:13:00,20611.0,BUY,3,0.02h,Stop Loss,$-9.00,$-120.00,$58763.00,140,$-120.00
2024-07-15,07:50:00,20624.75,SELL,3,0.02h,Stop Loss,$-9.00,$-129.00,$58754.00,140,$-129.00
2024-07-15,08:05:00,20625.75,BUY,3,0.02h,Stop Loss,$-9.00,$-138.00,$58745.00,140,$-138.00
2024-07-15,08:30:00,20622.75,SELL,3,0.02h,Stop Loss,$-9.00,$-147.00,$58736.00,140,$-147.00
2024-07-15,08:31:00,20627.75,BUY,3,0.02h,Stop Loss,$-9.00,$-156.00,$58727.00,140,$-156.00
2024-07-15,08:49:00,20623.5,SELL,3,0.02h,Stop Loss,$-9.00,$-165.00,$58718.00,140,$-165.00
2024-07-15,08:53:00,20627.25,BUY,3,0.02h,Stop Loss,$-9.00,$-174.00,$58709.00,140,$-174.00
2024-07-15,08:54:00,20625.5,SELL,3,0.03h,Stop Loss,$-9.00,$-183.00,$58700.00,140,$-183.00
2024-07-15,08:56:00,20626.5,BUY,3,0.03h,Stop Loss,$-9.00,$-192.00,$58691.00,140,$-192.00
2024-07-15,09:03:00,20625.5,SELL,3,0.02h,Break Even,$-1.50,$-193.50,$58689.50,140,$-193.50
2024-07-15,09:14:00,20627.0,BUY,3,0.02h,Stop Loss,$-9.00,$-202.50,$58680.50,140,$-202.50
2024-07-15,09:16:00,20624.0,SELL,3,0.02h,Stop Loss,$-9.00,$-211.50,$58671.50,140,$-211.50
2024-07-15,09:18:00,20626.75,BUY,3,0.02h,Break Even,$-1.50,$-213.00,$58670.00,140,$-213.00
2024-07-15,09:21:00,20624.5,SELL,3,0.02h,Stop Loss,$-9.00,$-222.00,$58661.00,140,$-222.00
2024-07-15,09:23:00,20626.25,BUY,3,0.02h,Break Even,$-1.50,$-223.50,$58659.50,140,$-223.50
2024-07-15,09:33:00,20625.75,SELL,3,0.02h,Break Even,$-1.50,$-225.00,$58658.00,140,$-225.00
2024-07-15,09:43:00,20628.25,BUY,3,0.02h,Break Even,$-1.50,$-226.50,$58656.50,140,$-226.50
2024-07-15,09:55:00,20626.5,SELL,3,0.05h,Break Even,$-1.50,$-228.00,$58655.00,140,$-228.00
2024-07-15,10:07:00,20629.5,BUY,3,0.02h,Stop Loss,$13.50,$-214.50,$58668.50,140,$-214.50
2024-07-15,10:20:00,20622.75,SELL,3,0.02h,Break Even,$-1.50,$-216.00,$58667.00,140,$-216.00
2024-07-15,10:24:00,20628.75,BUY,3,0.02h,Stop Loss,$-9.00,$-225.00,$58658.00,140,$-225.00
2024-07-15,10:31:00,20625.0,SELL,3,0.02h,Break Even,$-1.50,$-226.50,$58656.50,140,$-226.50
2024-07-15,10:52:00,20625.0,BUY,3,0.02h,Stop Loss,$-9.00,$-235.50,$58647.50,140,$-235.50
2024-07-15,10:57:00,20623.75,SELL,3,0.03h,Stop Loss,$-9.00,$-244.50,$58638.50,140,$-244.50
2024-07-15,11:00:00,20627.75,BUY,3,0.02h,Break Even,$-1.50,$-246.00,$58637.00,140,$-246.00
2024-07-15,11:40:00,20632.0,SELL,3,0.02h,Stop Loss,$21.00,$-225.00,$58658.00,140,$-225.00
2024-07-15,12:14:00,20632.0,BUY,3,0.02h,Break Even,$-1.50,$-226.50,$58656.50,140,$-226.50
2024-07-15,12:37:00,20620.0,SELL,3,0.02h,Stop Loss,$9.00,$-217.50,$58665.50,140,$-217.50
2024-07-15,13:06:00,20612.5,BUY,3,0.02h,Break Even,$-1.50,$-219.00,$58664.00,140,$-219.00
2024-07-15,13:13:00,20602.0,SELL,3,0.02h,Break Even,$-1.50,$-220.50,$58662.50,140,$-220.50
2024-07-15,13:21:00,20612.75,BUY,3,0.02h,Break Even,$-1.50,$-222.00,$58661.00,140,$-222.00
2024-07-15,13:46:00,20599.25,SELL,3,0.02h,Stop Loss,$57.00,$-165.00,$58718.00,140,$-165.00
2024-07-15,13:55:00,20635.25,BUY,3,0.02h,Break Even,$-1.50,$-166.50,$58716.50,140,$-166.50
2024-07-15,15:30:00,20734.5,SELL,3,0.02h,Stop Loss,$57.00,$-109.50,$58773.50,140,$-109.50
2024-07-15,16:30:00,20663.75,BUY,3,0.02h,Stop Loss,$-9.00,$-118.50,$58764.50,140,$-118.50
2024-07-15,16:46:00,20645.75,SELL,3,0.02h,Stop Loss,$36.00,$-82.50,$58800.50,140,$-82.50
2024-07-15,16:59:00,20654.0,BUY,3,0.02h,Break Even,$-1.50,$-84.00,$58799.00,140,$-84.00
2024-07-15,17:01:00,20617.25,SELL,3,0.02h,Stop Loss,$129.00,$45.00,$58928.00,140,$45.00
2024-07-15,17:25:00,20647.5,BUY,3,0.02h,Break Even,$-1.50,$43.50,$58926.50,140,$43.50
2024-07-15,17:28:00,20616.5,SELL,3,0.02h,Stop Loss,$72.00,$115.50,$58998.50,140,$115.50
2024-07-15,18:24:00,20589.25,BUY,3,0.02h,Stop Loss,$40.50,$156.00,$59039.00,140,$156.00
2024-07-15,18:46:00,20588.5,SELL,3,0.02h,Stop Loss,$-9.00,$147.00,$59030.00,140,$147.00
2024-07-15,18:48:00,20606.25,BUY,3,0.02h,Stop Loss,$28.50,$175.50,$59058.50,140,$175.50
2024-07-15,19:37:00,20611.5,SELL,3,0.02h,Stop Loss,$12.00,$187.50,$59070.50,140,$187.50
2024-07-15,20:01:00,20599.25,BUY,3,0.02h,Break Even,$-1.50,$186.00,$59069.00,140,$186.00
2024-07-15,23:51:00,20636.0,SELL,3,0.02h,Break Even,$-1.50,$184.50,$59067.50,140,$184.50
,,,,,,,,,,,
2024-07-16,00:15:00,20634.5,BUY,3,0.02h,Stop Loss,$-9.00,$-9.00,$59058.50,141,$-9.00
2024-07-16,00:31:00,20631.25,SELL,3,0.02h,Stop Loss,$-9.00,$-18.00,$59049.50,141,$-18.00
2024-07-16,00:59:00,20627.0,BUY,3,0.02h,Break Even,$-1.50,$-19.50,$59048.00,141,$-19.50
2024-07-16,01:17:00,20622.0,SELL,3,0.02h,Stop Loss,$-9.00,$-28.50,$59039.00,141,$-28.50
2024-07-16,01:32:00,20633.75,BUY,3,0.02h,Stop Loss,$-9.00,$-37.50,$59030.00,141,$-37.50
2024-07-16,01:47:00,20629.75,SELL,3,0.02h,Stop Loss,$-9.00,$-46.50,$59021.00,141,$-46.50
2024-07-16,01:48:00,20631.25,BUY,3,0.03h,Stop Loss,$-9.00,$-55.50,$59012.00,141,$-55.50
2024-07-16,01:51:00,20630.0,SELL,3,0.02h,Stop Loss,$-9.00,$-64.50,$59003.00,141,$-64.50
2024-07-16,01:53:00,20632.25,BUY,3,0.02h,Stop Loss,$-9.00,$-73.50,$58994.00,141,$-73.50
2024-07-16,01:54:00,20630.0,SELL,3,0.02h,Stop Loss,$-9.00,$-82.50,$58985.00,141,$-82.50
2024-07-16,02:00:00,20633.25,BUY,3,0.02h,Stop Loss,$6.00,$-76.50,$58991.00,141,$-76.50
2024-07-16,03:04:00,20646.5,SELL,3,0.02h,Stop Loss,$-9.00,$-85.50,$58982.00,141,$-85.50
2024-07-16,03:22:00,20649.0,BUY,3,0.02h,Break Even,$-1.50,$-87.00,$58980.50,141,$-87.00
2024-07-16,03:35:00,20646.5,SELL,3,0.02h,Stop Loss,$-9.00,$-96.00,$58971.50,141,$-96.00
2024-07-16,03:36:00,20648.25,BUY,3,0.10h,Stop Loss,$4.50,$-91.50,$58976.00,141,$-91.50
2024-07-16,03:49:00,20645.75,SELL,3,0.02h,Stop Loss,$-9.00,$-100.50,$58967.00,141,$-100.50
2024-07-16,03:51:00,20651.5,BUY,3,0.03h,Stop Loss,$-9.00,$-109.50,$58958.00,141,$-109.50
2024-07-16,04:02:00,20646.25,SELL,3,0.02h,Break Even,$-1.50,$-111.00,$58956.50,141,$-111.00
2024-07-16,04:12:00,20651.5,BUY,3,0.02h,Stop Loss,$-9.00,$-120.00,$58947.50,141,$-120.00
2024-07-16,04:23:00,20646.5,SELL,3,0.03h,Stop Loss,$-9.00,$-129.00,$58938.50,141,$-129.00
2024-07-16,05:28:00,20642.0,BUY,3,0.05h,Stop Loss,$21.00,$-108.00,$58959.50,141,$-108.00
2024-07-16,05:52:00,20638.5,SELL,3,0.02h,Stop Loss,$-9.00,$-117.00,$58950.50,141,$-117.00
2024-07-16,06:36:00,20631.5,BUY,3,0.02h,Stop Loss,$-9.00,$-126.00,$58941.50,141,$-126.00
2024-07-16,06:42:00,20623.25,SELL,3,0.02h,Break Even,$-1.50,$-127.50,$58940.00,141,$-127.50
2024-07-16,07:29:00,20594.25,BUY,3,0.02h,Stop Loss,$-9.00,$-136.50,$58931.00,141,$-136.50
2024-07-16,07:53:00,20589.5,SELL,3,0.02h,Stop Loss,$-9.00,$-145.50,$58922.00,141,$-145.50
2024-07-16,08:24:00,20571.75,BUY,3,0.02h,Stop Loss,$39.00,$-106.50,$58961.00,141,$-106.50
2024-07-16,08:49:00,20563.0,SELL,3,0.02h,Stop Loss,$-9.00,$-115.50,$58952.00,141,$-115.50
2024-07-16,08:51:00,20575.0,BUY,3,0.02h,Stop Loss,$10.50,$-105.00,$58962.50,141,$-105.00
2024-07-16,09:31:00,20585.25,SELL,3,0.02h,Stop Loss,$-9.00,$-114.00,$58953.50,141,$-114.00
2024-07-16,09:50:00,20595.75,BUY,3,0.02h,Stop Loss,$-9.00,$-123.00,$58944.50,141,$-123.00
2024-07-16,10:58:00,20618.25,SELL,3,0.02h,Stop Loss,$3.00,$-120.00,$58947.50,141,$-120.00
2024-07-16,11:03:00,20633.75,BUY,3,0.02h,Break Even,$-1.50,$-121.50,$58946.00,141,$-121.50
2024-07-16,11:24:00,20624.5,SELL,3,0.02h,Stop Loss,$24.00,$-97.50,$58970.00,141,$-97.50
2024-07-16,11:36:00,20635.25,BUY,3,0.02h,Stop Loss,$-9.00,$-106.50,$58961.00,141,$-106.50
2024-07-16,11:39:00,20621.5,SELL,3,0.02h,Stop Loss,$-9.00,$-115.50,$58952.00,141,$-115.50
2024-07-16,11:50:00,20631.0,BUY,3,0.02h,Stop Loss,$-9.00,$-124.50,$58943.00,141,$-124.50
2024-07-16,12:18:00,20627.5,SELL,3,0.02h,Break Even,$-1.50,$-126.00,$58941.50,141,$-126.00
2024-07-16,12:22:00,20631.5,BUY,3,0.02h,Break Even,$-1.50,$-127.50,$58940.00,141,$-127.50
2024-07-16,12:51:00,20628.25,SELL,3,0.02h,Stop Loss,$27.00,$-100.50,$58967.00,141,$-100.50
2024-07-16,13:12:00,20636.0,BUY,3,0.02h,Break Even,$-1.50,$-102.00,$58965.50,141,$-102.00
2024-07-16,13:46:00,20630.75,SELL,3,0.02h,Stop Loss,$37.50,$-64.50,$59003.00,141,$-64.50
2024-07-16,14:33:00,20548.75,BUY,3,0.02h,Stop Loss,$-9.00,$-73.50,$58994.00,141,$-73.50
2024-07-16,14:59:00,20543.75,SELL,3,0.02h,Stop Loss,$48.00,$-25.50,$59042.00,141,$-25.50
2024-07-16,15:05:00,20568.5,BUY,3,0.02h,Break Even,$-1.50,$-27.00,$59040.50,141,$-27.00
2024-07-16,15:22:00,20561.5,SELL,3,0.02h,Stop Loss,$-9.00,$-36.00,$59031.50,141,$-36.00
2024-07-16,15:51:00,20554.0,BUY,3,0.02h,Stop Loss,$54.00,$18.00,$59085.50,141,$18.00
2024-07-16,16:08:00,20547.25,SELL,3,0.02h,Stop Loss,$-9.00,$9.00,$59076.50,141,$9.00
2024-07-16,16:49:00,20518.75,BUY,3,0.02h,Stop Loss,$10.50,$19.50,$59087.00,141,$19.50
2024-07-16,17:16:00,20515.0,SELL,3,0.02h,Stop Loss,$67.50,$87.00,$59154.50,141,$87.00
2024-07-16,17:49:00,20523.5,BUY,3,0.02h,Stop Loss,$-9.00,$78.00,$59145.50,141,$78.00
2024-07-16,18:04:00,20508.5,SELL,3,0.02h,Break Even,$-1.50,$76.50,$59144.00,141,$76.50
2024-07-16,18:06:00,20522.75,BUY,3,0.02h,Break Even,$-1.50,$75.00,$59142.50,141,$75.00
2024-07-16,18:14:00,20506.5,SELL,3,0.02h,Stop Loss,$-9.00,$66.00,$59133.50,141,$66.00
2024-07-16,18:24:00,20528.5,BUY,3,0.02h,Stop Loss,$85.50,$151.50,$59219.00,141,$151.50
2024-07-16,19:20:00,20566.75,SELL,3,0.02h,Stop Loss,$13.50,$165.00,$59232.50,141,$165.00
2024-07-16,19:34:00,20584.25,BUY,3,0.02h,Stop Loss,$48.00,$213.00,$59280.50,141,$213.00
2024-07-16,19:47:00,20568.5,SELL,3,0.02h,Break Even,$-1.50,$211.50,$59279.00,141,$211.50
2024-07-16,19:52:00,20593.25,BUY,3,0.02h,Stop Loss,$3.00,$214.50,$59282.00,141,$214.50
2024-07-16,20:24:00,20594.25,SELL,3,0.03h,Break Even,$-1.50,$213.00,$59280.50,141,$213.00
2024-07-16,20:29:00,20599.0,BUY,3,0.02h,Stop Loss,$-9.00,$204.00,$59271.50,141,$204.00
2024-07-16,20:47:00,20597.0,SELL,3,0.03h,Stop Loss,$-9.00,$195.00,$59262.50,141,$195.00
2024-07-16,23:55:00,20568.75,BUY,3,0.02h,Stop Loss,$-9.00,$186.00,$59253.50,141,$186.00
2024-07-16,23:58:00,20566.5,SELL,3,0.02h,Break Even,$-1.50,$184.50,$59252.00,141,$184.50
,,,,,,,,,,,
2024-07-17,00:29:00,20565.75,BUY,3,0.02h,Stop Loss,$-9.00,$-9.00,$59243.00,142,$-9.00
2024-07-17,00:54:00,20566.5,SELL,3,0.02h,Stop Loss,$-9.00,$-18.00,$59234.00,142,$-18.00
2024-07-17,01:27:00,20562.25,BUY,3,0.02h,Stop Loss,$-9.00,$-27.00,$59225.00,142,$-27.00
2024-07-17,01:34:00,20558.0,SELL,3,0.02h,Break Even,$-1.50,$-28.50,$59223.50,142,$-28.50
2024-07-17,01:53:00,20559.0,BUY,3,0.02h,Stop Loss,$-9.00,$-37.50,$59214.50,142,$-37.50
2024-07-17,01:55:00,20554.0,SELL,3,0.02h,Stop Loss,$-9.00,$-46.50,$59205.50,142,$-46.50
2024-07-17,02:18:00,20556.0,BUY,3,0.02h,Stop Loss,$-9.00,$-55.50,$59196.50,142,$-55.50
2024-07-17,02:26:00,20549.75,SELL,3,0.02h,Stop Loss,$-9.00,$-64.50,$59187.50,142,$-64.50
2024-07-17,02:33:00,20554.5,BUY,3,0.02h,Break Even,$-1.50,$-66.00,$59186.00,142,$-66.00
2024-07-17,02:58:00,20554.0,SELL,3,0.02h,Break Even,$-1.50,$-67.50,$59184.50,142,$-67.50
2024-07-17,03:30:00,20552.0,BUY,3,0.02h,Break Even,$-1.50,$-69.00,$59183.00,142,$-69.00
2024-07-17,03:41:00,20547.25,SELL,3,0.02h,Break Even,$-1.50,$-70.50,$59181.50,142,$-70.50
2024-07-17,05:01:00,20529.75,BUY,3,0.02h,Stop Loss,$3.00,$-67.50,$59184.50,142,$-67.50
2024-07-17,05:07:00,20511.5,SELL,3,0.02h,Stop Loss,$-9.00,$-76.50,$59175.50,142,$-76.50
2024-07-17,05:37:00,20521.5,BUY,3,0.02h,Stop Loss,$-9.00,$-85.50,$59166.50,142,$-85.50
2024-07-17,05:56:00,20510.75,SELL,3,0.02h,Stop Loss,$-9.00,$-94.50,$59157.50,142,$-94.50
2024-07-17,06:51:00,20455.5,BUY,3,0.02h,Stop Loss,$-9.00,$-103.50,$59148.50,142,$-103.50
2024-07-17,07:03:00,20439.25,SELL,3,0.02h,Stop Loss,$61.50,$-42.00,$59210.00,142,$-42.00
2024-07-17,08:50:00,20336.75,BUY,3,0.02h,Stop Loss,$16.50,$-25.50,$59226.50,142,$-25.50
2024-07-17,09:29:00,20339.25,SELL,3,0.02h,Break Even,$-1.50,$-27.00,$59225.00,142,$-27.00
2024-07-17,09:40:00,20342.25,BUY,3,0.02h,Stop Loss,$13.50,$-13.50,$59238.50,142,$-13.50
2024-07-17,10:22:00,20344.0,SELL,3,0.02h,Stop Loss,$36.00,$22.50,$59274.50,142,$22.50
2024-07-17,10:28:00,20355.25,BUY,3,0.02h,Stop Loss,$-9.00,$13.50,$59265.50,142,$13.50
2024-07-17,10:51:00,20345.25,SELL,3,0.02h,Break Even,$-1.50,$12.00,$59264.00,142,$12.00
2024-07-17,11:48:00,20288.25,BUY,3,0.02h,Stop Loss,$-9.00,$3.00,$59255.00,142,$3.00
2024-07-17,12:39:00,20289.0,SELL,3,0.02h,Break Even,$-1.50,$1.50,$59253.50,142,$1.50
2024-07-17,13:09:00,20295.25,BUY,3,0.02h,Break Even,$-1.50,$0.00,$59252.00,142,$0.00
2024-07-17,13:13:00,20284.0,SELL,3,0.02h,Break Even,$-1.50,$-1.50,$59250.50,142,$-1.50
2024-07-17,14:36:00,20169.5,BUY,3,0.02h,Break Even,$-1.50,$-3.00,$59249.00,142,$-3.00
2024-07-17,14:50:00,20125.25,SELL,3,0.02h,Stop Loss,$43.50,$40.50,$59292.50,142,$40.50
2024-07-17,15:20:00,20127.75,BUY,3,0.02h,Stop Loss,$-9.00,$31.50,$59283.50,142,$31.50
2024-07-17,15:21:00,20113.5,SELL,3,0.02h,Break Even,$-1.50,$30.00,$59282.00,142,$30.00
2024-07-17,15:22:00,20138.0,BUY,3,0.02h,Stop Loss,$27.00,$57.00,$59309.00,142,$57.00
2024-07-17,15:27:00,20097.5,SELL,3,0.02h,Break Even,$-1.50,$55.50,$59307.50,142,$55.50
2024-07-17,15:31:00,20130.0,BUY,3,0.02h,Stop Loss,$4.50,$60.00,$59312.00,142,$60.00
2024-07-17,15:37:00,20108.0,SELL,3,0.02h,Stop Loss,$-9.00,$51.00,$59303.00,142,$51.00
2024-07-17,16:55:00,20047.75,BUY,3,0.02h,Stop Loss,$61.50,$112.50,$59364.50,142,$112.50
2024-07-17,17:10:00,20023.0,SELL,3,0.02h,Stop Loss,$-9.00,$103.50,$59355.50,142,$103.50
2024-07-17,17:22:00,20051.0,BUY,3,0.02h,Break Even,$-1.50,$102.00,$59354.00,142,$102.00
2024-07-17,17:29:00,20033.0,SELL,3,0.02h,Stop Loss,$-9.00,$93.00,$59345.00,142,$93.00
2024-07-17,17:30:00,20046.5,BUY,3,0.02h,Stop Loss,$57.00,$150.00,$59402.00,142,$150.00
2024-07-17,17:44:00,20040.5,SELL,3,0.02h,Break Even,$-1.50,$148.50,$59400.50,142,$148.50
2024-07-17,18:11:00,20048.0,BUY,3,0.02h,Stop Loss,$18.00,$166.50,$59418.50,142,$166.50
2024-07-17,18:40:00,20041.25,SELL,3,0.02h,Stop Loss,$-9.00,$157.50,$59409.50,142,$157.50
2024-07-17,19:13:00,20039.5,BUY,3,0.02h,Break Even,$-1.50,$156.00,$59408.00,142,$156.00
2024-07-17,19:18:00,20013.0,SELL,3,0.02h,Break Even,$-1.50,$154.50,$59406.50,142,$154.50
2024-07-17,19:22:00,20032.25,BUY,3,0.02h,Stop Loss,$87.00,$241.50,$59493.50,142,$241.50
2024-07-17,19:40:00,20027.25,SELL,3,0.02h,Stop Loss,$-9.00,$232.50,$59484.50,142,$232.50
2024-07-17,19:50:00,20055.0,BUY,3,0.02h,Stop Loss,$75.00,$307.50,$59559.50,142,$307.50
2024-07-17,19:57:00,20014.25,SELL,3,0.02h,Stop Loss,$39.00,$346.50,$59598.50,142,$346.50
2024-07-17,20:24:00,20009.25,BUY,3,0.02h,Stop Loss,$37.50,$384.00,$59636.00,142,$384.00
2024-07-17,20:47:00,20009.75,SELL,3,0.02h,Stop Loss,$-9.00,$375.00,$59627.00,142,$375.00
2024-07-17,21:26:00,20017.0,BUY,3,1.57h,Stop Loss,$247.50,$622.50,$59874.50,142,$622.50
2024-07-17,23:50:00,20059.5,SELL,3,0.02h,Stop Loss,$18.00,$640.50,$59892.50,142,$640.50
,,,,,,,,,,,
2024-07-18,00:01:00,20062.75,BUY,3,0.02h,Stop Loss,$-9.00,$-9.00,$59883.50,143,$-9.00
2024-07-18,00:17:00,20055.0,SELL,3,0.02h,Stop Loss,$-9.00,$-18.00,$59874.50,143,$-18.00
2024-07-18,00:29:00,20064.25,BUY,3,0.02h,Break Even,$-1.50,$-19.50,$59873.00,143,$-19.50
2024-07-18,00:58:00,20064.5,SELL,3,0.02h,Stop Loss,$-9.00,$-28.50,$59864.00,143,$-28.50
2024-07-18,01:10:00,20076.5,BUY,3,0.02h,Stop Loss,$-9.00,$-37.50,$59855.00,143,$-37.50
2024-07-18,01:15:00,20057.25,SELL,3,0.02h,Stop Loss,$-9.00,$-46.50,$59846.00,143,$-46.50
2024-07-18,01:22:00,20066.0,BUY,3,0.02h,Stop Loss,$-9.00,$-55.50,$59837.00,143,$-55.50
2024-07-18,01:23:00,20063.75,SELL,3,0.02h,Stop Loss,$-9.00,$-64.50,$59828.00,143,$-64.50
2024-07-18,01:25:00,20065.75,BUY,3,0.02h,Break Even,$-1.50,$-66.00,$59826.50,143,$-66.00
2024-07-18,01:43:00,20065.5,SELL,3,0.03h,Break Even,$-1.50,$-67.50,$59825.00,143,$-67.50
2024-07-18,01:47:00,20068.0,BUY,3,0.02h,Stop Loss,$-9.00,$-76.50,$59816.00,143,$-76.50
2024-07-18,02:14:00,20066.25,SELL,3,0.02h,Break Even,$-1.50,$-78.00,$59814.50,143,$-78.00
2024-07-18,02:48:00,20066.75,BUY,3,0.02h,Stop Loss,$-9.00,$-87.00,$59805.50,143,$-87.00
2024-07-18,03:02:00,20061.25,SELL,3,0.02h,Stop Loss,$-9.00,$-96.00,$59796.50,143,$-96.00
2024-07-18,03:48:00,20050.25,BUY,3,0.02h,Break Even,$-1.50,$-97.50,$59795.00,143,$-97.50
2024-07-18,04:18:00,20041.0,SELL,3,0.02h,Stop Loss,$-9.00,$-106.50,$59786.00,143,$-106.50
2024-07-18,04:55:00,20045.0,BUY,3,0.02h,Break Even,$-1.50,$-108.00,$59784.50,143,$-108.00
2024-07-18,06:07:00,20064.25,SELL,3,0.02h,Stop Loss,$-9.00,$-117.00,$59775.50,143,$-117.00
2024-07-18,06:10:00,20079.25,BUY,3,0.02h,Stop Loss,$-9.00,$-126.00,$59766.50,143,$-126.00
2024-07-18,07:03:00,20134.0,SELL,3,0.02h,Break Even,$-1.50,$-127.50,$59765.00,143,$-127.50
2024-07-18,07:52:00,20089.75,BUY,3,0.02h,Break Even,$-1.50,$-129.00,$59763.50,143,$-129.00
2024-07-18,08:07:00,20069.5,SELL,3,0.02h,Stop Loss,$-9.00,$-138.00,$59754.50,143,$-138.00
2024-07-18,08:23:00,20094.0,BUY,3,0.02h,Stop Loss,$-9.00,$-147.00,$59745.50,143,$-147.00
2024-07-18,08:28:00,20077.25,SELL,3,0.02h,Stop Loss,$-9.00,$-156.00,$59736.50,143,$-156.00
2024-07-18,08:33:00,20096.25,BUY,3,0.02h,Stop Loss,$42.00,$-114.00,$59778.50,143,$-114.00
2024-07-18,09:06:00,20107.25,SELL,3,0.02h,Stop Loss,$6.00,$-108.00,$59784.50,143,$-108.00
2024-07-18,09:09:00,20117.0,BUY,3,0.02h,Stop Loss,$-9.00,$-117.00,$59775.50,143,$-117.00
2024-07-18,09:26:00,20110.75,SELL,3,0.02h,Stop Loss,$18.00,$-99.00,$59793.50,143,$-99.00
2024-07-18,10:24:00,20052.75,BUY,3,0.02h,Stop Loss,$7.50,$-91.50,$59801.00,143,$-91.50
2024-07-18,10:30:00,20039.75,SELL,3,0.02h,Break Even,$-1.50,$-93.00,$59799.50,143,$-93.00
2024-07-18,10:33:00,20048.0,BUY,3,0.02h,Stop Loss,$18.00,$-75.00,$59817.50,143,$-75.00
2024-07-18,11:13:00,20060.75,SELL,3,0.02h,Stop Loss,$-9.00,$-84.00,$59808.50,143,$-84.00
2024-07-18,11:16:00,20079.0,BUY,3,0.02h,Stop Loss,$-9.00,$-93.00,$59799.50,143,$-93.00
2024-07-18,11:19:00,20062.75,SELL,3,0.02h,Stop Loss,$3.00,$-90.00,$59802.50,143,$-90.00
2024-07-18,11:36:00,20072.25,BUY,3,0.02h,Stop Loss,$18.00,$-72.00,$59820.50,143,$-72.00
2024-07-18,12:06:00,20076.5,SELL,3,0.02h,Break Even,$-1.50,$-73.50,$59819.00,143,$-73.50
2024-07-18,12:13:00,20089.5,BUY,3,0.02h,Break Even,$-1.50,$-75.00,$59817.50,143,$-75.00
2024-07-18,13:23:00,20136.75,SELL,3,0.02h,Break Even,$-1.50,$-76.50,$59816.00,143,$-76.50
2024-07-18,14:06:00,20092.25,BUY,3,0.02h,Stop Loss,$58.50,$-18.00,$59874.50,143,$-18.00
2024-07-18,14:21:00,20056.75,SELL,3,0.02h,Stop Loss,$25.50,$7.50,$59900.00,143,$7.50
2024-07-18,14:54:00,20011.5,BUY,3,0.02h,Stop Loss,$30.00,$37.50,$59930.00,143,$37.50
2024-07-18,15:07:00,19948.75,SELL,3,0.02h,Stop Loss,$57.00,$94.50,$59987.00,143,$94.50
2024-07-18,16:10:00,19837.75,BUY,3,0.02h,Stop Loss,$-9.00,$85.50,$59978.00,143,$85.50
2024-07-18,16:20:00,19810.25,SELL,3,0.02h,Break Even,$-1.50,$84.00,$59976.50,143,$84.00
2024-07-18,16:21:00,19815.25,BUY,3,0.02h,Stop Loss,$105.00,$189.00,$60081.50,143,$189.00
2024-07-18,17:09:00,19874.25,SELL,3,0.02h,Stop Loss,$49.50,$238.50,$60131.00,143,$238.50
2024-07-18,17:13:00,19914.0,BUY,3,0.02h,Stop Loss,$-9.00,$229.50,$60122.00,143,$229.50
2024-07-18,17:38:00,19906.0,SELL,3,0.02h,Stop Loss,$73.50,$303.00,$60195.50,143,$303.00
2024-07-18,17:48:00,19916.0,BUY,3,0.02h,Stop Loss,$28.50,$331.50,$60224.00,143,$331.50
2024-07-18,17:52:00,19883.75,SELL,3,0.02h,Stop Loss,$34.50,$366.00,$60258.50,143,$366.00
2024-07-18,18:25:00,19886.0,BUY,3,0.02h,Stop Loss,$-9.00,$357.00,$60249.50,143,$357.00
2024-07-18,18:28:00,19856.75,SELL,3,0.02h,Stop Loss,$22.50,$379.50,$60272.00,143,$379.50
2024-07-18,18:57:00,19845.25,BUY,3,0.02h,Stop Loss,$6.00,$385.50,$60278.00,143,$385.50
2024-07-18,19:08:00,19830.0,SELL,3,0.02h,Stop Loss,$66.00,$451.50,$60344.00,143,$451.50
2024-07-18,19:30:00,19823.75,BUY,3,0.02h,Stop Loss,$39.00,$490.50,$60383.00,143,$490.50
2024-07-18,23:44:00,19954.0,SELL,3,0.02h,Break Even,$-1.50,$489.00,$60381.50,143,$489.00
,,,,,,,,,,,
2024-07-19,00:13:00,19948.75,BUY,3,0.02h,Stop Loss,$9.00,$9.00,$60390.50,144,$9.00
2024-07-19,00:42:00,19948.75,SELL,3,0.02h,Break Even,$-1.50,$7.50,$60389.00,144,$7.50
2024-07-19,01:06:00,19952.0,BUY,3,0.02h,Break Even,$-1.50,$6.00,$60387.50,144,$6.00
2024-07-19,01:09:00,19948.25,SELL,3,0.02h,Stop Loss,$-9.00,$-3.00,$60378.50,144,$-3.00
2024-07-19,01:11:00,19952.25,BUY,3,0.02h,Stop Loss,$-9.00,$-12.00,$60369.50,144,$-12.00
2024-07-19,01:15:00,19946.75,SELL,3,0.02h,Break Even,$-1.50,$-13.50,$60368.00,144,$-13.50
2024-07-19,01:24:00,19954.25,BUY,3,0.02h,Break Even,$-1.50,$-15.00,$60366.50,144,$-15.00
2024-07-19,01:49:00,19949.75,SELL,3,0.02h,Stop Loss,$10.50,$-4.50,$60377.00,144,$-4.50
2024-07-19,02:12:00,19951.5,BUY,3,0.02h,Break Even,$-1.50,$-6.00,$60375.50,144,$-6.00
2024-07-19,02:28:00,19949.0,SELL,3,0.03h,Stop Loss,$-9.00,$-15.00,$60366.50,144,$-15.00
2024-07-19,02:35:00,19951.25,BUY,3,0.03h,Break Even,$-1.50,$-16.50,$60365.00,144,$-16.50
2024-07-19,03:00:00,19953.0,SELL,3,0.02h,Stop Loss,$-9.00,$-25.50,$60356.00,144,$-25.50
2024-07-19,03:01:00,19956.0,BUY,3,0.02h,Break Even,$-1.50,$-27.00,$60354.50,144,$-27.00
2024-07-19,03:10:00,19949.5,SELL,3,0.02h,Stop Loss,$-9.00,$-36.00,$60345.50,144,$-36.00
2024-07-19,03:39:00,19952.5,BUY,3,0.02h,Stop Loss,$-9.00,$-45.00,$60336.50,144,$-45.00
2024-07-19,03:44:00,19949.5,SELL,3,0.02h,Stop Loss,$-9.00,$-54.00,$60327.50,144,$-54.00
2024-07-19,03:55:00,19952.5,BUY,3,0.02h,Stop Loss,$-9.00,$-63.00,$60318.50,144,$-63.00
2024-07-19,05:15:00,19956.25,SELL,3,0.02h,Break Even,$-1.50,$-64.50,$60317.00,144,$-64.50
2024-07-19,05:23:00,19958.25,BUY,3,0.02h,Break Even,$-1.50,$-66.00,$60315.50,144,$-66.00
2024-07-19,05:24:00,19956.75,SELL,3,0.02h,Break Even,$-1.50,$-67.50,$60314.00,144,$-67.50
2024-07-19,05:38:00,19955.75,BUY,3,0.02h,Break Even,$-1.50,$-69.00,$60312.50,144,$-69.00
2024-07-19,05:47:00,19953.25,SELL,3,0.03h,Stop Loss,$-9.00,$-78.00,$60303.50,144,$-78.00
2024-07-19,05:50:00,19955.75,BUY,3,0.02h,Stop Loss,$-9.00,$-87.00,$60294.50,144,$-87.00
2024-07-19,06:27:00,19964.0,SELL,3,0.02h,Stop Loss,$-9.00,$-96.00,$60285.50,144,$-96.00
2024-07-19,07:56:00,19832.75,BUY,3,0.02h,Break Even,$-1.50,$-97.50,$60284.00,144,$-97.50
2024-07-19,08:01:00,19789.0,SELL,3,0.02h,Stop Loss,$4.50,$-93.00,$60288.50,144,$-93.00
2024-07-19,08:04:00,19808.0,BUY,3,0.02h,Stop Loss,$66.00,$-27.00,$60354.50,144,$-27.00
2024-07-19,08:23:00,19794.5,SELL,3,0.02h,Stop Loss,$-9.00,$-36.00,$60345.50,144,$-36.00
2024-07-19,08:28:00,19835.0,BUY,3,0.02h,Stop Loss,$12.00,$-24.00,$60357.50,144,$-24.00
2024-07-19,08:56:00,19835.0,SELL,3,0.02h,Break Even,$-1.50,$-25.50,$60356.00,144,$-25.50
2024-07-19,09:04:00,19850.0,BUY,3,0.02h,Stop Loss,$10.50,$-15.00,$60366.50,144,$-15.00
2024-07-19,09:21:00,19841.25,SELL,3,0.02h,Stop Loss,$33.00,$18.00,$60399.50,144,$18.00
2024-07-19,09:35:00,19850.75,BUY,3,0.02h,Stop Loss,$6.00,$24.00,$60405.50,144,$24.00
2024-07-19,09:39:00,19829.0,SELL,3,0.02h,Stop Loss,$40.50,$64.50,$60446.00,144,$64.50
2024-07-19,09:48:00,19850.25,BUY,3,0.02h,Stop Loss,$21.00,$85.50,$60467.00,144,$85.50
2024-07-19,10:40:00,19879.75,SELL,3,0.02h,Break Even,$-1.50,$84.00,$60465.50,144,$84.00
2024-07-19,11:04:00,19893.5,BUY,3,0.02h,Stop Loss,$-9.00,$75.00,$60456.50,144,$75.00
2024-07-19,11:53:00,19921.25,SELL,3,0.02h,Stop Loss,$3.00,$78.00,$60459.50,144,$78.00
2024-07-19,12:04:00,19938.0,BUY,3,0.02h,Stop Loss,$15.00,$93.00,$60474.50,144,$93.00
2024-07-19,12:11:00,19918.75,SELL,3,0.02h,Stop Loss,$37.50,$130.50,$60512.00,144,$130.50
2024-07-19,12:35:00,19925.25,BUY,3,0.02h,Stop Loss,$-9.00,$121.50,$60503.00,144,$121.50
2024-07-19,13:04:00,19919.25,SELL,3,0.02h,Stop Loss,$22.50,$144.00,$60525.50,144,$144.00
2024-07-19,13:40:00,19927.5,BUY,3,0.02h,Stop Loss,$159.00,$303.00,$60684.50,144,$303.00
2024-07-19,13:48:00,19862.75,SELL,3,0.02h,Stop Loss,$3.00,$306.00,$60687.50,144,$306.00
2024-07-19,13:52:00,19922.25,BUY,3,0.02h,Stop Loss,$42.00,$348.00,$60729.50,144,$348.00
2024-07-19,14:13:00,19879.0,SELL,3,0.02h,Stop Loss,$168.00,$516.00,$60897.50,144,$516.00
2024-07-19,14:55:00,19821.5,BUY,3,0.02h,Stop Loss,$49.50,$565.50,$60947.00,144,$565.50
2024-07-19,15:11:00,19800.5,SELL,3,0.02h,Stop Loss,$84.00,$649.50,$61031.00,144,$649.50
2024-07-19,15:52:00,19767.25,BUY,3,0.02h,Stop Loss,$13.50,$663.00,$61044.50,144,$663.00
2024-07-19,16:20:00,19778.0,SELL,3,0.02h,Break Even,$-1.50,$661.50,$61043.00,144,$661.50
2024-07-19,17:00:00,19728.75,BUY,3,0.02h,Break Even,$-1.50,$660.00,$61041.50,144,$660.00
2024-07-19,17:03:00,19695.75,SELL,3,0.02h,Stop Loss,$10.50,$670.50,$61052.00,144,$670.50
2024-07-19,17:34:00,19690.5,BUY,3,0.02h,Stop Loss,$27.00,$697.50,$61079.00,144,$697.50
2024-07-19,17:44:00,19667.75,SELL,3,0.02h,Break Even,$-1.50,$696.00,$61077.50,144,$696.00
2024-07-19,17:47:00,19700.25,BUY,3,0.02h,Stop Loss,$36.00,$732.00,$61113.50,144,$732.00
2024-07-19,18:23:00,19708.75,SELL,3,0.02h,Stop Loss,$22.50,$754.50,$61136.00,144,$754.50
2024-07-19,18:52:00,19711.75,BUY,3,0.02h,Break Even,$-1.50,$753.00,$61134.50,144,$753.00
2024-07-19,19:33:00,19743.75,SELL,3,0.02h,Stop Loss,$24.00,$777.00,$61158.50,144,$777.00
2024-07-19,20:44:00,19703.5,BUY,3,0.02h,Stop Loss,$-9.00,$768.00,$61149.50,144,$768.00
2024-07-19,20:56:00,19700.5,SELL,3,0.02h,Break Even,$-1.50,$766.50,$61148.00,144,$766.50
,,,,,,,,,,,
2024-07-22,00:00:00,19816.75,BUY,3,0.02h,Stop Loss,$21.00,$21.00,$61169.00,145,$21.00
2024-07-22,00:25:00,19782.0,SELL,3,0.02h,Break Even,$-1.50,$19.50,$61167.50,145,$19.50
2024-07-22,00:29:00,19798.5,BUY,3,0.02h,Stop Loss,$6.00,$25.50,$61173.50,145,$25.50
2024-07-22,00:34:00,19789.0,SELL,3,0.02h,Break Even,$-1.50,$24.00,$61172.00,145,$24.00
2024-07-22,00:48:00,19794.75,BUY,3,0.02h,Break Even,$-1.50,$22.50,$61170.50,145,$22.50
2024-07-22,01:10:00,19780.5,SELL,3,0.02h,Break Even,$-1.50,$21.00,$61169.00,145,$21.00
2024-07-22,01:42:00,19783.0,BUY,3,0.02h,Break Even,$-1.50,$19.50,$61167.50,145,$19.50
2024-07-22,01:49:00,19769.5,SELL,3,0.02h,Stop Loss,$21.00,$40.50,$61188.50,145,$40.50
2024-07-22,02:32:00,19754.75,BUY,3,0.02h,Stop Loss,$-9.00,$31.50,$61179.50,145,$31.50
2024-07-22,02:48:00,19739.25,SELL,3,0.02h,Stop Loss,$-9.00,$22.50,$61170.50,145,$22.50
2024-07-22,02:52:00,19750.25,BUY,3,0.02h,Stop Loss,$4.50,$27.00,$61175.00,145,$27.00
2024-07-22,03:34:00,19776.75,SELL,3,0.02h,Stop Loss,$-9.00,$18.00,$61166.00,145,$18.00
2024-07-22,03:55:00,19774.5,BUY,3,0.02h,Stop Loss,$-9.00,$9.00,$61157.00,145,$9.00
2024-07-22,03:57:00,19769.5,SELL,3,0.02h,Stop Loss,$-9.00,$0.00,$61148.00,145,$0.00
2024-07-22,03:59:00,19777.25,BUY,3,0.02h,Break Even,$-1.50,$-1.50,$61146.50,145,$-1.50
2024-07-22,04:03:00,19770.25,SELL,3,0.02h,Break Even,$-1.50,$-3.00,$61145.00,145,$-3.00
2024-07-22,04:21:00,19764.5,BUY,3,0.02h,Break Even,$-1.50,$-4.50,$61143.50,145,$-4.50
2024-07-22,05:09:00,19787.5,SELL,3,0.02h,Break Even,$-1.50,$-6.00,$61142.00,145,$-6.00
2024-07-22,05:33:00,19794.0,BUY,3,0.02h,Stop Loss,$-9.00,$-15.00,$61133.00,145,$-15.00
2024-07-22,05:54:00,19793.5,SELL,3,0.02h,Stop Loss,$-9.00,$-24.00,$61124.00,145,$-24.00
2024-07-22,06:11:00,19795.25,BUY,3,0.02h,Break Even,$-1.50,$-25.50,$61122.50,145,$-25.50
2024-07-22,06:36:00,19800.75,SELL,3,0.02h,Stop Loss,$-9.00,$-34.50,$61113.50,145,$-34.50
2024-07-22,06:37:00,19808.5,BUY,3,0.02h,Stop Loss,$24.00,$-10.50,$61137.50,145,$-10.50
2024-07-22,06:56:00,19804.75,SELL,3,0.02h,Break Even,$-1.50,$-12.00,$61136.00,145,$-12.00
2024-07-22,07:35:00,19802.25,BUY,3,0.02h,Stop Loss,$24.00,$12.00,$61160.00,145,$12.00
2024-07-22,08:04:00,19815.0,SELL,3,0.02h,Stop Loss,$18.00,$30.00,$61178.00,145,$30.00
2024-07-22,08:12:00,19830.5,BUY,3,0.02h,Stop Loss,$-9.00,$21.00,$61169.00,145,$21.00
2024-07-22,08:19:00,19810.5,SELL,3,0.02h,Break Even,$-1.50,$19.50,$61167.50,145,$19.50
2024-07-22,08:30:00,19825.5,BUY,3,0.02h,Stop Loss,$10.50,$30.00,$61178.00,145,$30.00
2024-07-22,08:53:00,19824.5,SELL,3,0.02h,Break Even,$-1.50,$28.50,$61176.50,145,$28.50
2024-07-22,09:07:00,19832.0,BUY,3,0.02h,Stop Loss,$-9.00,$19.50,$61167.50,145,$19.50
2024-07-22,09:17:00,19824.75,SELL,3,0.02h,Stop Loss,$-9.00,$10.50,$61158.50,145,$10.50
2024-07-22,09:18:00,19827.0,BUY,3,0.02h,Stop Loss,$-9.00,$1.50,$61149.50,145,$1.50
2024-07-22,09:19:00,19821.0,SELL,3,0.02h,Stop Loss,$-9.00,$-7.50,$61140.50,145,$-7.50
2024-07-22,09:25:00,19831.25,BUY,3,0.02h,Break Even,$-1.50,$-9.00,$61139.00,145,$-9.00
2024-07-22,10:14:00,19837.75,SELL,3,0.02h,Stop Loss,$-9.00,$-18.00,$61130.00,145,$-18.00
2024-07-22,10:18:00,19858.75,BUY,3,0.02h,Stop Loss,$16.50,$-1.50,$61146.50,145,$-1.50
2024-07-22,11:09:00,19875.5,SELL,3,0.02h,Stop Loss,$-9.00,$-10.50,$61137.50,145,$-10.50
2024-07-22,11:33:00,19879.75,BUY,3,0.02h,Break Even,$-1.50,$-12.00,$61136.00,145,$-12.00
2024-07-22,12:49:00,19915.25,SELL,3,0.02h,Stop Loss,$-9.00,$-21.00,$61127.00,145,$-21.00
2024-07-22,13:04:00,19924.75,BUY,3,0.02h,Stop Loss,$-9.00,$-30.00,$61118.00,145,$-30.00
2024-07-22,13:32:00,19901.0,SELL,3,0.02h,Stop Loss,$15.00,$-15.00,$61133.00,145,$-15.00
2024-07-22,13:39:00,19974.25,BUY,3,0.02h,Stop Loss,$6.00,$-9.00,$61139.00,145,$-9.00
2024-07-22,14:02:00,19945.5,SELL,3,0.02h,Stop Loss,$46.50,$37.50,$61185.50,145,$37.50
2024-07-22,14:29:00,19962.25,BUY,3,0.02h,Stop Loss,$13.50,$51.00,$61199.00,145,$51.00
2024-07-22,14:55:00,19964.25,SELL,3,0.02h,Break Even,$-1.50,$49.50,$61197.50,145,$49.50
2024-07-22,15:06:00,19987.75,BUY,3,0.02h,Stop Loss,$40.50,$90.00,$61238.00,145,$90.00
2024-07-22,15:10:00,19895.75,SELL,3,0.02h,Stop Loss,$7.50,$97.50,$61245.50,145,$97.50
2024-07-22,15:54:00,19859.5,BUY,3,0.02h,Stop Loss,$49.50,$147.00,$61295.00,145,$147.00
2024-07-22,17:58:00,19989.5,SELL,3,0.02h,Stop Loss,$22.50,$169.50,$61317.50,145,$169.50
2024-07-22,18:01:00,19998.75,BUY,3,0.02h,Stop Loss,$9.00,$178.50,$61326.50,145,$178.50
2024-07-22,18:44:00,20017.5,SELL,3,0.02h,Stop Loss,$-9.00,$169.50,$61317.50,145,$169.50
2024-07-22,18:54:00,20032.0,BUY,3,0.02h,Break Even,$-1.50,$168.00,$61316.00,145,$168.00
2024-07-22,18:56:00,20022.0,SELL,3,0.02h,Stop Loss,$49.50,$217.50,$61365.50,145,$217.50
2024-07-22,19:39:00,20014.75,BUY,3,0.02h,Stop Loss,$19.50,$237.00,$61385.00,145,$237.00
2024-07-22,19:55:00,19992.25,SELL,3,0.02h,Break Even,$-1.50,$235.50,$61383.50,145,$235.50
2024-07-22,20:58:00,19976.5,BUY,3,0.02h,Break Even,$-1.50,$234.00,$61382.00,145,$234.00
2024-07-22,23:13:00,19975.25,SELL,3,0.02h,Break Even,$-1.50,$232.50,$61380.50,145,$232.50
,,,,,,,,,,,
2024-07-23,00:11:00,19962.5,BUY,3,0.02h,Stop Loss,$-9.00,$-9.00,$61371.50,146,$-9.00
2024-07-23,00:15:00,19956.5,SELL,3,0.02h,Break Even,$-1.50,$-10.50,$61370.00,146,$-10.50
2024-07-23,00:17:00,19961.5,BUY,3,0.02h,Stop Loss,$-9.00,$-19.50,$61361.00,146,$-19.50
2024-07-23,00:25:00,19957.75,SELL,3,0.02h,Stop Loss,$3.00,$-16.50,$61364.00,146,$-16.50
2024-07-23,01:06:00,19944.25,BUY,3,0.02h,Break Even,$-1.50,$-18.00,$61362.50,146,$-18.00
2024-07-23,01:39:00,19952.25,SELL,3,0.02h,Stop Loss,$-9.00,$-27.00,$61353.50,146,$-27.00
2024-07-23,02:01:00,19953.5,BUY,3,0.02h,Break Even,$-1.50,$-28.50,$61352.00,146,$-28.50
2024-07-23,02:13:00,19945.25,SELL,3,0.02h,Break Even,$-1.50,$-30.00,$61350.50,146,$-30.00
2024-07-23,02:30:00,19947.5,BUY,3,0.03h,Break Even,$-1.50,$-31.50,$61349.00,146,$-31.50
2024-07-23,03:02:00,19945.0,SELL,3,0.02h,Stop Loss,$6.00,$-25.50,$61355.00,146,$-25.50
2024-07-23,03:50:00,19930.25,BUY,3,0.02h,Stop Loss,$-9.00,$-34.50,$61346.00,146,$-34.50
2024-07-23,04:31:00,19936.75,SELL,3,0.02h,Break Even,$-1.50,$-36.00,$61344.50,146,$-36.00
2024-07-23,04:51:00,19940.75,BUY,3,0.02h,Stop Loss,$-9.00,$-45.00,$61335.50,146,$-45.00
2024-07-23,05:25:00,19943.25,SELL,3,0.03h,Stop Loss,$-9.00,$-54.00,$61326.50,146,$-54.00
2024-07-23,05:28:00,19945.75,BUY,3,0.02h,Stop Loss,$-9.00,$-63.00,$61317.50,146,$-63.00
2024-07-23,05:30:00,19944.75,SELL,3,0.02h,Break Even,$-1.50,$-64.50,$61316.00,146,$-64.50
2024-07-23,05:46:00,19946.5,BUY,3,0.02h,Stop Loss,$-9.00,$-73.50,$61307.00,146,$-73.50
2024-07-23,05:49:00,19933.75,SELL,3,0.02h,Stop Loss,$51.00,$-22.50,$61358.00,146,$-22.50
2024-07-23,06:40:00,19921.0,BUY,3,0.02h,Stop Loss,$-9.00,$-31.50,$61349.00,146,$-31.50
2024-07-23,07:09:00,19929.0,SELL,3,0.02h,Stop Loss,$24.00,$-7.50,$61373.00,146,$-7.50
2024-07-23,07:43:00,19910.75,BUY,3,0.02h,Break Even,$-1.50,$-9.00,$61371.50,146,$-9.00
2024-07-23,07:55:00,19898.5,SELL,3,0.02h,Stop Loss,$39.00,$30.00,$61410.50,146,$30.00
2024-07-23,08:12:00,19902.5,BUY,3,0.02h,Stop Loss,$28.50,$58.50,$61439.00,146,$58.50
2024-07-23,08:24:00,19890.0,SELL,3,0.02h,Stop Loss,$27.00,$85.50,$61466.00,146,$85.50
2024-07-23,08:35:00,19907.25,BUY,3,0.02h,Stop Loss,$7.50,$93.00,$61473.50,146,$93.00
2024-07-23,10:00:00,19958.5,SELL,3,0.02h,Break Even,$-1.50,$91.50,$61472.00,146,$91.50
2024-07-23,10:08:00,19966.25,BUY,3,0.02h,Stop Loss,$15.00,$106.50,$61487.00,146,$106.50
2024-07-23,10:46:00,19972.0,SELL,3,0.02h,Stop Loss,$16.50,$123.00,$61503.50,146,$123.00
2024-07-23,10:57:00,19982.25,BUY,3,0.02h,Stop Loss,$-9.00,$114.00,$61494.50,146,$114.00
2024-07-23,11:00:00,19973.75,SELL,3,0.02h,Stop Loss,$-9.00,$105.00,$61485.50,146,$105.00
2024-07-23,11:01:00,19980.0,BUY,3,0.02h,Stop Loss,$31.50,$136.50,$61517.00,146,$136.50
2024-07-23,11:44:00,19999.25,SELL,3,0.02h,Stop Loss,$48.00,$184.50,$61565.00,146,$184.50
2024-07-23,12:48:00,19955.75,BUY,3,0.02h,Stop Loss,$39.00,$223.50,$61604.00,146,$223.50
2024-07-23,13:14:00,19958.75,SELL,3,0.02h,Stop Loss,$3.00,$226.50,$61607.00,146,$226.50
2024-07-23,13:19:00,19975.0,BUY,3,0.02h,Stop Loss,$-9.00,$217.50,$61598.00,146,$217.50
2024-07-23,13:29:00,19956.25,SELL,3,0.02h,Break Even,$-1.50,$216.00,$61596.50,146,$216.00
2024-07-23,13:38:00,19988.5,BUY,3,0.02h,Stop Loss,$12.00,$228.00,$61608.50,146,$228.00
2024-07-23,14:03:00,19972.25,SELL,3,0.02h,Stop Loss,$51.00,$279.00,$61659.50,146,$279.00
2024-07-23,14:08:00,20014.5,BUY,3,0.02h,Stop Loss,$33.00,$312.00,$61692.50,146,$312.00
2024-07-23,14:33:00,20006.75,SELL,3,0.02h,Stop Loss,$51.00,$363.00,$61743.50,146,$363.00
2024-07-23,15:02:00,19988.75,BUY,3,0.02h,Stop Loss,$-9.00,$354.00,$61734.50,146,$354.00
2024-07-23,15:45:00,20049.5,SELL,3,0.02h,Break Even,$-1.50,$352.50,$61733.00,146,$352.50
2024-07-23,17:23:00,19963.25,BUY,3,0.02h,Stop Loss,$9.00,$361.50,$61742.00,146,$361.50
2024-07-23,17:42:00,19953.25,SELL,3,0.02h,Stop Loss,$16.50,$378.00,$61758.50,146,$378.00
2024-07-23,17:47:00,19964.5,BUY,3,0.02h,Stop Loss,$21.00,$399.00,$61779.50,146,$399.00
2024-07-23,18:26:00,19968.75,SELL,3,0.02h,Stop Loss,$112.50,$511.50,$61892.00,146,$511.50
2024-07-23,18:39:00,19986.25,BUY,3,0.02h,Stop Loss,$4.50,$516.00,$61896.50,146,$516.00
2024-07-23,18:42:00,19967.75,SELL,3,0.02h,Stop Loss,$6.00,$522.00,$61902.50,146,$522.00
2024-07-23,19:00:00,19976.25,BUY,3,0.02h,Break Even,$-1.50,$520.50,$61901.00,146,$520.50
2024-07-23,19:19:00,19973.25,SELL,3,0.02h,Break Even,$-1.50,$519.00,$61899.50,146,$519.00
2024-07-23,19:22:00,19984.5,BUY,3,0.02h,Stop Loss,$34.50,$553.50,$61934.00,146,$553.50
2024-07-23,19:35:00,19974.25,SELL,3,0.02h,Break Even,$-1.50,$552.00,$61932.50,146,$552.00
2024-07-23,20:05:00,19986.75,BUY,3,0.02h,Stop Loss,$33.00,$585.00,$61965.50,146,$585.00
2024-07-23,20:13:00,19932.75,SELL,3,0.02h,Stop Loss,$12.00,$597.00,$61977.50,146,$597.00
2024-07-23,20:24:00,19960.0,BUY,3,0.02h,Stop Loss,$-9.00,$588.00,$61968.50,146,$588.00
2024-07-23,21:00:00,19944.75,SELL,3,2.00h,Stop Loss,$768.00,$1356.00,$62736.50,146,$1356.00
,,,,,,,,,,,
2024-07-24,00:08:00,19814.0,BUY,3,0.02h,Stop Loss,$3.00,$3.00,$62739.50,147,$3.00
2024-07-24,00:59:00,19825.5,SELL,3,0.02h,Stop Loss,$-9.00,$-6.00,$62730.50,147,$-6.00
2024-07-24,01:00:00,19828.0,BUY,3,0.02h,Break Even,$-1.50,$-7.50,$62729.00,147,$-7.50
2024-07-24,01:01:00,19825.5,SELL,3,0.02h,Stop Loss,$-9.00,$-16.50,$62720.00,147,$-16.50
2024-07-24,01:06:00,19830.0,BUY,3,0.02h,Break Even,$-1.50,$-18.00,$62718.50,147,$-18.00
2024-07-24,01:10:00,19826.5,SELL,3,0.02h,Stop Loss,$-9.00,$-27.00,$62709.50,147,$-27.00
2024-07-24,01:21:00,19828.25,BUY,3,0.02h,Break Even,$-1.50,$-28.50,$62708.00,147,$-28.50
2024-07-24,01:39:00,19829.5,SELL,3,0.02h,Stop Loss,$4.50,$-24.00,$62712.50,147,$-24.00
2024-07-24,02:10:00,19821.0,BUY,3,0.02h,Break Even,$-1.50,$-25.50,$62711.00,147,$-25.50
2024-07-24,02:20:00,19815.75,SELL,3,0.02h,Stop Loss,$-9.00,$-34.50,$62702.00,147,$-34.50
2024-07-24,02:27:00,19820.25,BUY,3,0.03h,Stop Loss,$-9.00,$-43.50,$62693.00,147,$-43.50
2024-07-24,02:39:00,19816.5,SELL,3,0.02h,Stop Loss,$-9.00,$-52.50,$62684.00,147,$-52.50
2024-07-24,02:57:00,19820.0,BUY,3,0.02h,Stop Loss,$-9.00,$-61.50,$62675.00,147,$-61.50
2024-07-24,03:08:00,19814.25,SELL,3,0.02h,Stop Loss,$-9.00,$-70.50,$62666.00,147,$-70.50
2024-07-24,05:05:00,19742.0,BUY,3,0.02h,Break Even,$-1.50,$-72.00,$62664.50,147,$-72.00
2024-07-24,05:49:00,19759.5,SELL,3,0.02h,Stop Loss,$12.00,$-60.00,$62676.50,147,$-60.00
2024-07-24,06:10:00,19765.5,BUY,3,0.02h,Break Even,$-1.50,$-61.50,$62675.00,147,$-61.50
2024-07-24,06:14:00,19756.25,SELL,3,0.02h,Stop Loss,$46.50,$-15.00,$62721.50,147,$-15.00
2024-07-24,06:49:00,19743.75,BUY,3,0.02h,Stop Loss,$-9.00,$-24.00,$62712.50,147,$-24.00
2024-07-24,06:51:00,19727.75,SELL,3,0.02h,Break Even,$-1.50,$-25.50,$62711.00,147,$-25.50
2024-07-24,07:12:00,19731.75,BUY,3,0.02h,Stop Loss,$-9.00,$-34.50,$62702.00,147,$-34.50
2024-07-24,07:52:00,19727.5,SELL,3,0.02h,Break Even,$-1.50,$-36.00,$62700.50,147,$-36.00
2024-07-24,08:40:00,19718.0,BUY,3,0.02h,Stop Loss,$6.00,$-30.00,$62706.50,147,$-30.00
2024-07-24,09:14:00,19732.0,SELL,3,0.02h,Stop Loss,$-9.00,$-39.00,$62697.50,147,$-39.00
2024-07-24,09:49:00,19722.75,BUY,3,0.02h,Stop Loss,$-9.00,$-48.00,$62688.50,147,$-48.00
2024-07-24,09:54:00,19715.0,SELL,3,0.02h,Break Even,$-1.50,$-49.50,$62687.00,147,$-49.50
2024-07-24,09:58:00,19723.0,BUY,3,0.02h,Break Even,$-1.50,$-51.00,$62685.50,147,$-51.00
2024-07-24,10:35:00,19727.75,SELL,3,0.02h,Stop Loss,$6.00,$-45.00,$62691.50,147,$-45.00
2024-07-24,11:20:00,19715.25,BUY,3,0.02h,Stop Loss,$-9.00,$-54.00,$62682.50,147,$-54.00
2024-07-24,11:37:00,19707.0,SELL,3,0.02h,Stop Loss,$4.50,$-49.50,$62687.00,147,$-49.50
2024-07-24,13:01:00,19636.25,BUY,3,0.02h,Break Even,$-1.50,$-51.00,$62685.50,147,$-51.00
2024-07-24,13:26:00,19629.25,SELL,3,0.02h,Stop Loss,$-9.00,$-60.00,$62676.50,147,$-60.00
2024-07-24,13:27:00,19641.25,BUY,3,0.02h,Stop Loss,$7.50,$-52.50,$62684.00,147,$-52.50
2024-07-24,13:31:00,19631.75,SELL,3,0.02h,Break Even,$-1.50,$-54.00,$62682.50,147,$-54.00
2024-07-24,13:32:00,19645.5,BUY,3,0.02h,Stop Loss,$18.00,$-36.00,$62700.50,147,$-36.00
2024-07-24,13:33:00,19629.25,SELL,3,0.02h,Stop Loss,$129.00,$93.00,$62829.50,147,$93.00
2024-07-24,15:38:00,19404.5,BUY,3,0.02h,Stop Loss,$4.50,$97.50,$62834.00,147,$97.50
2024-07-24,15:41:00,19391.0,SELL,3,0.02h,Stop Loss,$31.50,$129.00,$62865.50,147,$129.00
2024-07-24,16:23:00,19358.25,BUY,3,0.02h,Stop Loss,$-9.00,$120.00,$62856.50,147,$120.00
2024-07-24,16:24:00,19347.75,SELL,3,0.02h,Break Even,$-1.50,$118.50,$62855.00,147,$118.50
2024-07-24,17:07:00,19343.0,BUY,3,0.02h,Break Even,$-1.50,$117.00,$62853.50,147,$117.00
2024-07-24,17:31:00,19340.25,SELL,3,0.02h,Break Even,$-1.50,$115.50,$62852.00,147,$115.50
2024-07-24,17:36:00,19363.0,BUY,3,0.02h,Stop Loss,$-9.00,$106.50,$62843.00,147,$106.50
2024-07-24,17:49:00,19342.5,SELL,3,0.02h,Stop Loss,$10.50,$117.00,$62853.50,147,$117.00
2024-07-24,19:35:00,19267.75,BUY,3,0.02h,Stop Loss,$-9.00,$108.00,$62844.50,147,$108.00
2024-07-24,19:53:00,19243.5,SELL,3,0.02h,Stop Loss,$109.50,$217.50,$62954.00,147,$217.50
2024-07-24,20:10:00,19248.0,BUY,3,0.02h,Stop Loss,$40.50,$258.00,$62994.50,147,$258.00
2024-07-24,20:55:00,19259.25,SELL,3,0.02h,Break Even,$-1.50,$256.50,$62993.00,147,$256.50
2024-07-24,23:00:00,19278.75,BUY,3,0.02h,Stop Loss,$7.50,$264.00,$63000.50,147,$264.00
2024-07-24,23:33:00,19273.5,SELL,3,0.02h,Break Even,$-1.50,$262.50,$62999.00,147,$262.50
2024-07-24,23:37:00,19281.5,BUY,3,0.02h,Stop Loss,$-9.00,$253.50,$62990.00,147,$253.50
2024-07-24,23:41:00,19272.5,SELL,3,0.02h,Break Even,$-1.50,$252.00,$62988.50,147,$252.00
2024-07-24,23:53:00,19277.75,BUY,3,0.02h,Stop Loss,$-9.00,$243.00,$62979.50,147,$243.00
,,,,,,,,,,,
2024-07-25,00:00:00,19271.25,SELL,3,0.02h,Stop Loss,$51.00,$51.00,$63030.50,148,$51.00
2024-07-25,00:15:00,19275.5,BUY,3,0.02h,Stop Loss,$-9.00,$42.00,$63021.50,148,$42.00
2024-07-25,00:37:00,19280.25,SELL,3,0.02h,Stop Loss,$6.00,$48.00,$63027.50,148,$48.00
2024-07-25,00:42:00,19286.75,BUY,3,0.02h,Break Even,$-1.50,$46.50,$63026.00,148,$46.50
2024-07-25,01:22:00,19290.25,SELL,3,0.02h,Stop Loss,$-9.00,$37.50,$63017.00,148,$37.50
2024-07-25,02:19:00,19271.0,BUY,3,0.02h,Break Even,$-1.50,$36.00,$63015.50,148,$36.00
2024-07-25,02:27:00,19264.5,SELL,3,0.02h,Stop Loss,$30.00,$66.00,$63045.50,148,$66.00
2024-07-25,03:03:00,19241.25,BUY,3,0.02h,Break Even,$-1.50,$64.50,$63044.00,148,$64.50
2024-07-25,04:04:00,19264.25,SELL,3,0.02h,Stop Loss,$-9.00,$55.50,$63035.00,148,$55.50
2024-07-25,04:08:00,19270.25,BUY,3,0.02h,Stop Loss,$-9.00,$46.50,$63026.00,148,$46.50
2024-07-25,04:13:00,19264.0,SELL,3,0.02h,Stop Loss,$3.00,$49.50,$63029.00,148,$49.50
2024-07-25,04:32:00,19268.0,BUY,3,0.02h,Stop Loss,$-9.00,$40.50,$63020.00,148,$40.50
2024-07-25,04:45:00,19258.25,SELL,3,0.02h,Stop Loss,$-9.00,$31.50,$63011.00,148,$31.50
2024-07-25,05:07:00,19266.25,BUY,3,0.02h,Break Even,$-1.50,$30.00,$63009.50,148,$30.00
2024-07-25,05:22:00,19257.5,SELL,3,0.02h,Break Even,$-1.50,$28.50,$63008.00,148,$28.50
2024-07-25,06:22:00,19229.0,BUY,3,0.02h,Stop Loss,$24.00,$52.50,$63032.00,148,$52.50
2024-07-25,07:03:00,19243.0,SELL,3,0.02h,Stop Loss,$61.50,$114.00,$63093.50,148,$114.00
2024-07-25,07:39:00,19216.0,BUY,3,0.02h,Stop Loss,$19.50,$133.50,$63113.00,148,$133.50
2024-07-25,07:43:00,19205.75,SELL,3,0.02h,Stop Loss,$109.50,$243.00,$63222.50,148,$243.00
2024-07-25,08:29:00,19131.0,BUY,3,0.02h,Stop Loss,$70.50,$313.50,$63293.00,148,$313.50
2024-07-25,09:18:00,19189.25,SELL,3,0.02h,Stop Loss,$40.50,$354.00,$63333.50,148,$354.00
2024-07-25,10:24:00,19145.75,BUY,3,0.02h,Break Even,$-1.50,$352.50,$63332.00,148,$352.50
2024-07-25,10:29:00,19118.75,SELL,3,0.02h,Stop Loss,$63.00,$415.50,$63395.00,148,$415.50
2024-07-25,10:35:00,19138.75,BUY,3,0.02h,Stop Loss,$25.50,$441.00,$63420.50,148,$441.00
2024-07-25,10:38:00,19120.25,SELL,3,0.02h,Stop Loss,$37.50,$478.50,$63458.00,148,$478.50
2024-07-25,10:47:00,19136.75,BUY,3,0.02h,Stop Loss,$-9.00,$469.50,$63449.00,148,$469.50
2024-07-25,11:27:00,19163.75,SELL,3,0.02h,Stop Loss,$27.00,$496.50,$63476.00,148,$496.50
2024-07-25,11:42:00,19179.25,BUY,3,0.02h,Break Even,$-1.50,$495.00,$63474.50,148,$495.00
2024-07-25,11:48:00,19147.0,SELL,3,0.02h,Break Even,$-1.50,$493.50,$63473.00,148,$493.50
2024-07-25,12:07:00,19157.0,BUY,3,0.02h,Stop Loss,$-9.00,$484.50,$63464.00,148,$484.50
2024-07-25,12:11:00,19146.0,SELL,3,0.02h,Break Even,$-1.50,$483.00,$63462.50,148,$483.00
2024-07-25,12:32:00,19160.5,BUY,3,0.02h,Stop Loss,$96.00,$579.00,$63558.50,148,$579.00
2024-07-25,13:31:00,19198.75,SELL,3,0.02h,Stop Loss,$37.50,$616.50,$63596.00,148,$616.50
2024-07-25,14:24:00,19029.5,BUY,3,0.02h,Stop Loss,$121.50,$738.00,$63717.50,148,$738.00
2024-07-25,15:28:00,19187.75,SELL,3,0.02h,Stop Loss,$13.50,$751.50,$63731.00,148,$751.50
2024-07-25,15:40:00,19222.5,BUY,3,0.02h,Stop Loss,$-9.00,$742.50,$63722.00,148,$742.50
2024-07-25,15:41:00,19201.5,SELL,3,0.02h,Stop Loss,$178.50,$921.00,$63900.50,148,$921.00
2024-07-25,15:54:00,19203.0,BUY,3,0.02h,Stop Loss,$34.50,$955.50,$63935.00,148,$955.50
2024-07-25,16:52:00,19304.25,SELL,3,0.02h,Break Even,$-1.50,$954.00,$63933.50,148,$954.00
2024-07-25,17:00:00,19333.5,BUY,3,0.02h,Stop Loss,$42.00,$996.00,$63975.50,148,$996.00
2024-07-25,17:16:00,19314.0,SELL,3,0.02h,Stop Loss,$22.50,$1018.50,$63998.00,148,$1018.50
2024-07-25,17:59:00,19300.0,BUY,3,0.02h,Stop Loss,$-9.00,$1009.50,$63989.00,148,$1009.50
2024-07-25,18:05:00,19256.25,SELL,3,0.02h,Stop Loss,$121.50,$1131.00,$64110.50,148,$1131.00
2024-07-25,18:35:00,19243.5,BUY,3,0.02h,Break Even,$-1.50,$1129.50,$64109.00,148,$1129.50
2024-07-25,18:37:00,19204.75,SELL,3,0.02h,Stop Loss,$9.00,$1138.50,$64118.00,148,$1138.50
2024-07-25,19:21:00,19155.0,BUY,3,0.02h,Stop Loss,$147.00,$1285.50,$64265.00,148,$1285.50
2024-07-25,19:38:00,19158.0,SELL,3,0.02h,Stop Loss,$70.50,$1356.00,$64335.50,148,$1356.00
2024-07-25,20:48:00,18983.5,BUY,3,0.02h,Stop Loss,$-9.00,$1347.00,$64326.50,148,$1347.00
2024-07-25,23:53:00,19017.5,SELL,3,0.02h,Stop Loss,$-9.00,$1338.00,$64317.50,148,$1338.00
2024-07-25,23:55:00,19021.75,BUY,3,0.02h,Stop Loss,$-9.00,$1329.00,$64308.50,148,$1329.00
,,,,,,,,,,,
2024-07-26,00:33:00,19041.75,SELL,3,0.02h,Break Even,$-1.50,$-1.50,$64307.00,149,$-1.50
2024-07-26,00:37:00,19049.75,BUY,3,0.02h,Break Even,$-1.50,$-3.00,$64305.50,149,$-3.00
2024-07-26,00:51:00,19041.0,SELL,3,0.02h,Stop Loss,$-9.00,$-12.00,$64296.50,149,$-12.00
2024-07-26,00:57:00,19049.75,BUY,3,0.02h,Stop Loss,$-9.00,$-21.00,$64287.50,149,$-21.00
2024-07-26,02:04:00,19074.0,SELL,3,0.02h,Stop Loss,$9.00,$-12.00,$64296.50,149,$-12.00
2024-07-26,02:11:00,19083.0,BUY,3,0.02h,Stop Loss,$6.00,$-6.00,$64302.50,149,$-6.00
2024-07-26,02:36:00,19081.75,SELL,3,0.02h,Stop Loss,$7.50,$1.50,$64310.00,149,$1.50
2024-07-26,03:05:00,19080.25,BUY,3,0.02h,Stop Loss,$-9.00,$-7.50,$64301.00,149,$-7.50
2024-07-26,03:11:00,19070.0,SELL,3,0.02h,Stop Loss,$55.50,$48.00,$64356.50,149,$48.00
2024-07-26,03:21:00,19079.25,BUY,3,0.02h,Stop Loss,$-9.00,$39.00,$64347.50,149,$39.00
2024-07-26,03:47:00,19075.5,SELL,3,0.02h,Break Even,$-1.50,$37.50,$64346.00,149,$37.50
2024-07-26,04:09:00,19079.0,BUY,3,0.02h,Stop Loss,$-9.00,$28.50,$64337.00,149,$28.50
2024-07-26,05:41:00,19103.25,SELL,3,0.02h,Stop Loss,$36.00,$64.50,$64373.00,149,$64.50
2024-07-26,06:08:00,19096.75,BUY,3,0.02h,Stop Loss,$79.50,$144.00,$64452.50,149,$144.00
2024-07-26,06:23:00,19082.25,SELL,3,0.02h,Stop Loss,$37.50,$181.50,$64490.00,149,$181.50
2024-07-26,06:40:00,19090.0,BUY,3,0.02h,Break Even,$-1.50,$180.00,$64488.50,149,$180.00
2024-07-26,07:00:00,19090.25,SELL,3,0.02h,Stop Loss,$15.00,$195.00,$64503.50,149,$195.00
2024-07-26,07:01:00,19095.75,BUY,3,0.02h,Stop Loss,$21.00,$216.00,$64524.50,149,$216.00
2024-07-26,07:12:00,19089.25,SELL,3,0.02h,Stop Loss,$-9.00,$207.00,$64515.50,149,$207.00
2024-07-26,07:13:00,19100.0,BUY,3,0.02h,Stop Loss,$34.50,$241.50,$64550.00,149,$241.50
2024-07-26,09:25:00,19193.0,SELL,3,0.02h,Stop Loss,$-9.00,$232.50,$64541.00,149,$232.50
2024-07-26,09:38:00,19199.5,BUY,3,0.02h,Stop Loss,$3.00,$235.50,$64544.00,149,$235.50
2024-07-26,09:44:00,19187.25,SELL,3,0.02h,Break Even,$-1.50,$234.00,$64542.50,149,$234.00
2024-07-26,09:54:00,19197.75,BUY,3,0.02h,Break Even,$-1.50,$232.50,$64541.00,149,$232.50
2024-07-26,09:58:00,19189.0,SELL,3,0.02h,Stop Loss,$-9.00,$223.50,$64532.00,149,$223.50
2024-07-26,10:00:00,19192.75,BUY,3,0.02h,Break Even,$-1.50,$222.00,$64530.50,149,$222.00
2024-07-26,10:01:00,19188.75,SELL,3,0.02h,Stop Loss,$-9.00,$213.00,$64521.50,149,$213.00
2024-07-26,10:10:00,19194.5,BUY,3,0.02h,Stop Loss,$-9.00,$204.00,$64512.50,149,$204.00
2024-07-26,10:12:00,19188.5,SELL,3,0.02h,Break Even,$-1.50,$202.50,$64511.00,149,$202.50
2024-07-26,10:34:00,19196.25,BUY,3,0.02h,Stop Loss,$-9.00,$193.50,$64502.00,149,$193.50
2024-07-26,10:45:00,19181.25,SELL,3,0.02h,Stop Loss,$4.50,$198.00,$64506.50,149,$198.00
2024-07-26,11:09:00,19181.25,BUY,3,0.02h,Stop Loss,$-9.00,$189.00,$64497.50,149,$189.00
2024-07-26,11:23:00,19178.75,SELL,3,0.02h,Stop Loss,$-9.00,$180.00,$64488.50,149,$180.00
2024-07-26,11:24:00,19183.5,BUY,3,0.02h,Break Even,$-1.50,$178.50,$64487.00,149,$178.50
2024-07-26,12:17:00,19207.5,SELL,3,0.02h,Break Even,$-1.50,$177.00,$64485.50,149,$177.00
2024-07-26,12:31:00,19222.5,BUY,3,0.02h,Stop Loss,$24.00,$201.00,$64509.50,149,$201.00
2024-07-26,12:33:00,19193.75,SELL,3,0.02h,Break Even,$-1.50,$199.50,$64508.00,149,$199.50
2024-07-26,13:26:00,19181.75,BUY,3,0.02h,Break Even,$-1.50,$198.00,$64506.50,149,$198.00
2024-07-26,13:29:00,19160.0,SELL,3,0.02h,Stop Loss,$-9.00,$189.00,$64497.50,149,$189.00
2024-07-26,14:01:00,19164.5,BUY,3,0.02h,Stop Loss,$33.00,$222.00,$64530.50,149,$222.00
2024-07-26,14:07:00,19081.5,SELL,3,0.02h,Stop Loss,$15.00,$237.00,$64545.50,149,$237.00
2024-07-26,14:24:00,19126.25,BUY,3,0.02h,Stop Loss,$129.00,$366.00,$64674.50,149,$366.00
2024-07-26,14:33:00,19073.5,SELL,3,0.02h,Stop Loss,$54.00,$420.00,$64728.50,149,$420.00
2024-07-26,14:59:00,19119.0,BUY,3,0.02h,Stop Loss,$75.00,$495.00,$64803.50,149,$495.00
2024-07-26,15:19:00,19107.5,SELL,3,0.02h,Stop Loss,$24.00,$519.00,$64827.50,149,$519.00
2024-07-26,15:32:00,19133.25,BUY,3,0.02h,Stop Loss,$16.50,$535.50,$64844.00,149,$535.50
2024-07-26,15:37:00,19113.5,SELL,3,0.02h,Break Even,$-1.50,$534.00,$64842.50,149,$534.00
2024-07-26,15:38:00,19134.25,BUY,3,0.02h,Stop Loss,$22.50,$556.50,$64865.00,149,$556.50
2024-07-26,17:11:00,19271.25,SELL,3,0.02h,Stop Loss,$19.50,$576.00,$64884.50,149,$576.00
2024-07-26,17:13:00,19279.0,BUY,3,0.02h,Stop Loss,$9.00,$585.00,$64893.50,149,$585.00
2024-07-26,17:15:00,19264.5,SELL,3,0.02h,Stop Loss,$-9.00,$576.00,$64884.50,149,$576.00
2024-07-26,17:17:00,19278.0,BUY,3,0.02h,Stop Loss,$4.50,$580.50,$64889.00,149,$580.50
2024-07-26,17:35:00,19231.5,SELL,3,0.02h,Stop Loss,$243.00,$823.50,$65132.00,149,$823.50
2024-07-26,18:04:00,19210.0,BUY,3,0.02h,Break Even,$-1.50,$822.00,$65130.50,149,$822.00
2024-07-26,18:05:00,19192.0,SELL,3,0.02h,Stop Loss,$36.00,$858.00,$65166.50,149,$858.00
2024-07-26,18:08:00,19208.75,BUY,3,0.02h,Break Even,$-1.50,$856.50,$65165.00,149,$856.50
2024-07-26,18:20:00,19170.25,SELL,3,0.02h,Break Even,$-1.50,$855.00,$65163.50,149,$855.00
2024-07-26,19:23:00,19140.75,BUY,3,0.02h,Stop Loss,$24.00,$879.00,$65187.50,149,$879.00
2024-07-26,19:35:00,19116.75,SELL,3,0.02h,Stop Loss,$24.00,$903.00,$65211.50,149,$903.00
2024-07-26,19:42:00,19170.25,BUY,3,0.02h,Stop Loss,$-9.00,$894.00,$65202.50,149,$894.00
2024-07-26,19:54:00,19133.25,SELL,3,0.02h,Stop Loss,$70.50,$964.50,$65273.00,149,$964.50
2024-07-26,20:01:00,19174.25,BUY,3,0.02h,Break Even,$-1.50,$963.00,$65271.50,149,$963.00
2024-07-26,20:39:00,19177.5,SELL,3,0.02h,Stop Loss,$-9.00,$954.00,$65262.50,149,$954.00
,,,,,,,,,,,
2024-07-29,00:00:00,19241.5,BUY,3,0.02h,Stop Loss,$12.00,$12.00,$65274.50,150,$12.00
2024-07-29,01:03:00,19296.25,SELL,3,0.02h,Break Even,$-1.50,$10.50,$65273.00,150,$10.50
2024-07-29,01:20:00,19302.25,BUY,3,0.02h,Stop Loss,$-9.00,$1.50,$65264.00,150,$1.50
2024-07-29,01:21:00,19293.75,SELL,3,0.02h,Stop Loss,$28.50,$30.00,$65292.50,150,$30.00
2024-07-29,01:32:00,19307.5,BUY,3,0.02h,Break Even,$-1.50,$28.50,$65291.00,150,$28.50
2024-07-29,01:41:00,19291.25,SELL,3,0.02h,Stop Loss,$28.50,$57.00,$65319.50,150,$57.00
2024-07-29,01:59:00,19294.25,BUY,3,0.02h,Stop Loss,$-9.00,$48.00,$65310.50,150,$48.00
2024-07-29,02:11:00,19287.0,SELL,3,0.02h,Break Even,$-1.50,$46.50,$65309.00,150,$46.50
2024-07-29,02:14:00,19303.75,BUY,3,0.02h,Stop Loss,$48.00,$94.50,$65357.00,150,$94.50
2024-07-29,02:32:00,19296.0,SELL,3,0.02h,Stop Loss,$-9.00,$85.50,$65348.00,150,$85.50
2024-07-29,03:07:00,19297.0,BUY,3,0.02h,Break Even,$-1.50,$84.00,$65346.50,150,$84.00
2024-07-29,04:01:00,19305.0,SELL,3,0.03h,Stop Loss,$-9.00,$75.00,$65337.50,150,$75.00
2024-07-29,04:07:00,19307.5,BUY,3,0.02h,Stop Loss,$-9.00,$66.00,$65328.50,150,$66.00
2024-07-29,04:28:00,19306.75,SELL,3,0.02h,Stop Loss,$4.50,$70.50,$65333.00,150,$70.50
2024-07-29,05:02:00,19303.0,BUY,3,0.02h,Break Even,$-1.50,$69.00,$65331.50,150,$69.00
2024-07-29,05:07:00,19300.0,SELL,3,0.02h,Stop Loss,$-9.00,$60.00,$65322.50,150,$60.00
2024-07-29,05:08:00,19303.25,BUY,3,0.02h,Stop Loss,$-9.00,$51.00,$65313.50,150,$51.00
2024-07-29,05:50:00,19309.75,SELL,3,0.02h,Break Even,$-1.50,$49.50,$65312.00,150,$49.50
2024-07-29,06:17:00,19315.5,BUY,3,0.02h,Break Even,$-1.50,$48.00,$65310.50,150,$48.00
2024-07-29,06:24:00,19305.0,SELL,3,0.02h,Break Even,$-1.50,$46.50,$65309.00,150,$46.50
2024-07-29,06:54:00,19309.75,BUY,3,0.02h,Stop Loss,$-9.00,$37.50,$65300.00,150,$37.50
2024-07-29,07:07:00,19292.5,SELL,3,0.02h,Stop Loss,$-9.00,$28.50,$65291.00,150,$28.50
2024-07-29,08:08:00,19254.25,BUY,3,0.02h,Stop Loss,$60.00,$88.50,$65351.00,150,$88.50
2024-07-29,08:28:00,19260.0,SELL,3,0.02h,Stop Loss,$-9.00,$79.50,$65342.00,150,$79.50
2024-07-29,08:59:00,19253.0,BUY,3,0.02h,Stop Loss,$-9.00,$70.50,$65333.00,150,$70.50
2024-07-29,09:03:00,19241.0,SELL,3,0.02h,Stop Loss,$3.00,$73.50,$65336.00,150,$73.50
2024-07-29,09:04:00,19248.0,BUY,3,0.02h,Break Even,$-1.50,$72.00,$65334.50,150,$72.00
2024-07-29,09:11:00,19239.0,SELL,3,0.02h,Stop Loss,$4.50,$76.50,$65339.00,150,$76.50
2024-07-29,09:23:00,19249.25,BUY,3,0.02h,Stop Loss,$12.00,$88.50,$65351.00,150,$88.50
2024-07-29,11:04:00,19282.0,SELL,3,0.02h,Break Even,$-1.50,$87.00,$65349.50,150,$87.00
2024-07-29,11:09:00,19288.25,BUY,3,0.02h,Stop Loss,$-9.00,$78.00,$65340.50,150,$78.00
2024-07-29,11:16:00,19284.25,SELL,3,0.02h,Stop Loss,$19.50,$97.50,$65360.00,150,$97.50
2024-07-29,11:23:00,19293.0,BUY,3,0.02h,Stop Loss,$16.50,$114.00,$65376.50,150,$114.00
2024-07-29,11:48:00,19299.75,SELL,3,0.02h,Stop Loss,$-9.00,$105.00,$65367.50,150,$105.00
2024-07-29,12:01:00,19311.0,BUY,3,0.02h,Stop Loss,$-9.00,$96.00,$65358.50,150,$96.00
2024-07-29,12:05:00,19292.25,SELL,3,0.02h,Break Even,$-1.50,$94.50,$65357.00,150,$94.50
2024-07-29,12:19:00,19307.75,BUY,3,0.02h,Stop Loss,$4.50,$99.00,$65361.50,150,$99.00
2024-07-29,12:51:00,19328.0,SELL,3,0.02h,Stop Loss,$52.50,$151.50,$65414.00,150,$151.50
2024-07-29,13:40:00,19312.75,BUY,3,0.02h,Stop Loss,$36.00,$187.50,$65450.00,150,$187.50
2024-07-29,14:10:00,19307.75,SELL,3,0.02h,Stop Loss,$76.50,$264.00,$65526.50,150,$264.00
2024-07-29,14:42:00,19304.75,BUY,3,0.02h,Stop Loss,$43.50,$307.50,$65570.00,150,$307.50
2024-07-29,14:51:00,19252.25,SELL,3,0.02h,Stop Loss,$12.00,$319.50,$65582.00,150,$319.50
2024-07-29,15:45:00,19164.75,BUY,3,0.02h,Stop Loss,$70.50,$390.00,$65652.50,150,$390.00
2024-07-29,16:52:00,19297.25,SELL,3,0.02h,Break Even,$-1.50,$388.50,$65651.00,150,$388.50
2024-07-29,16:56:00,19328.5,BUY,3,0.02h,Stop Loss,$4.50,$393.00,$65655.50,150,$393.00
2024-07-29,16:59:00,19313.5,SELL,3,0.02h,Stop Loss,$46.50,$439.50,$65702.00,150,$439.50
2024-07-29,17:04:00,19319.25,BUY,3,0.02h,Stop Loss,$-9.00,$430.50,$65693.00,150,$430.50
2024-07-29,17:06:00,19310.0,SELL,3,0.02h,Stop Loss,$-9.00,$421.50,$65684.00,150,$421.50
2024-07-29,17:11:00,19324.75,BUY,3,0.02h,Stop Loss,$13.50,$435.00,$65697.50,150,$435.00
2024-07-29,17:21:00,19308.75,SELL,3,0.02h,Stop Loss,$40.50,$475.50,$65738.00,150,$475.50
2024-07-29,18:58:00,19213.75,BUY,3,0.02h,Stop Loss,$52.50,$528.00,$65790.50,150,$528.00
2024-07-29,19:53:00,19238.75,SELL,3,0.02h,Stop Loss,$43.50,$571.50,$65834.00,150,$571.50
2024-07-29,20:27:00,19210.5,BUY,3,0.02h,Stop Loss,$6.00,$577.50,$65840.00,150,$577.50
2024-07-29,20:53:00,19210.0,SELL,3,0.02h,Break Even,$-1.50,$576.00,$65838.50,150,$576.00
2024-07-29,21:00:00,19221.75,BUY,3,2.00h,Stop Loss,$-9.00,$567.00,$65829.50,150,$567.00
2024-07-29,23:04:00,19208.25,SELL,3,0.02h,Stop Loss,$-9.00,$558.00,$65820.50,150,$558.00
,,,,,,,,,,,
2024-07-30,00:08:00,19151.0,BUY,3,0.02h,Stop Loss,$-9.00,$-9.00,$65811.50,151,$-9.00
2024-07-30,00:15:00,19139.0,SELL,3,0.02h,Stop Loss,$3.00,$-6.00,$65814.50,151,$-6.00
2024-07-30,00:28:00,19144.25,BUY,3,0.02h,Stop Loss,$10.50,$4.50,$65825.00,151,$4.50
2024-07-30,00:40:00,19139.25,SELL,3,0.02h,Stop Loss,$-9.00,$-4.50,$65816.00,151,$-4.50
2024-07-30,00:45:00,19147.0,BUY,3,0.02h,Stop Loss,$-9.00,$-13.50,$65807.00,151,$-13.50
2024-07-30,01:09:00,19144.25,SELL,3,0.02h,Break Even,$-1.50,$-15.00,$65805.50,151,$-15.00
2024-07-30,01:12:00,19161.25,BUY,3,0.02h,Stop Loss,$3.00,$-12.00,$65808.50,151,$-12.00
2024-07-30,01:18:00,19146.5,SELL,3,0.02h,Stop Loss,$-9.00,$-21.00,$65799.50,151,$-21.00
2024-07-30,02:13:00,19114.25,BUY,3,0.02h,Break Even,$-1.50,$-22.50,$65798.00,151,$-22.50
2024-07-30,02:29:00,19099.75,SELL,3,0.02h,Break Even,$-1.50,$-24.00,$65796.50,151,$-24.00
2024-07-30,02:49:00,19104.25,BUY,3,0.02h,Stop Loss,$4.50,$-19.50,$65801.00,151,$-19.50
2024-07-30,03:32:00,19115.75,SELL,3,0.02h,Stop Loss,$4.50,$-15.00,$65805.50,151,$-15.00
2024-07-30,03:41:00,19120.5,BUY,3,0.02h,Stop Loss,$27.00,$12.00,$65832.50,151,$12.00
2024-07-30,05:31:00,19178.5,SELL,3,0.02h,Stop Loss,$39.00,$51.00,$65871.50,151,$51.00
2024-07-30,05:41:00,19193.25,BUY,3,0.02h,Break Even,$-1.50,$49.50,$65870.00,151,$49.50
2024-07-30,06:07:00,19190.75,SELL,3,0.02h,Stop Loss,$-9.00,$40.50,$65861.00,151,$40.50
2024-07-30,06:09:00,19196.0,BUY,3,0.02h,Break Even,$-1.50,$39.00,$65859.50,151,$39.00
2024-07-30,06:25:00,19190.75,SELL,3,0.02h,Break Even,$-1.50,$37.50,$65858.00,151,$37.50
2024-07-30,06:29:00,19210.25,BUY,3,0.02h,Stop Loss,$7.50,$45.00,$65865.50,151,$45.00
2024-07-30,06:38:00,19189.0,SELL,3,0.02h,Break Even,$-1.50,$43.50,$65864.00,151,$43.50
2024-07-30,06:49:00,19206.0,BUY,3,0.02h,Stop Loss,$12.00,$55.50,$65876.00,151,$55.50
2024-07-30,07:59:00,19232.0,SELL,3,0.02h,Break Even,$-1.50,$54.00,$65874.50,151,$54.00
2024-07-30,08:05:00,19253.75,BUY,3,0.02h,Stop Loss,$-9.00,$45.00,$65865.50,151,$45.00
2024-07-30,08:11:00,19234.0,SELL,3,0.02h,Stop Loss,$81.00,$126.00,$65946.50,151,$126.00
2024-07-30,08:34:00,19227.75,BUY,3,0.02h,Stop Loss,$30.00,$156.00,$65976.50,151,$156.00
2024-07-30,09:24:00,19245.25,SELL,3,0.02h,Stop Loss,$6.00,$162.00,$65982.50,151,$162.00
2024-07-30,09:57:00,19231.0,BUY,3,0.02h,Break Even,$-1.50,$160.50,$65981.00,151,$160.50
2024-07-30,10:17:00,19221.75,SELL,3,0.02h,Break Even,$-1.50,$159.00,$65979.50,151,$159.00
2024-07-30,10:22:00,19232.0,BUY,3,0.02h,Stop Loss,$-9.00,$150.00,$65970.50,151,$150.00
2024-07-30,11:20:00,19249.5,SELL,3,0.02h,Break Even,$-1.50,$148.50,$65969.00,151,$148.50
2024-07-30,11:31:00,19262.25,BUY,3,0.02h,Stop Loss,$-9.00,$139.50,$65960.00,151,$139.50
2024-07-30,11:59:00,19264.0,SELL,3,0.03h,Stop Loss,$9.00,$148.50,$65969.00,151,$148.50
2024-07-30,12:06:00,19272.0,BUY,3,0.02h,Break Even,$-1.50,$147.00,$65967.50,151,$147.00
2024-07-30,12:19:00,19267.75,SELL,3,0.02h,Break Even,$-1.50,$145.50,$65966.00,151,$145.50
2024-07-30,12:39:00,19266.0,BUY,3,0.02h,Break Even,$-1.50,$144.00,$65964.50,151,$144.00
2024-07-30,12:54:00,19263.25,SELL,3,0.02h,Stop Loss,$-9.00,$135.00,$65955.50,151,$135.00
2024-07-30,12:55:00,19268.75,BUY,3,0.02h,Stop Loss,$-9.00,$126.00,$65946.50,151,$126.00
2024-07-30,13:10:00,19264.5,SELL,3,0.02h,Stop Loss,$-9.00,$117.00,$65937.50,151,$117.00
2024-07-30,13:11:00,19268.0,BUY,3,0.02h,Stop Loss,$-9.00,$108.00,$65928.50,151,$108.00
2024-07-30,13:46:00,19236.25,SELL,3,0.02h,Stop Loss,$15.00,$123.00,$65943.50,151,$123.00
2024-07-30,14:18:00,19229.0,BUY,3,0.02h,Break Even,$-1.50,$121.50,$65942.00,151,$121.50
2024-07-30,14:19:00,19199.0,SELL,3,0.02h,Stop Loss,$33.00,$154.50,$65975.00,151,$154.50
2024-07-30,16:10:00,18968.5,BUY,3,0.02h,Break Even,$-1.50,$153.00,$65973.50,151,$153.00
2024-07-30,16:22:00,18929.0,SELL,3,0.02h,Stop Loss,$67.50,$220.50,$66041.00,151,$220.50
2024-07-30,16:43:00,18945.25,BUY,3,0.02h,Break Even,$-1.50,$219.00,$66039.50,151,$219.00
2024-07-30,16:46:00,18915.5,SELL,3,0.02h,Stop Loss,$97.50,$316.50,$66137.00,151,$316.50
2024-07-30,17:15:00,18878.75,BUY,3,0.02h,Stop Loss,$34.50,$351.00,$66171.50,151,$351.00
2024-07-30,18:48:00,18962.75,SELL,3,0.02h,Stop Loss,$18.00,$369.00,$66189.50,151,$369.00
2024-07-30,19:24:00,18947.5,BUY,3,0.02h,Break Even,$-1.50,$367.50,$66188.00,151,$367.50
2024-07-30,19:32:00,18926.25,SELL,3,0.02h,Stop Loss,$40.50,$408.00,$66228.50,151,$408.00
2024-07-30,19:47:00,18936.5,BUY,3,0.02h,Stop Loss,$198.00,$606.00,$66426.50,151,$606.00
2024-07-30,20:01:00,18866.75,SELL,3,0.02h,Stop Loss,$571.50,$1177.50,$66998.00,151,$1177.50
2024-07-30,20:30:00,18839.5,BUY,3,0.02h,Stop Loss,$27.00,$1204.50,$67025.00,151,$1204.50
2024-07-30,20:56:00,18847.5,SELL,3,0.02h,Break Even,$-1.50,$1203.00,$67023.50,151,$1203.00
2024-07-30,23:00:00,18969.75,BUY,3,0.02h,Stop Loss,$19.50,$1222.50,$67043.00,151,$1222.50
,,,,,,,,,,,
2024-07-31,00:11:00,19041.75,SELL,3,0.02h,Stop Loss,$7.50,$7.50,$67050.50,152,$7.50
2024-07-31,00:31:00,19045.75,BUY,3,0.02h,Stop Loss,$31.50,$39.00,$67082.00,152,$39.00
2024-07-31,01:16:00,19071.0,SELL,3,0.02h,Stop Loss,$10.50,$49.50,$67092.50,152,$49.50
2024-07-31,01:31:00,19071.0,BUY,3,0.02h,Stop Loss,$-9.00,$40.50,$67083.50,152,$40.50
2024-07-31,01:32:00,19063.25,SELL,3,0.02h,Stop Loss,$3.00,$43.50,$67086.50,152,$43.50
2024-07-31,01:38:00,19076.75,BUY,3,0.02h,Stop Loss,$10.50,$54.00,$67097.00,152,$54.00
2024-07-31,01:43:00,19058.75,SELL,3,0.02h,Stop Loss,$-9.00,$45.00,$67088.00,152,$45.00
2024-07-31,01:50:00,19075.0,BUY,3,0.02h,Stop Loss,$7.50,$52.50,$67095.50,152,$52.50
2024-07-31,02:47:00,19105.5,SELL,3,0.02h,Break Even,$-1.50,$51.00,$67094.00,152,$51.00
2024-07-31,03:04:00,19109.5,BUY,3,0.02h,Stop Loss,$-9.00,$42.00,$67085.00,152,$42.00
2024-07-31,03:07:00,19106.75,SELL,3,0.02h,Break Even,$-1.50,$40.50,$67083.50,152,$40.50
2024-07-31,03:39:00,19105.5,BUY,3,0.02h,Stop Loss,$-9.00,$31.50,$67074.50,152,$31.50
2024-07-31,03:49:00,19099.75,SELL,3,0.02h,Stop Loss,$-9.00,$22.50,$67065.50,152,$22.50
2024-07-31,03:52:00,19104.0,BUY,3,0.02h,Stop Loss,$-9.00,$13.50,$67056.50,152,$13.50
2024-07-31,03:55:00,19100.25,SELL,3,0.02h,Stop Loss,$3.00,$16.50,$67059.50,152,$16.50
2024-07-31,03:59:00,19121.0,BUY,3,0.02h,Stop Loss,$93.00,$109.50,$67152.50,152,$109.50
2024-07-31,04:07:00,19099.0,SELL,3,0.02h,Stop Loss,$-9.00,$100.50,$67143.50,152,$100.50
2024-07-31,04:24:00,19104.75,BUY,3,0.02h,Stop Loss,$-9.00,$91.50,$67134.50,152,$91.50
2024-07-31,04:25:00,19100.75,SELL,3,0.02h,Stop Loss,$13.50,$105.00,$67148.00,152,$105.00
2024-07-31,04:42:00,19104.75,BUY,3,0.02h,Break Even,$-1.50,$103.50,$67146.50,152,$103.50
2024-07-31,04:57:00,19097.25,SELL,3,0.02h,Break Even,$-1.50,$102.00,$67145.00,152,$102.00
2024-07-31,05:21:00,19108.5,BUY,3,0.02h,Stop Loss,$-9.00,$93.00,$67136.00,152,$93.00
2024-07-31,06:09:00,19183.25,SELL,3,0.02h,Stop Loss,$75.00,$168.00,$67211.00,152,$168.00
2024-07-31,06:15:00,19198.25,BUY,3,0.02h,Stop Loss,$43.50,$211.50,$67254.50,152,$211.50
2024-07-31,07:02:00,19205.5,SELL,3,0.02h,Stop Loss,$-9.00,$202.50,$67245.50,152,$202.50
2024-07-31,07:21:00,19218.0,BUY,3,0.02h,Break Even,$-1.50,$201.00,$67244.00,152,$201.00
2024-07-31,08:03:00,19209.75,SELL,3,0.02h,Stop Loss,$30.00,$231.00,$67274.00,152,$231.00
2024-07-31,08:23:00,19209.75,BUY,3,0.02h,Stop Loss,$10.50,$241.50,$67284.50,152,$241.50
2024-07-31,08:56:00,19224.75,SELL,3,0.02h,Stop Loss,$51.00,$292.50,$67335.50,152,$292.50
2024-07-31,09:35:00,19228.0,BUY,3,0.02h,Break Even,$-1.50,$291.00,$67334.00,152,$291.00
2024-07-31,09:47:00,19206.5,SELL,3,0.02h,Stop Loss,$-9.00,$282.00,$67325.00,152,$282.00
2024-07-31,10:05:00,19218.5,BUY,3,0.02h,Stop Loss,$10.50,$292.50,$67335.50,152,$292.50
2024-07-31,10:30:00,19216.75,SELL,3,0.02h,Break Even,$-1.50,$291.00,$67334.00,152,$291.00
2024-07-31,10:31:00,19219.25,BUY,3,0.02h,Stop Loss,$-9.00,$282.00,$67325.00,152,$282.00
2024-07-31,10:32:00,19214.0,SELL,3,0.02h,Stop Loss,$-9.00,$273.00,$67316.00,152,$273.00
2024-07-31,10:38:00,19222.25,BUY,3,0.02h,Stop Loss,$-9.00,$264.00,$67307.00,152,$264.00
2024-07-31,10:46:00,19213.75,SELL,3,0.02h,Break Even,$-1.50,$262.50,$67305.50,152,$262.50
2024-07-31,10:49:00,19224.0,BUY,3,0.02h,Break Even,$-1.50,$261.00,$67304.00,152,$261.00
2024-07-31,11:08:00,19218.25,SELL,3,0.02h,Stop Loss,$-9.00,$252.00,$67295.00,152,$252.00
2024-07-31,11:09:00,19225.0,BUY,3,0.02h,Break Even,$-1.50,$250.50,$67293.50,152,$250.50
2024-07-31,11:32:00,19225.0,SELL,3,0.02h,Break Even,$-1.50,$249.00,$67292.00,152,$249.00
2024-07-31,11:43:00,19233.75,BUY,3,0.02h,Break Even,$-1.50,$247.50,$67290.50,152,$247.50
2024-07-31,13:33:00,19335.5,SELL,3,0.02h,Stop Loss,$27.00,$274.50,$67317.50,152,$274.50
2024-07-31,13:41:00,19398.25,BUY,3,0.02h,Stop Loss,$39.00,$313.50,$67356.50,152,$313.50
2024-07-31,13:47:00,19334.5,SELL,3,0.02h,Stop Loss,$-9.00,$304.50,$67347.50,152,$304.50
2024-07-31,13:50:00,19364.0,BUY,3,0.02h,Break Even,$-1.50,$303.00,$67346.00,152,$303.00
2024-07-31,14:49:00,19447.25,SELL,3,0.02h,Stop Loss,$42.00,$345.00,$67388.00,152,$345.00
2024-07-31,15:04:00,19456.5,BUY,3,0.02h,Stop Loss,$25.50,$370.50,$67413.50,152,$370.50
2024-07-31,15:48:00,19481.25,SELL,3,0.02h,Break Even,$-1.50,$369.00,$67412.00,152,$369.00
2024-07-31,15:49:00,19487.0,BUY,3,0.02h,Break Even,$-1.50,$367.50,$67410.50,152,$367.50
2024-07-31,15:51:00,19476.75,SELL,3,0.02h,Stop Loss,$61.50,$429.00,$67472.00,152,$429.00
2024-07-31,16:14:00,19475.25,BUY,3,0.02h,Stop Loss,$33.00,$462.00,$67505.00,152,$462.00
2024-07-31,16:25:00,19461.75,SELL,3,0.02h,Stop Loss,$97.50,$559.50,$67602.50,152,$559.50
2024-07-31,16:52:00,19452.75,BUY,3,0.02h,Break Even,$-1.50,$558.00,$67601.00,152,$558.00
2024-07-31,16:54:00,19440.25,SELL,3,0.02h,Stop Loss,$33.00,$591.00,$67634.00,152,$591.00
2024-07-31,17:06:00,19447.75,BUY,3,0.02h,Stop Loss,$9.00,$600.00,$67643.00,152,$600.00
2024-07-31,17:26:00,19436.0,SELL,3,0.02h,Stop Loss,$3.00,$603.00,$67646.00,152,$603.00
2024-07-31,17:51:00,19432.5,BUY,3,0.02h,Stop Loss,$-9.00,$594.00,$67637.00,152,$594.00
2024-07-31,19:14:00,19535.75,SELL,3,0.02h,Stop Loss,$45.00,$639.00,$67682.00,152,$639.00
2024-07-31,19:17:00,19555.25,BUY,3,0.02h,Stop Loss,$54.00,$693.00,$67736.00,152,$693.00
2024-07-31,19:19:00,19502.5,SELL,3,0.02h,Stop Loss,$166.50,$859.50,$67902.50,152,$859.50
2024-07-31,19:41:00,19515.25,BUY,3,0.02h,Stop Loss,$63.00,$922.50,$67965.50,152,$922.50
2024-07-31,19:53:00,19463.75,SELL,3,0.02h,Stop Loss,$55.50,$978.00,$68021.00,152,$978.00
2024-07-31,20:01:00,19550.0,BUY,3,0.02h,Stop Loss,$151.50,$1129.50,$68172.50,152,$1129.50
2024-07-31,23:58:00,19673.75,SELL,3,0.02h,Stop Loss,$-9.00,$1120.50,$68163.50,152,$1120.50
,,,,,,,,,,,
2024-08-01,00:02:00,19679.75,BUY,3,0.02h,Stop Loss,$-9.00,$-9.00,$68154.50,153,$-9.00
2024-08-01,00:33:00,19679.25,SELL,3,0.02h,Break Even,$-1.50,$-10.50,$68153.00,153,$-10.50
2024-08-01,01:25:00,19656.25,BUY,3,0.02h,Stop Loss,$-9.00,$-19.50,$68144.00,153,$-19.50
2024-08-01,01:30:00,19634.5,SELL,3,0.02h,Stop Loss,$-9.00,$-28.50,$68135.00,153,$-28.50
2024-08-01,02:21:00,19642.0,BUY,3,0.02h,Stop Loss,$21.00,$-7.50,$68156.00,153,$-7.50
2024-08-01,03:21:00,19666.0,SELL,3,0.02h,Stop Loss,$-9.00,$-16.50,$68147.00,153,$-16.50
2024-08-01,03:26:00,19672.0,BUY,3,0.02h,Break Even,$-1.50,$-18.00,$68145.50,153,$-18.00
2024-08-01,03:42:00,19669.5,SELL,3,0.02h,Stop Loss,$-9.00,$-27.00,$68136.50,153,$-27.00
2024-08-01,03:44:00,19674.5,BUY,3,0.02h,Break Even,$-1.50,$-28.50,$68135.00,153,$-28.50
2024-08-01,04:31:00,19676.5,SELL,3,0.02h,Break Even,$-1.50,$-30.00,$68133.50,153,$-30.00
2024-08-01,05:18:00,19666.25,BUY,3,0.02h,Stop Loss,$-9.00,$-39.00,$68124.50,153,$-39.00
2024-08-01,05:27:00,19662.5,SELL,3,0.02h,Break Even,$-1.50,$-40.50,$68123.00,153,$-40.50
2024-08-01,05:30:00,19665.25,BUY,3,0.02h,Stop Loss,$-9.00,$-49.50,$68114.00,153,$-49.50
2024-08-01,05:31:00,19661.5,SELL,3,0.02h,Stop Loss,$-9.00,$-58.50,$68105.00,153,$-58.50
2024-08-01,05:34:00,19669.25,BUY,3,0.02h,Break Even,$-1.50,$-60.00,$68103.50,153,$-60.00
2024-08-01,06:03:00,19644.5,SELL,3,0.02h,Stop Loss,$22.50,$-37.50,$68126.00,153,$-37.50
2024-08-01,06:33:00,19637.25,BUY,3,0.02h,Break Even,$-1.50,$-39.00,$68124.50,153,$-39.00
2024-08-01,06:53:00,19622.25,SELL,3,0.02h,Break Even,$-1.50,$-40.50,$68123.00,153,$-40.50
2024-08-01,07:09:00,19636.75,BUY,3,0.02h,Stop Loss,$9.00,$-31.50,$68132.00,153,$-31.50
2024-08-01,07:33:00,19636.25,SELL,3,0.02h,Stop Loss,$3.00,$-28.50,$68135.00,153,$-28.50
2024-08-01,07:38:00,19650.0,BUY,3,0.02h,Break Even,$-1.50,$-30.00,$68133.50,153,$-30.00
2024-08-01,07:43:00,19634.75,SELL,3,0.02h,Stop Loss,$49.50,$19.50,$68183.00,153,$19.50
2024-08-01,07:47:00,19645.5,BUY,3,0.02h,Stop Loss,$-9.00,$10.50,$68174.00,153,$10.50
2024-08-01,07:48:00,19636.5,SELL,3,0.02h,Stop Loss,$21.00,$31.50,$68195.00,153,$31.50
2024-08-01,07:50:00,19647.25,BUY,3,0.02h,Stop Loss,$55.50,$87.00,$68250.50,153,$87.00
2024-08-01,07:54:00,19633.75,SELL,3,0.02h,Stop Loss,$48.00,$135.00,$68298.50,153,$135.00
2024-08-01,09:04:00,19539.0,BUY,3,0.02h,Stop Loss,$27.00,$162.00,$68325.50,153,$162.00
2024-08-01,09:31:00,19554.5,SELL,3,0.02h,Break Even,$-1.50,$160.50,$68324.00,153,$160.50
2024-08-01,09:32:00,19567.75,BUY,3,0.02h,Stop Loss,$36.00,$196.50,$68360.00,153,$196.50
2024-08-01,10:12:00,19586.25,SELL,3,0.02h,Stop Loss,$-9.00,$187.50,$68351.00,153,$187.50
2024-08-01,10:29:00,19598.75,BUY,3,0.02h,Stop Loss,$-9.00,$178.50,$68342.00,153,$178.50
2024-08-01,10:34:00,19575.75,SELL,3,0.02h,Break Even,$-1.50,$177.00,$68340.50,153,$177.00
2024-08-01,10:49:00,19586.0,BUY,3,0.02h,Stop Loss,$12.00,$189.00,$68352.50,153,$189.00
2024-08-01,11:50:00,19602.75,SELL,3,0.02h,Stop Loss,$58.50,$247.50,$68411.00,153,$247.50
2024-08-01,12:15:00,19597.0,BUY,3,0.02h,Stop Loss,$9.00,$256.50,$68420.00,153,$256.50
2024-08-01,12:41:00,19596.0,SELL,3,0.02h,Break Even,$-1.50,$255.00,$68418.50,153,$255.00
2024-08-01,13:40:00,19563.25,BUY,3,0.02h,Stop Loss,$123.00,$378.00,$68541.50,153,$378.00
2024-08-01,14:06:00,19578.75,SELL,3,0.02h,Stop Loss,$84.00,$462.00,$68625.50,153,$462.00
2024-08-01,16:08:00,19227.75,BUY,3,0.02h,Stop Loss,$-9.00,$453.00,$68616.50,153,$453.00
2024-08-01,16:21:00,19175.5,SELL,3,0.02h,Stop Loss,$40.50,$493.50,$68657.00,153,$493.50
2024-08-01,17:58:00,18981.5,BUY,3,0.02h,Stop Loss,$81.00,$574.50,$68738.00,153,$574.50
2024-08-01,18:13:00,18950.0,SELL,3,0.02h,Break Even,$-1.50,$573.00,$68736.50,153,$573.00
2024-08-01,19:02:00,18915.25,BUY,3,0.02h,Stop Loss,$43.50,$616.50,$68780.00,153,$616.50
2024-08-01,20:03:00,18953.0,SELL,3,0.02h,Stop Loss,$180.00,$796.50,$68960.00,153,$796.50
2024-08-01,20:39:00,18929.25,BUY,3,0.02h,Stop Loss,$3.00,$799.50,$68963.00,153,$799.50
2024-08-01,20:41:00,18908.5,SELL,3,0.02h,Stop Loss,$45.00,$844.50,$69008.00,153,$844.50
2024-08-01,20:48:00,18928.75,BUY,3,0.02h,Break Even,$-1.50,$843.00,$69006.50,153,$843.00
2024-08-01,23:01:00,18872.0,SELL,3,0.02h,Stop Loss,$58.50,$901.50,$69065.00,153,$901.50
2024-08-01,23:26:00,18910.25,BUY,3,0.02h,Stop Loss,$57.00,$958.50,$69122.00,153,$958.50
2024-08-01,23:52:00,18923.0,SELL,3,0.02h,Stop Loss,$24.00,$982.50,$69146.00,153,$982.50
,,,,,,,,,,,
2024-08-02,00:35:00,18913.5,BUY,3,0.02h,Break Even,$-1.50,$-1.50,$69144.50,154,$-1.50
2024-08-02,00:48:00,18903.25,SELL,3,0.02h,Stop Loss,$-9.00,$-10.50,$69135.50,154,$-10.50
2024-08-02,00:49:00,18906.75,BUY,3,0.02h,Stop Loss,$-9.00,$-19.50,$69126.50,154,$-19.50
2024-08-02,00:50:00,18896.25,SELL,3,0.02h,Stop Loss,$102.00,$82.50,$69228.50,154,$82.50
2024-08-02,01:00:00,18908.75,BUY,3,0.02h,Stop Loss,$27.00,$109.50,$69255.50,154,$109.50
2024-08-02,01:04:00,18894.5,SELL,3,0.02h,Stop Loss,$30.00,$139.50,$69285.50,154,$139.50
2024-08-02,01:14:00,18903.0,BUY,3,0.02h,Break Even,$-1.50,$138.00,$69284.00,154,$138.00
2024-08-02,01:22:00,18888.75,SELL,3,0.02h,Stop Loss,$-9.00,$129.00,$69275.00,154,$129.00
2024-08-02,01:25:00,18899.25,BUY,3,0.02h,Stop Loss,$-9.00,$120.00,$69266.00,154,$120.00
2024-08-02,01:26:00,18886.75,SELL,3,0.02h,Stop Loss,$55.50,$175.50,$69321.50,154,$175.50
2024-08-02,01:40:00,18900.75,BUY,3,0.02h,Break Even,$-1.50,$174.00,$69320.00,154,$174.00
2024-08-02,02:01:00,18896.75,SELL,3,0.02h,Stop Loss,$49.50,$223.50,$69369.50,154,$223.50
2024-08-02,02:57:00,18772.25,BUY,3,0.02h,Break Even,$-1.50,$222.00,$69368.00,154,$222.00
2024-08-02,03:17:00,18760.0,SELL,3,0.02h,Stop Loss,$-9.00,$213.00,$69359.00,154,$213.00
2024-08-02,03:20:00,18779.25,BUY,3,0.02h,Stop Loss,$10.50,$223.50,$69369.50,154,$223.50
2024-08-02,03:45:00,18765.75,SELL,3,0.02h,Break Even,$-1.50,$222.00,$69368.00,154,$222.00
2024-08-02,03:54:00,18787.5,BUY,3,0.02h,Stop Loss,$48.00,$270.00,$69416.00,154,$270.00
2024-08-02,04:10:00,18775.75,SELL,3,0.02h,Stop Loss,$-9.00,$261.00,$69407.00,154,$261.00
2024-08-02,04:25:00,18787.25,BUY,3,0.02h,Stop Loss,$-9.00,$252.00,$69398.00,154,$252.00
2024-08-02,04:29:00,18776.0,SELL,3,0.02h,Stop Loss,$-9.00,$243.00,$69389.00,154,$243.00
2024-08-02,04:31:00,18786.5,BUY,3,0.02h,Stop Loss,$-9.00,$234.00,$69380.00,154,$234.00
2024-08-02,04:34:00,18778.0,SELL,3,0.02h,Stop Loss,$-9.00,$225.00,$69371.00,154,$225.00
2024-08-02,05:09:00,18780.25,BUY,3,0.02h,Stop Loss,$4.50,$229.50,$69375.50,154,$229.50
2024-08-02,05:34:00,18776.0,SELL,3,0.02h,Stop Loss,$28.50,$258.00,$69404.00,154,$258.00
2024-08-02,06:01:00,18763.25,BUY,3,0.02h,Stop Loss,$102.00,$360.00,$69506.00,154,$360.00
2024-08-02,06:08:00,18758.5,SELL,3,0.02h,Stop Loss,$28.50,$388.50,$69534.50,154,$388.50
2024-08-02,06:48:00,18733.0,BUY,3,0.02h,Break Even,$-1.50,$387.00,$69533.00,154,$387.00
2024-08-02,06:59:00,18713.0,SELL,3,0.02h,Stop Loss,$43.50,$430.50,$69576.50,154,$430.50
2024-08-02,07:29:00,18711.25,BUY,3,0.02h,Stop Loss,$61.50,$492.00,$69638.00,154,$492.00
2024-08-02,07:57:00,18696.0,SELL,3,0.02h,Stop Loss,$-9.00,$483.00,$69629.00,154,$483.00
2024-08-02,08:00:00,18749.0,BUY,3,0.02h,Stop Loss,$61.50,$544.50,$69690.50,154,$544.50
2024-08-02,08:06:00,18703.75,SELL,3,0.02h,Stop Loss,$28.50,$573.00,$69719.00,154,$573.00
2024-08-02,08:29:00,18720.0,BUY,3,0.02h,Stop Loss,$37.50,$610.50,$69756.50,154,$610.50
2024-08-02,08:49:00,18708.5,SELL,3,0.02h,Stop Loss,$28.50,$639.00,$69785.00,154,$639.00
2024-08-02,08:56:00,18730.75,BUY,3,0.02h,Stop Loss,$7.50,$646.50,$69792.50,154,$646.50
2024-08-02,09:06:00,18708.25,SELL,3,0.02h,Break Even,$-1.50,$645.00,$69791.00,154,$645.00
2024-08-02,09:39:00,18691.75,BUY,3,0.02h,Stop Loss,$25.50,$670.50,$69816.50,154,$670.50
2024-08-02,09:46:00,18671.0,SELL,3,0.02h,Stop Loss,$-9.00,$661.50,$69807.50,154,$661.50
2024-08-02,09:56:00,18686.5,BUY,3,0.02h,Stop Loss,$15.00,$676.50,$69822.50,154,$676.50
2024-08-02,10:05:00,18664.75,SELL,3,0.02h,Stop Loss,$45.00,$721.50,$69867.50,154,$721.50
2024-08-02,10:19:00,18680.75,BUY,3,0.02h,Break Even,$-1.50,$720.00,$69866.00,154,$720.00
2024-08-02,10:36:00,18681.75,SELL,3,0.02h,Stop Loss,$3.00,$723.00,$69869.00,154,$723.00
2024-08-02,10:42:00,18720.25,BUY,3,0.02h,Stop Loss,$16.50,$739.50,$69885.50,154,$739.50
2024-08-02,11:02:00,18701.25,SELL,3,0.02h,Break Even,$-1.50,$738.00,$69884.00,154,$738.00
2024-08-02,11:05:00,18726.75,BUY,3,0.02h,Stop Loss,$25.50,$763.50,$69909.50,154,$763.50
2024-08-02,11:08:00,18705.75,SELL,3,0.02h,Stop Loss,$10.50,$774.00,$69920.00,154,$774.00
2024-08-02,11:35:00,18721.25,BUY,3,0.02h,Stop Loss,$7.50,$781.50,$69927.50,154,$781.50
2024-08-02,11:40:00,18701.0,SELL,3,0.02h,Break Even,$-1.50,$780.00,$69926.00,154,$780.00
2024-08-02,12:05:00,18700.25,BUY,3,0.02h,Stop Loss,$12.00,$792.00,$69938.00,154,$792.00
2024-08-02,12:31:00,18602.0,SELL,3,0.02h,Stop Loss,$109.50,$901.50,$70047.50,154,$901.50
2024-08-02,12:54:00,18612.0,BUY,3,0.02h,Stop Loss,$130.50,$1032.00,$70178.00,154,$1032.00
2024-08-02,13:02:00,18573.0,SELL,3,0.02h,Stop Loss,$99.00,$1131.00,$70277.00,154,$1131.00
2024-08-02,13:09:00,18595.25,BUY,3,0.02h,Stop Loss,$24.00,$1155.00,$70301.00,154,$1155.00
2024-08-02,13:34:00,18562.75,SELL,3,0.02h,Stop Loss,$105.00,$1260.00,$70406.00,154,$1260.00
2024-08-02,13:40:00,18719.25,BUY,3,0.02h,Stop Loss,$210.00,$1470.00,$70616.00,154,$1470.00
2024-08-02,13:52:00,18605.25,SELL,3,0.02h,Stop Loss,$100.50,$1570.50,$70716.50,154,$1570.50
2024-08-02,14:30:00,18486.75,BUY,3,0.02h,Stop Loss,$201.00,$1771.50,$70917.50,154,$1771.50
2024-08-02,14:36:00,18457.25,SELL,3,0.02h,Stop Loss,$96.00,$1867.50,$71013.50,154,$1867.50
2024-08-02,14:47:00,18499.5,BUY,3,0.02h,Stop Loss,$145.50,$2013.00,$71159.00,154,$2013.00
2024-08-02,14:57:00,18453.0,SELL,3,0.02h,Stop Loss,$105.00,$2118.00,$71264.00,154,$2118.00
2024-08-02,15:13:00,18476.75,BUY,3,0.02h,Stop Loss,$7.50,$2125.50,$71271.50,154,$2125.50
2024-08-02,15:21:00,18432.5,SELL,3,0.02h,Break Even,$-1.50,$2124.00,$71270.00,154,$2124.00
2024-08-02,15:24:00,18493.25,BUY,3,0.02h,Stop Loss,$63.00,$2187.00,$71333.00,154,$2187.00
2024-08-02,16:12:00,18535.5,SELL,3,0.02h,Stop Loss,$66.00,$2253.00,$71399.00,154,$2253.00
2024-08-02,16:22:00,18607.5,BUY,3,0.02h,Break Even,$-1.50,$2251.50,$71397.50,154,$2251.50
2024-08-02,16:38:00,18563.25,SELL,3,0.02h,Break Even,$-1.50,$2250.00,$71396.00,154,$2250.00
2024-08-02,16:41:00,18608.0,BUY,3,0.02h,Stop Loss,$130.50,$2380.50,$71526.50,154,$2380.50
2024-08-02,16:48:00,18558.75,SELL,3,0.02h,Stop Loss,$7.50,$2388.00,$71534.00,154,$2388.00
2024-08-02,17:15:00,18550.25,BUY,3,0.02h,Stop Loss,$28.50,$2416.50,$71562.50,154,$2416.50
2024-08-02,17:23:00,18509.75,SELL,3,0.02h,Stop Loss,$36.00,$2452.50,$71598.50,154,$2452.50
2024-08-02,17:59:00,18484.5,BUY,3,0.02h,Stop Loss,$39.00,$2491.50,$71637.50,154,$2491.50
2024-08-02,18:15:00,18474.25,SELL,3,0.02h,Stop Loss,$34.50,$2526.00,$71672.00,154,$2526.00
2024-08-02,18:23:00,18501.25,BUY,3,0.02h,Stop Loss,$57.00,$2583.00,$71729.00,154,$2583.00
2024-08-02,18:59:00,18514.75,SELL,3,0.02h,Stop Loss,$85.50,$2668.50,$71814.50,154,$2668.50
2024-08-02,19:04:00,18532.0,BUY,3,0.02h,Break Even,$-1.50,$2667.00,$71813.00,154,$2667.00
2024-08-02,19:05:00,18520.75,SELL,3,0.02h,Stop Loss,$76.50,$2743.50,$71889.50,154,$2743.50
2024-08-02,19:15:00,18540.25,BUY,3,0.02h,Stop Loss,$3.00,$2746.50,$71892.50,154,$2746.50
2024-08-02,19:39:00,18504.5,SELL,3,0.02h,Stop Loss,$85.50,$2832.00,$71978.00,154,$2832.00
2024-08-02,19:56:00,18555.25,BUY,3,0.02h,Stop Loss,$129.00,$2961.00,$72107.00,154,$2961.00
2024-08-02,20:32:00,18543.25,SELL,3,0.02h,Stop Loss,$9.00,$2970.00,$72116.00,154,$2970.00
,,,,,,,,,,,
2024-08-05,00:45:00,18242.25,BUY,3,0.02h,Stop Loss,$6.00,$6.00,$72122.00,155,$6.00
2024-08-05,00:49:00,18203.75,SELL,3,0.02h,Stop Loss,$91.50,$97.50,$72213.50,155,$97.50
2024-08-05,01:35:00,18124.75,BUY,3,0.02h,Stop Loss,$3.00,$100.50,$72216.50,155,$100.50
2024-08-05,01:48:00,18105.75,SELL,3,0.02h,Break Even,$-1.50,$99.00,$72215.00,155,$99.00
2024-08-05,01:58:00,18122.25,BUY,3,0.02h,Stop Loss,$18.00,$117.00,$72233.00,155,$117.00
2024-08-05,02:04:00,18106.0,SELL,3,0.02h,Stop Loss,$-9.00,$108.00,$72224.00,155,$108.00
2024-08-05,02:19:00,18127.5,BUY,3,0.02h,Stop Loss,$-9.00,$99.00,$72215.00,155,$99.00
2024-08-05,02:40:00,18131.75,SELL,3,0.02h,Stop Loss,$27.00,$126.00,$72242.00,155,$126.00
2024-08-05,06:32:00,17589.25,BUY,3,0.02h,Stop Loss,$297.00,$423.00,$72539.00,155,$423.00
2024-08-05,08:34:00,17889.75,SELL,3,0.02h,Stop Loss,$64.50,$487.50,$72603.50,155,$487.50
2024-08-05,09:32:00,17833.75,BUY,3,0.02h,Break Even,$-1.50,$486.00,$72602.00,155,$486.00
2024-08-05,09:36:00,17790.75,SELL,3,0.02h,Stop Loss,$301.50,$787.50,$72903.50,155,$787.50
2024-08-05,09:58:00,17802.25,BUY,3,0.02h,Stop Loss,$69.00,$856.50,$72972.50,155,$856.50
2024-08-05,10:26:00,17743.0,SELL,3,0.02h,Stop Loss,$205.50,$1062.00,$73178.00,155,$1062.00
2024-08-05,10:55:00,17723.0,BUY,3,0.02h,Break Even,$-1.50,$1060.50,$73176.50,155,$1060.50
2024-08-05,11:11:00,17724.25,SELL,3,0.02h,Stop Loss,$12.00,$1072.50,$73188.50,155,$1072.50
2024-08-05,11:13:00,17749.0,BUY,3,0.02h,Stop Loss,$174.00,$1246.50,$73362.50,155,$1246.50
2024-08-05,11:30:00,17723.25,SELL,3,0.02h,Stop Loss,$18.00,$1264.50,$73380.50,155,$1264.50
2024-08-05,12:42:00,17574.25,BUY,3,0.02h,Stop Loss,$91.50,$1356.00,$73472.00,155,$1356.00
2024-08-05,12:48:00,17481.25,SELL,3,0.02h,Stop Loss,$54.00,$1410.00,$73526.00,155,$1410.00
2024-08-05,12:56:00,17523.0,BUY,3,0.02h,Stop Loss,$49.50,$1459.50,$73575.50,155,$1459.50
2024-08-05,13:30:00,17564.25,SELL,3,0.02h,Stop Loss,$309.00,$1768.50,$73884.50,155,$1768.50
2024-08-05,13:34:00,17681.0,BUY,3,0.02h,Stop Loss,$148.50,$1917.00,$74033.00,155,$1917.00
2024-08-05,14:28:00,17906.75,SELL,3,0.02h,Stop Loss,$135.00,$2052.00,$74168.00,155,$2052.00
2024-08-05,14:37:00,17968.5,BUY,3,0.02h,Stop Loss,$78.00,$2130.00,$74246.00,155,$2130.00
2024-08-05,15:01:00,17918.0,SELL,3,0.02h,Stop Loss,$151.50,$2281.50,$74397.50,155,$2281.50
2024-08-05,15:08:00,18018.75,BUY,3,0.02h,Stop Loss,$601.50,$2883.00,$74999.00,155,$2883.00
2024-08-05,15:44:00,18080.75,SELL,3,0.02h,Stop Loss,$52.50,$2935.50,$75051.50,155,$2935.50
2024-08-05,16:04:00,18151.75,BUY,3,0.02h,Break Even,$-1.50,$2934.00,$75050.00,155,$2934.00
2024-08-05,16:38:00,18139.5,SELL,3,0.02h,Stop Loss,$48.00,$2982.00,$75098.00,155,$2982.00
2024-08-05,17:16:00,18104.25,BUY,3,0.02h,Stop Loss,$24.00,$3006.00,$75122.00,155,$3006.00
2024-08-05,17:50:00,18101.0,SELL,3,0.02h,Stop Loss,$31.50,$3037.50,$75153.50,155,$3037.50
2024-08-05,18:31:00,18052.5,BUY,3,0.02h,Stop Loss,$19.50,$3057.00,$75173.00,155,$3057.00
2024-08-05,18:39:00,17999.75,SELL,3,0.02h,Stop Loss,$19.50,$3076.50,$75192.50,155,$3076.50
2024-08-05,19:05:00,17996.0,BUY,3,0.02h,Stop Loss,$-9.00,$3067.50,$75183.50,155,$3067.50
2024-08-05,19:10:00,17926.75,SELL,3,0.02h,Break Even,$-1.50,$3066.00,$75182.00,155,$3066.00
2024-08-05,19:23:00,17948.0,BUY,3,0.02h,Stop Loss,$40.50,$3106.50,$75222.50,155,$3106.50
2024-08-05,19:45:00,17932.75,SELL,3,0.02h,Stop Loss,$25.50,$3132.00,$75248.00,155,$3132.00
2024-08-05,19:54:00,17968.25,BUY,3,0.02h,Break Even,$-1.50,$3130.50,$75246.50,155,$3130.50
,,,,,,,,,,,
2024-08-06,00:17:00,18256.75,SELL,3,0.02h,Stop Loss,$84.00,$84.00,$75330.50,156,$84.00
2024-08-06,00:36:00,18262.0,BUY,3,0.02h,Stop Loss,$66.00,$150.00,$75396.50,156,$150.00
2024-08-06,01:25:00,18336.0,SELL,3,0.02h,Stop Loss,$-9.00,$141.00,$75387.50,156,$141.00
2024-08-06,01:50:00,18357.75,BUY,3,0.02h,Stop Loss,$40.50,$181.50,$75428.00,156,$181.50
2024-08-06,02:09:00,18333.0,SELL,3,0.02h,Break Even,$-1.50,$180.00,$75426.50,156,$180.00
2024-08-06,02:27:00,18360.0,BUY,3,0.02h,Stop Loss,$-9.00,$171.00,$75417.50,156,$171.00
2024-08-06,02:31:00,18336.25,SELL,3,0.02h,Stop Loss,$48.00,$219.00,$75465.50,156,$219.00
2024-08-06,02:41:00,18349.0,BUY,3,0.02h,Stop Loss,$-9.00,$210.00,$75456.50,156,$210.00
2024-08-06,02:50:00,18339.5,SELL,3,0.02h,Break Even,$-1.50,$208.50,$75455.00,156,$208.50
2024-08-06,02:54:00,18347.25,BUY,3,0.02h,Stop Loss,$-9.00,$199.50,$75446.00,156,$199.50
2024-08-06,04:04:00,18391.0,SELL,3,0.02h,Stop Loss,$4.50,$204.00,$75450.50,156,$204.00
2024-08-06,04:24:00,18393.5,BUY,3,0.02h,Stop Loss,$7.50,$211.50,$75458.00,156,$211.50
2024-08-06,04:31:00,18384.5,SELL,3,0.02h,Stop Loss,$-9.00,$202.50,$75449.00,156,$202.50
2024-08-06,05:26:00,18305.75,BUY,3,0.02h,Stop Loss,$112.50,$315.00,$75561.50,156,$315.00
2024-08-06,05:51:00,18329.25,SELL,3,0.02h,Stop Loss,$73.50,$388.50,$75635.00,156,$388.50
2024-08-06,05:59:00,18346.5,BUY,3,0.02h,Stop Loss,$6.00,$394.50,$75641.00,156,$394.50
2024-08-06,06:01:00,18326.5,SELL,3,0.02h,Stop Loss,$108.00,$502.50,$75749.00,156,$502.50
2024-08-06,06:04:00,18350.0,BUY,3,0.02h,Stop Loss,$18.00,$520.50,$75767.00,156,$520.50
2024-08-06,06:05:00,18331.25,SELL,3,0.02h,Stop Loss,$52.50,$573.00,$75819.50,156,$573.00
2024-08-06,06:26:00,18347.0,BUY,3,0.02h,Break Even,$-1.50,$571.50,$75818.00,156,$571.50
2024-08-06,06:41:00,18304.0,SELL,3,0.02h,Stop Loss,$-9.00,$562.50,$75809.00,156,$562.50
2024-08-06,07:20:00,18289.5,BUY,3,0.02h,Stop Loss,$16.50,$579.00,$75825.50,156,$579.00
2024-08-06,07:31:00,18267.5,SELL,3,0.02h,Break Even,$-1.50,$577.50,$75824.00,156,$577.50
2024-08-06,07:33:00,18277.75,BUY,3,0.02h,Stop Loss,$24.00,$601.50,$75848.00,156,$601.50
2024-08-06,07:36:00,18260.0,SELL,3,0.02h,Stop Loss,$67.50,$669.00,$75915.50,156,$669.00
2024-08-06,08:33:00,18189.75,BUY,3,0.02h,Stop Loss,$42.00,$711.00,$75957.50,156,$711.00
2024-08-06,08:36:00,18164.25,SELL,3,0.02h,Stop Loss,$36.00,$747.00,$75993.50,156,$747.00
2024-08-06,08:50:00,18182.75,BUY,3,0.02h,Stop Loss,$147.00,$894.00,$76140.50,156,$894.00
2024-08-06,09:01:00,18147.0,SELL,3,0.02h,Stop Loss,$63.00,$957.00,$76203.50,156,$957.00
2024-08-06,09:27:00,18127.0,BUY,3,0.02h,Stop Loss,$-9.00,$948.00,$76194.50,156,$948.00
2024-08-06,09:29:00,18110.0,SELL,3,0.02h,Break Even,$-1.50,$946.50,$76193.00,156,$946.50
2024-08-06,09:30:00,18125.75,BUY,3,0.02h,Stop Loss,$-9.00,$937.50,$76184.00,156,$937.50
2024-08-06,09:31:00,18093.25,SELL,3,0.02h,Stop Loss,$118.50,$1056.00,$76302.50,156,$1056.00
2024-08-06,09:56:00,18086.75,BUY,3,0.02h,Stop Loss,$37.50,$1093.50,$76340.00,156,$1093.50
2024-08-06,10:08:00,18061.5,SELL,3,0.02h,Break Even,$-1.50,$1092.00,$76338.50,156,$1092.00
2024-08-06,10:12:00,18093.5,BUY,3,0.02h,Stop Loss,$78.00,$1170.00,$76416.50,156,$1170.00
2024-08-06,11:26:00,18188.0,SELL,3,0.02h,Stop Loss,$-9.00,$1161.00,$76407.50,156,$1161.00
2024-08-06,11:28:00,18198.0,BUY,3,0.02h,Stop Loss,$72.00,$1233.00,$76479.50,156,$1233.00
2024-08-06,11:41:00,18175.5,SELL,3,0.02h,Stop Loss,$109.50,$1342.50,$76589.00,156,$1342.50
2024-08-06,12:02:00,18178.0,BUY,3,0.02h,Stop Loss,$85.50,$1428.00,$76674.50,156,$1428.00
2024-08-06,12:08:00,18142.75,SELL,3,0.02h,Stop Loss,$30.00,$1458.00,$76704.50,156,$1458.00
2024-08-06,13:20:00,18102.25,BUY,3,0.02h,Stop Loss,$7.50,$1465.50,$76712.00,156,$1465.50
2024-08-06,13:25:00,18082.25,SELL,3,0.02h,Stop Loss,$3.00,$1468.50,$76715.00,156,$1468.50
2024-08-06,13:26:00,18105.75,BUY,3,0.02h,Stop Loss,$111.00,$1579.50,$76826.00,156,$1579.50
2024-08-06,13:38:00,18047.25,SELL,3,0.02h,Stop Loss,$21.00,$1600.50,$76847.00,156,$1600.50
2024-08-06,13:54:00,18117.25,BUY,3,0.02h,Stop Loss,$127.50,$1728.00,$76974.50,156,$1728.00
2024-08-06,14:31:00,18133.5,SELL,3,0.02h,Stop Loss,$10.50,$1738.50,$76985.00,156,$1738.50
2024-08-06,14:37:00,18193.5,BUY,3,0.02h,Stop Loss,$159.00,$1897.50,$77144.00,156,$1897.50
2024-08-06,15:14:00,18280.0,SELL,3,0.02h,Stop Loss,$82.50,$1980.00,$77226.50,156,$1980.00
2024-08-06,15:44:00,18250.25,BUY,3,0.02h,Stop Loss,$63.00,$2043.00,$77289.50,156,$2043.00
2024-08-06,16:27:00,18330.25,SELL,3,0.02h,Stop Loss,$9.00,$2052.00,$77298.50,156,$2052.00
2024-08-06,16:42:00,18358.75,BUY,3,0.02h,Stop Loss,$30.00,$2082.00,$77328.50,156,$2082.00
2024-08-06,17:19:00,18408.0,SELL,3,0.02h,Stop Loss,$24.00,$2106.00,$77352.50,156,$2106.00
2024-08-06,17:30:00,18422.75,BUY,3,0.02h,Stop Loss,$61.50,$2167.50,$77414.00,156,$2167.50
2024-08-06,17:44:00,18402.75,SELL,3,0.02h,Stop Loss,$15.00,$2182.50,$77429.00,156,$2182.50
2024-08-06,17:54:00,18428.0,BUY,3,0.02h,Stop Loss,$33.00,$2215.50,$77462.00,156,$2215.50
2024-08-06,18:04:00,18408.0,SELL,3,0.02h,Break Even,$-1.50,$2214.00,$77460.50,156,$2214.00
2024-08-06,18:18:00,18425.5,BUY,3,0.02h,Stop Loss,$69.00,$2283.00,$77529.50,156,$2283.00
2024-08-06,18:58:00,18442.75,SELL,3,0.02h,Stop Loss,$187.50,$2470.50,$77717.00,156,$2470.50
2024-08-06,19:26:00,18366.0,BUY,3,0.02h,Break Even,$-1.50,$2469.00,$77715.50,156,$2469.00
2024-08-06,19:37:00,18330.5,SELL,3,0.02h,Stop Loss,$6.00,$2475.00,$77721.50,156,$2475.00
2024-08-06,20:21:00,18265.5,BUY,3,0.02h,Break Even,$-1.50,$2473.50,$77720.00,156,$2473.50
2024-08-06,20:33:00,18181.25,SELL,3,0.02h,Stop Loss,$-9.00,$2464.50,$77711.00,156,$2464.50
,,,,,,,,,,,
2024-08-07,00:04:00,18077.0,BUY,3,0.02h,Stop Loss,$27.00,$27.00,$77738.00,157,$27.00
2024-08-07,00:56:00,18155.75,SELL,3,0.02h,Stop Loss,$37.50,$64.50,$77775.50,157,$64.50
2024-08-07,01:17:00,18167.0,BUY,3,0.02h,Break Even,$-1.50,$63.00,$77774.00,157,$63.00
2024-08-07,02:57:00,18347.0,SELL,3,0.02h,Stop Loss,$-9.00,$54.00,$77765.00,157,$54.00
2024-08-07,03:00:00,18351.0,BUY,3,0.02h,Break Even,$-1.50,$52.50,$77763.50,157,$52.50
2024-08-07,03:22:00,18354.75,SELL,3,0.02h,Stop Loss,$-9.00,$43.50,$77754.50,157,$43.50
2024-08-07,03:25:00,18377.5,BUY,3,0.02h,Break Even,$-1.50,$42.00,$77753.00,157,$42.00
2024-08-07,03:32:00,18364.75,SELL,3,0.02h,Stop Loss,$10.50,$52.50,$77763.50,157,$52.50
2024-08-07,03:38:00,18387.5,BUY,3,0.02h,Break Even,$-1.50,$51.00,$77762.00,157,$51.00
2024-08-07,04:20:00,18378.75,SELL,3,0.02h,Break Even,$-1.50,$49.50,$77760.50,157,$49.50
2024-08-07,04:37:00,18395.5,BUY,3,0.02h,Stop Loss,$45.00,$94.50,$77805.50,157,$94.50
2024-08-07,04:59:00,18397.0,SELL,3,0.02h,Stop Loss,$-9.00,$85.50,$77796.50,157,$85.50
2024-08-07,05:28:00,18392.75,BUY,3,0.02h,Break Even,$-1.50,$84.00,$77795.00,157,$84.00
2024-08-07,05:39:00,18366.0,SELL,3,0.02h,Stop Loss,$-9.00,$75.00,$77786.00,157,$75.00
2024-08-07,06:30:00,18317.75,BUY,3,0.02h,Stop Loss,$-9.00,$66.00,$77777.00,157,$66.00
2024-08-07,06:48:00,18302.25,SELL,3,0.02h,Stop Loss,$-9.00,$57.00,$77768.00,157,$57.00
2024-08-07,06:51:00,18316.0,BUY,3,0.02h,Stop Loss,$21.00,$78.00,$77789.00,157,$78.00
2024-08-07,06:55:00,18303.0,SELL,3,0.02h,Stop Loss,$-9.00,$69.00,$77780.00,157,$69.00
2024-08-07,07:10:00,18318.0,BUY,3,0.02h,Stop Loss,$85.50,$154.50,$77865.50,157,$154.50
2024-08-07,07:14:00,18299.75,SELL,3,0.02h,Stop Loss,$9.00,$163.50,$77874.50,157,$163.50
2024-08-07,07:37:00,18302.5,BUY,3,0.02h,Stop Loss,$55.50,$219.00,$77930.00,157,$219.00
2024-08-07,07:48:00,18277.0,SELL,3,0.02h,Stop Loss,$4.50,$223.50,$77934.50,157,$223.50
2024-08-07,07:49:00,18288.75,BUY,3,0.02h,Stop Loss,$42.00,$265.50,$77976.50,157,$265.50
2024-08-07,07:53:00,18271.75,SELL,3,0.02h,Stop Loss,$94.50,$360.00,$78071.00,157,$360.00
2024-08-07,08:04:00,18285.0,BUY,3,0.02h,Stop Loss,$25.50,$385.50,$78096.50,157,$385.50
2024-08-07,08:45:00,18341.5,SELL,3,0.02h,Stop Loss,$-9.00,$376.50,$78087.50,157,$376.50
2024-08-07,08:47:00,18354.25,BUY,3,0.02h,Stop Loss,$87.00,$463.50,$78174.50,157,$463.50
2024-08-07,09:46:00,18397.75,SELL,3,0.02h,Stop Loss,$28.50,$492.00,$78203.00,157,$492.00
2024-08-07,10:03:00,18422.75,BUY,3,0.02h,Stop Loss,$7.50,$499.50,$78210.50,157,$499.50
2024-08-07,10:08:00,18402.75,SELL,3,0.02h,Stop Loss,$10.50,$510.00,$78221.00,157,$510.00
2024-08-07,10:11:00,18422.0,BUY,3,0.02h,Stop Loss,$4.50,$514.50,$78225.50,157,$514.50
2024-08-07,10:24:00,18401.0,SELL,3,0.02h,Stop Loss,$-9.00,$505.50,$78216.50,157,$505.50
2024-08-07,10:30:00,18416.25,BUY,3,0.02h,Stop Loss,$46.50,$552.00,$78263.00,157,$552.00
2024-08-07,10:46:00,18410.75,SELL,3,0.02h,Stop Loss,$-9.00,$543.00,$78254.00,157,$543.00
2024-08-07,10:49:00,18427.75,BUY,3,0.02h,Stop Loss,$10.50,$553.50,$78264.50,157,$553.50
2024-08-07,11:30:00,18438.75,SELL,3,0.02h,Break Even,$-1.50,$552.00,$78263.00,157,$552.00
2024-08-07,12:11:00,18410.0,BUY,3,0.02h,Break Even,$-1.50,$550.50,$78261.50,157,$550.50
2024-08-07,12:24:00,18404.0,SELL,3,0.02h,Stop Loss,$63.00,$613.50,$78324.50,157,$613.50
2024-08-07,12:32:00,18428.25,BUY,3,0.02h,Stop Loss,$9.00,$622.50,$78333.50,157,$622.50
2024-08-07,12:55:00,18416.75,SELL,3,0.02h,Stop Loss,$9.00,$631.50,$78342.50,157,$631.50
2024-08-07,13:11:00,18440.0,BUY,3,0.02h,Stop Loss,$-9.00,$622.50,$78333.50,157,$622.50
2024-08-07,13:13:00,18418.5,SELL,3,0.02h,Stop Loss,$52.50,$675.00,$78386.00,157,$675.00
2024-08-07,13:26:00,18433.75,BUY,3,0.02h,Stop Loss,$16.50,$691.50,$78402.50,157,$691.50
2024-08-07,14:08:00,18503.25,SELL,3,0.02h,Stop Loss,$12.00,$703.50,$78414.50,157,$703.50
2024-08-07,14:10:00,18533.5,BUY,3,0.02h,Stop Loss,$52.50,$756.00,$78467.00,157,$756.00
2024-08-07,14:18:00,18482.75,SELL,3,0.02h,Stop Loss,$235.50,$991.50,$78702.50,157,$991.50
2024-08-07,14:45:00,18503.25,BUY,3,0.02h,Stop Loss,$120.00,$1111.50,$78822.50,157,$1111.50
2024-08-07,15:14:00,18491.75,SELL,3,0.02h,Stop Loss,$49.50,$1161.00,$78872.00,157,$1161.00
2024-08-07,16:22:00,18382.0,BUY,3,0.02h,Stop Loss,$22.50,$1183.50,$78894.50,157,$1183.50
2024-08-07,16:43:00,18351.5,SELL,3,0.02h,Stop Loss,$115.50,$1299.00,$79010.00,157,$1299.00
2024-08-07,17:38:00,18232.0,BUY,3,0.02h,Stop Loss,$69.00,$1368.00,$79079.00,157,$1368.00
2024-08-07,17:42:00,18196.0,SELL,3,0.02h,Stop Loss,$27.00,$1395.00,$79106.00,157,$1395.00
2024-08-07,18:30:00,18080.0,BUY,3,0.02h,Stop Loss,$-9.00,$1386.00,$79097.00,157,$1386.00
2024-08-07,18:32:00,18049.5,SELL,3,0.02h,Stop Loss,$111.00,$1497.00,$79208.00,157,$1497.00
2024-08-07,19:03:00,18085.25,BUY,3,0.02h,Stop Loss,$114.00,$1611.00,$79322.00,157,$1611.00
2024-08-07,19:27:00,18077.0,SELL,3,0.02h,Stop Loss,$64.50,$1675.50,$79386.50,157,$1675.50
2024-08-07,19:38:00,18103.25,BUY,3,0.02h,Stop Loss,$54.00,$1729.50,$79440.50,157,$1729.50
2024-08-07,19:41:00,18076.0,SELL,3,0.02h,Stop Loss,$19.50,$1749.00,$79460.00,157,$1749.00
2024-08-07,23:05:00,17897.75,BUY,3,0.02h,Stop Loss,$6.00,$1755.00,$79466.00,157,$1755.00
2024-08-07,23:10:00,17875.5,SELL,3,0.02h,Break Even,$-1.50,$1753.50,$79464.50,157,$1753.50
2024-08-07,23:51:00,17818.5,BUY,3,0.02h,Break Even,$-1.50,$1752.00,$79463.00,157,$1752.00
,,,,,,,,,,,
2024-08-08,00:40:00,17879.75,SELL,3,0.02h,Stop Loss,$-9.00,$-9.00,$79454.00,158,$-9.00
2024-08-08,00:59:00,17904.0,BUY,3,0.02h,Stop Loss,$12.00,$3.00,$79466.00,158,$3.00
2024-08-08,01:41:00,17949.0,SELL,3,0.02h,Stop Loss,$27.00,$30.00,$79493.00,158,$30.00
2024-08-08,01:53:00,17978.0,BUY,3,0.02h,Stop Loss,$30.00,$60.00,$79523.00,158,$60.00
2024-08-08,02:35:00,18008.5,SELL,3,0.02h,Stop Loss,$-9.00,$51.00,$79514.00,158,$51.00
2024-08-08,02:37:00,18028.75,BUY,3,0.02h,Break Even,$-1.50,$49.50,$79512.50,158,$49.50
2024-08-08,02:39:00,18015.5,SELL,3,0.02h,Break Even,$-1.50,$48.00,$79511.00,158,$48.00
2024-08-08,02:41:00,18025.25,BUY,3,0.02h,Stop Loss,$-9.00,$39.00,$79502.00,158,$39.00
2024-08-08,02:43:00,18012.25,SELL,3,0.02h,Break Even,$-1.50,$37.50,$79500.50,158,$37.50
2024-08-08,02:51:00,18037.25,BUY,3,0.02h,Stop Loss,$-9.00,$28.50,$79491.50,158,$28.50
2024-08-08,03:55:00,18053.0,SELL,3,0.02h,Stop Loss,$123.00,$151.50,$79614.50,158,$151.50
2024-08-08,04:18:00,18036.0,BUY,3,0.02h,Break Even,$-1.50,$150.00,$79613.00,158,$150.00
2024-08-08,04:28:00,17992.5,SELL,3,0.02h,Stop Loss,$-9.00,$141.00,$79604.00,158,$141.00
2024-08-08,04:59:00,17990.25,BUY,3,0.02h,Stop Loss,$27.00,$168.00,$79631.00,158,$168.00
2024-08-08,05:21:00,17992.0,SELL,3,0.02h,Stop Loss,$69.00,$237.00,$79700.00,158,$237.00
2024-08-08,06:12:00,17967.25,BUY,3,0.02h,Stop Loss,$78.00,$315.00,$79778.00,158,$315.00
2024-08-08,06:47:00,18010.0,SELL,3,0.02h,Stop Loss,$76.50,$391.50,$79854.50,158,$391.50
2024-08-08,06:56:00,18036.25,BUY,3,0.02h,Break Even,$-1.50,$390.00,$79853.00,158,$390.00
2024-08-08,07:03:00,17986.75,SELL,3,0.02h,Stop Loss,$63.00,$453.00,$79916.00,158,$453.00
2024-08-08,08:03:00,17947.25,BUY,3,0.02h,Stop Loss,$43.50,$496.50,$79959.50,158,$496.50
2024-08-08,08:24:00,17919.75,SELL,3,0.02h,Stop Loss,$12.00,$508.50,$79971.50,158,$508.50
2024-08-08,08:36:00,17940.75,BUY,3,0.02h,Stop Loss,$30.00,$538.50,$80001.50,158,$538.50
2024-08-08,09:18:00,17980.5,SELL,3,0.02h,Break Even,$-1.50,$537.00,$80000.00,158,$537.00
2024-08-08,09:21:00,17993.5,BUY,3,0.02h,Stop Loss,$-9.00,$528.00,$79991.00,158,$528.00
2024-08-08,09:22:00,17979.25,SELL,3,0.02h,Stop Loss,$-9.00,$519.00,$79982.00,158,$519.00
2024-08-08,10:15:00,17954.5,BUY,3,0.02h,Break Even,$-1.50,$517.50,$79980.50,158,$517.50
2024-08-08,10:52:00,17970.75,SELL,3,0.02h,Stop Loss,$13.50,$531.00,$79994.00,158,$531.00
2024-08-08,11:11:00,17982.25,BUY,3,0.02h,Stop Loss,$10.50,$541.50,$80004.50,158,$541.50
2024-08-08,11:31:00,17969.5,SELL,3,0.02h,Break Even,$-1.50,$540.00,$80003.00,158,$540.00
2024-08-08,11:36:00,17987.0,BUY,3,0.02h,Stop Loss,$-9.00,$531.00,$79994.00,158,$531.00
2024-08-08,12:05:00,17984.75,SELL,3,0.02h,Break Even,$-1.50,$529.50,$79992.50,158,$529.50
2024-08-08,12:09:00,17996.5,BUY,3,0.02h,Stop Loss,$-9.00,$520.50,$79983.50,158,$520.50
2024-08-08,12:19:00,17987.75,SELL,3,0.02h,Break Even,$-1.50,$519.00,$79982.00,158,$519.00
2024-08-08,12:31:00,18128.0,BUY,3,0.02h,Stop Loss,$18.00,$537.00,$80000.00,158,$537.00
2024-08-08,13:38:00,18163.75,SELL,3,0.02h,Stop Loss,$103.50,$640.50,$80103.50,158,$640.50
2024-08-08,13:59:00,18174.5,BUY,3,0.02h,Stop Loss,$214.50,$855.00,$80318.00,158,$855.00
2024-08-08,15:08:00,18383.5,SELL,3,0.02h,Stop Loss,$39.00,$894.00,$80357.00,158,$894.00
2024-08-08,15:25:00,18395.75,BUY,3,0.02h,Stop Loss,$10.50,$904.50,$80367.50,158,$904.50
2024-08-08,15:42:00,18377.75,SELL,3,0.02h,Stop Loss,$19.50,$924.00,$80387.00,158,$924.00
2024-08-08,15:43:00,18389.25,BUY,3,0.02h,Stop Loss,$-9.00,$915.00,$80378.00,158,$915.00
2024-08-08,15:47:00,18376.0,SELL,3,0.02h,Break Even,$-1.50,$913.50,$80376.50,158,$913.50
2024-08-08,15:55:00,18396.75,BUY,3,0.02h,Stop Loss,$31.50,$945.00,$80408.00,158,$945.00
2024-08-08,16:31:00,18408.5,SELL,3,0.02h,Stop Loss,$132.00,$1077.00,$80540.00,158,$1077.00
2024-08-08,16:53:00,18411.0,BUY,3,0.02h,Stop Loss,$51.00,$1128.00,$80591.00,158,$1128.00
2024-08-08,17:03:00,18381.25,SELL,3,0.02h,Stop Loss,$61.50,$1189.50,$80652.50,158,$1189.50
2024-08-08,17:13:00,18412.0,BUY,3,0.02h,Stop Loss,$61.50,$1251.00,$80714.00,158,$1251.00
2024-08-08,18:28:00,18498.75,SELL,3,0.02h,Break Even,$-1.50,$1249.50,$80712.50,158,$1249.50
2024-08-08,19:13:00,18506.0,BUY,3,0.02h,Stop Loss,$6.00,$1255.50,$80718.50,158,$1255.50
2024-08-08,19:18:00,18484.75,SELL,3,0.02h,Stop Loss,$70.50,$1326.00,$80789.00,158,$1326.00
2024-08-08,19:23:00,18501.0,BUY,3,0.02h,Stop Loss,$21.00,$1347.00,$80810.00,158,$1347.00
2024-08-08,19:29:00,18463.25,SELL,3,0.02h,Stop Loss,$127.50,$1474.50,$80937.50,158,$1474.50
2024-08-08,19:44:00,18495.0,BUY,3,0.02h,Stop Loss,$75.00,$1549.50,$81012.50,158,$1549.50
2024-08-08,20:53:00,18563.0,SELL,3,0.02h,Break Even,$-1.50,$1548.00,$81011.00,158,$1548.00
2024-08-08,20:56:00,18566.0,BUY,3,0.02h,Stop Loss,$-9.00,$1539.00,$81002.00,158,$1539.00
2024-08-08,21:00:00,18557.5,SELL,3,2.00h,Break Even,$-1.50,$1537.50,$81000.50,158,$1537.50
2024-08-08,23:04:00,18568.75,BUY,3,0.02h,Stop Loss,$10.50,$1548.00,$81011.00,158,$1548.00
2024-08-08,23:25:00,18572.5,SELL,3,0.02h,Stop Loss,$48.00,$1596.00,$81059.00,158,$1596.00
2024-08-08,23:43:00,18583.5,BUY,3,0.02h,Stop Loss,$10.50,$1606.50,$81069.50,158,$1606.50
,,,,,,,,,,,
2024-08-09,00:02:00,18569.0,SELL,3,0.02h,Break Even,$-1.50,$-1.50,$81068.00,159,$-1.50
2024-08-09,00:53:00,18534.75,BUY,3,0.02h,Stop Loss,$-9.00,$-10.50,$81059.00,159,$-10.50
2024-08-09,00:58:00,18521.75,SELL,3,0.02h,Stop Loss,$15.00,$4.50,$81074.00,159,$4.50
2024-08-09,01:04:00,18530.0,BUY,3,0.02h,Stop Loss,$39.00,$43.50,$81113.00,159,$43.50
2024-08-09,01:18:00,18523.75,SELL,3,0.02h,Break Even,$-1.50,$42.00,$81111.50,159,$42.00
2024-08-09,01:31:00,18533.25,BUY,3,0.02h,Break Even,$-1.50,$40.50,$81110.00,159,$40.50
2024-08-09,02:01:00,18536.0,SELL,3,0.02h,Stop Loss,$-9.00,$31.50,$81101.00,159,$31.50
2024-08-09,02:06:00,18550.0,BUY,3,0.02h,Stop Loss,$25.50,$57.00,$81126.50,159,$57.00
2024-08-09,03:15:00,18579.75,SELL,3,0.02h,Stop Loss,$7.50,$64.50,$81134.00,159,$64.50
2024-08-09,03:56:00,18566.0,BUY,3,0.02h,Break Even,$-1.50,$63.00,$81132.50,159,$63.00
2024-08-09,04:30:00,18564.25,SELL,3,0.02h,Stop Loss,$16.50,$79.50,$81149.00,159,$79.50
2024-08-09,05:19:00,18482.5,BUY,3,0.02h,Stop Loss,$-9.00,$70.50,$81140.00,159,$70.50
2024-08-09,06:03:00,18511.0,SELL,3,0.02h,Stop Loss,$55.50,$126.00,$81195.50,159,$126.00
2024-08-09,06:17:00,18514.25,BUY,3,0.02h,Stop Loss,$-9.00,$117.00,$81186.50,159,$117.00
2024-08-09,06:18:00,18507.0,SELL,3,0.02h,Stop Loss,$18.00,$135.00,$81204.50,159,$135.00
2024-08-09,06:31:00,18514.75,BUY,3,0.02h,Stop Loss,$-9.00,$126.00,$81195.50,159,$126.00
2024-08-09,07:02:00,18509.25,SELL,3,0.02h,Stop Loss,$39.00,$165.00,$81234.50,159,$165.00
2024-08-09,07:12:00,18544.75,BUY,3,0.02h,Break Even,$-1.50,$163.50,$81233.00,159,$163.50
2024-08-09,07:27:00,18513.5,SELL,3,0.02h,Break Even,$-1.50,$162.00,$81231.50,159,$162.00
2024-08-09,07:30:00,18542.5,BUY,3,0.02h,Stop Loss,$33.00,$195.00,$81264.50,159,$195.00
2024-08-09,07:46:00,18529.0,SELL,3,0.02h,Stop Loss,$79.50,$274.50,$81344.00,159,$274.50
2024-08-09,07:54:00,18545.25,BUY,3,0.02h,Break Even,$-1.50,$273.00,$81342.50,159,$273.00
2024-08-09,09:08:00,18625.5,SELL,3,0.02h,Stop Loss,$-9.00,$264.00,$81333.50,159,$264.00
2024-08-09,09:09:00,18639.75,BUY,3,0.02h,Stop Loss,$-9.00,$255.00,$81324.50,159,$255.00
2024-08-09,09:14:00,18630.0,SELL,3,0.02h,Stop Loss,$-9.00,$246.00,$81315.50,159,$246.00
2024-08-09,09:17:00,18641.5,BUY,3,0.02h,Break Even,$-1.50,$244.50,$81314.00,159,$244.50
2024-08-09,09:23:00,18630.75,SELL,3,0.02h,Break Even,$-1.50,$243.00,$81312.50,159,$243.00
2024-08-09,09:57:00,18619.75,BUY,3,0.02h,Break Even,$-1.50,$241.50,$81311.00,159,$241.50
2024-08-09,10:02:00,18604.25,SELL,3,0.02h,Stop Loss,$69.00,$310.50,$81380.00,159,$310.50
2024-08-09,10:31:00,18586.5,BUY,3,0.02h,Break Even,$-1.50,$309.00,$81378.50,159,$309.00
2024-08-09,10:40:00,18566.5,SELL,3,0.02h,Break Even,$-1.50,$307.50,$81377.00,159,$307.50
2024-08-09,11:02:00,18574.5,BUY,3,0.02h,Stop Loss,$45.00,$352.50,$81422.00,159,$352.50
2024-08-09,11:24:00,18567.25,SELL,3,0.02h,Stop Loss,$13.50,$366.00,$81435.50,159,$366.00
2024-08-09,11:58:00,18527.75,BUY,3,0.02h,Stop Loss,$-9.00,$357.00,$81426.50,159,$357.00
2024-08-09,12:03:00,18511.75,SELL,3,0.02h,Stop Loss,$73.50,$430.50,$81500.00,159,$430.50
2024-08-09,12:53:00,18439.25,BUY,3,0.02h,Break Even,$-1.50,$429.00,$81498.50,159,$429.00
2024-08-09,12:55:00,18420.75,SELL,3,0.02h,Stop Loss,$-9.00,$420.00,$81489.50,159,$420.00
2024-08-09,12:57:00,18440.75,BUY,3,0.02h,Stop Loss,$-9.00,$411.00,$81480.50,159,$411.00
2024-08-09,13:00:00,18424.0,SELL,3,0.02h,Stop Loss,$67.50,$478.50,$81548.00,159,$478.50
2024-08-09,13:07:00,18439.75,BUY,3,0.02h,Break Even,$-1.50,$477.00,$81546.50,159,$477.00
2024-08-09,13:25:00,18429.25,SELL,3,0.02h,Stop Loss,$-9.00,$468.00,$81537.50,159,$468.00
2024-08-09,13:29:00,18448.0,BUY,3,0.02h,Stop Loss,$28.50,$496.50,$81566.00,159,$496.50
2024-08-09,13:47:00,18437.0,SELL,3,0.02h,Break Even,$-1.50,$495.00,$81564.50,159,$495.00
2024-08-09,13:54:00,18475.25,BUY,3,0.02h,Stop Loss,$45.00,$540.00,$81609.50,159,$540.00
2024-08-09,13:57:00,18437.5,SELL,3,0.02h,Stop Loss,$46.50,$586.50,$81656.00,159,$586.50
2024-08-09,14:05:00,18490.5,BUY,3,0.02h,Break Even,$-1.50,$585.00,$81654.50,159,$585.00
2024-08-09,14:30:00,18495.25,SELL,3,0.02h,Stop Loss,$129.00,$714.00,$81783.50,159,$714.00
2024-08-09,14:48:00,18501.0,BUY,3,0.02h,Stop Loss,$46.50,$760.50,$81830.00,159,$760.50
2024-08-09,15:25:00,18535.0,SELL,3,0.02h,Stop Loss,$-9.00,$751.50,$81821.00,159,$751.50
2024-08-09,15:27:00,18546.5,BUY,3,0.02h,Stop Loss,$40.50,$792.00,$81861.50,159,$792.00
2024-08-09,15:29:00,18531.5,SELL,3,0.02h,Stop Loss,$127.50,$919.50,$81989.00,159,$919.50
2024-08-09,15:50:00,18530.0,BUY,3,0.02h,Stop Loss,$7.50,$927.00,$81996.50,159,$927.00
2024-08-09,15:57:00,18481.25,SELL,3,0.02h,Stop Loss,$30.00,$957.00,$82026.50,159,$957.00
2024-08-09,16:30:00,18481.25,BUY,3,0.02h,Stop Loss,$105.00,$1062.00,$82131.50,159,$1062.00
2024-08-09,17:51:00,18619.25,SELL,3,0.02h,Break Even,$-1.50,$1060.50,$82130.00,159,$1060.50
2024-08-09,18:41:00,18601.0,BUY,3,0.02h,Stop Loss,$3.00,$1063.50,$82133.00,159,$1063.50
2024-08-09,18:53:00,18584.5,SELL,3,0.02h,Stop Loss,$73.50,$1137.00,$82206.50,159,$1137.00
2024-08-09,19:08:00,18600.0,BUY,3,0.02h,Stop Loss,$19.50,$1156.50,$82226.00,159,$1156.50
2024-08-09,19:54:00,18596.5,SELL,3,0.02h,Stop Loss,$100.50,$1257.00,$82326.50,159,$1257.00
2024-08-09,20:04:00,18617.75,BUY,3,0.02h,Break Even,$-1.50,$1255.50,$82325.00,159,$1255.50
2024-08-09,20:22:00,18608.5,SELL,3,0.02h,Stop Loss,$-9.00,$1246.50,$82316.00,159,$1246.50
,,,,,,,,,,,
2024-08-12,00:00:00,18627.5,BUY,3,0.02h,Stop Loss,$6.00,$6.00,$82322.00,160,$6.00
2024-08-12,00:10:00,18598.0,SELL,3,0.02h,Stop Loss,$-9.00,$-3.00,$82313.00,160,$-3.00
2024-08-12,00:18:00,18617.0,BUY,3,0.02h,Stop Loss,$7.50,$4.50,$82320.50,160,$4.50
2024-08-12,00:33:00,18604.5,SELL,3,0.02h,Stop Loss,$-9.00,$-4.50,$82311.50,160,$-4.50
2024-08-12,00:36:00,18614.0,BUY,3,0.02h,Stop Loss,$-9.00,$-13.50,$82302.50,160,$-13.50
2024-08-12,01:00:00,18604.5,SELL,3,0.02h,Stop Loss,$30.00,$16.50,$82332.50,160,$16.50
2024-08-12,01:16:00,18613.0,BUY,3,0.02h,Stop Loss,$15.00,$31.50,$82347.50,160,$31.50
2024-08-12,01:37:00,18609.5,SELL,3,0.02h,Break Even,$-1.50,$30.00,$82346.00,160,$30.00
2024-08-12,01:56:00,18609.0,BUY,3,0.02h,Break Even,$-1.50,$28.50,$82344.50,160,$28.50
2024-08-12,01:59:00,18605.5,SELL,3,0.02h,Stop Loss,$-9.00,$19.50,$82335.50,160,$19.50
2024-08-12,02:00:00,18608.0,BUY,3,0.02h,Stop Loss,$64.50,$84.00,$82400.00,160,$84.00
2024-08-12,03:22:00,18648.25,SELL,3,0.02h,Stop Loss,$-9.00,$75.00,$82391.00,160,$75.00
2024-08-12,03:58:00,18635.5,BUY,3,0.02h,Break Even,$-1.50,$73.50,$82389.50,160,$73.50
2024-08-12,04:10:00,18624.5,SELL,3,0.02h,Stop Loss,$-9.00,$64.50,$82380.50,160,$64.50
2024-08-12,04:11:00,18636.0,BUY,3,0.02h,Stop Loss,$-9.00,$55.50,$82371.50,160,$55.50
2024-08-12,04:12:00,18631.0,SELL,3,0.02h,Break Even,$-1.50,$54.00,$82370.00,160,$54.00
2024-08-12,04:23:00,18633.25,BUY,3,0.02h,Stop Loss,$-9.00,$45.00,$82361.00,160,$45.00
2024-08-12,05:16:00,18645.25,SELL,3,0.02h,Break Even,$-1.50,$43.50,$82359.50,160,$43.50
2024-08-12,05:28:00,18650.75,BUY,3,0.02h,Break Even,$-1.50,$42.00,$82358.00,160,$42.00
2024-08-12,05:30:00,18645.0,SELL,3,0.02h,Stop Loss,$-9.00,$33.00,$82349.00,160,$33.00
2024-08-12,05:55:00,18650.5,BUY,3,0.02h,Break Even,$-1.50,$31.50,$82347.50,160,$31.50
2024-08-12,06:05:00,18637.75,SELL,3,0.02h,Stop Loss,$31.50,$63.00,$82379.00,160,$63.00
2024-08-12,06:49:00,18630.0,BUY,3,0.02h,Stop Loss,$-9.00,$54.00,$82370.00,160,$54.00
2024-08-12,06:52:00,18620.25,SELL,3,0.02h,Stop Loss,$-9.00,$45.00,$82361.00,160,$45.00
2024-08-12,06:57:00,18625.5,BUY,3,0.02h,Break Even,$-1.50,$43.50,$82359.50,160,$43.50
2024-08-12,07:02:00,18619.75,SELL,3,0.02h,Break Even,$-1.50,$42.00,$82358.00,160,$42.00
2024-08-12,07:04:00,18634.0,BUY,3,0.02h,Stop Loss,$31.50,$73.50,$82389.50,160,$73.50
2024-08-12,07:17:00,18606.75,SELL,3,0.02h,Stop Loss,$4.50,$78.00,$82394.00,160,$78.00
2024-08-12,07:28:00,18636.0,BUY,3,0.02h,Break Even,$-1.50,$76.50,$82392.50,160,$76.50
2024-08-12,08:19:00,18670.0,SELL,3,0.02h,Break Even,$-1.50,$75.00,$82391.00,160,$75.00
2024-08-12,08:26:00,18681.5,BUY,3,0.02h,Stop Loss,$-9.00,$66.00,$82382.00,160,$66.00
2024-08-12,08:32:00,18671.5,SELL,3,0.02h,Stop Loss,$-9.00,$57.00,$82373.00,160,$57.00
2024-08-12,08:33:00,18677.25,BUY,3,0.02h,Stop Loss,$-9.00,$48.00,$82364.00,160,$48.00
2024-08-12,08:35:00,18669.25,SELL,3,0.02h,Break Even,$-1.50,$46.50,$82362.50,160,$46.50
2024-08-12,09:17:00,18647.25,BUY,3,0.02h,Stop Loss,$30.00,$76.50,$82392.50,160,$76.50
2024-08-12,09:31:00,18641.25,SELL,3,0.02h,Stop Loss,$-9.00,$67.50,$82383.50,160,$67.50
2024-08-12,09:39:00,18652.25,BUY,3,0.02h,Stop Loss,$25.50,$93.00,$82409.00,160,$93.00
2024-08-12,10:02:00,18645.0,SELL,3,0.02h,Stop Loss,$27.00,$120.00,$82436.00,160,$120.00
2024-08-12,10:15:00,18653.25,BUY,3,0.02h,Break Even,$-1.50,$118.50,$82434.50,160,$118.50
2024-08-12,10:53:00,18660.75,SELL,3,0.02h,Break Even,$-1.50,$117.00,$82433.00,160,$117.00
2024-08-12,11:13:00,18664.75,BUY,3,0.02h,Stop Loss,$13.50,$130.50,$82446.50,160,$130.50
2024-08-12,11:34:00,18657.5,SELL,3,0.02h,Stop Loss,$-9.00,$121.50,$82437.50,160,$121.50
2024-08-12,11:54:00,18660.75,BUY,3,0.02h,Break Even,$-1.50,$120.00,$82436.00,160,$120.00
2024-08-12,12:40:00,18670.75,SELL,3,0.02h,Break Even,$-1.50,$118.50,$82434.50,160,$118.50
2024-08-12,13:03:00,18671.0,BUY,3,0.02h,Stop Loss,$-9.00,$109.50,$82425.50,160,$109.50
2024-08-12,13:10:00,18655.0,SELL,3,0.02h,Stop Loss,$-9.00,$100.50,$82416.50,160,$100.50
2024-08-12,13:27:00,18663.0,BUY,3,0.02h,Break Even,$-1.50,$99.00,$82415.00,160,$99.00
2024-08-12,13:29:00,18639.25,SELL,3,0.02h,Break Even,$-1.50,$97.50,$82413.50,160,$97.50
2024-08-12,14:07:00,18605.25,BUY,3,0.02h,Stop Loss,$58.50,$156.00,$82472.00,160,$156.00
2024-08-12,15:23:00,18682.0,SELL,3,0.02h,Stop Loss,$247.50,$403.50,$82719.50,160,$403.50
2024-08-12,15:51:00,18670.75,BUY,3,0.02h,Stop Loss,$81.00,$484.50,$82800.50,160,$484.50
2024-08-12,16:19:00,18686.25,SELL,3,0.02h,Break Even,$-1.50,$483.00,$82799.00,160,$483.00
2024-08-12,16:26:00,18699.75,BUY,3,0.02h,Stop Loss,$4.50,$487.50,$82803.50,160,$487.50
2024-08-12,16:29:00,18685.25,SELL,3,0.02h,Break Even,$-1.50,$486.00,$82802.00,160,$486.00
2024-08-12,16:30:00,18694.75,BUY,3,0.02h,Stop Loss,$22.50,$508.50,$82824.50,160,$508.50
2024-08-12,16:37:00,18688.75,SELL,3,0.02h,Stop Loss,$13.50,$522.00,$82838.00,160,$522.00
2024-08-12,16:40:00,18709.75,BUY,3,0.02h,Stop Loss,$16.50,$538.50,$82854.50,160,$538.50
2024-08-12,16:43:00,18686.5,SELL,3,0.02h,Stop Loss,$-9.00,$529.50,$82845.50,160,$529.50
2024-08-12,16:44:00,18698.75,BUY,3,0.02h,Break Even,$-1.50,$528.00,$82844.00,160,$528.00
2024-08-12,16:53:00,18686.25,SELL,3,0.02h,Break Even,$-1.50,$526.50,$82842.50,160,$526.50
2024-08-12,17:20:00,18664.0,BUY,3,0.02h,Stop Loss,$42.00,$568.50,$82884.50,160,$568.50
2024-08-12,17:39:00,18642.75,SELL,3,0.02h,Stop Loss,$-9.00,$559.50,$82875.50,160,$559.50
2024-08-12,18:17:00,18627.0,BUY,3,0.02h,Break Even,$-1.50,$558.00,$82874.00,160,$558.00
2024-08-12,18:31:00,18608.75,SELL,3,0.02h,Break Even,$-1.50,$556.50,$82872.50,160,$556.50
2024-08-12,18:37:00,18629.25,BUY,3,0.02h,Stop Loss,$4.50,$561.00,$82877.00,160,$561.00
2024-08-12,19:09:00,18619.25,SELL,3,0.02h,Stop Loss,$19.50,$580.50,$82896.50,160,$580.50
2024-08-12,19:13:00,18635.0,BUY,3,0.02h,Stop Loss,$-9.00,$571.50,$82887.50,160,$571.50
2024-08-12,19:14:00,18617.0,SELL,3,0.02h,Stop Loss,$4.50,$576.00,$82892.00,160,$576.00
2024-08-12,19:26:00,18631.25,BUY,3,0.02h,Stop Loss,$25.50,$601.50,$82917.50,160,$601.50
2024-08-12,19:30:00,18620.5,SELL,3,0.02h,Stop Loss,$-9.00,$592.50,$82908.50,160,$592.50
2024-08-12,19:31:00,18631.5,BUY,3,0.02h,Break Even,$-1.50,$591.00,$82907.00,160,$591.00
2024-08-12,19:33:00,18623.75,SELL,3,0.02h,Stop Loss,$18.00,$609.00,$82925.00,160,$609.00
2024-08-12,19:59:00,18618.25,BUY,3,0.02h,Stop Loss,$156.00,$765.00,$83081.00,160,$765.00
2024-08-12,20:30:00,18631.5,SELL,3,0.02h,Break Even,$-1.50,$763.50,$83079.50,160,$763.50
2024-08-12,23:00:00,18641.0,BUY,3,0.02h,Break Even,$-1.50,$762.00,$83078.00,160,$762.00
2024-08-12,23:41:00,18642.75,SELL,3,0.02h,Break Even,$-1.50,$760.50,$83076.50,160,$760.50
2024-08-12,23:56:00,18648.25,BUY,3,0.02h,Stop Loss,$-9.00,$751.50,$83067.50,160,$751.50
,,,,,,,,,,,
2024-08-13,00:14:00,18647.75,SELL,3,0.02h,Break Even,$-1.50,$-1.50,$83066.00,161,$-1.50
2024-08-13,00:16:00,18651.75,BUY,3,0.02h,Break Even,$-1.50,$-3.00,$83064.50,161,$-3.00
2024-08-13,00:18:00,18644.75,SELL,3,0.02h,Break Even,$-1.50,$-4.50,$83063.00,161,$-4.50
2024-08-13,00:33:00,18650.0,BUY,3,0.02h,Break Even,$-1.50,$-6.00,$83061.50,161,$-6.00
2024-08-13,01:08:00,18653.25,SELL,3,0.02h,Stop Loss,$6.00,$0.00,$83067.50,161,$0.00
2024-08-13,01:21:00,18661.0,BUY,3,0.02h,Stop Loss,$-9.00,$-9.00,$83058.50,161,$-9.00
2024-08-13,01:23:00,18651.25,SELL,3,0.02h,Stop Loss,$-9.00,$-18.00,$83049.50,161,$-18.00
2024-08-13,01:36:00,18661.0,BUY,3,0.02h,Break Even,$-1.50,$-19.50,$83048.00,161,$-19.50
2024-08-13,01:52:00,18657.75,SELL,3,0.02h,Stop Loss,$-9.00,$-28.50,$83039.00,161,$-28.50
2024-08-13,01:53:00,18660.25,BUY,3,0.02h,Break Even,$-1.50,$-30.00,$83037.50,161,$-30.00
2024-08-13,01:56:00,18656.75,SELL,3,0.02h,Stop Loss,$-9.00,$-39.00,$83028.50,161,$-39.00
2024-08-13,02:05:00,18661.75,BUY,3,0.02h,Break Even,$-1.50,$-40.50,$83027.00,161,$-40.50
2024-08-13,02:28:00,18657.25,SELL,3,0.02h,Break Even,$-1.50,$-42.00,$83025.50,161,$-42.00
2024-08-13,02:37:00,18662.25,BUY,3,0.02h,Break Even,$-1.50,$-43.50,$83024.00,161,$-43.50
2024-08-13,03:27:00,18667.75,SELL,3,0.02h,Stop Loss,$-9.00,$-52.50,$83015.00,161,$-52.50
2024-08-13,03:47:00,18678.25,BUY,3,0.02h,Break Even,$-1.50,$-54.00,$83013.50,161,$-54.00
2024-08-13,03:50:00,18671.75,SELL,3,0.02h,Stop Loss,$-9.00,$-63.00,$83004.50,161,$-63.00
2024-08-13,03:52:00,18677.5,BUY,3,0.02h,Stop Loss,$-9.00,$-72.00,$82995.50,161,$-72.00
2024-08-13,03:54:00,18673.5,SELL,3,0.02h,Stop Loss,$-9.00,$-81.00,$82986.50,161,$-81.00
2024-08-13,04:08:00,18677.5,BUY,3,0.02h,Stop Loss,$-9.00,$-90.00,$82977.50,161,$-90.00
2024-08-13,05:07:00,18686.75,SELL,3,0.02h,Stop Loss,$-9.00,$-99.00,$82968.50,161,$-99.00
2024-08-13,05:09:00,18691.0,BUY,3,0.02h,Stop Loss,$-9.00,$-108.00,$82959.50,161,$-108.00
2024-08-13,05:10:00,18689.25,SELL,3,0.02h,Stop Loss,$-9.00,$-117.00,$82950.50,161,$-117.00
2024-08-13,05:12:00,18691.5,BUY,3,0.02h,Stop Loss,$6.00,$-111.00,$82956.50,161,$-111.00
2024-08-13,05:47:00,18698.5,SELL,3,0.02h,Stop Loss,$-9.00,$-120.00,$82947.50,161,$-120.00
2024-08-13,05:54:00,18706.0,BUY,3,0.02h,Stop Loss,$-9.00,$-129.00,$82938.50,161,$-129.00
2024-08-13,05:56:00,18699.75,SELL,3,0.02h,Stop Loss,$-9.00,$-138.00,$82929.50,161,$-138.00
2024-08-13,06:00:00,18706.75,BUY,3,0.02h,Break Even,$-1.50,$-139.50,$82928.00,161,$-139.50
2024-08-13,06:02:00,18698.5,SELL,3,0.02h,Stop Loss,$21.00,$-118.50,$82949.00,161,$-118.50
2024-08-13,06:18:00,18705.25,BUY,3,0.02h,Break Even,$-1.50,$-120.00,$82947.50,161,$-120.00
2024-08-13,06:29:00,18699.5,SELL,3,0.02h,Stop Loss,$-9.00,$-129.00,$82938.50,161,$-129.00
2024-08-13,06:39:00,18706.25,BUY,3,0.02h,Break Even,$-1.50,$-130.50,$82937.00,161,$-130.50
2024-08-13,07:35:00,18775.5,SELL,3,0.02h,Stop Loss,$-9.00,$-139.50,$82928.00,161,$-139.50
2024-08-13,07:58:00,18782.75,BUY,3,0.02h,Stop Loss,$-9.00,$-148.50,$82919.00,161,$-148.50
2024-08-13,07:59:00,18777.0,SELL,3,0.02h,Break Even,$-1.50,$-150.00,$82917.50,161,$-150.00
2024-08-13,09:07:00,18746.75,BUY,3,0.02h,Stop Loss,$-9.00,$-159.00,$82908.50,161,$-159.00
2024-08-13,09:08:00,18734.25,SELL,3,0.02h,Stop Loss,$13.50,$-145.50,$82922.00,161,$-145.50
2024-08-13,09:27:00,18743.75,BUY,3,0.02h,Stop Loss,$10.50,$-135.00,$82932.50,161,$-135.00
2024-08-13,09:57:00,18746.0,SELL,3,0.02h,Stop Loss,$-9.00,$-144.00,$82923.50,161,$-144.00
2024-08-13,11:09:00,18672.75,BUY,3,0.02h,Stop Loss,$15.00,$-129.00,$82938.50,161,$-129.00
2024-08-13,13:17:00,18800.0,SELL,3,0.02h,Break Even,$-1.50,$-130.50,$82937.00,161,$-130.50
2024-08-13,13:19:00,18813.5,BUY,3,0.02h,Stop Loss,$-9.00,$-139.50,$82928.00,161,$-139.50
2024-08-13,14:19:00,18878.0,SELL,3,0.02h,Break Even,$-1.50,$-141.00,$82926.50,161,$-141.00
2024-08-13,14:27:00,18902.75,BUY,3,0.02h,Stop Loss,$28.50,$-112.50,$82955.00,161,$-112.50
2024-08-13,14:32:00,18873.5,SELL,3,0.02h,Stop Loss,$12.00,$-100.50,$82967.00,161,$-100.50
2024-08-13,14:38:00,18903.0,BUY,3,0.02h,Stop Loss,$-9.00,$-109.50,$82958.00,161,$-109.50
2024-08-13,17:27:00,19067.0,SELL,3,0.02h,Stop Loss,$43.50,$-66.00,$83001.50,161,$-66.00
2024-08-13,17:32:00,19078.5,BUY,3,0.02h,Stop Loss,$13.50,$-52.50,$83015.00,161,$-52.50
2024-08-13,17:34:00,19065.5,SELL,3,0.02h,Stop Loss,$49.50,$-3.00,$83064.50,161,$-3.00
2024-08-13,17:44:00,19079.0,BUY,3,0.02h,Break Even,$-1.50,$-4.50,$83063.00,161,$-4.50
2024-08-13,17:47:00,19015.75,SELL,3,0.02h,Stop Loss,$10.50,$6.00,$83073.50,161,$6.00
2024-08-13,18:06:00,19059.0,BUY,3,0.02h,Stop Loss,$24.00,$30.00,$83097.50,161,$30.00
2024-08-13,18:19:00,19045.0,SELL,3,0.02h,Break Even,$-1.50,$28.50,$83096.00,161,$28.50
2024-08-13,18:24:00,19063.0,BUY,3,0.02h,Stop Loss,$22.50,$51.00,$83118.50,161,$51.00
2024-08-13,19:06:00,19052.5,SELL,3,0.02h,Break Even,$-1.50,$49.50,$83117.00,161,$49.50
2024-08-13,19:31:00,19063.5,BUY,3,0.02h,Stop Loss,$24.00,$73.50,$83141.00,161,$73.50
2024-08-13,20:30:00,19097.25,SELL,3,0.02h,Stop Loss,$39.00,$112.50,$83180.00,161,$112.50
2024-08-13,20:59:00,19096.5,BUY,3,0.02h,Stop Loss,$7.50,$120.00,$83187.50,161,$120.00
2024-08-13,23:52:00,19113.5,SELL,3,0.02h,Break Even,$-1.50,$118.50,$83186.00,161,$118.50
2024-08-13,23:54:00,19119.0,BUY,3,0.02h,Stop Loss,$-9.00,$109.50,$83177.00,161,$109.50
,,,,,,,,,,,
2024-08-14,00:05:00,19112.25,SELL,3,0.02h,Stop Loss,$-9.00,$-9.00,$83168.00,162,$-9.00
2024-08-14,00:06:00,19122.25,BUY,3,0.02h,Stop Loss,$-9.00,$-18.00,$83159.00,162,$-18.00
2024-08-14,00:09:00,19111.25,SELL,3,0.02h,Stop Loss,$-9.00,$-27.00,$83150.00,162,$-27.00
2024-08-14,00:42:00,19107.25,BUY,3,0.02h,Break Even,$-1.50,$-28.50,$83148.50,162,$-28.50
2024-08-14,00:46:00,19100.75,SELL,3,0.02h,Break Even,$-1.50,$-30.00,$83147.00,162,$-30.00
2024-08-14,00:52:00,19106.25,BUY,3,0.02h,Break Even,$-1.50,$-31.50,$83145.50,162,$-31.50
2024-08-14,02:05:00,19140.5,SELL,3,0.02h,Stop Loss,$30.00,$-1.50,$83175.50,162,$-1.50
2024-08-14,02:47:00,19101.25,BUY,3,0.02h,Break Even,$-1.50,$-3.00,$83174.00,162,$-3.00
2024-08-14,03:05:00,19096.5,SELL,3,0.02h,Stop Loss,$-9.00,$-12.00,$83165.00,162,$-12.00
2024-08-14,03:06:00,19103.5,BUY,3,0.02h,Stop Loss,$-9.00,$-21.00,$83156.00,162,$-21.00
2024-08-14,03:38:00,19097.75,SELL,3,0.02h,Stop Loss,$-9.00,$-30.00,$83147.00,162,$-30.00
2024-08-14,03:47:00,19112.75,BUY,3,0.02h,Stop Loss,$4.50,$-25.50,$83151.50,162,$-25.50
2024-08-14,04:03:00,19106.0,SELL,3,0.02h,Break Even,$-1.50,$-27.00,$83150.00,162,$-27.00
2024-08-14,04:13:00,19110.75,BUY,3,0.02h,Break Even,$-1.50,$-28.50,$83148.50,162,$-28.50
2024-08-14,04:20:00,19107.75,SELL,3,0.02h,Stop Loss,$-9.00,$-37.50,$83139.50,162,$-37.50
2024-08-14,04:21:00,19110.25,BUY,3,0.02h,Stop Loss,$-9.00,$-46.50,$83130.50,162,$-46.50
2024-08-14,04:22:00,19108.25,SELL,3,0.02h,Break Even,$-1.50,$-48.00,$83129.00,162,$-48.00
2024-08-14,04:26:00,19110.5,BUY,3,0.03h,Break Even,$-1.50,$-49.50,$83127.50,162,$-49.50
2024-08-14,04:48:00,19110.5,SELL,3,0.03h,Stop Loss,$-9.00,$-58.50,$83118.50,162,$-58.50
2024-08-14,05:13:00,19110.75,BUY,3,0.02h,Stop Loss,$-9.00,$-67.50,$83109.50,162,$-67.50
2024-08-14,05:29:00,19104.75,SELL,3,0.02h,Break Even,$-1.50,$-69.00,$83108.00,162,$-69.00
2024-08-14,05:36:00,19116.25,BUY,3,0.02h,Stop Loss,$-9.00,$-78.00,$83099.00,162,$-78.00
2024-08-14,05:52:00,19106.75,SELL,3,0.02h,Stop Loss,$-9.00,$-87.00,$83090.00,162,$-87.00
2024-08-14,05:59:00,19113.75,BUY,3,0.02h,Stop Loss,$9.00,$-78.00,$83099.00,162,$-78.00
2024-08-14,06:16:00,19108.5,SELL,3,0.02h,Stop Loss,$-9.00,$-87.00,$83090.00,162,$-87.00
2024-08-14,06:17:00,19116.0,BUY,3,0.02h,Stop Loss,$-9.00,$-96.00,$83081.00,162,$-96.00
2024-08-14,06:48:00,19117.0,SELL,3,0.02h,Break Even,$-1.50,$-97.50,$83079.50,162,$-97.50
2024-08-14,07:22:00,19111.25,BUY,3,0.02h,Break Even,$-1.50,$-99.00,$83078.00,162,$-99.00
2024-08-14,07:30:00,19095.75,SELL,3,0.02h,Stop Loss,$18.00,$-81.00,$83096.00,162,$-81.00
2024-08-14,07:43:00,19103.0,BUY,3,0.02h,Break Even,$-1.50,$-82.50,$83094.50,162,$-82.50
2024-08-14,07:45:00,19096.5,SELL,3,0.02h,Break Even,$-1.50,$-84.00,$83093.00,162,$-84.00
2024-08-14,07:47:00,19103.75,BUY,3,0.02h,Break Even,$-1.50,$-85.50,$83091.50,162,$-85.50
2024-08-14,07:55:00,19094.0,SELL,3,0.02h,Stop Loss,$-9.00,$-94.50,$83082.50,162,$-94.50
2024-08-14,08:32:00,19088.25,BUY,3,0.02h,Stop Loss,$21.00,$-73.50,$83103.50,162,$-73.50
2024-08-14,08:41:00,19084.0,SELL,3,0.02h,Stop Loss,$31.50,$-42.00,$83135.00,162,$-42.00
2024-08-14,08:46:00,19086.75,BUY,3,0.02h,Break Even,$-1.50,$-43.50,$83133.50,162,$-43.50
2024-08-14,08:56:00,19081.75,SELL,3,0.02h,Break Even,$-1.50,$-45.00,$83132.00,162,$-45.00
2024-08-14,08:58:00,19087.75,BUY,3,0.02h,Break Even,$-1.50,$-46.50,$83130.50,162,$-46.50
2024-08-14,09:05:00,19081.0,SELL,3,0.02h,Break Even,$-1.50,$-48.00,$83129.00,162,$-48.00
2024-08-14,09:22:00,19087.5,BUY,3,0.02h,Break Even,$-1.50,$-49.50,$83127.50,162,$-49.50
2024-08-14,10:20:00,19101.75,SELL,3,0.02h,Break Even,$-1.50,$-51.00,$83126.00,162,$-51.00
2024-08-14,10:23:00,19103.75,BUY,3,0.02h,Stop Loss,$4.50,$-46.50,$83130.50,162,$-46.50
2024-08-14,10:57:00,19104.75,SELL,3,0.02h,Stop Loss,$7.50,$-39.00,$83138.00,162,$-39.00
2024-08-14,11:30:00,19103.5,BUY,3,0.02h,Stop Loss,$3.00,$-36.00,$83141.00,162,$-36.00
2024-08-14,12:08:00,19105.25,SELL,3,0.02h,Break Even,$-1.50,$-37.50,$83139.50,162,$-37.50
2024-08-14,12:29:00,19108.75,BUY,3,0.02h,Stop Loss,$225.00,$187.50,$83364.50,162,$187.50
2024-08-14,12:33:00,19063.5,SELL,3,0.02h,Stop Loss,$51.00,$238.50,$83415.50,162,$238.50
2024-08-14,12:40:00,19122.5,BUY,3,0.02h,Stop Loss,$-9.00,$229.50,$83406.50,162,$229.50
2024-08-14,13:21:00,19133.75,SELL,3,0.02h,Break Even,$-1.50,$228.00,$83405.00,162,$228.00
2024-08-14,13:22:00,19138.75,BUY,3,0.02h,Break Even,$-1.50,$226.50,$83403.50,162,$226.50
2024-08-14,13:29:00,19126.25,SELL,3,0.02h,Break Even,$-1.50,$225.00,$83402.00,162,$225.00
2024-08-14,13:31:00,19162.5,BUY,3,0.02h,Stop Loss,$54.00,$279.00,$83456.00,162,$279.00
2024-08-14,13:35:00,19108.25,SELL,3,0.02h,Stop Loss,$130.50,$409.50,$83586.50,162,$409.50
2024-08-14,14:44:00,18995.75,BUY,3,0.02h,Stop Loss,$9.00,$418.50,$83595.50,162,$418.50
2024-08-14,16:15:00,19162.0,SELL,3,0.02h,Stop Loss,$85.50,$504.00,$83681.00,162,$504.00
2024-08-14,17:02:00,19068.75,BUY,3,0.02h,Stop Loss,$30.00,$534.00,$83711.00,162,$534.00
2024-08-14,17:28:00,19064.75,SELL,3,0.02h,Stop Loss,$-9.00,$525.00,$83702.00,162,$525.00
2024-08-14,17:30:00,19084.5,BUY,3,0.02h,Stop Loss,$12.00,$537.00,$83714.00,162,$537.00
2024-08-14,17:40:00,19071.0,SELL,3,0.02h,Break Even,$-1.50,$535.50,$83712.50,162,$535.50
2024-08-14,17:50:00,19084.25,BUY,3,0.02h,Stop Loss,$7.50,$543.00,$83720.00,162,$543.00
2024-08-14,17:52:00,19073.25,SELL,3,0.02h,Stop Loss,$-9.00,$534.00,$83711.00,162,$534.00
2024-08-14,17:54:00,19086.75,BUY,3,0.02h,Break Even,$-1.50,$532.50,$83709.50,162,$532.50
2024-08-14,18:01:00,19051.75,SELL,3,0.02h,Break Even,$-1.50,$531.00,$83708.00,162,$531.00
2024-08-14,18:21:00,19082.25,BUY,3,0.02h,Stop Loss,$16.50,$547.50,$83724.50,162,$547.50
2024-08-14,18:47:00,19078.5,SELL,3,0.02h,Stop Loss,$18.00,$565.50,$83742.50,162,$565.50
2024-08-14,18:53:00,19091.5,BUY,3,0.02h,Stop Loss,$6.00,$571.50,$83748.50,162,$571.50
2024-08-14,19:11:00,19076.5,SELL,3,0.02h,Break Even,$-1.50,$570.00,$83747.00,162,$570.00
2024-08-14,19:42:00,19071.5,BUY,3,0.02h,Stop Loss,$10.50,$580.50,$83757.50,162,$580.50
2024-08-14,20:36:00,19143.75,SELL,3,0.02h,Stop Loss,$-9.00,$571.50,$83748.50,162,$571.50
2024-08-14,20:48:00,19148.25,BUY,3,0.02h,Stop Loss,$-9.00,$562.50,$83739.50,162,$562.50
2024-08-14,20:53:00,19144.75,SELL,3,0.02h,Break Even,$-1.50,$561.00,$83738.00,162,$561.00
,,,,,,,,,,,
2024-08-15,00:07:00,19120.75,BUY,3,0.02h,Break Even,$-1.50,$-1.50,$83736.50,163,$-1.50
2024-08-15,01:19:00,19159.75,SELL,3,0.02h,Stop Loss,$16.50,$15.00,$83753.00,163,$15.00
2024-08-15,01:42:00,19161.0,BUY,3,0.02h,Stop Loss,$19.50,$34.50,$83772.50,163,$34.50
2024-08-15,03:11:00,19205.25,SELL,3,0.02h,Stop Loss,$-9.00,$25.50,$83763.50,163,$25.50
2024-08-15,03:32:00,19214.0,BUY,3,0.02h,Stop Loss,$-9.00,$16.50,$83754.50,163,$16.50
2024-08-15,03:55:00,19213.0,SELL,3,0.02h,Stop Loss,$-9.00,$7.50,$83745.50,163,$7.50
2024-08-15,03:56:00,19215.5,BUY,3,0.02h,Stop Loss,$-9.00,$-1.50,$83736.50,163,$-1.50
2024-08-15,04:02:00,19213.5,SELL,3,0.03h,Stop Loss,$-9.00,$-10.50,$83727.50,163,$-10.50
2024-08-15,04:05:00,19215.5,BUY,3,0.02h,Stop Loss,$7.50,$-3.00,$83735.00,163,$-3.00
2024-08-15,04:36:00,19215.0,SELL,3,0.02h,Stop Loss,$27.00,$24.00,$83762.00,163,$24.00
2024-08-15,04:58:00,19215.0,BUY,3,0.02h,Stop Loss,$-9.00,$15.00,$83753.00,163,$15.00
2024-08-15,05:01:00,19208.5,SELL,3,0.02h,Break Even,$-1.50,$13.50,$83751.50,163,$13.50
2024-08-15,06:39:00,19176.25,BUY,3,0.02h,Break Even,$-1.50,$12.00,$83750.00,163,$12.00
2024-08-15,07:03:00,19158.0,SELL,3,0.02h,Stop Loss,$3.00,$15.00,$83753.00,163,$15.00
2024-08-15,07:10:00,19173.25,BUY,3,0.02h,Stop Loss,$-9.00,$6.00,$83744.00,163,$6.00
2024-08-15,07:11:00,19163.5,SELL,3,0.02h,Stop Loss,$-9.00,$-3.00,$83735.00,163,$-3.00
2024-08-15,07:12:00,19170.75,BUY,3,0.02h,Stop Loss,$-9.00,$-12.00,$83726.00,163,$-12.00
2024-08-15,07:45:00,19178.25,SELL,3,0.02h,Stop Loss,$-9.00,$-21.00,$83717.00,163,$-21.00
2024-08-15,07:46:00,19186.0,BUY,3,0.02h,Stop Loss,$-9.00,$-30.00,$83708.00,163,$-30.00
2024-08-15,08:09:00,19182.0,SELL,3,0.02h,Stop Loss,$19.50,$-10.50,$83727.50,163,$-10.50
2024-08-15,08:49:00,19149.0,BUY,3,0.02h,Break Even,$-1.50,$-12.00,$83726.00,163,$-12.00
2024-08-15,08:51:00,19145.25,SELL,3,0.02h,Break Even,$-1.50,$-13.50,$83724.50,163,$-13.50
2024-08-15,08:53:00,19148.75,BUY,3,0.02h,Break Even,$-1.50,$-15.00,$83723.00,163,$-15.00
2024-08-15,09:44:00,19156.75,SELL,3,0.02h,Stop Loss,$-9.00,$-24.00,$83714.00,163,$-24.00
2024-08-15,09:48:00,19164.25,BUY,3,0.02h,Break Even,$-1.50,$-25.50,$83712.50,163,$-25.50
2024-08-15,10:11:00,19163.75,SELL,3,0.02h,Break Even,$-1.50,$-27.00,$83711.00,163,$-27.00
2024-08-15,11:08:00,19141.25,BUY,3,0.02h,Break Even,$-1.50,$-28.50,$83709.50,163,$-28.50
2024-08-15,11:54:00,19158.0,SELL,3,0.02h,Stop Loss,$-9.00,$-37.50,$83700.50,163,$-37.50
2024-08-15,12:13:00,19169.75,BUY,3,0.02h,Stop Loss,$-9.00,$-46.50,$83691.50,163,$-46.50
2024-08-15,12:27:00,19160.75,SELL,3,0.02h,Break Even,$-1.50,$-48.00,$83690.00,163,$-48.00
2024-08-15,12:31:00,19245.25,BUY,3,0.02h,Stop Loss,$25.50,$-22.50,$83715.50,163,$-22.50
2024-08-15,13:18:00,19322.25,SELL,3,0.02h,Stop Loss,$10.50,$-12.00,$83726.00,163,$-12.00
2024-08-15,13:25:00,19335.75,BUY,3,0.02h,Stop Loss,$3.00,$-9.00,$83729.00,163,$-9.00
2024-08-15,14:57:00,19472.25,SELL,3,0.02h,Stop Loss,$7.50,$-1.50,$83736.50,163,$-1.50
2024-08-15,15:05:00,19494.25,BUY,3,0.02h,Stop Loss,$12.00,$10.50,$83748.50,163,$10.50
2024-08-15,15:36:00,19505.5,SELL,3,0.02h,Break Even,$-1.50,$9.00,$83747.00,163,$9.00
2024-08-15,15:37:00,19515.0,BUY,3,0.02h,Stop Loss,$9.00,$18.00,$83756.00,163,$18.00
2024-08-15,16:41:00,19547.0,SELL,3,0.02h,Stop Loss,$88.50,$106.50,$83844.50,163,$106.50
2024-08-15,17:16:00,19539.25,BUY,3,0.02h,Stop Loss,$15.00,$121.50,$83859.50,163,$121.50
2024-08-15,18:17:00,19569.0,SELL,3,0.02h,Stop Loss,$-9.00,$112.50,$83850.50,163,$112.50
2024-08-15,18:22:00,19586.0,BUY,3,0.02h,Stop Loss,$-9.00,$103.50,$83841.50,163,$103.50
2024-08-15,18:33:00,19578.5,SELL,3,0.02h,Break Even,$-1.50,$102.00,$83840.00,163,$102.00
2024-08-15,18:34:00,19583.0,BUY,3,0.02h,Break Even,$-1.50,$100.50,$83838.50,163,$100.50
2024-08-15,18:40:00,19580.0,SELL,3,0.02h,Stop Loss,$6.00,$106.50,$83844.50,163,$106.50
2024-08-15,18:49:00,19582.75,BUY,3,0.02h,Break Even,$-1.50,$105.00,$83843.00,163,$105.00
2024-08-15,18:51:00,19573.5,SELL,3,0.02h,Stop Loss,$21.00,$126.00,$83864.00,163,$126.00
2024-08-15,18:58:00,19584.5,BUY,3,0.02h,Stop Loss,$-9.00,$117.00,$83855.00,163,$117.00
2024-08-15,19:01:00,19566.75,SELL,3,0.02h,Break Even,$-1.50,$115.50,$83853.50,163,$115.50
2024-08-15,19:07:00,19585.5,BUY,3,0.02h,Break Even,$-1.50,$114.00,$83852.00,163,$114.00
2024-08-15,19:13:00,19571.5,SELL,3,0.02h,Break Even,$-1.50,$112.50,$83850.50,163,$112.50
2024-08-15,19:20:00,19584.0,BUY,3,0.02h,Stop Loss,$-9.00,$103.50,$83841.50,163,$103.50
2024-08-15,19:49:00,19586.0,SELL,3,0.02h,Stop Loss,$58.50,$162.00,$83900.00,163,$162.00
2024-08-15,20:03:00,19579.5,BUY,3,0.02h,Break Even,$-1.50,$160.50,$83898.50,163,$160.50
2024-08-15,20:04:00,19573.25,SELL,3,0.02h,Stop Loss,$27.00,$187.50,$83925.50,163,$187.50
2024-08-15,20:10:00,19583.0,BUY,3,0.02h,Break Even,$-1.50,$186.00,$83924.00,163,$186.00
2024-08-15,20:15:00,19566.0,SELL,3,0.02h,Stop Loss,$-9.00,$177.00,$83915.00,163,$177.00
2024-08-15,20:29:00,19583.25,BUY,3,0.02h,Stop Loss,$10.50,$187.50,$83925.50,163,$187.50
2024-08-15,20:50:00,19577.5,SELL,3,0.02h,Break Even,$-1.50,$186.00,$83924.00,163,$186.00
2024-08-15,23:01:00,19603.0,BUY,3,0.02h,Break Even,$-1.50,$184.50,$83922.50,163,$184.50
2024-08-15,23:42:00,19611.0,SELL,3,0.02h,Stop Loss,$-9.00,$175.50,$83913.50,163,$175.50
,,,,,,,,,,,
2024-08-16,00:28:00,19605.75,BUY,3,0.02h,Break Even,$-1.50,$-1.50,$83912.00,164,$-1.50
2024-08-16,00:36:00,19584.25,SELL,3,0.02h,Break Even,$-1.50,$-3.00,$83910.50,164,$-3.00
2024-08-16,00:57:00,19595.75,BUY,3,0.02h,Stop Loss,$46.50,$43.50,$83957.00,164,$43.50
2024-08-16,01:14:00,19591.5,SELL,3,0.02h,Stop Loss,$-9.00,$34.50,$83948.00,164,$34.50
2024-08-16,01:16:00,19597.75,BUY,3,0.02h,Break Even,$-1.50,$33.00,$83946.50,164,$33.00
2024-08-16,01:53:00,19609.0,SELL,3,0.02h,Break Even,$-1.50,$31.50,$83945.00,164,$31.50
2024-08-16,01:58:00,19613.5,BUY,3,0.02h,Break Even,$-1.50,$30.00,$83943.50,164,$30.00
2024-08-16,02:13:00,19612.75,SELL,3,0.02h,Stop Loss,$-9.00,$21.00,$83934.50,164,$21.00
2024-08-16,02:14:00,19614.75,BUY,3,0.02h,Stop Loss,$3.00,$24.00,$83937.50,164,$24.00
2024-08-16,02:53:00,19625.25,SELL,3,0.02h,Stop Loss,$-9.00,$15.00,$83928.50,164,$15.00
2024-08-16,03:07:00,19629.25,BUY,3,0.02h,Break Even,$-1.50,$13.50,$83927.00,164,$13.50
2024-08-16,03:15:00,19622.0,SELL,3,0.02h,Break Even,$-1.50,$12.00,$83925.50,164,$12.00
2024-08-16,03:29:00,19629.5,BUY,3,0.02h,Stop Loss,$12.00,$24.00,$83937.50,164,$24.00
2024-08-16,03:57:00,19634.0,SELL,3,0.02h,Stop Loss,$-9.00,$15.00,$83928.50,164,$15.00
2024-08-16,03:58:00,19636.25,BUY,3,0.03h,Stop Loss,$-9.00,$6.00,$83919.50,164,$6.00
2024-08-16,04:00:00,19634.25,SELL,3,0.02h,Stop Loss,$12.00,$18.00,$83931.50,164,$18.00
2024-08-16,04:51:00,19621.75,BUY,3,0.02h,Stop Loss,$-9.00,$9.00,$83922.50,164,$9.00
2024-08-16,06:29:00,19662.5,SELL,3,0.02h,Stop Loss,$-9.00,$0.00,$83913.50,164,$0.00
2024-08-16,06:30:00,19668.75,BUY,3,0.02h,Stop Loss,$-9.00,$-9.00,$83904.50,164,$-9.00
2024-08-16,06:37:00,19663.0,SELL,3,0.02h,Stop Loss,$-9.00,$-18.00,$83895.50,164,$-18.00
2024-08-16,06:38:00,19667.0,BUY,3,0.02h,Break Even,$-1.50,$-19.50,$83894.00,164,$-19.50
2024-08-16,07:07:00,19670.75,SELL,3,0.02h,Stop Loss,$15.00,$-4.50,$83909.00,164,$-4.50
2024-08-16,08:08:00,19646.0,BUY,3,0.02h,Break Even,$-1.50,$-6.00,$83907.50,164,$-6.00
2024-08-16,08:10:00,19640.0,SELL,3,0.02h,Stop Loss,$25.50,$19.50,$83933.00,164,$19.50
2024-08-16,08:51:00,19620.75,BUY,3,0.02h,Stop Loss,$16.50,$36.00,$83949.50,164,$36.00
2024-08-16,09:19:00,19622.5,SELL,3,0.02h,Stop Loss,$9.00,$45.00,$83958.50,164,$45.00
2024-08-16,09:23:00,19631.5,BUY,3,0.02h,Stop Loss,$21.00,$66.00,$83979.50,164,$66.00
2024-08-16,09:33:00,19627.25,SELL,3,0.02h,Stop Loss,$-9.00,$57.00,$83970.50,164,$57.00
2024-08-16,09:35:00,19637.0,BUY,3,0.02h,Stop Loss,$15.00,$72.00,$83985.50,164,$72.00
2024-08-16,09:44:00,19630.25,SELL,3,0.02h,Stop Loss,$15.00,$87.00,$84000.50,164,$87.00
2024-08-16,10:57:00,19593.75,BUY,3,0.02h,Stop Loss,$-9.00,$78.00,$83991.50,164,$78.00
2024-08-16,11:07:00,19584.0,SELL,3,0.02h,Stop Loss,$-9.00,$69.00,$83982.50,164,$69.00
2024-08-16,11:39:00,19583.0,BUY,3,0.02h,Break Even,$-1.50,$67.50,$83981.00,164,$67.50
2024-08-16,11:45:00,19569.75,SELL,3,0.02h,Stop Loss,$13.50,$81.00,$83994.50,164,$81.00
2024-08-16,13:01:00,19479.25,BUY,3,0.02h,Break Even,$-1.50,$79.50,$83993.00,164,$79.50
2024-08-16,13:31:00,19466.0,SELL,3,0.02h,Break Even,$-1.50,$78.00,$83991.50,164,$78.00
2024-08-16,13:33:00,19503.25,BUY,3,0.02h,Stop Loss,$48.00,$126.00,$84039.50,164,$126.00
2024-08-16,13:47:00,19486.5,SELL,3,0.02h,Stop Loss,$9.00,$135.00,$84048.50,164,$135.00
2024-08-16,13:51:00,19521.25,BUY,3,0.02h,Stop Loss,$39.00,$174.00,$84087.50,164,$174.00
2024-08-16,14:00:00,19495.75,SELL,3,0.02h,Stop Loss,$13.50,$187.50,$84101.00,164,$187.50
2024-08-16,14:01:00,19525.5,BUY,3,0.02h,Stop Loss,$7.50,$195.00,$84108.50,164,$195.00
2024-08-16,14:41:00,19553.5,SELL,3,0.02h,Stop Loss,$51.00,$246.00,$84159.50,164,$246.00
2024-08-16,15:29:00,19532.0,BUY,3,0.02h,Break Even,$-1.50,$244.50,$84158.00,164,$244.50
2024-08-16,17:16:00,19627.0,SELL,3,0.02h,Break Even,$-1.50,$243.00,$84156.50,164,$243.00
2024-08-16,17:21:00,19636.5,BUY,3,0.02h,Break Even,$-1.50,$241.50,$84155.00,164,$241.50
2024-08-16,17:22:00,19633.5,SELL,3,0.02h,Stop Loss,$-9.00,$232.50,$84146.00,164,$232.50
2024-08-16,17:23:00,19637.25,BUY,3,0.02h,Stop Loss,$13.50,$246.00,$84159.50,164,$246.00
2024-08-16,17:42:00,19629.75,SELL,3,0.02h,Stop Loss,$-9.00,$237.00,$84150.50,164,$237.00
2024-08-16,17:44:00,19640.25,BUY,3,0.02h,Stop Loss,$21.00,$258.00,$84171.50,164,$258.00
2024-08-16,17:48:00,19630.0,SELL,3,0.02h,Stop Loss,$-9.00,$249.00,$84162.50,164,$249.00
2024-08-16,18:30:00,19615.5,BUY,3,0.02h,Stop Loss,$3.00,$252.00,$84165.50,164,$252.00
2024-08-16,18:44:00,19603.0,SELL,3,0.02h,Stop Loss,$12.00,$264.00,$84177.50,164,$264.00
2024-08-16,18:55:00,19616.0,BUY,3,0.02h,Break Even,$-1.50,$262.50,$84176.00,164,$262.50
2024-08-16,19:11:00,19606.5,SELL,3,0.02h,Break Even,$-1.50,$261.00,$84174.50,164,$261.00
2024-08-16,19:35:00,19611.75,BUY,3,0.02h,Break Even,$-1.50,$259.50,$84173.00,164,$259.50
2024-08-16,19:40:00,19603.25,SELL,3,0.02h,Break Even,$-1.50,$258.00,$84171.50,164,$258.00
2024-08-16,19:57:00,19608.75,BUY,3,0.02h,Stop Loss,$3.00,$261.00,$84174.50,164,$261.00
2024-08-16,20:32:00,19606.25,SELL,3,0.02h,Stop Loss,$4.50,$265.50,$84179.00,164,$265.50
2024-08-16,20:53:00,19610.5,BUY,3,0.02h,Break Even,$-1.50,$264.00,$84177.50,164,$264.00
2024-08-16,21:00:00,19604.5,SELL,3,51.00h,Stop Loss,$-9.00,$255.00,$84168.50,164,$255.00
,,,,,,,,,,,
2024-08-19,00:00:00,19648.5,BUY,3,0.02h,Stop Loss,$34.50,$34.50,$84203.00,165,$34.50
2024-08-19,00:57:00,19654.0,SELL,3,0.02h,Stop Loss,$3.00,$37.50,$84206.00,165,$37.50
2024-08-19,01:14:00,19661.0,BUY,3,0.02h,Stop Loss,$-9.00,$28.50,$84197.00,165,$28.50
2024-08-19,01:17:00,19652.75,SELL,3,0.02h,Break Even,$-1.50,$27.00,$84195.50,165,$27.00
2024-08-19,01:44:00,19653.5,BUY,3,0.02h,Break Even,$-1.50,$25.50,$84194.00,165,$25.50
2024-08-19,02:34:00,19657.25,SELL,3,0.02h,Stop Loss,$22.50,$48.00,$84216.50,165,$48.00
2024-08-19,02:47:00,19658.5,BUY,3,0.02h,Break Even,$-1.50,$46.50,$84215.00,165,$46.50
2024-08-19,03:18:00,19661.75,SELL,3,0.03h,Stop Loss,$7.50,$54.00,$84222.50,165,$54.00
2024-08-19,03:30:00,19666.75,BUY,3,0.02h,Break Even,$-1.50,$52.50,$84221.00,165,$52.50
2024-08-19,03:42:00,19658.5,SELL,3,0.02h,Break Even,$-1.50,$51.00,$84219.50,165,$51.00
2024-08-19,04:29:00,19644.0,BUY,3,0.02h,Stop Loss,$-9.00,$42.00,$84210.50,165,$42.00
2024-08-19,04:30:00,19642.0,SELL,3,0.02h,Stop Loss,$6.00,$48.00,$84216.50,165,$48.00
2024-08-19,05:03:00,19617.5,BUY,3,0.02h,Stop Loss,$3.00,$51.00,$84219.50,165,$51.00
2024-08-19,05:12:00,19610.5,SELL,3,0.02h,Break Even,$-1.50,$49.50,$84218.00,165,$49.50
2024-08-19,05:18:00,19616.75,BUY,3,0.02h,Break Even,$-1.50,$48.00,$84216.50,165,$48.00
2024-08-19,05:22:00,19602.25,SELL,3,0.02h,Stop Loss,$4.50,$52.50,$84221.00,165,$52.50
2024-08-19,05:50:00,19597.25,BUY,3,0.02h,Stop Loss,$-9.00,$43.50,$84212.00,165,$43.50
2024-08-19,05:53:00,19591.0,SELL,3,0.02h,Break Even,$-1.50,$42.00,$84210.50,165,$42.00
2024-08-19,06:05:00,19595.75,BUY,3,0.02h,Break Even,$-1.50,$40.50,$84209.00,165,$40.50
2024-08-19,06:07:00,19583.75,SELL,3,0.02h,Stop Loss,$79.50,$120.00,$84288.50,165,$120.00
2024-08-19,06:38:00,19578.25,BUY,3,0.02h,Break Even,$-1.50,$118.50,$84287.00,165,$118.50
2024-08-19,06:52:00,19573.75,SELL,3,0.02h,Stop Loss,$-9.00,$109.50,$84278.00,165,$109.50
2024-08-19,07:03:00,19586.25,BUY,3,0.02h,Stop Loss,$-9.00,$100.50,$84269.00,165,$100.50
2024-08-19,07:22:00,19575.5,SELL,3,0.02h,Stop Loss,$12.00,$112.50,$84281.00,165,$112.50
2024-08-19,07:29:00,19591.0,BUY,3,0.02h,Break Even,$-1.50,$111.00,$84279.50,165,$111.00
2024-08-19,07:54:00,19586.0,SELL,3,0.02h,Stop Loss,$15.00,$126.00,$84294.50,165,$126.00
2024-08-19,08:28:00,19564.25,BUY,3,0.02h,Stop Loss,$-9.00,$117.00,$84285.50,165,$117.00
2024-08-19,08:42:00,19548.25,SELL,3,0.02h,Stop Loss,$-9.00,$108.00,$84276.50,165,$108.00
2024-08-19,08:47:00,19567.0,BUY,3,0.02h,Break Even,$-1.50,$106.50,$84275.00,165,$106.50
2024-08-19,09:06:00,19561.5,SELL,3,0.02h,Break Even,$-1.50,$105.00,$84273.50,165,$105.00
2024-08-19,09:27:00,19561.5,BUY,3,0.02h,Stop Loss,$13.50,$118.50,$84287.00,165,$118.50
2024-08-19,09:49:00,19565.0,SELL,3,0.02h,Break Even,$-1.50,$117.00,$84285.50,165,$117.00
2024-08-19,09:53:00,19573.25,BUY,3,0.02h,Break Even,$-1.50,$115.50,$84284.00,165,$115.50
2024-08-19,10:35:00,19593.5,SELL,3,0.02h,Break Even,$-1.50,$114.00,$84282.50,165,$114.00
2024-08-19,11:04:00,19593.75,BUY,3,0.02h,Stop Loss,$9.00,$123.00,$84291.50,165,$123.00
2024-08-19,11:42:00,19603.75,SELL,3,0.02h,Break Even,$-1.50,$121.50,$84290.00,165,$121.50
2024-08-19,11:55:00,19610.5,BUY,3,0.02h,Break Even,$-1.50,$120.00,$84288.50,165,$120.00
2024-08-19,12:37:00,19621.25,SELL,3,0.02h,Stop Loss,$-9.00,$111.00,$84279.50,165,$111.00
2024-08-19,12:48:00,19628.75,BUY,3,0.02h,Stop Loss,$-9.00,$102.00,$84270.50,165,$102.00
2024-08-19,12:53:00,19618.5,SELL,3,0.02h,Stop Loss,$-9.00,$93.00,$84261.50,165,$93.00
2024-08-19,13:06:00,19630.5,BUY,3,0.02h,Break Even,$-1.50,$91.50,$84260.00,165,$91.50
2024-08-19,13:23:00,19623.0,SELL,3,0.02h,Break Even,$-1.50,$90.00,$84258.50,165,$90.00
2024-08-19,13:48:00,19613.5,BUY,3,0.02h,Stop Loss,$40.50,$130.50,$84299.00,165,$130.50
2024-08-19,13:55:00,19583.25,SELL,3,0.02h,Stop Loss,$27.00,$157.50,$84326.00,165,$157.50
2024-08-19,14:09:00,19619.0,BUY,3,0.02h,Stop Loss,$-9.00,$148.50,$84317.00,165,$148.50
2024-08-19,14:18:00,19549.25,SELL,3,0.02h,Stop Loss,$-9.00,$139.50,$84308.00,165,$139.50
2024-08-19,14:28:00,19610.25,BUY,3,0.02h,Stop Loss,$13.50,$153.00,$84321.50,165,$153.00
2024-08-19,15:19:00,19643.0,SELL,3,0.02h,Break Even,$-1.50,$151.50,$84320.00,165,$151.50
2024-08-19,15:25:00,19662.5,BUY,3,0.02h,Stop Loss,$-9.00,$142.50,$84311.00,165,$142.50
2024-08-19,15:42:00,19655.0,SELL,3,0.02h,Break Even,$-1.50,$141.00,$84309.50,165,$141.00
2024-08-19,15:45:00,19659.5,BUY,3,0.02h,Stop Loss,$21.00,$162.00,$84330.50,165,$162.00
2024-08-19,15:58:00,19644.75,SELL,3,0.02h,Stop Loss,$132.00,$294.00,$84462.50,165,$294.00
2024-08-19,16:17:00,19655.0,BUY,3,0.02h,Stop Loss,$16.50,$310.50,$84479.00,165,$310.50
2024-08-19,16:36:00,19649.0,SELL,3,0.02h,Stop Loss,$-9.00,$301.50,$84470.00,165,$301.50
2024-08-19,16:39:00,19660.75,BUY,3,0.02h,Break Even,$-1.50,$300.00,$84468.50,165,$300.00
2024-08-19,17:15:00,19681.75,SELL,3,0.02h,Stop Loss,$24.00,$324.00,$84492.50,165,$324.00
2024-08-19,17:22:00,19690.5,BUY,3,0.02h,Stop Loss,$-9.00,$315.00,$84483.50,165,$315.00
2024-08-19,19:03:00,19761.75,SELL,3,0.02h,Stop Loss,$-9.00,$306.00,$84474.50,165,$306.00
2024-08-19,19:16:00,19767.75,BUY,3,0.02h,Stop Loss,$6.00,$312.00,$84480.50,165,$312.00
2024-08-19,19:47:00,19768.5,SELL,3,0.02h,Stop Loss,$-9.00,$303.00,$84471.50,165,$303.00
2024-08-19,19:52:00,19792.5,BUY,3,0.02h,Stop Loss,$48.00,$351.00,$84519.50,165,$351.00
2024-08-19,20:48:00,19860.25,SELL,3,0.02h,Stop Loss,$-9.00,$342.00,$84510.50,165,$342.00
2024-08-19,23:01:00,19872.75,BUY,3,0.02h,Stop Loss,$-9.00,$333.00,$84501.50,165,$333.00
2024-08-19,23:15:00,19861.5,SELL,3,0.02h,Stop Loss,$-9.00,$324.00,$84492.50,165,$324.00
2024-08-19,23:20:00,19866.25,BUY,3,0.02h,Stop Loss,$-9.00,$315.00,$84483.50,165,$315.00
2024-08-19,23:21:00,19864.5,SELL,3,0.02h,Stop Loss,$-9.00,$306.00,$84474.50,165,$306.00
2024-08-19,23:22:00,19865.5,BUY,3,0.02h,Stop Loss,$-9.00,$297.00,$84465.50,165,$297.00
2024-08-19,23:23:00,19863.75,SELL,3,0.02h,Stop Loss,$-9.00,$288.00,$84456.50,165,$288.00
2024-08-19,23:42:00,19865.25,BUY,3,0.02h,Stop Loss,$-9.00,$279.00,$84447.50,165,$279.00
2024-08-19,23:53:00,19861.5,SELL,3,0.02h,Break Even,$-1.50,$277.50,$84446.00,165,$277.50
,,,,,,,,,,,
2024-08-20,00:10:00,19866.0,BUY,3,0.02h,Break Even,$-1.50,$-1.50,$84444.50,166,$-1.50
2024-08-20,00:13:00,19860.75,SELL,3,0.02h,Stop Loss,$-9.00,$-10.50,$84435.50,166,$-10.50
2024-08-20,00:14:00,19862.25,BUY,3,0.02h,Stop Loss,$-9.00,$-19.50,$84426.50,166,$-19.50
2024-08-20,00:44:00,19863.25,SELL,3,0.02h,Stop Loss,$-9.00,$-28.50,$84417.50,166,$-28.50
2024-08-20,01:00:00,19865.75,BUY,3,0.02h,Break Even,$-1.50,$-30.00,$84416.00,166,$-30.00
2024-08-20,01:06:00,19855.75,SELL,3,0.02h,Stop Loss,$43.50,$13.50,$84459.50,166,$13.50
2024-08-20,01:16:00,19864.75,BUY,3,0.02h,Break Even,$-1.50,$12.00,$84458.00,166,$12.00
2024-08-20,03:08:00,19904.25,SELL,3,0.02h,Break Even,$-1.50,$10.50,$84456.50,166,$10.50
2024-08-20,04:04:00,19880.0,BUY,3,0.02h,Stop Loss,$-9.00,$1.50,$84447.50,166,$1.50
2024-08-20,04:35:00,19885.0,SELL,3,0.02h,Break Even,$-1.50,$0.00,$84446.00,166,$0.00
2024-08-20,05:04:00,19886.5,BUY,3,0.02h,Stop Loss,$-9.00,$-9.00,$84437.00,166,$-9.00
2024-08-20,05:09:00,19877.75,SELL,3,0.02h,Stop Loss,$-9.00,$-18.00,$84428.00,166,$-18.00
2024-08-20,05:18:00,19888.75,BUY,3,0.02h,Stop Loss,$-9.00,$-27.00,$84419.00,166,$-27.00
2024-08-20,05:43:00,19885.5,SELL,3,0.02h,Stop Loss,$-9.00,$-36.00,$84410.00,166,$-36.00
2024-08-20,05:59:00,19886.75,BUY,3,0.02h,Stop Loss,$12.00,$-24.00,$84422.00,166,$-24.00
2024-08-20,06:09:00,19884.5,SELL,3,0.02h,Break Even,$-1.50,$-25.50,$84420.50,166,$-25.50
2024-08-20,06:18:00,19889.5,BUY,3,0.02h,Stop Loss,$-9.00,$-34.50,$84411.50,166,$-34.50
2024-08-20,06:21:00,19884.0,SELL,3,0.03h,Stop Loss,$-9.00,$-43.50,$84402.50,166,$-43.50
2024-08-20,06:30:00,19888.5,BUY,3,0.02h,Break Even,$-1.50,$-45.00,$84401.00,166,$-45.00
2024-08-20,07:00:00,19892.25,SELL,3,0.02h,Break Even,$-1.50,$-46.50,$84399.50,166,$-46.50
2024-08-20,07:17:00,19910.5,BUY,3,0.02h,Stop Loss,$-9.00,$-55.50,$84390.50,166,$-55.50
2024-08-20,07:45:00,19913.5,SELL,3,0.02h,Stop Loss,$-9.00,$-64.50,$84381.50,166,$-64.50
2024-08-20,07:46:00,19917.75,BUY,3,0.02h,Stop Loss,$40.50,$-24.00,$84422.00,166,$-24.00
2024-08-20,07:53:00,19914.5,SELL,3,0.02h,Break Even,$-1.50,$-25.50,$84420.50,166,$-25.50
2024-08-20,08:57:00,19871.75,BUY,3,0.02h,Break Even,$-1.50,$-27.00,$84419.00,166,$-27.00
2024-08-20,09:48:00,19890.25,SELL,3,0.02h,Break Even,$-1.50,$-28.50,$84417.50,166,$-28.50
2024-08-20,10:35:00,19879.25,BUY,3,0.02h,Break Even,$-1.50,$-30.00,$84416.00,166,$-30.00
2024-08-20,10:56:00,19878.25,SELL,3,0.02h,Stop Loss,$4.50,$-25.50,$84420.50,166,$-25.50
2024-08-20,11:04:00,19887.0,BUY,3,0.02h,Break Even,$-1.50,$-27.00,$84419.00,166,$-27.00
2024-08-20,11:14:00,19877.5,SELL,3,0.02h,Stop Loss,$-9.00,$-36.00,$84410.00,166,$-36.00
2024-08-20,11:42:00,19876.5,BUY,3,0.02h,Break Even,$-1.50,$-37.50,$84408.50,166,$-37.50
2024-08-20,11:53:00,19871.25,SELL,3,0.02h,Stop Loss,$-9.00,$-46.50,$84399.50,166,$-46.50
2024-08-20,12:01:00,19878.25,BUY,3,0.02h,Stop Loss,$-9.00,$-55.50,$84390.50,166,$-55.50
2024-08-20,12:02:00,19869.75,SELL,3,0.02h,Break Even,$-1.50,$-57.00,$84389.00,166,$-57.00
2024-08-20,12:12:00,19875.75,BUY,3,0.02h,Stop Loss,$-9.00,$-66.00,$84380.00,166,$-66.00
2024-08-20,12:22:00,19870.25,SELL,3,0.02h,Stop Loss,$7.50,$-58.50,$84387.50,166,$-58.50
2024-08-20,13:32:00,19839.75,BUY,3,0.02h,Stop Loss,$30.00,$-28.50,$84417.50,166,$-28.50
2024-08-20,14:12:00,19862.5,SELL,3,0.02h,Stop Loss,$196.50,$168.00,$84614.00,166,$168.00
2024-08-20,14:54:00,19808.5,BUY,3,0.02h,Break Even,$-1.50,$166.50,$84612.50,166,$166.50
2024-08-20,14:58:00,19783.25,SELL,3,0.02h,Break Even,$-1.50,$165.00,$84611.00,166,$165.00
2024-08-20,15:14:00,19800.75,BUY,3,0.02h,Break Even,$-1.50,$163.50,$84609.50,166,$163.50
2024-08-20,15:31:00,19797.0,SELL,3,0.02h,Break Even,$-1.50,$162.00,$84608.00,166,$162.00
2024-08-20,15:32:00,19807.25,BUY,3,0.02h,Stop Loss,$9.00,$171.00,$84617.00,166,$171.00
2024-08-20,15:45:00,19795.0,SELL,3,0.02h,Stop Loss,$66.00,$237.00,$84683.00,166,$237.00
2024-08-20,15:54:00,19820.5,BUY,3,0.02h,Stop Loss,$10.50,$247.50,$84693.50,166,$247.50
2024-08-20,16:17:00,19820.25,SELL,3,0.02h,Stop Loss,$37.50,$285.00,$84731.00,166,$285.00
2024-08-20,16:51:00,19813.5,BUY,3,0.02h,Break Even,$-1.50,$283.50,$84729.50,166,$283.50
2024-08-20,16:52:00,19807.0,SELL,3,0.02h,Stop Loss,$12.00,$295.50,$84741.50,166,$295.50
2024-08-20,17:28:00,19792.25,BUY,3,0.02h,Stop Loss,$-9.00,$286.50,$84732.50,166,$286.50
2024-08-20,18:50:00,19849.75,SELL,3,0.02h,Break Even,$-1.50,$285.00,$84731.00,166,$285.00
2024-08-20,19:05:00,19853.0,BUY,3,0.02h,Stop Loss,$6.00,$291.00,$84737.00,166,$291.00
2024-08-20,19:09:00,19839.75,SELL,3,0.02h,Break Even,$-1.50,$289.50,$84735.50,166,$289.50
2024-08-20,19:49:00,19837.5,BUY,3,0.02h,Stop Loss,$24.00,$313.50,$84759.50,166,$313.50
2024-08-20,19:55:00,19826.75,SELL,3,0.02h,Stop Loss,$48.00,$361.50,$84807.50,166,$361.50
2024-08-20,20:15:00,19831.5,BUY,3,0.02h,Stop Loss,$-9.00,$352.50,$84798.50,166,$352.50
2024-08-20,20:24:00,19818.75,SELL,3,0.02h,Stop Loss,$-9.00,$343.50,$84789.50,166,$343.50
2024-08-20,23:32:00,19803.5,BUY,3,0.02h,Stop Loss,$-9.00,$334.50,$84780.50,166,$334.50
2024-08-20,23:48:00,19793.75,SELL,3,0.02h,Stop Loss,$-9.00,$325.50,$84771.50,166,$325.50
,,,,,,,,,,,
2024-08-21,00:04:00,19799.75,BUY,3,0.02h,Break Even,$-1.50,$-1.50,$84770.00,167,$-1.50
2024-08-21,00:32:00,19801.75,SELL,3,0.02h,Stop Loss,$12.00,$10.50,$84782.00,167,$10.50
2024-08-21,00:37:00,19813.75,BUY,3,0.02h,Stop Loss,$-9.00,$1.50,$84773.00,167,$1.50
2024-08-21,01:07:00,19817.5,SELL,3,0.02h,Break Even,$-1.50,$0.00,$84771.50,167,$0.00
2024-08-21,01:15:00,19828.25,BUY,3,0.02h,Stop Loss,$3.00,$3.00,$84774.50,167,$3.00
2024-08-21,01:32:00,19821.25,SELL,3,0.02h,Stop Loss,$-9.00,$-6.00,$84765.50,167,$-6.00
2024-08-21,01:40:00,19828.0,BUY,3,0.02h,Stop Loss,$-9.00,$-15.00,$84756.50,167,$-15.00
2024-08-21,01:45:00,19819.25,SELL,3,0.02h,Stop Loss,$-9.00,$-24.00,$84747.50,167,$-24.00
2024-08-21,01:52:00,19827.5,BUY,3,0.02h,Break Even,$-1.50,$-25.50,$84746.00,167,$-25.50
2024-08-21,02:00:00,19817.5,SELL,3,0.02h,Stop Loss,$18.00,$-7.50,$84764.00,167,$-7.50
2024-08-21,02:21:00,19820.0,BUY,3,0.02h,Break Even,$-1.50,$-9.00,$84762.50,167,$-9.00
2024-08-21,02:42:00,19816.5,SELL,3,0.02h,Stop Loss,$-9.00,$-18.00,$84753.50,167,$-18.00
2024-08-21,02:53:00,19823.75,BUY,3,0.03h,Stop Loss,$-9.00,$-27.00,$84744.50,167,$-27.00
2024-08-21,03:58:00,19831.5,SELL,3,0.02h,Stop Loss,$-9.00,$-36.00,$84735.50,167,$-36.00
2024-08-21,04:15:00,19834.75,BUY,3,0.02h,Stop Loss,$-9.00,$-45.00,$84726.50,167,$-45.00
2024-08-21,04:24:00,19831.5,SELL,3,0.02h,Break Even,$-1.50,$-46.50,$84725.00,167,$-46.50
2024-08-21,04:32:00,19836.0,BUY,3,0.02h,Stop Loss,$-9.00,$-55.50,$84716.00,167,$-55.50
2024-08-21,04:34:00,19833.0,SELL,3,0.02h,Stop Loss,$-9.00,$-64.50,$84707.00,167,$-64.50
2024-08-21,04:36:00,19836.25,BUY,3,0.02h,Break Even,$-1.50,$-66.00,$84705.50,167,$-66.00
2024-08-21,05:38:00,19844.75,SELL,3,0.02h,Break Even,$-1.50,$-67.50,$84704.00,167,$-67.50
2024-08-21,06:25:00,19832.5,BUY,3,0.02h,Stop Loss,$-9.00,$-76.50,$84695.00,167,$-76.50
2024-08-21,06:26:00,19830.0,SELL,3,0.02h,Break Even,$-1.50,$-78.00,$84693.50,167,$-78.00
2024-08-21,07:13:00,19818.5,BUY,3,0.02h,Stop Loss,$-9.00,$-87.00,$84684.50,167,$-87.00
2024-08-21,07:58:00,19819.0,SELL,3,0.02h,Break Even,$-1.50,$-88.50,$84683.00,167,$-88.50
2024-08-21,08:19:00,19827.5,BUY,3,0.02h,Stop Loss,$-9.00,$-97.50,$84674.00,167,$-97.50
2024-08-21,08:26:00,19802.0,SELL,3,0.02h,Stop Loss,$24.00,$-73.50,$84698.00,167,$-73.50
2024-08-21,08:44:00,19810.75,BUY,3,0.02h,Break Even,$-1.50,$-75.00,$84696.50,167,$-75.00
2024-08-21,08:48:00,19803.75,SELL,3,0.02h,Stop Loss,$-9.00,$-84.00,$84687.50,167,$-84.00
2024-08-21,08:54:00,19809.5,BUY,3,0.02h,Stop Loss,$-9.00,$-93.00,$84678.50,167,$-93.00
2024-08-21,08:55:00,19805.75,SELL,3,0.02h,Stop Loss,$-9.00,$-102.00,$84669.50,167,$-102.00
2024-08-21,08:56:00,19808.0,BUY,3,0.02h,Stop Loss,$-9.00,$-111.00,$84660.50,167,$-111.00
2024-08-21,08:58:00,19806.0,SELL,3,0.02h,Stop Loss,$16.50,$-94.50,$84677.00,167,$-94.50
2024-08-21,09:14:00,19807.25,BUY,3,0.02h,Break Even,$-1.50,$-96.00,$84675.50,167,$-96.00
2024-08-21,09:28:00,19800.75,SELL,3,0.02h,Stop Loss,$12.00,$-84.00,$84687.50,167,$-84.00
2024-08-21,09:37:00,19805.75,BUY,3,0.02h,Stop Loss,$-9.00,$-93.00,$84678.50,167,$-93.00
2024-08-21,09:41:00,19800.5,SELL,3,0.02h,Stop Loss,$-9.00,$-102.00,$84669.50,167,$-102.00
2024-08-21,09:42:00,19808.75,BUY,3,0.02h,Stop Loss,$-9.00,$-111.00,$84660.50,167,$-111.00
2024-08-21,09:52:00,19800.0,SELL,3,0.02h,Break Even,$-1.50,$-112.50,$84659.00,167,$-112.50
2024-08-21,10:06:00,19808.0,BUY,3,0.02h,Break Even,$-1.50,$-114.00,$84657.50,167,$-114.00
2024-08-21,11:29:00,19844.75,SELL,3,0.02h,Break Even,$-1.50,$-115.50,$84656.00,167,$-115.50
2024-08-21,12:14:00,19834.5,BUY,3,0.02h,Break Even,$-1.50,$-117.00,$84654.50,167,$-117.00
2024-08-21,12:50:00,19848.5,SELL,3,0.02h,Stop Loss,$3.00,$-114.00,$84657.50,167,$-114.00
2024-08-21,13:06:00,19853.0,BUY,3,0.02h,Stop Loss,$-9.00,$-123.00,$84648.50,167,$-123.00
2024-08-21,13:21:00,19843.75,SELL,3,0.02h,Break Even,$-1.50,$-124.50,$84647.00,167,$-124.50
2024-08-21,13:25:00,19854.5,BUY,3,0.02h,Stop Loss,$-9.00,$-133.50,$84638.00,167,$-133.50
2024-08-21,13:29:00,19844.0,SELL,3,0.02h,Stop Loss,$9.00,$-124.50,$84647.00,167,$-124.50
2024-08-21,13:42:00,19855.5,BUY,3,0.02h,Break Even,$-1.50,$-126.00,$84645.50,167,$-126.00
2024-08-21,14:17:00,19869.0,SELL,3,0.02h,Stop Loss,$30.00,$-96.00,$84675.50,167,$-96.00
2024-08-21,14:20:00,19898.25,BUY,3,0.02h,Stop Loss,$30.00,$-66.00,$84705.50,167,$-66.00
2024-08-21,14:28:00,19881.75,SELL,3,0.02h,Break Even,$-1.50,$-67.50,$84704.00,167,$-67.50
2024-08-21,14:37:00,19935.5,BUY,3,0.02h,Stop Loss,$30.00,$-37.50,$84734.00,167,$-37.50
2024-08-21,14:52:00,19859.75,SELL,3,0.02h,Stop Loss,$298.50,$261.00,$85032.50,167,$261.00
2024-08-21,15:13:00,19879.75,BUY,3,0.02h,Stop Loss,$49.50,$310.50,$85082.00,167,$310.50
2024-08-21,15:27:00,19864.0,SELL,3,0.02h,Break Even,$-1.50,$309.00,$85080.50,167,$309.00
2024-08-21,16:19:00,19818.25,BUY,3,0.02h,Stop Loss,$67.50,$376.50,$85148.00,167,$376.50
2024-08-21,17:19:00,19858.5,SELL,3,0.02h,Stop Loss,$-9.00,$367.50,$85139.00,167,$367.50
2024-08-21,17:32:00,19868.25,BUY,3,0.02h,Break Even,$-1.50,$366.00,$85137.50,167,$366.00
2024-08-21,18:40:00,19904.25,SELL,3,0.02h,Stop Loss,$28.50,$394.50,$85166.00,167,$394.50
2024-08-21,18:55:00,19915.0,BUY,3,0.02h,Break Even,$-1.50,$393.00,$85164.50,167,$393.00
2024-08-21,19:01:00,19898.25,SELL,3,0.02h,Stop Loss,$33.00,$426.00,$85197.50,167,$426.00
2024-08-21,19:34:00,19875.0,BUY,3,0.02h,Stop Loss,$-9.00,$417.00,$85188.50,167,$417.00
2024-08-21,19:39:00,19865.0,SELL,3,0.02h,Stop Loss,$-9.00,$408.00,$85179.50,167,$408.00
2024-08-21,19:40:00,19875.25,BUY,3,0.02h,Break Even,$-1.50,$406.50,$85178.00,167,$406.50
2024-08-21,19:44:00,19859.75,SELL,3,0.02h,Stop Loss,$-9.00,$397.50,$85169.00,167,$397.50
2024-08-21,19:49:00,19879.0,BUY,3,0.02h,Stop Loss,$22.50,$420.00,$85191.50,167,$420.00
2024-08-21,20:48:00,19912.75,SELL,3,0.02h,Stop Loss,$-9.00,$411.00,$85182.50,167,$411.00
2024-08-21,20:52:00,19918.75,BUY,3,0.02h,Stop Loss,$-9.00,$402.00,$85173.50,167,$402.00
,,,,,,,,,,,
2024-08-22,00:03:00,19931.5,SELL,3,0.02h,Break Even,$-1.50,$-1.50,$85172.00,168,$-1.50
2024-08-22,00:11:00,19942.25,BUY,3,0.02h,Break Even,$-1.50,$-3.00,$85170.50,168,$-3.00
2024-08-22,00:26:00,19934.25,SELL,3,0.02h,Stop Loss,$6.00,$3.00,$85176.50,168,$3.00
2024-08-22,00:40:00,19938.75,BUY,3,0.02h,Stop Loss,$-9.00,$-6.00,$85167.50,168,$-6.00
2024-08-22,00:45:00,19933.75,SELL,3,0.02h,Break Even,$-1.50,$-7.50,$85166.00,168,$-7.50
2024-08-22,00:54:00,19935.5,BUY,3,0.03h,Break Even,$-1.50,$-9.00,$85164.50,168,$-9.00
2024-08-22,00:58:00,19932.75,SELL,3,0.02h,Break Even,$-1.50,$-10.50,$85163.00,168,$-10.50
2024-08-22,01:52:00,19927.25,BUY,3,0.02h,Break Even,$-1.50,$-12.00,$85161.50,168,$-12.00
2024-08-22,02:01:00,19921.25,SELL,3,0.02h,Break Even,$-1.50,$-13.50,$85160.00,168,$-13.50
2024-08-22,03:05:00,19888.5,BUY,3,0.02h,Stop Loss,$-9.00,$-22.50,$85151.00,168,$-22.50
2024-08-22,03:07:00,19875.5,SELL,3,0.02h,Stop Loss,$28.50,$6.00,$85179.50,168,$6.00
2024-08-22,03:43:00,19879.75,BUY,3,0.02h,Break Even,$-1.50,$4.50,$85178.00,168,$4.50
2024-08-22,04:23:00,19883.5,SELL,3,0.02h,Break Even,$-1.50,$3.00,$85176.50,168,$3.00
2024-08-22,04:34:00,19889.25,BUY,3,0.03h,Stop Loss,$-9.00,$-6.00,$85167.50,168,$-6.00
2024-08-22,05:41:00,19900.75,SELL,3,0.02h,Stop Loss,$-9.00,$-15.00,$85158.50,168,$-15.00
2024-08-22,06:08:00,19901.25,BUY,3,0.02h,Break Even,$-1.50,$-16.50,$85157.00,168,$-16.50
2024-08-22,06:37:00,19904.75,SELL,3,0.02h,Stop Loss,$-9.00,$-25.50,$85148.00,168,$-25.50
2024-08-22,06:42:00,19908.5,BUY,3,0.02h,Break Even,$-1.50,$-27.00,$85146.50,168,$-27.00
2024-08-22,06:46:00,19905.0,SELL,3,0.02h,Stop Loss,$-9.00,$-36.00,$85137.50,168,$-36.00
2024-08-22,06:47:00,19909.5,BUY,3,0.02h,Stop Loss,$16.50,$-19.50,$85154.00,168,$-19.50
2024-08-22,07:15:00,19915.0,SELL,3,0.02h,Stop Loss,$-9.00,$-28.50,$85145.00,168,$-28.50
2024-08-22,07:16:00,19919.0,BUY,3,0.02h,Stop Loss,$13.50,$-15.00,$85158.50,168,$-15.00
2024-08-22,07:27:00,19913.5,SELL,3,0.02h,Stop Loss,$-9.00,$-24.00,$85149.50,168,$-24.00
2024-08-22,07:51:00,19912.25,BUY,3,0.02h,Stop Loss,$-9.00,$-33.00,$85140.50,168,$-33.00
2024-08-22,08:09:00,19901.0,SELL,3,0.02h,Break Even,$-1.50,$-34.50,$85139.00,168,$-34.50
2024-08-22,08:18:00,19915.5,BUY,3,0.02h,Stop Loss,$3.00,$-31.50,$85142.00,168,$-31.50
2024-08-22,08:58:00,19915.0,SELL,3,0.02h,Stop Loss,$-9.00,$-40.50,$85133.00,168,$-40.50
2024-08-22,09:02:00,19922.5,BUY,3,0.02h,Stop Loss,$-9.00,$-49.50,$85124.00,168,$-49.50
2024-08-22,09:30:00,19923.25,SELL,3,0.02h,Break Even,$-1.50,$-51.00,$85122.50,168,$-51.00
2024-08-22,09:56:00,19920.25,BUY,3,0.02h,Stop Loss,$-9.00,$-60.00,$85113.50,168,$-60.00
2024-08-22,09:58:00,19916.0,SELL,3,0.02h,Break Even,$-1.50,$-61.50,$85112.00,168,$-61.50
2024-08-22,10:05:00,19923.0,BUY,3,0.02h,Break Even,$-1.50,$-63.00,$85110.50,168,$-63.00
2024-08-22,11:36:00,19969.0,SELL,3,0.02h,Break Even,$-1.50,$-64.50,$85109.00,168,$-64.50
2024-08-22,11:48:00,19971.75,BUY,3,0.02h,Stop Loss,$-9.00,$-73.50,$85100.00,168,$-73.50
2024-08-22,12:15:00,19975.25,SELL,3,0.02h,Stop Loss,$-9.00,$-82.50,$85091.00,168,$-82.50
2024-08-22,12:33:00,19972.5,BUY,3,0.02h,Stop Loss,$-9.00,$-91.50,$85082.00,168,$-91.50
2024-08-22,12:34:00,19960.25,SELL,3,0.02h,Break Even,$-1.50,$-93.00,$85080.50,168,$-93.00
2024-08-22,12:52:00,19971.75,BUY,3,0.02h,Stop Loss,$6.00,$-87.00,$85086.50,168,$-87.00
2024-08-22,13:39:00,19981.25,SELL,3,0.02h,Stop Loss,$46.50,$-40.50,$85133.00,168,$-40.50
2024-08-22,13:57:00,20003.75,BUY,3,0.02h,Stop Loss,$10.50,$-30.00,$85143.50,168,$-30.00
2024-08-22,14:01:00,19973.75,SELL,3,0.02h,Stop Loss,$94.50,$64.50,$85238.00,168,$64.50
2024-08-22,15:03:00,19905.5,BUY,3,0.02h,Stop Loss,$9.00,$73.50,$85247.00,168,$73.50
2024-08-22,15:11:00,19869.0,SELL,3,0.02h,Stop Loss,$45.00,$118.50,$85292.00,168,$118.50
2024-08-22,16:06:00,19736.0,BUY,3,0.02h,Stop Loss,$7.50,$126.00,$85299.50,168,$126.00
2024-08-22,16:51:00,19775.25,SELL,3,0.02h,Stop Loss,$94.50,$220.50,$85394.00,168,$220.50
2024-08-22,17:28:00,19720.75,BUY,3,0.02h,Break Even,$-1.50,$219.00,$85392.50,168,$219.00
2024-08-22,17:30:00,19709.25,SELL,3,0.02h,Stop Loss,$7.50,$226.50,$85400.00,168,$226.50
2024-08-22,18:16:00,19639.75,BUY,3,0.02h,Break Even,$-1.50,$225.00,$85398.50,168,$225.00
2024-08-22,18:55:00,19629.25,SELL,3,0.02h,Stop Loss,$-9.00,$216.00,$85389.50,168,$216.00
2024-08-22,19:05:00,19660.75,BUY,3,0.02h,Break Even,$-1.50,$214.50,$85388.00,168,$214.50
2024-08-22,19:11:00,19630.0,SELL,3,0.02h,Stop Loss,$-9.00,$205.50,$85379.00,168,$205.50
2024-08-22,20:03:00,19597.25,BUY,3,0.02h,Stop Loss,$18.00,$223.50,$85397.00,168,$223.50
2024-08-22,20:44:00,19609.5,SELL,3,0.02h,Break Even,$-1.50,$222.00,$85395.50,168,$222.00
2024-08-22,20:45:00,19613.5,BUY,3,0.02h,Stop Loss,$15.00,$237.00,$85410.50,168,$237.00
2024-08-22,23:19:00,19623.5,SELL,3,0.02h,Stop Loss,$-9.00,$228.00,$85401.50,168,$228.00
2024-08-22,23:33:00,19630.25,BUY,3,0.02h,Stop Loss,$-9.00,$219.00,$85392.50,168,$219.00
2024-08-22,23:41:00,19621.25,SELL,3,0.02h,Stop Loss,$-9.00,$210.00,$85383.50,168,$210.00
2024-08-22,23:47:00,19627.75,BUY,3,0.02h,Stop Loss,$-9.00,$201.00,$85374.50,168,$201.00
,,,,,,,,,,,
2024-08-23,00:43:00,19647.75,SELL,3,0.02h,Stop Loss,$-9.00,$-9.00,$85365.50,169,$-9.00
2024-08-23,00:44:00,19652.0,BUY,3,0.02h,Break Even,$-1.50,$-10.50,$85364.00,169,$-10.50
2024-08-23,00:46:00,19649.0,SELL,3,0.02h,Break Even,$-1.50,$-12.00,$85362.50,169,$-12.00
2024-08-23,01:07:00,19646.75,BUY,3,0.02h,Break Even,$-1.50,$-13.50,$85361.00,169,$-13.50
2024-08-23,01:22:00,19642.75,SELL,3,0.02h,Stop Loss,$13.50,$0.00,$85374.50,169,$0.00
2024-08-23,01:30:00,19657.25,BUY,3,0.02h,Stop Loss,$-9.00,$-9.00,$85365.50,169,$-9.00
2024-08-23,01:52:00,19645.75,SELL,3,0.02h,Break Even,$-1.50,$-10.50,$85364.00,169,$-10.50
2024-08-23,02:08:00,19653.75,BUY,3,0.02h,Break Even,$-1.50,$-12.00,$85362.50,169,$-12.00
2024-08-23,02:30:00,19650.25,SELL,3,0.02h,Break Even,$-1.50,$-13.50,$85361.00,169,$-13.50
2024-08-23,02:48:00,19650.75,BUY,3,0.02h,Stop Loss,$-9.00,$-22.50,$85352.00,169,$-22.50
2024-08-23,02:51:00,19644.5,SELL,3,0.02h,Break Even,$-1.50,$-24.00,$85350.50,169,$-24.00
2024-08-23,03:00:00,19650.0,BUY,3,0.02h,Break Even,$-1.50,$-25.50,$85349.00,169,$-25.50
2024-08-23,04:41:00,19681.0,SELL,3,0.05h,Stop Loss,$-9.00,$-34.50,$85340.00,169,$-34.50
2024-08-23,04:48:00,19684.75,BUY,3,0.02h,Break Even,$-1.50,$-36.00,$85338.50,169,$-36.00
2024-08-23,04:51:00,19678.75,SELL,3,0.02h,Break Even,$-1.50,$-37.50,$85337.00,169,$-37.50
2024-08-23,05:05:00,19682.75,BUY,3,0.02h,Break Even,$-1.50,$-39.00,$85335.50,169,$-39.00
2024-08-23,05:46:00,19687.0,SELL,3,0.02h,Break Even,$-1.50,$-40.50,$85334.00,169,$-40.50
2024-08-23,06:07:00,19689.5,BUY,3,0.02h,Stop Loss,$-9.00,$-49.50,$85325.00,169,$-49.50
2024-08-23,06:17:00,19684.5,SELL,3,0.02h,Stop Loss,$-9.00,$-58.50,$85316.00,169,$-58.50
2024-08-23,06:22:00,19687.75,BUY,3,0.02h,Stop Loss,$-9.00,$-67.50,$85307.00,169,$-67.50
2024-08-23,06:25:00,19681.0,SELL,3,0.02h,Stop Loss,$18.00,$-49.50,$85325.00,169,$-49.50
2024-08-23,06:37:00,19688.5,BUY,3,0.02h,Stop Loss,$15.00,$-34.50,$85340.00,169,$-34.50
2024-08-23,06:50:00,19679.75,SELL,3,0.02h,Break Even,$-1.50,$-36.00,$85338.50,169,$-36.00
2024-08-23,06:55:00,19688.25,BUY,3,0.02h,Stop Loss,$-9.00,$-45.00,$85329.50,169,$-45.00
2024-08-23,07:36:00,19693.0,SELL,3,0.02h,Stop Loss,$-9.00,$-54.00,$85320.50,169,$-54.00
2024-08-23,07:45:00,19704.5,BUY,3,0.02h,Stop Loss,$-9.00,$-63.00,$85311.50,169,$-63.00
2024-08-23,07:53:00,19691.5,SELL,3,0.02h,Stop Loss,$10.50,$-52.50,$85322.00,169,$-52.50
2024-08-23,08:11:00,19693.25,BUY,3,0.02h,Stop Loss,$-9.00,$-61.50,$85313.00,169,$-61.50
2024-08-23,09:07:00,19703.75,SELL,3,0.02h,Break Even,$-1.50,$-63.00,$85311.50,169,$-63.00
2024-08-23,09:31:00,19705.5,BUY,3,0.02h,Break Even,$-1.50,$-64.50,$85310.00,169,$-64.50
2024-08-23,10:26:00,19719.0,SELL,3,0.02h,Stop Loss,$-9.00,$-73.50,$85301.00,169,$-73.50
2024-08-23,10:34:00,19727.75,BUY,3,0.02h,Stop Loss,$-9.00,$-82.50,$85292.00,169,$-82.50
2024-08-23,11:04:00,19735.25,SELL,3,0.02h,Stop Loss,$-9.00,$-91.50,$85283.00,169,$-91.50
2024-08-23,11:09:00,19744.75,BUY,3,0.02h,Stop Loss,$-9.00,$-100.50,$85274.00,169,$-100.50
2024-08-23,11:13:00,19735.0,SELL,3,0.02h,Break Even,$-1.50,$-102.00,$85272.50,169,$-102.00
2024-08-23,11:38:00,19733.75,BUY,3,0.02h,Stop Loss,$-9.00,$-111.00,$85263.50,169,$-111.00
2024-08-23,11:54:00,19728.75,SELL,3,0.02h,Stop Loss,$-9.00,$-120.00,$85254.50,169,$-120.00
2024-08-23,11:58:00,19739.0,BUY,3,0.02h,Break Even,$-1.50,$-121.50,$85253.00,169,$-121.50
2024-08-23,12:14:00,19732.0,SELL,3,0.02h,Stop Loss,$4.50,$-117.00,$85257.50,169,$-117.00
2024-08-23,12:34:00,19738.0,BUY,3,0.02h,Break Even,$-1.50,$-118.50,$85256.00,169,$-118.50
2024-08-23,13:27:00,19761.5,SELL,3,0.02h,Stop Loss,$10.50,$-108.00,$85266.50,169,$-108.00
2024-08-23,13:50:00,19749.5,BUY,3,0.02h,Stop Loss,$21.00,$-87.00,$85287.50,169,$-87.00
2024-08-23,14:38:00,19830.25,SELL,3,0.02h,Stop Loss,$130.50,$43.50,$85418.00,169,$43.50
2024-08-23,15:16:00,19780.25,BUY,3,0.02h,Break Even,$-1.50,$42.00,$85416.50,169,$42.00
2024-08-23,15:46:00,19718.0,SELL,3,0.02h,Stop Loss,$34.50,$76.50,$85451.00,169,$76.50
2024-08-23,16:36:00,19690.75,BUY,3,0.02h,Stop Loss,$34.50,$111.00,$85485.50,169,$111.00
2024-08-23,16:43:00,19608.25,SELL,3,0.02h,Stop Loss,$6.00,$117.00,$85491.50,169,$117.00
2024-08-23,16:56:00,19689.75,BUY,3,0.02h,Stop Loss,$39.00,$156.00,$85530.50,169,$156.00
2024-08-23,18:00:00,19732.75,SELL,3,0.02h,Stop Loss,$40.50,$196.50,$85571.00,169,$196.50
2024-08-23,18:05:00,19748.75,BUY,3,0.02h,Break Even,$-1.50,$195.00,$85569.50,169,$195.00
2024-08-23,18:33:00,19742.25,SELL,3,0.02h,Break Even,$-1.50,$193.50,$85568.00,169,$193.50
2024-08-23,18:41:00,19753.75,BUY,3,0.02h,Stop Loss,$42.00,$235.50,$85610.00,169,$235.50
2024-08-23,18:58:00,19742.5,SELL,3,0.02h,Stop Loss,$99.00,$334.50,$85709.00,169,$334.50
2024-08-23,19:13:00,19755.25,BUY,3,0.02h,Stop Loss,$165.00,$499.50,$85874.00,169,$499.50
2024-08-23,19:39:00,19770.25,SELL,3,0.02h,Stop Loss,$54.00,$553.50,$85928.00,169,$553.50
2024-08-23,19:54:00,19781.75,BUY,3,0.02h,Stop Loss,$127.50,$681.00,$86055.50,169,$681.00
2024-08-23,20:34:00,19786.75,SELL,3,0.02h,Break Even,$-1.50,$679.50,$86054.00,169,$679.50
,,,,,,,,,,,
2024-08-26,00:19:00,19783.25,BUY,3,0.02h,Stop Loss,$-9.00,$-9.00,$86045.00,170,$-9.00
2024-08-26,00:29:00,19772.0,SELL,3,0.02h,Stop Loss,$-9.00,$-18.00,$86036.00,170,$-18.00
2024-08-26,00:33:00,19784.5,BUY,3,0.02h,Stop Loss,$-9.00,$-27.00,$86027.00,170,$-27.00
2024-08-26,01:39:00,19807.0,SELL,3,0.02h,Stop Loss,$9.00,$-18.00,$86036.00,170,$-18.00
2024-08-26,02:55:00,19795.75,BUY,3,0.02h,Stop Loss,$-9.00,$-27.00,$86027.00,170,$-27.00
2024-08-26,02:57:00,19789.25,SELL,3,0.02h,Stop Loss,$-9.00,$-36.00,$86018.00,170,$-36.00
2024-08-26,02:59:00,19793.0,BUY,3,0.02h,Stop Loss,$-9.00,$-45.00,$86009.00,170,$-45.00
2024-08-26,03:00:00,19789.75,SELL,3,0.02h,Stop Loss,$-9.00,$-54.00,$86000.00,170,$-54.00
2024-08-26,03:02:00,19793.5,BUY,3,0.02h,Break Even,$-1.50,$-55.50,$85998.50,170,$-55.50
2024-08-26,03:27:00,19791.0,SELL,3,0.02h,Stop Loss,$-9.00,$-64.50,$85989.50,170,$-64.50
2024-08-26,04:11:00,19771.0,BUY,3,0.02h,Stop Loss,$7.50,$-57.00,$85997.00,170,$-57.00
2024-08-26,05:02:00,19773.75,SELL,3,0.02h,Break Even,$-1.50,$-58.50,$85995.50,170,$-58.50
2024-08-26,05:21:00,19776.75,BUY,3,0.02h,Break Even,$-1.50,$-60.00,$85994.00,170,$-60.00
2024-08-26,06:36:00,19793.0,SELL,3,0.02h,Break Even,$-1.50,$-61.50,$85992.50,170,$-61.50
2024-08-26,07:02:00,19796.25,BUY,3,0.02h,Stop Loss,$-9.00,$-70.50,$85983.50,170,$-70.50
2024-08-26,07:04:00,19785.0,SELL,3,0.02h,Break Even,$-1.50,$-72.00,$85982.00,170,$-72.00
2024-08-26,07:05:00,19790.75,BUY,3,0.02h,Stop Loss,$21.00,$-51.00,$86003.00,170,$-51.00
2024-08-26,07:45:00,19814.0,SELL,3,0.02h,Break Even,$-1.50,$-52.50,$86001.50,170,$-52.50
2024-08-26,07:55:00,19822.5,BUY,3,0.02h,Break Even,$-1.50,$-54.00,$86000.00,170,$-54.00
2024-08-26,08:25:00,19826.5,SELL,3,0.02h,Break Even,$-1.50,$-55.50,$85998.50,170,$-55.50
2024-08-26,08:33:00,19837.5,BUY,3,0.02h,Stop Loss,$-9.00,$-64.50,$85989.50,170,$-64.50
2024-08-26,09:06:00,19834.25,SELL,3,0.02h,Stop Loss,$10.50,$-54.00,$86000.00,170,$-54.00
2024-08-26,09:23:00,19836.0,BUY,3,0.02h,Break Even,$-1.50,$-55.50,$85998.50,170,$-55.50
2024-08-26,09:34:00,19829.75,SELL,3,0.02h,Stop Loss,$-9.00,$-64.50,$85989.50,170,$-64.50
2024-08-26,09:39:00,19837.0,BUY,3,0.02h,Break Even,$-1.50,$-66.00,$85988.00,170,$-66.00
2024-08-26,09:48:00,19832.0,SELL,3,0.02h,Break Even,$-1.50,$-67.50,$85986.50,170,$-67.50
2024-08-26,09:57:00,19834.5,BUY,3,0.02h,Break Even,$-1.50,$-69.00,$85985.00,170,$-69.00
2024-08-26,10:31:00,19825.0,SELL,3,0.02h,Stop Loss,$12.00,$-57.00,$85997.00,170,$-57.00
2024-08-26,12:03:00,19779.25,BUY,3,0.02h,Stop Loss,$-9.00,$-66.00,$85988.00,170,$-66.00
2024-08-26,12:04:00,19774.25,SELL,3,0.02h,Break Even,$-1.50,$-67.50,$85986.50,170,$-67.50
2024-08-26,12:05:00,19776.0,BUY,3,0.02h,Stop Loss,$-9.00,$-76.50,$85977.50,170,$-76.50
2024-08-26,12:28:00,19776.5,SELL,3,0.02h,Stop Loss,$-9.00,$-85.50,$85968.50,170,$-85.50
2024-08-26,12:55:00,19773.0,BUY,3,0.02h,Break Even,$-1.50,$-87.00,$85967.00,170,$-87.00
2024-08-26,13:05:00,19760.25,SELL,3,0.02h,Stop Loss,$-9.00,$-96.00,$85958.00,170,$-96.00
2024-08-26,13:09:00,19774.0,BUY,3,0.02h,Stop Loss,$-9.00,$-105.00,$85949.00,170,$-105.00
2024-08-26,13:31:00,19768.25,SELL,3,0.02h,Stop Loss,$132.00,$27.00,$86081.00,170,$27.00
2024-08-26,13:34:00,19793.75,BUY,3,0.02h,Stop Loss,$25.50,$52.50,$86106.50,170,$52.50
2024-08-26,13:43:00,19760.25,SELL,3,0.02h,Stop Loss,$61.50,$114.00,$86168.00,170,$114.00
2024-08-26,14:57:00,19576.75,BUY,3,0.02h,Stop Loss,$42.00,$156.00,$86210.00,170,$156.00
2024-08-26,15:33:00,19595.25,SELL,3,0.02h,Stop Loss,$-9.00,$147.00,$86201.00,170,$147.00
2024-08-26,15:43:00,19611.0,BUY,3,0.02h,Stop Loss,$40.50,$187.50,$86241.50,170,$187.50
2024-08-26,15:46:00,19588.5,SELL,3,0.02h,Stop Loss,$6.00,$193.50,$86247.50,170,$193.50
2024-08-26,16:18:00,19579.0,BUY,3,0.02h,Break Even,$-1.50,$192.00,$86246.00,170,$192.00
2024-08-26,16:57:00,19619.5,SELL,3,0.02h,Break Even,$-1.50,$190.50,$86244.50,170,$190.50
2024-08-26,17:26:00,19618.25,BUY,3,0.02h,Stop Loss,$-9.00,$181.50,$86235.50,170,$181.50
2024-08-26,17:30:00,19595.25,SELL,3,0.02h,Break Even,$-1.50,$180.00,$86234.00,170,$180.00
2024-08-26,18:17:00,19541.25,BUY,3,0.02h,Break Even,$-1.50,$178.50,$86232.50,170,$178.50
2024-08-26,19:09:00,19597.25,SELL,3,0.02h,Break Even,$-1.50,$177.00,$86231.00,170,$177.00
2024-08-26,19:55:00,19586.5,BUY,3,0.02h,Break Even,$-1.50,$175.50,$86229.50,170,$175.50
2024-08-26,19:57:00,19571.0,SELL,3,0.02h,Stop Loss,$66.00,$241.50,$86295.50,170,$241.50
2024-08-26,20:00:00,19593.5,BUY,3,0.02h,Stop Loss,$3.00,$244.50,$86298.50,170,$244.50
2024-08-26,20:06:00,19575.25,SELL,3,0.02h,Break Even,$-1.50,$243.00,$86297.00,170,$243.00
2024-08-26,20:55:00,19566.5,BUY,3,0.02h,Break Even,$-1.50,$241.50,$86295.50,170,$241.50
2024-08-26,21:00:00,19549.75,SELL,3,2.02h,Stop Loss,$64.50,$306.00,$86360.00,170,$306.00
2024-08-26,23:18:00,19559.5,BUY,3,0.02h,Break Even,$-1.50,$304.50,$86358.50,170,$304.50
,,,,,,,,,,,
2024-08-27,00:02:00,19568.0,SELL,3,0.02h,Stop Loss,$-9.00,$-9.00,$86349.50,171,$-9.00
2024-08-27,00:19:00,19575.0,BUY,3,0.02h,Stop Loss,$-9.00,$-18.00,$86340.50,171,$-18.00
2024-08-27,00:45:00,19575.5,SELL,3,0.02h,Stop Loss,$-9.00,$-27.00,$86331.50,171,$-27.00
2024-08-27,01:18:00,19567.0,BUY,3,0.02h,Stop Loss,$25.50,$-1.50,$86357.00,171,$-1.50
2024-08-27,01:34:00,19559.75,SELL,3,0.02h,Stop Loss,$-9.00,$-10.50,$86348.00,171,$-10.50
2024-08-27,01:51:00,19565.25,BUY,3,0.02h,Break Even,$-1.50,$-12.00,$86346.50,171,$-12.00
2024-08-27,03:21:00,19598.0,SELL,3,0.02h,Break Even,$-1.50,$-13.50,$86345.00,171,$-13.50
2024-08-27,03:45:00,19598.75,BUY,3,0.02h,Stop Loss,$-9.00,$-22.50,$86336.00,171,$-22.50
2024-08-27,04:01:00,19594.5,SELL,3,0.02h,Stop Loss,$-9.00,$-31.50,$86327.00,171,$-31.50
2024-08-27,04:03:00,19597.0,BUY,3,0.02h,Stop Loss,$-9.00,$-40.50,$86318.00,171,$-40.50
2024-08-27,04:04:00,19593.0,SELL,3,0.02h,Break Even,$-1.50,$-42.00,$86316.50,171,$-42.00
2024-08-27,04:17:00,19595.0,BUY,3,0.02h,Break Even,$-1.50,$-43.50,$86315.00,171,$-43.50
2024-08-27,04:46:00,19597.5,SELL,3,0.02h,Break Even,$-1.50,$-45.00,$86313.50,171,$-45.00
2024-08-27,04:49:00,19601.75,BUY,3,0.02h,Stop Loss,$-9.00,$-54.00,$86304.50,171,$-54.00
2024-08-27,05:40:00,19609.5,SELL,3,0.02h,Stop Loss,$-9.00,$-63.00,$86295.50,171,$-63.00
2024-08-27,05:52:00,19615.25,BUY,3,0.02h,Stop Loss,$-9.00,$-72.00,$86286.50,171,$-72.00
2024-08-27,06:04:00,19611.75,SELL,3,0.02h,Break Even,$-1.50,$-73.50,$86285.00,171,$-73.50
2024-08-27,06:38:00,19610.0,BUY,3,0.02h,Stop Loss,$16.50,$-57.00,$86301.50,171,$-57.00
2024-08-27,07:01:00,19607.75,SELL,3,0.02h,Break Even,$-1.50,$-58.50,$86300.00,171,$-58.50
2024-08-27,07:04:00,19614.0,BUY,3,0.02h,Stop Loss,$10.50,$-48.00,$86310.50,171,$-48.00
2024-08-27,07:07:00,19602.5,SELL,3,0.02h,Stop Loss,$-9.00,$-57.00,$86301.50,171,$-57.00
2024-08-27,07:33:00,19602.75,BUY,3,0.02h,Break Even,$-1.50,$-58.50,$86300.00,171,$-58.50
2024-08-27,07:53:00,19599.0,SELL,3,0.02h,Stop Loss,$-9.00,$-67.50,$86291.00,171,$-67.50
2024-08-27,07:55:00,19605.5,BUY,3,0.02h,Break Even,$-1.50,$-69.00,$86289.50,171,$-69.00
2024-08-27,08:48:00,19635.75,SELL,3,0.02h,Break Even,$-1.50,$-70.50,$86288.00,171,$-70.50
2024-08-27,09:11:00,19631.5,BUY,3,0.02h,Stop Loss,$-9.00,$-79.50,$86279.00,171,$-79.50
2024-08-27,09:35:00,19632.0,SELL,3,0.02h,Stop Loss,$-9.00,$-88.50,$86270.00,171,$-88.50
2024-08-27,09:37:00,19637.75,BUY,3,0.02h,Break Even,$-1.50,$-90.00,$86268.50,171,$-90.00
2024-08-27,09:39:00,19631.75,SELL,3,0.02h,Stop Loss,$-9.00,$-99.00,$86259.50,171,$-99.00
2024-08-27,09:57:00,19635.0,BUY,3,0.02h,Break Even,$-1.50,$-100.50,$86258.00,171,$-100.50
2024-08-27,10:01:00,19629.5,SELL,3,0.02h,Break Even,$-1.50,$-102.00,$86256.50,171,$-102.00
2024-08-27,11:09:00,19584.5,BUY,3,0.02h,Break Even,$-1.50,$-103.50,$86255.00,171,$-103.50
2024-08-27,11:57:00,19598.5,SELL,3,0.02h,Stop Loss,$10.50,$-93.00,$86265.50,171,$-93.00
2024-08-27,13:24:00,19516.0,BUY,3,0.02h,Stop Loss,$3.00,$-90.00,$86268.50,171,$-90.00
2024-08-27,13:38:00,19488.25,SELL,3,0.02h,Stop Loss,$99.00,$9.00,$86367.50,171,$9.00
2024-08-27,13:52:00,19509.75,BUY,3,0.02h,Stop Loss,$126.00,$135.00,$86493.50,171,$135.00
2024-08-27,15:20:00,19656.0,SELL,3,0.02h,Stop Loss,$22.50,$157.50,$86516.00,171,$157.50
2024-08-27,16:03:00,19614.5,BUY,3,0.02h,Stop Loss,$3.00,$160.50,$86519.00,171,$160.50
2024-08-27,16:32:00,19618.0,SELL,3,0.02h,Stop Loss,$-9.00,$151.50,$86510.00,171,$151.50
2024-08-27,16:33:00,19635.75,BUY,3,0.02h,Stop Loss,$34.50,$186.00,$86544.50,171,$186.00
2024-08-27,16:42:00,19610.5,SELL,3,0.02h,Stop Loss,$144.00,$330.00,$86688.50,171,$330.00
2024-08-27,16:51:00,19638.5,BUY,3,0.02h,Stop Loss,$31.50,$361.50,$86720.00,171,$361.50
2024-08-27,17:05:00,19622.25,SELL,3,0.02h,Stop Loss,$10.50,$372.00,$86730.50,171,$372.00
2024-08-27,17:06:00,19631.5,BUY,3,0.02h,Break Even,$-1.50,$370.50,$86729.00,171,$370.50
2024-08-27,18:12:00,19670.75,SELL,3,0.02h,Stop Loss,$43.50,$414.00,$86772.50,171,$414.00
2024-08-27,18:46:00,19667.0,BUY,3,0.02h,Stop Loss,$-9.00,$405.00,$86763.50,171,$405.00
2024-08-27,18:50:00,19658.75,SELL,3,0.02h,Stop Loss,$91.50,$496.50,$86855.00,171,$496.50
2024-08-27,19:28:00,19656.5,BUY,3,0.02h,Stop Loss,$-9.00,$487.50,$86846.00,171,$487.50
2024-08-27,19:32:00,19640.25,SELL,3,0.02h,Stop Loss,$18.00,$505.50,$86864.00,171,$505.50
2024-08-27,19:40:00,19650.5,BUY,3,0.02h,Stop Loss,$19.50,$525.00,$86883.50,171,$525.00
2024-08-27,19:54:00,19636.75,SELL,3,0.02h,Break Even,$-1.50,$523.50,$86882.00,171,$523.50
2024-08-27,20:04:00,19654.25,BUY,3,0.02h,Stop Loss,$19.50,$543.00,$86901.50,171,$543.00
2024-08-27,20:13:00,19646.0,SELL,3,0.02h,Stop Loss,$-9.00,$534.00,$86892.50,171,$534.00
2024-08-27,23:50:00,19585.5,BUY,3,0.02h,Stop Loss,$13.50,$547.50,$86906.00,171,$547.50
,,,,,,,,,,,
2024-08-28,00:19:00,19586.25,SELL,3,0.02h,Break Even,$-1.50,$-1.50,$86904.50,172,$-1.50
2024-08-28,00:33:00,19593.25,BUY,3,0.02h,Stop Loss,$-9.00,$-10.50,$86895.50,172,$-10.50
2024-08-28,01:15:00,19599.25,SELL,3,0.02h,Break Even,$-1.50,$-12.00,$86894.00,172,$-12.00
2024-08-28,01:17:00,19603.5,BUY,3,0.02h,Break Even,$-1.50,$-13.50,$86892.50,172,$-13.50
2024-08-28,01:28:00,19597.0,SELL,3,0.02h,Stop Loss,$4.50,$-9.00,$86897.00,172,$-9.00
2024-08-28,01:46:00,19603.0,BUY,3,0.02h,Stop Loss,$-9.00,$-18.00,$86888.00,172,$-18.00
2024-08-28,02:35:00,19614.25,SELL,3,0.02h,Stop Loss,$-9.00,$-27.00,$86879.00,172,$-27.00
2024-08-28,02:37:00,19619.25,BUY,3,0.02h,Stop Loss,$-9.00,$-36.00,$86870.00,172,$-36.00
2024-08-28,03:16:00,19619.75,SELL,3,0.02h,Break Even,$-1.50,$-37.50,$86868.50,172,$-37.50
2024-08-28,03:48:00,19619.5,BUY,3,0.02h,Stop Loss,$-9.00,$-46.50,$86859.50,172,$-46.50
2024-08-28,05:04:00,19628.75,SELL,3,0.02h,Break Even,$-1.50,$-48.00,$86858.00,172,$-48.00
2024-08-28,05:27:00,19628.0,BUY,3,0.07h,Break Even,$-1.50,$-49.50,$86856.50,172,$-49.50
2024-08-28,07:21:00,19641.5,SELL,3,0.02h,Stop Loss,$-9.00,$-58.50,$86847.50,172,$-58.50
2024-08-28,07:56:00,19645.25,BUY,3,0.02h,Stop Loss,$3.00,$-55.50,$86850.50,172,$-55.50
2024-08-28,08:11:00,19632.75,SELL,3,0.02h,Stop Loss,$7.50,$-48.00,$86858.00,172,$-48.00
2024-08-28,08:21:00,19646.0,BUY,3,0.02h,Break Even,$-1.50,$-49.50,$86856.50,172,$-49.50
2024-08-28,09:13:00,19676.0,SELL,3,0.02h,Stop Loss,$-9.00,$-58.50,$86847.50,172,$-58.50
2024-08-28,09:26:00,19683.0,BUY,3,0.02h,Break Even,$-1.50,$-60.00,$86846.00,172,$-60.00
2024-08-28,09:33:00,19678.25,SELL,3,0.02h,Stop Loss,$19.50,$-40.50,$86865.50,172,$-40.50
2024-08-28,10:04:00,19672.75,BUY,3,0.02h,Stop Loss,$-9.00,$-49.50,$86856.50,172,$-49.50
2024-08-28,10:11:00,19668.0,SELL,3,0.02h,Break Even,$-1.50,$-51.00,$86855.00,172,$-51.00
2024-08-28,10:30:00,19667.5,BUY,3,0.02h,Stop Loss,$10.50,$-40.50,$86865.50,172,$-40.50
2024-08-28,10:34:00,19664.5,SELL,3,0.02h,Stop Loss,$-9.00,$-49.50,$86856.50,172,$-49.50
2024-08-28,10:35:00,19668.0,BUY,3,0.02h,Stop Loss,$-9.00,$-58.50,$86847.50,172,$-58.50
2024-08-28,10:36:00,19665.75,SELL,3,0.02h,Stop Loss,$-9.00,$-67.50,$86838.50,172,$-67.50
2024-08-28,10:47:00,19671.5,BUY,3,0.02h,Break Even,$-1.50,$-69.00,$86837.00,172,$-69.00
2024-08-28,10:55:00,19665.5,SELL,3,0.02h,Stop Loss,$-9.00,$-78.00,$86828.00,172,$-78.00
2024-08-28,11:25:00,19654.75,BUY,3,0.02h,Stop Loss,$-9.00,$-87.00,$86819.00,172,$-87.00
2024-08-28,11:26:00,19649.0,SELL,3,0.02h,Break Even,$-1.50,$-88.50,$86817.50,172,$-88.50
2024-08-28,12:19:00,19629.25,BUY,3,0.02h,Stop Loss,$-9.00,$-97.50,$86808.50,172,$-97.50
2024-08-28,12:52:00,19635.25,SELL,3,0.02h,Break Even,$-1.50,$-99.00,$86807.00,172,$-99.00
2024-08-28,12:54:00,19639.0,BUY,3,0.02h,Break Even,$-1.50,$-100.50,$86805.50,172,$-100.50
2024-08-28,13:07:00,19630.25,SELL,3,0.02h,Stop Loss,$60.00,$-40.50,$86865.50,172,$-40.50
2024-08-28,13:31:00,19653.75,BUY,3,0.02h,Break Even,$-1.50,$-42.00,$86864.00,172,$-42.00
2024-08-28,13:38:00,19610.75,SELL,3,0.02h,Stop Loss,$31.50,$-10.50,$86895.50,172,$-10.50
2024-08-28,14:20:00,19568.5,BUY,3,0.02h,Stop Loss,$27.00,$16.50,$86922.50,172,$16.50
2024-08-28,14:38:00,19559.0,SELL,3,0.02h,Break Even,$-1.50,$15.00,$86921.00,172,$15.00
2024-08-28,15:37:00,19400.75,BUY,3,0.02h,Stop Loss,$10.50,$25.50,$86931.50,172,$25.50
2024-08-28,16:16:00,19406.25,SELL,3,0.02h,Stop Loss,$99.00,$124.50,$87030.50,172,$124.50
2024-08-28,16:35:00,19417.0,BUY,3,0.02h,Stop Loss,$13.50,$138.00,$87044.00,172,$138.00
2024-08-28,17:15:00,19417.25,SELL,3,0.02h,Stop Loss,$13.50,$151.50,$87057.50,172,$151.50
2024-08-28,17:36:00,19436.5,BUY,3,0.02h,Stop Loss,$-9.00,$142.50,$87048.50,172,$142.50
2024-08-28,17:39:00,19430.0,SELL,3,0.02h,Stop Loss,$43.50,$186.00,$87092.00,172,$186.00
2024-08-28,18:24:00,19333.5,BUY,3,0.02h,Break Even,$-1.50,$184.50,$87090.50,172,$184.50
2024-08-28,18:25:00,19326.0,SELL,3,0.02h,Stop Loss,$9.00,$193.50,$87099.50,172,$193.50
2024-08-28,18:34:00,19334.5,BUY,3,0.02h,Break Even,$-1.50,$192.00,$87098.00,172,$192.00
2024-08-28,18:45:00,19324.75,SELL,3,0.02h,Break Even,$-1.50,$190.50,$87096.50,172,$190.50
2024-08-28,18:51:00,19342.5,BUY,3,0.02h,Stop Loss,$90.00,$280.50,$87186.50,172,$280.50
2024-08-28,19:58:00,19432.5,SELL,3,0.02h,Stop Loss,$67.50,$348.00,$87254.00,172,$348.00
2024-08-28,20:20:00,19449.0,BUY,3,0.02h,Break Even,$-1.50,$346.50,$87252.50,172,$346.50
2024-08-28,20:24:00,19347.25,SELL,3,0.02h,Stop Loss,$504.00,$850.50,$87756.50,172,$850.50
2024-08-28,23:45:00,19198.25,BUY,3,0.02h,Stop Loss,$16.50,$867.00,$87773.00,172,$867.00
,,,,,,,,,,,
2024-08-29,00:00:00,19192.75,SELL,3,0.02h,Stop Loss,$-9.00,$-9.00,$87764.00,173,$-9.00
2024-08-29,00:01:00,19198.75,BUY,3,0.02h,Stop Loss,$-9.00,$-18.00,$87755.00,173,$-18.00
2024-08-29,00:04:00,19193.5,SELL,3,0.02h,Break Even,$-1.50,$-19.50,$87753.50,173,$-19.50
2024-08-29,00:05:00,19201.5,BUY,3,0.02h,Stop Loss,$15.00,$-4.50,$87768.50,173,$-4.50
2024-08-29,01:14:00,19240.5,SELL,3,0.02h,Break Even,$-1.50,$-6.00,$87767.00,173,$-6.00
2024-08-29,01:22:00,19246.5,BUY,3,0.02h,Break Even,$-1.50,$-7.50,$87765.50,173,$-7.50
2024-08-29,01:24:00,19240.25,SELL,3,0.02h,Stop Loss,$58.50,$51.00,$87824.00,173,$51.00
2024-08-29,01:42:00,19239.75,BUY,3,0.02h,Break Even,$-1.50,$49.50,$87822.50,173,$49.50
2024-08-29,01:58:00,19233.5,SELL,3,0.02h,Break Even,$-1.50,$48.00,$87821.00,173,$48.00
2024-08-29,02:24:00,19236.0,BUY,3,0.02h,Stop Loss,$-9.00,$39.00,$87812.00,173,$39.00
2024-08-29,03:27:00,19261.0,SELL,3,0.02h,Stop Loss,$-9.00,$30.00,$87803.00,173,$30.00
2024-08-29,03:36:00,19272.75,BUY,3,0.02h,Stop Loss,$4.50,$34.50,$87807.50,173,$34.50
2024-08-29,04:39:00,19287.75,SELL,3,0.02h,Break Even,$-1.50,$33.00,$87806.00,173,$33.00
2024-08-29,04:52:00,19291.25,BUY,3,0.02h,Break Even,$-1.50,$31.50,$87804.50,173,$31.50
2024-08-29,05:09:00,19284.0,SELL,3,0.02h,Break Even,$-1.50,$30.00,$87803.00,173,$30.00
2024-08-29,05:28:00,19289.25,BUY,3,0.02h,Stop Loss,$-9.00,$21.00,$87794.00,173,$21.00
2024-08-29,05:29:00,19285.25,SELL,3,0.02h,Stop Loss,$-9.00,$12.00,$87785.00,173,$12.00
2024-08-29,05:38:00,19307.5,BUY,3,0.02h,Stop Loss,$21.00,$33.00,$87806.00,173,$33.00
2024-08-29,06:16:00,19314.75,SELL,3,0.02h,Stop Loss,$19.50,$52.50,$87825.50,173,$52.50
2024-08-29,06:21:00,19324.75,BUY,3,0.02h,Stop Loss,$-9.00,$43.50,$87816.50,173,$43.50
2024-08-29,06:23:00,19316.0,SELL,3,0.02h,Stop Loss,$-9.00,$34.50,$87807.50,173,$34.50
2024-08-29,06:25:00,19327.5,BUY,3,0.02h,Break Even,$-1.50,$33.00,$87806.00,173,$33.00
2024-08-29,07:50:00,19376.0,SELL,3,0.02h,Break Even,$-1.50,$31.50,$87804.50,173,$31.50
2024-08-29,08:06:00,19384.5,BUY,3,0.02h,Stop Loss,$-9.00,$22.50,$87795.50,173,$22.50
2024-08-29,08:08:00,19375.25,SELL,3,0.02h,Break Even,$-1.50,$21.00,$87794.00,173,$21.00
2024-08-29,08:11:00,19387.5,BUY,3,0.02h,Stop Loss,$6.00,$27.00,$87800.00,173,$27.00
2024-08-29,08:26:00,19383.5,SELL,3,0.02h,Stop Loss,$4.50,$31.50,$87804.50,173,$31.50
2024-08-29,08:32:00,19399.5,BUY,3,0.02h,Stop Loss,$-9.00,$22.50,$87795.50,173,$22.50
2024-08-29,10:17:00,19478.75,SELL,3,0.02h,Stop Loss,$21.00,$43.50,$87816.50,173,$43.50
2024-08-29,10:50:00,19468.5,BUY,3,0.02h,Break Even,$-1.50,$42.00,$87815.00,173,$42.00
2024-08-29,10:57:00,19457.5,SELL,3,0.02h,Stop Loss,$28.50,$70.50,$87843.50,173,$70.50
2024-08-29,11:17:00,19451.0,BUY,3,0.02h,Stop Loss,$3.00,$73.50,$87846.50,173,$73.50
2024-08-29,11:24:00,19439.0,SELL,3,0.02h,Break Even,$-1.50,$72.00,$87845.00,173,$72.00
2024-08-29,11:34:00,19449.75,BUY,3,0.02h,Stop Loss,$-9.00,$63.00,$87836.00,173,$63.00
2024-08-29,11:35:00,19443.0,SELL,3,0.02h,Stop Loss,$16.50,$79.50,$87852.50,173,$79.50
2024-08-29,11:37:00,19448.5,BUY,3,0.02h,Stop Loss,$76.50,$156.00,$87929.00,173,$156.00
2024-08-29,12:02:00,19457.0,SELL,3,0.02h,Break Even,$-1.50,$154.50,$87927.50,173,$154.50
2024-08-29,12:20:00,19470.5,BUY,3,0.02h,Stop Loss,$-9.00,$145.50,$87918.50,173,$145.50
2024-08-29,12:21:00,19462.75,SELL,3,0.02h,Stop Loss,$4.50,$150.00,$87923.00,173,$150.00
2024-08-29,12:25:00,19470.5,BUY,3,0.02h,Stop Loss,$-9.00,$141.00,$87914.00,173,$141.00
2024-08-29,12:26:00,19463.25,SELL,3,0.02h,Stop Loss,$-9.00,$132.00,$87905.00,173,$132.00
2024-08-29,12:27:00,19467.75,BUY,3,0.02h,Stop Loss,$13.50,$145.50,$87918.50,173,$145.50
2024-08-29,12:41:00,19457.0,SELL,3,0.02h,Stop Loss,$37.50,$183.00,$87956.00,173,$183.00
2024-08-29,12:50:00,19479.75,BUY,3,0.02h,Break Even,$-1.50,$181.50,$87954.50,173,$181.50
2024-08-29,13:00:00,19468.75,SELL,3,0.02h,Stop Loss,$9.00,$190.50,$87963.50,173,$190.50
2024-08-29,13:03:00,19477.25,BUY,3,0.02h,Break Even,$-1.50,$189.00,$87962.00,173,$189.00
2024-08-29,13:06:00,19468.75,SELL,3,0.02h,Stop Loss,$10.50,$199.50,$87972.50,173,$199.50
2024-08-29,13:07:00,19473.75,BUY,3,0.02h,Break Even,$-1.50,$198.00,$87971.00,173,$198.00
2024-08-29,13:27:00,19474.75,SELL,3,0.02h,Stop Loss,$19.50,$217.50,$87990.50,173,$217.50
2024-08-29,13:29:00,19493.5,BUY,3,0.02h,Stop Loss,$40.50,$258.00,$88031.00,173,$258.00
2024-08-29,14:16:00,19605.0,SELL,3,0.02h,Stop Loss,$105.00,$363.00,$88136.00,173,$363.00
2024-08-29,14:30:00,19599.25,BUY,3,0.02h,Stop Loss,$61.50,$424.50,$88197.50,173,$424.50
2024-08-29,15:06:00,19637.75,SELL,3,0.02h,Stop Loss,$78.00,$502.50,$88275.50,173,$502.50
2024-08-29,15:11:00,19663.75,BUY,3,0.02h,Stop Loss,$-9.00,$493.50,$88266.50,173,$493.50
2024-08-29,15:20:00,19637.25,SELL,3,0.02h,Stop Loss,$108.00,$601.50,$88374.50,173,$601.50
2024-08-29,15:40:00,19649.0,BUY,3,0.02h,Break Even,$-1.50,$600.00,$88373.00,173,$600.00
2024-08-29,15:45:00,19622.75,SELL,3,0.02h,Break Even,$-1.50,$598.50,$88371.50,173,$598.50
2024-08-29,16:01:00,19645.0,BUY,3,0.02h,Stop Loss,$21.00,$619.50,$88392.50,173,$619.50
2024-08-29,16:51:00,19657.5,SELL,3,0.02h,Break Even,$-1.50,$618.00,$88391.00,173,$618.00
2024-08-29,17:37:00,19623.75,BUY,3,0.02h,Stop Loss,$-9.00,$609.00,$88382.00,173,$609.00
2024-08-29,17:38:00,19615.5,SELL,3,0.02h,Break Even,$-1.50,$607.50,$88380.50,173,$607.50
2024-08-29,17:57:00,19627.0,BUY,3,0.02h,Break Even,$-1.50,$606.00,$88379.00,173,$606.00
2024-08-29,18:02:00,19584.75,SELL,3,0.02h,Break Even,$-1.50,$604.50,$88377.50,173,$604.50
2024-08-29,19:26:00,19401.25,BUY,3,0.02h,Stop Loss,$6.00,$610.50,$88383.50,173,$610.50
2024-08-29,19:51:00,19402.75,SELL,3,0.02h,Stop Loss,$78.00,$688.50,$88461.50,173,$688.50
2024-08-29,20:07:00,19420.5,BUY,3,0.02h,Stop Loss,$15.00,$703.50,$88476.50,173,$703.50
2024-08-29,20:50:00,19441.25,SELL,3,0.02h,Stop Loss,$-9.00,$694.50,$88467.50,173,$694.50
2024-08-29,20:55:00,19447.0,BUY,3,0.02h,Break Even,$-1.50,$693.00,$88466.00,173,$693.00
2024-08-29,23:00:00,19432.5,SELL,3,0.02h,Stop Loss,$12.00,$705.00,$88478.00,173,$705.00
2024-08-29,23:17:00,19439.75,BUY,3,0.02h,Stop Loss,$-9.00,$696.00,$88469.00,173,$696.00
2024-08-29,23:18:00,19436.25,SELL,3,0.02h,Stop Loss,$-9.00,$687.00,$88460.00,173,$687.00
2024-08-29,23:20:00,19437.5,BUY,3,0.02h,Break Even,$-1.50,$685.50,$88458.50,173,$685.50
2024-08-29,23:32:00,19432.75,SELL,3,0.02h,Stop Loss,$-9.00,$676.50,$88449.50,173,$676.50
2024-08-29,23:49:00,19439.25,BUY,3,0.02h,Stop Loss,$-9.00,$667.50,$88440.50,173,$667.50
2024-08-29,23:54:00,19429.75,SELL,3,0.02h,Stop Loss,$-9.00,$658.50,$88431.50,173,$658.50
,,,,,,,,,,,
2024-08-30,00:26:00,19416.0,BUY,3,0.02h,Stop Loss,$-9.00,$-9.00,$88422.50,174,$-9.00
2024-08-30,01:13:00,19443.0,SELL,3,0.02h,Stop Loss,$-9.00,$-18.00,$88413.50,174,$-18.00
2024-08-30,01:37:00,19441.0,BUY,3,0.02h,Break Even,$-1.50,$-19.50,$88412.00,174,$-19.50
2024-08-30,02:00:00,19441.5,SELL,3,0.02h,Break Even,$-1.50,$-21.00,$88410.50,174,$-21.00
2024-08-30,02:05:00,19451.25,BUY,3,0.02h,Stop Loss,$-9.00,$-30.00,$88401.50,174,$-30.00
2024-08-30,02:11:00,19441.5,SELL,3,0.02h,Stop Loss,$-9.00,$-39.00,$88392.50,174,$-39.00
2024-08-30,02:13:00,19448.0,BUY,3,0.02h,Break Even,$-1.50,$-40.50,$88391.00,174,$-40.50
2024-08-30,02:58:00,19462.75,SELL,3,0.02h,Stop Loss,$-9.00,$-49.50,$88382.00,174,$-49.50
2024-08-30,02:59:00,19468.25,BUY,3,0.02h,Stop Loss,$18.00,$-31.50,$88400.00,174,$-31.50
2024-08-30,03:07:00,19455.0,SELL,3,0.02h,Stop Loss,$-9.00,$-40.50,$88391.00,174,$-40.50
2024-08-30,03:49:00,19451.5,BUY,3,0.02h,Stop Loss,$-9.00,$-49.50,$88382.00,174,$-49.50
2024-08-30,03:50:00,19447.5,SELL,3,0.02h,Stop Loss,$-9.00,$-58.50,$88373.00,174,$-58.50
2024-08-30,03:51:00,19452.25,BUY,3,0.02h,Break Even,$-1.50,$-60.00,$88371.50,174,$-60.00
2024-08-30,04:03:00,19444.0,SELL,3,0.02h,Break Even,$-1.50,$-61.50,$88370.00,174,$-61.50
2024-08-30,04:36:00,19447.25,BUY,3,0.02h,Break Even,$-1.50,$-63.00,$88368.50,174,$-63.00
2024-08-30,05:17:00,19460.0,SELL,3,0.02h,Stop Loss,$-9.00,$-72.00,$88359.50,174,$-72.00
2024-08-30,05:37:00,19464.25,BUY,3,0.02h,Break Even,$-1.50,$-73.50,$88358.00,174,$-73.50
2024-08-30,06:00:00,19456.5,SELL,3,0.02h,Stop Loss,$-9.00,$-82.50,$88349.00,174,$-82.50
2024-08-30,06:08:00,19481.5,BUY,3,0.02h,Stop Loss,$4.50,$-78.00,$88353.50,174,$-78.00
2024-08-30,06:37:00,19470.75,SELL,3,0.02h,Stop Loss,$-9.00,$-87.00,$88344.50,174,$-87.00
2024-08-30,06:44:00,19483.25,BUY,3,0.02h,Break Even,$-1.50,$-88.50,$88343.00,174,$-88.50
2024-08-30,06:51:00,19476.75,SELL,3,0.02h,Break Even,$-1.50,$-90.00,$88341.50,174,$-90.00
2024-08-30,06:54:00,19481.75,BUY,3,0.02h,Break Even,$-1.50,$-91.50,$88340.00,174,$-91.50
2024-08-30,07:05:00,19477.75,SELL,3,0.02h,Break Even,$-1.50,$-93.00,$88338.50,174,$-93.00
2024-08-30,07:19:00,19486.25,BUY,3,0.02h,Stop Loss,$9.00,$-84.00,$88347.50,174,$-84.00
2024-08-30,08:06:00,19512.0,SELL,3,0.02h,Stop Loss,$-9.00,$-93.00,$88338.50,174,$-93.00
2024-08-30,08:19:00,19522.0,BUY,3,0.02h,Break Even,$-1.50,$-94.50,$88337.00,174,$-94.50
2024-08-30,08:21:00,19510.75,SELL,3,0.02h,Stop Loss,$-9.00,$-103.50,$88328.00,174,$-103.50
2024-08-30,08:25:00,19518.25,BUY,3,0.02h,Stop Loss,$22.50,$-81.00,$88350.50,174,$-81.00
2024-08-30,08:54:00,19515.25,SELL,3,0.02h,Break Even,$-1.50,$-82.50,$88349.00,174,$-82.50
2024-08-30,09:12:00,19522.25,BUY,3,0.02h,Break Even,$-1.50,$-84.00,$88347.50,174,$-84.00
2024-08-30,09:21:00,19518.75,SELL,3,0.02h,Stop Loss,$13.50,$-70.50,$88361.00,174,$-70.50
2024-08-30,09:42:00,19518.0,BUY,3,0.02h,Stop Loss,$-9.00,$-79.50,$88352.00,174,$-79.50
2024-08-30,10:16:00,19517.5,SELL,3,0.02h,Stop Loss,$-9.00,$-88.50,$88343.00,174,$-88.50
2024-08-30,10:47:00,19517.75,BUY,3,0.02h,Stop Loss,$-9.00,$-97.50,$88334.00,174,$-97.50
2024-08-30,11:31:00,19535.25,SELL,3,0.02h,Break Even,$-1.50,$-99.00,$88332.50,174,$-99.00
2024-08-30,11:36:00,19539.5,BUY,3,0.02h,Stop Loss,$4.50,$-94.50,$88337.00,174,$-94.50
2024-08-30,11:38:00,19536.25,SELL,3,0.02h,Break Even,$-1.50,$-96.00,$88335.50,174,$-96.00
2024-08-30,12:01:00,19537.25,BUY,3,0.02h,Break Even,$-1.50,$-97.50,$88334.00,174,$-97.50
2024-08-30,12:35:00,19533.0,SELL,3,0.02h,Stop Loss,$87.00,$-10.50,$88421.00,174,$-10.50
2024-08-30,13:09:00,19536.75,BUY,3,0.02h,Stop Loss,$19.50,$9.00,$88440.50,174,$9.00
2024-08-30,13:34:00,19525.5,SELL,3,0.02h,Stop Loss,$40.50,$49.50,$88481.00,174,$49.50
2024-08-30,13:42:00,19565.0,BUY,3,0.02h,Stop Loss,$18.00,$67.50,$88499.00,174,$67.50
2024-08-30,14:15:00,19575.25,SELL,3,0.02h,Stop Loss,$75.00,$142.50,$88574.00,174,$142.50
2024-08-30,14:37:00,19583.0,BUY,3,0.02h,Stop Loss,$-9.00,$133.50,$88565.00,174,$133.50
2024-08-30,14:47:00,19555.25,SELL,3,0.02h,Stop Loss,$28.50,$162.00,$88593.50,174,$162.00
2024-08-30,14:50:00,19588.5,BUY,3,0.02h,Break Even,$-1.50,$160.50,$88592.00,174,$160.50
2024-08-30,14:53:00,19563.25,SELL,3,0.02h,Stop Loss,$130.50,$291.00,$88722.50,174,$291.00
2024-08-30,15:54:00,19470.75,BUY,3,0.02h,Stop Loss,$6.00,$297.00,$88728.50,174,$297.00
2024-08-30,16:01:00,19424.25,SELL,3,0.02h,Stop Loss,$49.50,$346.50,$88778.00,174,$346.50
2024-08-30,16:08:00,19467.5,BUY,3,0.02h,Stop Loss,$27.00,$373.50,$88805.00,174,$373.50
2024-08-30,16:22:00,19456.0,SELL,3,0.02h,Stop Loss,$19.50,$393.00,$88824.50,174,$393.00
2024-08-30,16:52:00,19431.75,BUY,3,0.02h,Stop Loss,$76.50,$469.50,$88901.00,174,$469.50
2024-08-30,17:24:00,19458.25,SELL,3,0.02h,Stop Loss,$31.50,$501.00,$88932.50,174,$501.00
2024-08-30,17:32:00,19472.75,BUY,3,0.02h,Stop Loss,$42.00,$543.00,$88974.50,174,$543.00
2024-08-30,17:45:00,19467.0,SELL,3,0.02h,Stop Loss,$24.00,$567.00,$88998.50,174,$567.00
2024-08-30,18:12:00,19469.25,BUY,3,0.02h,Stop Loss,$21.00,$588.00,$89019.50,174,$588.00
2024-08-30,19:13:00,19504.5,SELL,3,0.02h,Stop Loss,$48.00,$636.00,$89067.50,174,$636.00
2024-08-30,19:19:00,19520.25,BUY,3,0.02h,Stop Loss,$6.00,$642.00,$89073.50,174,$642.00
2024-08-30,19:44:00,19529.5,SELL,3,0.02h,Break Even,$-1.50,$640.50,$89072.00,174,$640.50
2024-08-30,19:51:00,19593.5,BUY,3,0.02h,Stop Loss,$61.50,$702.00,$89133.50,174,$702.00
2024-08-30,20:42:00,19597.75,SELL,3,0.02h,Stop Loss,$-9.00,$693.00,$89124.50,174,$693.00
,,,,,,,,,,,
2024-09-02,00:18:00,19597.25,BUY,3,0.02h,Stop Loss,$-9.00,$-9.00,$89115.50,175,$-9.00
2024-09-02,01:43:00,19619.75,SELL,3,0.02h,Break Even,$-1.50,$-10.50,$89114.00,175,$-10.50
2024-09-02,02:41:00,19599.5,BUY,3,0.02h,Break Even,$-1.50,$-12.00,$89112.50,175,$-12.00
2024-09-02,02:54:00,19598.0,SELL,3,0.02h,Stop Loss,$-9.00,$-21.00,$89103.50,175,$-21.00
2024-09-02,03:31:00,19594.0,BUY,3,0.02h,Stop Loss,$-9.00,$-30.00,$89094.50,175,$-30.00
2024-09-02,03:34:00,19589.5,SELL,3,0.02h,Break Even,$-1.50,$-31.50,$89093.00,175,$-31.50
2024-09-02,03:50:00,19591.25,BUY,3,0.02h,Stop Loss,$-9.00,$-40.50,$89084.00,175,$-40.50
2024-09-02,04:05:00,19585.25,SELL,3,0.02h,Stop Loss,$-9.00,$-49.50,$89075.00,175,$-49.50
2024-09-02,04:32:00,19581.25,BUY,3,0.02h,Stop Loss,$-9.00,$-58.50,$89066.00,175,$-58.50
2024-09-02,04:34:00,19578.0,SELL,3,0.02h,Break Even,$-1.50,$-60.00,$89064.50,175,$-60.00
2024-09-02,04:55:00,19578.5,BUY,3,0.02h,Stop Loss,$-9.00,$-69.00,$89055.50,175,$-69.00
2024-09-02,05:56:00,19587.75,SELL,3,0.02h,Stop Loss,$-9.00,$-78.00,$89046.50,175,$-78.00
2024-09-02,07:51:00,19531.0,BUY,3,0.02h,Stop Loss,$-9.00,$-87.00,$89037.50,175,$-87.00
2024-09-02,08:59:00,19570.75,SELL,3,0.02h,Break Even,$-1.50,$-88.50,$89036.00,175,$-88.50
2024-09-02,09:19:00,19577.0,BUY,3,0.02h,Break Even,$-1.50,$-90.00,$89034.50,175,$-90.00
2024-09-02,10:05:00,19586.75,SELL,3,0.02h,Break Even,$-1.50,$-91.50,$89033.00,175,$-91.50
2024-09-02,10:10:00,19590.0,BUY,3,0.02h,Stop Loss,$-9.00,$-100.50,$89024.00,175,$-100.50
2024-09-02,10:14:00,19583.25,SELL,3,0.02h,Stop Loss,$-9.00,$-109.50,$89015.00,175,$-109.50
2024-09-02,10:24:00,19589.25,BUY,3,0.02h,Break Even,$-1.50,$-111.00,$89013.50,175,$-111.00
2024-09-02,10:26:00,19581.0,SELL,3,0.02h,Stop Loss,$-9.00,$-120.00,$89004.50,175,$-120.00
2024-09-02,10:28:00,19588.75,BUY,3,0.02h,Stop Loss,$-9.00,$-129.00,$88995.50,175,$-129.00
2024-09-02,11:09:00,19591.25,SELL,3,0.02h,Stop Loss,$-9.00,$-138.00,$88986.50,175,$-138.00
2024-09-02,11:32:00,19594.5,BUY,3,0.02h,Break Even,$-1.50,$-139.50,$88985.00,175,$-139.50
2024-09-02,12:28:00,19612.5,SELL,3,0.02h,Stop Loss,$-9.00,$-148.50,$88976.00,175,$-148.50
2024-09-02,12:33:00,19618.0,BUY,3,0.02h,Stop Loss,$-9.00,$-157.50,$88967.00,175,$-157.50
2024-09-02,12:35:00,19613.5,SELL,3,0.02h,Stop Loss,$-9.00,$-166.50,$88958.00,175,$-166.50
2024-09-02,12:53:00,19613.25,BUY,3,0.02h,Stop Loss,$-9.00,$-175.50,$88949.00,175,$-175.50
2024-09-02,12:54:00,19611.0,SELL,3,0.03h,Stop Loss,$-9.00,$-184.50,$88940.00,175,$-184.50
2024-09-02,12:58:00,19609.75,SELL,3,0.02h,Break Even,$-1.50,$-186.00,$88938.50,175,$-186.00
2024-09-02,13:02:00,19615.25,BUY,3,0.02h,Stop Loss,$4.50,$-181.50,$88943.00,175,$-181.50
2024-09-02,13:30:00,19618.0,SELL,3,0.02h,Stop Loss,$-9.00,$-190.50,$88934.00,175,$-190.50
2024-09-02,13:31:00,19621.75,BUY,3,0.02h,Stop Loss,$4.50,$-186.00,$88938.50,175,$-186.00
2024-09-02,13:35:00,19617.75,SELL,3,0.02h,Break Even,$-1.50,$-187.50,$88937.00,175,$-187.50
2024-09-02,13:39:00,19625.5,BUY,3,0.02h,Break Even,$-1.50,$-189.00,$88935.50,175,$-189.00
2024-09-02,14:00:00,19619.5,SELL,3,0.02h,Break Even,$-1.50,$-190.50,$88934.00,175,$-190.50
2024-09-02,14:32:00,19617.75,BUY,3,0.02h,Stop Loss,$58.50,$-132.00,$88992.50,175,$-132.00
2024-09-02,15:26:00,19656.25,SELL,3,0.02h,Break Even,$-1.50,$-133.50,$88991.00,175,$-133.50
2024-09-02,15:51:00,19653.75,BUY,3,0.02h,Break Even,$-1.50,$-135.00,$88989.50,175,$-135.00
2024-09-02,16:08:00,19650.0,SELL,3,0.02h,Stop Loss,$-9.00,$-144.00,$88980.50,175,$-144.00
2024-09-02,16:10:00,19654.75,BUY,3,0.02h,Break Even,$-1.50,$-145.50,$88979.00,175,$-145.50
2024-09-02,16:21:00,19651.25,SELL,3,0.02h,Break Even,$-1.50,$-147.00,$88977.50,175,$-147.00
2024-09-02,16:42:00,19653.5,BUY,3,0.02h,Stop Loss,$-9.00,$-156.00,$88968.50,175,$-156.00
2024-09-02,16:49:00,19648.0,SELL,3,0.02h,Stop Loss,$9.00,$-147.00,$88977.50,175,$-147.00
,,,,,,,,,,,
2024-09-03,00:00:00,19580.5,BUY,3,0.02h,Stop Loss,$33.00,$33.00,$89010.50,176,$33.00
2024-09-03,00:12:00,19577.25,SELL,3,0.02h,Stop Loss,$-9.00,$24.00,$89001.50,176,$24.00
2024-09-03,00:13:00,19580.25,BUY,3,0.02h,Stop Loss,$13.50,$37.50,$89015.00,176,$37.50
2024-09-03,00:36:00,19585.5,SELL,3,0.02h,Stop Loss,$16.50,$54.00,$89031.50,176,$54.00
2024-09-03,00:59:00,19592.0,BUY,3,0.02h,Break Even,$-1.50,$52.50,$89030.00,176,$52.50
2024-09-03,01:29:00,19594.75,SELL,3,0.02h,Stop Loss,$-9.00,$43.50,$89021.00,176,$43.50
2024-09-03,01:32:00,19600.5,BUY,3,0.02h,Stop Loss,$-9.00,$34.50,$89012.00,176,$34.50
2024-09-03,01:34:00,19596.25,SELL,3,0.02h,Break Even,$-1.50,$33.00,$89010.50,176,$33.00
2024-09-03,01:38:00,19601.0,BUY,3,0.02h,Break Even,$-1.50,$31.50,$89009.00,176,$31.50
2024-09-03,01:44:00,19593.5,SELL,3,0.02h,Stop Loss,$15.00,$46.50,$89024.00,176,$46.50
2024-09-03,01:52:00,19600.5,BUY,3,0.02h,Stop Loss,$-9.00,$37.50,$89015.00,176,$37.50
2024-09-03,01:56:00,19594.75,SELL,3,0.02h,Stop Loss,$-9.00,$28.50,$89006.00,176,$28.50
2024-09-03,02:18:00,19596.25,BUY,3,0.03h,Stop Loss,$-9.00,$19.50,$88997.00,176,$19.50
2024-09-03,02:36:00,19589.75,SELL,3,0.02h,Stop Loss,$3.00,$22.50,$89000.00,176,$22.50
2024-09-03,03:36:00,19537.25,BUY,3,0.02h,Break Even,$-1.50,$21.00,$88998.50,176,$21.00
2024-09-03,04:25:00,19552.75,SELL,3,0.02h,Break Even,$-1.50,$19.50,$88997.00,176,$19.50
2024-09-03,04:31:00,19559.5,BUY,3,0.02h,Stop Loss,$-9.00,$10.50,$88988.00,176,$10.50
2024-09-03,04:35:00,19553.75,SELL,3,0.02h,Stop Loss,$3.00,$13.50,$88991.00,176,$13.50
2024-09-03,04:46:00,19558.5,BUY,3,0.03h,Stop Loss,$-9.00,$4.50,$88982.00,176,$4.50
2024-09-03,04:57:00,19551.5,SELL,3,0.03h,Stop Loss,$-9.00,$-4.50,$88973.00,176,$-4.50
2024-09-03,05:02:00,19559.25,BUY,3,0.02h,Stop Loss,$19.50,$15.00,$88992.50,176,$15.00
2024-09-03,05:24:00,19552.5,SELL,3,0.02h,Break Even,$-1.50,$13.50,$88991.00,176,$13.50
2024-09-03,05:51:00,19558.5,BUY,3,0.02h,Break Even,$-1.50,$12.00,$88989.50,176,$12.00
2024-09-03,06:03:00,19544.25,SELL,3,0.02h,Break Even,$-1.50,$10.50,$88988.00,176,$10.50
2024-09-03,06:34:00,19552.5,BUY,3,0.02h,Stop Loss,$-9.00,$1.50,$88979.00,176,$1.50
2024-09-03,07:55:00,19615.5,SELL,3,0.02h,Stop Loss,$-9.00,$-7.50,$88970.00,176,$-7.50
2024-09-03,08:04:00,19627.75,BUY,3,0.02h,Stop Loss,$-9.00,$-16.50,$88961.00,176,$-16.50
2024-09-03,08:06:00,19621.0,SELL,3,0.02h,Stop Loss,$-9.00,$-25.50,$88952.00,176,$-25.50
2024-09-03,09:38:00,19487.75,BUY,3,0.02h,Stop Loss,$24.00,$-1.50,$88976.00,176,$-1.50
2024-09-03,09:54:00,19482.0,SELL,3,0.02h,Stop Loss,$10.50,$9.00,$88986.50,176,$9.00
2024-09-03,10:15:00,19482.25,BUY,3,0.02h,Break Even,$-1.50,$7.50,$88985.00,176,$7.50
2024-09-03,10:40:00,19479.5,SELL,3,0.02h,Break Even,$-1.50,$6.00,$88983.50,176,$6.00
2024-09-03,10:42:00,19487.75,BUY,3,0.02h,Stop Loss,$-9.00,$-3.00,$88974.50,176,$-3.00
2024-09-03,10:48:00,19481.25,SELL,3,0.02h,Break Even,$-1.50,$-4.50,$88973.00,176,$-4.50
2024-09-03,10:50:00,19492.5,BUY,3,0.02h,Stop Loss,$39.00,$34.50,$89012.00,176,$34.50
2024-09-03,11:05:00,19486.5,SELL,3,0.02h,Stop Loss,$36.00,$70.50,$89048.00,176,$70.50
2024-09-03,11:20:00,19493.0,BUY,3,0.02h,Stop Loss,$-9.00,$61.50,$89039.00,176,$61.50
2024-09-03,11:46:00,19487.75,SELL,3,0.02h,Break Even,$-1.50,$60.00,$89037.50,176,$60.00
2024-09-03,11:57:00,19501.5,BUY,3,0.02h,Stop Loss,$-9.00,$51.00,$89028.50,176,$51.00
2024-09-03,12:30:00,19497.5,SELL,3,0.02h,Stop Loss,$21.00,$72.00,$89049.50,176,$72.00
2024-09-03,12:38:00,19515.0,BUY,3,0.02h,Stop Loss,$3.00,$75.00,$89052.50,176,$75.00
2024-09-03,12:55:00,19504.5,SELL,3,0.02h,Stop Loss,$25.50,$100.50,$89078.00,176,$100.50
2024-09-03,13:22:00,19495.0,BUY,3,0.02h,Stop Loss,$-9.00,$91.50,$89069.00,176,$91.50
2024-09-03,13:30:00,19478.25,SELL,3,0.02h,Stop Loss,$151.50,$243.00,$89220.50,176,$243.00
2024-09-03,15:13:00,19216.5,BUY,3,0.02h,Stop Loss,$28.50,$271.50,$89249.00,176,$271.50
2024-09-03,15:25:00,19195.75,SELL,3,0.02h,Stop Loss,$21.00,$292.50,$89270.00,176,$292.50
2024-09-03,15:37:00,19219.75,BUY,3,0.02h,Break Even,$-1.50,$291.00,$89268.50,176,$291.00
2024-09-03,15:41:00,19184.75,SELL,3,0.02h,Stop Loss,$36.00,$327.00,$89304.50,176,$327.00
2024-09-03,16:16:00,19176.5,BUY,3,0.02h,Stop Loss,$97.50,$424.50,$89402.00,176,$424.50
2024-09-03,16:27:00,19159.25,SELL,3,0.02h,Stop Loss,$6.00,$430.50,$89408.00,176,$430.50
2024-09-03,17:08:00,19157.75,BUY,3,0.02h,Stop Loss,$27.00,$457.50,$89435.00,176,$457.50
2024-09-03,17:13:00,19139.0,SELL,3,0.02h,Stop Loss,$57.00,$514.50,$89492.00,176,$514.50
2024-09-03,17:22:00,19168.0,BUY,3,0.02h,Stop Loss,$42.00,$556.50,$89534.00,176,$556.50
2024-09-03,17:35:00,19138.25,SELL,3,0.02h,Stop Loss,$-9.00,$547.50,$89525.00,176,$547.50
2024-09-03,18:40:00,19056.25,BUY,3,0.02h,Stop Loss,$10.50,$558.00,$89535.50,176,$558.00
2024-09-03,18:43:00,19049.75,SELL,3,0.02h,Stop Loss,$15.00,$573.00,$89550.50,176,$573.00
2024-09-03,19:02:00,19055.75,BUY,3,0.02h,Break Even,$-1.50,$571.50,$89549.00,176,$571.50
2024-09-03,19:12:00,19045.75,SELL,3,0.02h,Stop Loss,$16.50,$588.00,$89565.50,176,$588.00
2024-09-03,19:22:00,19060.25,BUY,3,0.02h,Break Even,$-1.50,$586.50,$89564.00,176,$586.50
2024-09-03,19:25:00,19044.25,SELL,3,0.02h,Stop Loss,$10.50,$597.00,$89574.50,176,$597.00
2024-09-03,19:59:00,19001.25,BUY,3,0.02h,Stop Loss,$64.50,$661.50,$89639.00,176,$661.50
2024-09-03,20:19:00,18994.0,SELL,3,0.02h,Stop Loss,$-9.00,$652.50,$89630.00,176,$652.50
2024-09-03,20:55:00,18987.5,BUY,3,0.02h,Stop Loss,$21.00,$673.50,$89651.00,176,$673.50
2024-09-03,23:00:00,18964.0,SELL,3,0.02h,Break Even,$-1.50,$672.00,$89649.50,176,$672.00
2024-09-03,23:19:00,18972.5,BUY,3,0.02h,Break Even,$-1.50,$670.50,$89648.00,176,$670.50
2024-09-03,23:29:00,18958.25,SELL,3,0.02h,Break Even,$-1.50,$669.00,$89646.50,176,$669.00
2024-09-03,23:54:00,18970.25,BUY,3,0.02h,Stop Loss,$-9.00,$660.00,$89637.50,176,$660.00
,,,,,,,,,,,
2024-09-04,00:20:00,18964.25,SELL,3,0.02h,Break Even,$-1.50,$-1.50,$89636.00,177,$-1.50
2024-09-04,01:31:00,18886.0,BUY,3,0.02h,Stop Loss,$30.00,$28.50,$89666.00,177,$28.50
2024-09-04,02:00:00,18888.25,SELL,3,0.02h,Stop Loss,$28.50,$57.00,$89694.50,177,$57.00
2024-09-04,02:17:00,18907.25,BUY,3,0.02h,Stop Loss,$12.00,$69.00,$89706.50,177,$69.00
2024-09-04,02:43:00,18906.0,SELL,3,0.02h,Break Even,$-1.50,$67.50,$89705.00,177,$67.50
2024-09-04,03:05:00,18913.0,BUY,3,0.02h,Stop Loss,$-9.00,$58.50,$89696.00,177,$58.50
2024-09-04,03:08:00,18903.25,SELL,3,0.02h,Break Even,$-1.50,$57.00,$89694.50,177,$57.00
2024-09-04,03:09:00,18908.75,BUY,3,0.02h,Stop Loss,$-9.00,$48.00,$89685.50,177,$48.00
2024-09-04,03:10:00,18904.0,SELL,3,0.02h,Break Even,$-1.50,$46.50,$89684.00,177,$46.50
2024-09-04,04:02:00,18891.0,BUY,3,0.02h,Stop Loss,$15.00,$61.50,$89699.00,177,$61.50
2024-09-04,04:18:00,18882.5,SELL,3,0.02h,Stop Loss,$-9.00,$52.50,$89690.00,177,$52.50
2024-09-04,04:43:00,18886.5,BUY,3,0.02h,Break Even,$-1.50,$51.00,$89688.50,177,$51.00
2024-09-04,04:50:00,18877.75,SELL,3,0.02h,Stop Loss,$118.50,$169.50,$89807.00,177,$169.50
2024-09-04,05:25:00,18862.5,BUY,3,0.02h,Stop Loss,$27.00,$196.50,$89834.00,177,$196.50
2024-09-04,05:40:00,18858.0,SELL,3,0.02h,Stop Loss,$34.50,$231.00,$89868.50,177,$231.00
2024-09-04,05:58:00,18865.75,BUY,3,0.02h,Stop Loss,$-9.00,$222.00,$89859.50,177,$222.00
2024-09-04,06:45:00,18888.0,SELL,3,0.02h,Break Even,$-1.50,$220.50,$89858.00,177,$220.50
2024-09-04,07:12:00,18870.25,BUY,3,0.02h,Stop Loss,$31.50,$252.00,$89889.50,177,$252.00
2024-09-04,07:30:00,18864.75,SELL,3,0.02h,Stop Loss,$18.00,$270.00,$89907.50,177,$270.00
2024-09-04,07:36:00,18877.0,BUY,3,0.02h,Stop Loss,$42.00,$312.00,$89949.50,177,$312.00
2024-09-04,08:05:00,18891.75,SELL,3,0.02h,Stop Loss,$27.00,$339.00,$89976.50,177,$339.00
2024-09-04,08:27:00,18896.25,BUY,3,0.02h,Stop Loss,$-9.00,$330.00,$89967.50,177,$330.00
2024-09-04,08:44:00,18893.75,SELL,3,0.02h,Stop Loss,$-9.00,$321.00,$89958.50,177,$321.00
2024-09-04,08:54:00,18906.25,BUY,3,0.02h,Stop Loss,$54.00,$375.00,$90012.50,177,$375.00
2024-09-04,09:08:00,18899.75,SELL,3,0.02h,Break Even,$-1.50,$373.50,$90011.00,177,$373.50
2024-09-04,09:18:00,18913.5,BUY,3,0.02h,Stop Loss,$7.50,$381.00,$90018.50,177,$381.00
2024-09-04,09:53:00,18907.5,SELL,3,0.02h,Break Even,$-1.50,$379.50,$90017.00,177,$379.50
2024-09-04,10:02:00,18924.25,BUY,3,0.02h,Stop Loss,$-9.00,$370.50,$90008.00,177,$370.50
2024-09-04,10:04:00,18916.0,SELL,3,0.02h,Stop Loss,$27.00,$397.50,$90035.00,177,$397.50
2024-09-04,11:24:00,18866.75,BUY,3,0.02h,Break Even,$-1.50,$396.00,$90033.50,177,$396.00
2024-09-04,11:25:00,18857.5,SELL,3,0.02h,Stop Loss,$-9.00,$387.00,$90024.50,177,$387.00
2024-09-04,11:30:00,18871.75,BUY,3,0.02h,Stop Loss,$43.50,$430.50,$90068.00,177,$430.50
2024-09-04,11:43:00,18858.75,SELL,3,0.02h,Break Even,$-1.50,$429.00,$90066.50,177,$429.00
2024-09-04,11:57:00,18873.5,BUY,3,0.02h,Stop Loss,$36.00,$465.00,$90102.50,177,$465.00
2024-09-04,12:19:00,18870.25,SELL,3,0.02h,Break Even,$-1.50,$463.50,$90101.00,177,$463.50
2024-09-04,12:31:00,18877.25,BUY,3,0.02h,Stop Loss,$12.00,$475.50,$90113.00,177,$475.50
2024-09-04,12:32:00,18872.5,SELL,3,0.02h,Stop Loss,$16.50,$492.00,$90129.50,177,$492.00
2024-09-04,12:43:00,18882.75,BUY,3,0.02h,Stop Loss,$18.00,$510.00,$90147.50,177,$510.00
2024-09-04,13:11:00,18892.25,SELL,3,0.02h,Stop Loss,$4.50,$514.50,$90152.00,177,$514.50
2024-09-04,13:35:00,18922.25,BUY,3,0.02h,Break Even,$-1.50,$513.00,$90150.50,177,$513.00
2024-09-04,14:01:00,18852.0,SELL,3,0.02h,Break Even,$-1.50,$511.50,$90149.00,177,$511.50
2024-09-04,14:10:00,18971.75,BUY,3,0.02h,Stop Loss,$157.50,$669.00,$90306.50,177,$669.00
2024-09-04,14:19:00,18931.5,SELL,3,0.02h,Stop Loss,$25.50,$694.50,$90332.00,177,$694.50
2024-09-04,14:24:00,18962.0,BUY,3,0.02h,Stop Loss,$48.00,$742.50,$90380.00,177,$742.50
2024-09-04,15:16:00,19054.75,SELL,3,0.02h,Stop Loss,$31.50,$774.00,$90411.50,177,$774.00
2024-09-04,15:55:00,19029.25,BUY,3,0.02h,Stop Loss,$-9.00,$765.00,$90402.50,177,$765.00
2024-09-04,15:57:00,18991.25,SELL,3,0.02h,Stop Loss,$7.50,$772.50,$90410.00,177,$772.50
2024-09-04,16:17:00,19023.5,BUY,3,0.02h,Stop Loss,$46.50,$819.00,$90456.50,177,$819.00
2024-09-04,16:47:00,19032.5,SELL,3,0.02h,Break Even,$-1.50,$817.50,$90455.00,177,$817.50
2024-09-04,16:56:00,19053.25,BUY,3,0.02h,Stop Loss,$13.50,$831.00,$90468.50,177,$831.00
2024-09-04,17:05:00,19041.25,SELL,3,0.02h,Stop Loss,$-9.00,$822.00,$90459.50,177,$822.00
2024-09-04,17:11:00,19060.0,BUY,3,0.02h,Stop Loss,$21.00,$843.00,$90480.50,177,$843.00
2024-09-04,17:15:00,19036.75,SELL,3,0.02h,Break Even,$-1.50,$841.50,$90479.00,177,$841.50
2024-09-04,17:23:00,19058.75,BUY,3,0.02h,Stop Loss,$-9.00,$832.50,$90470.00,177,$832.50
2024-09-04,17:25:00,19037.5,SELL,3,0.02h,Stop Loss,$22.50,$855.00,$90492.50,177,$855.00
2024-09-04,18:15:00,19016.75,BUY,3,0.02h,Stop Loss,$34.50,$889.50,$90527.00,177,$889.50
2024-09-04,18:20:00,18991.0,SELL,3,0.02h,Stop Loss,$12.00,$901.50,$90539.00,177,$901.50
2024-09-04,18:27:00,19018.25,BUY,3,0.02h,Break Even,$-1.50,$900.00,$90537.50,177,$900.00
2024-09-04,18:35:00,18991.25,SELL,3,0.02h,Stop Loss,$106.50,$1006.50,$90644.00,177,$1006.50
2024-09-04,19:24:00,18937.75,BUY,3,0.02h,Stop Loss,$69.00,$1075.50,$90713.00,177,$1075.50
2024-09-04,20:01:00,18960.75,SELL,3,0.02h,Stop Loss,$37.50,$1113.00,$90750.50,177,$1113.00
2024-09-04,20:30:00,18954.75,BUY,3,0.02h,Break Even,$-1.50,$1111.50,$90749.00,177,$1111.50
2024-09-04,23:12:00,18959.0,SELL,3,0.02h,Stop Loss,$-9.00,$1102.50,$90740.00,177,$1102.50
2024-09-04,23:59:00,18928.75,BUY,3,0.02h,Stop Loss,$3.00,$1105.50,$90743.00,177,$1105.50
,,,,,,,,,,,
2024-09-05,01:11:00,18983.0,SELL,3,0.02h,Stop Loss,$27.00,$27.00,$90770.00,178,$27.00
2024-09-05,01:26:00,18992.0,BUY,3,0.02h,Break Even,$-1.50,$25.50,$90768.50,178,$25.50
2024-09-05,01:52:00,18983.75,SELL,3,0.02h,Stop Loss,$19.50,$45.00,$90788.00,178,$45.00
2024-09-05,02:29:00,18967.25,BUY,3,0.02h,Break Even,$-1.50,$43.50,$90786.50,178,$43.50
2024-09-05,02:41:00,18962.75,SELL,3,0.02h,Break Even,$-1.50,$42.00,$90785.00,178,$42.00
2024-09-05,02:46:00,18969.5,BUY,3,0.02h,Break Even,$-1.50,$40.50,$90783.50,178,$40.50
2024-09-05,03:01:00,18968.0,SELL,3,0.02h,Stop Loss,$4.50,$45.00,$90788.00,178,$45.00
2024-09-05,04:09:00,18915.75,BUY,3,0.02h,Break Even,$-1.50,$43.50,$90786.50,178,$43.50
2024-09-05,04:32:00,18915.5,SELL,3,0.02h,Break Even,$-1.50,$42.00,$90785.00,178,$42.00
2024-09-05,04:51:00,18916.75,BUY,3,0.02h,Stop Loss,$16.50,$58.50,$90801.50,178,$58.50
2024-09-05,04:56:00,18910.25,SELL,3,0.02h,Stop Loss,$-9.00,$49.50,$90792.50,178,$49.50
2024-09-05,04:57:00,18916.0,BUY,3,0.02h,Stop Loss,$-9.00,$40.50,$90783.50,178,$40.50
2024-09-05,04:59:00,18908.25,SELL,3,0.02h,Break Even,$-1.50,$39.00,$90782.00,178,$39.00
2024-09-05,05:17:00,18914.0,BUY,3,0.02h,Break Even,$-1.50,$37.50,$90780.50,178,$37.50
2024-09-05,06:15:00,18937.0,SELL,3,0.02h,Stop Loss,$21.00,$58.50,$90801.50,178,$58.50
2024-09-05,07:05:00,18911.25,BUY,3,0.02h,Break Even,$-1.50,$57.00,$90800.00,178,$57.00
2024-09-05,08:07:00,18984.0,SELL,3,0.02h,Stop Loss,$36.00,$93.00,$90836.00,178,$93.00
2024-09-05,08:29:00,18984.25,BUY,3,0.02h,Break Even,$-1.50,$91.50,$90834.50,178,$91.50
2024-09-05,08:34:00,18972.5,SELL,3,0.02h,Stop Loss,$37.50,$129.00,$90872.00,178,$129.00
2024-09-05,08:55:00,18980.25,BUY,3,0.02h,Break Even,$-1.50,$127.50,$90870.50,178,$127.50
2024-09-05,08:56:00,18971.0,SELL,3,0.02h,Break Even,$-1.50,$126.00,$90869.00,178,$126.00
2024-09-05,09:45:00,18928.75,BUY,3,0.02h,Break Even,$-1.50,$124.50,$90867.50,178,$124.50
2024-09-05,10:29:00,18935.25,SELL,3,0.02h,Break Even,$-1.50,$123.00,$90866.00,178,$123.00
2024-09-05,10:31:00,18946.0,BUY,3,0.02h,Stop Loss,$-9.00,$114.00,$90857.00,178,$114.00
2024-09-05,10:51:00,18941.25,SELL,3,0.02h,Stop Loss,$-9.00,$105.00,$90848.00,178,$105.00
2024-09-05,10:58:00,18948.5,BUY,3,0.02h,Break Even,$-1.50,$103.50,$90846.50,178,$103.50
2024-09-05,11:12:00,18936.0,SELL,3,0.02h,Stop Loss,$40.50,$144.00,$90887.00,178,$144.00
2024-09-05,11:29:00,18952.75,BUY,3,0.02h,Stop Loss,$22.50,$166.50,$90909.50,178,$166.50
2024-09-05,11:43:00,18944.75,SELL,3,0.02h,Stop Loss,$15.00,$181.50,$90924.50,178,$181.50
2024-09-05,12:33:00,18911.5,BUY,3,0.02h,Stop Loss,$4.50,$186.00,$90929.00,178,$186.00
2024-09-05,12:41:00,18861.75,SELL,3,0.02h,Stop Loss,$34.50,$220.50,$90963.50,178,$220.50
2024-09-05,12:48:00,18889.75,BUY,3,0.02h,Stop Loss,$28.50,$249.00,$90992.00,178,$249.00
2024-09-05,13:26:00,18897.5,SELL,3,0.02h,Stop Loss,$15.00,$264.00,$91007.00,178,$264.00
2024-09-05,13:34:00,18932.25,BUY,3,0.02h,Stop Loss,$19.50,$283.50,$91026.50,178,$283.50
2024-09-05,14:17:00,19048.75,SELL,3,0.02h,Stop Loss,$21.00,$304.50,$91047.50,178,$304.50
2024-09-05,14:18:00,19058.25,BUY,3,0.02h,Stop Loss,$37.50,$342.00,$91085.00,178,$342.00
2024-09-05,14:45:00,19071.0,SELL,3,0.02h,Stop Loss,$205.50,$547.50,$91290.50,178,$547.50
2024-09-05,16:04:00,18907.25,BUY,3,0.02h,Stop Loss,$-9.00,$538.50,$91281.50,178,$538.50
2024-09-05,16:17:00,18879.75,SELL,3,0.02h,Stop Loss,$10.50,$549.00,$91292.00,178,$549.00
2024-09-05,16:21:00,18899.75,BUY,3,0.02h,Stop Loss,$15.00,$564.00,$91307.00,178,$564.00
2024-09-05,16:53:00,18932.0,SELL,3,0.02h,Stop Loss,$37.50,$601.50,$91344.50,178,$601.50
2024-09-05,16:58:00,18950.75,BUY,3,0.02h,Break Even,$-1.50,$600.00,$91343.00,178,$600.00
2024-09-05,17:06:00,18930.5,SELL,3,0.02h,Stop Loss,$135.00,$735.00,$91478.00,178,$735.00
2024-09-05,17:38:00,18950.25,BUY,3,0.02h,Break Even,$-1.50,$733.50,$91476.50,178,$733.50
2024-09-05,18:26:00,18993.25,SELL,3,0.02h,Break Even,$-1.50,$732.00,$91475.00,178,$732.00
2024-09-05,18:38:00,19009.5,BUY,3,0.02h,Stop Loss,$-9.00,$723.00,$91466.00,178,$723.00
2024-09-05,18:43:00,18989.25,SELL,3,0.02h,Break Even,$-1.50,$721.50,$91464.50,178,$721.50
2024-09-05,18:48:00,19012.0,BUY,3,0.02h,Break Even,$-1.50,$720.00,$91463.00,178,$720.00
2024-09-05,18:59:00,18992.5,SELL,3,0.02h,Stop Loss,$6.00,$726.00,$91469.00,178,$726.00
2024-09-05,19:32:00,18971.5,BUY,3,0.02h,Stop Loss,$45.00,$771.00,$91514.00,178,$771.00
2024-09-05,19:42:00,18942.5,SELL,3,0.02h,Stop Loss,$54.00,$825.00,$91568.00,178,$825.00
2024-09-05,20:00:00,18975.75,BUY,3,0.02h,Stop Loss,$49.50,$874.50,$91617.50,178,$874.50
2024-09-05,20:17:00,18933.5,SELL,3,0.02h,Stop Loss,$102.00,$976.50,$91719.50,178,$976.50
2024-09-05,20:47:00,18931.0,BUY,3,0.02h,Stop Loss,$-9.00,$967.50,$91710.50,178,$967.50
2024-09-05,20:49:00,18926.5,SELL,3,0.02h,Stop Loss,$36.00,$1003.50,$91746.50,178,$1003.50
2024-09-05,23:34:00,18905.5,BUY,3,0.02h,Break Even,$-1.50,$1002.00,$91745.00,178,$1002.00
,,,,,,,,,,,
2024-09-06,00:02:00,18900.0,SELL,3,0.02h,Stop Loss,$6.00,$6.00,$91751.00,179,$6.00
2024-09-06,01:26:00,18823.5,BUY,3,0.02h,Stop Loss,$49.50,$55.50,$91800.50,179,$55.50
2024-09-06,02:25:00,18873.0,SELL,3,0.02h,Stop Loss,$-9.00,$46.50,$91791.50,179,$46.50
2024-09-06,02:37:00,18879.25,BUY,3,0.02h,Stop Loss,$3.00,$49.50,$91794.50,179,$49.50
2024-09-06,03:25:00,18892.5,SELL,3,0.02h,Stop Loss,$15.00,$64.50,$91809.50,179,$64.50
2024-09-06,03:42:00,18899.75,BUY,3,0.02h,Break Even,$-1.50,$63.00,$91808.00,179,$63.00
2024-09-06,03:44:00,18889.0,SELL,3,0.02h,Stop Loss,$22.50,$85.50,$91830.50,179,$85.50
2024-09-06,04:13:00,18881.0,BUY,3,0.02h,Break Even,$-1.50,$84.00,$91829.00,179,$84.00
2024-09-06,04:37:00,18880.0,SELL,3,0.02h,Stop Loss,$-9.00,$75.00,$91820.00,179,$75.00
2024-09-06,04:41:00,18891.25,BUY,3,0.02h,Break Even,$-1.50,$73.50,$91818.50,179,$73.50
2024-09-06,05:07:00,18881.0,SELL,3,0.02h,Break Even,$-1.50,$72.00,$91817.00,179,$72.00
2024-09-06,05:52:00,18873.75,BUY,3,0.02h,Stop Loss,$27.00,$99.00,$91844.00,179,$99.00
2024-09-06,06:11:00,18853.75,SELL,3,0.02h,Break Even,$-1.50,$97.50,$91842.50,179,$97.50
2024-09-06,06:48:00,18850.5,BUY,3,0.02h,Stop Loss,$58.50,$156.00,$91901.00,179,$156.00
2024-09-06,06:58:00,18843.5,SELL,3,0.02h,Break Even,$-1.50,$154.50,$91899.50,179,$154.50
2024-09-06,07:45:00,18761.0,BUY,3,0.02h,Stop Loss,$3.00,$157.50,$91902.50,179,$157.50
2024-09-06,07:46:00,18747.25,SELL,3,0.02h,Stop Loss,$45.00,$202.50,$91947.50,179,$202.50
2024-09-06,07:54:00,18763.5,BUY,3,0.02h,Stop Loss,$-9.00,$193.50,$91938.50,179,$193.50
2024-09-06,08:17:00,18763.75,SELL,3,0.02h,Stop Loss,$33.00,$226.50,$91971.50,179,$226.50
2024-09-06,08:32:00,18776.5,BUY,3,0.02h,Stop Loss,$-9.00,$217.50,$91962.50,179,$217.50
2024-09-06,08:38:00,18758.25,SELL,3,0.02h,Break Even,$-1.50,$216.00,$91961.00,179,$216.00
2024-09-06,09:23:00,18736.25,BUY,3,0.02h,Stop Loss,$-9.00,$207.00,$91952.00,179,$207.00
2024-09-06,09:43:00,18731.0,SELL,3,0.02h,Break Even,$-1.50,$205.50,$91950.50,179,$205.50
2024-09-06,09:47:00,18744.75,BUY,3,0.02h,Stop Loss,$31.50,$237.00,$91982.00,179,$237.00
2024-09-06,10:15:00,18749.75,SELL,3,0.02h,Break Even,$-1.50,$235.50,$91980.50,179,$235.50
2024-09-06,10:30:00,18753.25,BUY,3,0.02h,Stop Loss,$-9.00,$226.50,$91971.50,179,$226.50
2024-09-06,10:35:00,18747.5,SELL,3,0.02h,Stop Loss,$-9.00,$217.50,$91962.50,179,$217.50
2024-09-06,10:51:00,18747.5,BUY,3,0.02h,Stop Loss,$-9.00,$208.50,$91953.50,179,$208.50
2024-09-06,10:56:00,18732.75,SELL,3,0.02h,Stop Loss,$-9.00,$199.50,$91944.50,179,$199.50
2024-09-06,11:02:00,18747.25,BUY,3,0.02h,Break Even,$-1.50,$198.00,$91943.00,179,$198.00
2024-09-06,11:44:00,18761.5,SELL,3,0.02h,Stop Loss,$-9.00,$189.00,$91934.00,179,$189.00
2024-09-06,11:45:00,18768.5,BUY,3,0.02h,Stop Loss,$-9.00,$180.00,$91925.00,179,$180.00
2024-09-06,11:47:00,18762.25,SELL,3,0.02h,Stop Loss,$-9.00,$171.00,$91916.00,179,$171.00
2024-09-06,11:48:00,18766.75,BUY,3,0.02h,Stop Loss,$34.50,$205.50,$91950.50,179,$205.50
2024-09-06,12:14:00,18780.75,SELL,3,0.02h,Stop Loss,$9.00,$214.50,$91959.50,179,$214.50
2024-09-06,12:19:00,18793.75,BUY,3,0.02h,Break Even,$-1.50,$213.00,$91958.00,179,$213.00
2024-09-06,13:33:00,18891.75,SELL,3,0.02h,Stop Loss,$19.50,$232.50,$91977.50,179,$232.50
2024-09-06,15:03:00,18603.5,BUY,3,0.02h,Stop Loss,$61.50,$294.00,$92039.00,179,$294.00
2024-09-06,15:09:00,18536.0,SELL,3,0.02h,Stop Loss,$33.00,$327.00,$92072.00,179,$327.00
2024-09-06,15:34:00,18544.75,BUY,3,0.02h,Stop Loss,$-9.00,$318.00,$92063.00,179,$318.00
2024-09-06,15:36:00,18520.5,SELL,3,0.02h,Stop Loss,$78.00,$396.00,$92141.00,179,$396.00
2024-09-06,16:14:00,18477.5,BUY,3,0.02h,Stop Loss,$52.50,$448.50,$92193.50,179,$448.50
2024-09-06,16:15:00,18470.0,SELL,3,0.02h,Stop Loss,$45.00,$493.50,$92238.50,179,$493.50
2024-09-06,16:26:00,18484.5,BUY,3,0.02h,Break Even,$-1.50,$492.00,$92237.00,179,$492.00
2024-09-06,16:29:00,18456.25,SELL,3,0.02h,Stop Loss,$30.00,$522.00,$92267.00,179,$522.00
2024-09-06,16:36:00,18484.25,BUY,3,0.02h,Stop Loss,$25.50,$547.50,$92292.50,179,$547.50
2024-09-06,16:41:00,18449.0,SELL,3,0.02h,Stop Loss,$7.50,$555.00,$92300.00,179,$555.00
2024-09-06,16:46:00,18472.5,BUY,3,0.02h,Break Even,$-1.50,$553.50,$92298.50,179,$553.50
2024-09-06,16:47:00,18463.25,SELL,3,0.02h,Stop Loss,$16.50,$570.00,$92315.00,179,$570.00
2024-09-06,17:05:00,18470.25,BUY,3,0.02h,Break Even,$-1.50,$568.50,$92313.50,179,$568.50
2024-09-06,17:33:00,18494.25,SELL,3,0.02h,Stop Loss,$57.00,$625.50,$92370.50,179,$625.50
2024-09-06,17:57:00,18490.75,BUY,3,0.02h,Stop Loss,$-9.00,$616.50,$92361.50,179,$616.50
2024-09-06,18:03:00,18457.25,SELL,3,0.02h,Stop Loss,$13.50,$630.00,$92375.00,179,$630.00
2024-09-06,18:42:00,18458.25,BUY,3,0.02h,Stop Loss,$30.00,$660.00,$92405.00,179,$660.00
2024-09-06,19:37:00,18495.5,SELL,3,0.02h,Stop Loss,$111.00,$771.00,$92516.00,179,$771.00
2024-09-06,19:50:00,18516.75,BUY,3,0.02h,Stop Loss,$70.50,$841.50,$92586.50,179,$841.50
2024-09-06,19:52:00,18477.5,SELL,3,0.02h,Stop Loss,$52.50,$894.00,$92639.00,179,$894.00
,,,,,,,,,,,
2024-09-09,00:00:00,18446.5,BUY,3,0.02h,Break Even,$-1.50,$-1.50,$92637.50,180,$-1.50
2024-09-09,00:50:00,18477.75,SELL,3,0.02h,Stop Loss,$-9.00,$-10.50,$92628.50,180,$-10.50
2024-09-09,00:53:00,18483.0,BUY,3,0.02h,Stop Loss,$48.00,$37.50,$92676.50,180,$37.50
2024-09-09,02:00:00,18513.0,SELL,3,0.02h,Stop Loss,$13.50,$51.00,$92690.00,180,$51.00
2024-09-09,02:12:00,18514.25,BUY,3,0.02h,Break Even,$-1.50,$49.50,$92688.50,180,$49.50
2024-09-09,02:19:00,18506.5,SELL,3,0.02h,Break Even,$-1.50,$48.00,$92687.00,180,$48.00
2024-09-09,02:34:00,18513.0,BUY,3,0.02h,Stop Loss,$-9.00,$39.00,$92678.00,180,$39.00
2024-09-09,02:35:00,18509.0,SELL,3,0.02h,Stop Loss,$-9.00,$30.00,$92669.00,180,$30.00
2024-09-09,02:36:00,18514.25,BUY,3,0.02h,Break Even,$-1.50,$28.50,$92667.50,180,$28.50
2024-09-09,03:22:00,18521.0,SELL,3,0.02h,Break Even,$-1.50,$27.00,$92666.00,180,$27.00
2024-09-09,03:24:00,18523.75,BUY,3,0.03h,Break Even,$-1.50,$25.50,$92664.50,180,$25.50
2024-09-09,05:01:00,18565.75,SELL,3,0.02h,Break Even,$-1.50,$24.00,$92663.00,180,$24.00
2024-09-09,05:34:00,18570.0,BUY,3,0.02h,Stop Loss,$-9.00,$15.00,$92654.00,180,$15.00
2024-09-09,05:45:00,18549.5,SELL,3,0.02h,Stop Loss,$13.50,$28.50,$92667.50,180,$28.50
2024-09-09,06:06:00,18561.25,BUY,3,0.02h,Stop Loss,$22.50,$51.00,$92690.00,180,$51.00
2024-09-09,06:15:00,18553.75,SELL,3,0.02h,Stop Loss,$-9.00,$42.00,$92681.00,180,$42.00
2024-09-09,06:16:00,18558.0,BUY,3,0.02h,Break Even,$-1.50,$40.50,$92679.50,180,$40.50
2024-09-09,06:47:00,18559.0,SELL,3,0.02h,Break Even,$-1.50,$39.00,$92678.00,180,$39.00
2024-09-09,06:55:00,18572.25,BUY,3,0.02h,Break Even,$-1.50,$37.50,$92676.50,180,$37.50
2024-09-09,08:15:00,18602.25,SELL,3,0.02h,Stop Loss,$10.50,$48.00,$92687.00,180,$48.00
2024-09-09,08:36:00,18602.25,BUY,3,0.02h,Stop Loss,$-9.00,$39.00,$92678.00,180,$39.00
2024-09-09,08:37:00,18595.75,SELL,3,0.02h,Stop Loss,$-9.00,$30.00,$92669.00,180,$30.00
2024-09-09,08:50:00,18604.25,BUY,3,0.02h,Stop Loss,$13.50,$43.50,$92682.50,180,$43.50
2024-09-09,09:40:00,18619.75,SELL,3,0.02h,Stop Loss,$-9.00,$34.50,$92673.50,180,$34.50
2024-09-09,10:00:00,18627.0,BUY,3,0.02h,Stop Loss,$-9.00,$25.50,$92664.50,180,$25.50
2024-09-09,10:24:00,18628.25,SELL,3,0.02h,Stop Loss,$3.00,$28.50,$92667.50,180,$28.50
2024-09-09,11:11:00,18619.25,BUY,3,0.02h,Stop Loss,$-9.00,$19.50,$92658.50,180,$19.50
2024-09-09,11:35:00,18607.5,SELL,3,0.02h,Break Even,$-1.50,$18.00,$92657.00,180,$18.00
2024-09-09,12:35:00,18586.25,BUY,3,0.02h,Break Even,$-1.50,$16.50,$92655.50,180,$16.50
2024-09-09,14:20:00,18651.75,SELL,3,0.02h,Stop Loss,$51.00,$67.50,$92706.50,180,$67.50
2024-09-09,15:27:00,18541.5,BUY,3,0.02h,Stop Loss,$9.00,$76.50,$92715.50,180,$76.50
2024-09-09,17:25:00,18709.0,SELL,3,0.02h,Break Even,$-1.50,$75.00,$92714.00,180,$75.00
2024-09-09,18:47:00,18613.25,BUY,3,0.02h,Stop Loss,$3.00,$78.00,$92717.00,180,$78.00
2024-09-09,19:00:00,18603.75,SELL,3,0.02h,Stop Loss,$24.00,$102.00,$92741.00,180,$102.00
2024-09-09,19:11:00,18608.0,BUY,3,0.02h,Stop Loss,$7.50,$109.50,$92748.50,180,$109.50
2024-09-09,19:12:00,18600.0,SELL,3,0.02h,Break Even,$-1.50,$108.00,$92747.00,180,$108.00
2024-09-09,19:13:00,18604.25,BUY,3,0.02h,Break Even,$-1.50,$106.50,$92745.50,180,$106.50
2024-09-09,19:15:00,18596.5,SELL,3,0.02h,Stop Loss,$-9.00,$97.50,$92736.50,180,$97.50
2024-09-09,19:16:00,18606.25,BUY,3,0.02h,Stop Loss,$21.00,$118.50,$92757.50,180,$118.50
2024-09-09,19:21:00,18596.5,SELL,3,0.02h,Stop Loss,$54.00,$172.50,$92811.50,180,$172.50
2024-09-09,19:26:00,18608.25,BUY,3,0.02h,Stop Loss,$61.50,$234.00,$92873.00,180,$234.00
2024-09-09,20:49:00,18716.5,SELL,3,0.02h,Stop Loss,$-9.00,$225.00,$92864.00,180,$225.00
2024-09-09,23:18:00,18714.25,BUY,3,0.02h,Stop Loss,$9.00,$234.00,$92873.00,180,$234.00
2024-09-09,23:53:00,18714.75,SELL,3,0.02h,Break Even,$-1.50,$232.50,$92871.50,180,$232.50
,,,,,,,,,,,
2024-09-10,00:41:00,18669.0,BUY,3,0.02h,Break Even,$-1.50,$-1.50,$92870.00,181,$-1.50
2024-09-10,01:20:00,18678.75,SELL,3,0.02h,Stop Loss,$-9.00,$-10.50,$92861.00,181,$-10.50
2024-09-10,01:24:00,18683.75,BUY,3,0.02h,Break Even,$-1.50,$-12.00,$92859.50,181,$-12.00
2024-09-10,01:31:00,18669.0,SELL,3,0.02h,Stop Loss,$21.00,$9.00,$92880.50,181,$9.00
2024-09-10,01:38:00,18688.0,BUY,3,0.02h,Stop Loss,$4.50,$13.50,$92885.00,181,$13.50
2024-09-10,01:50:00,18677.5,SELL,3,0.02h,Stop Loss,$3.00,$16.50,$92888.00,181,$16.50
2024-09-10,01:54:00,18685.0,BUY,3,0.02h,Break Even,$-1.50,$15.00,$92886.50,181,$15.00
2024-09-10,02:03:00,18674.75,SELL,3,0.02h,Stop Loss,$48.00,$63.00,$92934.50,181,$63.00
2024-09-10,02:33:00,18666.25,BUY,3,0.02h,Stop Loss,$-9.00,$54.00,$92925.50,181,$54.00
2024-09-10,03:07:00,18666.5,SELL,3,0.02h,Stop Loss,$4.50,$58.50,$92930.00,181,$58.50
2024-09-10,03:53:00,18653.25,BUY,3,0.02h,Stop Loss,$-9.00,$49.50,$92921.00,181,$49.50
2024-09-10,04:17:00,18650.75,SELL,3,0.02h,Stop Loss,$-9.00,$40.50,$92912.00,181,$40.50
2024-09-10,04:24:00,18654.5,BUY,3,0.02h,Stop Loss,$-9.00,$31.50,$92903.00,181,$31.50
2024-09-10,04:25:00,18652.0,SELL,3,0.02h,Break Even,$-1.50,$30.00,$92901.50,181,$30.00
2024-09-10,05:07:00,18632.75,BUY,3,0.02h,Stop Loss,$31.50,$61.50,$92933.00,181,$61.50
2024-09-10,05:34:00,18629.0,SELL,3,0.02h,Stop Loss,$15.00,$76.50,$92948.00,181,$76.50
2024-09-10,06:17:00,18633.25,BUY,3,0.02h,Stop Loss,$-9.00,$67.50,$92939.00,181,$67.50
2024-09-10,06:53:00,18629.0,SELL,3,0.02h,Stop Loss,$-9.00,$58.50,$92930.00,181,$58.50
2024-09-10,07:10:00,18641.0,BUY,3,0.02h,Stop Loss,$13.50,$72.00,$92943.50,181,$72.00
2024-09-10,08:14:00,18673.0,SELL,3,0.02h,Stop Loss,$16.50,$88.50,$92960.00,181,$88.50
2024-09-10,08:19:00,18678.25,BUY,3,0.02h,Stop Loss,$-9.00,$79.50,$92951.00,181,$79.50
2024-09-10,08:20:00,18673.25,SELL,3,0.02h,Stop Loss,$28.50,$108.00,$92979.50,181,$108.00
2024-09-10,09:32:00,18612.25,BUY,3,0.02h,Break Even,$-1.50,$106.50,$92978.00,181,$106.50
2024-09-10,10:14:00,18634.5,SELL,3,0.02h,Stop Loss,$16.50,$123.00,$92994.50,181,$123.00
2024-09-10,10:27:00,18644.25,BUY,3,0.02h,Break Even,$-1.50,$121.50,$92993.00,181,$121.50
2024-09-10,10:54:00,18654.25,SELL,3,0.02h,Stop Loss,$6.00,$127.50,$92999.00,181,$127.50
2024-09-10,11:02:00,18665.25,BUY,3,0.02h,Break Even,$-1.50,$126.00,$92997.50,181,$126.00
2024-09-10,11:20:00,18658.0,SELL,3,0.02h,Break Even,$-1.50,$124.50,$92996.00,181,$124.50
2024-09-10,11:24:00,18668.75,BUY,3,0.02h,Stop Loss,$12.00,$136.50,$93008.00,181,$136.50
2024-09-10,11:38:00,18654.0,SELL,3,0.02h,Stop Loss,$3.00,$139.50,$93011.00,181,$139.50
2024-09-10,11:43:00,18672.25,BUY,3,0.02h,Break Even,$-1.50,$138.00,$93009.50,181,$138.00
2024-09-10,13:17:00,18756.0,SELL,3,0.02h,Break Even,$-1.50,$136.50,$93008.00,181,$136.50
2024-09-10,13:19:00,18760.0,BUY,3,0.02h,Stop Loss,$16.50,$153.00,$93024.50,181,$153.00
2024-09-10,13:38:00,18747.0,SELL,3,0.02h,Stop Loss,$67.50,$220.50,$93092.00,181,$220.50
2024-09-10,13:54:00,18772.75,BUY,3,0.02h,Stop Loss,$46.50,$267.00,$93138.50,181,$267.00
2024-09-10,14:13:00,18739.5,SELL,3,0.02h,Stop Loss,$186.00,$453.00,$93324.50,181,$453.00
2024-09-10,14:30:00,18780.75,BUY,3,0.02h,Stop Loss,$10.50,$463.50,$93335.00,181,$463.50
2024-09-10,14:44:00,18734.0,SELL,3,0.02h,Stop Loss,$90.00,$553.50,$93425.00,181,$553.50
2024-09-10,15:10:00,18732.25,BUY,3,0.02h,Stop Loss,$91.50,$645.00,$93516.50,181,$645.00
2024-09-10,15:40:00,18742.0,SELL,3,0.02h,Stop Loss,$9.00,$654.00,$93525.50,181,$654.00
2024-09-10,16:25:00,18647.0,BUY,3,0.02h,Stop Loss,$27.00,$681.00,$93552.50,181,$681.00
2024-09-10,18:53:00,18820.75,SELL,3,0.02h,Stop Loss,$-9.00,$672.00,$93543.50,181,$672.00
2024-09-10,19:10:00,18833.0,BUY,3,0.02h,Stop Loss,$48.00,$720.00,$93591.50,181,$720.00
2024-09-10,19:45:00,18848.0,SELL,3,0.02h,Break Even,$-1.50,$718.50,$93590.00,181,$718.50
2024-09-10,19:48:00,18858.25,BUY,3,0.02h,Stop Loss,$-9.00,$709.50,$93581.00,181,$709.50
2024-09-10,19:51:00,18840.25,SELL,3,0.02h,Stop Loss,$-9.00,$700.50,$93572.00,181,$700.50
2024-09-10,19:56:00,18855.75,BUY,3,0.02h,Stop Loss,$15.00,$715.50,$93587.00,181,$715.50
2024-09-10,20:03:00,18846.25,SELL,3,0.02h,Break Even,$-1.50,$714.00,$93585.50,181,$714.00
2024-09-10,20:55:00,18831.25,BUY,3,0.02h,Stop Loss,$-9.00,$705.00,$93576.50,181,$705.00
2024-09-10,23:44:00,18845.75,SELL,3,0.02h,Break Even,$-1.50,$703.50,$93575.00,181,$703.50
,,,,,,,,,,,
2024-09-11,00:45:00,18822.25,BUY,3,0.02h,Stop Loss,$12.00,$12.00,$93587.00,182,$12.00
2024-09-11,00:56:00,18815.75,SELL,3,0.02h,Break Even,$-1.50,$10.50,$93585.50,182,$10.50
2024-09-11,01:20:00,18814.75,BUY,3,0.02h,Stop Loss,$-9.00,$1.50,$93576.50,182,$1.50
2024-09-11,01:35:00,18771.75,SELL,3,0.02h,Stop Loss,$115.50,$117.00,$93692.00,182,$117.00
2024-09-11,01:46:00,18809.25,BUY,3,0.02h,Stop Loss,$16.50,$133.50,$93708.50,182,$133.50
2024-09-11,01:52:00,18792.25,SELL,3,0.02h,Stop Loss,$7.50,$141.00,$93716.00,182,$141.00
2024-09-11,02:24:00,18790.0,BUY,3,0.02h,Stop Loss,$15.00,$156.00,$93731.00,182,$156.00
2024-09-11,02:32:00,18776.25,SELL,3,0.02h,Stop Loss,$-9.00,$147.00,$93722.00,182,$147.00
2024-09-11,02:39:00,18788.75,BUY,3,0.02h,Stop Loss,$7.50,$154.50,$93729.50,182,$154.50
2024-09-11,02:56:00,18787.0,SELL,3,0.02h,Stop Loss,$-9.00,$145.50,$93720.50,182,$145.50
2024-09-11,02:57:00,18790.25,BUY,3,0.02h,Stop Loss,$-9.00,$136.50,$93711.50,182,$136.50
2024-09-11,02:59:00,18786.5,SELL,3,0.02h,Stop Loss,$-9.00,$127.50,$93702.50,182,$127.50
2024-09-11,03:01:00,18791.25,BUY,3,0.02h,Stop Loss,$21.00,$148.50,$93723.50,182,$148.50
2024-09-11,03:04:00,18779.75,SELL,3,0.02h,Break Even,$-1.50,$147.00,$93722.00,182,$147.00
2024-09-11,03:50:00,18753.0,BUY,3,0.02h,Stop Loss,$3.00,$150.00,$93725.00,182,$150.00
2024-09-11,04:02:00,18751.5,SELL,3,0.02h,Break Even,$-1.50,$148.50,$93723.50,182,$148.50
2024-09-11,04:32:00,18741.0,BUY,3,0.02h,Break Even,$-1.50,$147.00,$93722.00,182,$147.00
2024-09-11,04:39:00,18736.25,SELL,3,0.02h,Break Even,$-1.50,$145.50,$93720.50,182,$145.50
2024-09-11,05:02:00,18731.75,BUY,3,0.02h,Stop Loss,$16.50,$162.00,$93737.00,182,$162.00
2024-09-11,05:18:00,18725.5,SELL,3,0.02h,Break Even,$-1.50,$160.50,$93735.50,182,$160.50
2024-09-11,05:36:00,18726.25,BUY,3,0.02h,Stop Loss,$-9.00,$151.50,$93726.50,182,$151.50
2024-09-11,05:40:00,18715.5,SELL,3,0.02h,Stop Loss,$-9.00,$142.50,$93717.50,182,$142.50
2024-09-11,05:44:00,18731.25,BUY,3,0.02h,Break Even,$-1.50,$141.00,$93716.00,182,$141.00
2024-09-11,07:02:00,18785.5,SELL,3,0.02h,Stop Loss,$-9.00,$132.00,$93707.00,182,$132.00
2024-09-11,07:03:00,18795.75,BUY,3,0.02h,Break Even,$-1.50,$130.50,$93705.50,182,$130.50
2024-09-11,07:27:00,18794.75,SELL,3,0.02h,Break Even,$-1.50,$129.00,$93704.00,182,$129.00
2024-09-11,07:31:00,18804.5,BUY,3,0.02h,Stop Loss,$25.50,$154.50,$93729.50,182,$154.50
2024-09-11,07:38:00,18800.5,SELL,3,0.02h,Break Even,$-1.50,$153.00,$93728.00,182,$153.00
2024-09-11,07:42:00,18809.0,BUY,3,0.02h,Stop Loss,$-9.00,$144.00,$93719.00,182,$144.00
2024-09-11,07:43:00,18798.75,SELL,3,0.02h,Break Even,$-1.50,$142.50,$93717.50,182,$142.50
2024-09-11,07:54:00,18810.5,BUY,3,0.02h,Stop Loss,$12.00,$154.50,$93729.50,182,$154.50
2024-09-11,08:15:00,18799.5,SELL,3,0.02h,Stop Loss,$10.50,$165.00,$93740.00,182,$165.00
2024-09-11,08:21:00,18817.75,BUY,3,0.02h,Stop Loss,$10.50,$175.50,$93750.50,182,$175.50
2024-09-11,08:33:00,18796.5,SELL,3,0.02h,Stop Loss,$4.50,$180.00,$93755.00,182,$180.00
2024-09-11,09:07:00,18785.5,BUY,3,0.02h,Stop Loss,$-9.00,$171.00,$93746.00,182,$171.00
2024-09-11,09:24:00,18782.5,SELL,3,0.02h,Stop Loss,$19.50,$190.50,$93765.50,182,$190.50
2024-09-11,09:32:00,18797.0,BUY,3,0.02h,Break Even,$-1.50,$189.00,$93764.00,182,$189.00
2024-09-11,09:47:00,18788.25,SELL,3,0.02h,Stop Loss,$-9.00,$180.00,$93755.00,182,$180.00
2024-09-11,09:49:00,18797.25,BUY,3,0.02h,Stop Loss,$-9.00,$171.00,$93746.00,182,$171.00
2024-09-11,10:13:00,18802.75,SELL,3,0.02h,Stop Loss,$-9.00,$162.00,$93737.00,182,$162.00
2024-09-11,10:14:00,18807.25,BUY,3,0.02h,Break Even,$-1.50,$160.50,$93735.50,182,$160.50
2024-09-11,10:27:00,18796.5,SELL,3,0.02h,Stop Loss,$9.00,$169.50,$93744.50,182,$169.50
2024-09-11,10:41:00,18806.25,BUY,3,0.02h,Break Even,$-1.50,$168.00,$93743.00,182,$168.00
2024-09-11,10:58:00,18801.0,SELL,3,0.02h,Break Even,$-1.50,$166.50,$93741.50,182,$166.50
2024-09-11,11:13:00,18811.5,BUY,3,0.02h,Break Even,$-1.50,$165.00,$93740.00,182,$165.00
2024-09-11,11:30:00,18806.5,SELL,3,0.02h,Stop Loss,$-9.00,$156.00,$93731.00,182,$156.00
2024-09-11,11:31:00,18810.5,BUY,3,0.02h,Break Even,$-1.50,$154.50,$93729.50,182,$154.50
2024-09-11,12:04:00,18823.5,SELL,3,0.02h,Break Even,$-1.50,$153.00,$93728.00,182,$153.00
2024-09-11,12:09:00,18833.25,BUY,3,0.02h,Stop Loss,$-9.00,$144.00,$93719.00,182,$144.00
2024-09-11,12:31:00,18754.25,SELL,3,0.02h,Stop Loss,$120.00,$264.00,$93839.00,182,$264.00
2024-09-11,12:50:00,18822.5,BUY,3,0.02h,Stop Loss,$30.00,$294.00,$93869.00,182,$294.00
2024-09-11,13:32:00,18891.0,SELL,3,0.02h,Stop Loss,$97.50,$391.50,$93966.50,182,$391.50
2024-09-11,15:05:00,18607.25,BUY,3,0.02h,Stop Loss,$225.00,$616.50,$94191.50,182,$616.50
2024-09-11,16:48:00,18885.25,SELL,3,0.02h,Stop Loss,$27.00,$643.50,$94218.50,182,$643.50
2024-09-11,16:55:00,18916.0,BUY,3,0.02h,Stop Loss,$-9.00,$634.50,$94209.50,182,$634.50
2024-09-11,18:55:00,19107.25,SELL,3,0.02h,Break Even,$-1.50,$633.00,$94208.00,182,$633.00
2024-09-11,18:56:00,19134.75,BUY,3,0.02h,Stop Loss,$16.50,$649.50,$94224.50,182,$649.50
2024-09-11,19:00:00,19127.75,SELL,3,0.02h,Stop Loss,$81.00,$730.50,$94305.50,182,$730.50
2024-09-11,19:08:00,19138.5,BUY,3,0.02h,Stop Loss,$40.50,$771.00,$94346.00,182,$771.00
2024-09-11,20:47:00,19246.25,SELL,3,0.02h,Break Even,$-1.50,$769.50,$94344.50,182,$769.50
2024-09-11,20:48:00,19249.0,BUY,3,0.02h,Stop Loss,$-9.00,$760.50,$94335.50,182,$760.50
2024-09-11,20:50:00,19246.25,SELL,3,0.02h,Break Even,$-1.50,$759.00,$94334.00,182,$759.00
2024-09-11,20:52:00,19249.5,BUY,3,0.02h,Stop Loss,$-9.00,$750.00,$94325.00,182,$750.00
2024-09-11,20:57:00,19242.75,SELL,3,0.02h,Stop Loss,$-9.00,$741.00,$94316.00,182,$741.00
2024-09-11,23:19:00,19248.0,BUY,3,0.02h,Stop Loss,$-9.00,$732.00,$94307.00,182,$732.00
2024-09-11,23:29:00,19242.0,SELL,3,0.03h,Break Even,$-1.50,$730.50,$94305.50,182,$730.50
2024-09-11,23:53:00,19240.75,BUY,3,0.03h,Stop Loss,$-9.00,$721.50,$94296.50,182,$721.50
2024-09-11,23:55:00,19240.0,SELL,3,0.02h,Break Even,$-1.50,$720.00,$94295.00,182,$720.00
2024-09-11,23:59:00,19245.0,BUY,3,0.02h,Stop Loss,$-9.00,$711.00,$94286.00,182,$711.00
,,,,,,,,,,,
2024-09-12,00:47:00,19261.5,SELL,3,0.02h,Break Even,$-1.50,$-1.50,$94284.50,183,$-1.50
2024-09-12,01:17:00,19262.25,BUY,3,0.02h,Stop Loss,$4.50,$3.00,$94289.00,183,$3.00
2024-09-12,01:58:00,19272.25,SELL,3,0.02h,Stop Loss,$-9.00,$-6.00,$94280.00,183,$-6.00
2024-09-12,02:04:00,19277.5,BUY,3,0.02h,Stop Loss,$-9.00,$-15.00,$94271.00,183,$-15.00
2024-09-12,02:05:00,19275.0,SELL,3,0.02h,Break Even,$-1.50,$-16.50,$94269.50,183,$-16.50
2024-09-12,02:22:00,19280.5,BUY,3,0.02h,Stop Loss,$21.00,$4.50,$94290.50,183,$4.50
2024-09-12,02:53:00,19278.5,SELL,3,0.02h,Stop Loss,$-9.00,$-4.50,$94281.50,183,$-4.50
2024-09-12,03:01:00,19513.75,BUY,3,0.02h,Stop Loss,$-9.00,$-13.50,$94272.50,183,$-13.50
2024-09-12,03:06:00,19280.75,SELL,3,0.02h,Stop Loss,$18.00,$4.50,$94290.50,183,$4.50
2024-09-12,03:14:00,19519.25,BUY,3,0.02h,Stop Loss,$-9.00,$-4.50,$94281.50,183,$-4.50
2024-09-12,03:36:00,19288.5,SELL,3,0.02h,Stop Loss,$-9.00,$-13.50,$94272.50,183,$-13.50
2024-09-12,03:38:00,19527.75,BUY,3,0.02h,Break Even,$-1.50,$-15.00,$94271.00,183,$-15.00
2024-09-12,03:48:00,19299.0,SELL,3,0.02h,Break Even,$-1.50,$-16.50,$94269.50,183,$-16.50
2024-09-12,03:52:00,19533.0,BUY,3,0.02h,Stop Loss,$-9.00,$-25.50,$94260.50,183,$-25.50
2024-09-12,03:53:00,19298.25,SELL,3,0.02h,Stop Loss,$-9.00,$-34.50,$94251.50,183,$-34.50
2024-09-12,03:56:00,19540.25,BUY,3,0.02h,Break Even,$-1.50,$-36.00,$94250.00,183,$-36.00
2024-09-12,04:06:00,19304.5,SELL,3,0.02h,Stop Loss,$-9.00,$-45.00,$94241.00,183,$-45.00
2024-09-12,04:07:00,19541.25,BUY,3,0.03h,Stop Loss,$-9.00,$-54.00,$94232.00,183,$-54.00
2024-09-12,04:09:00,19305.25,SELL,3,0.02h,Stop Loss,$4.50,$-49.50,$94236.50,183,$-49.50
2024-09-12,04:17:00,19539.75,BUY,3,0.02h,Stop Loss,$-9.00,$-58.50,$94227.50,183,$-58.50
2024-09-12,04:18:00,19305.75,SELL,3,0.02h,Stop Loss,$-9.00,$-67.50,$94218.50,183,$-67.50
2024-09-12,04:19:00,19540.0,BUY,3,0.02h,Stop Loss,$-9.00,$-76.50,$94209.50,183,$-76.50
2024-09-12,04:22:00,19301.25,SELL,3,0.02h,Break Even,$-1.50,$-78.00,$94208.00,183,$-78.00
2024-09-12,04:29:00,19538.25,BUY,3,0.02h,Stop Loss,$-9.00,$-87.00,$94199.00,183,$-87.00
2024-09-12,04:30:00,19306.25,SELL,3,0.02h,Stop Loss,$-9.00,$-96.00,$94190.00,183,$-96.00
2024-09-12,04:34:00,19545.0,BUY,3,0.02h,Stop Loss,$10.50,$-85.50,$94200.50,183,$-85.50
2024-09-12,04:40:00,19316.25,SELL,3,0.02h,Stop Loss,$-9.00,$-94.50,$94191.50,183,$-94.50
2024-09-12,04:41:00,19553.75,BUY,3,0.02h,Stop Loss,$-9.00,$-103.50,$94182.50,183,$-103.50
2024-09-12,04:42:00,19318.25,SELL,3,0.02h,Stop Loss,$-9.00,$-112.50,$94173.50,183,$-112.50
2024-09-12,04:58:00,19550.5,BUY,3,0.02h,Stop Loss,$-9.00,$-121.50,$94164.50,183,$-121.50
2024-09-12,04:59:00,19313.75,SELL,3,0.02h,Stop Loss,$-9.00,$-130.50,$94155.50,183,$-130.50
2024-09-12,05:00:00,19549.5,BUY,3,0.02h,Stop Loss,$-9.00,$-139.50,$94146.50,183,$-139.50
2024-09-12,05:07:00,19311.25,SELL,3,0.02h,Break Even,$-1.50,$-141.00,$94145.00,183,$-141.00
2024-09-12,05:09:00,19546.0,BUY,3,0.02h,Stop Loss,$-9.00,$-150.00,$94136.00,183,$-150.00
2024-09-12,05:10:00,19313.0,SELL,3,0.02h,Break Even,$-1.50,$-151.50,$94134.50,183,$-151.50
2024-09-12,05:16:00,19547.0,BUY,3,0.02h,Stop Loss,$-9.00,$-160.50,$94125.50,183,$-160.50
2024-09-12,05:18:00,19312.5,SELL,3,0.02h,Stop Loss,$-9.00,$-169.50,$94116.50,183,$-169.50
2024-09-12,05:19:00,19551.0,BUY,3,0.02h,Stop Loss,$-9.00,$-178.50,$94107.50,183,$-178.50
2024-09-12,05:20:00,19316.0,SELL,3,0.02h,Stop Loss,$-9.00,$-187.50,$94098.50,183,$-187.50
2024-09-12,05:21:00,19554.25,BUY,3,0.02h,Stop Loss,$-9.00,$-196.50,$94089.50,183,$-196.50
2024-09-12,05:31:00,19324.5,SELL,3,0.02h,Break Even,$-1.50,$-198.00,$94088.00,183,$-198.00
2024-09-12,05:33:00,19558.5,BUY,3,0.02h,Stop Loss,$-9.00,$-207.00,$94079.00,183,$-207.00
2024-09-12,05:34:00,19322.0,SELL,3,0.02h,Stop Loss,$-9.00,$-216.00,$94070.00,183,$-216.00
2024-09-12,05:35:00,19551.25,BUY,3,0.02h,Stop Loss,$-9.00,$-225.00,$94061.00,183,$-225.00
2024-09-12,05:40:00,19307.5,SELL,3,0.02h,Stop Loss,$-9.00,$-234.00,$94052.00,183,$-234.00
2024-09-12,05:48:00,19541.25,BUY,3,0.02h,Break Even,$-1.50,$-235.50,$94050.50,183,$-235.50
2024-09-12,05:53:00,19322.25,SELL,3,0.02h,Stop Loss,$3.00,$-232.50,$94053.50,183,$-232.50
2024-09-12,06:00:00,19548.0,BUY,3,0.02h,Stop Loss,$-9.00,$-241.50,$94044.50,183,$-241.50
2024-09-12,06:01:00,19317.5,SELL,3,0.02h,Stop Loss,$-9.00,$-250.50,$94035.50,183,$-250.50
2024-09-12,06:02:00,19554.75,BUY,3,0.02h,Stop Loss,$-9.00,$-259.50,$94026.50,183,$-259.50
2024-09-12,06:03:00,19323.75,SELL,3,0.02h,Break Even,$-1.50,$-261.00,$94025.00,183,$-261.00
2024-09-12,06:10:00,19572.75,BUY,3,0.02h,Stop Loss,$4.50,$-256.50,$94029.50,183,$-256.50
2024-09-12,06:17:00,19330.25,SELL,3,0.02h,Stop Loss,$10.50,$-246.00,$94040.00,183,$-246.00
2024-09-12,06:19:00,19563.25,BUY,3,0.02h,Stop Loss,$-9.00,$-255.00,$94031.00,183,$-255.00
2024-09-12,06:27:00,19314.0,SELL,3,0.02h,Break Even,$-1.50,$-256.50,$94029.50,183,$-256.50
2024-09-12,06:34:00,19555.25,BUY,3,0.02h,Stop Loss,$-9.00,$-265.50,$94020.50,183,$-265.50
2024-09-12,06:42:00,19314.5,SELL,3,0.02h,Stop Loss,$-9.00,$-274.50,$94011.50,183,$-274.50
2024-09-12,06:49:00,19547.25,BUY,3,0.02h,Break Even,$-1.50,$-276.00,$94010.00,183,$-276.00
2024-09-12,06:51:00,19309.75,SELL,3,0.02h,Stop Loss,$-9.00,$-285.00,$94001.00,183,$-285.00
2024-09-12,06:52:00,19550.75,BUY,3,0.02h,Break Even,$-1.50,$-286.50,$93999.50,183,$-286.50
2024-09-12,07:04:00,19312.75,SELL,3,0.02h,Stop Loss,$-9.00,$-295.50,$93990.50,183,$-295.50
2024-09-12,07:05:00,19547.5,BUY,3,0.02h,Stop Loss,$-9.00,$-304.50,$93981.50,183,$-304.50
2024-09-12,07:06:00,19306.5,SELL,3,0.02h,Stop Loss,$28.50,$-276.00,$94010.00,183,$-276.00
2024-09-12,07:13:00,19543.0,BUY,3,0.02h,Stop Loss,$-9.00,$-285.00,$94001.00,183,$-285.00
2024-09-12,07:14:00,19315.25,SELL,3,0.02h,Stop Loss,$4.50,$-280.50,$94005.50,183,$-280.50
2024-09-12,07:25:00,19533.75,BUY,3,0.02h,Stop Loss,$36.00,$-244.50,$94041.50,183,$-244.50
2024-09-12,07:36:00,19314.75,SELL,3,0.02h,Stop Loss,$-9.00,$-253.50,$94032.50,183,$-253.50
2024-09-12,07:37:00,19547.25,BUY,3,0.02h,Stop Loss,$-9.00,$-262.50,$94023.50,183,$-262.50
2024-09-12,07:38:00,19306.0,SELL,3,0.02h,Stop Loss,$7.50,$-255.00,$94031.00,183,$-255.00
2024-09-12,07:41:00,19548.75,BUY,3,0.02h,Stop Loss,$-9.00,$-264.00,$94022.00,183,$-264.00
2024-09-12,07:49:00,19301.75,SELL,3,0.02h,Stop Loss,$-9.00,$-273.00,$94013.00,183,$-273.00
2024-09-12,07:51:00,19525.25,BUY,3,0.02h,Stop Loss,$-9.00,$-282.00,$94004.00,183,$-282.00
2024-09-12,07:52:00,19293.5,SELL,3,0.02h,Break Even,$-1.50,$-283.50,$94002.50,183,$-283.50
2024-09-12,08:00:00,19515.5,BUY,3,0.02h,Stop Loss,$-9.00,$-292.50,$93993.50,183,$-292.50
2024-09-12,08:01:00,19263.0,SELL,3,0.02h,Stop Loss,$-9.00,$-301.50,$93984.50,183,$-301.50
2024-09-12,08:03:00,19502.5,BUY,3,0.02h,Stop Loss,$-9.00,$-310.50,$93975.50,183,$-310.50
2024-09-12,08:04:00,19264.25,SELL,3,0.02h,Stop Loss,$-9.00,$-319.50,$93966.50,183,$-319.50
2024-09-12,08:06:00,19503.25,BUY,3,0.02h,Break Even,$-1.50,$-321.00,$93965.00,183,$-321.00
2024-09-12,08:09:00,19272.0,SELL,3,0.02h,Stop Loss,$10.50,$-310.50,$93975.50,183,$-310.50
2024-09-12,08:13:00,19518.25,BUY,3,0.02h,Stop Loss,$21.00,$-289.50,$93996.50,183,$-289.50
2024-09-12,08:16:00,19283.5,SELL,3,0.02h,Stop Loss,$6.00,$-283.50,$94002.50,183,$-283.50
2024-09-12,08:19:00,19522.0,BUY,3,0.02h,Stop Loss,$-9.00,$-292.50,$93993.50,183,$-292.50
2024-09-12,08:22:00,19278.5,SELL,3,0.02h,Stop Loss,$-9.00,$-301.50,$93984.50,183,$-301.50
2024-09-12,08:23:00,19514.25,BUY,3,0.03h,Stop Loss,$25.50,$-276.00,$94010.00,183,$-276.00
2024-09-12,08:26:00,19281.25,SELL,3,0.02h,Stop Loss,$-9.00,$-285.00,$94001.00,183,$-285.00
2024-09-12,08:30:00,19515.0,BUY,3,0.02h,Stop Loss,$-9.00,$-294.00,$93992.00,183,$-294.00
2024-09-12,08:32:00,19277.5,SELL,3,0.02h,Stop Loss,$-9.00,$-303.00,$93983.00,183,$-303.00
2024-09-12,08:41:00,19532.0,BUY,3,0.02h,Stop Loss,$-9.00,$-312.00,$93974.00,183,$-312.00
2024-09-12,08:42:00,19302.75,SELL,3,0.02h,Stop Loss,$-9.00,$-321.00,$93965.00,183,$-321.00
2024-09-12,08:44:00,19544.75,BUY,3,0.02h,Stop Loss,$-9.00,$-330.00,$93956.00,183,$-330.00
2024-09-12,08:45:00,19310.75,SELL,3,0.02h,Break Even,$-1.50,$-331.50,$93954.50,183,$-331.50
2024-09-12,08:47:00,19540.5,BUY,3,0.02h,Stop Loss,$-9.00,$-340.50,$93945.50,183,$-340.50
2024-09-12,08:48:00,19305.5,SELL,3,0.02h,Stop Loss,$-9.00,$-349.50,$93936.50,183,$-349.50
2024-09-12,08:49:00,19536.0,BUY,3,0.02h,Stop Loss,$6.00,$-343.50,$93942.50,183,$-343.50
2024-09-12,08:55:00,19301.5,SELL,3,0.02h,Stop Loss,$31.50,$-312.00,$93974.00,183,$-312.00
2024-09-12,08:58:00,19533.75,BUY,3,0.02h,Stop Loss,$-9.00,$-321.00,$93965.00,183,$-321.00
2024-09-12,08:59:00,19296.0,SELL,3,0.02h,Stop Loss,$-9.00,$-330.00,$93956.00,183,$-330.00
2024-09-12,09:09:00,19547.75,BUY,3,0.02h,Stop Loss,$9.00,$-321.00,$93965.00,183,$-321.00
2024-09-12,09:14:00,19318.25,SELL,3,0.02h,Stop Loss,$-9.00,$-330.00,$93956.00,183,$-330.00
2024-09-12,09:18:00,19556.5,BUY,3,0.02h,Stop Loss,$-9.00,$-339.00,$93947.00,183,$-339.00
2024-09-12,09:25:00,19324.0,SELL,3,0.02h,Stop Loss,$-9.00,$-348.00,$93938.00,183,$-348.00
2024-09-12,09:26:00,19554.25,BUY,3,0.02h,Stop Loss,$-9.00,$-357.00,$93929.00,183,$-357.00
2024-09-12,09:31:00,19323.25,SELL,3,0.02h,Break Even,$-1.50,$-358.50,$93927.50,183,$-358.50
2024-09-12,09:39:00,19551.5,BUY,3,0.02h,Stop Loss,$-9.00,$-367.50,$93918.50,183,$-367.50
2024-09-12,09:42:00,19316.25,SELL,3,0.02h,Stop Loss,$-9.00,$-376.50,$93909.50,183,$-376.50
2024-09-12,09:43:00,19549.5,BUY,3,0.02h,Stop Loss,$-9.00,$-385.50,$93900.50,183,$-385.50
2024-09-12,09:44:00,19316.25,SELL,3,0.02h,Stop Loss,$-9.00,$-394.50,$93891.50,183,$-394.50
2024-09-12,09:45:00,19542.5,BUY,3,0.02h,Stop Loss,$-9.00,$-403.50,$93882.50,183,$-403.50
2024-09-12,09:46:00,19308.0,SELL,3,0.02h,Stop Loss,$30.00,$-373.50,$93912.50,183,$-373.50
2024-09-12,09:48:00,19528.75,BUY,3,0.02h,Stop Loss,$-9.00,$-382.50,$93903.50,183,$-382.50
2024-09-12,09:49:00,19294.75,SELL,3,0.02h,Stop Loss,$-9.00,$-391.50,$93894.50,183,$-391.50
2024-09-12,09:50:00,19532.75,BUY,3,0.02h,Break Even,$-1.50,$-393.00,$93893.00,183,$-393.00
2024-09-12,09:58:00,19294.0,SELL,3,0.02h,Stop Loss,$-9.00,$-402.00,$93884.00,183,$-402.00
2024-09-12,10:03:00,19530.75,BUY,3,0.02h,Stop Loss,$-9.00,$-411.00,$93875.00,183,$-411.00
2024-09-12,10:05:00,19289.5,SELL,3,0.02h,Stop Loss,$-9.00,$-420.00,$93866.00,183,$-420.00
2024-09-12,10:06:00,19526.5,BUY,3,0.02h,Break Even,$-1.50,$-421.50,$93864.50,183,$-421.50
2024-09-12,10:14:00,19301.5,SELL,3,0.02h,Stop Loss,$10.50,$-411.00,$93875.00,183,$-411.00
2024-09-12,10:17:00,19523.5,BUY,3,0.02h,Stop Loss,$9.00,$-402.00,$93884.00,183,$-402.00
2024-09-12,10:20:00,19290.5,SELL,3,0.02h,Break Even,$-1.50,$-403.50,$93882.50,183,$-403.50
2024-09-12,10:24:00,19523.5,BUY,3,0.03h,Break Even,$-1.50,$-405.00,$93881.00,183,$-405.00
2024-09-12,10:26:00,19285.0,SELL,3,0.02h,Stop Loss,$-9.00,$-414.00,$93872.00,183,$-414.00
2024-09-12,10:27:00,19523.5,BUY,3,0.02h,Stop Loss,$-9.00,$-423.00,$93863.00,183,$-423.00
2024-09-12,10:34:00,19289.25,SELL,3,0.02h,Stop Loss,$-9.00,$-432.00,$93854.00,183,$-432.00
2024-09-12,10:36:00,19529.75,BUY,3,0.02h,Stop Loss,$12.00,$-420.00,$93866.00,183,$-420.00
2024-09-12,10:38:00,19301.25,SELL,3,0.02h,Stop Loss,$27.00,$-393.00,$93893.00,183,$-393.00
2024-09-12,10:46:00,19543.25,BUY,3,0.02h,Stop Loss,$-9.00,$-402.00,$93884.00,183,$-402.00
2024-09-12,10:52:00,19292.5,SELL,3,0.02h,Stop Loss,$-9.00,$-411.00,$93875.00,183,$-411.00
2024-09-12,10:53:00,19528.75,BUY,3,0.02h,Stop Loss,$25.50,$-385.50,$93900.50,183,$-385.50
2024-09-12,11:00:00,19288.25,SELL,3,0.02h,Stop Loss,$-9.00,$-394.50,$93891.50,183,$-394.50
2024-09-12,11:08:00,19513.25,BUY,3,0.02h,Stop Loss,$-9.00,$-403.50,$93882.50,183,$-403.50
2024-09-12,11:20:00,19282.5,SELL,3,0.02h,Break Even,$-1.50,$-405.00,$93881.00,183,$-405.00
2024-09-12,11:29:00,19516.5,BUY,3,0.02h,Break Even,$-1.50,$-406.50,$93879.50,183,$-406.50
2024-09-12,11:31:00,19276.25,SELL,3,0.02h,Break Even,$-1.50,$-408.00,$93878.00,183,$-408.00
2024-09-12,11:39:00,19520.5,BUY,3,0.02h,Stop Loss,$-9.00,$-417.00,$93869.00,183,$-417.00
2024-09-12,11:40:00,19282.0,SELL,3,0.02h,Stop Loss,$-9.00,$-426.00,$93860.00,183,$-426.00
2024-09-12,11:41:00,19521.0,BUY,3,0.02h,Stop Loss,$-9.00,$-435.00,$93851.00,183,$-435.00
2024-09-12,11:47:00,19285.25,SELL,3,0.02h,Break Even,$-1.50,$-436.50,$93849.50,183,$-436.50
2024-09-12,12:02:00,19537.75,BUY,3,0.02h,Stop Loss,$-9.00,$-445.50,$93840.50,183,$-445.50
2024-09-12,12:03:00,19303.0,SELL,3,0.02h,Stop Loss,$-9.00,$-454.50,$93831.50,183,$-454.50
2024-09-12,12:04:00,19533.5,BUY,3,0.02h,Break Even,$-1.50,$-456.00,$93830.00,183,$-456.00
2024-09-12,12:11:00,19300.75,SELL,3,0.02h,Break Even,$-1.50,$-457.50,$93828.50,183,$-457.50
2024-09-12,12:14:00,19536.0,BUY,3,0.02h,Stop Loss,$-9.00,$-466.50,$93819.50,183,$-466.50
2024-09-12,12:15:00,19300.5,SELL,3,0.02h,Stop Loss,$36.00,$-430.50,$93855.50,183,$-430.50
2024-09-12,12:18:00,19545.0,BUY,3,0.02h,Break Even,$-1.50,$-432.00,$93854.00,183,$-432.00
2024-09-12,12:21:00,19313.75,SELL,3,0.02h,Stop Loss,$-9.00,$-441.00,$93845.00,183,$-441.00
2024-09-12,12:22:00,19551.75,BUY,3,0.02h,Stop Loss,$-9.00,$-450.00,$93836.00,183,$-450.00
2024-09-12,12:28:00,19311.75,SELL,3,0.02h,Stop Loss,$-9.00,$-459.00,$93827.00,183,$-459.00
2024-09-12,12:29:00,19548.75,BUY,3,0.02h,Stop Loss,$-9.00,$-468.00,$93818.00,183,$-468.00
2024-09-12,12:30:00,19313.0,SELL,3,0.02h,Stop Loss,$228.00,$-240.00,$94046.00,183,$-240.00
2024-09-12,12:37:00,19508.0,BUY,3,0.02h,Break Even,$-1.50,$-241.50,$94044.50,183,$-241.50
2024-09-12,12:47:00,19281.5,SELL,3,0.02h,Stop Loss,$-9.00,$-250.50,$94035.50,183,$-250.50
2024-09-12,12:48:00,19517.5,BUY,3,0.02h,Break Even,$-1.50,$-252.00,$94034.00,183,$-252.00
2024-09-12,12:50:00,19276.25,SELL,3,0.02h,Stop Loss,$-9.00,$-261.00,$94025.00,183,$-261.00
2024-09-12,12:51:00,19502.25,BUY,3,0.02h,Break Even,$-1.50,$-262.50,$94023.50,183,$-262.50
2024-09-12,12:53:00,19268.75,SELL,3,0.02h,Stop Loss,$42.00,$-220.50,$94065.50,183,$-220.50
2024-09-12,12:57:00,19499.25,BUY,3,0.02h,Break Even,$-1.50,$-222.00,$94064.00,183,$-222.00
2024-09-12,13:00:00,19258.75,SELL,3,0.02h,Stop Loss,$-9.00,$-231.00,$94055.00,183,$-231.00
2024-09-12,13:01:00,19488.75,BUY,3,0.02h,Stop Loss,$-9.00,$-240.00,$94046.00,183,$-240.00
2024-09-12,13:02:00,19264.25,SELL,3,0.02h,Stop Loss,$6.00,$-234.00,$94052.00,183,$-234.00
2024-09-12,13:07:00,19511.0,BUY,3,0.02h,Stop Loss,$-9.00,$-243.00,$94043.00,183,$-243.00
2024-09-12,13:08:00,19279.0,SELL,3,0.02h,Stop Loss,$30.00,$-213.00,$94073.00,183,$-213.00
2024-09-12,13:17:00,19505.75,BUY,3,0.02h,Stop Loss,$7.50,$-205.50,$94080.50,183,$-205.50
2024-09-12,13:22:00,19263.75,SELL,3,0.02h,Break Even,$-1.50,$-207.00,$94079.00,183,$-207.00
2024-09-12,13:34:00,19504.75,BUY,3,0.02h,Stop Loss,$40.50,$-166.50,$94119.50,183,$-166.50
2024-09-12,13:41:00,19275.0,SELL,3,0.02h,Stop Loss,$135.00,$-31.50,$94254.50,183,$-31.50
2024-09-12,13:43:00,19512.75,BUY,3,0.02h,Stop Loss,$-9.00,$-40.50,$94245.50,183,$-40.50
2024-09-12,13:44:00,19265.5,SELL,3,0.02h,Stop Loss,$-9.00,$-49.50,$94236.50,183,$-49.50
2024-09-12,13:45:00,19503.5,BUY,3,0.02h,Stop Loss,$24.00,$-25.50,$94260.50,183,$-25.50
2024-09-12,13:48:00,19221.25,SELL,3,0.02h,Stop Loss,$-9.00,$-34.50,$94251.50,183,$-34.50
2024-09-12,13:49:00,19461.0,BUY,3,0.02h,Stop Loss,$43.50,$9.00,$94295.00,183,$9.00
2024-09-12,13:51:00,19190.5,SELL,3,0.02h,Stop Loss,$-9.00,$0.00,$94286.00,183,$0.00
2024-09-12,13:54:00,19477.75,BUY,3,0.02h,Stop Loss,$-9.00,$-9.00,$94277.00,183,$-9.00
2024-09-12,13:55:00,19261.5,SELL,3,0.02h,Stop Loss,$120.00,$111.00,$94397.00,183,$111.00
2024-09-12,14:03:00,19500.0,BUY,3,0.02h,Stop Loss,$-9.00,$102.00,$94388.00,183,$102.00
2024-09-12,14:04:00,19269.0,SELL,3,0.02h,Stop Loss,$-9.00,$93.00,$94379.00,183,$93.00
2024-09-12,14:05:00,19473.75,BUY,3,0.02h,Stop Loss,$-9.00,$84.00,$94370.00,183,$84.00
2024-09-12,14:06:00,19249.25,SELL,3,0.02h,Stop Loss,$-9.00,$75.00,$94361.00,183,$75.00
2024-09-12,14:07:00,19482.5,BUY,3,0.02h,Stop Loss,$-9.00,$66.00,$94352.00,183,$66.00
2024-09-12,14:08:00,19242.5,SELL,3,0.02h,Stop Loss,$111.00,$177.00,$94463.00,183,$177.00
2024-09-12,14:10:00,19481.75,BUY,3,0.02h,Stop Loss,$-9.00,$168.00,$94454.00,183,$168.00
2024-09-12,14:11:00,19255.0,SELL,3,0.02h,Stop Loss,$-9.00,$159.00,$94445.00,183,$159.00
2024-09-12,14:13:00,19532.0,BUY,3,0.02h,Stop Loss,$-9.00,$150.00,$94436.00,183,$150.00
2024-09-12,14:15:00,19311.0,SELL,3,0.02h,Stop Loss,$82.50,$232.50,$94518.50,183,$232.50
2024-09-12,14:18:00,19569.0,BUY,3,0.02h,Stop Loss,$-9.00,$223.50,$94509.50,183,$223.50
2024-09-12,14:37:00,19281.25,SELL,3,0.02h,Stop Loss,$-9.00,$214.50,$94500.50,183,$214.50
2024-09-12,14:38:00,19536.5,BUY,3,0.02h,Stop Loss,$78.00,$292.50,$94578.50,183,$292.50
2024-09-12,14:40:00,19298.5,SELL,3,0.02h,Stop Loss,$40.50,$333.00,$94619.00,183,$333.00
2024-09-12,14:43:00,19549.25,BUY,3,0.02h,Stop Loss,$37.50,$370.50,$94656.50,183,$370.50
2024-09-12,14:51:00,19307.5,SELL,3,0.02h,Stop Loss,$13.50,$384.00,$94670.00,183,$384.00
2024-09-12,14:56:00,19582.25,BUY,3,0.02h,Stop Loss,$-9.00,$375.00,$94661.00,183,$375.00
2024-09-12,14:57:00,19334.5,SELL,3,0.02h,Stop Loss,$237.00,$612.00,$94898.00,183,$612.00
2024-09-12,15:03:00,19535.75,BUY,3,0.02h,Stop Loss,$36.00,$648.00,$94934.00,183,$648.00
2024-09-12,15:09:00,19336.5,SELL,3,0.02h,Stop Loss,$-9.00,$639.00,$94925.00,183,$639.00
2024-09-12,15:10:00,19569.0,BUY,3,0.02h,Stop Loss,$9.00,$648.00,$94934.00,183,$648.00
2024-09-12,15:18:00,19329.75,SELL,3,0.02h,Stop Loss,$-9.00,$639.00,$94925.00,183,$639.00
2024-09-12,15:19:00,19561.0,BUY,3,0.02h,Stop Loss,$-9.00,$630.00,$94916.00,183,$630.00
2024-09-12,15:20:00,19336.75,SELL,3,0.02h,Stop Loss,$-9.00,$621.00,$94907.00,183,$621.00
2024-09-12,15:21:00,19565.25,BUY,3,0.02h,Stop Loss,$22.50,$643.50,$94929.50,183,$643.50
2024-09-12,15:24:00,19310.0,SELL,3,0.02h,Stop Loss,$33.00,$676.50,$94962.50,183,$676.50
2024-09-12,15:49:00,19495.0,BUY,3,0.02h,Stop Loss,$13.50,$690.00,$94976.00,183,$690.00
2024-09-12,15:59:00,19261.0,SELL,3,0.02h,Stop Loss,$31.50,$721.50,$95007.50,183,$721.50
2024-09-12,16:06:00,19521.25,BUY,3,0.02h,Stop Loss,$-9.00,$712.50,$94998.50,183,$712.50
2024-09-12,16:07:00,19298.25,SELL,3,0.02h,Stop Loss,$97.50,$810.00,$95096.00,183,$810.00
2024-09-12,16:09:00,19521.5,BUY,3,0.02h,Stop Loss,$-9.00,$801.00,$95087.00,183,$801.00
2024-09-12,16:10:00,19292.75,SELL,3,0.02h,Stop Loss,$6.00,$807.00,$95093.00,183,$807.00
2024-09-12,16:13:00,19535.75,BUY,3,0.02h,Stop Loss,$-9.00,$798.00,$95084.00,183,$798.00
2024-09-12,16:14:00,19291.5,SELL,3,0.02h,Stop Loss,$-9.00,$789.00,$95075.00,183,$789.00
2024-09-12,16:15:00,19539.0,BUY,3,0.02h,Stop Loss,$-9.00,$780.00,$95066.00,183,$780.00
2024-09-12,16:16:00,19301.0,SELL,3,0.02h,Stop Loss,$-9.00,$771.00,$95057.00,183,$771.00
2024-09-12,16:17:00,19539.0,BUY,3,0.02h,Stop Loss,$-9.00,$762.00,$95048.00,183,$762.00
2024-09-12,16:21:00,19299.5,SELL,3,0.02h,Stop Loss,$-9.00,$753.00,$95039.00,183,$753.00
2024-09-12,16:22:00,19545.75,BUY,3,0.02h,Stop Loss,$-9.00,$744.00,$95030.00,183,$744.00
2024-09-12,16:23:00,19310.5,SELL,3,0.02h,Stop Loss,$85.50,$829.50,$95115.50,183,$829.50
2024-09-12,16:25:00,19537.0,BUY,3,0.02h,Stop Loss,$-9.00,$820.50,$95106.50,183,$820.50
2024-09-12,16:26:00,19311.0,SELL,3,0.02h,Stop Loss,$-9.00,$811.50,$95097.50,183,$811.50
2024-09-12,16:30:00,19552.5,BUY,3,0.02h,Stop Loss,$-9.00,$802.50,$95088.50,183,$802.50
2024-09-12,16:31:00,19314.5,SELL,3,0.02h,Stop Loss,$19.50,$822.00,$95108.00,183,$822.00
2024-09-12,16:34:00,19550.25,BUY,3,0.02h,Stop Loss,$-9.00,$813.00,$95099.00,183,$813.00
2024-09-12,16:41:00,19289.25,SELL,3,0.02h,Stop Loss,$-9.00,$804.00,$95090.00,183,$804.00
2024-09-12,16:42:00,19539.25,BUY,3,0.02h,Stop Loss,$-9.00,$795.00,$95081.00,183,$795.00
2024-09-12,16:43:00,19308.25,SELL,3,0.02h,Stop Loss,$10.50,$805.50,$95091.50,183,$805.50
2024-09-12,16:49:00,19560.5,BUY,3,0.02h,Stop Loss,$-9.00,$796.50,$95082.50,183,$796.50
2024-09-12,16:50:00,19327.25,SELL,3,0.02h,Stop Loss,$-9.00,$787.50,$95073.50,183,$787.50
2024-09-12,16:54:00,19592.75,BUY,3,0.02h,Stop Loss,$-9.00,$778.50,$95064.50,183,$778.50
2024-09-12,16:56:00,19356.25,SELL,3,0.02h,Stop Loss,$-9.00,$769.50,$95055.50,183,$769.50
2024-09-12,16:57:00,19594.5,BUY,3,0.02h,Stop Loss,$-9.00,$760.50,$95046.50,183,$760.50
2024-09-12,17:11:00,19389.5,SELL,3,0.02h,Stop Loss,$33.00,$793.50,$95079.50,183,$793.50
2024-09-12,17:13:00,19623.25,BUY,3,0.02h,Stop Loss,$-9.00,$784.50,$95070.50,183,$784.50
2024-09-12,17:14:00,19391.0,SELL,3,0.02h,Stop Loss,$-9.00,$775.50,$95061.50,183,$775.50
2024-09-12,17:18:00,19635.25,BUY,3,0.02h,Stop Loss,$-9.00,$766.50,$95052.50,183,$766.50
2024-09-12,17:19:00,19395.5,SELL,3,0.02h,Break Even,$-1.50,$765.00,$95051.00,183,$765.00
2024-09-12,17:25:00,19648.25,BUY,3,0.02h,Break Even,$-1.50,$763.50,$95049.50,183,$763.50
2024-09-12,17:36:00,19410.5,SELL,3,0.02h,Stop Loss,$-9.00,$754.50,$95040.50,183,$754.50
2024-09-12,17:43:00,19659.75,BUY,3,0.02h,Stop Loss,$-9.00,$745.50,$95031.50,183,$745.50
2024-09-12,17:44:00,19420.0,SELL,3,0.02h,Break Even,$-1.50,$744.00,$95030.00,183,$744.00
2024-09-12,17:46:00,19664.5,BUY,3,0.02h,Stop Loss,$-9.00,$735.00,$95021.00,183,$735.00
2024-09-12,17:48:00,19427.5,SELL,3,0.02h,Stop Loss,$-9.00,$726.00,$95012.00,183,$726.00
2024-09-12,17:49:00,19666.75,BUY,3,0.02h,Stop Loss,$-9.00,$717.00,$95003.00,183,$717.00
2024-09-12,18:01:00,19462.0,SELL,3,0.02h,Stop Loss,$21.00,$738.00,$95024.00,183,$738.00
2024-09-12,18:08:00,19696.0,BUY,3,0.02h,Stop Loss,$-9.00,$729.00,$95015.00,183,$729.00
2024-09-12,18:09:00,19456.25,SELL,3,0.02h,Stop Loss,$67.50,$796.50,$95082.50,183,$796.50
2024-09-12,18:11:00,19676.75,BUY,3,0.02h,Stop Loss,$16.50,$813.00,$95099.00,183,$813.00
2024-09-12,18:18:00,19447.25,SELL,3,0.02h,Stop Loss,$-9.00,$804.00,$95090.00,183,$804.00
2024-09-12,18:19:00,19683.25,BUY,3,0.02h,Stop Loss,$13.50,$817.50,$95103.50,183,$817.50
2024-09-12,18:22:00,19464.5,SELL,3,0.02h,Stop Loss,$-9.00,$808.50,$95094.50,183,$808.50
2024-09-12,18:23:00,19704.5,BUY,3,0.02h,Stop Loss,$-9.00,$799.50,$95085.50,183,$799.50
2024-09-12,18:25:00,19470.25,SELL,3,0.02h,Stop Loss,$-9.00,$790.50,$95076.50,183,$790.50
2024-09-12,18:26:00,19709.5,BUY,3,0.02h,Stop Loss,$-9.00,$781.50,$95067.50,183,$781.50
2024-09-12,18:28:00,19471.0,SELL,3,0.02h,Stop Loss,$-9.00,$772.50,$95058.50,183,$772.50
2024-09-12,18:38:00,19710.25,BUY,3,0.02h,Break Even,$-1.50,$771.00,$95057.00,183,$771.00
2024-09-12,18:44:00,19465.0,SELL,3,0.02h,Break Even,$-1.50,$769.50,$95055.50,183,$769.50
2024-09-12,18:47:00,19701.5,BUY,3,0.02h,Stop Loss,$-9.00,$760.50,$95046.50,183,$760.50
2024-09-12,18:48:00,19474.25,SELL,3,0.02h,Stop Loss,$-9.00,$751.50,$95037.50,183,$751.50
2024-09-12,18:49:00,19695.5,BUY,3,0.02h,Stop Loss,$-9.00,$742.50,$95028.50,183,$742.50
2024-09-12,18:51:00,19450.75,SELL,3,0.02h,Stop Loss,$-9.00,$733.50,$95019.50,183,$733.50
2024-09-12,18:52:00,19616.5,BUY,3,0.02h,Stop Loss,$24.00,$757.50,$95043.50,183,$757.50
2024-09-12,19:01:00,19447.5,SELL,3,0.02h,Stop Loss,$-9.00,$748.50,$95034.50,183,$748.50
2024-09-12,19:02:00,19682.25,BUY,3,0.02h,Stop Loss,$-9.00,$739.50,$95025.50,183,$739.50
2024-09-12,19:03:00,19453.5,SELL,3,0.02h,Stop Loss,$-9.00,$730.50,$95016.50,183,$730.50
2024-09-12,19:04:00,19677.0,BUY,3,0.02h,Stop Loss,$6.00,$736.50,$95022.50,183,$736.50
2024-09-12,19:12:00,19451.0,SELL,3,0.02h,Break Even,$-1.50,$735.00,$95021.00,183,$735.00
2024-09-12,19:15:00,19685.0,BUY,3,0.02h,Stop Loss,$-9.00,$726.00,$95012.00,183,$726.00
2024-09-12,19:16:00,19456.0,SELL,3,0.02h,Stop Loss,$42.00,$768.00,$95054.00,183,$768.00
2024-09-12,19:19:00,19685.0,BUY,3,0.02h,Stop Loss,$-9.00,$759.00,$95045.00,183,$759.00
2024-09-12,19:20:00,19462.0,SELL,3,0.02h,Stop Loss,$52.50,$811.50,$95097.50,183,$811.50
2024-09-12,19:23:00,19681.5,BUY,3,0.02h,Stop Loss,$-9.00,$802.50,$95088.50,183,$802.50
2024-09-12,19:24:00,19451.5,SELL,3,0.02h,Stop Loss,$-9.00,$793.50,$95079.50,183,$793.50
2024-09-12,19:25:00,19684.75,BUY,3,0.02h,Stop Loss,$13.50,$807.00,$95093.00,183,$807.00
2024-09-12,19:27:00,19445.25,SELL,3,0.02h,Stop Loss,$-9.00,$798.00,$95084.00,183,$798.00
2024-09-12,19:28:00,19673.75,BUY,3,0.02h,Stop Loss,$-9.00,$789.00,$95075.00,183,$789.00
2024-09-12,19:35:00,19445.0,SELL,3,0.02h,Break Even,$-1.50,$787.50,$95073.50,183,$787.50
2024-09-12,19:38:00,19681.25,BUY,3,0.02h,Stop Loss,$13.50,$801.00,$95087.00,183,$801.00
2024-09-12,19:44:00,19460.25,SELL,3,0.02h,Stop Loss,$-9.00,$792.00,$95078.00,183,$792.00
2024-09-12,19:45:00,19690.0,BUY,3,0.02h,Stop Loss,$-9.00,$783.00,$95069.00,183,$783.00
2024-09-12,19:46:00,19449.0,SELL,3,0.02h,Stop Loss,$-9.00,$774.00,$95060.00,183,$774.00
2024-09-12,19:48:00,19670.5,BUY,3,0.02h,Stop Loss,$3.00,$777.00,$95063.00,183,$777.00
2024-09-12,19:51:00,19438.5,SELL,3,0.02h,Stop Loss,$-9.00,$768.00,$95054.00,183,$768.00
2024-09-12,19:52:00,19674.25,BUY,3,0.02h,Stop Loss,$-9.00,$759.00,$95045.00,183,$759.00
2024-09-12,19:53:00,19431.0,SELL,3,0.02h,Stop Loss,$-9.00,$750.00,$95036.00,183,$750.00
2024-09-12,19:55:00,19651.0,BUY,3,0.02h,Stop Loss,$99.00,$849.00,$95135.00,183,$849.00
2024-09-12,19:58:00,19431.0,SELL,3,0.02h,Break Even,$-1.50,$847.50,$95133.50,183,$847.50
2024-09-12,20:12:00,19642.5,BUY,3,0.02h,Stop Loss,$-9.00,$838.50,$95124.50,183,$838.50
2024-09-12,20:13:00,19418.25,SELL,3,0.02h,Stop Loss,$7.50,$846.00,$95132.00,183,$846.00
2024-09-12,20:18:00,19650.25,BUY,3,0.02h,Stop Loss,$-9.00,$837.00,$95123.00,183,$837.00
2024-09-12,20:19:00,19412.0,SELL,3,0.02h,Stop Loss,$-9.00,$828.00,$95114.00,183,$828.00
2024-09-12,20:20:00,19656.0,BUY,3,0.02h,Stop Loss,$-9.00,$819.00,$95105.00,183,$819.00
2024-09-12,20:28:00,19431.5,SELL,3,0.02h,Stop Loss,$-9.00,$810.00,$95096.00,183,$810.00
2024-09-12,20:30:00,19671.25,BUY,3,0.02h,Break Even,$-1.50,$808.50,$95094.50,183,$808.50
2024-09-12,20:36:00,19422.0,SELL,3,0.02h,Stop Loss,$-9.00,$799.50,$95085.50,183,$799.50
2024-09-12,20:48:00,19652.0,BUY,3,0.02h,Stop Loss,$-9.00,$790.50,$95076.50,183,$790.50
2024-09-12,20:52:00,19417.0,SELL,3,0.02h,Stop Loss,$-9.00,$781.50,$95067.50,183,$781.50
2024-09-12,23:03:00,19681.0,BUY,3,0.02h,Stop Loss,$-9.00,$772.50,$95058.50,183,$772.50
2024-09-12,23:17:00,19452.75,SELL,3,0.02h,Stop Loss,$13.50,$786.00,$95072.00,183,$786.00
2024-09-12,23:36:00,19688.5,BUY,3,0.02h,Stop Loss,$-9.00,$777.00,$95063.00,183,$777.00
2024-09-12,23:51:00,19461.25,SELL,3,0.02h,Stop Loss,$-9.00,$768.00,$95054.00,183,$768.00
2024-09-12,23:52:00,19694.0,BUY,3,0.02h,Stop Loss,$-9.00,$759.00,$95045.00,183,$759.00
2024-09-12,23:53:00,19458.0,SELL,3,0.02h,Stop Loss,$-9.00,$750.00,$95036.00,183,$750.00
2024-09-12,23:54:00,19690.25,BUY,3,0.02h,Stop Loss,$-9.00,$741.00,$95027.00,183,$741.00
2024-09-12,23:55:00,19452.0,SELL,3,0.02h,Stop Loss,$3.00,$744.00,$95030.00,183,$744.00
2024-09-12,23:59:00,19687.25,BUY,3,0.03h,Stop Loss,$-9.00,$735.00,$95021.00,183,$735.00
,,,,,,,,,,,
2024-09-13,00:02:00,19451.25,SELL,3,0.02h,Stop Loss,$-9.00,$-9.00,$95012.00,184,$-9.00
2024-09-13,00:03:00,19690.25,BUY,3,0.02h,Stop Loss,$-9.00,$-18.00,$95003.00,184,$-18.00
2024-09-13,00:05:00,19449.0,SELL,3,0.02h,Stop Loss,$-9.00,$-27.00,$94994.00,184,$-27.00
2024-09-13,00:06:00,19686.0,BUY,3,0.03h,Break Even,$-1.50,$-28.50,$94992.50,184,$-28.50
2024-09-13,00:09:00,19452.25,SELL,3,0.02h,Stop Loss,$-9.00,$-37.50,$94983.50,184,$-37.50
2024-09-13,00:14:00,19697.75,BUY,3,0.02h,Stop Loss,$-9.00,$-46.50,$94974.50,184,$-46.50
2024-09-13,00:17:00,19465.25,SELL,3,0.02h,Break Even,$-1.50,$-48.00,$94973.00,184,$-48.00
2024-09-13,00:24:00,19688.0,BUY,3,0.02h,Break Even,$-1.50,$-49.50,$94971.50,184,$-49.50
2024-09-13,00:35:00,19466.0,SELL,3,0.02h,Stop Loss,$-9.00,$-58.50,$94962.50,184,$-58.50
2024-09-13,00:36:00,19700.0,BUY,3,0.02h,Stop Loss,$-9.00,$-67.50,$94953.50,184,$-67.50
2024-09-13,00:37:00,19469.25,SELL,3,0.02h,Stop Loss,$-9.00,$-76.50,$94944.50,184,$-76.50
2024-09-13,00:38:00,19704.0,BUY,3,0.02h,Break Even,$-1.50,$-78.00,$94943.00,184,$-78.00
2024-09-13,00:46:00,19465.0,SELL,3,0.02h,Stop Loss,$-9.00,$-87.00,$94934.00,184,$-87.00
2024-09-13,00:47:00,19699.25,BUY,3,0.02h,Break Even,$-1.50,$-88.50,$94932.50,184,$-88.50
2024-09-13,00:49:00,19467.5,SELL,3,0.02h,Stop Loss,$-9.00,$-97.50,$94923.50,184,$-97.50
2024-09-13,00:59:00,19691.0,BUY,3,0.02h,Stop Loss,$-9.00,$-106.50,$94914.50,184,$-106.50
2024-09-13,01:01:00,19455.75,SELL,3,0.02h,Break Even,$-1.50,$-108.00,$94913.00,184,$-108.00
2024-09-13,01:08:00,19685.25,BUY,3,0.02h,Stop Loss,$-9.00,$-117.00,$94904.00,184,$-117.00
2024-09-13,01:09:00,19452.25,SELL,3,0.02h,Stop Loss,$6.00,$-111.00,$94910.00,184,$-111.00
2024-09-13,01:21:00,19674.75,BUY,3,0.02h,Stop Loss,$-9.00,$-120.00,$94901.00,184,$-120.00
2024-09-13,01:22:00,19436.5,SELL,3,0.02h,Stop Loss,$-9.00,$-129.00,$94892.00,184,$-129.00
2024-09-13,01:28:00,19676.5,BUY,3,0.03h,Stop Loss,$9.00,$-120.00,$94901.00,184,$-120.00
2024-09-13,01:36:00,19448.75,SELL,3,0.02h,Stop Loss,$-9.00,$-129.00,$94892.00,184,$-129.00
2024-09-13,01:37:00,19681.5,BUY,3,0.02h,Break Even,$-1.50,$-130.50,$94890.50,184,$-130.50
2024-09-13,01:42:00,19451.75,SELL,3,0.02h,Break Even,$-1.50,$-132.00,$94889.00,184,$-132.00
2024-09-13,01:49:00,19679.0,BUY,3,0.02h,Stop Loss,$-9.00,$-141.00,$94880.00,184,$-141.00
2024-09-13,01:55:00,19451.0,SELL,3,0.02h,Stop Loss,$-9.00,$-150.00,$94871.00,184,$-150.00
2024-09-13,01:56:00,19684.0,BUY,3,0.03h,Break Even,$-1.50,$-151.50,$94869.50,184,$-151.50
2024-09-13,02:04:00,19441.75,SELL,3,0.02h,Stop Loss,$-9.00,$-160.50,$94860.50,184,$-160.50
2024-09-13,02:06:00,19676.75,BUY,3,0.02h,Stop Loss,$-9.00,$-169.50,$94851.50,184,$-169.50
2024-09-13,02:07:00,19441.75,SELL,3,0.03h,Break Even,$-1.50,$-171.00,$94850.00,184,$-171.00
2024-09-13,02:16:00,19676.0,BUY,3,0.02h,Stop Loss,$-9.00,$-180.00,$94841.00,184,$-180.00
2024-09-13,02:17:00,19438.25,SELL,3,0.02h,Stop Loss,$19.50,$-160.50,$94860.50,184,$-160.50
2024-09-13,02:26:00,19674.25,BUY,3,0.03h,Stop Loss,$-9.00,$-169.50,$94851.50,184,$-169.50
2024-09-13,02:31:00,19438.25,SELL,3,0.02h,Stop Loss,$-9.00,$-178.50,$94842.50,184,$-178.50
2024-09-13,02:32:00,19671.75,BUY,3,0.02h,Stop Loss,$-9.00,$-187.50,$94833.50,184,$-187.50
2024-09-13,02:40:00,19431.25,SELL,3,0.02h,Stop Loss,$3.00,$-184.50,$94836.50,184,$-184.50
2024-09-13,02:48:00,19661.25,BUY,3,0.02h,Stop Loss,$-9.00,$-193.50,$94827.50,184,$-193.50
2024-09-13,02:49:00,19426.75,SELL,3,0.02h,Stop Loss,$-9.00,$-202.50,$94818.50,184,$-202.50
2024-09-13,02:50:00,19661.25,BUY,3,0.02h,Stop Loss,$-9.00,$-211.50,$94809.50,184,$-211.50
2024-09-13,02:55:00,19426.25,SELL,3,0.02h,Break Even,$-1.50,$-213.00,$94808.00,184,$-213.00
2024-09-13,03:01:00,19660.0,BUY,3,0.03h,Stop Loss,$3.00,$-210.00,$94811.00,184,$-210.00
2024-09-13,03:12:00,19439.5,SELL,3,0.02h,Stop Loss,$-9.00,$-219.00,$94802.00,184,$-219.00
2024-09-13,03:15:00,19671.75,BUY,3,0.02h,Break Even,$-1.50,$-220.50,$94800.50,184,$-220.50
2024-09-13,03:20:00,19442.5,SELL,3,0.02h,Break Even,$-1.50,$-222.00,$94799.00,184,$-222.00
2024-09-13,03:29:00,19681.75,BUY,3,0.02h,Stop Loss,$-9.00,$-231.00,$94790.00,184,$-231.00
2024-09-13,03:30:00,19444.5,SELL,3,0.02h,Stop Loss,$-9.00,$-240.00,$94781.00,184,$-240.00
2024-09-13,03:31:00,19678.0,BUY,3,0.02h,Stop Loss,$-9.00,$-249.00,$94772.00,184,$-249.00
2024-09-13,03:37:00,19449.0,SELL,3,0.02h,Stop Loss,$-9.00,$-258.00,$94763.00,184,$-258.00
2024-09-13,03:38:00,19680.75,BUY,3,0.02h,Stop Loss,$-9.00,$-267.00,$94754.00,184,$-267.00
2024-09-13,03:39:00,19448.5,SELL,3,0.02h,Stop Loss,$-9.00,$-276.00,$94745.00,184,$-276.00
2024-09-13,03:45:00,19682.75,BUY,3,0.02h,Stop Loss,$-9.00,$-285.00,$94736.00,184,$-285.00
2024-09-13,03:46:00,19449.0,SELL,3,0.02h,Break Even,$-1.50,$-286.50,$94734.50,184,$-286.50
2024-09-13,03:52:00,19685.5,BUY,3,0.02h,Stop Loss,$-9.00,$-295.50,$94725.50,184,$-295.50
2024-09-13,03:53:00,19449.5,SELL,3,0.02h,Break Even,$-1.50,$-297.00,$94724.00,184,$-297.00
2024-09-13,03:59:00,19684.75,BUY,3,0.02h,Stop Loss,$-9.00,$-306.00,$94715.00,184,$-306.00
2024-09-13,04:00:00,19450.75,SELL,3,0.02h,Stop Loss,$-9.00,$-315.00,$94706.00,184,$-315.00
2024-09-13,04:01:00,19684.25,BUY,3,0.02h,Stop Loss,$-9.00,$-324.00,$94697.00,184,$-324.00
2024-09-13,04:05:00,19448.75,SELL,3,0.02h,Break Even,$-1.50,$-325.50,$94695.50,184,$-325.50
2024-09-13,04:07:00,19679.25,BUY,3,0.03h,Stop Loss,$-9.00,$-334.50,$94686.50,184,$-334.50
2024-09-13,04:17:00,19447.75,SELL,3,0.02h,Stop Loss,$-9.00,$-343.50,$94677.50,184,$-343.50
2024-09-13,04:18:00,19683.0,BUY,3,0.02h,Stop Loss,$-9.00,$-352.50,$94668.50,184,$-352.50
2024-09-13,04:19:00,19447.25,SELL,3,0.02h,Stop Loss,$-9.00,$-361.50,$94659.50,184,$-361.50
2024-09-13,04:20:00,19683.0,BUY,3,0.02h,Stop Loss,$-9.00,$-370.50,$94650.50,184,$-370.50
2024-09-13,04:21:00,19448.0,SELL,3,0.02h,Stop Loss,$-9.00,$-379.50,$94641.50,184,$-379.50
2024-09-13,04:22:00,19681.75,BUY,3,0.02h,Stop Loss,$-9.00,$-388.50,$94632.50,184,$-388.50
2024-09-13,04:29:00,19443.5,SELL,3,0.02h,Stop Loss,$-9.00,$-397.50,$94623.50,184,$-397.50
2024-09-13,04:36:00,19675.75,BUY,3,0.03h,Break Even,$-1.50,$-399.00,$94622.00,184,$-399.00
2024-09-13,04:39:00,19446.75,SELL,3,0.02h,Break Even,$-1.50,$-400.50,$94620.50,184,$-400.50
2024-09-13,04:55:00,19684.75,BUY,3,0.05h,Stop Loss,$-9.00,$-409.50,$94611.50,184,$-409.50
2024-09-13,05:01:00,19448.0,SELL,3,0.02h,Stop Loss,$-9.00,$-418.50,$94602.50,184,$-418.50
2024-09-13,05:02:00,19682.0,BUY,3,0.02h,Break Even,$-1.50,$-420.00,$94601.00,184,$-420.00
2024-09-13,05:13:00,19462.5,SELL,3,0.02h,Stop Loss,$-9.00,$-429.00,$94592.00,184,$-429.00
2024-09-13,05:18:00,19696.75,BUY,3,0.03h,Break Even,$-1.50,$-430.50,$94590.50,184,$-430.50
2024-09-13,05:33:00,19468.75,SELL,3,0.02h,Stop Loss,$-9.00,$-439.50,$94581.50,184,$-439.50
2024-09-13,05:34:00,19705.75,BUY,3,0.02h,Stop Loss,$-9.00,$-448.50,$94572.50,184,$-448.50
2024-09-13,05:35:00,19470.0,SELL,3,0.02h,Stop Loss,$-9.00,$-457.50,$94563.50,184,$-457.50
2024-09-13,05:41:00,19705.5,BUY,3,0.02h,Stop Loss,$-9.00,$-466.50,$94554.50,184,$-466.50
2024-09-13,05:42:00,19475.75,SELL,3,0.02h,Stop Loss,$-9.00,$-475.50,$94545.50,184,$-475.50
2024-09-13,05:43:00,19713.0,BUY,3,0.02h,Stop Loss,$-9.00,$-484.50,$94536.50,184,$-484.50
2024-09-13,05:44:00,19478.5,SELL,3,0.02h,Break Even,$-1.50,$-486.00,$94535.00,184,$-486.00
2024-09-13,05:47:00,19709.75,BUY,3,0.02h,Stop Loss,$-9.00,$-495.00,$94526.00,184,$-495.00
2024-09-13,05:48:00,19476.75,SELL,3,0.02h,Stop Loss,$3.00,$-492.00,$94529.00,184,$-492.00
2024-09-13,06:03:00,19686.0,BUY,3,0.02h,Stop Loss,$-9.00,$-501.00,$94520.00,184,$-501.00
2024-09-13,06:14:00,19435.25,SELL,3,0.02h,Break Even,$-1.50,$-502.50,$94518.50,184,$-502.50
2024-09-13,06:24:00,19673.0,BUY,3,0.03h,Break Even,$-1.50,$-504.00,$94517.00,184,$-504.00
2024-09-13,06:33:00,19436.75,SELL,3,0.02h,Stop Loss,$-9.00,$-513.00,$94508.00,184,$-513.00
2024-09-13,06:34:00,19672.75,BUY,3,0.08h,Break Even,$-1.50,$-514.50,$94506.50,184,$-514.50
2024-09-13,06:47:00,19444.0,SELL,3,0.02h,Stop Loss,$-9.00,$-523.50,$94497.50,184,$-523.50
2024-09-13,06:48:00,19678.25,BUY,3,0.03h,Stop Loss,$-9.00,$-532.50,$94488.50,184,$-532.50
2024-09-13,06:50:00,19443.25,SELL,3,0.02h,Stop Loss,$-9.00,$-541.50,$94479.50,184,$-541.50
2024-09-13,06:52:00,19676.25,BUY,3,0.02h,Stop Loss,$-9.00,$-550.50,$94470.50,184,$-550.50
2024-09-13,06:53:00,19442.0,SELL,3,0.02h,Break Even,$-1.50,$-552.00,$94469.00,184,$-552.00
2024-09-13,07:05:00,19686.75,BUY,3,0.02h,Stop Loss,$-9.00,$-561.00,$94460.00,184,$-561.00
2024-09-13,07:06:00,19451.0,SELL,3,0.02h,Stop Loss,$-9.00,$-570.00,$94451.00,184,$-570.00
2024-09-13,07:09:00,19691.25,BUY,3,0.02h,Stop Loss,$-9.00,$-579.00,$94442.00,184,$-579.00
2024-09-13,07:10:00,19458.0,SELL,3,0.02h,Stop Loss,$-9.00,$-588.00,$94433.00,184,$-588.00
2024-09-13,07:11:00,19690.5,BUY,3,0.02h,Stop Loss,$-9.00,$-597.00,$94424.00,184,$-597.00
2024-09-13,07:20:00,19455.0,SELL,3,0.02h,Stop Loss,$-9.00,$-606.00,$94415.00,184,$-606.00
2024-09-13,07:22:00,19689.0,BUY,3,0.02h,Stop Loss,$-9.00,$-615.00,$94406.00,184,$-615.00
2024-09-13,07:23:00,19452.75,SELL,3,0.02h,Stop Loss,$-9.00,$-624.00,$94397.00,184,$-624.00
2024-09-13,07:24:00,19697.25,BUY,3,0.02h,Stop Loss,$-9.00,$-633.00,$94388.00,184,$-633.00
2024-09-13,07:25:00,19465.25,SELL,3,0.02h,Stop Loss,$-9.00,$-642.00,$94379.00,184,$-642.00
2024-09-13,07:26:00,19697.5,BUY,3,0.02h,Stop Loss,$-9.00,$-651.00,$94370.00,184,$-651.00
2024-09-13,07:27:00,19470.0,SELL,3,0.02h,Stop Loss,$-9.00,$-660.00,$94361.00,184,$-660.00
2024-09-13,07:28:00,19702.0,BUY,3,0.02h,Stop Loss,$-9.00,$-669.00,$94352.00,184,$-669.00
2024-09-13,07:30:00,19471.0,SELL,3,0.02h,Stop Loss,$-9.00,$-678.00,$94343.00,184,$-678.00
2024-09-13,07:31:00,19705.75,BUY,3,0.02h,Stop Loss,$-9.00,$-687.00,$94334.00,184,$-687.00
2024-09-13,07:35:00,19456.25,SELL,3,0.02h,Stop Loss,$-9.00,$-696.00,$94325.00,184,$-696.00
2024-09-13,07:43:00,19695.5,BUY,3,0.02h,Stop Loss,$-9.00,$-705.00,$94316.00,184,$-705.00
2024-09-13,07:48:00,19448.5,SELL,3,0.02h,Stop Loss,$10.50,$-694.50,$94326.50,184,$-694.50
2024-09-13,07:52:00,19681.5,BUY,3,0.02h,Break Even,$-1.50,$-696.00,$94325.00,184,$-696.00
2024-09-13,07:57:00,19441.25,SELL,3,0.02h,Stop Loss,$-9.00,$-705.00,$94316.00,184,$-705.00
2024-09-13,07:58:00,19674.25,BUY,3,0.02h,Stop Loss,$-9.00,$-714.00,$94307.00,184,$-714.00
2024-09-13,07:59:00,19436.5,SELL,3,0.02h,Stop Loss,$-9.00,$-723.00,$94298.00,184,$-723.00
2024-09-13,08:00:00,19670.75,BUY,3,0.02h,Break Even,$-1.50,$-724.50,$94296.50,184,$-724.50
2024-09-13,08:02:00,19427.0,SELL,3,0.02h,Break Even,$-1.50,$-726.00,$94295.00,184,$-726.00
2024-09-13,08:06:00,19666.0,BUY,3,0.02h,Stop Loss,$-9.00,$-735.00,$94286.00,184,$-735.00
2024-09-13,08:07:00,19437.5,SELL,3,0.02h,Break Even,$-1.50,$-736.50,$94284.50,184,$-736.50
2024-09-13,08:13:00,19685.0,BUY,3,0.03h,Break Even,$-1.50,$-738.00,$94283.00,184,$-738.00
2024-09-13,08:20:00,19449.5,SELL,3,0.02h,Stop Loss,$-9.00,$-747.00,$94274.00,184,$-747.00
2024-09-13,08:26:00,19681.75,BUY,3,0.02h,Stop Loss,$-9.00,$-756.00,$94265.00,184,$-756.00
2024-09-13,08:27:00,19452.5,SELL,3,0.02h,Stop Loss,$-9.00,$-765.00,$94256.00,184,$-765.00
2024-09-13,08:28:00,19680.25,BUY,3,0.02h,Stop Loss,$-9.00,$-774.00,$94247.00,184,$-774.00
2024-09-13,08:35:00,19441.5,SELL,3,0.02h,Stop Loss,$-9.00,$-783.00,$94238.00,184,$-783.00
2024-09-13,08:36:00,19677.75,BUY,3,0.02h,Break Even,$-1.50,$-784.50,$94236.50,184,$-784.50
2024-09-13,08:39:00,19445.25,SELL,3,0.02h,Stop Loss,$-9.00,$-793.50,$94227.50,184,$-793.50
2024-09-13,08:50:00,19700.75,BUY,3,0.02h,Stop Loss,$-9.00,$-802.50,$94218.50,184,$-802.50
2024-09-13,08:51:00,19463.0,SELL,3,0.02h,Break Even,$-1.50,$-804.00,$94217.00,184,$-804.00
2024-09-13,08:53:00,19690.75,BUY,3,0.02h,Stop Loss,$-9.00,$-813.00,$94208.00,184,$-813.00
2024-09-13,09:01:00,19455.75,SELL,3,0.02h,Stop Loss,$-9.00,$-822.00,$94199.00,184,$-822.00
2024-09-13,09:02:00,19695.25,BUY,3,0.02h,Stop Loss,$-9.00,$-831.00,$94190.00,184,$-831.00
2024-09-13,09:03:00,19454.75,SELL,3,0.02h,Stop Loss,$-9.00,$-840.00,$94181.00,184,$-840.00
2024-09-13,09:04:00,19685.25,BUY,3,0.02h,Stop Loss,$-9.00,$-849.00,$94172.00,184,$-849.00
2024-09-13,09:05:00,19452.75,SELL,3,0.02h,Stop Loss,$-9.00,$-858.00,$94163.00,184,$-858.00
2024-09-13,09:07:00,19703.0,BUY,3,0.02h,Stop Loss,$-9.00,$-867.00,$94154.00,184,$-867.00
2024-09-13,09:10:00,19461.75,SELL,3,0.02h,Stop Loss,$-9.00,$-876.00,$94145.00,184,$-876.00
2024-09-13,09:14:00,19702.75,BUY,3,0.02h,Break Even,$-1.50,$-877.50,$94143.50,184,$-877.50
2024-09-13,09:20:00,19461.0,SELL,3,0.02h,Break Even,$-1.50,$-879.00,$94142.00,184,$-879.00
2024-09-13,09:22:00,19701.5,BUY,3,0.02h,Break Even,$-1.50,$-880.50,$94140.50,184,$-880.50
2024-09-13,09:44:00,19468.75,SELL,3,0.02h,Stop Loss,$-9.00,$-889.50,$94131.50,184,$-889.50
2024-09-13,09:45:00,19706.5,BUY,3,0.02h,Stop Loss,$-9.00,$-898.50,$94122.50,184,$-898.50
2024-09-13,09:46:00,19468.0,SELL,3,0.02h,Stop Loss,$-9.00,$-907.50,$94113.50,184,$-907.50
2024-09-13,09:58:00,19699.5,BUY,3,0.02h,Break Even,$-1.50,$-909.00,$94112.00,184,$-909.00
2024-09-13,10:00:00,19462.5,SELL,3,0.02h,Stop Loss,$36.00,$-873.00,$94148.00,184,$-873.00
2024-09-13,10:02:00,19699.25,BUY,3,0.02h,Round Number,$1.50,$-871.50,$94149.50,184,$-871.50
2024-09-13,10:06:00,19464.75,SELL,3,0.02h,Stop Loss,$-9.00,$-880.50,$94140.50,184,$-880.50
2024-09-13,10:10:00,19708.25,BUY,3,0.02h,Stop Loss,$-9.00,$-889.50,$94131.50,184,$-889.50
2024-09-13,10:12:00,19468.75,SELL,3,0.02h,Break Even,$-1.50,$-891.00,$94130.00,184,$-891.00
2024-09-13,10:17:00,19699.0,BUY,3,0.02h,Stop Loss,$-9.00,$-900.00,$94121.00,184,$-900.00
2024-09-13,10:18:00,19466.0,SELL,3,0.02h,Stop Loss,$-9.00,$-909.00,$94112.00,184,$-909.00
2024-09-13,10:19:00,19699.5,BUY,3,0.02h,Stop Loss,$-9.00,$-918.00,$94103.00,184,$-918.00
2024-09-13,10:20:00,19460.5,SELL,3,0.02h,Break Even,$-1.50,$-919.50,$94101.50,184,$-919.50
2024-09-13,10:30:00,19705.75,BUY,3,0.03h,Stop Loss,$-9.00,$-928.50,$94092.50,184,$-928.50
2024-09-13,10:33:00,19466.25,SELL,3,0.02h,Stop Loss,$-9.00,$-937.50,$94083.50,184,$-937.50
2024-09-13,10:35:00,19708.0,BUY,3,0.02h,Stop Loss,$-9.00,$-946.50,$94074.50,184,$-946.50
2024-09-13,10:36:00,19465.5,SELL,3,0.02h,Break Even,$-1.50,$-948.00,$94073.00,184,$-948.00
2024-09-13,10:54:00,19701.25,BUY,3,0.02h,Stop Loss,$7.50,$-940.50,$94080.50,184,$-940.50
2024-09-13,11:10:00,19451.25,SELL,3,0.02h,Stop Loss,$-9.00,$-949.50,$94071.50,184,$-949.50
2024-09-13,11:16:00,19690.25,BUY,3,0.02h,Stop Loss,$-9.00,$-958.50,$94062.50,184,$-958.50
2024-09-13,11:17:00,19447.0,SELL,3,0.03h,Stop Loss,$-9.00,$-967.50,$94053.50,184,$-967.50
2024-09-13,11:22:00,19692.5,BUY,3,0.03h,Break Even,$-1.50,$-969.00,$94052.00,184,$-969.00
2024-09-13,11:30:00,19460.75,SELL,3,0.02h,Break Even,$-1.50,$-970.50,$94050.50,184,$-970.50
2024-09-13,11:35:00,19698.0,BUY,3,0.02h,Stop Loss,$-9.00,$-979.50,$94041.50,184,$-979.50
2024-09-13,11:42:00,19449.0,SELL,3,0.02h,Break Even,$-1.50,$-981.00,$94040.00,184,$-981.00
2024-09-13,11:53:00,19695.5,BUY,3,0.02h,Break Even,$-1.50,$-982.50,$94038.50,184,$-982.50
2024-09-13,11:57:00,19451.0,SELL,3,0.02h,Stop Loss,$-9.00,$-991.50,$94029.50,184,$-991.50
2024-09-13,11:58:00,19691.75,BUY,3,0.02h,Stop Loss,$-9.00,$-1000.50,$94020.50,184,$-1000.50
2024-09-13,11:59:00,19451.75,SELL,3,0.02h,Stop Loss,$-9.00,$-1009.50,$94011.50,184,$-1009.50
2024-09-13,12:03:00,19696.0,BUY,3,0.02h,Stop Loss,$3.00,$-1006.50,$94014.50,184,$-1006.50
2024-09-13,12:08:00,19455.0,SELL,3,0.02h,Stop Loss,$12.00,$-994.50,$94026.50,184,$-994.50
2024-09-13,12:14:00,19694.0,BUY,3,0.02h,Stop Loss,$-9.00,$-1003.50,$94017.50,184,$-1003.50
2024-09-13,12:15:00,19456.25,SELL,3,0.02h,Stop Loss,$-9.00,$-1012.50,$94008.50,184,$-1012.50
2024-09-13,12:17:00,19699.5,BUY,3,0.02h,Stop Loss,$-9.00,$-1021.50,$93999.50,184,$-1021.50
2024-09-13,12:22:00,19462.75,SELL,3,0.02h,Stop Loss,$-9.00,$-1030.50,$93990.50,184,$-1030.50
2024-09-13,12:23:00,19696.25,BUY,3,0.02h,Stop Loss,$-9.00,$-1039.50,$93981.50,184,$-1039.50
2024-09-13,12:27:00,19453.75,SELL,3,0.02h,Stop Loss,$-9.00,$-1048.50,$93972.50,184,$-1048.50
2024-09-13,12:28:00,19689.5,BUY,3,0.02h,Stop Loss,$-9.00,$-1057.50,$93963.50,184,$-1057.50
2024-09-13,12:29:00,19453.5,SELL,3,0.02h,Break Even,$-1.50,$-1059.00,$93962.00,184,$-1059.00
2024-09-13,12:32:00,19686.75,BUY,3,0.02h,Stop Loss,$3.00,$-1056.00,$93965.00,184,$-1056.00
2024-09-13,12:34:00,19450.5,SELL,3,0.02h,Stop Loss,$-9.00,$-1065.00,$93956.00,184,$-1065.00
2024-09-13,12:35:00,19686.25,BUY,3,0.02h,Stop Loss,$-9.00,$-1074.00,$93947.00,184,$-1074.00
2024-09-13,12:36:00,19448.25,SELL,3,0.02h,Stop Loss,$9.00,$-1065.00,$93956.00,184,$-1065.00
2024-09-13,12:39:00,19680.25,BUY,3,0.02h,Stop Loss,$-9.00,$-1074.00,$93947.00,184,$-1074.00
2024-09-13,12:49:00,19443.0,SELL,3,0.02h,Stop Loss,$-9.00,$-1083.00,$93938.00,184,$-1083.00
2024-09-13,12:51:00,19683.0,BUY,3,0.02h,Stop Loss,$-9.00,$-1092.00,$93929.00,184,$-1092.00
2024-09-13,12:55:00,19450.5,SELL,3,0.02h,Stop Loss,$-9.00,$-1101.00,$93920.00,184,$-1101.00
2024-09-13,13:07:00,19679.0,BUY,3,0.02h,Stop Loss,$15.00,$-1086.00,$93935.00,184,$-1086.00
2024-09-13,13:12:00,19438.25,SELL,3,0.02h,Stop Loss,$-9.00,$-1095.00,$93926.00,184,$-1095.00
2024-09-13,13:13:00,19670.5,BUY,3,0.02h,Stop Loss,$-9.00,$-1104.00,$93917.00,184,$-1104.00
2024-09-13,13:14:00,19435.75,SELL,3,0.02h,Break Even,$-1.50,$-1105.50,$93915.50,184,$-1105.50
2024-09-13,13:22:00,19662.25,BUY,3,0.02h,Break Even,$-1.50,$-1107.00,$93914.00,184,$-1107.00
2024-09-13,13:29:00,19429.0,SELL,3,0.02h,Stop Loss,$-9.00,$-1116.00,$93905.00,184,$-1116.00
2024-09-13,13:30:00,19645.0,BUY,3,0.02h,Stop Loss,$-9.00,$-1125.00,$93896.00,184,$-1125.00
2024-09-13,13:31:00,19419.5,SELL,3,0.02h,Stop Loss,$-9.00,$-1134.00,$93887.00,184,$-1134.00
2024-09-13,13:32:00,19644.5,BUY,3,0.02h,Stop Loss,$-9.00,$-1143.00,$93878.00,184,$-1143.00
2024-09-13,13:33:00,19420.75,SELL,3,0.02h,Stop Loss,$4.50,$-1138.50,$93882.50,184,$-1138.50
2024-09-13,13:42:00,19711.75,BUY,3,0.02h,Stop Loss,$49.50,$-1089.00,$93932.00,184,$-1089.00
2024-09-13,13:53:00,19483.0,SELL,3,0.02h,Stop Loss,$-9.00,$-1098.00,$93923.00,184,$-1098.00
2024-09-13,13:54:00,19716.5,BUY,3,0.02h,Stop Loss,$16.50,$-1081.50,$93939.50,184,$-1081.50
2024-09-13,14:03:00,19461.0,SELL,3,0.02h,Stop Loss,$-9.00,$-1090.50,$93930.50,184,$-1090.50
2024-09-13,14:15:00,19722.5,BUY,3,0.02h,Stop Loss,$-9.00,$-1099.50,$93921.50,184,$-1099.50
2024-09-13,14:17:00,19506.0,SELL,3,0.02h,Break Even,$-1.50,$-1101.00,$93920.00,184,$-1101.00
2024-09-13,14:19:00,19746.75,BUY,3,0.02h,Stop Loss,$-9.00,$-1110.00,$93911.00,184,$-1110.00
2024-09-13,14:21:00,19504.75,SELL,3,0.02h,Stop Loss,$66.00,$-1044.00,$93977.00,184,$-1044.00
2024-09-13,14:26:00,19757.75,BUY,3,0.02h,Stop Loss,$-9.00,$-1053.00,$93968.00,184,$-1053.00
2024-09-13,14:27:00,19494.25,SELL,3,0.02h,Stop Loss,$97.50,$-955.50,$94065.50,184,$-955.50
2024-09-13,14:29:00,19718.0,BUY,3,0.02h,Stop Loss,$-9.00,$-964.50,$94056.50,184,$-964.50
2024-09-13,14:30:00,19462.0,SELL,3,0.02h,Stop Loss,$181.50,$-783.00,$94238.00,184,$-783.00
2024-09-13,14:32:00,19673.75,BUY,3,0.02h,Stop Loss,$-9.00,$-792.00,$94229.00,184,$-792.00
2024-09-13,14:33:00,19456.0,SELL,3,0.02h,Stop Loss,$97.50,$-694.50,$94326.50,184,$-694.50
2024-09-13,14:43:00,19735.5,BUY,3,0.02h,Stop Loss,$-9.00,$-703.50,$94317.50,184,$-703.50
2024-09-13,14:57:00,19517.25,SELL,3,0.02h,Stop Loss,$141.00,$-562.50,$94458.50,184,$-562.50
2024-09-13,14:59:00,19731.75,BUY,3,0.02h,Stop Loss,$94.50,$-468.00,$94553.00,184,$-468.00
2024-09-13,15:02:00,19513.0,SELL,3,0.02h,Break Even,$-1.50,$-469.50,$94551.50,184,$-469.50
2024-09-13,15:04:00,19763.5,BUY,3,0.02h,Stop Loss,$-9.00,$-478.50,$94542.50,184,$-478.50
2024-09-13,15:18:00,19518.25,SELL,3,0.02h,Stop Loss,$-9.00,$-487.50,$94533.50,184,$-487.50
2024-09-13,15:19:00,19758.5,BUY,3,0.02h,Break Even,$-1.50,$-489.00,$94532.00,184,$-489.00
2024-09-13,15:28:00,19531.75,SELL,3,0.02h,Stop Loss,$36.00,$-453.00,$94568.00,184,$-453.00
2024-09-13,15:36:00,19762.75,BUY,3,0.02h,Stop Loss,$-9.00,$-462.00,$94559.00,184,$-462.00
2024-09-13,15:38:00,19507.0,SELL,3,0.02h,Stop Loss,$31.50,$-430.50,$94590.50,184,$-430.50
2024-09-13,15:44:00,19758.0,BUY,3,0.02h,Stop Loss,$-9.00,$-439.50,$94581.50,184,$-439.50
2024-09-13,15:45:00,19518.25,SELL,3,0.02h,Stop Loss,$-9.00,$-448.50,$94572.50,184,$-448.50
2024-09-13,15:47:00,19761.75,BUY,3,0.02h,Stop Loss,$-9.00,$-457.50,$94563.50,184,$-457.50
2024-09-13,15:48:00,19533.0,SELL,3,0.02h,Stop Loss,$-9.00,$-466.50,$94554.50,184,$-466.50
2024-09-13,15:50:00,19767.25,BUY,3,0.02h,Stop Loss,$-9.00,$-475.50,$94545.50,184,$-475.50
2024-09-13,15:51:00,19529.75,SELL,3,0.02h,Break Even,$-1.50,$-477.00,$94544.00,184,$-477.00
2024-09-13,15:55:00,19774.5,BUY,3,0.02h,Stop Loss,$-9.00,$-486.00,$94535.00,184,$-486.00
2024-09-13,15:56:00,19535.5,SELL,3,0.02h,Stop Loss,$-9.00,$-495.00,$94526.00,184,$-495.00
2024-09-13,15:57:00,19772.5,BUY,3,0.02h,Stop Loss,$27.00,$-468.00,$94553.00,184,$-468.00
2024-09-13,16:03:00,19549.5,SELL,3,0.02h,Stop Loss,$48.00,$-420.00,$94601.00,184,$-420.00
2024-09-13,16:05:00,19783.75,BUY,3,0.02h,Stop Loss,$-9.00,$-429.00,$94592.00,184,$-429.00
2024-09-13,16:08:00,19528.0,SELL,3,0.02h,Stop Loss,$-9.00,$-438.00,$94583.00,184,$-438.00
2024-09-13,16:09:00,19761.5,BUY,3,0.02h,Break Even,$-1.50,$-439.50,$94581.50,184,$-439.50
2024-09-13,16:11:00,19521.25,SELL,3,0.02h,Stop Loss,$6.00,$-433.50,$94587.50,184,$-433.50
2024-09-13,16:20:00,19734.5,BUY,3,0.02h,Stop Loss,$-9.00,$-442.50,$94578.50,184,$-442.50
2024-09-13,16:21:00,19508.5,SELL,3,0.02h,Stop Loss,$63.00,$-379.50,$94641.50,184,$-379.50
2024-09-13,16:27:00,19739.75,BUY,3,0.02h,Stop Loss,$-9.00,$-388.50,$94632.50,184,$-388.50
2024-09-13,16:28:00,19494.5,SELL,3,0.02h,Break Even,$-1.50,$-390.00,$94631.00,184,$-390.00
2024-09-13,16:30:00,19733.5,BUY,3,0.02h,Stop Loss,$24.00,$-366.00,$94655.00,184,$-366.00
2024-09-13,16:38:00,19499.25,SELL,3,0.02h,Stop Loss,$-9.00,$-375.00,$94646.00,184,$-375.00
2024-09-13,16:39:00,19729.25,BUY,3,0.02h,Stop Loss,$10.50,$-364.50,$94656.50,184,$-364.50
2024-09-13,16:45:00,19492.25,SELL,3,0.02h,Stop Loss,$10.50,$-354.00,$94667.00,184,$-354.00
2024-09-13,16:55:00,19763.25,BUY,3,0.02h,Break Even,$-1.50,$-355.50,$94665.50,184,$-355.50
2024-09-13,17:07:00,19552.5,SELL,3,0.02h,Stop Loss,$-9.00,$-364.50,$94656.50,184,$-364.50
2024-09-13,17:08:00,19786.25,BUY,3,0.02h,Break Even,$-1.50,$-366.00,$94655.00,184,$-366.00
2024-09-13,17:19:00,19562.75,SELL,3,0.02h,Stop Loss,$-9.00,$-375.00,$94646.00,184,$-375.00
2024-09-13,17:20:00,19798.25,BUY,3,0.02h,Stop Loss,$-9.00,$-384.00,$94637.00,184,$-384.00
2024-09-13,17:35:00,19552.25,SELL,3,0.02h,Stop Loss,$16.50,$-367.50,$94653.50,184,$-367.50
2024-09-13,17:44:00,19798.75,BUY,3,0.02h,Break Even,$-1.50,$-369.00,$94652.00,184,$-369.00
2024-09-13,17:46:00,19563.25,SELL,3,0.02h,Stop Loss,$-9.00,$-378.00,$94643.00,184,$-378.00
2024-09-13,17:51:00,19806.5,BUY,3,0.02h,Stop Loss,$10.50,$-367.50,$94653.50,184,$-367.50
2024-09-13,17:59:00,19560.5,SELL,3,0.02h,Stop Loss,$-9.00,$-376.50,$94644.50,184,$-376.50
2024-09-13,18:00:00,19797.5,BUY,3,0.02h,Stop Loss,$-9.00,$-385.50,$94635.50,184,$-385.50
2024-09-13,18:01:00,19514.75,SELL,3,0.02h,Break Even,$-1.50,$-387.00,$94634.00,184,$-387.00
2024-09-13,18:10:00,19802.0,BUY,3,0.02h,Stop Loss,$-9.00,$-396.00,$94625.00,184,$-396.00
2024-09-13,18:11:00,19561.0,SELL,3,0.02h,Stop Loss,$-9.00,$-405.00,$94616.00,184,$-405.00
2024-09-13,18:12:00,19790.0,BUY,3,0.02h,Stop Loss,$-9.00,$-414.00,$94607.00,184,$-414.00
2024-09-13,18:26:00,19505.75,SELL,3,0.02h,Stop Loss,$-9.00,$-423.00,$94598.00,184,$-423.00
2024-09-13,18:28:00,19746.75,BUY,3,0.02h,Stop Loss,$7.50,$-415.50,$94605.50,184,$-415.50
2024-09-13,18:34:00,19508.25,SELL,3,0.02h,Stop Loss,$6.00,$-409.50,$94611.50,184,$-409.50
2024-09-13,18:54:00,19741.75,BUY,3,0.02h,Stop Loss,$34.50,$-375.00,$94646.00,184,$-375.00
2024-09-13,18:58:00,19509.5,SELL,3,0.02h,Stop Loss,$4.50,$-370.50,$94650.50,184,$-370.50
2024-09-13,19:00:00,19748.5,BUY,3,0.02h,Stop Loss,$-9.00,$-379.50,$94641.50,184,$-379.50
2024-09-13,19:02:00,19496.0,SELL,3,0.02h,Stop Loss,$-9.00,$-388.50,$94632.50,184,$-388.50
2024-09-13,19:03:00,19741.25,BUY,3,0.02h,Stop Loss,$-9.00,$-397.50,$94623.50,184,$-397.50
2024-09-13,19:15:00,19511.75,SELL,3,0.02h,Stop Loss,$9.00,$-388.50,$94632.50,184,$-388.50
2024-09-13,19:18:00,19752.25,BUY,3,0.02h,Stop Loss,$36.00,$-352.50,$94668.50,184,$-352.50
2024-09-13,19:20:00,19520.0,SELL,3,0.02h,Stop Loss,$-9.00,$-361.50,$94659.50,184,$-361.50
2024-09-13,19:21:00,19760.25,BUY,3,0.02h,Stop Loss,$-9.00,$-370.50,$94650.50,184,$-370.50
2024-09-13,19:24:00,19525.0,SELL,3,0.02h,Stop Loss,$-9.00,$-379.50,$94641.50,184,$-379.50
2024-09-13,19:25:00,19765.0,BUY,3,0.02h,Stop Loss,$-9.00,$-388.50,$94632.50,184,$-388.50
2024-09-13,19:26:00,19537.5,SELL,3,0.02h,Stop Loss,$-9.00,$-397.50,$94623.50,184,$-397.50
2024-09-13,19:27:00,19767.0,BUY,3,0.02h,Stop Loss,$-9.00,$-406.50,$94614.50,184,$-406.50
2024-09-13,19:28:00,19518.0,SELL,3,0.02h,Stop Loss,$-9.00,$-415.50,$94605.50,184,$-415.50
2024-09-13,19:33:00,19763.5,BUY,3,0.02h,Stop Loss,$24.00,$-391.50,$94629.50,184,$-391.50
2024-09-13,19:41:00,19532.5,SELL,3,0.02h,Stop Loss,$-9.00,$-400.50,$94620.50,184,$-400.50
2024-09-13,19:53:00,19780.5,BUY,3,0.02h,Stop Loss,$-9.00,$-409.50,$94611.50,184,$-409.50
2024-09-13,19:54:00,19539.25,SELL,3,0.02h,Stop Loss,$-9.00,$-418.50,$94602.50,184,$-418.50
2024-09-13,19:55:00,19779.75,BUY,3,0.02h,Stop Loss,$31.50,$-387.00,$94634.00,184,$-387.00
2024-09-13,19:59:00,19538.5,SELL,3,0.02h,Stop Loss,$-9.00,$-396.00,$94625.00,184,$-396.00
2024-09-13,20:00:00,19764.5,BUY,3,0.02h,Stop Loss,$-9.00,$-405.00,$94616.00,184,$-405.00
2024-09-13,20:01:00,19519.5,SELL,3,0.02h,Stop Loss,$-9.00,$-414.00,$94607.00,184,$-414.00
2024-09-13,20:02:00,19752.5,BUY,3,0.02h,Stop Loss,$-9.00,$-423.00,$94598.00,184,$-423.00
2024-09-13,20:03:00,19507.0,SELL,3,0.02h,Stop Loss,$13.50,$-409.50,$94611.50,184,$-409.50
2024-09-13,20:13:00,19744.25,BUY,3,0.02h,Stop Loss,$-9.00,$-418.50,$94602.50,184,$-418.50
2024-09-13,20:14:00,19507.5,SELL,3,0.02h,Stop Loss,$-9.00,$-427.50,$94593.50,184,$-427.50
2024-09-13,20:19:00,19755.5,BUY,3,0.03h,Break Even,$-1.50,$-429.00,$94592.00,184,$-429.00
2024-09-13,20:22:00,19519.0,SELL,3,0.02h,Stop Loss,$-9.00,$-438.00,$94583.00,184,$-438.00
2024-09-13,20:23:00,19756.0,BUY,3,0.02h,Stop Loss,$-9.00,$-447.00,$94574.00,184,$-447.00
2024-09-13,20:28:00,19526.75,SELL,3,0.02h,Stop Loss,$-9.00,$-456.00,$94565.00,184,$-456.00
2024-09-13,20:29:00,19758.75,BUY,3,0.02h,Stop Loss,$-9.00,$-465.00,$94556.00,184,$-465.00
2024-09-13,20:30:00,19522.25,SELL,3,0.02h,Stop Loss,$22.50,$-442.50,$94578.50,184,$-442.50
2024-09-13,20:38:00,19757.75,BUY,3,0.03h,Stop Loss,$-9.00,$-451.50,$94569.50,184,$-451.50
2024-09-13,20:46:00,19511.75,SELL,3,0.02h,Break Even,$-1.50,$-453.00,$94568.00,184,$-453.00
2024-09-13,20:52:00,19745.75,BUY,3,0.02h,Stop Loss,$-9.00,$-462.00,$94559.00,184,$-462.00
2024-09-13,20:53:00,19506.25,SELL,3,0.02h,Stop Loss,$-9.00,$-471.00,$94550.00,184,$-471.00
2024-09-13,20:58:00,19742.5,BUY,3,0.02h,Stop Loss,$-9.00,$-480.00,$94541.00,184,$-480.00
2024-09-13,20:59:00,19506.0,SELL,3,0.02h,Stop Loss,$3.00,$-477.00,$94544.00,184,$-477.00
,,,,,,,,,,,
2024-09-16,00:00:00,19776.25,BUY,3,0.02h,Break Even,$-1.50,$-1.50,$94542.50,185,$-1.50
2024-09-16,00:56:00,19756.25,SELL,3,0.02h,Stop Loss,$-9.00,$-10.50,$94533.50,185,$-10.50
2024-09-16,01:39:00,19747.5,BUY,3,0.03h,Stop Loss,$3.00,$-7.50,$94536.50,185,$-7.50
2024-09-16,02:30:00,19759.25,SELL,3,0.07h,Stop Loss,$27.00,$19.50,$94563.50,185,$19.50
2024-09-16,03:01:00,19755.5,BUY,3,0.05h,Stop Loss,$-9.00,$10.50,$94554.50,185,$10.50
2024-09-16,03:05:00,19750.5,SELL,3,0.02h,Stop Loss,$-9.00,$1.50,$94545.50,185,$1.50
2024-09-16,03:13:00,19759.5,BUY,3,0.02h,Stop Loss,$19.50,$21.00,$94565.00,185,$21.00
2024-09-16,03:53:00,19760.25,SELL,3,0.02h,Stop Loss,$-9.00,$12.00,$94556.00,185,$12.00
2024-09-16,03:57:00,19766.0,BUY,3,0.03h,Stop Loss,$-9.00,$3.00,$94547.00,185,$3.00
2024-09-16,04:05:00,19762.25,SELL,3,0.02h,Stop Loss,$-9.00,$-6.00,$94538.00,185,$-6.00
2024-09-16,04:13:00,19764.25,BUY,3,0.07h,Break Even,$-1.50,$-7.50,$94536.50,185,$-7.50
2024-09-16,04:37:00,19764.75,SELL,3,0.07h,Stop Loss,$-9.00,$-16.50,$94527.50,185,$-16.50
2024-09-16,04:47:00,19764.0,SELL,3,0.05h,Break Even,$-1.50,$-18.00,$94526.00,185,$-18.00
2024-09-16,04:54:00,19767.25,BUY,3,0.02h,Stop Loss,$-9.00,$-27.00,$94517.00,185,$-27.00
2024-09-16,05:07:00,19764.5,SELL,3,0.03h,Break Even,$-1.50,$-28.50,$94515.50,185,$-28.50
2024-09-16,05:53:00,19754.5,BUY,3,0.02h,Stop Loss,$-9.00,$-37.50,$94506.50,185,$-37.50
2024-09-16,06:02:00,19748.0,SELL,3,0.02h,Stop Loss,$-9.00,$-46.50,$94497.50,185,$-46.50
2024-09-16,06:58:00,19728.0,BUY,3,0.02h,Stop Loss,$-9.00,$-55.50,$94488.50,185,$-55.50
2024-09-16,07:01:00,19725.75,SELL,3,0.02h,Stop Loss,$3.00,$-52.50,$94491.50,185,$-52.50
2024-09-16,07:02:00,19727.5,BUY,3,0.02h,Stop Loss,$-9.00,$-61.50,$94482.50,185,$-61.50
2024-09-16,07:03:00,19726.75,SELL,3,0.02h,Break Even,$-1.50,$-63.00,$94481.00,185,$-63.00
2024-09-16,07:06:00,19730.75,BUY,3,0.02h,Break Even,$-1.50,$-64.50,$94479.50,185,$-64.50
2024-09-16,08:35:00,19764.0,SELL,3,0.02h,Stop Loss,$-9.00,$-73.50,$94470.50,185,$-73.50
2024-09-16,08:57:00,19766.25,BUY,3,0.02h,Stop Loss,$-9.00,$-82.50,$94461.50,185,$-82.50
2024-09-16,09:01:00,19762.0,SELL,3,0.02h,Stop Loss,$-9.00,$-91.50,$94452.50,185,$-91.50
2024-09-16,09:02:00,19766.25,BUY,3,0.02h,Break Even,$-1.50,$-93.00,$94451.00,185,$-93.00
2024-09-16,09:24:00,19761.0,SELL,3,0.02h,Break Even,$-1.50,$-94.50,$94449.50,185,$-94.50
2024-09-16,10:47:00,19726.75,BUY,3,0.02h,Break Even,$-1.50,$-96.00,$94448.00,185,$-96.00
2024-09-16,11:06:00,19714.25,SELL,3,0.02h,Stop Loss,$-9.00,$-105.00,$94439.00,185,$-105.00
2024-09-16,11:48:00,19705.5,BUY,3,0.02h,Stop Loss,$-9.00,$-114.00,$94430.00,185,$-114.00
2024-09-16,11:54:00,19694.75,SELL,3,0.02h,Stop Loss,$6.00,$-108.00,$94436.00,185,$-108.00
2024-09-16,13:01:00,19673.5,BUY,3,0.02h,Stop Loss,$10.50,$-97.50,$94446.50,185,$-97.50
2024-09-16,13:08:00,19667.0,SELL,3,0.02h,Stop Loss,$-9.00,$-106.50,$94437.50,185,$-106.50
2024-09-16,13:50:00,19641.75,BUY,3,0.02h,Stop Loss,$54.00,$-52.50,$94491.50,185,$-52.50
2024-09-16,14:21:00,19640.75,SELL,3,0.02h,Stop Loss,$-9.00,$-61.50,$94482.50,185,$-61.50
2024-09-16,15:12:00,19597.75,BUY,3,0.02h,Stop Loss,$43.50,$-18.00,$94526.00,185,$-18.00
2024-09-16,15:39:00,19595.0,SELL,3,0.02h,Stop Loss,$-9.00,$-27.00,$94517.00,185,$-27.00
2024-09-16,15:59:00,19597.5,BUY,3,0.02h,Break Even,$-1.50,$-28.50,$94515.50,185,$-28.50
2024-09-16,16:14:00,19583.5,SELL,3,0.02h,Break Even,$-1.50,$-30.00,$94514.00,185,$-30.00
2024-09-16,16:29:00,19598.25,BUY,3,0.02h,Break Even,$-1.50,$-31.50,$94512.50,185,$-31.50
2024-09-16,16:45:00,19577.75,SELL,3,0.02h,Stop Loss,$3.00,$-28.50,$94515.50,185,$-28.50
2024-09-16,16:51:00,19599.5,BUY,3,0.02h,Stop Loss,$25.50,$-3.00,$94541.00,185,$-3.00
2024-09-16,17:20:00,19606.75,SELL,3,0.02h,Stop Loss,$16.50,$13.50,$94557.50,185,$13.50
2024-09-16,17:26:00,19623.0,BUY,3,0.02h,Stop Loss,$28.50,$42.00,$94586.00,185,$42.00
2024-09-16,18:08:00,19641.25,SELL,3,0.02h,Break Even,$-1.50,$40.50,$94584.50,185,$40.50
2024-09-16,18:12:00,19665.75,BUY,3,0.02h,Stop Loss,$4.50,$45.00,$94589.00,185,$45.00
2024-09-16,18:41:00,19645.25,SELL,3,0.02h,Stop Loss,$-9.00,$36.00,$94580.00,185,$36.00
2024-09-16,19:00:00,19665.5,BUY,3,0.02h,Break Even,$-1.50,$34.50,$94578.50,185,$34.50
2024-09-16,19:15:00,19648.0,SELL,3,0.02h,Stop Loss,$22.50,$57.00,$94601.00,185,$57.00
2024-09-16,19:32:00,19654.0,BUY,3,0.02h,Stop Loss,$7.50,$64.50,$94608.50,185,$64.50
2024-09-16,20:03:00,19664.25,SELL,3,0.02h,Stop Loss,$9.00,$73.50,$94617.50,185,$73.50
2024-09-16,20:23:00,19667.5,BUY,3,0.02h,Break Even,$-1.50,$72.00,$94616.00,185,$72.00
2024-09-16,20:34:00,19662.0,SELL,3,0.02h,Break Even,$-1.50,$70.50,$94614.50,185,$70.50
2024-09-16,23:00:00,19682.5,BUY,3,0.02h,Stop Loss,$12.00,$82.50,$94626.50,185,$82.50
2024-09-16,23:37:00,19676.75,SELL,3,0.03h,Break Even,$-1.50,$81.00,$94625.00,185,$81.00
2024-09-16,23:48:00,19680.0,BUY,3,0.02h,Stop Loss,$-9.00,$72.00,$94616.00,185,$72.00
2024-09-16,23:56:00,19677.25,SELL,3,0.02h,Break Even,$-1.50,$70.50,$94614.50,185,$70.50
,,,,,,,,,,,
2024-09-17,01:41:00,19648.75,BUY,3,0.02h,Break Even,$-1.50,$-1.50,$94613.00,186,$-1.50
2024-09-17,02:25:00,19647.5,SELL,3,0.02h,Stop Loss,$-9.00,$-10.50,$94604.00,186,$-10.50
2024-09-17,02:28:00,19652.25,BUY,3,0.02h,Stop Loss,$-9.00,$-19.50,$94595.00,186,$-19.50
2024-09-17,02:30:00,19649.75,SELL,3,0.02h,Stop Loss,$4.50,$-15.00,$94599.50,186,$-15.00
2024-09-17,02:42:00,19653.0,BUY,3,0.02h,Break Even,$-1.50,$-16.50,$94598.00,186,$-16.50
2024-09-17,03:14:00,19648.0,SELL,3,0.02h,Break Even,$-1.50,$-18.00,$94596.50,186,$-18.00
2024-09-17,03:34:00,19656.0,BUY,3,0.02h,Stop Loss,$-9.00,$-27.00,$94587.50,186,$-27.00
2024-09-17,03:42:00,19643.75,SELL,3,0.02h,Break Even,$-1.50,$-28.50,$94586.00,186,$-28.50
2024-09-17,03:52:00,19649.25,BUY,3,0.02h,Break Even,$-1.50,$-30.00,$94584.50,186,$-30.00
2024-09-17,03:56:00,19644.0,SELL,3,0.02h,Break Even,$-1.50,$-31.50,$94583.00,186,$-31.50
2024-09-17,04:02:00,19648.5,BUY,3,0.02h,Stop Loss,$-9.00,$-40.50,$94574.00,186,$-40.50
2024-09-17,04:03:00,19642.75,SELL,3,0.02h,Stop Loss,$-9.00,$-49.50,$94565.00,186,$-49.50
2024-09-17,04:10:00,19649.5,BUY,3,0.02h,Break Even,$-1.50,$-51.00,$94563.50,186,$-51.00
2024-09-17,06:06:00,19683.75,SELL,3,0.02h,Stop Loss,$3.00,$-48.00,$94566.50,186,$-48.00
2024-09-17,06:23:00,19684.0,BUY,3,0.02h,Stop Loss,$-9.00,$-57.00,$94557.50,186,$-57.00
2024-09-17,06:44:00,19686.5,SELL,3,0.02h,Break Even,$-1.50,$-58.50,$94556.00,186,$-58.50
2024-09-17,06:47:00,19690.0,BUY,3,0.02h,Stop Loss,$4.50,$-54.00,$94560.50,186,$-54.00
2024-09-17,07:56:00,19725.5,SELL,3,0.02h,Stop Loss,$-9.00,$-63.00,$94551.50,186,$-63.00
2024-09-17,07:57:00,19734.25,BUY,3,0.02h,Stop Loss,$-9.00,$-72.00,$94542.50,186,$-72.00
2024-09-17,08:26:00,19736.25,SELL,3,0.02h,Break Even,$-1.50,$-73.50,$94541.00,186,$-73.50
2024-09-17,08:44:00,19736.5,BUY,3,0.02h,Break Even,$-1.50,$-75.00,$94539.50,186,$-75.00
2024-09-17,08:48:00,19732.25,SELL,3,0.02h,Stop Loss,$-9.00,$-84.00,$94530.50,186,$-84.00
2024-09-17,08:53:00,19738.5,BUY,3,0.02h,Stop Loss,$-9.00,$-93.00,$94521.50,186,$-93.00
2024-09-17,10:19:00,19775.5,SELL,3,0.02h,Stop Loss,$-9.00,$-102.00,$94512.50,186,$-102.00
2024-09-17,10:22:00,19779.75,BUY,3,0.02h,Break Even,$-1.50,$-103.50,$94511.00,186,$-103.50
2024-09-17,10:39:00,19776.75,SELL,3,0.02h,Stop Loss,$12.00,$-91.50,$94523.00,186,$-91.50
2024-09-17,11:34:00,19751.5,BUY,3,0.02h,Break Even,$-1.50,$-93.00,$94521.50,186,$-93.00
2024-09-17,11:35:00,19749.5,SELL,3,0.02h,Stop Loss,$24.00,$-69.00,$94545.50,186,$-69.00
2024-09-17,11:41:00,19753.5,BUY,3,0.02h,Break Even,$-1.50,$-70.50,$94544.00,186,$-70.50
2024-09-17,12:15:00,19774.5,SELL,3,0.02h,Break Even,$-1.50,$-72.00,$94542.50,186,$-72.00
2024-09-17,12:31:00,19788.0,BUY,3,0.02h,Break Even,$-1.50,$-73.50,$94541.00,186,$-73.50
2024-09-17,12:47:00,19781.25,SELL,3,0.02h,Break Even,$-1.50,$-75.00,$94539.50,186,$-75.00
2024-09-17,12:54:00,19791.5,BUY,3,0.02h,Break Even,$-1.50,$-76.50,$94538.00,186,$-76.50
2024-09-17,13:21:00,19792.25,SELL,3,0.02h,Stop Loss,$30.00,$-46.50,$94568.00,186,$-46.50
2024-09-17,13:32:00,19813.5,BUY,3,0.02h,Stop Loss,$24.00,$-22.50,$94592.00,186,$-22.50
2024-09-17,13:35:00,19772.25,SELL,3,0.02h,Stop Loss,$33.00,$10.50,$94625.00,186,$10.50
2024-09-17,13:48:00,19797.0,BUY,3,0.02h,Stop Loss,$51.00,$61.50,$94676.00,186,$61.50
2024-09-17,13:49:00,19782.0,SELL,3,0.02h,Stop Loss,$195.00,$256.50,$94871.00,186,$256.50
2024-09-17,14:05:00,19790.5,BUY,3,0.02h,Stop Loss,$9.00,$265.50,$94880.00,186,$265.50
2024-09-17,14:35:00,19777.75,SELL,3,0.02h,Stop Loss,$25.50,$291.00,$94905.50,186,$291.00
2024-09-17,14:42:00,19803.0,BUY,3,0.02h,Break Even,$-1.50,$289.50,$94904.00,186,$289.50
2024-09-17,14:59:00,19780.75,SELL,3,0.02h,Stop Loss,$193.50,$483.00,$95097.50,186,$483.00
2024-09-17,15:16:00,19806.75,BUY,3,0.02h,Stop Loss,$36.00,$519.00,$95133.50,186,$519.00
2024-09-17,15:23:00,19771.75,SELL,3,0.02h,Break Even,$-1.50,$517.50,$95132.00,186,$517.50
2024-09-17,15:53:00,19770.5,BUY,3,0.02h,Break Even,$-1.50,$516.00,$95130.50,186,$516.00
2024-09-17,15:56:00,19757.0,SELL,3,0.02h,Break Even,$-1.50,$514.50,$95129.00,186,$514.50
2024-09-17,15:58:00,19767.25,BUY,3,0.02h,Stop Loss,$10.50,$525.00,$95139.50,186,$525.00
2024-09-17,16:09:00,19761.5,SELL,3,0.02h,Stop Loss,$27.00,$552.00,$95166.50,186,$552.00
2024-09-17,17:19:00,19644.75,BUY,3,0.02h,Stop Loss,$58.50,$610.50,$95225.00,186,$610.50
2024-09-17,17:41:00,19639.5,SELL,3,0.02h,Stop Loss,$60.00,$670.50,$95285.00,186,$670.50
2024-09-17,17:54:00,19665.5,BUY,3,0.02h,Stop Loss,$3.00,$673.50,$95288.00,186,$673.50
2024-09-17,18:19:00,19655.75,SELL,3,0.02h,Stop Loss,$42.00,$715.50,$95330.00,186,$715.50
2024-09-17,18:23:00,19672.0,BUY,3,0.02h,Stop Loss,$27.00,$742.50,$95357.00,186,$742.50
2024-09-17,18:31:00,19652.5,SELL,3,0.02h,Stop Loss,$48.00,$790.50,$95405.00,186,$790.50
2024-09-17,18:43:00,19670.5,BUY,3,0.02h,Stop Loss,$7.50,$798.00,$95412.50,186,$798.00
2024-09-17,18:48:00,19657.75,SELL,3,0.02h,Stop Loss,$270.00,$1068.00,$95682.50,186,$1068.00
2024-09-17,19:10:00,19651.5,BUY,3,0.02h,Stop Loss,$24.00,$1092.00,$95706.50,186,$1092.00
2024-09-17,19:24:00,19626.0,SELL,3,0.02h,Stop Loss,$9.00,$1101.00,$95715.50,186,$1101.00
2024-09-17,19:32:00,19657.0,BUY,3,0.02h,Stop Loss,$-9.00,$1092.00,$95706.50,186,$1092.00
2024-09-17,19:34:00,19641.0,SELL,3,0.02h,Stop Loss,$10.50,$1102.50,$95717.00,186,$1102.50
2024-09-17,19:35:00,19649.25,BUY,3,0.02h,Break Even,$-1.50,$1101.00,$95715.50,186,$1101.00
2024-09-17,19:36:00,19642.5,SELL,3,0.02h,Stop Loss,$-9.00,$1092.00,$95706.50,186,$1092.00
2024-09-17,19:37:00,19652.0,BUY,3,0.02h,Stop Loss,$10.50,$1102.50,$95717.00,186,$1102.50
2024-09-17,19:42:00,19640.0,SELL,3,0.02h,Stop Loss,$-9.00,$1093.50,$95708.00,186,$1093.50
2024-09-17,19:50:00,19656.75,BUY,3,0.02h,Stop Loss,$57.00,$1150.50,$95765.00,186,$1150.50
2024-09-17,20:50:00,19690.75,SELL,3,0.02h,Stop Loss,$18.00,$1168.50,$95783.00,186,$1168.50
2024-09-17,23:18:00,19690.75,BUY,3,0.02h,Break Even,$-1.50,$1167.00,$95781.50,186,$1167.00
,,,,,,,,,,,
2024-09-18,00:09:00,19699.75,SELL,3,0.02h,Break Even,$-1.50,$-1.50,$95780.00,187,$-1.50
2024-09-18,00:16:00,19703.5,BUY,3,0.02h,Stop Loss,$4.50,$3.00,$95784.50,187,$3.00
2024-09-18,00:39:00,19702.75,SELL,3,0.02h,Stop Loss,$-9.00,$-6.00,$95775.50,187,$-6.00
2024-09-18,00:48:00,19708.75,BUY,3,0.02h,Stop Loss,$-9.00,$-15.00,$95766.50,187,$-15.00
2024-09-18,01:01:00,19702.25,SELL,3,0.02h,Stop Loss,$-9.00,$-24.00,$95757.50,187,$-24.00
2024-09-18,01:10:00,19709.0,BUY,3,0.02h,Stop Loss,$-9.00,$-33.00,$95748.50,187,$-33.00
2024-09-18,01:13:00,19701.5,SELL,3,0.02h,Break Even,$-1.50,$-34.50,$95747.00,187,$-34.50
2024-09-18,01:20:00,19706.0,BUY,3,0.02h,Stop Loss,$-9.00,$-43.50,$95738.00,187,$-43.50
2024-09-18,01:44:00,19704.0,SELL,3,0.02h,Break Even,$-1.50,$-45.00,$95736.50,187,$-45.00
2024-09-18,01:51:00,19707.75,BUY,3,0.02h,Stop Loss,$22.50,$-22.50,$95759.00,187,$-22.50
2024-09-18,01:57:00,19705.5,SELL,3,0.02h,Stop Loss,$-9.00,$-31.50,$95750.00,187,$-31.50
2024-09-18,01:58:00,19707.25,BUY,3,0.02h,Break Even,$-1.50,$-33.00,$95748.50,187,$-33.00
2024-09-18,02:21:00,19707.5,SELL,3,0.02h,Stop Loss,$-9.00,$-42.00,$95739.50,187,$-42.00
2024-09-18,02:30:00,19712.0,BUY,3,0.02h,Break Even,$-1.50,$-43.50,$95738.00,187,$-43.50
2024-09-18,02:39:00,19709.75,SELL,3,0.02h,Break Even,$-1.50,$-45.00,$95736.50,187,$-45.00
2024-09-18,02:58:00,19710.75,BUY,3,0.05h,Break Even,$-1.50,$-46.50,$95735.00,187,$-46.50
2024-09-18,03:03:00,19709.0,SELL,3,0.07h,Stop Loss,$-9.00,$-55.50,$95726.00,187,$-55.50
2024-09-18,04:14:00,19691.0,BUY,3,0.02h,Break Even,$-1.50,$-57.00,$95724.50,187,$-57.00
2024-09-18,04:17:00,19688.5,SELL,3,0.02h,Stop Loss,$-9.00,$-66.00,$95715.50,187,$-66.00
2024-09-18,04:20:00,19692.0,BUY,3,0.03h,Stop Loss,$12.00,$-54.00,$95727.50,187,$-54.00
2024-09-18,04:31:00,19686.25,SELL,3,0.02h,Stop Loss,$16.50,$-37.50,$95744.00,187,$-37.50
2024-09-18,05:13:00,19680.25,BUY,3,0.02h,Break Even,$-1.50,$-39.00,$95742.50,187,$-39.00
2024-09-18,05:20:00,19676.75,SELL,3,0.02h,Break Even,$-1.50,$-40.50,$95741.00,187,$-40.50
2024-09-18,05:24:00,19683.75,BUY,3,0.03h,Stop Loss,$10.50,$-30.00,$95751.50,187,$-30.00
2024-09-18,05:33:00,19674.75,SELL,3,0.02h,Break Even,$-1.50,$-31.50,$95750.00,187,$-31.50
2024-09-18,05:41:00,19684.0,BUY,3,0.02h,Stop Loss,$-9.00,$-40.50,$95741.00,187,$-40.50
2024-09-18,06:45:00,19706.25,SELL,3,0.02h,Break Even,$-1.50,$-42.00,$95739.50,187,$-42.00
2024-09-18,06:52:00,19716.0,BUY,3,0.02h,Stop Loss,$-9.00,$-51.00,$95730.50,187,$-51.00
2024-09-18,07:22:00,19712.5,SELL,3,0.02h,Break Even,$-1.50,$-52.50,$95729.00,187,$-52.50
2024-09-18,07:52:00,19702.0,BUY,3,0.02h,Stop Loss,$-9.00,$-61.50,$95720.00,187,$-61.50
2024-09-18,08:02:00,19687.0,SELL,3,0.02h,Stop Loss,$3.00,$-58.50,$95723.00,187,$-58.50
2024-09-18,08:44:00,19676.5,BUY,3,0.02h,Stop Loss,$-9.00,$-67.50,$95714.00,187,$-67.50
2024-09-18,08:47:00,19666.0,SELL,3,0.02h,Stop Loss,$-9.00,$-76.50,$95705.00,187,$-76.50
2024-09-18,08:48:00,19672.0,BUY,3,0.02h,Stop Loss,$9.00,$-67.50,$95714.00,187,$-67.50
2024-09-18,10:17:00,19698.75,SELL,3,0.02h,Stop Loss,$-9.00,$-76.50,$95705.00,187,$-76.50
2024-09-18,10:25:00,19706.25,BUY,3,0.02h,Stop Loss,$-9.00,$-85.50,$95696.00,187,$-85.50
2024-09-18,10:26:00,19703.0,SELL,3,0.02h,Break Even,$-1.50,$-87.00,$95694.50,187,$-87.00
2024-09-18,10:36:00,19707.5,BUY,3,0.02h,Stop Loss,$-9.00,$-96.00,$95685.50,187,$-96.00
2024-09-18,11:28:00,19712.0,SELL,3,0.02h,Stop Loss,$-9.00,$-105.00,$95676.50,187,$-105.00
2024-09-18,12:25:00,19698.5,BUY,3,0.02h,Stop Loss,$-9.00,$-114.00,$95667.50,187,$-114.00
2024-09-18,13:32:00,19712.25,SELL,3,0.02h,Stop Loss,$-9.00,$-123.00,$95658.50,187,$-123.00
2024-09-18,14:00:00,19708.5,BUY,3,0.02h,Break Even,$-1.50,$-124.50,$95657.00,187,$-124.50
2024-09-18,14:08:00,19692.75,SELL,3,0.02h,Stop Loss,$52.50,$-72.00,$95709.50,187,$-72.00
2024-09-18,14:30:00,19700.0,BUY,3,0.02h,Stop Loss,$7.50,$-64.50,$95717.00,187,$-64.50
2024-09-18,14:57:00,19689.5,SELL,3,0.02h,Stop Loss,$36.00,$-28.50,$95753.00,187,$-28.50
2024-09-18,15:06:00,19703.75,BUY,3,0.02h,Break Even,$-1.50,$-30.00,$95751.50,187,$-30.00
2024-09-18,15:07:00,19693.0,SELL,3,0.02h,Stop Loss,$30.00,$0.00,$95781.50,187,$0.00
2024-09-18,16:12:00,19625.0,BUY,3,0.02h,Stop Loss,$15.00,$15.00,$95796.50,187,$15.00
2024-09-18,17:18:00,19686.5,SELL,3,0.02h,Stop Loss,$4.50,$19.50,$95801.00,187,$19.50
2024-09-18,17:30:00,19704.0,BUY,3,0.02h,Stop Loss,$46.50,$66.00,$95847.50,187,$66.00
2024-09-18,17:41:00,19689.0,SELL,3,0.02h,Stop Loss,$16.50,$82.50,$95864.00,187,$82.50
2024-09-18,18:01:00,19848.0,BUY,3,0.02h,Stop Loss,$289.50,$372.00,$96153.50,187,$372.00
2024-09-18,18:14:00,19701.5,SELL,3,0.02h,Stop Loss,$127.50,$499.50,$96281.00,187,$499.50
2024-09-18,18:18:00,19791.75,BUY,3,0.02h,Stop Loss,$106.50,$606.00,$96387.50,187,$606.00
2024-09-18,18:42:00,19775.0,SELL,3,0.02h,Stop Loss,$120.00,$726.00,$96507.50,187,$726.00
2024-09-18,18:53:00,19815.25,BUY,3,0.02h,Break Even,$-1.50,$724.50,$96506.00,187,$724.50
2024-09-18,19:00:00,19722.5,SELL,3,0.02h,Stop Loss,$171.00,$895.50,$96677.00,187,$895.50
2024-09-18,19:27:00,19742.75,BUY,3,0.02h,Stop Loss,$166.50,$1062.00,$96843.50,187,$1062.00
2024-09-18,19:37:00,19662.5,SELL,3,0.02h,Stop Loss,$63.00,$1125.00,$96906.50,187,$1125.00
2024-09-18,20:09:00,19647.25,BUY,3,0.02h,Break Even,$-1.50,$1123.50,$96905.00,187,$1123.50
2024-09-18,20:41:00,19628.25,SELL,3,0.02h,Stop Loss,$12.00,$1135.50,$96917.00,187,$1135.50
2024-09-18,23:00:00,19666.75,BUY,3,0.02h,Stop Loss,$73.50,$1209.00,$96990.50,187,$1209.00
2024-09-18,23:23:00,19649.0,SELL,3,0.02h,Stop Loss,$12.00,$1221.00,$97002.50,187,$1221.00
2024-09-18,23:39:00,19660.75,BUY,3,0.02h,Break Even,$-1.50,$1219.50,$97001.00,187,$1219.50
,,,,,,,,,,,
2024-09-19,00:32:00,19748.5,SELL,3,0.02h,Break Even,$-1.50,$-1.50,$96999.50,188,$-1.50
2024-09-19,01:24:00,19722.25,BUY,3,0.02h,Break Even,$-1.50,$-3.00,$96998.00,188,$-3.00
2024-09-19,01:30:00,19697.0,SELL,3,0.02h,Stop Loss,$51.00,$48.00,$97049.00,188,$48.00
2024-09-19,01:41:00,19714.25,BUY,3,0.02h,Stop Loss,$21.00,$69.00,$97070.00,188,$69.00
2024-09-19,03:07:00,19810.75,SELL,3,0.02h,Break Even,$-1.50,$67.50,$97068.50,188,$67.50
2024-09-19,03:25:00,19817.75,BUY,3,0.02h,Break Even,$-1.50,$66.00,$97067.00,188,$66.00
2024-09-19,04:25:00,19854.25,SELL,3,0.02h,Stop Loss,$-9.00,$57.00,$97058.00,188,$57.00
2024-09-19,04:27:00,19856.0,BUY,3,0.02h,Stop Loss,$-9.00,$48.00,$97049.00,188,$48.00
2024-09-19,04:29:00,19851.5,SELL,3,0.02h,Break Even,$-1.50,$46.50,$97047.50,188,$46.50
2024-09-19,04:33:00,19857.5,BUY,3,0.02h,Stop Loss,$12.00,$58.50,$97059.50,188,$58.50
2024-09-19,04:42:00,19849.25,SELL,3,0.02h,Stop Loss,$-9.00,$49.50,$97050.50,188,$49.50
2024-09-19,04:48:00,19858.5,BUY,3,0.02h,Stop Loss,$-9.00,$40.50,$97041.50,188,$40.50
2024-09-19,05:11:00,19852.0,SELL,3,0.02h,Stop Loss,$-9.00,$31.50,$97032.50,188,$31.50
2024-09-19,05:37:00,19857.5,BUY,3,0.02h,Break Even,$-1.50,$30.00,$97031.00,188,$30.00
2024-09-19,05:40:00,19855.25,SELL,3,0.02h,Stop Loss,$6.00,$36.00,$97037.00,188,$36.00
2024-09-19,05:41:00,19858.75,BUY,3,0.02h,Stop Loss,$16.50,$52.50,$97053.50,188,$52.50
2024-09-19,05:47:00,19846.25,SELL,3,0.02h,Break Even,$-1.50,$51.00,$97052.00,188,$51.00
2024-09-19,05:50:00,19862.25,BUY,3,0.02h,Break Even,$-1.50,$49.50,$97050.50,188,$49.50
2024-09-19,06:19:00,19869.0,SELL,3,0.02h,Break Even,$-1.50,$48.00,$97049.00,188,$48.00
2024-09-19,06:23:00,19882.75,BUY,3,0.02h,Stop Loss,$3.00,$51.00,$97052.00,188,$51.00
2024-09-19,07:11:00,19904.0,SELL,3,0.02h,Stop Loss,$22.50,$73.50,$97074.50,188,$73.50
2024-09-19,07:39:00,19904.75,BUY,3,0.02h,Break Even,$-1.50,$72.00,$97073.00,188,$72.00
2024-09-19,08:21:00,19916.5,SELL,3,0.02h,Break Even,$-1.50,$70.50,$97071.50,188,$70.50
2024-09-19,08:35:00,19922.0,BUY,3,0.02h,Stop Loss,$-9.00,$61.50,$97062.50,188,$61.50
2024-09-19,08:36:00,19916.75,SELL,3,0.02h,Stop Loss,$-9.00,$52.50,$97053.50,188,$52.50
2024-09-19,08:37:00,19919.75,BUY,3,0.02h,Stop Loss,$18.00,$70.50,$97071.50,188,$70.50
2024-09-19,10:04:00,19967.75,SELL,3,0.02h,Stop Loss,$-9.00,$61.50,$97062.50,188,$61.50
2024-09-19,10:12:00,19980.5,BUY,3,0.02h,Break Even,$-1.50,$60.00,$97061.00,188,$60.00
2024-09-19,10:51:00,19987.25,SELL,3,0.02h,Stop Loss,$-9.00,$51.00,$97052.00,188,$51.00
2024-09-19,10:55:00,19997.0,BUY,3,0.02h,Break Even,$-1.50,$49.50,$97050.50,188,$49.50
2024-09-19,11:03:00,19990.75,SELL,3,0.02h,Break Even,$-1.50,$48.00,$97049.00,188,$48.00
2024-09-19,11:34:00,19991.75,BUY,3,0.02h,Stop Loss,$21.00,$69.00,$97070.00,188,$69.00
2024-09-19,12:11:00,20001.75,SELL,3,0.02h,Stop Loss,$-9.00,$60.00,$97061.00,188,$60.00
2024-09-19,12:12:00,20002.75,BUY,3,0.02h,Stop Loss,$40.50,$100.50,$97101.50,188,$100.50
2024-09-19,12:28:00,19999.0,SELL,3,0.02h,Break Even,$-1.50,$99.00,$97100.00,188,$99.00
2024-09-19,12:34:00,20016.0,BUY,3,0.02h,Break Even,$-1.50,$97.50,$97098.50,188,$97.50
2024-09-19,12:38:00,20002.5,SELL,3,0.02h,Break Even,$-1.50,$96.00,$97097.00,188,$96.00
2024-09-19,12:42:00,20010.75,BUY,3,0.02h,Break Even,$-1.50,$94.50,$97095.50,188,$94.50
2024-09-19,12:44:00,20001.75,SELL,3,0.02h,Stop Loss,$18.00,$112.50,$97113.50,188,$112.50
2024-09-19,13:10:00,20012.25,BUY,3,0.02h,Stop Loss,$9.00,$121.50,$97122.50,188,$121.50
2024-09-19,13:37:00,20009.75,SELL,3,0.02h,Stop Loss,$15.00,$136.50,$97137.50,188,$136.50
2024-09-19,13:40:00,20050.5,BUY,3,0.02h,Stop Loss,$54.00,$190.50,$97191.50,188,$190.50
2024-09-19,13:49:00,20026.5,SELL,3,0.02h,Stop Loss,$87.00,$277.50,$97278.50,188,$277.50
2024-09-19,14:04:00,20035.5,BUY,3,0.02h,Stop Loss,$3.00,$280.50,$97281.50,188,$280.50
2024-09-19,14:48:00,20091.5,SELL,3,0.02h,Stop Loss,$63.00,$343.50,$97344.50,188,$343.50
2024-09-19,15:07:00,20108.75,BUY,3,0.02h,Stop Loss,$-9.00,$334.50,$97335.50,188,$334.50
2024-09-19,15:09:00,20072.0,SELL,3,0.02h,Break Even,$-1.50,$333.00,$97334.00,188,$333.00
2024-09-19,15:12:00,20104.0,BUY,3,0.02h,Stop Loss,$39.00,$372.00,$97373.00,188,$372.00
2024-09-19,15:53:00,20104.0,SELL,3,0.02h,Stop Loss,$63.00,$435.00,$97436.00,188,$435.00
2024-09-19,16:06:00,20130.5,BUY,3,0.02h,Stop Loss,$3.00,$438.00,$97439.00,188,$438.00
2024-09-19,16:59:00,20153.75,SELL,3,0.02h,Break Even,$-1.50,$436.50,$97437.50,188,$436.50
2024-09-19,17:18:00,20168.5,BUY,3,0.02h,Stop Loss,$3.00,$439.50,$97440.50,188,$439.50
2024-09-19,18:10:00,20175.0,SELL,3,0.02h,Stop Loss,$76.50,$516.00,$97517.00,188,$516.00
2024-09-19,19:01:00,20146.0,BUY,3,0.02h,Stop Loss,$-9.00,$507.00,$97508.00,188,$507.00
2024-09-19,19:02:00,20127.75,SELL,3,0.02h,Stop Loss,$36.00,$543.00,$97544.00,188,$543.00
2024-09-19,19:38:00,20115.0,BUY,3,0.02h,Break Even,$-1.50,$541.50,$97542.50,188,$541.50
2024-09-19,19:52:00,20079.0,SELL,3,0.02h,Stop Loss,$49.50,$591.00,$97592.00,188,$591.00
2024-09-19,20:39:00,20069.75,BUY,3,0.02h,Stop Loss,$-9.00,$582.00,$97583.00,188,$582.00
2024-09-19,20:47:00,20066.0,SELL,3,0.03h,Break Even,$-1.50,$580.50,$97581.50,188,$580.50
2024-09-19,23:30:00,20057.75,BUY,3,0.02h,Stop Loss,$28.50,$609.00,$97610.00,188,$609.00
2024-09-19,23:54:00,20054.75,SELL,3,0.02h,Stop Loss,$4.50,$613.50,$97614.50,188,$613.50
,,,,,,,,,,,
2024-09-20,00:57:00,20039.25,BUY,3,0.02h,Stop Loss,$-9.00,$-9.00,$97605.50,189,$-9.00
2024-09-20,00:58:00,20034.0,SELL,3,0.02h,Break Even,$-1.50,$-10.50,$97604.00,189,$-10.50
2024-09-20,01:01:00,20038.75,BUY,3,0.02h,Stop Loss,$9.00,$-1.50,$97613.00,189,$-1.50
2024-09-20,01:22:00,20038.0,SELL,3,0.02h,Stop Loss,$-9.00,$-10.50,$97604.00,189,$-10.50
2024-09-20,01:34:00,20040.25,BUY,3,0.02h,Stop Loss,$-9.00,$-19.50,$97595.00,189,$-19.50
2024-09-20,01:35:00,20038.5,SELL,3,0.02h,Stop Loss,$-9.00,$-28.50,$97586.00,189,$-28.50
2024-09-20,01:36:00,20041.0,BUY,3,0.02h,Stop Loss,$-9.00,$-37.50,$97577.00,189,$-37.50
2024-09-20,01:42:00,20037.75,SELL,3,0.02h,Stop Loss,$-9.00,$-46.50,$97568.00,189,$-46.50
2024-09-20,01:44:00,20042.75,BUY,3,0.02h,Break Even,$-1.50,$-48.00,$97566.50,189,$-48.00
2024-09-20,02:19:00,20048.75,SELL,3,0.02h,Stop Loss,$6.00,$-42.00,$97572.50,189,$-42.00
2024-09-20,03:14:00,20032.75,BUY,3,0.02h,Stop Loss,$-9.00,$-51.00,$97563.50,189,$-51.00
2024-09-20,04:18:00,20043.0,SELL,3,0.02h,Stop Loss,$-9.00,$-60.00,$97554.50,189,$-60.00
2024-09-20,04:24:00,20052.25,BUY,3,0.02h,Stop Loss,$-9.00,$-69.00,$97545.50,189,$-69.00
2024-09-20,05:00:00,20057.75,SELL,3,0.02h,Break Even,$-1.50,$-70.50,$97544.00,189,$-70.50
2024-09-20,05:50:00,20038.0,BUY,3,0.02h,Break Even,$-1.50,$-72.00,$97542.50,189,$-72.00
2024-09-20,06:14:00,20041.0,SELL,3,0.02h,Stop Loss,$-9.00,$-81.00,$97533.50,189,$-81.00
2024-09-20,06:20:00,20050.75,BUY,3,0.02h,Break Even,$-1.50,$-82.50,$97532.00,189,$-82.50
2024-09-20,06:24:00,20042.75,SELL,3,0.02h,Stop Loss,$-9.00,$-91.50,$97523.00,189,$-91.50
2024-09-20,07:07:00,20040.0,BUY,3,0.02h,Stop Loss,$-9.00,$-100.50,$97514.00,189,$-100.50
2024-09-20,07:10:00,20031.75,SELL,3,0.02h,Break Even,$-1.50,$-102.00,$97512.50,189,$-102.00
2024-09-20,07:14:00,20049.75,BUY,3,0.02h,Break Even,$-1.50,$-103.50,$97511.00,189,$-103.50
2024-09-20,07:30:00,20041.75,SELL,3,0.02h,Stop Loss,$-9.00,$-112.50,$97502.00,189,$-112.50
2024-09-20,07:31:00,20047.25,BUY,3,0.02h,Break Even,$-1.50,$-114.00,$97500.50,189,$-114.00
2024-09-20,08:03:00,20050.25,SELL,3,0.02h,Break Even,$-1.50,$-115.50,$97499.00,189,$-115.50
2024-09-20,08:50:00,20026.25,BUY,3,0.02h,Stop Loss,$-9.00,$-124.50,$97490.00,189,$-124.50
2024-09-20,08:51:00,20019.75,SELL,3,0.02h,Stop Loss,$-9.00,$-133.50,$97481.00,189,$-133.50
2024-09-20,09:04:00,20032.75,BUY,3,0.02h,Stop Loss,$-9.00,$-142.50,$97472.00,189,$-142.50
2024-09-20,09:30:00,20024.5,SELL,3,0.02h,Stop Loss,$3.00,$-139.50,$97475.00,189,$-139.50
2024-09-20,10:17:00,20015.5,BUY,3,0.02h,Stop Loss,$-9.00,$-148.50,$97466.00,189,$-148.50
2024-09-20,10:32:00,20006.75,SELL,3,0.02h,Stop Loss,$-9.00,$-157.50,$97457.00,189,$-157.50
2024-09-20,11:20:00,20001.5,BUY,3,0.02h,Break Even,$-1.50,$-159.00,$97455.50,189,$-159.00
2024-09-20,11:35:00,19992.75,SELL,3,0.02h,Break Even,$-1.50,$-160.50,$97454.00,189,$-160.50
2024-09-20,11:41:00,20000.5,BUY,3,0.02h,Break Even,$-1.50,$-162.00,$97452.50,189,$-162.00
2024-09-20,13:02:00,20054.75,SELL,3,0.02h,Stop Loss,$10.50,$-151.50,$97463.00,189,$-151.50
2024-09-20,13:31:00,20042.5,BUY,3,0.02h,Stop Loss,$117.00,$-34.50,$97580.00,189,$-34.50
2024-09-20,13:50:00,20036.5,SELL,3,0.02h,Break Even,$-1.50,$-36.00,$97578.50,189,$-36.00
2024-09-20,13:51:00,20065.75,BUY,3,0.02h,Stop Loss,$30.00,$-6.00,$97608.50,189,$-6.00
2024-09-20,13:54:00,20036.0,SELL,3,0.02h,Stop Loss,$36.00,$30.00,$97644.50,189,$30.00
2024-09-20,14:29:00,20007.75,BUY,3,0.02h,Break Even,$-1.50,$28.50,$97643.00,189,$28.50
2024-09-20,14:31:00,19989.75,SELL,3,0.02h,Stop Loss,$61.50,$90.00,$97704.50,189,$90.00
2024-09-20,14:40:00,20009.25,BUY,3,0.02h,Stop Loss,$-9.00,$81.00,$97695.50,189,$81.00
2024-09-20,14:44:00,19991.5,SELL,3,0.02h,Stop Loss,$19.50,$100.50,$97715.00,189,$100.50
2024-09-20,15:34:00,19930.75,BUY,3,0.02h,Stop Loss,$103.50,$204.00,$97818.50,189,$204.00
2024-09-20,17:05:00,20004.25,SELL,3,0.02h,Break Even,$-1.50,$202.50,$97817.00,189,$202.50
2024-09-20,17:18:00,20018.5,BUY,3,0.02h,Break Even,$-1.50,$201.00,$97815.50,189,$201.00
2024-09-20,17:23:00,20008.0,SELL,3,0.02h,Break Even,$-1.50,$199.50,$97814.00,189,$199.50
2024-09-20,17:34:00,20021.5,BUY,3,0.02h,Stop Loss,$7.50,$207.00,$97821.50,189,$207.00
2024-09-20,17:46:00,20011.0,SELL,3,0.02h,Stop Loss,$22.50,$229.50,$97844.00,189,$229.50
2024-09-20,18:50:00,19957.5,BUY,3,0.02h,Stop Loss,$12.00,$241.50,$97856.00,189,$241.50
2024-09-20,19:53:00,20036.75,SELL,3,0.02h,Break Even,$-1.50,$240.00,$97854.50,189,$240.00
2024-09-20,20:41:00,20022.25,BUY,3,0.02h,Stop Loss,$-9.00,$231.00,$97845.50,189,$231.00
,,,,,,,,,,,
2024-09-23,01:48:00,20134.0,SELL,3,0.02h,Break Even,$-1.50,$-1.50,$97844.00,190,$-1.50
2024-09-23,02:12:00,20135.75,BUY,3,0.02h,Stop Loss,$-9.00,$-10.50,$97835.00,190,$-10.50
2024-09-23,02:13:00,20132.0,SELL,3,0.02h,Stop Loss,$-9.00,$-19.50,$97826.00,190,$-19.50
2024-09-23,02:15:00,20135.75,BUY,3,0.02h,Stop Loss,$-9.00,$-28.50,$97817.00,190,$-28.50
2024-09-23,03:01:00,20149.75,SELL,3,0.02h,Stop Loss,$-9.00,$-37.50,$97808.00,190,$-37.50
2024-09-23,03:13:00,20153.75,BUY,3,0.02h,Break Even,$-1.50,$-39.00,$97806.50,190,$-39.00
2024-09-23,03:38:00,20153.75,SELL,3,0.02h,Stop Loss,$-9.00,$-48.00,$97797.50,190,$-48.00
2024-09-23,03:39:00,20156.75,BUY,3,0.02h,Stop Loss,$-9.00,$-57.00,$97788.50,190,$-57.00
2024-09-23,03:51:00,20154.75,SELL,3,0.02h,Stop Loss,$-9.00,$-66.00,$97779.50,190,$-66.00
2024-09-23,04:18:00,20152.0,BUY,3,0.02h,Stop Loss,$-9.00,$-75.00,$97770.50,190,$-75.00
2024-09-23,04:25:00,20148.75,SELL,3,0.02h,Break Even,$-1.50,$-76.50,$97769.00,190,$-76.50
2024-09-23,04:33:00,20150.5,BUY,3,0.02h,Stop Loss,$-9.00,$-85.50,$97760.00,190,$-85.50
2024-09-23,04:34:00,20147.75,SELL,3,0.02h,Break Even,$-1.50,$-87.00,$97758.50,190,$-87.00
2024-09-23,04:39:00,20155.75,BUY,3,0.02h,Stop Loss,$4.50,$-82.50,$97763.00,190,$-82.50
2024-09-23,04:44:00,20148.75,SELL,3,0.02h,Stop Loss,$-9.00,$-91.50,$97754.00,190,$-91.50
2024-09-23,06:33:00,20097.5,BUY,3,0.02h,Break Even,$-1.50,$-93.00,$97752.50,190,$-93.00
2024-09-23,06:39:00,20093.0,SELL,3,0.02h,Stop Loss,$-9.00,$-102.00,$97743.50,190,$-102.00
2024-09-23,06:42:00,20095.75,BUY,3,0.02h,Break Even,$-1.50,$-103.50,$97742.00,190,$-103.50
2024-09-23,06:53:00,20094.75,SELL,3,0.02h,Break Even,$-1.50,$-105.00,$97740.50,190,$-105.00
2024-09-23,07:34:00,20017.0,BUY,3,0.02h,Stop Loss,$-9.00,$-114.00,$97731.50,190,$-114.00
2024-09-23,07:35:00,20005.25,SELL,3,0.02h,Break Even,$-1.50,$-115.50,$97730.00,190,$-115.50
2024-09-23,07:37:00,20015.75,BUY,3,0.02h,Stop Loss,$22.50,$-93.00,$97752.50,190,$-93.00
2024-09-23,08:14:00,20039.25,SELL,3,0.02h,Break Even,$-1.50,$-94.50,$97751.00,190,$-94.50
2024-09-23,08:25:00,20053.5,BUY,3,0.02h,Stop Loss,$18.00,$-76.50,$97769.00,190,$-76.50
2024-09-23,08:35:00,20044.25,SELL,3,0.02h,Stop Loss,$-9.00,$-85.50,$97760.00,190,$-85.50
2024-09-23,08:54:00,20040.5,BUY,3,0.02h,Stop Loss,$30.00,$-55.50,$97790.00,190,$-55.50
2024-09-23,09:18:00,20037.75,SELL,3,0.02h,Break Even,$-1.50,$-57.00,$97788.50,190,$-57.00
2024-09-23,09:24:00,20057.5,BUY,3,0.02h,Stop Loss,$6.00,$-51.00,$97794.50,190,$-51.00
2024-09-23,10:14:00,20071.25,SELL,3,0.02h,Stop Loss,$-9.00,$-60.00,$97785.50,190,$-60.00
2024-09-23,10:20:00,20078.5,BUY,3,0.02h,Break Even,$-1.50,$-61.50,$97784.00,190,$-61.50
2024-09-23,10:26:00,20074.75,SELL,3,0.02h,Stop Loss,$-9.00,$-70.50,$97775.00,190,$-70.50
2024-09-23,10:27:00,20078.25,BUY,3,0.02h,Break Even,$-1.50,$-72.00,$97773.50,190,$-72.00
2024-09-23,10:52:00,20079.75,SELL,3,0.02h,Break Even,$-1.50,$-73.50,$97772.00,190,$-73.50
2024-09-23,11:22:00,20072.25,BUY,3,0.02h,Break Even,$-1.50,$-75.00,$97770.50,190,$-75.00
2024-09-23,11:26:00,20057.5,SELL,3,0.02h,Stop Loss,$57.00,$-18.00,$97827.50,190,$-18.00
2024-09-23,11:41:00,20063.5,BUY,3,0.02h,Stop Loss,$-9.00,$-27.00,$97818.50,190,$-27.00
2024-09-23,12:19:00,20067.0,SELL,3,0.02h,Stop Loss,$15.00,$-12.00,$97833.50,190,$-12.00
2024-09-23,12:25:00,20079.5,BUY,3,0.02h,Break Even,$-1.50,$-13.50,$97832.00,190,$-13.50
2024-09-23,12:50:00,20076.0,SELL,3,0.02h,Stop Loss,$4.50,$-9.00,$97836.50,190,$-9.00
2024-09-23,12:59:00,20091.75,BUY,3,0.02h,Break Even,$-1.50,$-10.50,$97835.00,190,$-10.50
2024-09-23,13:12:00,20080.5,SELL,3,0.02h,Stop Loss,$31.50,$21.00,$97866.50,190,$21.00
2024-09-23,13:49:00,20082.25,BUY,3,0.02h,Stop Loss,$91.50,$112.50,$97958.00,190,$112.50
2024-09-23,14:15:00,20057.25,SELL,3,0.02h,Stop Loss,$40.50,$153.00,$97998.50,190,$153.00
2024-09-23,14:22:00,20086.75,BUY,3,0.02h,Stop Loss,$67.50,$220.50,$98066.00,190,$220.50
2024-09-23,14:39:00,20074.5,SELL,3,0.02h,Stop Loss,$84.00,$304.50,$98150.00,190,$304.50
2024-09-23,14:45:00,20104.75,BUY,3,0.02h,Break Even,$-1.50,$303.00,$98148.50,190,$303.00
2024-09-23,15:02:00,20083.25,SELL,3,0.02h,Stop Loss,$34.50,$337.50,$98183.00,190,$337.50
2024-09-23,15:27:00,20083.75,BUY,3,0.02h,Stop Loss,$-9.00,$328.50,$98174.00,190,$328.50
2024-09-23,16:03:00,20102.25,SELL,3,0.02h,Stop Loss,$22.50,$351.00,$98196.50,190,$351.00
2024-09-23,17:20:00,20051.75,BUY,3,0.02h,Stop Loss,$19.50,$370.50,$98216.00,190,$370.50
2024-09-23,17:29:00,20037.25,SELL,3,0.02h,Break Even,$-1.50,$369.00,$98214.50,190,$369.00
2024-09-23,17:33:00,20049.5,BUY,3,0.02h,Stop Loss,$25.50,$394.50,$98240.00,190,$394.50
2024-09-23,18:30:00,20067.0,SELL,3,0.02h,Break Even,$-1.50,$393.00,$98238.50,190,$393.00
2024-09-23,18:43:00,20075.75,BUY,3,0.02h,Stop Loss,$-9.00,$384.00,$98229.50,190,$384.00
2024-09-23,18:46:00,20068.5,SELL,3,0.02h,Stop Loss,$-9.00,$375.00,$98220.50,190,$375.00
2024-09-23,18:51:00,20076.5,BUY,3,0.02h,Stop Loss,$-9.00,$366.00,$98211.50,190,$366.00
2024-09-23,19:10:00,20068.25,SELL,3,0.02h,Stop Loss,$12.00,$378.00,$98223.50,190,$378.00
2024-09-23,19:23:00,20077.25,BUY,3,0.02h,Stop Loss,$-9.00,$369.00,$98214.50,190,$369.00
2024-09-23,19:44:00,20069.75,SELL,3,0.02h,Stop Loss,$73.50,$442.50,$98288.00,190,$442.50
2024-09-23,19:50:00,20085.0,BUY,3,0.02h,Break Even,$-1.50,$441.00,$98286.50,190,$441.00
2024-09-23,19:54:00,20067.25,SELL,3,0.02h,Break Even,$-1.50,$439.50,$98285.00,190,$439.50
2024-09-23,19:57:00,20076.75,BUY,3,0.02h,Stop Loss,$10.50,$450.00,$98295.50,190,$450.00
2024-09-23,20:08:00,20067.0,SELL,3,0.02h,Break Even,$-1.50,$448.50,$98294.00,190,$448.50
2024-09-23,20:53:00,20062.0,BUY,3,0.02h,Stop Loss,$-9.00,$439.50,$98285.00,190,$439.50
2024-09-23,20:59:00,20058.25,SELL,3,0.02h,Stop Loss,$-9.00,$430.50,$98276.00,190,$430.50
2024-09-23,21:00:00,20063.25,BUY,3,2.00h,Stop Loss,$-9.00,$421.50,$98267.00,190,$421.50
2024-09-23,23:00:00,20051.25,SELL,3,0.02h,Break Even,$-1.50,$420.00,$98265.50,190,$420.00
2024-09-23,23:32:00,20054.5,BUY,3,0.02h,Stop Loss,$6.00,$426.00,$98271.50,190,$426.00
,,,,,,,,,,,
2024-09-24,00:07:00,20063.75,SELL,3,0.02h,Break Even,$-1.50,$-1.50,$98270.00,191,$-1.50
2024-09-24,00:14:00,20068.75,BUY,3,0.02h,Break Even,$-1.50,$-3.00,$98268.50,191,$-3.00
2024-09-24,00:34:00,20067.75,SELL,3,0.02h,Break Even,$-1.50,$-4.50,$98267.00,191,$-4.50
2024-09-24,01:01:00,20064.25,BUY,3,0.02h,Break Even,$-1.50,$-6.00,$98265.50,191,$-6.00
2024-09-24,01:31:00,20075.75,SELL,3,0.02h,Stop Loss,$-9.00,$-15.00,$98256.50,191,$-15.00
2024-09-24,02:43:00,20036.0,BUY,3,0.02h,Stop Loss,$-9.00,$-24.00,$98247.50,191,$-24.00
2024-09-24,02:46:00,20033.0,SELL,3,0.02h,Break Even,$-1.50,$-25.50,$98246.00,191,$-25.50
2024-09-24,02:48:00,20036.5,BUY,3,0.02h,Stop Loss,$-9.00,$-34.50,$98237.00,191,$-34.50
2024-09-24,02:51:00,20033.5,SELL,3,0.02h,Break Even,$-1.50,$-36.00,$98235.50,191,$-36.00
2024-09-24,02:57:00,20036.75,BUY,3,0.02h,Stop Loss,$6.00,$-30.00,$98241.50,191,$-30.00
2024-09-24,03:29:00,20041.5,SELL,3,0.02h,Stop Loss,$-9.00,$-39.00,$98232.50,191,$-39.00
2024-09-24,03:31:00,20045.0,BUY,3,0.02h,Stop Loss,$-9.00,$-48.00,$98223.50,191,$-48.00
2024-09-24,03:32:00,20042.5,SELL,3,0.02h,Break Even,$-1.50,$-49.50,$98222.00,191,$-49.50
2024-09-24,03:40:00,20046.0,BUY,3,0.02h,Stop Loss,$-9.00,$-58.50,$98213.00,191,$-58.50
2024-09-24,04:07:00,20047.5,SELL,3,0.02h,Stop Loss,$-9.00,$-67.50,$98204.00,191,$-67.50
2024-09-24,04:22:00,20051.25,BUY,3,0.02h,Break Even,$-1.50,$-69.00,$98202.50,191,$-69.00
2024-09-24,05:37:00,20087.0,SELL,3,0.02h,Stop Loss,$-9.00,$-78.00,$98193.50,191,$-78.00
2024-09-24,05:44:00,20093.5,BUY,3,0.02h,Stop Loss,$-9.00,$-87.00,$98184.50,191,$-87.00
2024-09-24,07:22:00,20125.75,SELL,3,0.02h,Stop Loss,$25.50,$-61.50,$98210.00,191,$-61.50
2024-09-24,07:46:00,20122.75,BUY,3,0.02h,Stop Loss,$27.00,$-34.50,$98237.00,191,$-34.50
2024-09-24,08:40:00,20157.25,SELL,3,0.02h,Break Even,$-1.50,$-36.00,$98235.50,191,$-36.00
2024-09-24,08:53:00,20162.5,BUY,3,0.02h,Stop Loss,$-9.00,$-45.00,$98226.50,191,$-45.00
2024-09-24,09:06:00,20157.75,SELL,3,0.02h,Break Even,$-1.50,$-46.50,$98225.00,191,$-46.50
2024-09-24,10:11:00,20138.75,BUY,3,0.02h,Stop Loss,$-9.00,$-55.50,$98216.00,191,$-55.50
2024-09-24,10:48:00,20128.75,SELL,3,0.02h,Break Even,$-1.50,$-57.00,$98214.50,191,$-57.00
2024-09-24,11:29:00,20089.5,BUY,3,0.02h,Break Even,$-1.50,$-58.50,$98213.00,191,$-58.50
2024-09-24,11:57:00,20102.0,SELL,3,0.02h,Break Even,$-1.50,$-60.00,$98211.50,191,$-60.00
2024-09-24,12:05:00,20114.5,BUY,3,0.02h,Stop Loss,$-9.00,$-69.00,$98202.50,191,$-69.00
2024-09-24,12:11:00,20101.0,SELL,3,0.02h,Break Even,$-1.50,$-70.50,$98201.00,191,$-70.50
2024-09-24,12:15:00,20113.25,BUY,3,0.02h,Break Even,$-1.50,$-72.00,$98199.50,191,$-72.00
2024-09-24,12:29:00,20105.75,SELL,3,0.02h,Stop Loss,$-9.00,$-81.00,$98190.50,191,$-81.00
2024-09-24,12:49:00,20109.0,BUY,3,0.02h,Stop Loss,$3.00,$-78.00,$98193.50,191,$-78.00
2024-09-24,13:33:00,20117.75,SELL,3,0.02h,Stop Loss,$30.00,$-48.00,$98223.50,191,$-48.00
2024-09-24,14:48:00,20014.25,BUY,3,0.02h,Stop Loss,$9.00,$-39.00,$98232.50,191,$-39.00
2024-09-24,16:26:00,20183.5,SELL,3,0.02h,Stop Loss,$52.50,$13.50,$98285.00,191,$13.50
2024-09-24,16:34:00,20197.0,BUY,3,0.02h,Break Even,$-1.50,$12.00,$98283.50,191,$12.00
2024-09-24,16:54:00,20191.75,SELL,3,0.02h,Stop Loss,$58.50,$70.50,$98342.00,191,$70.50
2024-09-24,17:17:00,20185.5,BUY,3,0.02h,Stop Loss,$22.50,$93.00,$98364.50,191,$93.00
2024-09-24,17:24:00,20173.25,SELL,3,0.02h,Break Even,$-1.50,$91.50,$98363.00,191,$91.50
2024-09-24,17:34:00,20183.0,BUY,3,0.02h,Stop Loss,$10.50,$102.00,$98373.50,191,$102.00
2024-09-24,17:49:00,20177.5,SELL,3,0.02h,Stop Loss,$36.00,$138.00,$98409.50,191,$138.00
2024-09-24,18:54:00,20153.0,BUY,3,0.02h,Break Even,$-1.50,$136.50,$98408.00,191,$136.50
2024-09-24,19:19:00,20146.0,SELL,3,0.02h,Break Even,$-1.50,$135.00,$98406.50,191,$135.00
2024-09-24,19:21:00,20153.5,BUY,3,0.02h,Stop Loss,$3.00,$138.00,$98409.50,191,$138.00
2024-09-24,19:31:00,20146.5,SELL,3,0.02h,Break Even,$-1.50,$136.50,$98408.00,191,$136.50
2024-09-24,19:39:00,20154.25,BUY,3,0.02h,Stop Loss,$28.50,$165.00,$98436.50,191,$165.00
2024-09-24,19:57:00,20151.75,SELL,3,0.02h,Break Even,$-1.50,$163.50,$98435.00,191,$163.50
2024-09-24,20:01:00,20165.75,BUY,3,0.02h,Break Even,$-1.50,$162.00,$98433.50,191,$162.00
2024-09-24,23:04:00,20185.75,SELL,3,0.02h,Stop Loss,$-9.00,$153.00,$98424.50,191,$153.00
2024-09-24,23:09:00,20189.5,BUY,3,0.02h,Break Even,$-1.50,$151.50,$98423.00,191,$151.50
2024-09-24,23:25:00,20185.75,SELL,3,0.02h,Stop Loss,$-9.00,$142.50,$98414.00,191,$142.50
,,,,,,,,,,,
2024-09-25,01:07:00,20151.0,BUY,3,0.02h,Stop Loss,$9.00,$9.00,$98423.00,192,$9.00
2024-09-25,01:16:00,20134.75,SELL,3,0.02h,Stop Loss,$-9.00,$0.00,$98414.00,192,$0.00
2024-09-25,01:44:00,20134.0,BUY,3,0.02h,Stop Loss,$-9.00,$-9.00,$98405.00,192,$-9.00
2024-09-25,01:46:00,20127.5,SELL,3,0.02h,Break Even,$-1.50,$-10.50,$98403.50,192,$-10.50
2024-09-25,02:04:00,20135.75,BUY,3,0.02h,Stop Loss,$-9.00,$-19.50,$98394.50,192,$-19.50
2024-09-25,02:26:00,20126.0,SELL,3,0.02h,Stop Loss,$-9.00,$-28.50,$98385.50,192,$-28.50
2024-09-25,02:39:00,20136.0,BUY,3,0.02h,Stop Loss,$-9.00,$-37.50,$98376.50,192,$-37.50
2024-09-25,02:49:00,20128.25,SELL,3,0.02h,Stop Loss,$27.00,$-10.50,$98403.50,192,$-10.50
2024-09-25,03:16:00,20128.75,BUY,3,0.02h,Break Even,$-1.50,$-12.00,$98402.00,192,$-12.00
2024-09-25,03:40:00,20127.5,SELL,3,0.02h,Stop Loss,$7.50,$-4.50,$98409.50,192,$-4.50
2024-09-25,04:01:00,20130.25,BUY,3,0.02h,Stop Loss,$-9.00,$-13.50,$98400.50,192,$-13.50
2024-09-25,04:20:00,20127.25,SELL,3,0.02h,Stop Loss,$-9.00,$-22.50,$98391.50,192,$-22.50
2024-09-25,04:25:00,20131.25,BUY,3,0.02h,Break Even,$-1.50,$-24.00,$98390.00,192,$-24.00
2024-09-25,04:38:00,20127.75,SELL,3,0.02h,Stop Loss,$-9.00,$-33.00,$98381.00,192,$-33.00
2024-09-25,04:39:00,20132.0,BUY,3,0.03h,Break Even,$-1.50,$-34.50,$98379.50,192,$-34.50
2024-09-25,04:42:00,20128.0,SELL,3,0.02h,Stop Loss,$-9.00,$-43.50,$98370.50,192,$-43.50
2024-09-25,04:47:00,20133.75,BUY,3,0.02h,Break Even,$-1.50,$-45.00,$98369.00,192,$-45.00
2024-09-25,04:58:00,20126.0,SELL,3,0.02h,Stop Loss,$-9.00,$-54.00,$98360.00,192,$-54.00
2024-09-25,05:06:00,20136.5,BUY,3,0.02h,Stop Loss,$-9.00,$-63.00,$98351.00,192,$-63.00
2024-09-25,05:17:00,20128.25,SELL,3,0.02h,Stop Loss,$19.50,$-43.50,$98370.50,192,$-43.50
2024-09-25,05:33:00,20132.5,BUY,3,0.02h,Stop Loss,$-9.00,$-52.50,$98361.50,192,$-52.50
2024-09-25,05:38:00,20125.0,SELL,3,0.02h,Stop Loss,$-9.00,$-61.50,$98352.50,192,$-61.50
2024-09-25,06:45:00,20087.0,BUY,3,0.02h,Stop Loss,$-9.00,$-70.50,$98343.50,192,$-70.50
2024-09-25,06:47:00,20080.25,SELL,3,0.02h,Stop Loss,$9.00,$-61.50,$98352.50,192,$-61.50
2024-09-25,07:08:00,20092.0,BUY,3,0.02h,Stop Loss,$-9.00,$-70.50,$98343.50,192,$-70.50
2024-09-25,07:12:00,20072.25,SELL,3,0.02h,Stop Loss,$18.00,$-52.50,$98361.50,192,$-52.50
2024-09-25,07:17:00,20089.5,BUY,3,0.02h,Break Even,$-1.50,$-54.00,$98360.00,192,$-54.00
2024-09-25,07:54:00,20103.75,SELL,3,0.02h,Stop Loss,$-9.00,$-63.00,$98351.00,192,$-63.00
2024-09-25,07:55:00,20107.75,BUY,3,0.02h,Stop Loss,$4.50,$-58.50,$98355.50,192,$-58.50
2024-09-25,08:07:00,20102.5,SELL,3,0.02h,Stop Loss,$-9.00,$-67.50,$98346.50,192,$-67.50
2024-09-25,08:17:00,20106.75,BUY,3,0.02h,Break Even,$-1.50,$-69.00,$98345.00,192,$-69.00
2024-09-25,08:21:00,20099.25,SELL,3,0.02h,Stop Loss,$-9.00,$-78.00,$98336.00,192,$-78.00
2024-09-25,09:09:00,20099.75,BUY,3,0.02h,Break Even,$-1.50,$-79.50,$98334.50,192,$-79.50
2024-09-25,09:17:00,20089.0,SELL,3,0.02h,Break Even,$-1.50,$-81.00,$98333.00,192,$-81.00
2024-09-25,09:33:00,20100.0,BUY,3,0.02h,Stop Loss,$9.00,$-72.00,$98342.00,192,$-72.00
2024-09-25,10:37:00,20126.5,SELL,3,0.02h,Break Even,$-1.50,$-73.50,$98340.50,192,$-73.50
2024-09-25,10:59:00,20123.25,BUY,3,0.02h,Stop Loss,$30.00,$-43.50,$98370.50,192,$-43.50
2024-09-25,11:25:00,20128.25,SELL,3,0.02h,Stop Loss,$-9.00,$-52.50,$98361.50,192,$-52.50
2024-09-25,11:26:00,20132.0,BUY,3,0.02h,Break Even,$-1.50,$-54.00,$98360.00,192,$-54.00
2024-09-25,11:27:00,20130.5,SELL,3,0.02h,Stop Loss,$9.00,$-45.00,$98369.00,192,$-45.00
2024-09-25,11:54:00,20138.25,BUY,3,0.02h,Stop Loss,$-9.00,$-54.00,$98360.00,192,$-54.00
2024-09-25,12:11:00,20129.5,SELL,3,0.02h,Break Even,$-1.50,$-55.50,$98358.50,192,$-55.50
2024-09-25,12:18:00,20139.25,BUY,3,0.02h,Break Even,$-1.50,$-57.00,$98357.00,192,$-57.00
2024-09-25,12:49:00,20141.25,SELL,3,0.02h,Stop Loss,$6.00,$-51.00,$98363.00,192,$-51.00
2024-09-25,12:53:00,20149.5,BUY,3,0.02h,Stop Loss,$-9.00,$-60.00,$98354.00,192,$-60.00
2024-09-25,13:04:00,20142.0,SELL,3,0.02h,Stop Loss,$-9.00,$-69.00,$98345.00,192,$-69.00
2024-09-25,13:10:00,20151.0,BUY,3,0.02h,Stop Loss,$-9.00,$-78.00,$98336.00,192,$-78.00
2024-09-25,13:20:00,20146.0,SELL,3,0.02h,Stop Loss,$-9.00,$-87.00,$98327.00,192,$-87.00
2024-09-25,13:31:00,20160.75,BUY,3,0.02h,Stop Loss,$73.50,$-13.50,$98400.50,192,$-13.50
2024-09-25,14:30:00,20227.5,SELL,3,0.02h,Stop Loss,$72.00,$58.50,$98472.50,192,$58.50
2024-09-25,15:09:00,20243.75,BUY,3,0.02h,Break Even,$-1.50,$57.00,$98471.00,192,$57.00
2024-09-25,15:13:00,20222.25,SELL,3,0.02h,Stop Loss,$19.50,$76.50,$98490.50,192,$76.50
2024-09-25,15:39:00,20238.5,BUY,3,0.02h,Stop Loss,$-9.00,$67.50,$98481.50,192,$67.50
2024-09-25,15:47:00,20208.5,SELL,3,0.02h,Break Even,$-1.50,$66.00,$98480.00,192,$66.00
2024-09-25,16:21:00,20207.0,BUY,3,0.02h,Stop Loss,$9.00,$75.00,$98489.00,192,$75.00
2024-09-25,16:44:00,20195.75,SELL,3,0.02h,Break Even,$-1.50,$73.50,$98487.50,192,$73.50
2024-09-25,17:27:00,20181.0,BUY,3,0.02h,Stop Loss,$9.00,$82.50,$98496.50,192,$82.50
2024-09-25,17:36:00,20162.0,SELL,3,0.02h,Break Even,$-1.50,$81.00,$98495.00,192,$81.00
2024-09-25,17:55:00,20186.0,BUY,3,0.02h,Stop Loss,$13.50,$94.50,$98508.50,192,$94.50
2024-09-25,18:13:00,20176.0,SELL,3,0.02h,Break Even,$-1.50,$93.00,$98507.00,192,$93.00
2024-09-25,18:27:00,20185.5,BUY,3,0.02h,Stop Loss,$4.50,$97.50,$98511.50,192,$97.50
2024-09-25,18:58:00,20182.75,SELL,3,0.02h,Stop Loss,$34.50,$132.00,$98546.00,192,$132.00
2024-09-25,19:04:00,20198.5,BUY,3,0.02h,Stop Loss,$-9.00,$123.00,$98537.00,192,$123.00
2024-09-25,19:09:00,20186.75,SELL,3,0.02h,Break Even,$-1.50,$121.50,$98535.50,192,$121.50
2024-09-25,19:38:00,20185.0,BUY,3,0.02h,Break Even,$-1.50,$120.00,$98534.00,192,$120.00
2024-09-25,19:40:00,20179.0,SELL,3,0.02h,Stop Loss,$3.00,$123.00,$98537.00,192,$123.00
2024-09-25,19:49:00,20189.0,BUY,3,0.02h,Break Even,$-1.50,$121.50,$98535.50,192,$121.50
,,,,,,,,,,,
2024-09-26,00:47:00,20302.0,SELL,3,0.02h,Break Even,$-1.50,$-1.50,$98534.00,193,$-1.50
2024-09-26,01:11:00,20303.5,BUY,3,0.02h,Stop Loss,$12.00,$10.50,$98546.00,193,$10.50
2024-09-26,01:18:00,20294.75,SELL,3,0.02h,Break Even,$-1.50,$9.00,$98544.50,193,$9.00
2024-09-26,01:46:00,20298.25,BUY,3,0.02h,Stop Loss,$-9.00,$0.00,$98535.50,193,$0.00
2024-09-26,02:45:00,20319.75,SELL,3,0.02h,Stop Loss,$-9.00,$-9.00,$98526.50,193,$-9.00
2024-09-26,02:47:00,20322.5,BUY,3,0.02h,Break Even,$-1.50,$-10.50,$98525.00,193,$-10.50
2024-09-26,03:23:00,20328.25,SELL,3,0.02h,Stop Loss,$-9.00,$-19.50,$98516.00,193,$-19.50
2024-09-26,03:24:00,20331.0,BUY,3,0.02h,Stop Loss,$-9.00,$-28.50,$98507.00,193,$-28.50
2024-09-26,05:06:00,20365.75,SELL,3,0.02h,Break Even,$-1.50,$-30.00,$98505.50,193,$-30.00
2024-09-26,05:10:00,20374.75,BUY,3,0.02h,Break Even,$-1.50,$-31.50,$98504.00,193,$-31.50
2024-09-26,06:31:00,20436.75,SELL,3,0.02h,Stop Loss,$-9.00,$-40.50,$98495.00,193,$-40.50
2024-09-26,06:39:00,20445.5,BUY,3,0.02h,Break Even,$-1.50,$-42.00,$98493.50,193,$-42.00
2024-09-26,06:45:00,20440.0,SELL,3,0.02h,Break Even,$-1.50,$-43.50,$98492.00,193,$-43.50
2024-09-26,06:46:00,20447.0,BUY,3,0.02h,Break Even,$-1.50,$-45.00,$98490.50,193,$-45.00
2024-09-26,08:02:00,20480.75,SELL,3,0.02h,Break Even,$-1.50,$-46.50,$98489.00,193,$-46.50
2024-09-26,08:16:00,20486.0,BUY,3,0.02h,Stop Loss,$-9.00,$-55.50,$98480.00,193,$-55.50
2024-09-26,08:19:00,20473.0,SELL,3,0.02h,Stop Loss,$-9.00,$-64.50,$98471.00,193,$-64.50
2024-09-26,08:35:00,20479.75,BUY,3,0.02h,Stop Loss,$10.50,$-54.00,$98481.50,193,$-54.00
2024-09-26,08:39:00,20472.0,SELL,3,0.02h,Stop Loss,$9.00,$-45.00,$98490.50,193,$-45.00
2024-09-26,09:27:00,20473.0,BUY,3,0.02h,Stop Loss,$-9.00,$-54.00,$98481.50,193,$-54.00
2024-09-26,09:55:00,20465.75,SELL,3,0.02h,Break Even,$-1.50,$-55.50,$98480.00,193,$-55.50
2024-09-26,09:58:00,20470.25,BUY,3,0.02h,Break Even,$-1.50,$-57.00,$98478.50,193,$-57.00
2024-09-26,10:00:00,20468.5,SELL,3,0.02h,Break Even,$-1.50,$-58.50,$98477.00,193,$-58.50
2024-09-26,10:18:00,20469.75,BUY,3,0.02h,Break Even,$-1.50,$-60.00,$98475.50,193,$-60.00
2024-09-26,11:15:00,20481.5,SELL,3,0.02h,Stop Loss,$-9.00,$-69.00,$98466.50,193,$-69.00
2024-09-26,11:25:00,20488.0,BUY,3,0.02h,Break Even,$-1.50,$-70.50,$98465.00,193,$-70.50
2024-09-26,11:47:00,20489.5,SELL,3,0.02h,Break Even,$-1.50,$-72.00,$98463.50,193,$-72.00
2024-09-26,12:21:00,20480.25,BUY,3,0.02h,Break Even,$-1.50,$-73.50,$98462.00,193,$-73.50
2024-09-26,13:26:00,20508.0,SELL,3,0.02h,Break Even,$-1.50,$-75.00,$98460.50,193,$-75.00
2024-09-26,15:18:00,20274.5,BUY,3,0.02h,Stop Loss,$-9.00,$-84.00,$98451.50,193,$-84.00
2024-09-26,15:19:00,20257.0,SELL,3,0.02h,Stop Loss,$117.00,$33.00,$98568.50,193,$33.00
2024-09-26,15:42:00,20250.0,BUY,3,0.02h,Stop Loss,$40.50,$73.50,$98609.00,193,$73.50
2024-09-26,16:12:00,20277.0,SELL,3,0.02h,Stop Loss,$18.00,$91.50,$98627.00,193,$91.50
2024-09-26,16:54:00,20259.0,BUY,3,0.02h,Stop Loss,$-9.00,$82.50,$98618.00,193,$82.50
2024-09-26,16:55:00,20252.25,SELL,3,0.02h,Stop Loss,$6.00,$88.50,$98624.00,193,$88.50
2024-09-26,17:31:00,20256.5,BUY,3,0.02h,Stop Loss,$52.50,$141.00,$98676.50,193,$141.00
2024-09-26,18:48:00,20326.0,SELL,3,0.02h,Stop Loss,$-9.00,$132.00,$98667.50,193,$132.00
2024-09-26,18:52:00,20334.0,BUY,3,0.02h,Break Even,$-1.50,$130.50,$98666.00,193,$130.50
2024-09-26,19:03:00,20323.25,SELL,3,0.02h,Stop Loss,$-9.00,$121.50,$98657.00,193,$121.50
2024-09-26,19:06:00,20337.75,BUY,3,0.02h,Stop Loss,$-9.00,$112.50,$98648.00,193,$112.50
2024-09-26,19:40:00,20345.75,SELL,3,0.02h,Break Even,$-1.50,$111.00,$98646.50,193,$111.00
2024-09-26,19:50:00,20353.5,BUY,3,0.02h,Break Even,$-1.50,$109.50,$98645.00,193,$109.50
2024-09-26,19:51:00,20346.25,SELL,3,0.02h,Stop Loss,$60.00,$169.50,$98705.00,193,$169.50
2024-09-26,20:08:00,20352.0,BUY,3,0.02h,Break Even,$-1.50,$168.00,$98703.50,193,$168.00
2024-09-26,20:21:00,20344.0,SELL,3,0.02h,Break Even,$-1.50,$166.50,$98702.00,193,$166.50
2024-09-26,20:27:00,20347.0,BUY,3,0.02h,Stop Loss,$-9.00,$157.50,$98693.00,193,$157.50
2024-09-26,20:30:00,20346.25,SELL,3,0.02h,Stop Loss,$-9.00,$148.50,$98684.00,193,$148.50
2024-09-26,20:31:00,20348.0,BUY,3,0.02h,Stop Loss,$-9.00,$139.50,$98675.00,193,$139.50
2024-09-26,20:43:00,20343.25,SELL,3,0.02h,Stop Loss,$-9.00,$130.50,$98666.00,193,$130.50
2024-09-26,23:00:00,20365.25,BUY,3,0.02h,Stop Loss,$-9.00,$121.50,$98657.00,193,$121.50
2024-09-26,23:26:00,20356.0,SELL,3,0.02h,Stop Loss,$13.50,$135.00,$98670.50,193,$135.00
,,,,,,,,,,,
2024-09-27,00:18:00,20341.75,BUY,3,0.02h,Break Even,$-1.50,$-1.50,$98669.00,194,$-1.50
2024-09-27,00:38:00,20324.0,SELL,3,0.02h,Break Even,$-1.50,$-3.00,$98667.50,194,$-3.00
2024-09-27,00:47:00,20338.25,BUY,3,0.02h,Stop Loss,$-9.00,$-12.00,$98658.50,194,$-12.00
2024-09-27,00:55:00,20332.0,SELL,3,0.02h,Stop Loss,$9.00,$-3.00,$98667.50,194,$-3.00
2024-09-27,01:00:00,20336.0,BUY,3,0.02h,Break Even,$-1.50,$-4.50,$98666.00,194,$-4.50
2024-09-27,01:01:00,20330.75,SELL,3,0.02h,Break Even,$-1.50,$-6.00,$98664.50,194,$-6.00
2024-09-27,01:03:00,20335.5,BUY,3,0.02h,Stop Loss,$13.50,$7.50,$98678.00,194,$7.50
2024-09-27,01:16:00,20331.5,SELL,3,0.02h,Break Even,$-1.50,$6.00,$98676.50,194,$6.00
2024-09-27,02:21:00,20302.75,BUY,3,0.02h,Break Even,$-1.50,$4.50,$98675.00,194,$4.50
2024-09-27,02:27:00,20298.0,SELL,3,0.02h,Stop Loss,$36.00,$40.50,$98711.00,194,$40.50
2024-09-27,02:50:00,20296.5,BUY,3,0.02h,Break Even,$-1.50,$39.00,$98709.50,194,$39.00
2024-09-27,02:58:00,20294.0,SELL,3,0.02h,Break Even,$-1.50,$37.50,$98708.00,194,$37.50
2024-09-27,03:00:00,20295.5,BUY,3,0.02h,Break Even,$-1.50,$36.00,$98706.50,194,$36.00
2024-09-27,03:06:00,20293.75,SELL,3,0.02h,Stop Loss,$-9.00,$27.00,$98697.50,194,$27.00
2024-09-27,03:08:00,20295.5,BUY,3,0.02h,Stop Loss,$-9.00,$18.00,$98688.50,194,$18.00
2024-09-27,03:09:00,20286.0,SELL,3,0.02h,Stop Loss,$-9.00,$9.00,$98679.50,194,$9.00
2024-09-27,03:22:00,20294.25,BUY,3,0.02h,Stop Loss,$-9.00,$0.00,$98670.50,194,$0.00
2024-09-27,04:28:00,20321.5,SELL,3,0.02h,Stop Loss,$-9.00,$-9.00,$98661.50,194,$-9.00
2024-09-27,04:30:00,20329.0,BUY,3,0.02h,Stop Loss,$4.50,$-4.50,$98666.00,194,$-4.50
2024-09-27,05:17:00,20341.75,SELL,3,0.02h,Stop Loss,$-9.00,$-13.50,$98657.00,194,$-13.50
2024-09-27,05:59:00,20319.0,BUY,3,0.02h,Stop Loss,$6.00,$-7.50,$98663.00,194,$-7.50
2024-09-27,06:15:00,20311.0,SELL,3,0.02h,Stop Loss,$22.50,$15.00,$98685.50,194,$15.00
2024-09-27,07:00:00,20273.75,BUY,3,0.02h,Stop Loss,$15.00,$30.00,$98700.50,194,$30.00
2024-09-27,07:24:00,20273.25,SELL,3,0.02h,Break Even,$-1.50,$28.50,$98699.00,194,$28.50
2024-09-27,08:03:00,20267.5,BUY,3,0.02h,Break Even,$-1.50,$27.00,$98697.50,194,$27.00
2024-09-27,08:45:00,20286.5,SELL,3,0.02h,Stop Loss,$-9.00,$18.00,$98688.50,194,$18.00
2024-09-27,09:02:00,20302.5,BUY,3,0.02h,Break Even,$-1.50,$16.50,$98687.00,194,$16.50
2024-09-27,09:27:00,20297.25,SELL,3,0.02h,Stop Loss,$-9.00,$7.50,$98678.00,194,$7.50
2024-09-27,09:47:00,20301.25,BUY,3,0.02h,Break Even,$-1.50,$6.00,$98676.50,194,$6.00
2024-09-27,10:20:00,20302.5,SELL,3,0.02h,Stop Loss,$-9.00,$-3.00,$98667.50,194,$-3.00
2024-09-27,10:52:00,20298.5,BUY,3,0.02h,Break Even,$-1.50,$-4.50,$98666.00,194,$-4.50
2024-09-27,10:54:00,20292.25,SELL,3,0.02h,Stop Loss,$-9.00,$-13.50,$98657.00,194,$-13.50
2024-09-27,11:02:00,20300.25,BUY,3,0.02h,Stop Loss,$31.50,$18.00,$98688.50,194,$18.00
2024-09-27,12:55:00,20361.5,SELL,3,0.02h,Stop Loss,$-9.00,$9.00,$98679.50,194,$9.00
2024-09-27,13:05:00,20379.25,BUY,3,0.02h,Stop Loss,$10.50,$19.50,$98690.00,194,$19.50
2024-09-27,13:26:00,20373.5,SELL,3,0.02h,Break Even,$-1.50,$18.00,$98688.50,194,$18.00
2024-09-27,14:04:00,20370.25,BUY,3,0.02h,Stop Loss,$12.00,$30.00,$98700.50,194,$30.00
2024-09-27,14:06:00,20331.0,SELL,3,0.02h,Break Even,$-1.50,$28.50,$98699.00,194,$28.50
2024-09-27,14:42:00,20325.5,BUY,3,0.02h,Stop Loss,$4.50,$33.00,$98703.50,194,$33.00
2024-09-27,14:51:00,20298.5,SELL,3,0.02h,Break Even,$-1.50,$31.50,$98702.00,194,$31.50
2024-09-27,15:43:00,20282.5,BUY,3,0.02h,Break Even,$-1.50,$30.00,$98700.50,194,$30.00
2024-09-27,15:50:00,20253.0,SELL,3,0.02h,Stop Loss,$99.00,$129.00,$98799.50,194,$129.00
2024-09-27,16:28:00,20249.75,BUY,3,0.02h,Stop Loss,$40.50,$169.50,$98840.00,194,$169.50
2024-09-27,17:11:00,20252.75,SELL,3,0.02h,Stop Loss,$10.50,$180.00,$98850.50,194,$180.00
2024-09-27,17:48:00,20243.75,BUY,3,0.02h,Break Even,$-1.50,$178.50,$98849.00,194,$178.50
2024-09-27,18:13:00,20255.25,SELL,3,0.02h,Stop Loss,$13.50,$192.00,$98862.50,194,$192.00
2024-09-27,18:48:00,20229.75,BUY,3,0.02h,Stop Loss,$4.50,$196.50,$98867.00,194,$196.50
2024-09-27,19:24:00,20235.75,SELL,3,0.02h,Stop Loss,$25.50,$222.00,$98892.50,194,$222.00
2024-09-27,19:54:00,20232.25,BUY,3,0.02h,Stop Loss,$45.00,$267.00,$98937.50,194,$267.00
2024-09-27,20:00:00,20223.0,SELL,3,0.02h,Stop Loss,$43.50,$310.50,$98981.00,194,$310.50
2024-09-27,20:34:00,20207.25,BUY,3,0.02h,Stop Loss,$-9.00,$301.50,$98972.00,194,$301.50
2024-09-27,20:38:00,20204.0,SELL,3,0.02h,Stop Loss,$4.50,$306.00,$98976.50,194,$306.00
,,,,,,,,,,,
2024-09-30,00:00:00,20273.0,BUY,3,0.02h,Stop Loss,$60.00,$60.00,$99036.50,195,$60.00
2024-09-30,00:30:00,20256.75,SELL,3,0.02h,Stop Loss,$-9.00,$51.00,$99027.50,195,$51.00
2024-09-30,02:42:00,20179.5,BUY,3,0.02h,Break Even,$-1.50,$49.50,$99026.00,195,$49.50
2024-09-30,04:17:00,20214.5,SELL,3,0.02h,Stop Loss,$-9.00,$40.50,$99017.00,195,$40.50
2024-09-30,05:10:00,20199.75,BUY,3,0.02h,Break Even,$-1.50,$39.00,$99015.50,195,$39.00
2024-09-30,05:13:00,20190.25,SELL,3,0.02h,Break Even,$-1.50,$37.50,$99014.00,195,$37.50
2024-09-30,05:26:00,20198.5,BUY,3,0.02h,Stop Loss,$-9.00,$28.50,$99005.00,195,$28.50
2024-09-30,05:39:00,20188.25,SELL,3,0.02h,Stop Loss,$-9.00,$19.50,$98996.00,195,$19.50
2024-09-30,06:40:00,20165.75,BUY,3,0.02h,Stop Loss,$-9.00,$10.50,$98987.00,195,$10.50
2024-09-30,07:59:00,20229.25,SELL,3,0.02h,Stop Loss,$25.50,$36.00,$99012.50,195,$36.00
2024-09-30,08:29:00,20204.75,BUY,3,0.02h,Break Even,$-1.50,$34.50,$99011.00,195,$34.50
2024-09-30,08:32:00,20185.0,SELL,3,0.02h,Stop Loss,$30.00,$64.50,$99041.00,195,$64.50
2024-09-30,08:43:00,20202.25,BUY,3,0.02h,Stop Loss,$-9.00,$55.50,$99032.00,195,$55.50
2024-09-30,08:49:00,20188.75,SELL,3,0.02h,Break Even,$-1.50,$54.00,$99030.50,195,$54.00
2024-09-30,09:00:00,20197.0,BUY,3,0.02h,Stop Loss,$-9.00,$45.00,$99021.50,195,$45.00
2024-09-30,09:01:00,20188.5,SELL,3,0.02h,Stop Loss,$-9.00,$36.00,$99012.50,195,$36.00
2024-09-30,09:25:00,20201.25,BUY,3,0.02h,Stop Loss,$6.00,$42.00,$99018.50,195,$42.00
2024-09-30,09:44:00,20194.25,SELL,3,0.02h,Stop Loss,$9.00,$51.00,$99027.50,195,$51.00
2024-09-30,09:49:00,20203.75,BUY,3,0.02h,Break Even,$-1.50,$49.50,$99026.00,195,$49.50
2024-09-30,10:32:00,20204.75,SELL,3,0.02h,Stop Loss,$3.00,$52.50,$99029.00,195,$52.50
2024-09-30,10:57:00,20197.0,BUY,3,0.02h,Stop Loss,$-9.00,$43.50,$99020.00,195,$43.50
2024-09-30,11:01:00,20189.0,SELL,3,0.02h,Break Even,$-1.50,$42.00,$99018.50,195,$42.00
2024-09-30,12:06:00,20143.75,BUY,3,0.02h,Stop Loss,$37.50,$79.50,$99056.00,195,$79.50
2024-09-30,12:45:00,20147.75,SELL,3,0.02h,Stop Loss,$-9.00,$70.50,$99047.00,195,$70.50
2024-09-30,12:50:00,20161.25,BUY,3,0.02h,Stop Loss,$25.50,$96.00,$99072.50,195,$96.00
2024-09-30,13:24:00,20173.25,SELL,3,0.02h,Break Even,$-1.50,$94.50,$99071.00,195,$94.50
2024-09-30,13:29:00,20178.75,BUY,3,0.02h,Stop Loss,$4.50,$99.00,$99075.50,195,$99.00
2024-09-30,13:59:00,20216.75,SELL,3,0.02h,Stop Loss,$84.00,$183.00,$99159.50,195,$183.00
2024-09-30,14:33:00,20177.75,BUY,3,0.02h,Stop Loss,$88.50,$271.50,$99248.00,195,$271.50
2024-09-30,14:47:00,20177.25,SELL,3,0.02h,Stop Loss,$42.00,$313.50,$99290.00,195,$313.50
2024-09-30,14:51:00,20186.0,BUY,3,0.02h,Stop Loss,$-9.00,$304.50,$99281.00,195,$304.50
2024-09-30,14:52:00,20178.25,SELL,3,0.02h,Break Even,$-1.50,$303.00,$99279.50,195,$303.00
2024-09-30,14:54:00,20186.25,BUY,3,0.02h,Break Even,$-1.50,$301.50,$99278.00,195,$301.50
2024-09-30,14:55:00,20177.5,SELL,3,0.02h,Break Even,$-1.50,$300.00,$99276.50,195,$300.00
2024-09-30,15:02:00,20184.5,BUY,3,0.02h,Stop Loss,$15.00,$315.00,$99291.50,195,$315.00
2024-09-30,15:38:00,20186.0,SELL,3,0.02h,Stop Loss,$13.50,$328.50,$99305.00,195,$328.50
2024-09-30,15:48:00,20217.75,BUY,3,0.02h,Break Even,$-1.50,$327.00,$99303.50,195,$327.00
2024-09-30,16:33:00,20225.75,SELL,3,0.02h,Break Even,$-1.50,$325.50,$99302.00,195,$325.50
2024-09-30,17:53:00,20188.5,BUY,3,0.02h,Stop Loss,$19.50,$345.00,$99321.50,195,$345.00
2024-09-30,18:11:00,20180.75,SELL,3,0.02h,Stop Loss,$27.00,$372.00,$99348.50,195,$372.00
2024-09-30,18:38:00,20146.75,BUY,3,0.02h,Stop Loss,$3.00,$375.00,$99351.50,195,$375.00
2024-09-30,19:02:00,20137.25,SELL,3,0.02h,Stop Loss,$28.50,$403.50,$99380.00,195,$403.50
2024-09-30,19:20:00,20156.5,BUY,3,0.02h,Break Even,$-1.50,$402.00,$99378.50,195,$402.00
2024-09-30,20:42:00,20253.5,SELL,3,0.02h,Stop Loss,$-9.00,$393.00,$99369.50,195,$393.00
2024-09-30,23:53:00,20234.0,BUY,3,0.02h,Break Even,$-1.50,$391.50,$99368.00,195,$391.50
,,,,,,,,,,,
2024-10-01,00:17:00,20222.75,SELL,3,0.02h,Stop Loss,$-9.00,$-9.00,$99359.00,196,$-9.00
2024-10-01,00:28:00,20249.0,BUY,3,0.02h,Stop Loss,$-9.00,$-18.00,$99350.00,196,$-18.00
2024-10-01,02:17:00,20313.25,SELL,3,0.02h,Stop Loss,$-9.00,$-27.00,$99341.00,196,$-27.00
2024-10-01,03:45:00,20285.25,BUY,3,0.02h,Stop Loss,$7.50,$-19.50,$99348.50,196,$-19.50
2024-10-01,04:02:00,20275.75,SELL,3,0.02h,Stop Loss,$-9.00,$-28.50,$99339.50,196,$-28.50
2024-10-01,05:14:00,20260.5,BUY,3,0.02h,Stop Loss,$3.00,$-25.50,$99342.50,196,$-25.50
2024-10-01,05:21:00,20255.5,SELL,3,0.02h,Break Even,$-1.50,$-27.00,$99341.00,196,$-27.00
2024-10-01,05:25:00,20260.5,BUY,3,0.02h,Break Even,$-1.50,$-28.50,$99339.50,196,$-28.50
2024-10-01,05:39:00,20252.5,SELL,3,0.02h,Stop Loss,$46.50,$18.00,$99386.00,196,$18.00
2024-10-01,05:51:00,20264.5,BUY,3,0.02h,Break Even,$-1.50,$16.50,$99384.50,196,$16.50
2024-10-01,06:00:00,20252.0,SELL,3,0.02h,Stop Loss,$-9.00,$7.50,$99375.50,196,$7.50
2024-10-01,06:14:00,20260.5,BUY,3,0.03h,Break Even,$-1.50,$6.00,$99374.00,196,$6.00
2024-10-01,06:57:00,20264.0,SELL,3,0.02h,Stop Loss,$16.50,$22.50,$99390.50,196,$22.50
2024-10-01,07:28:00,20255.0,BUY,3,0.02h,Break Even,$-1.50,$21.00,$99389.00,196,$21.00
2024-10-01,08:09:00,20265.0,SELL,3,0.02h,Stop Loss,$-9.00,$12.00,$99380.00,196,$12.00
2024-10-01,08:33:00,20274.0,BUY,3,0.02h,Stop Loss,$4.50,$16.50,$99384.50,196,$16.50
2024-10-01,08:52:00,20264.5,SELL,3,0.02h,Stop Loss,$19.50,$36.00,$99404.00,196,$36.00
2024-10-01,09:04:00,20273.25,BUY,3,0.02h,Stop Loss,$-9.00,$27.00,$99395.00,196,$27.00
2024-10-01,09:12:00,20264.25,SELL,3,0.02h,Break Even,$-1.50,$25.50,$99393.50,196,$25.50
2024-10-01,09:28:00,20273.25,BUY,3,0.02h,Break Even,$-1.50,$24.00,$99392.00,196,$24.00
2024-10-01,11:16:00,20308.5,SELL,3,0.02h,Stop Loss,$18.00,$42.00,$99410.00,196,$42.00
2024-10-01,12:00:00,20272.25,BUY,3,0.02h,Break Even,$-1.50,$40.50,$99408.50,196,$40.50
2024-10-01,12:14:00,20272.0,SELL,3,0.02h,Stop Loss,$-9.00,$31.50,$99399.50,196,$31.50
2024-10-01,12:26:00,20283.25,BUY,3,0.02h,Break Even,$-1.50,$30.00,$99398.00,196,$30.00
2024-10-01,12:31:00,20263.75,SELL,3,0.02h,Stop Loss,$19.50,$49.50,$99417.50,196,$49.50
2024-10-01,12:55:00,20269.75,BUY,3,0.02h,Break Even,$-1.50,$48.00,$99416.00,196,$48.00
2024-10-01,13:16:00,20258.75,SELL,3,0.02h,Break Even,$-1.50,$46.50,$99414.50,196,$46.50
2024-10-01,14:43:00,19960.5,BUY,3,0.02h,Stop Loss,$3.00,$49.50,$99417.50,196,$49.50
2024-10-01,14:53:00,19921.0,SELL,3,0.02h,Break Even,$-1.50,$48.00,$99416.00,196,$48.00
2024-10-01,15:30:00,19893.5,BUY,3,0.02h,Stop Loss,$16.50,$64.50,$99432.50,196,$64.50
2024-10-01,16:02:00,19919.5,SELL,3,0.02h,Stop Loss,$13.50,$78.00,$99446.00,196,$78.00
2024-10-01,16:04:00,19955.5,BUY,3,0.02h,Stop Loss,$61.50,$139.50,$99507.50,196,$139.50
2024-10-01,16:27:00,19948.25,SELL,3,0.02h,Stop Loss,$81.00,$220.50,$99588.50,196,$220.50
2024-10-01,16:56:00,19927.5,BUY,3,0.02h,Stop Loss,$21.00,$241.50,$99609.50,196,$241.50
2024-10-01,17:05:00,19894.5,SELL,3,0.02h,Stop Loss,$96.00,$337.50,$99705.50,196,$337.50
2024-10-01,17:33:00,19888.5,BUY,3,0.02h,Stop Loss,$93.00,$430.50,$99798.50,196,$430.50
2024-10-01,18:53:00,20040.0,SELL,3,0.02h,Stop Loss,$43.50,$474.00,$99842.00,196,$474.00
2024-10-01,18:57:00,20061.0,BUY,3,0.02h,Stop Loss,$7.50,$481.50,$99849.50,196,$481.50
2024-10-01,19:06:00,20044.5,SELL,3,0.02h,Break Even,$-1.50,$480.00,$99848.00,196,$480.00
2024-10-01,19:08:00,20053.5,BUY,3,0.02h,Stop Loss,$45.00,$525.00,$99893.00,196,$525.00
2024-10-01,19:13:00,20039.0,SELL,3,0.02h,Stop Loss,$46.50,$571.50,$99939.50,196,$571.50
2024-10-01,20:02:00,20008.75,BUY,3,0.02h,Stop Loss,$30.00,$601.50,$99969.50,196,$601.50
2024-10-01,20:09:00,19983.0,SELL,3,0.02h,Stop Loss,$-9.00,$592.50,$99960.50,196,$592.50
2024-10-01,23:40:00,19924.0,BUY,3,0.02h,Break Even,$-1.50,$591.00,$99959.00,196,$591.00
,,,,,,,,,,,
2024-10-02,00:22:00,19934.25,SELL,3,0.02h,Stop Loss,$-9.00,$-9.00,$99950.00,197,$-9.00
2024-10-02,00:38:00,19947.0,BUY,3,0.02h,Break Even,$-1.50,$-10.50,$99948.50,197,$-10.50
2024-10-02,00:55:00,19942.5,SELL,3,0.02h,Stop Loss,$7.50,$-3.00,$99956.00,197,$-3.00
2024-10-02,01:01:00,19953.25,BUY,3,0.02h,Break Even,$-1.50,$-4.50,$99954.50,197,$-4.50
2024-10-02,01:16:00,19947.75,SELL,3,0.02h,Stop Loss,$-9.00,$-13.50,$99945.50,197,$-13.50
2024-10-02,01:17:00,19953.0,BUY,3,0.02h,Stop Loss,$-9.00,$-22.50,$99936.50,197,$-22.50
2024-10-02,02:21:00,19979.75,SELL,3,0.02h,Stop Loss,$16.50,$-6.00,$99953.00,197,$-6.00
2024-10-02,02:52:00,19975.5,BUY,3,0.02h,Stop Loss,$-9.00,$-15.00,$99944.00,197,$-15.00
2024-10-02,02:54:00,19966.75,SELL,3,0.02h,Stop Loss,$-9.00,$-24.00,$99935.00,197,$-24.00
2024-10-02,02:56:00,19974.75,BUY,3,0.02h,Stop Loss,$-9.00,$-33.00,$99926.00,197,$-33.00
2024-10-02,03:00:00,19967.0,SELL,3,0.02h,Break Even,$-1.50,$-34.50,$99924.50,197,$-34.50
2024-10-02,03:30:00,19960.5,BUY,3,0.02h,Stop Loss,$10.50,$-24.00,$99935.00,197,$-24.00
2024-10-02,04:11:00,19978.75,SELL,3,0.02h,Stop Loss,$-9.00,$-33.00,$99926.00,197,$-33.00
2024-10-02,05:09:00,19942.25,BUY,3,0.02h,Break Even,$-1.50,$-34.50,$99924.50,197,$-34.50
2024-10-02,05:10:00,19935.75,SELL,3,0.02h,Stop Loss,$-9.00,$-43.50,$99915.50,197,$-43.50
2024-10-02,05:12:00,19941.75,BUY,3,0.02h,Stop Loss,$-9.00,$-52.50,$99906.50,197,$-52.50
2024-10-02,05:13:00,19932.75,SELL,3,0.02h,Stop Loss,$22.50,$-30.00,$99929.00,197,$-30.00
2024-10-02,05:47:00,19916.75,BUY,3,0.02h,Break Even,$-1.50,$-31.50,$99927.50,197,$-31.50
2024-10-02,05:48:00,19896.0,SELL,3,0.02h,Stop Loss,$-9.00,$-40.50,$99918.50,197,$-40.50
2024-10-02,06:00:00,19921.25,BUY,3,0.02h,Stop Loss,$13.50,$-27.00,$99932.00,197,$-27.00
2024-10-02,06:09:00,19900.0,SELL,3,0.02h,Stop Loss,$22.50,$-4.50,$99954.50,197,$-4.50
2024-10-02,06:15:00,19915.0,BUY,3,0.02h,Stop Loss,$-9.00,$-13.50,$99945.50,197,$-13.50
2024-10-02,06:21:00,19901.75,SELL,3,0.02h,Break Even,$-1.50,$-15.00,$99944.00,197,$-15.00
2024-10-02,06:30:00,19914.25,BUY,3,0.02h,Stop Loss,$-9.00,$-24.00,$99935.00,197,$-24.00
2024-10-02,06:33:00,19904.5,SELL,3,0.02h,Stop Loss,$21.00,$-3.00,$99956.00,197,$-3.00
2024-10-02,06:35:00,19914.25,BUY,3,0.02h,Stop Loss,$43.50,$40.50,$99999.50,197,$40.50
2024-10-02,06:49:00,19906.5,SELL,3,0.02h,Stop Loss,$18.00,$58.50,$100017.50,197,$58.50
2024-10-02,06:54:00,19924.0,BUY,3,0.02h,Stop Loss,$7.50,$66.00,$100025.00,197,$66.00
2024-10-02,07:12:00,19904.25,SELL,3,0.02h,Stop Loss,$13.50,$79.50,$100038.50,197,$79.50
2024-10-02,07:18:00,19938.0,BUY,3,0.02h,Stop Loss,$19.50,$99.00,$100058.00,197,$99.00
2024-10-02,07:23:00,19914.25,SELL,3,0.02h,Stop Loss,$13.50,$112.50,$100071.50,197,$112.50
2024-10-02,07:28:00,19944.75,BUY,3,0.02h,Break Even,$-1.50,$111.00,$100070.00,197,$111.00
2024-10-02,08:02:00,19936.5,SELL,3,0.02h,Stop Loss,$4.50,$115.50,$100074.50,197,$115.50
2024-10-02,08:07:00,19961.0,BUY,3,0.02h,Stop Loss,$-9.00,$106.50,$100065.50,197,$106.50
2024-10-02,08:19:00,19948.25,SELL,3,0.02h,Stop Loss,$10.50,$117.00,$100076.00,197,$117.00
2024-10-02,08:33:00,19963.5,BUY,3,0.02h,Stop Loss,$-9.00,$108.00,$100067.00,197,$108.00
2024-10-02,08:44:00,19946.0,SELL,3,0.02h,Break Even,$-1.50,$106.50,$100065.50,197,$106.50
2024-10-02,09:32:00,19932.0,BUY,3,0.02h,Break Even,$-1.50,$105.00,$100064.00,197,$105.00
2024-10-02,09:44:00,19923.25,SELL,3,0.02h,Break Even,$-1.50,$103.50,$100062.50,197,$103.50
2024-10-02,10:20:00,19918.75,BUY,3,0.02h,Break Even,$-1.50,$102.00,$100061.00,197,$102.00
2024-10-02,11:07:00,19945.25,SELL,3,0.02h,Stop Loss,$43.50,$145.50,$100104.50,197,$145.50
2024-10-02,11:17:00,19951.0,BUY,3,0.02h,Stop Loss,$-9.00,$136.50,$100095.50,197,$136.50
2024-10-02,11:18:00,19940.5,SELL,3,0.02h,Stop Loss,$4.50,$141.00,$100100.00,197,$141.00
2024-10-02,11:26:00,19961.5,BUY,3,0.02h,Break Even,$-1.50,$139.50,$100098.50,197,$139.50
2024-10-02,11:52:00,19948.0,SELL,3,0.02h,Stop Loss,$-9.00,$130.50,$100089.50,197,$130.50
2024-10-02,12:16:00,19958.25,BUY,3,0.02h,Stop Loss,$-9.00,$121.50,$100080.50,197,$121.50
2024-10-02,12:30:00,19931.5,SELL,3,0.02h,Stop Loss,$-9.00,$112.50,$100071.50,197,$112.50
2024-10-02,12:37:00,19960.0,BUY,3,0.02h,Stop Loss,$39.00,$151.50,$100110.50,197,$151.50
2024-10-02,13:01:00,19963.75,SELL,3,0.02h,Stop Loss,$36.00,$187.50,$100146.50,197,$187.50
2024-10-02,13:56:00,19922.75,BUY,3,0.02h,Break Even,$-1.50,$186.00,$100145.00,197,$186.00
2024-10-02,14:57:00,20002.25,SELL,3,0.02h,Stop Loss,$7.50,$193.50,$100152.50,197,$193.50
2024-10-02,15:04:00,20033.25,BUY,3,0.02h,Stop Loss,$40.50,$234.00,$100193.00,197,$234.00
2024-10-02,15:55:00,20046.0,SELL,3,0.02h,Stop Loss,$27.00,$261.00,$100220.00,197,$261.00
2024-10-02,16:02:00,20062.25,BUY,3,0.02h,Stop Loss,$58.50,$319.50,$100278.50,197,$319.50
2024-10-02,16:20:00,20047.5,SELL,3,0.02h,Stop Loss,$52.50,$372.00,$100331.00,197,$372.00
2024-10-02,16:27:00,20075.25,BUY,3,0.02h,Break Even,$-1.50,$370.50,$100329.50,197,$370.50
2024-10-02,16:32:00,20049.25,SELL,3,0.02h,Break Even,$-1.50,$369.00,$100328.00,197,$369.00
2024-10-02,17:29:00,20018.5,BUY,3,0.02h,Break Even,$-1.50,$367.50,$100326.50,197,$367.50
2024-10-02,17:35:00,19976.25,SELL,3,0.02h,Stop Loss,$28.50,$396.00,$100355.00,197,$396.00
2024-10-02,17:39:00,20005.75,BUY,3,0.02h,Stop Loss,$15.00,$411.00,$100370.00,197,$411.00
2024-10-02,18:25:00,20036.0,SELL,3,0.02h,Break Even,$-1.50,$409.50,$100368.50,197,$409.50
2024-10-02,19:05:00,20028.75,BUY,3,0.02h,Break Even,$-1.50,$408.00,$100367.00,197,$408.00
2024-10-02,19:41:00,20024.75,SELL,3,0.02h,Stop Loss,$-9.00,$399.00,$100358.00,197,$399.00
2024-10-02,19:45:00,20043.75,BUY,3,0.02h,Stop Loss,$25.50,$424.50,$100383.50,197,$424.50
2024-10-02,19:55:00,20030.75,SELL,3,0.02h,Stop Loss,$30.00,$454.50,$100413.50,197,$454.50
2024-10-02,20:11:00,20035.5,BUY,3,0.02h,Stop Loss,$3.00,$457.50,$100416.50,197,$457.50
2024-10-02,23:00:00,20044.5,SELL,3,0.02h,Break Even,$-1.50,$456.00,$100415.00,197,$456.00
2024-10-02,23:37:00,20043.5,BUY,3,0.02h,Break Even,$-1.50,$454.50,$100413.50,197,$454.50
,,,,,,,,,,,
2024-10-03,00:05:00,20027.5,SELL,3,0.02h,Stop Loss,$102.00,$102.00,$100515.50,198,$102.00
2024-10-03,01:03:00,20008.5,BUY,3,0.02h,Break Even,$-1.50,$100.50,$100514.00,198,$100.50
2024-10-03,01:10:00,19976.0,SELL,3,0.02h,Break Even,$-1.50,$99.00,$100512.50,198,$99.00
2024-10-03,01:54:00,19972.75,BUY,3,0.02h,Stop Loss,$-9.00,$90.00,$100503.50,198,$90.00
2024-10-03,02:10:00,19966.0,SELL,3,0.02h,Break Even,$-1.50,$88.50,$100502.00,198,$88.50
2024-10-03,02:27:00,19978.5,BUY,3,0.02h,Stop Loss,$-9.00,$79.50,$100493.00,198,$79.50
2024-10-03,02:54:00,19965.5,SELL,3,0.02h,Stop Loss,$4.50,$84.00,$100497.50,198,$84.00
2024-10-03,03:14:00,19977.5,BUY,3,0.02h,Break Even,$-1.50,$82.50,$100496.00,198,$82.50
2024-10-03,03:29:00,19969.5,SELL,3,0.02h,Stop Loss,$-9.00,$73.50,$100487.00,198,$73.50
2024-10-03,04:05:00,19952.0,BUY,3,0.02h,Stop Loss,$-9.00,$64.50,$100478.00,198,$64.50
2024-10-03,04:22:00,19949.5,SELL,3,0.02h,Stop Loss,$-9.00,$55.50,$100469.00,198,$55.50
2024-10-03,04:24:00,19953.5,BUY,3,0.02h,Break Even,$-1.50,$54.00,$100467.50,198,$54.00
2024-10-03,04:28:00,19950.0,SELL,3,0.02h,Stop Loss,$-9.00,$45.00,$100458.50,198,$45.00
2024-10-03,04:31:00,19956.25,BUY,3,0.02h,Stop Loss,$-9.00,$36.00,$100449.50,198,$36.00
2024-10-03,04:42:00,19949.5,SELL,3,0.02h,Break Even,$-1.50,$34.50,$100448.00,198,$34.50
2024-10-03,05:03:00,19949.75,BUY,3,0.02h,Break Even,$-1.50,$33.00,$100446.50,198,$33.00
2024-10-03,05:45:00,19945.5,SELL,3,0.02h,Stop Loss,$18.00,$51.00,$100464.50,198,$51.00
2024-10-03,06:07:00,19947.75,BUY,3,0.02h,Break Even,$-1.50,$49.50,$100463.00,198,$49.50
2024-10-03,06:25:00,19949.25,SELL,3,0.02h,Stop Loss,$-9.00,$40.50,$100454.00,198,$40.50
2024-10-03,06:46:00,19956.75,BUY,3,0.02h,Break Even,$-1.50,$39.00,$100452.50,198,$39.00
2024-10-03,07:10:00,19949.75,SELL,3,0.02h,Stop Loss,$22.50,$61.50,$100475.00,198,$61.50
2024-10-03,07:59:00,19882.25,BUY,3,0.02h,Stop Loss,$21.00,$82.50,$100496.00,198,$82.50
2024-10-03,08:37:00,19895.5,SELL,3,0.02h,Break Even,$-1.50,$81.00,$100494.50,198,$81.00
2024-10-03,08:38:00,19909.75,BUY,3,0.02h,Stop Loss,$36.00,$117.00,$100530.50,198,$117.00
2024-10-03,08:59:00,19908.5,SELL,3,0.02h,Break Even,$-1.50,$115.50,$100529.00,198,$115.50
2024-10-03,09:13:00,19912.5,BUY,3,0.02h,Break Even,$-1.50,$114.00,$100527.50,198,$114.00
2024-10-03,09:45:00,19916.25,SELL,3,0.02h,Break Even,$-1.50,$112.50,$100526.00,198,$112.50
2024-10-03,09:47:00,19920.75,BUY,3,0.02h,Stop Loss,$-9.00,$103.50,$100517.00,198,$103.50
2024-10-03,09:49:00,19910.5,SELL,3,0.02h,Stop Loss,$-9.00,$94.50,$100508.00,198,$94.50
2024-10-03,10:01:00,19925.0,BUY,3,0.02h,Stop Loss,$3.00,$97.50,$100511.00,198,$97.50
2024-10-03,10:13:00,19910.25,SELL,3,0.02h,Break Even,$-1.50,$96.00,$100509.50,198,$96.00
2024-10-03,10:24:00,19922.5,BUY,3,0.02h,Break Even,$-1.50,$94.50,$100508.00,198,$94.50
2024-10-03,10:43:00,19917.0,SELL,3,0.02h,Stop Loss,$-9.00,$85.50,$100499.00,198,$85.50
2024-10-03,10:46:00,19924.75,BUY,3,0.02h,Stop Loss,$-9.00,$76.50,$100490.00,198,$76.50
2024-10-03,11:17:00,19936.75,SELL,3,0.02h,Break Even,$-1.50,$75.00,$100488.50,198,$75.00
2024-10-03,11:29:00,19954.25,BUY,3,0.02h,Break Even,$-1.50,$73.50,$100487.00,198,$73.50
2024-10-03,12:25:00,19964.75,SELL,3,0.02h,Break Even,$-1.50,$72.00,$100485.50,198,$72.00
2024-10-03,12:29:00,19973.0,BUY,3,0.02h,Break Even,$-1.50,$70.50,$100484.00,198,$70.50
2024-10-03,12:30:00,19968.25,SELL,3,0.02h,Stop Loss,$40.50,$111.00,$100524.50,198,$111.00
2024-10-03,12:31:00,19974.75,BUY,3,0.02h,Stop Loss,$15.00,$126.00,$100539.50,198,$126.00
2024-10-03,12:36:00,19949.75,SELL,3,0.02h,Stop Loss,$4.50,$130.50,$100544.00,198,$130.50
2024-10-03,13:33:00,19940.5,BUY,3,0.02h,Stop Loss,$109.50,$240.00,$100653.50,198,$240.00
2024-10-03,14:20:00,20028.25,SELL,3,0.02h,Stop Loss,$69.00,$309.00,$100722.50,198,$309.00
2024-10-03,14:52:00,20019.5,BUY,3,0.02h,Stop Loss,$9.00,$318.00,$100731.50,198,$318.00
2024-10-03,15:00:00,19939.75,SELL,3,0.02h,Stop Loss,$19.50,$337.50,$100751.00,198,$337.50
2024-10-03,15:17:00,19983.0,BUY,3,0.02h,Break Even,$-1.50,$336.00,$100749.50,198,$336.00
2024-10-03,16:07:00,20030.0,SELL,3,0.02h,Stop Loss,$48.00,$384.00,$100797.50,198,$384.00
2024-10-03,16:11:00,20042.75,BUY,3,0.02h,Break Even,$-1.50,$382.50,$100796.00,198,$382.50
2024-10-03,16:17:00,20032.25,SELL,3,0.02h,Stop Loss,$22.50,$405.00,$100818.50,198,$405.00
2024-10-03,16:23:00,20047.5,BUY,3,0.02h,Stop Loss,$-9.00,$396.00,$100809.50,198,$396.00
2024-10-03,16:31:00,20014.0,SELL,3,0.02h,Stop Loss,$9.00,$405.00,$100818.50,198,$405.00
2024-10-03,17:22:00,19936.75,BUY,3,0.02h,Stop Loss,$42.00,$447.00,$100860.50,198,$447.00
2024-10-03,17:43:00,19937.75,SELL,3,0.02h,Break Even,$-1.50,$445.50,$100859.00,198,$445.50
2024-10-03,17:46:00,19960.25,BUY,3,0.02h,Stop Loss,$4.50,$450.00,$100863.50,198,$450.00
2024-10-03,17:51:00,19941.5,SELL,3,0.02h,Break Even,$-1.50,$448.50,$100862.00,198,$448.50
2024-10-03,17:55:00,19956.25,BUY,3,0.02h,Stop Loss,$34.50,$483.00,$100896.50,198,$483.00
2024-10-03,18:18:00,19955.75,SELL,3,0.02h,Break Even,$-1.50,$481.50,$100895.00,198,$481.50
2024-10-03,18:20:00,19965.75,BUY,3,0.02h,Break Even,$-1.50,$480.00,$100893.50,198,$480.00
2024-10-03,18:23:00,19933.75,SELL,3,0.02h,Break Even,$-1.50,$478.50,$100892.00,198,$478.50
2024-10-03,18:41:00,19956.5,BUY,3,0.02h,Stop Loss,$28.50,$507.00,$100920.50,198,$507.00
2024-10-03,18:58:00,19948.5,SELL,3,0.02h,Stop Loss,$10.50,$517.50,$100931.00,198,$517.50
2024-10-03,19:25:00,19940.0,BUY,3,0.02h,Break Even,$-1.50,$516.00,$100929.50,198,$516.00
2024-10-03,19:29:00,19918.0,SELL,3,0.02h,Stop Loss,$-9.00,$507.00,$100920.50,198,$507.00
2024-10-03,19:35:00,19944.25,BUY,3,0.02h,Stop Loss,$9.00,$516.00,$100929.50,198,$516.00
2024-10-03,20:26:00,19983.5,SELL,3,0.02h,Break Even,$-1.50,$514.50,$100928.00,198,$514.50
2024-10-03,23:01:00,19987.0,BUY,3,0.02h,Break Even,$-1.50,$513.00,$100926.50,198,$513.00
2024-10-03,23:22:00,19972.75,SELL,3,0.02h,Stop Loss,$7.50,$520.50,$100934.00,198,$520.50
2024-10-03,23:32:00,19980.75,BUY,3,0.02h,Stop Loss,$-9.00,$511.50,$100925.00,198,$511.50
2024-10-03,23:33:00,19973.0,SELL,3,0.02h,Break Even,$-1.50,$510.00,$100923.50,198,$510.00
2024-10-03,23:46:00,19983.0,BUY,3,0.02h,Stop Loss,$3.00,$513.00,$100926.50,198,$513.00
,,,,,,,,,,,
2024-10-04,00:05:00,19974.25,SELL,3,0.02h,Break Even,$-1.50,$-1.50,$100925.00,199,$-1.50
2024-10-04,00:50:00,19964.25,BUY,3,0.02h,Stop Loss,$18.00,$16.50,$100943.00,199,$16.50
2024-10-04,02:52:00,20049.5,SELL,3,0.02h,Stop Loss,$46.50,$63.00,$100989.50,199,$63.00
2024-10-04,04:05:00,20021.5,BUY,3,0.02h,Stop Loss,$-9.00,$54.00,$100980.50,199,$54.00
2024-10-04,04:39:00,20016.0,SELL,3,0.02h,Break Even,$-1.50,$52.50,$100979.00,199,$52.50
2024-10-04,05:06:00,20010.5,BUY,3,0.02h,Stop Loss,$22.50,$75.00,$101001.50,199,$75.00
2024-10-04,05:35:00,20017.0,SELL,3,0.02h,Stop Loss,$13.50,$88.50,$101015.00,199,$88.50
2024-10-04,05:45:00,20025.5,BUY,3,0.02h,Stop Loss,$-9.00,$79.50,$101006.00,199,$79.50
2024-10-04,05:51:00,20012.75,SELL,3,0.02h,Stop Loss,$19.50,$99.00,$101025.50,199,$99.00
2024-10-04,05:56:00,20018.5,BUY,3,0.02h,Break Even,$-1.50,$97.50,$101024.00,199,$97.50
2024-10-04,05:58:00,20016.75,SELL,3,0.02h,Stop Loss,$-9.00,$88.50,$101015.00,199,$88.50
2024-10-04,06:21:00,20014.0,BUY,3,0.02h,Break Even,$-1.50,$87.00,$101013.50,199,$87.00
2024-10-04,06:30:00,20007.0,SELL,3,0.02h,Stop Loss,$4.50,$91.50,$101018.00,199,$91.50
2024-10-04,07:14:00,20012.5,BUY,3,0.02h,Break Even,$-1.50,$90.00,$101016.50,199,$90.00
2024-10-04,07:49:00,20018.75,SELL,3,0.02h,Break Even,$-1.50,$88.50,$101015.00,199,$88.50
2024-10-04,07:51:00,20029.25,BUY,3,0.02h,Stop Loss,$6.00,$94.50,$101021.00,199,$94.50
2024-10-04,08:08:00,20018.0,SELL,3,0.02h,Stop Loss,$3.00,$97.50,$101024.00,199,$97.50
2024-10-04,08:25:00,20020.5,BUY,3,0.02h,Stop Loss,$6.00,$103.50,$101030.00,199,$103.50
2024-10-04,08:34:00,20011.25,SELL,3,0.02h,Stop Loss,$-9.00,$94.50,$101021.00,199,$94.50
2024-10-04,08:38:00,20021.5,BUY,3,0.02h,Break Even,$-1.50,$93.00,$101019.50,199,$93.00
2024-10-04,08:49:00,20015.5,SELL,3,0.02h,Stop Loss,$-9.00,$84.00,$101010.50,199,$84.00
2024-10-04,09:10:00,20017.75,BUY,3,0.02h,Break Even,$-1.50,$82.50,$101009.00,199,$82.50
2024-10-04,09:13:00,20007.0,SELL,3,0.02h,Stop Loss,$-9.00,$73.50,$101000.00,199,$73.50
2024-10-04,09:31:00,20015.5,BUY,3,0.02h,Stop Loss,$31.50,$105.00,$101031.50,199,$105.00
2024-10-04,10:48:00,20055.0,SELL,3,0.02h,Break Even,$-1.50,$103.50,$101030.00,199,$103.50
2024-10-04,11:07:00,20059.0,BUY,3,0.02h,Stop Loss,$-9.00,$94.50,$101021.00,199,$94.50
2024-10-04,11:08:00,20051.5,SELL,3,0.02h,Stop Loss,$-9.00,$85.50,$101012.00,199,$85.50
2024-10-04,11:10:00,20056.75,BUY,3,0.02h,Stop Loss,$6.00,$91.50,$101018.00,199,$91.50
2024-10-04,11:14:00,20052.75,SELL,3,0.02h,Stop Loss,$-9.00,$82.50,$101009.00,199,$82.50
2024-10-04,11:15:00,20058.5,BUY,3,0.02h,Stop Loss,$15.00,$97.50,$101024.00,199,$97.50
2024-10-04,11:45:00,20064.0,SELL,3,0.02h,Stop Loss,$16.50,$114.00,$101040.50,199,$114.00
2024-10-04,12:17:00,20071.0,BUY,3,0.02h,Stop Loss,$-9.00,$105.00,$101031.50,199,$105.00
2024-10-04,12:23:00,20057.5,SELL,3,0.02h,Break Even,$-1.50,$103.50,$101030.00,199,$103.50
2024-10-04,12:24:00,20063.75,BUY,3,0.02h,Stop Loss,$45.00,$148.50,$101075.00,199,$148.50
2024-10-04,13:25:00,20225.0,SELL,3,0.02h,Break Even,$-1.50,$147.00,$101073.50,199,$147.00
2024-10-04,14:44:00,20079.25,BUY,3,0.02h,Stop Loss,$79.50,$226.50,$101153.00,199,$226.50
2024-10-04,15:16:00,20099.0,SELL,3,0.02h,Break Even,$-1.50,$225.00,$101151.50,199,$225.00
2024-10-04,15:53:00,20088.0,BUY,3,0.02h,Stop Loss,$67.50,$292.50,$101219.00,199,$292.50
2024-10-04,16:14:00,20100.25,SELL,3,0.02h,Stop Loss,$28.50,$321.00,$101247.50,199,$321.00
2024-10-04,16:34:00,20111.75,BUY,3,0.02h,Stop Loss,$-9.00,$312.00,$101238.50,199,$312.00
2024-10-04,17:03:00,20142.75,SELL,3,0.02h,Stop Loss,$-9.00,$303.00,$101229.50,199,$303.00
2024-10-04,17:16:00,20156.5,BUY,3,0.02h,Stop Loss,$39.00,$342.00,$101268.50,199,$342.00
2024-10-04,17:30:00,20145.0,SELL,3,0.02h,Stop Loss,$15.00,$357.00,$101283.50,199,$357.00
2024-10-04,17:45:00,20168.0,BUY,3,0.02h,Stop Loss,$-9.00,$348.00,$101274.50,199,$348.00
2024-10-04,17:54:00,20130.0,SELL,3,0.02h,Stop Loss,$22.50,$370.50,$101297.00,199,$370.50
2024-10-04,18:23:00,20141.75,BUY,3,0.02h,Stop Loss,$-9.00,$361.50,$101288.00,199,$361.50
2024-10-04,20:17:00,20214.0,SELL,3,0.02h,Stop Loss,$-9.00,$352.50,$101279.00,199,$352.50
,,,,,,,,,,,
2024-10-07,00:00:00,20231.0,BUY,3,0.02h,Stop Loss,$13.50,$13.50,$101292.50,200,$13.50
2024-10-07,00:12:00,20205.0,SELL,3,0.02h,Break Even,$-1.50,$12.00,$101291.00,200,$12.00
2024-10-07,00:38:00,20213.25,BUY,3,0.02h,Break Even,$-1.50,$10.50,$101289.50,200,$10.50
2024-10-07,00:48:00,20205.75,SELL,3,0.02h,Break Even,$-1.50,$9.00,$101288.00,200,$9.00
2024-10-07,00:56:00,20217.5,BUY,3,0.02h,Stop Loss,$3.00,$12.00,$101291.00,200,$12.00
2024-10-07,01:49:00,20234.25,SELL,3,0.02h,Stop Loss,$57.00,$69.00,$101348.00,200,$69.00
2024-10-07,02:10:00,20232.5,BUY,3,0.02h,Stop Loss,$3.00,$72.00,$101351.00,200,$72.00
2024-10-07,02:12:00,20223.25,SELL,3,0.02h,Stop Loss,$4.50,$76.50,$101355.50,200,$76.50
2024-10-07,02:51:00,20220.75,BUY,3,0.02h,Stop Loss,$3.00,$79.50,$101358.50,200,$79.50
2024-10-07,03:18:00,20219.0,SELL,3,0.02h,Break Even,$-1.50,$78.00,$101357.00,200,$78.00
2024-10-07,03:46:00,20215.75,BUY,3,0.02h,Stop Loss,$-9.00,$69.00,$101348.00,200,$69.00
2024-10-07,04:15:00,20216.0,SELL,3,0.02h,Break Even,$-1.50,$67.50,$101346.50,200,$67.50
2024-10-07,04:20:00,20220.25,BUY,3,0.02h,Stop Loss,$-9.00,$58.50,$101337.50,200,$58.50
2024-10-07,04:50:00,20223.25,SELL,3,0.02h,Stop Loss,$12.00,$70.50,$101349.50,200,$70.50
2024-10-07,06:10:00,20195.75,BUY,3,0.02h,Stop Loss,$4.50,$75.00,$101354.00,200,$75.00
2024-10-07,06:19:00,20189.0,SELL,3,0.02h,Stop Loss,$-9.00,$66.00,$101345.00,200,$66.00
2024-10-07,06:21:00,20197.0,BUY,3,0.02h,Stop Loss,$4.50,$70.50,$101349.50,200,$70.50
2024-10-07,06:27:00,20190.5,SELL,3,0.02h,Break Even,$-1.50,$69.00,$101348.00,200,$69.00
2024-10-07,06:44:00,20192.75,BUY,3,0.02h,Stop Loss,$25.50,$94.50,$101373.50,200,$94.50
2024-10-07,07:03:00,20193.75,SELL,3,0.02h,Break Even,$-1.50,$93.00,$101372.00,200,$93.00
2024-10-07,07:09:00,20209.75,BUY,3,0.02h,Break Even,$-1.50,$91.50,$101370.50,200,$91.50
2024-10-07,07:13:00,20187.0,SELL,3,0.02h,Break Even,$-1.50,$90.00,$101369.00,200,$90.00
2024-10-07,07:53:00,20159.75,BUY,3,0.02h,Stop Loss,$-9.00,$81.00,$101360.00,200,$81.00
2024-10-07,07:57:00,20143.75,SELL,3,0.02h,Stop Loss,$7.50,$88.50,$101367.50,200,$88.50
2024-10-07,08:05:00,20164.25,BUY,3,0.02h,Stop Loss,$-9.00,$79.50,$101358.50,200,$79.50
2024-10-07,08:16:00,20143.25,SELL,3,0.02h,Break Even,$-1.50,$78.00,$101357.00,200,$78.00
2024-10-07,08:33:00,20159.0,BUY,3,0.02h,Stop Loss,$10.50,$88.50,$101367.50,200,$88.50
2024-10-07,08:40:00,20142.25,SELL,3,0.02h,Break Even,$-1.50,$87.00,$101366.00,200,$87.00
2024-10-07,09:40:00,20088.5,BUY,3,0.02h,Break Even,$-1.50,$85.50,$101364.50,200,$85.50
2024-10-07,10:10:00,20080.25,SELL,3,0.02h,Break Even,$-1.50,$84.00,$101363.00,200,$84.00
2024-10-07,10:17:00,20095.75,BUY,3,0.02h,Stop Loss,$-9.00,$75.00,$101354.00,200,$75.00
2024-10-07,10:48:00,20092.25,SELL,3,0.02h,Break Even,$-1.50,$73.50,$101352.50,200,$73.50
2024-10-07,10:49:00,20097.5,BUY,3,0.02h,Break Even,$-1.50,$72.00,$101351.00,200,$72.00
2024-10-07,11:01:00,20089.5,SELL,3,0.02h,Stop Loss,$9.00,$81.00,$101360.00,200,$81.00
2024-10-07,11:09:00,20102.75,BUY,3,0.02h,Stop Loss,$-9.00,$72.00,$101351.00,200,$72.00
2024-10-07,11:16:00,20093.75,SELL,3,0.02h,Stop Loss,$30.00,$102.00,$101381.00,200,$102.00
2024-10-07,11:26:00,20101.25,BUY,3,0.02h,Stop Loss,$-9.00,$93.00,$101372.00,200,$93.00
2024-10-07,11:32:00,20093.0,SELL,3,0.02h,Break Even,$-1.50,$91.50,$101370.50,200,$91.50
2024-10-07,11:40:00,20098.0,BUY,3,0.02h,Break Even,$-1.50,$90.00,$101369.00,200,$90.00
2024-10-07,12:56:00,20128.0,SELL,3,0.02h,Stop Loss,$22.50,$112.50,$101391.50,200,$112.50
2024-10-07,13:09:00,20142.5,BUY,3,0.02h,Stop Loss,$-9.00,$103.50,$101382.50,200,$103.50
2024-10-07,13:44:00,20118.75,SELL,3,0.02h,Stop Loss,$48.00,$151.50,$101430.50,200,$151.50
2024-10-07,14:06:00,20142.5,BUY,3,0.02h,Stop Loss,$-9.00,$142.50,$101421.50,200,$142.50
2024-10-07,14:45:00,20147.75,SELL,3,0.02h,Stop Loss,$13.50,$156.00,$101435.00,200,$156.00
2024-10-07,14:57:00,20165.25,BUY,3,0.02h,Stop Loss,$37.50,$193.50,$101472.50,200,$193.50
2024-10-07,15:02:00,20142.75,SELL,3,0.02h,Stop Loss,$79.50,$273.00,$101552.00,200,$273.00
2024-10-07,15:15:00,20158.75,BUY,3,0.02h,Break Even,$-1.50,$271.50,$101550.50,200,$271.50
2024-10-07,15:39:00,20148.5,SELL,3,0.02h,Break Even,$-1.50,$270.00,$101549.00,200,$270.00
2024-10-07,15:41:00,20168.0,BUY,3,0.02h,Break Even,$-1.50,$268.50,$101547.50,200,$268.50
2024-10-07,15:44:00,20149.25,SELL,3,0.02h,Break Even,$-1.50,$267.00,$101546.00,200,$267.00
2024-10-07,16:18:00,20159.5,BUY,3,0.02h,Break Even,$-1.50,$265.50,$101544.50,200,$265.50
2024-10-07,16:33:00,20137.0,SELL,3,0.02h,Break Even,$-1.50,$264.00,$101543.00,200,$264.00
2024-10-07,17:03:00,20150.25,BUY,3,0.02h,Stop Loss,$6.00,$270.00,$101549.00,200,$270.00
2024-10-07,17:24:00,20132.75,SELL,3,0.02h,Stop Loss,$-9.00,$261.00,$101540.00,200,$261.00
2024-10-07,17:57:00,20134.25,BUY,3,0.02h,Stop Loss,$12.00,$273.00,$101552.00,200,$273.00
2024-10-07,18:03:00,20121.5,SELL,3,0.02h,Stop Loss,$15.00,$288.00,$101567.00,200,$288.00
2024-10-07,19:23:00,20015.75,BUY,3,0.02h,Stop Loss,$7.50,$295.50,$101574.50,200,$295.50
2024-10-07,19:29:00,19994.75,SELL,3,0.02h,Stop Loss,$13.50,$309.00,$101588.00,200,$309.00
2024-10-07,19:52:00,20008.75,BUY,3,0.02h,Stop Loss,$16.50,$325.50,$101604.50,200,$325.50
2024-10-07,20:56:00,20018.5,SELL,3,0.02h,Break Even,$-1.50,$324.00,$101603.00,200,$324.00
2024-10-07,23:45:00,19989.5,BUY,3,0.02h,Stop Loss,$-9.00,$315.00,$101594.00,200,$315.00
,,,,,,,,,,,
2024-10-08,00:42:00,20014.0,SELL,3,0.02h,Break Even,$-1.50,$-1.50,$101592.50,201,$-1.50
2024-10-08,00:51:00,20021.0,BUY,3,0.02h,Stop Loss,$-9.00,$-10.50,$101583.50,201,$-10.50
2024-10-08,00:56:00,20013.75,SELL,3,0.02h,Break Even,$-1.50,$-12.00,$101582.00,201,$-12.00
2024-10-08,00:58:00,20016.75,BUY,3,0.02h,Stop Loss,$-9.00,$-21.00,$101573.00,201,$-21.00
2024-10-08,00:59:00,20014.0,SELL,3,0.02h,Stop Loss,$-9.00,$-30.00,$101564.00,201,$-30.00
2024-10-08,01:00:00,20015.75,BUY,3,0.02h,Stop Loss,$3.00,$-27.00,$101567.00,201,$-27.00
2024-10-08,01:04:00,20013.25,SELL,3,0.02h,Stop Loss,$-9.00,$-36.00,$101558.00,201,$-36.00
2024-10-08,01:05:00,20016.5,BUY,3,0.02h,Stop Loss,$-9.00,$-45.00,$101549.00,201,$-45.00
2024-10-08,01:06:00,20008.0,SELL,3,0.02h,Stop Loss,$21.00,$-24.00,$101570.00,201,$-24.00
2024-10-08,01:50:00,19989.5,BUY,3,0.02h,Stop Loss,$7.50,$-16.50,$101577.50,201,$-16.50
2024-10-08,02:04:00,19977.0,SELL,3,0.02h,Stop Loss,$25.50,$9.00,$101603.00,201,$9.00
2024-10-08,02:21:00,19983.0,BUY,3,0.02h,Break Even,$-1.50,$7.50,$101601.50,201,$7.50
2024-10-08,02:32:00,19972.25,SELL,3,0.02h,Stop Loss,$12.00,$19.50,$101613.50,201,$19.50
2024-10-08,02:42:00,19988.25,BUY,3,0.02h,Stop Loss,$-9.00,$10.50,$101604.50,201,$10.50
2024-10-08,03:21:00,19998.0,SELL,3,0.02h,Break Even,$-1.50,$9.00,$101603.00,201,$9.00
2024-10-08,03:46:00,19998.5,BUY,3,0.02h,Break Even,$-1.50,$7.50,$101601.50,201,$7.50
2024-10-08,03:51:00,19990.25,SELL,3,0.02h,Stop Loss,$22.50,$30.00,$101624.00,201,$30.00
2024-10-08,04:07:00,19992.0,BUY,3,0.02h,Stop Loss,$4.50,$34.50,$101628.50,201,$34.50
2024-10-08,04:39:00,19991.25,SELL,3,0.03h,Stop Loss,$-9.00,$25.50,$101619.50,201,$25.50
2024-10-08,04:46:00,19996.25,BUY,3,0.02h,Stop Loss,$-9.00,$16.50,$101610.50,201,$16.50
2024-10-08,05:06:00,19993.0,SELL,3,0.02h,Stop Loss,$51.00,$67.50,$101661.50,201,$67.50
2024-10-08,05:38:00,19988.5,BUY,3,0.02h,Break Even,$-1.50,$66.00,$101660.00,201,$66.00
2024-10-08,05:50:00,19975.75,SELL,3,0.02h,Stop Loss,$-9.00,$57.00,$101651.00,201,$57.00
2024-10-08,06:02:00,19985.25,BUY,3,0.02h,Break Even,$-1.50,$55.50,$101649.50,201,$55.50
2024-10-08,06:09:00,19975.25,SELL,3,0.02h,Break Even,$-1.50,$54.00,$101648.00,201,$54.00
2024-10-08,06:17:00,19982.5,BUY,3,0.02h,Break Even,$-1.50,$52.50,$101646.50,201,$52.50
2024-10-08,06:20:00,19969.0,SELL,3,0.02h,Stop Loss,$40.50,$93.00,$101687.00,201,$93.00
2024-10-08,06:34:00,19977.25,BUY,3,0.02h,Stop Loss,$-9.00,$84.00,$101678.00,201,$84.00
2024-10-08,06:58:00,19972.0,SELL,3,0.02h,Stop Loss,$-9.00,$75.00,$101669.00,201,$75.00
2024-10-08,06:59:00,19979.25,BUY,3,0.02h,Break Even,$-1.50,$73.50,$101667.50,201,$73.50
2024-10-08,07:01:00,19967.0,SELL,3,0.02h,Stop Loss,$63.00,$136.50,$101730.50,201,$136.50
2024-10-08,07:10:00,19986.75,BUY,3,0.02h,Stop Loss,$9.00,$145.50,$101739.50,201,$145.50
2024-10-08,07:18:00,19967.0,SELL,3,0.02h,Stop Loss,$-9.00,$136.50,$101730.50,201,$136.50
2024-10-08,07:33:00,19980.0,BUY,3,0.02h,Stop Loss,$27.00,$163.50,$101757.50,201,$163.50
2024-10-08,08:07:00,19992.0,SELL,3,0.02h,Break Even,$-1.50,$162.00,$101756.00,201,$162.00
2024-10-08,08:19:00,20010.75,BUY,3,0.02h,Stop Loss,$4.50,$166.50,$101760.50,201,$166.50
2024-10-08,08:25:00,19997.5,SELL,3,0.02h,Break Even,$-1.50,$165.00,$101759.00,201,$165.00
2024-10-08,08:38:00,20006.75,BUY,3,0.02h,Stop Loss,$-9.00,$156.00,$101750.00,201,$156.00
2024-10-08,10:32:00,20075.25,SELL,3,0.02h,Stop Loss,$16.50,$172.50,$101766.50,201,$172.50
2024-10-08,10:52:00,20076.0,BUY,3,0.02h,Stop Loss,$21.00,$193.50,$101787.50,201,$193.50
2024-10-08,11:18:00,20081.5,SELL,3,0.02h,Stop Loss,$-9.00,$184.50,$101778.50,201,$184.50
2024-10-08,11:20:00,20090.5,BUY,3,0.02h,Break Even,$-1.50,$183.00,$101777.00,201,$183.00
2024-10-08,11:24:00,20075.25,SELL,3,0.02h,Stop Loss,$9.00,$192.00,$101786.00,201,$192.00
2024-10-08,11:33:00,20090.75,BUY,3,0.02h,Stop Loss,$28.50,$220.50,$101814.50,201,$220.50
2024-10-08,12:07:00,20087.5,SELL,3,0.02h,Break Even,$-1.50,$219.00,$101813.00,201,$219.00
2024-10-08,13:10:00,20072.0,BUY,3,0.02h,Stop Loss,$10.50,$229.50,$101823.50,201,$229.50
2024-10-08,15:12:00,20228.25,SELL,3,0.02h,Stop Loss,$13.50,$243.00,$101837.00,201,$243.00
2024-10-08,15:42:00,20235.5,BUY,3,0.02h,Stop Loss,$12.00,$255.00,$101849.00,201,$255.00
2024-10-08,16:04:00,20230.25,SELL,3,0.02h,Stop Loss,$33.00,$288.00,$101882.00,201,$288.00
2024-10-08,16:23:00,20233.5,BUY,3,0.02h,Break Even,$-1.50,$286.50,$101880.50,201,$286.50
2024-10-08,16:25:00,20224.0,SELL,3,0.02h,Stop Loss,$-9.00,$277.50,$101871.50,201,$277.50
2024-10-08,16:28:00,20238.5,BUY,3,0.02h,Break Even,$-1.50,$276.00,$101870.00,201,$276.00
2024-10-08,16:50:00,20222.75,SELL,3,0.02h,Stop Loss,$16.50,$292.50,$101886.50,201,$292.50
2024-10-08,17:01:00,20234.5,BUY,3,0.02h,Stop Loss,$-9.00,$283.50,$101877.50,201,$283.50
2024-10-08,17:02:00,20230.75,SELL,3,0.02h,Stop Loss,$9.00,$292.50,$101886.50,201,$292.50
2024-10-08,17:35:00,20207.75,BUY,3,0.02h,Stop Loss,$37.50,$330.00,$101924.00,201,$330.00
2024-10-08,18:32:00,20228.0,SELL,3,0.02h,Stop Loss,$7.50,$337.50,$101931.50,201,$337.50
2024-10-08,18:36:00,20242.0,BUY,3,0.02h,Break Even,$-1.50,$336.00,$101930.00,201,$336.00
2024-10-08,20:01:00,20286.5,SELL,3,0.02h,Stop Loss,$18.00,$354.00,$101948.00,201,$354.00
2024-10-08,20:38:00,20292.5,BUY,3,0.02h,Break Even,$-1.50,$352.50,$101946.50,201,$352.50
2024-10-08,20:56:00,20280.5,SELL,3,0.02h,Stop Loss,$-9.00,$343.50,$101937.50,201,$343.50
2024-10-08,23:02:00,20294.5,BUY,3,0.02h,Break Even,$-1.50,$342.00,$101936.00,201,$342.00
2024-10-08,23:06:00,20283.0,SELL,3,0.02h,Stop Loss,$-9.00,$333.00,$101927.00,201,$333.00
,,,,,,,,,,,
2024-10-09,00:18:00,20276.5,BUY,3,0.02h,Stop Loss,$-9.00,$-9.00,$101918.00,202,$-9.00
2024-10-09,00:32:00,20272.0,SELL,3,0.02h,Stop Loss,$-9.00,$-18.00,$101909.00,202,$-18.00
2024-10-09,00:34:00,20277.5,BUY,3,0.02h,Stop Loss,$-9.00,$-27.00,$101900.00,202,$-27.00
2024-10-09,00:39:00,20273.0,SELL,3,0.02h,Break Even,$-1.50,$-28.50,$101898.50,202,$-28.50
2024-10-09,00:44:00,20279.5,BUY,3,0.02h,Break Even,$-1.50,$-30.00,$101897.00,202,$-30.00
2024-10-09,00:58:00,20275.25,SELL,3,0.02h,Stop Loss,$-9.00,$-39.00,$101888.00,202,$-39.00
2024-10-09,01:00:00,20277.75,BUY,3,0.02h,Stop Loss,$-9.00,$-48.00,$101879.00,202,$-48.00
2024-10-09,01:28:00,20275.0,SELL,3,0.02h,Stop Loss,$-9.00,$-57.00,$101870.00,202,$-57.00
2024-10-09,01:30:00,20282.5,BUY,3,0.02h,Stop Loss,$-9.00,$-66.00,$101861.00,202,$-66.00
2024-10-09,01:31:00,20275.0,SELL,3,0.02h,Break Even,$-1.50,$-67.50,$101859.50,202,$-67.50
2024-10-09,01:34:00,20282.0,BUY,3,0.02h,Stop Loss,$-9.00,$-76.50,$101850.50,202,$-76.50
2024-10-09,01:47:00,20273.0,SELL,3,0.02h,Stop Loss,$4.50,$-72.00,$101855.00,202,$-72.00
2024-10-09,03:24:00,20245.75,BUY,3,0.02h,Stop Loss,$-9.00,$-81.00,$101846.00,202,$-81.00
2024-10-09,03:38:00,20239.75,SELL,3,0.02h,Break Even,$-1.50,$-82.50,$101844.50,202,$-82.50
2024-10-09,04:19:00,20243.5,BUY,3,0.05h,Break Even,$-1.50,$-84.00,$101843.00,202,$-84.00
2024-10-09,04:39:00,20241.75,SELL,3,0.02h,Break Even,$-1.50,$-85.50,$101841.50,202,$-85.50
2024-10-09,05:03:00,20245.5,BUY,3,0.02h,Break Even,$-1.50,$-87.00,$101840.00,202,$-87.00
2024-10-09,05:12:00,20231.75,SELL,3,0.02h,Stop Loss,$-9.00,$-96.00,$101831.00,202,$-96.00
2024-10-09,05:18:00,20240.5,BUY,3,0.02h,Break Even,$-1.50,$-97.50,$101829.50,202,$-97.50
2024-10-09,05:31:00,20228.5,SELL,3,0.02h,Break Even,$-1.50,$-99.00,$101828.00,202,$-99.00
2024-10-09,05:36:00,20242.5,BUY,3,0.02h,Stop Loss,$-9.00,$-108.00,$101819.00,202,$-108.00
2024-10-09,05:52:00,20237.75,SELL,3,0.02h,Stop Loss,$7.50,$-100.50,$101826.50,202,$-100.50
2024-10-09,06:46:00,20224.5,BUY,3,0.02h,Stop Loss,$-9.00,$-109.50,$101817.50,202,$-109.50
2024-10-09,07:10:00,20215.5,SELL,3,0.02h,Stop Loss,$16.50,$-93.00,$101834.00,202,$-93.00
2024-10-09,07:34:00,20217.25,BUY,3,0.02h,Stop Loss,$21.00,$-72.00,$101855.00,202,$-72.00
2024-10-09,07:45:00,20210.75,SELL,3,0.02h,Stop Loss,$7.50,$-64.50,$101862.50,202,$-64.50
2024-10-09,07:49:00,20219.25,BUY,3,0.02h,Stop Loss,$-9.00,$-73.50,$101853.50,202,$-73.50
2024-10-09,07:51:00,20212.0,SELL,3,0.02h,Break Even,$-1.50,$-75.00,$101852.00,202,$-75.00
2024-10-09,07:52:00,20216.0,BUY,3,0.02h,Stop Loss,$22.50,$-52.50,$101874.50,202,$-52.50
2024-10-09,08:18:00,20219.25,SELL,3,0.02h,Stop Loss,$12.00,$-40.50,$101886.50,202,$-40.50
2024-10-09,08:38:00,20228.25,BUY,3,0.02h,Stop Loss,$7.50,$-33.00,$101894.00,202,$-33.00
2024-10-09,10:04:00,20257.25,SELL,3,0.02h,Break Even,$-1.50,$-34.50,$101892.50,202,$-34.50
2024-10-09,10:08:00,20270.5,BUY,3,0.02h,Stop Loss,$-9.00,$-43.50,$101883.50,202,$-43.50
2024-10-09,11:00:00,20281.75,SELL,3,0.02h,Break Even,$-1.50,$-45.00,$101882.00,202,$-45.00
2024-10-09,11:03:00,20290.75,BUY,3,0.02h,Stop Loss,$-9.00,$-54.00,$101873.00,202,$-54.00
2024-10-09,11:06:00,20279.5,SELL,3,0.02h,Stop Loss,$-9.00,$-63.00,$101864.00,202,$-63.00
2024-10-09,11:21:00,20282.5,BUY,3,0.02h,Stop Loss,$-9.00,$-72.00,$101855.00,202,$-72.00
2024-10-09,11:25:00,20279.0,SELL,3,0.02h,Stop Loss,$-9.00,$-81.00,$101846.00,202,$-81.00
2024-10-09,11:47:00,20276.75,BUY,3,0.02h,Stop Loss,$-9.00,$-90.00,$101837.00,202,$-90.00
2024-10-09,11:49:00,20271.5,SELL,3,0.02h,Break Even,$-1.50,$-91.50,$101835.50,202,$-91.50
2024-10-09,12:08:00,20276.0,BUY,3,0.02h,Stop Loss,$-9.00,$-100.50,$101826.50,202,$-100.50
2024-10-09,12:14:00,20264.0,SELL,3,0.02h,Break Even,$-1.50,$-102.00,$101825.00,202,$-102.00
2024-10-09,12:29:00,20272.0,BUY,3,0.02h,Break Even,$-1.50,$-103.50,$101823.50,202,$-103.50
2024-10-09,12:45:00,20264.5,SELL,3,0.02h,Stop Loss,$18.00,$-85.50,$101841.50,202,$-85.50
2024-10-09,12:57:00,20272.75,BUY,3,0.02h,Break Even,$-1.50,$-87.00,$101840.00,202,$-87.00
2024-10-09,13:31:00,20284.25,SELL,3,0.02h,Stop Loss,$96.00,$9.00,$101936.00,202,$9.00
2024-10-09,14:02:00,20271.25,BUY,3,0.02h,Stop Loss,$12.00,$21.00,$101948.00,202,$21.00
2024-10-09,14:48:00,20321.5,SELL,3,0.02h,Break Even,$-1.50,$19.50,$101946.50,202,$19.50
2024-10-09,14:58:00,20347.75,BUY,3,0.02h,Stop Loss,$4.50,$24.00,$101951.00,202,$24.00
2024-10-09,16:06:00,20403.5,SELL,3,0.02h,Break Even,$-1.50,$22.50,$101949.50,202,$22.50
2024-10-09,16:31:00,20409.0,BUY,3,0.02h,Stop Loss,$24.00,$46.50,$101973.50,202,$46.50
2024-10-09,16:53:00,20403.75,SELL,3,0.02h,Stop Loss,$42.00,$88.50,$102015.50,202,$88.50
2024-10-09,17:14:00,20407.0,BUY,3,0.02h,Break Even,$-1.50,$87.00,$102014.00,202,$87.00
2024-10-09,17:52:00,20411.5,SELL,3,0.02h,Stop Loss,$90.00,$177.00,$102104.00,202,$177.00
2024-10-09,18:08:00,20410.5,BUY,3,0.02h,Break Even,$-1.50,$175.50,$102102.50,202,$175.50
2024-10-09,18:12:00,20400.0,SELL,3,0.02h,Stop Loss,$9.00,$184.50,$102111.50,202,$184.50
2024-10-09,18:15:00,20410.75,BUY,3,0.02h,Stop Loss,$-9.00,$175.50,$102102.50,202,$175.50
2024-10-09,18:17:00,20401.5,SELL,3,0.02h,Break Even,$-1.50,$174.00,$102101.00,202,$174.00
2024-10-09,18:25:00,20413.25,BUY,3,0.02h,Stop Loss,$67.50,$241.50,$102168.50,202,$241.50
2024-10-09,19:01:00,20427.75,SELL,3,0.02h,Stop Loss,$19.50,$261.00,$102188.00,202,$261.00
2024-10-09,19:06:00,20441.25,BUY,3,0.02h,Stop Loss,$-9.00,$252.00,$102179.00,202,$252.00
2024-10-09,19:08:00,20420.5,SELL,3,0.02h,Stop Loss,$30.00,$282.00,$102209.00,202,$282.00
2024-10-09,19:19:00,20435.0,BUY,3,0.02h,Stop Loss,$3.00,$285.00,$102212.00,202,$285.00
2024-10-09,20:03:00,20441.25,SELL,3,0.02h,Stop Loss,$10.50,$295.50,$102222.50,202,$295.50
2024-10-09,20:38:00,20436.75,BUY,3,0.02h,Stop Loss,$-9.00,$286.50,$102213.50,202,$286.50
2024-10-09,23:23:00,20445.5,SELL,3,0.02h,Stop Loss,$-9.00,$277.50,$102204.50,202,$277.50
2024-10-09,23:44:00,20454.25,BUY,3,0.02h,Break Even,$-1.50,$276.00,$102203.00,202,$276.00
,,,,,,,,,,,
2024-10-10,00:01:00,20446.25,SELL,3,0.02h,Break Even,$-1.50,$-1.50,$102201.50,203,$-1.50
2024-10-10,00:23:00,20447.25,BUY,3,0.02h,Stop Loss,$-9.00,$-10.50,$102192.50,203,$-10.50
2024-10-10,00:24:00,20443.0,SELL,3,0.02h,Break Even,$-1.50,$-12.00,$102191.00,203,$-12.00
2024-10-10,00:31:00,20445.5,BUY,3,0.02h,Break Even,$-1.50,$-13.50,$102189.50,203,$-13.50
2024-10-10,01:20:00,20453.25,SELL,3,0.02h,Break Even,$-1.50,$-15.00,$102188.00,203,$-15.00
2024-10-10,01:42:00,20456.0,BUY,3,0.02h,Break Even,$-1.50,$-16.50,$102186.50,203,$-16.50
2024-10-10,01:47:00,20452.25,SELL,3,0.02h,Break Even,$-1.50,$-18.00,$102185.00,203,$-18.00
2024-10-10,02:03:00,20454.25,BUY,3,0.02h,Break Even,$-1.50,$-19.50,$102183.50,203,$-19.50
2024-10-10,02:12:00,20449.0,SELL,3,0.02h,Stop Loss,$6.00,$-13.50,$102189.50,203,$-13.50
2024-10-10,02:24:00,20452.5,BUY,3,0.02h,Stop Loss,$-9.00,$-22.50,$102180.50,203,$-22.50
2024-10-10,02:25:00,20449.0,SELL,3,0.02h,Break Even,$-1.50,$-24.00,$102179.00,203,$-24.00
2024-10-10,02:26:00,20450.75,BUY,3,0.02h,Stop Loss,$-9.00,$-33.00,$102170.00,203,$-33.00
2024-10-10,02:27:00,20448.75,SELL,3,0.02h,Stop Loss,$-9.00,$-42.00,$102161.00,203,$-42.00
2024-10-10,02:29:00,20450.75,BUY,3,0.02h,Stop Loss,$-9.00,$-51.00,$102152.00,203,$-51.00
2024-10-10,03:23:00,20465.75,SELL,3,0.02h,Stop Loss,$-9.00,$-60.00,$102143.00,203,$-60.00
2024-10-10,03:45:00,20468.5,BUY,3,0.02h,Stop Loss,$-9.00,$-69.00,$102134.00,203,$-69.00
2024-10-10,04:10:00,20467.0,SELL,3,0.02h,Break Even,$-1.50,$-70.50,$102132.50,203,$-70.50
2024-10-10,04:41:00,20468.0,BUY,3,0.02h,Stop Loss,$-9.00,$-79.50,$102123.50,203,$-79.50
2024-10-10,04:49:00,20465.5,SELL,3,0.10h,Break Even,$-1.50,$-81.00,$102122.00,203,$-81.00
2024-10-10,05:02:00,20470.0,BUY,3,0.02h,Stop Loss,$-9.00,$-90.00,$102113.00,203,$-90.00
2024-10-10,05:22:00,20466.25,SELL,3,0.02h,Break Even,$-1.50,$-91.50,$102111.50,203,$-91.50
2024-10-10,06:30:00,20441.25,BUY,3,0.02h,Stop Loss,$-9.00,$-100.50,$102102.50,203,$-100.50
2024-10-10,07:11:00,20436.5,SELL,3,0.02h,Stop Loss,$-9.00,$-109.50,$102093.50,203,$-109.50
2024-10-10,08:02:00,20430.5,BUY,3,0.02h,Stop Loss,$-9.00,$-118.50,$102084.50,203,$-118.50
2024-10-10,08:10:00,20420.25,SELL,3,0.02h,Stop Loss,$7.50,$-111.00,$102092.00,203,$-111.00
2024-10-10,08:29:00,20425.25,BUY,3,0.02h,Break Even,$-1.50,$-112.50,$102090.50,203,$-112.50
2024-10-10,08:44:00,20416.25,SELL,3,0.02h,Stop Loss,$-9.00,$-121.50,$102081.50,203,$-121.50
2024-10-10,09:21:00,20417.75,BUY,3,0.02h,Break Even,$-1.50,$-123.00,$102080.00,203,$-123.00
2024-10-10,09:49:00,20421.5,SELL,3,0.02h,Break Even,$-1.50,$-124.50,$102078.50,203,$-124.50
2024-10-10,09:54:00,20426.5,BUY,3,0.02h,Stop Loss,$-9.00,$-133.50,$102069.50,203,$-133.50
2024-10-10,10:15:00,20425.5,SELL,3,0.02h,Break Even,$-1.50,$-135.00,$102068.00,203,$-135.00
2024-10-10,10:34:00,20427.25,BUY,3,0.02h,Break Even,$-1.50,$-136.50,$102066.50,203,$-136.50
2024-10-10,10:46:00,20415.75,SELL,3,0.02h,Stop Loss,$-9.00,$-145.50,$102057.50,203,$-145.50
2024-10-10,11:19:00,20417.25,BUY,3,0.02h,Break Even,$-1.50,$-147.00,$102056.00,203,$-147.00
2024-10-10,12:22:00,20437.75,SELL,3,0.02h,Stop Loss,$-9.00,$-156.00,$102047.00,203,$-156.00
2024-10-10,13:05:00,20380.25,BUY,3,0.02h,Break Even,$-1.50,$-157.50,$102045.50,203,$-157.50
2024-10-10,13:10:00,20362.5,SELL,3,0.02h,Stop Loss,$24.00,$-133.50,$102069.50,203,$-133.50
2024-10-10,13:32:00,20380.25,BUY,3,0.02h,Stop Loss,$31.50,$-102.00,$102101.00,203,$-102.00
2024-10-10,13:48:00,20331.75,SELL,3,0.02h,Stop Loss,$91.50,$-10.50,$102192.50,203,$-10.50
2024-10-10,13:58:00,20371.25,BUY,3,0.02h,Stop Loss,$37.50,$27.00,$102230.00,203,$27.00
2024-10-10,14:26:00,20381.0,SELL,3,0.02h,Break Even,$-1.50,$25.50,$102228.50,203,$25.50
2024-10-10,14:27:00,20391.75,BUY,3,0.02h,Stop Loss,$90.00,$115.50,$102318.50,203,$115.50
2024-10-10,14:35:00,20380.0,SELL,3,0.02h,Stop Loss,$15.00,$130.50,$102333.50,203,$130.50
2024-10-10,14:44:00,20410.0,BUY,3,0.02h,Stop Loss,$30.00,$160.50,$102363.50,203,$160.50
2024-10-10,14:54:00,20377.25,SELL,3,0.02h,Stop Loss,$16.50,$177.00,$102380.00,203,$177.00
2024-10-10,15:08:00,20403.25,BUY,3,0.02h,Stop Loss,$43.50,$220.50,$102423.50,203,$220.50
2024-10-10,16:28:00,20478.75,SELL,3,0.02h,Stop Loss,$52.50,$273.00,$102476.00,203,$273.00
2024-10-10,17:21:00,20455.75,BUY,3,0.02h,Stop Loss,$19.50,$292.50,$102495.50,203,$292.50
2024-10-10,17:47:00,20446.5,SELL,3,0.02h,Stop Loss,$81.00,$373.50,$102576.50,203,$373.50
2024-10-10,18:50:00,20411.0,BUY,3,0.02h,Stop Loss,$-9.00,$364.50,$102567.50,203,$364.50
2024-10-10,18:51:00,20402.5,SELL,3,0.02h,Stop Loss,$-9.00,$355.50,$102558.50,203,$355.50
2024-10-10,18:53:00,20410.25,BUY,3,0.02h,Break Even,$-1.50,$354.00,$102557.00,203,$354.00
2024-10-10,19:05:00,20401.5,SELL,3,0.02h,Stop Loss,$33.00,$387.00,$102590.00,203,$387.00
2024-10-10,19:20:00,20413.5,BUY,3,0.02h,Stop Loss,$6.00,$393.00,$102596.00,203,$393.00
2024-10-10,19:37:00,20404.5,SELL,3,0.02h,Stop Loss,$25.50,$418.50,$102621.50,203,$418.50
2024-10-10,19:48:00,20416.5,BUY,3,0.02h,Break Even,$-1.50,$417.00,$102620.00,203,$417.00
2024-10-10,20:10:00,20420.0,SELL,3,0.02h,Stop Loss,$-9.00,$408.00,$102611.00,203,$408.00
2024-10-10,20:17:00,20430.0,BUY,3,0.02h,Stop Loss,$-9.00,$399.00,$102602.00,203,$399.00
2024-10-10,23:00:00,20435.25,SELL,3,0.02h,Stop Loss,$-9.00,$390.00,$102593.00,203,$390.00
2024-10-10,23:01:00,20441.5,BUY,3,0.02h,Break Even,$-1.50,$388.50,$102591.50,203,$388.50
2024-10-10,23:45:00,20455.0,SELL,3,0.02h,Stop Loss,$-9.00,$379.50,$102582.50,203,$379.50
2024-10-10,23:53:00,20458.0,BUY,3,0.02h,Stop Loss,$-9.00,$370.50,$102573.50,203,$370.50
2024-10-10,23:54:00,20454.5,SELL,3,0.02h,Break Even,$-1.50,$369.00,$102572.00,203,$369.00
,,,,,,,,,,,
2024-10-11,00:05:00,20456.5,BUY,3,0.02h,Stop Loss,$-9.00,$-9.00,$102563.00,204,$-9.00
2024-10-11,00:06:00,20450.75,SELL,3,0.02h,Stop Loss,$10.50,$1.50,$102573.50,204,$1.50
2024-10-11,00:40:00,20451.5,BUY,3,0.02h,Break Even,$-1.50,$0.00,$102572.00,204,$0.00
2024-10-11,00:57:00,20447.75,SELL,3,0.02h,Break Even,$-1.50,$-1.50,$102570.50,204,$-1.50
2024-10-11,01:08:00,20451.5,BUY,3,0.02h,Stop Loss,$-9.00,$-10.50,$102561.50,204,$-10.50
2024-10-11,01:38:00,20453.0,SELL,3,0.02h,Stop Loss,$-9.00,$-19.50,$102552.50,204,$-19.50
2024-10-11,02:14:00,20452.75,BUY,3,0.05h,Stop Loss,$4.50,$-15.00,$102557.00,204,$-15.00
2024-10-11,02:31:00,20452.0,SELL,3,0.02h,Break Even,$-1.50,$-16.50,$102555.50,204,$-16.50
2024-10-11,02:58:00,20450.5,BUY,3,0.02h,Stop Loss,$-9.00,$-25.50,$102546.50,204,$-25.50
2024-10-11,03:04:00,20446.0,SELL,3,0.02h,Stop Loss,$-9.00,$-34.50,$102537.50,204,$-34.50
2024-10-11,03:07:00,20449.5,BUY,3,0.02h,Break Even,$-1.50,$-36.00,$102536.00,204,$-36.00
2024-10-11,03:28:00,20454.0,SELL,3,0.02h,Break Even,$-1.50,$-37.50,$102534.50,204,$-37.50
2024-10-11,03:43:00,20457.5,BUY,3,0.02h,Stop Loss,$-9.00,$-46.50,$102525.50,204,$-46.50
2024-10-11,04:01:00,20454.0,SELL,3,0.02h,Break Even,$-1.50,$-48.00,$102524.00,204,$-48.00
2024-10-11,05:47:00,20427.25,BUY,3,0.03h,Stop Loss,$-9.00,$-57.00,$102515.00,204,$-57.00
2024-10-11,05:51:00,20421.25,SELL,3,0.03h,Stop Loss,$-9.00,$-66.00,$102506.00,204,$-66.00
2024-10-11,05:56:00,20426.75,BUY,3,0.02h,Stop Loss,$-9.00,$-75.00,$102497.00,204,$-75.00
2024-10-11,06:14:00,20422.75,SELL,3,0.02h,Stop Loss,$21.00,$-54.00,$102518.00,204,$-54.00
2024-10-11,06:22:00,20427.25,BUY,3,0.02h,Stop Loss,$-9.00,$-63.00,$102509.00,204,$-63.00
2024-10-11,06:23:00,20423.0,SELL,3,0.03h,Break Even,$-1.50,$-64.50,$102507.50,204,$-64.50
2024-10-11,06:28:00,20425.75,BUY,3,0.02h,Stop Loss,$16.50,$-48.00,$102524.00,204,$-48.00
2024-10-11,06:32:00,20422.5,SELL,3,0.02h,Stop Loss,$-9.00,$-57.00,$102515.00,204,$-57.00
2024-10-11,06:56:00,20423.0,BUY,3,0.02h,Break Even,$-1.50,$-58.50,$102513.50,204,$-58.50
2024-10-11,06:59:00,20415.0,SELL,3,0.02h,Break Even,$-1.50,$-60.00,$102512.00,204,$-60.00
2024-10-11,07:43:00,20397.0,BUY,3,0.02h,Stop Loss,$-9.00,$-69.00,$102503.00,204,$-69.00
2024-10-11,08:06:00,20393.25,SELL,3,0.02h,Stop Loss,$36.00,$-33.00,$102539.00,204,$-33.00
2024-10-11,08:33:00,20384.0,BUY,3,0.02h,Break Even,$-1.50,$-34.50,$102537.50,204,$-34.50
2024-10-11,08:45:00,20377.5,SELL,3,0.02h,Break Even,$-1.50,$-36.00,$102536.00,204,$-36.00
2024-10-11,09:07:00,20374.75,BUY,3,0.02h,Stop Loss,$27.00,$-9.00,$102563.00,204,$-9.00
2024-10-11,09:20:00,20366.5,SELL,3,0.02h,Break Even,$-1.50,$-10.50,$102561.50,204,$-10.50
2024-10-11,09:34:00,20374.5,BUY,3,0.02h,Break Even,$-1.50,$-12.00,$102560.00,204,$-12.00
2024-10-11,09:48:00,20370.75,SELL,3,0.02h,Break Even,$-1.50,$-13.50,$102558.50,204,$-13.50
2024-10-11,10:09:00,20372.25,BUY,3,0.02h,Stop Loss,$-9.00,$-22.50,$102549.50,204,$-22.50
2024-10-11,10:38:00,20377.0,SELL,3,0.02h,Break Even,$-1.50,$-24.00,$102548.00,204,$-24.00
2024-10-11,10:44:00,20379.5,BUY,3,0.02h,Stop Loss,$-9.00,$-33.00,$102539.00,204,$-33.00
2024-10-11,10:51:00,20376.25,SELL,3,0.02h,Break Even,$-1.50,$-34.50,$102537.50,204,$-34.50
2024-10-11,10:59:00,20382.25,BUY,3,0.02h,Stop Loss,$-9.00,$-43.50,$102528.50,204,$-43.50
2024-10-11,11:12:00,20378.0,SELL,3,0.02h,Break Even,$-1.50,$-45.00,$102527.00,204,$-45.00
2024-10-11,11:45:00,20372.0,BUY,3,0.03h,Stop Loss,$3.00,$-42.00,$102530.00,204,$-42.00
2024-10-11,11:55:00,20368.0,SELL,3,0.02h,Stop Loss,$-9.00,$-51.00,$102521.00,204,$-51.00
2024-10-11,12:09:00,20376.25,BUY,3,0.02h,Stop Loss,$78.00,$27.00,$102599.00,204,$27.00
2024-10-11,12:40:00,20373.75,SELL,3,0.02h,Stop Loss,$46.50,$73.50,$102645.50,204,$73.50
2024-10-11,13:48:00,20354.5,BUY,3,0.02h,Break Even,$-1.50,$72.00,$102644.00,204,$72.00
2024-10-11,14:46:00,20434.25,SELL,3,0.02h,Stop Loss,$-9.00,$63.00,$102635.00,204,$63.00
2024-10-11,15:04:00,20441.5,BUY,3,0.02h,Stop Loss,$45.00,$108.00,$102680.00,204,$108.00
2024-10-11,15:19:00,20423.5,SELL,3,0.02h,Stop Loss,$63.00,$171.00,$102743.00,204,$171.00
2024-10-11,15:34:00,20442.75,BUY,3,0.02h,Stop Loss,$21.00,$192.00,$102764.00,204,$192.00
2024-10-11,16:16:00,20452.75,SELL,3,0.02h,Stop Loss,$12.00,$204.00,$102776.00,204,$204.00
2024-10-11,16:59:00,20439.5,BUY,3,0.02h,Break Even,$-1.50,$202.50,$102774.50,204,$202.50
2024-10-11,17:14:00,20424.25,SELL,3,0.02h,Stop Loss,$-9.00,$193.50,$102765.50,204,$193.50
2024-10-11,17:25:00,20437.75,BUY,3,0.02h,Stop Loss,$7.50,$201.00,$102773.00,204,$201.00
2024-10-11,18:01:00,20437.5,SELL,3,0.02h,Break Even,$-1.50,$199.50,$102771.50,204,$199.50
2024-10-11,18:06:00,20444.5,BUY,3,0.02h,Break Even,$-1.50,$198.00,$102770.00,204,$198.00
2024-10-11,18:37:00,20454.0,SELL,3,0.02h,Stop Loss,$3.00,$201.00,$102773.00,204,$201.00
2024-10-11,18:49:00,20459.0,BUY,3,0.02h,Break Even,$-1.50,$199.50,$102771.50,204,$199.50
2024-10-11,19:38:00,20473.5,SELL,3,0.02h,Stop Loss,$10.50,$210.00,$102782.00,204,$210.00
,,,,,,,,,,,
2024-10-14,00:00:00,20427.0,BUY,3,0.02h,Stop Loss,$4.50,$4.50,$102786.50,205,$4.50
2024-10-14,00:16:00,20418.75,SELL,3,0.02h,Break Even,$-1.50,$3.00,$102785.00,205,$3.00
2024-10-14,00:23:00,20429.75,BUY,3,0.02h,Stop Loss,$-9.00,$-6.00,$102776.00,205,$-6.00
2024-10-14,00:33:00,20422.5,SELL,3,0.02h,Break Even,$-1.50,$-7.50,$102774.50,205,$-7.50
2024-10-14,01:38:00,20415.25,BUY,3,0.02h,Break Even,$-1.50,$-9.00,$102773.00,205,$-9.00
2024-10-14,01:51:00,20402.0,SELL,3,0.02h,Stop Loss,$27.00,$18.00,$102800.00,205,$18.00
2024-10-14,02:20:00,20401.0,BUY,3,0.02h,Break Even,$-1.50,$16.50,$102798.50,205,$16.50
2024-10-14,02:58:00,20402.5,SELL,3,0.02h,Break Even,$-1.50,$15.00,$102797.00,205,$15.00
2024-10-14,03:10:00,20410.0,BUY,3,0.02h,Stop Loss,$-9.00,$6.00,$102788.00,205,$6.00
2024-10-14,03:36:00,20409.5,SELL,3,0.02h,Stop Loss,$-9.00,$-3.00,$102779.00,205,$-3.00
2024-10-14,03:37:00,20410.25,BUY,3,0.02h,Stop Loss,$-9.00,$-12.00,$102770.00,205,$-12.00
2024-10-14,03:51:00,20407.25,SELL,3,0.02h,Stop Loss,$-9.00,$-21.00,$102761.00,205,$-21.00
2024-10-14,04:22:00,20408.0,BUY,3,0.08h,Break Even,$-1.50,$-22.50,$102759.50,205,$-22.50
2024-10-14,04:31:00,20407.0,SELL,3,0.02h,Stop Loss,$-9.00,$-31.50,$102750.50,205,$-31.50
2024-10-14,04:32:00,20409.5,BUY,3,0.07h,Break Even,$-1.50,$-33.00,$102749.00,205,$-33.00
2024-10-14,04:40:00,20407.0,SELL,3,0.02h,Stop Loss,$-9.00,$-42.00,$102740.00,205,$-42.00
2024-10-14,04:41:00,20410.0,BUY,3,0.02h,Stop Loss,$-9.00,$-51.00,$102731.00,205,$-51.00
2024-10-14,05:43:00,20423.5,SELL,3,0.02h,Stop Loss,$-9.00,$-60.00,$102722.00,205,$-60.00
2024-10-14,05:55:00,20430.0,BUY,3,0.02h,Break Even,$-1.50,$-61.50,$102720.50,205,$-61.50
2024-10-14,06:14:00,20429.75,SELL,3,0.02h,Stop Loss,$-9.00,$-70.50,$102711.50,205,$-70.50
2024-10-14,06:16:00,20432.75,BUY,3,0.02h,Stop Loss,$-9.00,$-79.50,$102702.50,205,$-79.50
2024-10-14,06:20:00,20429.25,SELL,3,0.02h,Stop Loss,$-9.00,$-88.50,$102693.50,205,$-88.50
2024-10-14,06:21:00,20432.0,BUY,3,0.02h,Stop Loss,$-9.00,$-97.50,$102684.50,205,$-97.50
2024-10-14,06:22:00,20430.0,SELL,3,0.02h,Stop Loss,$-9.00,$-106.50,$102675.50,205,$-106.50
2024-10-14,06:24:00,20432.5,BUY,3,0.02h,Break Even,$-1.50,$-108.00,$102674.00,205,$-108.00
2024-10-14,06:34:00,20429.5,SELL,3,0.03h,Stop Loss,$-9.00,$-117.00,$102665.00,205,$-117.00
2024-10-14,06:38:00,20434.5,BUY,3,0.02h,Stop Loss,$16.50,$-100.50,$102681.50,205,$-100.50
2024-10-14,07:03:00,20437.0,SELL,3,0.02h,Stop Loss,$9.00,$-91.50,$102690.50,205,$-91.50
2024-10-14,07:18:00,20439.25,BUY,3,0.02h,Break Even,$-1.50,$-93.00,$102689.00,205,$-93.00
2024-10-14,08:38:00,20471.25,SELL,3,0.02h,Break Even,$-1.50,$-94.50,$102687.50,205,$-94.50
2024-10-14,08:42:00,20476.0,BUY,3,0.02h,Stop Loss,$-9.00,$-103.50,$102678.50,205,$-103.50
2024-10-14,08:43:00,20473.5,SELL,3,0.02h,Break Even,$-1.50,$-105.00,$102677.00,205,$-105.00
2024-10-14,08:44:00,20476.0,BUY,3,0.02h,Stop Loss,$-9.00,$-114.00,$102668.00,205,$-114.00
2024-10-14,08:51:00,20472.0,SELL,3,0.02h,Break Even,$-1.50,$-115.50,$102666.50,205,$-115.50
2024-10-14,09:04:00,20481.5,BUY,3,0.02h,Stop Loss,$4.50,$-111.00,$102671.00,205,$-111.00
2024-10-14,09:23:00,20477.0,SELL,3,0.02h,Break Even,$-1.50,$-112.50,$102669.50,205,$-112.50
2024-10-14,09:27:00,20482.25,BUY,3,0.02h,Break Even,$-1.50,$-114.00,$102668.00,205,$-114.00
2024-10-14,10:48:00,20513.5,SELL,3,0.02h,Break Even,$-1.50,$-115.50,$102666.50,205,$-115.50
2024-10-14,11:38:00,20506.0,BUY,3,0.02h,Stop Loss,$3.00,$-112.50,$102669.50,205,$-112.50
2024-10-14,11:56:00,20504.0,SELL,3,0.02h,Stop Loss,$-9.00,$-121.50,$102660.50,205,$-121.50
2024-10-14,12:09:00,20508.5,BUY,3,0.02h,Stop Loss,$-9.00,$-130.50,$102651.50,205,$-130.50
2024-10-14,12:10:00,20506.75,SELL,3,0.02h,Stop Loss,$-9.00,$-139.50,$102642.50,205,$-139.50
2024-10-14,12:11:00,20509.75,BUY,3,0.03h,Stop Loss,$10.50,$-129.00,$102653.00,205,$-129.00
2024-10-14,13:30:00,20550.5,SELL,3,0.02h,Stop Loss,$37.50,$-91.50,$102690.50,205,$-91.50
2024-10-14,13:32:00,20557.0,BUY,3,0.02h,Stop Loss,$81.00,$-10.50,$102771.50,205,$-10.50
2024-10-14,14:14:00,20627.75,SELL,3,0.02h,Stop Loss,$9.00,$-1.50,$102780.50,205,$-1.50
2024-10-14,14:29:00,20638.25,BUY,3,0.02h,Stop Loss,$19.50,$18.00,$102800.00,205,$18.00
2024-10-14,14:46:00,20627.0,SELL,3,0.02h,Stop Loss,$3.00,$21.00,$102803.00,205,$21.00
2024-10-14,15:22:00,20578.5,BUY,3,0.02h,Stop Loss,$30.00,$51.00,$102833.00,205,$51.00
2024-10-14,15:26:00,20561.0,SELL,3,0.02h,Stop Loss,$58.50,$109.50,$102891.50,205,$109.50
2024-10-14,15:48:00,20568.0,BUY,3,0.02h,Stop Loss,$9.00,$118.50,$102900.50,205,$118.50
2024-10-14,16:58:00,20601.25,SELL,3,0.02h,Stop Loss,$-9.00,$109.50,$102891.50,205,$109.50
2024-10-14,17:04:00,20618.5,BUY,3,0.02h,Stop Loss,$6.00,$115.50,$102897.50,205,$115.50
2024-10-14,17:11:00,20606.75,SELL,3,0.02h,Stop Loss,$24.00,$139.50,$102921.50,205,$139.50
2024-10-14,17:27:00,20611.5,BUY,3,0.02h,Stop Loss,$-9.00,$130.50,$102912.50,205,$130.50
2024-10-14,17:34:00,20600.0,SELL,3,0.02h,Stop Loss,$13.50,$144.00,$102926.00,205,$144.00
2024-10-14,17:39:00,20612.5,BUY,3,0.02h,Break Even,$-1.50,$142.50,$102924.50,205,$142.50
2024-10-14,18:01:00,20603.0,SELL,3,0.02h,Break Even,$-1.50,$141.00,$102923.00,205,$141.00
2024-10-14,18:06:00,20611.0,BUY,3,0.02h,Break Even,$-1.50,$139.50,$102921.50,205,$139.50
2024-10-14,19:01:00,20620.0,SELL,3,0.02h,Stop Loss,$4.50,$144.00,$102926.00,205,$144.00
2024-10-14,19:15:00,20627.25,BUY,3,0.02h,Stop Loss,$13.50,$157.50,$102939.50,205,$157.50
2024-10-14,19:55:00,20633.5,SELL,3,0.02h,Stop Loss,$30.00,$187.50,$102969.50,205,$187.50
2024-10-14,20:44:00,20627.5,BUY,3,0.02h,Stop Loss,$-9.00,$178.50,$102960.50,205,$178.50
2024-10-14,23:06:00,20621.75,SELL,3,0.02h,Stop Loss,$-9.00,$169.50,$102951.50,205,$169.50
2024-10-14,23:23:00,20628.75,BUY,3,0.02h,Break Even,$-1.50,$168.00,$102950.00,205,$168.00
,,,,,,,,,,,
2024-10-15,00:04:00,20627.5,SELL,3,0.02h,Stop Loss,$9.00,$9.00,$102959.00,206,$9.00
2024-10-15,01:11:00,20610.75,BUY,3,0.02h,Stop Loss,$9.00,$18.00,$102968.00,206,$18.00
2024-10-15,02:11:00,20625.0,SELL,3,0.02h,Stop Loss,$-9.00,$9.00,$102959.00,206,$9.00
2024-10-15,02:21:00,20630.75,BUY,3,0.02h,Stop Loss,$-9.00,$0.00,$102950.00,206,$0.00
2024-10-15,02:36:00,20627.0,SELL,3,0.03h,Stop Loss,$-9.00,$-9.00,$102941.00,206,$-9.00
2024-10-15,03:27:00,20624.0,BUY,3,0.02h,Break Even,$-1.50,$-10.50,$102939.50,206,$-10.50
2024-10-15,04:06:00,20628.75,SELL,3,0.03h,Stop Loss,$-9.00,$-19.50,$102930.50,206,$-19.50
2024-10-15,04:11:00,20633.0,BUY,3,0.02h,Stop Loss,$-9.00,$-28.50,$102921.50,206,$-28.50
2024-10-15,04:26:00,20627.75,SELL,3,0.12h,Break Even,$-1.50,$-30.00,$102920.00,206,$-30.00
2024-10-15,04:43:00,20629.75,BUY,3,0.03h,Break Even,$-1.50,$-31.50,$102918.50,206,$-31.50
2024-10-15,04:55:00,20628.5,SELL,3,0.02h,Stop Loss,$-9.00,$-40.50,$102909.50,206,$-40.50
2024-10-15,04:56:00,20630.75,BUY,3,0.02h,Stop Loss,$-9.00,$-49.50,$102900.50,206,$-49.50
2024-10-15,05:01:00,20627.75,SELL,3,0.03h,Stop Loss,$-9.00,$-58.50,$102891.50,206,$-58.50
2024-10-15,05:18:00,20630.0,BUY,3,0.02h,Stop Loss,$-9.00,$-67.50,$102882.50,206,$-67.50
2024-10-15,05:19:00,20627.75,SELL,3,0.05h,Stop Loss,$-9.00,$-76.50,$102873.50,206,$-76.50
2024-10-15,06:19:00,20611.0,BUY,3,0.02h,Stop Loss,$-9.00,$-85.50,$102864.50,206,$-85.50
2024-10-15,06:38:00,20606.5,SELL,3,0.02h,Stop Loss,$-9.00,$-94.50,$102855.50,206,$-94.50
2024-10-15,07:13:00,20603.25,BUY,3,0.02h,Break Even,$-1.50,$-96.00,$102854.00,206,$-96.00
2024-10-15,07:28:00,20597.25,SELL,3,0.02h,Stop Loss,$10.50,$-85.50,$102864.50,206,$-85.50
2024-10-15,07:34:00,20607.5,BUY,3,0.02h,Break Even,$-1.50,$-87.00,$102863.00,206,$-87.00
2024-10-15,07:59:00,20601.75,SELL,3,0.02h,Break Even,$-1.50,$-88.50,$102861.50,206,$-88.50
2024-10-15,08:48:00,20584.75,BUY,3,0.02h,Stop Loss,$-9.00,$-97.50,$102852.50,206,$-97.50
2024-10-15,09:06:00,20576.25,SELL,3,0.02h,Stop Loss,$9.00,$-88.50,$102861.50,206,$-88.50
2024-10-15,09:16:00,20584.25,BUY,3,0.02h,Stop Loss,$-9.00,$-97.50,$102852.50,206,$-97.50
2024-10-15,09:40:00,20578.75,SELL,3,0.02h,Break Even,$-1.50,$-99.00,$102851.00,206,$-99.00
2024-10-15,09:54:00,20585.5,BUY,3,0.02h,Break Even,$-1.50,$-100.50,$102849.50,206,$-100.50
2024-10-15,10:17:00,20587.75,SELL,3,0.02h,Break Even,$-1.50,$-102.00,$102848.00,206,$-102.00
2024-10-15,10:28:00,20593.0,BUY,3,0.02h,Stop Loss,$-9.00,$-111.00,$102839.00,206,$-111.00
2024-10-15,11:13:00,20607.5,SELL,3,0.02h,Stop Loss,$12.00,$-99.00,$102851.00,206,$-99.00
2024-10-15,11:48:00,20611.75,BUY,3,0.02h,Stop Loss,$-9.00,$-108.00,$102842.00,206,$-108.00
2024-10-15,12:29:00,20617.5,SELL,3,0.02h,Break Even,$-1.50,$-109.50,$102840.50,206,$-109.50
2024-10-15,12:53:00,20616.75,BUY,3,0.02h,Stop Loss,$7.50,$-102.00,$102848.00,206,$-102.00
2024-10-15,13:30:00,20631.25,SELL,3,0.02h,Stop Loss,$132.00,$30.00,$102980.00,206,$30.00
2024-10-15,13:55:00,20639.75,BUY,3,0.02h,Stop Loss,$82.50,$112.50,$103062.50,206,$112.50
2024-10-15,14:10:00,20621.25,SELL,3,0.02h,Stop Loss,$94.50,$207.00,$103157.00,206,$207.00
2024-10-15,15:16:00,20436.0,BUY,3,0.02h,Stop Loss,$22.50,$229.50,$103179.50,206,$229.50
2024-10-15,15:26:00,20402.75,SELL,3,0.02h,Stop Loss,$9.00,$238.50,$103188.50,206,$238.50
2024-10-15,15:34:00,20422.75,BUY,3,0.02h,Stop Loss,$43.50,$282.00,$103232.00,206,$282.00
2024-10-15,15:40:00,20400.0,SELL,3,0.02h,Stop Loss,$36.00,$318.00,$103268.00,206,$318.00
2024-10-15,16:11:00,20390.5,BUY,3,0.02h,Stop Loss,$4.50,$322.50,$103272.50,206,$322.50
2024-10-15,16:46:00,20391.5,SELL,3,0.02h,Stop Loss,$52.50,$375.00,$103325.00,206,$375.00
2024-10-15,17:41:00,20373.0,BUY,3,0.02h,Break Even,$-1.50,$373.50,$103323.50,206,$373.50
2024-10-15,17:58:00,20356.25,SELL,3,0.02h,Stop Loss,$-9.00,$364.50,$103314.50,206,$364.50
2024-10-15,18:04:00,20385.25,BUY,3,0.02h,Break Even,$-1.50,$363.00,$103313.00,206,$363.00
2024-10-15,18:10:00,20364.75,SELL,3,0.02h,Stop Loss,$3.00,$366.00,$103316.00,206,$366.00
2024-10-15,18:22:00,20378.75,BUY,3,0.02h,Break Even,$-1.50,$364.50,$103314.50,206,$364.50
2024-10-15,18:34:00,20363.0,SELL,3,0.02h,Stop Loss,$12.00,$376.50,$103326.50,206,$376.50
2024-10-15,19:43:00,20306.75,BUY,3,0.02h,Break Even,$-1.50,$375.00,$103325.00,206,$375.00
2024-10-15,20:18:00,20321.75,SELL,3,0.02h,Stop Loss,$-9.00,$366.00,$103316.00,206,$366.00
2024-10-15,20:25:00,20336.5,BUY,3,0.02h,Break Even,$-1.50,$364.50,$103314.50,206,$364.50
2024-10-15,20:47:00,20332.5,SELL,3,0.02h,Stop Loss,$-9.00,$355.50,$103305.50,206,$355.50
2024-10-15,20:49:00,20336.5,BUY,3,0.02h,Break Even,$-1.50,$354.00,$103304.00,206,$354.00
2024-10-15,20:57:00,20333.75,SELL,3,0.02h,Break Even,$-1.50,$352.50,$103302.50,206,$352.50
2024-10-15,23:00:00,20350.25,BUY,3,0.02h,Stop Loss,$33.00,$385.50,$103335.50,206,$385.50
2024-10-15,23:54:00,20353.5,SELL,3,0.02h,Stop Loss,$-9.00,$376.50,$103326.50,206,$376.50
,,,,,,,,,,,
2024-10-16,00:15:00,20355.25,BUY,3,0.02h,Break Even,$-1.50,$-1.50,$103325.00,207,$-1.50
2024-10-16,00:33:00,20354.5,SELL,3,0.02h,Break Even,$-1.50,$-3.00,$103323.50,207,$-3.00
2024-10-16,00:38:00,20362.5,BUY,3,0.02h,Break Even,$-1.50,$-4.50,$103322.00,207,$-4.50
2024-10-16,00:48:00,20357.5,SELL,3,0.02h,Break Even,$-1.50,$-6.00,$103320.50,207,$-6.00
2024-10-16,01:19:00,20359.5,BUY,3,0.02h,Stop Loss,$-9.00,$-15.00,$103311.50,207,$-15.00
2024-10-16,01:35:00,20356.5,SELL,3,0.02h,Stop Loss,$4.50,$-10.50,$103316.00,207,$-10.50
2024-10-16,01:38:00,20357.25,BUY,3,0.02h,Break Even,$-1.50,$-12.00,$103314.50,207,$-12.00
2024-10-16,02:06:00,20364.75,SELL,3,0.02h,Stop Loss,$-9.00,$-21.00,$103305.50,207,$-21.00
2024-10-16,02:08:00,20368.75,BUY,3,0.02h,Stop Loss,$-9.00,$-30.00,$103296.50,207,$-30.00
2024-10-16,02:55:00,20377.5,SELL,3,0.02h,Stop Loss,$-9.00,$-39.00,$103287.50,207,$-39.00
2024-10-16,02:56:00,20381.0,BUY,3,0.02h,Stop Loss,$-9.00,$-48.00,$103278.50,207,$-48.00
2024-10-16,03:00:00,20378.0,SELL,3,0.02h,Stop Loss,$-9.00,$-57.00,$103269.50,207,$-57.00
2024-10-16,03:15:00,20379.25,BUY,3,0.02h,Stop Loss,$-9.00,$-66.00,$103260.50,207,$-66.00
2024-10-16,03:16:00,20376.25,SELL,3,0.02h,Break Even,$-1.50,$-67.50,$103259.00,207,$-67.50
2024-10-16,03:22:00,20381.5,BUY,3,0.02h,Stop Loss,$-9.00,$-76.50,$103250.00,207,$-76.50
2024-10-16,03:40:00,20378.25,SELL,3,0.02h,Stop Loss,$-9.00,$-85.50,$103241.00,207,$-85.50
2024-10-16,03:41:00,20381.5,BUY,3,0.02h,Break Even,$-1.50,$-87.00,$103239.50,207,$-87.00
2024-10-16,04:21:00,20386.0,SELL,3,0.02h,Stop Loss,$-9.00,$-96.00,$103230.50,207,$-96.00
2024-10-16,04:37:00,20390.0,BUY,3,0.02h,Stop Loss,$-9.00,$-105.00,$103221.50,207,$-105.00
2024-10-16,04:50:00,20387.5,SELL,3,0.02h,Stop Loss,$-9.00,$-114.00,$103212.50,207,$-114.00
2024-10-16,04:58:00,20389.5,BUY,3,0.03h,Break Even,$-1.50,$-115.50,$103211.00,207,$-115.50
2024-10-16,05:08:00,20384.75,SELL,3,0.02h,Stop Loss,$18.00,$-97.50,$103229.00,207,$-97.50
2024-10-16,05:29:00,20388.5,BUY,3,0.02h,Stop Loss,$21.00,$-76.50,$103250.00,207,$-76.50
2024-10-16,05:56:00,20381.25,SELL,3,0.02h,Break Even,$-1.50,$-78.00,$103248.50,207,$-78.00
2024-10-16,06:34:00,20378.0,BUY,3,0.02h,Stop Loss,$-9.00,$-87.00,$103239.50,207,$-87.00
2024-10-16,07:01:00,20369.75,SELL,3,0.02h,Break Even,$-1.50,$-88.50,$103238.00,207,$-88.50
2024-10-16,07:31:00,20366.75,BUY,3,0.02h,Stop Loss,$16.50,$-72.00,$103254.50,207,$-72.00
2024-10-16,08:06:00,20371.0,SELL,3,0.02h,Stop Loss,$9.00,$-63.00,$103263.50,207,$-63.00
2024-10-16,08:45:00,20358.75,BUY,3,0.02h,Break Even,$-1.50,$-64.50,$103262.00,207,$-64.50
2024-10-16,08:46:00,20354.5,SELL,3,0.02h,Stop Loss,$-9.00,$-73.50,$103253.00,207,$-73.50
2024-10-16,08:47:00,20356.0,BUY,3,0.02h,Break Even,$-1.50,$-75.00,$103251.50,207,$-75.00
2024-10-16,09:24:00,20361.75,SELL,3,0.02h,Break Even,$-1.50,$-76.50,$103250.00,207,$-76.50
2024-10-16,10:00:00,20364.5,BUY,3,0.02h,Break Even,$-1.50,$-78.00,$103248.50,207,$-78.00
2024-10-16,10:10:00,20356.75,SELL,3,0.02h,Break Even,$-1.50,$-79.50,$103247.00,207,$-79.50
2024-10-16,10:24:00,20362.25,BUY,3,0.02h,Break Even,$-1.50,$-81.00,$103245.50,207,$-81.00
2024-10-16,11:06:00,20357.5,SELL,3,0.02h,Stop Loss,$-9.00,$-90.00,$103236.50,207,$-90.00
2024-10-16,11:09:00,20366.75,BUY,3,0.02h,Break Even,$-1.50,$-91.50,$103235.00,207,$-91.50
2024-10-16,11:42:00,20372.0,SELL,3,0.02h,Break Even,$-1.50,$-93.00,$103233.50,207,$-93.00
2024-10-16,12:04:00,20375.0,BUY,3,0.02h,Stop Loss,$-9.00,$-102.00,$103224.50,207,$-102.00
2024-10-16,12:05:00,20368.0,SELL,3,0.02h,Break Even,$-1.50,$-103.50,$103223.00,207,$-103.50
2024-10-16,12:53:00,20359.75,BUY,3,0.02h,Break Even,$-1.50,$-105.00,$103221.50,207,$-105.00
2024-10-16,13:00:00,20351.25,SELL,3,0.02h,Break Even,$-1.50,$-106.50,$103220.00,207,$-106.50
2024-10-16,13:01:00,20355.5,BUY,3,0.02h,Break Even,$-1.50,$-108.00,$103218.50,207,$-108.00
2024-10-16,13:23:00,20355.5,SELL,3,0.02h,Break Even,$-1.50,$-109.50,$103217.00,207,$-109.50
2024-10-16,14:09:00,20265.5,BUY,3,0.02h,Stop Loss,$108.00,$-1.50,$103325.00,207,$-1.50
2024-10-16,14:40:00,20280.0,SELL,3,0.02h,Stop Loss,$60.00,$58.50,$103385.00,207,$58.50
2024-10-16,15:12:00,20297.0,BUY,3,0.02h,Stop Loss,$34.50,$93.00,$103419.50,207,$93.00
2024-10-16,15:47:00,20294.5,SELL,3,0.02h,Stop Loss,$34.50,$127.50,$103454.00,207,$127.50
2024-10-16,16:11:00,20298.75,BUY,3,0.02h,Break Even,$-1.50,$126.00,$103452.50,207,$126.00
2024-10-16,16:14:00,20279.75,SELL,3,0.02h,Break Even,$-1.50,$124.50,$103451.00,207,$124.50
2024-10-16,16:24:00,20296.0,BUY,3,0.02h,Stop Loss,$3.00,$127.50,$103454.00,207,$127.50
2024-10-16,17:19:00,20313.0,SELL,3,0.02h,Stop Loss,$18.00,$145.50,$103472.00,207,$145.50
2024-10-16,17:35:00,20326.0,BUY,3,0.02h,Break Even,$-1.50,$144.00,$103470.50,207,$144.00
2024-10-16,17:41:00,20311.25,SELL,3,0.02h,Break Even,$-1.50,$142.50,$103469.00,207,$142.50
2024-10-16,17:44:00,20326.25,BUY,3,0.02h,Stop Loss,$13.50,$156.00,$103482.50,207,$156.00
2024-10-16,18:08:00,20323.75,SELL,3,0.02h,Stop Loss,$12.00,$168.00,$103494.50,207,$168.00
2024-10-16,18:11:00,20336.25,BUY,3,0.02h,Break Even,$-1.50,$166.50,$103493.00,207,$166.50
2024-10-16,19:02:00,20356.75,SELL,3,0.02h,Stop Loss,$10.50,$177.00,$103503.50,207,$177.00
2024-10-16,19:12:00,20364.25,BUY,3,0.02h,Stop Loss,$-9.00,$168.00,$103494.50,207,$168.00
2024-10-16,19:13:00,20358.0,SELL,3,0.02h,Break Even,$-1.50,$166.50,$103493.00,207,$166.50
2024-10-16,19:17:00,20361.75,BUY,3,0.02h,Break Even,$-1.50,$165.00,$103491.50,207,$165.00
2024-10-16,19:18:00,20358.5,SELL,3,0.02h,Break Even,$-1.50,$163.50,$103490.00,207,$163.50
2024-10-16,20:32:00,20339.0,BUY,3,0.02h,Break Even,$-1.50,$162.00,$103488.50,207,$162.00
2024-10-16,20:50:00,20333.25,SELL,3,0.02h,Stop Loss,$-9.00,$153.00,$103479.50,207,$153.00
,,,,,,,,,,,
2024-10-17,00:27:00,20305.75,BUY,3,0.02h,Break Even,$-1.50,$-1.50,$103478.00,208,$-1.50
2024-10-17,01:02:00,20310.25,SELL,3,0.02h,Stop Loss,$-9.00,$-10.50,$103469.00,208,$-10.50
2024-10-17,01:03:00,20314.75,BUY,3,0.02h,Stop Loss,$-9.00,$-19.50,$103460.00,208,$-19.50
2024-10-17,01:04:00,20311.5,SELL,3,0.02h,Stop Loss,$-9.00,$-28.50,$103451.00,208,$-28.50
2024-10-17,01:06:00,20314.0,BUY,3,0.02h,Stop Loss,$3.00,$-25.50,$103454.00,208,$-25.50
2024-10-17,01:19:00,20308.75,SELL,3,0.02h,Stop Loss,$3.00,$-22.50,$103457.00,208,$-22.50
2024-10-17,01:40:00,20309.75,BUY,3,0.02h,Stop Loss,$-9.00,$-31.50,$103448.00,208,$-31.50
2024-10-17,02:19:00,20310.0,SELL,3,0.02h,Break Even,$-1.50,$-33.00,$103446.50,208,$-33.00
2024-10-17,02:23:00,20319.25,BUY,3,0.02h,Stop Loss,$10.50,$-22.50,$103457.00,208,$-22.50
2024-10-17,02:28:00,20311.5,SELL,3,0.02h,Stop Loss,$-9.00,$-31.50,$103448.00,208,$-31.50
2024-10-17,03:03:00,20307.75,BUY,3,0.02h,Stop Loss,$-9.00,$-40.50,$103439.00,208,$-40.50
2024-10-17,03:15:00,20300.25,SELL,3,0.02h,Stop Loss,$-9.00,$-49.50,$103430.00,208,$-49.50
2024-10-17,03:42:00,20302.0,BUY,3,0.02h,Stop Loss,$-9.00,$-58.50,$103421.00,208,$-58.50
2024-10-17,03:44:00,20298.75,SELL,3,0.03h,Stop Loss,$-9.00,$-67.50,$103412.00,208,$-67.50
2024-10-17,04:46:00,20298.25,BUY,3,0.02h,Break Even,$-1.50,$-69.00,$103410.50,208,$-69.00
2024-10-17,04:54:00,20293.0,SELL,3,0.02h,Stop Loss,$-9.00,$-78.00,$103401.50,208,$-78.00
2024-10-17,04:57:00,20296.0,BUY,3,0.07h,Break Even,$-1.50,$-79.50,$103400.00,208,$-79.50
2024-10-17,06:58:00,20431.5,SELL,3,0.02h,Break Even,$-1.50,$-81.00,$103398.50,208,$-81.00
2024-10-17,07:30:00,20430.75,BUY,3,0.02h,Stop Loss,$30.00,$-51.00,$103428.50,208,$-51.00
2024-10-17,09:16:00,20485.0,SELL,3,0.02h,Stop Loss,$-9.00,$-60.00,$103419.50,208,$-60.00
2024-10-17,09:45:00,20485.25,BUY,3,0.02h,Stop Loss,$4.50,$-55.50,$103424.00,208,$-55.50
2024-10-17,11:05:00,20510.75,SELL,3,0.02h,Stop Loss,$-9.00,$-64.50,$103415.00,208,$-64.50
2024-10-17,11:40:00,20523.0,BUY,3,0.02h,Stop Loss,$-9.00,$-73.50,$103406.00,208,$-73.50
2024-10-17,11:45:00,20509.25,SELL,3,0.02h,Stop Loss,$-9.00,$-82.50,$103397.00,208,$-82.50
2024-10-17,11:57:00,20515.25,BUY,3,0.02h,Break Even,$-1.50,$-84.00,$103395.50,208,$-84.00
2024-10-17,12:27:00,20512.75,SELL,3,0.02h,Stop Loss,$-9.00,$-93.00,$103386.50,208,$-93.00
2024-10-17,12:34:00,20528.25,BUY,3,0.02h,Break Even,$-1.50,$-94.50,$103385.00,208,$-94.50
2024-10-17,12:47:00,20526.0,SELL,3,0.02h,Stop Loss,$7.50,$-87.00,$103392.50,208,$-87.00
2024-10-17,12:50:00,20533.25,BUY,3,0.02h,Stop Loss,$-9.00,$-96.00,$103383.50,208,$-96.00
2024-10-17,13:31:00,20548.0,SELL,3,0.02h,Stop Loss,$30.00,$-66.00,$103413.50,208,$-66.00
2024-10-17,14:21:00,20444.5,BUY,3,0.02h,Stop Loss,$12.00,$-54.00,$103425.50,208,$-54.00
2024-10-17,14:38:00,20414.25,SELL,3,0.02h,Stop Loss,$60.00,$6.00,$103485.50,208,$6.00
2024-10-17,15:10:00,20424.0,BUY,3,0.02h,Stop Loss,$22.50,$28.50,$103508.00,208,$28.50
2024-10-17,16:23:00,20487.75,SELL,3,0.02h,Break Even,$-1.50,$27.00,$103506.50,208,$27.00
2024-10-17,16:45:00,20488.25,BUY,3,0.02h,Stop Loss,$-9.00,$18.00,$103497.50,208,$18.00
2024-10-17,16:54:00,20471.75,SELL,3,0.02h,Stop Loss,$-9.00,$9.00,$103488.50,208,$9.00
2024-10-17,16:56:00,20486.25,BUY,3,0.02h,Stop Loss,$-9.00,$0.00,$103479.50,208,$0.00
2024-10-17,16:58:00,20474.25,SELL,3,0.02h,Stop Loss,$90.00,$90.00,$103569.50,208,$90.00
2024-10-17,17:05:00,20489.5,BUY,3,0.02h,Stop Loss,$-9.00,$81.00,$103560.50,208,$81.00
2024-10-17,17:20:00,20475.5,SELL,3,0.02h,Break Even,$-1.50,$79.50,$103559.00,208,$79.50
2024-10-17,17:40:00,20478.0,BUY,3,0.02h,Break Even,$-1.50,$78.00,$103557.50,208,$78.00
2024-10-17,17:57:00,20476.75,SELL,3,0.02h,Stop Loss,$19.50,$97.50,$103577.00,208,$97.50
2024-10-17,18:48:00,20413.25,BUY,3,0.02h,Stop Loss,$-9.00,$88.50,$103568.00,208,$88.50
2024-10-17,19:21:00,20409.0,SELL,3,0.02h,Stop Loss,$40.50,$129.00,$103608.50,208,$129.00
2024-10-17,20:02:00,20383.75,BUY,3,0.02h,Stop Loss,$30.00,$159.00,$103638.50,208,$159.00
2024-10-17,20:03:00,20372.75,SELL,3,0.02h,Break Even,$-1.50,$157.50,$103637.00,208,$157.50
2024-10-17,20:04:00,20379.25,BUY,3,0.02h,Stop Loss,$6.00,$163.50,$103643.00,208,$163.50
2024-10-17,20:28:00,20388.75,SELL,3,0.02h,Stop Loss,$-9.00,$154.50,$103634.00,208,$154.50
2024-10-17,23:00:00,20407.5,BUY,3,0.02h,Stop Loss,$-9.00,$145.50,$103625.00,208,$145.50
2024-10-17,23:48:00,20404.25,SELL,3,0.02h,Break Even,$-1.50,$144.00,$103623.50,208,$144.00
2024-10-17,23:56:00,20406.5,BUY,3,0.03h,Break Even,$-1.50,$142.50,$103622.00,208,$142.50
,,,,,,,,,,,
2024-10-18,00:01:00,20403.5,SELL,3,0.02h,Break Even,$-1.50,$-1.50,$103620.50,209,$-1.50
2024-10-18,00:51:00,20361.75,BUY,3,0.02h,Stop Loss,$-9.00,$-10.50,$103611.50,209,$-10.50
2024-10-18,01:06:00,20355.25,SELL,3,0.02h,Break Even,$-1.50,$-12.00,$103610.00,209,$-12.00
2024-10-18,01:07:00,20359.5,BUY,3,0.02h,Break Even,$-1.50,$-13.50,$103608.50,209,$-13.50
2024-10-18,01:08:00,20355.0,SELL,3,0.02h,Break Even,$-1.50,$-15.00,$103607.00,209,$-15.00
2024-10-18,01:10:00,20358.5,BUY,3,0.02h,Stop Loss,$-9.00,$-24.00,$103598.00,209,$-24.00
2024-10-18,01:11:00,20356.25,SELL,3,0.02h,Stop Loss,$15.00,$-9.00,$103613.00,209,$-9.00
2024-10-18,01:18:00,20359.25,BUY,3,0.02h,Break Even,$-1.50,$-10.50,$103611.50,209,$-10.50
2024-10-18,01:27:00,20356.25,SELL,3,0.02h,Stop Loss,$-9.00,$-19.50,$103602.50,209,$-19.50
2024-10-18,01:29:00,20363.5,BUY,3,0.02h,Stop Loss,$-9.00,$-28.50,$103593.50,209,$-28.50
2024-10-18,02:06:00,20372.25,SELL,3,0.02h,Stop Loss,$4.50,$-24.00,$103598.00,209,$-24.00
2024-10-18,02:30:00,20375.25,BUY,3,0.02h,Stop Loss,$3.00,$-21.00,$103601.00,209,$-21.00
2024-10-18,02:51:00,20379.5,SELL,3,0.02h,Stop Loss,$10.50,$-10.50,$103611.50,209,$-10.50
2024-10-18,03:04:00,20382.0,BUY,3,0.03h,Break Even,$-1.50,$-12.00,$103610.00,209,$-12.00
2024-10-18,03:11:00,20376.25,SELL,3,0.02h,Stop Loss,$-9.00,$-21.00,$103601.00,209,$-21.00
2024-10-18,04:18:00,20366.0,BUY,3,0.02h,Break Even,$-1.50,$-22.50,$103599.50,209,$-22.50
2024-10-18,04:57:00,20368.75,SELL,3,0.02h,Stop Loss,$-9.00,$-31.50,$103590.50,209,$-31.50
2024-10-18,05:01:00,20379.0,BUY,3,0.02h,Stop Loss,$-9.00,$-40.50,$103581.50,209,$-40.50
2024-10-18,05:03:00,20373.0,SELL,3,0.02h,Stop Loss,$-9.00,$-49.50,$103572.50,209,$-49.50
2024-10-18,05:11:00,20377.75,BUY,3,0.02h,Stop Loss,$4.50,$-45.00,$103577.00,209,$-45.00
2024-10-18,07:23:00,20426.0,SELL,3,0.02h,Stop Loss,$-9.00,$-54.00,$103568.00,209,$-54.00
2024-10-18,07:26:00,20433.5,BUY,3,0.02h,Stop Loss,$-9.00,$-63.00,$103559.00,209,$-63.00
2024-10-18,07:47:00,20427.25,SELL,3,0.02h,Stop Loss,$-9.00,$-72.00,$103550.00,209,$-72.00
2024-10-18,07:52:00,20435.75,BUY,3,0.02h,Break Even,$-1.50,$-73.50,$103548.50,209,$-73.50
2024-10-18,08:26:00,20451.0,SELL,3,0.02h,Stop Loss,$4.50,$-69.00,$103553.00,209,$-69.00
2024-10-18,08:51:00,20452.75,BUY,3,0.02h,Stop Loss,$-9.00,$-78.00,$103544.00,209,$-78.00
2024-10-18,08:55:00,20444.5,SELL,3,0.02h,Stop Loss,$-9.00,$-87.00,$103535.00,209,$-87.00
2024-10-18,09:01:00,20450.5,BUY,3,0.02h,Stop Loss,$-9.00,$-96.00,$103526.00,209,$-96.00
2024-10-18,09:21:00,20445.25,SELL,3,0.02h,Stop Loss,$-9.00,$-105.00,$103517.00,209,$-105.00
2024-10-18,10:20:00,20430.0,BUY,3,0.02h,Stop Loss,$-9.00,$-114.00,$103508.00,209,$-114.00
2024-10-18,10:21:00,20428.0,SELL,3,0.02h,Stop Loss,$4.50,$-109.50,$103512.50,209,$-109.50
2024-10-18,10:24:00,20437.5,BUY,3,0.02h,Stop Loss,$-9.00,$-118.50,$103503.50,209,$-118.50
2024-10-18,11:07:00,20443.5,SELL,3,0.02h,Stop Loss,$6.00,$-112.50,$103509.50,209,$-112.50
2024-10-18,11:13:00,20450.75,BUY,3,0.02h,Break Even,$-1.50,$-114.00,$103508.00,209,$-114.00
2024-10-18,11:59:00,20468.75,SELL,3,0.02h,Break Even,$-1.50,$-115.50,$103506.50,209,$-115.50
2024-10-18,12:17:00,20470.5,BUY,3,0.02h,Stop Loss,$-9.00,$-124.50,$103497.50,209,$-124.50
2024-10-18,12:19:00,20467.25,SELL,3,0.02h,Break Even,$-1.50,$-126.00,$103496.00,209,$-126.00
2024-10-18,12:29:00,20469.5,BUY,3,0.02h,Break Even,$-1.50,$-127.50,$103494.50,209,$-127.50
2024-10-18,12:56:00,20474.25,SELL,3,0.02h,Stop Loss,$-9.00,$-136.50,$103485.50,209,$-136.50
2024-10-18,13:00:00,20478.5,BUY,3,0.02h,Break Even,$-1.50,$-138.00,$103484.00,209,$-138.00
2024-10-18,13:27:00,20462.0,SELL,3,0.02h,Break Even,$-1.50,$-139.50,$103482.50,209,$-139.50
2024-10-18,13:44:00,20489.25,BUY,3,0.02h,Stop Loss,$57.00,$-82.50,$103539.50,209,$-82.50
2024-10-18,13:51:00,20463.0,SELL,3,0.02h,Stop Loss,$42.00,$-40.50,$103581.50,209,$-40.50
2024-10-18,13:56:00,20485.0,BUY,3,0.02h,Stop Loss,$3.00,$-37.50,$103584.50,209,$-37.50
2024-10-18,14:20:00,20487.5,SELL,3,0.02h,Stop Loss,$3.00,$-34.50,$103587.50,209,$-34.50
2024-10-18,14:22:00,20492.75,BUY,3,0.02h,Break Even,$-1.50,$-36.00,$103586.00,209,$-36.00
2024-10-18,14:23:00,20487.5,SELL,3,0.02h,Stop Loss,$40.50,$4.50,$103626.50,209,$4.50
2024-10-18,14:25:00,20492.5,BUY,3,0.02h,Stop Loss,$3.00,$7.50,$103629.50,209,$7.50
2024-10-18,14:26:00,20487.0,SELL,3,0.02h,Break Even,$-1.50,$6.00,$103628.00,209,$6.00
2024-10-18,14:27:00,20492.0,BUY,3,0.02h,Stop Loss,$-9.00,$-3.00,$103619.00,209,$-3.00
2024-10-18,14:28:00,20480.0,SELL,3,0.02h,Stop Loss,$15.00,$12.00,$103634.00,209,$12.00
2024-10-18,14:30:00,20499.5,BUY,3,0.02h,Stop Loss,$22.50,$34.50,$103656.50,209,$34.50
2024-10-18,14:37:00,20475.75,SELL,3,0.02h,Stop Loss,$10.50,$45.00,$103667.00,209,$45.00
2024-10-18,14:43:00,20494.25,BUY,3,0.02h,Break Even,$-1.50,$43.50,$103665.50,209,$43.50
2024-10-18,14:53:00,20481.75,SELL,3,0.02h,Stop Loss,$21.00,$64.50,$103686.50,209,$64.50
2024-10-18,15:07:00,20487.5,BUY,3,0.02h,Stop Loss,$10.50,$75.00,$103697.00,209,$75.00
2024-10-18,15:39:00,20491.5,SELL,3,0.02h,Stop Loss,$-9.00,$66.00,$103688.00,209,$66.00
2024-10-18,16:33:00,20468.0,BUY,3,0.02h,Stop Loss,$19.50,$85.50,$103707.50,209,$85.50
2024-10-18,17:27:00,20500.75,SELL,3,0.02h,Stop Loss,$58.50,$144.00,$103766.00,209,$144.00
2024-10-18,17:47:00,20503.0,BUY,3,0.02h,Stop Loss,$-9.00,$135.00,$103757.00,209,$135.00
2024-10-18,17:51:00,20494.5,SELL,3,0.02h,Break Even,$-1.50,$133.50,$103755.50,209,$133.50
2024-10-18,18:13:00,20495.75,BUY,3,0.02h,Break Even,$-1.50,$132.00,$103754.00,209,$132.00
2024-10-18,18:38:00,20495.0,SELL,3,0.02h,Stop Loss,$15.00,$147.00,$103769.00,209,$147.00
2024-10-18,19:28:00,20490.5,BUY,3,0.02h,Stop Loss,$12.00,$159.00,$103781.00,209,$159.00
2024-10-18,19:35:00,20481.0,SELL,3,0.02h,Stop Loss,$9.00,$168.00,$103790.00,209,$168.00
2024-10-18,19:38:00,20489.25,BUY,3,0.02h,Stop Loss,$-9.00,$159.00,$103781.00,209,$159.00
2024-10-18,19:39:00,20481.0,SELL,3,0.02h,Break Even,$-1.50,$157.50,$103779.50,209,$157.50
2024-10-18,19:58:00,20488.5,BUY,3,0.02h,Stop Loss,$-9.00,$148.50,$103770.50,209,$148.50
2024-10-18,20:30:00,20489.75,SELL,3,0.02h,Break Even,$-1.50,$147.00,$103769.00,209,$147.00
2024-10-18,20:32:00,20491.0,BUY,3,0.03h,Break Even,$-1.50,$145.50,$103767.50,209,$145.50
2024-10-18,20:35:00,20488.0,SELL,3,0.02h,Stop Loss,$-9.00,$136.50,$103758.50,209,$136.50
2024-10-18,20:40:00,20492.25,BUY,3,0.02h,Stop Loss,$-9.00,$127.50,$103749.50,209,$127.50
2024-10-18,20:49:00,20489.5,SELL,3,0.02h,Break Even,$-1.50,$126.00,$103748.00,209,$126.00
,,,,,,,,,,,
2024-10-21,00:00:00,20513.5,BUY,3,0.02h,Break Even,$-1.50,$-1.50,$103746.50,210,$-1.50
2024-10-21,00:22:00,20501.5,SELL,3,0.02h,Stop Loss,$-9.00,$-10.50,$103737.50,210,$-10.50
2024-10-21,00:25:00,20505.5,BUY,3,0.02h,Stop Loss,$-9.00,$-19.50,$103728.50,210,$-19.50
2024-10-21,00:26:00,20503.0,SELL,3,0.03h,Stop Loss,$-9.00,$-28.50,$103719.50,210,$-28.50
2024-10-21,00:31:00,20506.75,BUY,3,0.02h,Break Even,$-1.50,$-30.00,$103718.00,210,$-30.00
2024-10-21,01:00:00,20510.25,SELL,3,0.02h,Stop Loss,$-9.00,$-39.00,$103709.00,210,$-39.00
2024-10-21,01:20:00,20514.5,BUY,3,0.02h,Stop Loss,$-9.00,$-48.00,$103700.00,210,$-48.00
2024-10-21,01:39:00,20509.0,SELL,3,0.02h,Stop Loss,$-9.00,$-57.00,$103691.00,210,$-57.00
2024-10-21,02:26:00,20506.75,BUY,3,0.02h,Stop Loss,$-9.00,$-66.00,$103682.00,210,$-66.00
2024-10-21,02:27:00,20502.75,SELL,3,0.02h,Stop Loss,$-9.00,$-75.00,$103673.00,210,$-75.00
2024-10-21,02:28:00,20508.25,BUY,3,0.02h,Break Even,$-1.50,$-76.50,$103671.50,210,$-76.50
2024-10-21,02:35:00,20503.5,SELL,3,0.02h,Stop Loss,$-9.00,$-85.50,$103662.50,210,$-85.50
2024-10-21,03:11:00,20495.5,BUY,3,0.02h,Stop Loss,$-9.00,$-94.50,$103653.50,210,$-94.50
2024-10-21,03:16:00,20489.75,SELL,3,0.02h,Break Even,$-1.50,$-96.00,$103652.00,210,$-96.00
2024-10-21,03:32:00,20493.25,BUY,3,0.02h,Break Even,$-1.50,$-97.50,$103650.50,210,$-97.50
2024-10-21,03:48:00,20491.75,SELL,3,0.02h,Stop Loss,$-9.00,$-106.50,$103641.50,210,$-106.50
2024-10-21,06:06:00,20453.0,BUY,3,0.02h,Stop Loss,$3.00,$-103.50,$103644.50,210,$-103.50
2024-10-21,06:16:00,20449.0,SELL,3,0.02h,Break Even,$-1.50,$-105.00,$103643.00,210,$-105.00
2024-10-21,06:20:00,20458.0,BUY,3,0.02h,Break Even,$-1.50,$-106.50,$103641.50,210,$-106.50
2024-10-21,06:35:00,20450.75,SELL,3,0.02h,Stop Loss,$37.50,$-69.00,$103679.00,210,$-69.00
2024-10-21,07:06:00,20446.5,BUY,3,0.02h,Stop Loss,$-9.00,$-78.00,$103670.00,210,$-78.00
2024-10-21,07:27:00,20442.0,SELL,3,0.02h,Stop Loss,$12.00,$-66.00,$103682.00,210,$-66.00
2024-10-21,07:37:00,20451.75,BUY,3,0.02h,Break Even,$-1.50,$-67.50,$103680.50,210,$-67.50
2024-10-21,07:56:00,20447.75,SELL,3,0.02h,Stop Loss,$4.50,$-63.00,$103685.00,210,$-63.00
2024-10-21,08:05:00,20455.5,BUY,3,0.02h,Break Even,$-1.50,$-64.50,$103683.50,210,$-64.50
2024-10-21,08:13:00,20441.75,SELL,3,0.02h,Break Even,$-1.50,$-66.00,$103682.00,210,$-66.00
2024-10-21,08:34:00,20448.5,BUY,3,0.02h,Stop Loss,$-9.00,$-75.00,$103673.00,210,$-75.00
2024-10-21,09:07:00,20452.0,SELL,3,0.02h,Break Even,$-1.50,$-76.50,$103671.50,210,$-76.50
2024-10-21,09:45:00,20427.75,BUY,3,0.02h,Stop Loss,$3.00,$-73.50,$103674.50,210,$-73.50
2024-10-21,10:02:00,20424.25,SELL,3,0.02h,Stop Loss,$19.50,$-54.00,$103694.00,210,$-54.00
2024-10-21,10:14:00,20428.25,BUY,3,0.02h,Stop Loss,$-9.00,$-63.00,$103685.00,210,$-63.00
2024-10-21,10:19:00,20423.0,SELL,3,0.02h,Stop Loss,$-9.00,$-72.00,$103676.00,210,$-72.00
2024-10-21,10:33:00,20426.75,BUY,3,0.02h,Stop Loss,$-9.00,$-81.00,$103667.00,210,$-81.00
2024-10-21,10:38:00,20415.25,SELL,3,0.02h,Break Even,$-1.50,$-82.50,$103665.50,210,$-82.50
2024-10-21,11:45:00,20359.0,BUY,3,0.02h,Break Even,$-1.50,$-84.00,$103664.00,210,$-84.00
2024-10-21,11:46:00,20357.25,SELL,3,0.02h,Stop Loss,$6.00,$-78.00,$103670.00,210,$-78.00
2024-10-21,11:56:00,20362.5,BUY,3,0.02h,Stop Loss,$-9.00,$-87.00,$103661.00,210,$-87.00
2024-10-21,12:01:00,20352.0,SELL,3,0.02h,Stop Loss,$-9.00,$-96.00,$103652.00,210,$-96.00
2024-10-21,12:03:00,20360.75,BUY,3,0.02h,Break Even,$-1.50,$-97.50,$103650.50,210,$-97.50
2024-10-21,14:29:00,20507.0,SELL,3,0.02h,Stop Loss,$15.00,$-82.50,$103665.50,210,$-82.50
2024-10-21,15:39:00,20379.75,BUY,3,0.02h,Stop Loss,$117.00,$34.50,$103782.50,210,$34.50
2024-10-21,16:29:00,20441.0,SELL,3,0.02h,Stop Loss,$-9.00,$25.50,$103773.50,210,$25.50
2024-10-21,16:35:00,20453.0,BUY,3,0.02h,Break Even,$-1.50,$24.00,$103772.00,210,$24.00
2024-10-21,16:36:00,20444.0,SELL,3,0.02h,Stop Loss,$30.00,$54.00,$103802.00,210,$54.00
2024-10-21,16:50:00,20445.5,BUY,3,0.02h,Stop Loss,$6.00,$60.00,$103808.00,210,$60.00
2024-10-21,17:23:00,20463.75,SELL,3,0.02h,Stop Loss,$-9.00,$51.00,$103799.00,210,$51.00
2024-10-21,17:28:00,20474.0,BUY,3,0.02h,Stop Loss,$-9.00,$42.00,$103790.00,210,$42.00
2024-10-21,18:07:00,20478.25,SELL,3,0.02h,Stop Loss,$10.50,$52.50,$103800.50,210,$52.50
2024-10-21,18:17:00,20491.75,BUY,3,0.02h,Break Even,$-1.50,$51.00,$103799.00,210,$51.00
2024-10-21,18:21:00,20480.5,SELL,3,0.02h,Stop Loss,$10.50,$61.50,$103809.50,210,$61.50
2024-10-21,19:11:00,20470.25,BUY,3,0.02h,Stop Loss,$-9.00,$52.50,$103800.50,210,$52.50
2024-10-21,19:32:00,20469.75,SELL,3,0.02h,Stop Loss,$4.50,$57.00,$103805.00,210,$57.00
2024-10-21,19:47:00,20481.75,BUY,3,0.02h,Stop Loss,$-9.00,$48.00,$103796.00,210,$48.00
2024-10-21,20:55:00,20536.75,SELL,3,0.02h,Stop Loss,$-9.00,$39.00,$103787.00,210,$39.00
2024-10-21,20:59:00,20543.75,BUY,3,0.02h,Stop Loss,$-9.00,$30.00,$103778.00,210,$30.00
2024-10-21,23:00:00,20516.25,SELL,3,0.02h,Stop Loss,$-9.00,$21.00,$103769.00,210,$21.00
2024-10-21,23:58:00,20517.5,BUY,3,0.02h,Stop Loss,$-9.00,$12.00,$103760.00,210,$12.00
,,,,,,,,,,,
2024-10-22,00:01:00,20508.25,SELL,3,0.02h,Stop Loss,$4.50,$4.50,$103764.50,211,$4.50
2024-10-22,00:25:00,20507.5,BUY,3,0.02h,Stop Loss,$-9.00,$-4.50,$103755.50,211,$-4.50
2024-10-22,00:36:00,20497.75,SELL,3,0.02h,Break Even,$-1.50,$-6.00,$103754.00,211,$-6.00
2024-10-22,01:54:00,20471.0,BUY,3,0.02h,Break Even,$-1.50,$-7.50,$103752.50,211,$-7.50
2024-10-22,02:26:00,20474.75,SELL,3,0.02h,Stop Loss,$-9.00,$-16.50,$103743.50,211,$-16.50
2024-10-22,02:42:00,20478.25,BUY,3,0.02h,Stop Loss,$-9.00,$-25.50,$103734.50,211,$-25.50
2024-10-22,02:45:00,20471.25,SELL,3,0.02h,Stop Loss,$22.50,$-3.00,$103757.00,211,$-3.00
2024-10-22,03:10:00,20470.75,BUY,3,0.02h,Break Even,$-1.50,$-4.50,$103755.50,211,$-4.50
2024-10-22,03:45:00,20468.75,SELL,3,0.02h,Break Even,$-1.50,$-6.00,$103754.00,211,$-6.00
2024-10-22,04:19:00,20472.0,BUY,3,0.02h,Stop Loss,$-9.00,$-15.00,$103745.00,211,$-15.00
2024-10-22,04:44:00,20468.5,SELL,3,0.02h,Stop Loss,$-9.00,$-24.00,$103736.00,211,$-24.00
2024-10-22,05:25:00,20454.5,BUY,3,0.02h,Break Even,$-1.50,$-25.50,$103734.50,211,$-25.50
2024-10-22,05:51:00,20449.5,SELL,3,0.02h,Stop Loss,$-9.00,$-34.50,$103725.50,211,$-34.50
2024-10-22,06:05:00,20459.25,BUY,3,0.02h,Stop Loss,$-9.00,$-43.50,$103716.50,211,$-43.50
2024-10-22,06:06:00,20452.75,SELL,3,0.02h,Break Even,$-1.50,$-45.00,$103715.00,211,$-45.00
2024-10-22,06:24:00,20459.25,BUY,3,0.02h,Break Even,$-1.50,$-46.50,$103713.50,211,$-46.50
2024-10-22,06:28:00,20451.75,SELL,3,0.02h,Stop Loss,$-9.00,$-55.50,$103704.50,211,$-55.50
2024-10-22,06:36:00,20460.0,BUY,3,0.02h,Stop Loss,$-9.00,$-64.50,$103695.50,211,$-64.50
2024-10-22,06:43:00,20450.0,SELL,3,0.02h,Stop Loss,$45.00,$-19.50,$103740.50,211,$-19.50
2024-10-22,07:05:00,20451.25,BUY,3,0.02h,Break Even,$-1.50,$-21.00,$103739.00,211,$-21.00
2024-10-22,07:51:00,20465.25,SELL,3,0.02h,Break Even,$-1.50,$-22.50,$103737.50,211,$-22.50
2024-10-22,08:16:00,20465.5,BUY,3,0.02h,Stop Loss,$-9.00,$-31.50,$103728.50,211,$-31.50
2024-10-22,08:30:00,20459.25,SELL,3,0.02h,Break Even,$-1.50,$-33.00,$103727.00,211,$-33.00
2024-10-22,08:51:00,20453.5,BUY,3,0.02h,Stop Loss,$-9.00,$-42.00,$103718.00,211,$-42.00
2024-10-22,08:53:00,20447.5,SELL,3,0.02h,Break Even,$-1.50,$-43.50,$103716.50,211,$-43.50
2024-10-22,10:10:00,20397.5,BUY,3,0.02h,Stop Loss,$6.00,$-37.50,$103722.50,211,$-37.50
2024-10-22,10:33:00,20395.5,SELL,3,0.02h,Stop Loss,$-9.00,$-46.50,$103713.50,211,$-46.50
2024-10-22,10:34:00,20406.25,BUY,3,0.02h,Break Even,$-1.50,$-48.00,$103712.00,211,$-48.00
2024-10-22,10:36:00,20397.25,SELL,3,0.02h,Stop Loss,$13.50,$-34.50,$103725.50,211,$-34.50
2024-10-22,10:49:00,20399.0,BUY,3,0.02h,Stop Loss,$-9.00,$-43.50,$103716.50,211,$-43.50
2024-10-22,10:52:00,20391.5,SELL,3,0.02h,Stop Loss,$16.50,$-27.00,$103733.00,211,$-27.00
2024-10-22,11:01:00,20400.0,BUY,3,0.02h,Break Even,$-1.50,$-28.50,$103731.50,211,$-28.50
2024-10-22,11:45:00,20413.0,SELL,3,0.02h,Break Even,$-1.50,$-30.00,$103730.00,211,$-30.00
2024-10-22,12:05:00,20422.5,BUY,3,0.02h,Break Even,$-1.50,$-31.50,$103728.50,211,$-31.50
2024-10-22,12:30:00,20421.25,SELL,3,0.02h,Stop Loss,$-9.00,$-40.50,$103719.50,211,$-40.50
2024-10-22,13:15:00,20391.75,BUY,3,0.02h,Break Even,$-1.50,$-42.00,$103718.00,211,$-42.00
2024-10-22,14:40:00,20482.25,SELL,3,0.02h,Stop Loss,$-9.00,$-51.00,$103709.00,211,$-51.00
2024-10-22,14:56:00,20492.0,BUY,3,0.02h,Break Even,$-1.50,$-52.50,$103707.50,211,$-52.50
2024-10-22,15:12:00,20479.0,SELL,3,0.02h,Stop Loss,$7.50,$-45.00,$103715.00,211,$-45.00
2024-10-22,15:33:00,20486.25,BUY,3,0.02h,Break Even,$-1.50,$-46.50,$103713.50,211,$-46.50
2024-10-22,15:51:00,20474.75,SELL,3,0.02h,Stop Loss,$25.50,$-21.00,$103739.00,211,$-21.00
2024-10-22,15:56:00,20490.25,BUY,3,0.02h,Stop Loss,$-9.00,$-30.00,$103730.00,211,$-30.00
2024-10-22,16:00:00,20472.75,SELL,3,0.02h,Stop Loss,$30.00,$0.00,$103760.00,211,$0.00
2024-10-22,16:50:00,20463.25,BUY,3,0.02h,Stop Loss,$61.50,$61.50,$103821.50,211,$61.50
2024-10-22,18:14:00,20549.5,SELL,3,0.02h,Stop Loss,$7.50,$69.00,$103829.00,211,$69.00
2024-10-22,19:12:00,20543.25,BUY,3,0.02h,Break Even,$-1.50,$67.50,$103827.50,211,$67.50
2024-10-22,19:43:00,20544.25,SELL,3,0.02h,Break Even,$-1.50,$66.00,$103826.00,211,$66.00
2024-10-22,19:44:00,20548.25,BUY,3,0.02h,Break Even,$-1.50,$64.50,$103824.50,211,$64.50
2024-10-22,20:01:00,20524.25,SELL,3,0.02h,Stop Loss,$81.00,$145.50,$103905.50,211,$145.50
2024-10-22,20:36:00,20527.25,BUY,3,0.02h,Break Even,$-1.50,$144.00,$103904.00,211,$144.00
2024-10-22,20:46:00,20518.25,SELL,3,0.02h,Stop Loss,$-9.00,$135.00,$103895.00,211,$135.00
2024-10-22,20:50:00,20527.25,BUY,3,0.02h,Stop Loss,$-9.00,$126.00,$103886.00,211,$126.00
2024-10-22,20:51:00,20521.25,SELL,3,0.02h,Stop Loss,$-9.00,$117.00,$103877.00,211,$117.00
2024-10-22,20:52:00,20525.25,BUY,3,0.02h,Break Even,$-1.50,$115.50,$103875.50,211,$115.50
2024-10-22,21:00:00,20517.5,SELL,3,2.02h,Stop Loss,$64.50,$180.00,$103940.00,211,$180.00
2024-10-22,23:29:00,20513.25,BUY,3,0.02h,Stop Loss,$-9.00,$171.00,$103931.00,211,$171.00
,,,,,,,,,,,
2024-10-23,00:11:00,20521.5,SELL,3,0.02h,Stop Loss,$-9.00,$-9.00,$103922.00,212,$-9.00
2024-10-23,01:15:00,20504.5,BUY,3,0.02h,Stop Loss,$6.00,$-3.00,$103928.00,212,$-3.00
2024-10-23,01:41:00,20507.5,SELL,3,0.02h,Stop Loss,$-9.00,$-12.00,$103919.00,212,$-12.00
2024-10-23,01:42:00,20511.0,BUY,3,0.02h,Stop Loss,$-9.00,$-21.00,$103910.00,212,$-21.00
2024-10-23,01:43:00,20506.0,SELL,3,0.02h,Break Even,$-1.50,$-22.50,$103908.50,212,$-22.50
2024-10-23,01:48:00,20510.5,BUY,3,0.02h,Stop Loss,$3.00,$-19.50,$103911.50,212,$-19.50
2024-10-23,01:55:00,20507.25,SELL,3,0.02h,Stop Loss,$-9.00,$-28.50,$103902.50,212,$-28.50
2024-10-23,01:57:00,20509.0,BUY,3,0.02h,Stop Loss,$-9.00,$-37.50,$103893.50,212,$-37.50
2024-10-23,01:58:00,20508.5,SELL,3,0.02h,Break Even,$-1.50,$-39.00,$103892.00,212,$-39.00
2024-10-23,02:01:00,20512.75,BUY,3,0.02h,Stop Loss,$-9.00,$-48.00,$103883.00,212,$-48.00
2024-10-23,02:06:00,20502.25,SELL,3,0.02h,Stop Loss,$-9.00,$-57.00,$103874.00,212,$-57.00
2024-10-23,02:09:00,20512.0,BUY,3,0.02h,Stop Loss,$-9.00,$-66.00,$103865.00,212,$-66.00
2024-10-23,02:34:00,20514.75,SELL,3,0.02h,Stop Loss,$-9.00,$-75.00,$103856.00,212,$-75.00
2024-10-23,02:52:00,20518.5,BUY,3,0.02h,Stop Loss,$-9.00,$-84.00,$103847.00,212,$-84.00
2024-10-23,02:54:00,20515.75,SELL,3,0.02h,Stop Loss,$-9.00,$-93.00,$103838.00,212,$-93.00
2024-10-23,02:57:00,20518.5,BUY,3,0.02h,Break Even,$-1.50,$-94.50,$103836.50,212,$-94.50
2024-10-23,03:30:00,20521.0,SELL,3,0.02h,Stop Loss,$21.00,$-73.50,$103857.50,212,$-73.50
2024-10-23,04:03:00,20517.5,BUY,3,0.02h,Stop Loss,$-9.00,$-82.50,$103848.50,212,$-82.50
2024-10-23,04:06:00,20510.75,SELL,3,0.03h,Break Even,$-1.50,$-84.00,$103847.00,212,$-84.00
2024-10-23,04:16:00,20513.75,BUY,3,0.02h,Stop Loss,$-9.00,$-93.00,$103838.00,212,$-93.00
2024-10-23,04:17:00,20512.25,SELL,3,0.02h,Stop Loss,$-9.00,$-102.00,$103829.00,212,$-102.00
2024-10-23,04:18:00,20518.25,BUY,3,0.02h,Stop Loss,$-9.00,$-111.00,$103820.00,212,$-111.00
2024-10-23,05:04:00,20518.25,SELL,3,0.02h,Stop Loss,$-9.00,$-120.00,$103811.00,212,$-120.00
2024-10-23,05:05:00,20519.75,BUY,3,0.08h,Stop Loss,$19.50,$-100.50,$103830.50,212,$-100.50
2024-10-23,05:25:00,20518.5,SELL,3,0.02h,Stop Loss,$-9.00,$-109.50,$103821.50,212,$-109.50
2024-10-23,06:18:00,20510.5,BUY,3,0.02h,Stop Loss,$-9.00,$-118.50,$103812.50,212,$-118.50
2024-10-23,06:22:00,20500.5,SELL,3,0.02h,Break Even,$-1.50,$-120.00,$103811.00,212,$-120.00
2024-10-23,06:55:00,20506.5,BUY,3,0.02h,Stop Loss,$-9.00,$-129.00,$103802.00,212,$-129.00
2024-10-23,07:03:00,20500.0,SELL,3,0.02h,Stop Loss,$-9.00,$-138.00,$103793.00,212,$-138.00
2024-10-23,07:04:00,20507.0,BUY,3,0.02h,Break Even,$-1.50,$-139.50,$103791.50,212,$-139.50
2024-10-23,07:33:00,20518.25,SELL,3,0.02h,Stop Loss,$10.50,$-129.00,$103802.00,212,$-129.00
2024-10-23,08:08:00,20513.75,BUY,3,0.02h,Stop Loss,$16.50,$-112.50,$103818.50,212,$-112.50
2024-10-23,08:21:00,20508.75,SELL,3,0.02h,Break Even,$-1.50,$-114.00,$103817.00,212,$-114.00
2024-10-23,09:07:00,20497.25,BUY,3,0.02h,Break Even,$-1.50,$-115.50,$103815.50,212,$-115.50
2024-10-23,09:16:00,20489.75,SELL,3,0.02h,Stop Loss,$-9.00,$-124.50,$103806.50,212,$-124.50
2024-10-23,09:17:00,20500.75,BUY,3,0.02h,Stop Loss,$10.50,$-114.00,$103817.00,212,$-114.00
2024-10-23,09:23:00,20492.0,SELL,3,0.02h,Stop Loss,$-9.00,$-123.00,$103808.00,212,$-123.00
2024-10-23,09:26:00,20496.5,BUY,3,0.02h,Break Even,$-1.50,$-124.50,$103806.50,212,$-124.50
2024-10-23,09:38:00,20492.25,SELL,3,0.02h,Break Even,$-1.50,$-126.00,$103805.00,212,$-126.00
2024-10-23,09:56:00,20496.25,BUY,3,0.02h,Break Even,$-1.50,$-127.50,$103803.50,212,$-127.50
2024-10-23,09:59:00,20485.0,SELL,3,0.02h,Break Even,$-1.50,$-129.00,$103802.00,212,$-129.00
2024-10-23,11:04:00,20470.5,BUY,3,0.02h,Stop Loss,$-9.00,$-138.00,$103793.00,212,$-138.00
2024-10-23,11:27:00,20463.5,SELL,3,0.02h,Stop Loss,$-9.00,$-147.00,$103784.00,212,$-147.00
2024-10-23,11:42:00,20472.0,BUY,3,0.02h,Stop Loss,$-9.00,$-156.00,$103775.00,212,$-156.00
2024-10-23,11:45:00,20469.75,SELL,3,0.02h,Stop Loss,$-9.00,$-165.00,$103766.00,212,$-165.00
2024-10-23,11:46:00,20472.0,BUY,3,0.02h,Stop Loss,$-9.00,$-174.00,$103757.00,212,$-174.00
2024-10-23,11:47:00,20470.25,SELL,3,0.02h,Stop Loss,$-9.00,$-183.00,$103748.00,212,$-183.00
2024-10-23,11:48:00,20477.0,BUY,3,0.02h,Break Even,$-1.50,$-184.50,$103746.50,212,$-184.50
2024-10-23,12:01:00,20463.5,SELL,3,0.02h,Stop Loss,$-9.00,$-193.50,$103737.50,212,$-193.50
2024-10-23,12:17:00,20480.0,BUY,3,0.02h,Break Even,$-1.50,$-195.00,$103736.00,212,$-195.00
2024-10-23,12:34:00,20469.5,SELL,3,0.02h,Stop Loss,$16.50,$-178.50,$103752.50,212,$-178.50
2024-10-23,13:42:00,20436.75,BUY,3,0.02h,Stop Loss,$25.50,$-153.00,$103778.00,212,$-153.00
2024-10-23,13:45:00,20427.0,SELL,3,0.02h,Stop Loss,$43.50,$-109.50,$103821.50,212,$-109.50
2024-10-23,13:49:00,20442.25,BUY,3,0.02h,Stop Loss,$-9.00,$-118.50,$103812.50,212,$-118.50
2024-10-23,13:51:00,20423.5,SELL,3,0.02h,Stop Loss,$55.50,$-63.00,$103868.00,212,$-63.00
2024-10-23,13:57:00,20440.5,BUY,3,0.02h,Stop Loss,$21.00,$-42.00,$103889.00,212,$-42.00
2024-10-23,14:01:00,20418.75,SELL,3,0.02h,Stop Loss,$91.50,$49.50,$103980.50,212,$49.50
2024-10-23,14:30:00,20418.25,BUY,3,0.02h,Stop Loss,$34.50,$84.00,$104015.00,212,$84.00
2024-10-23,14:55:00,20407.75,SELL,3,0.02h,Stop Loss,$40.50,$124.50,$104055.50,212,$124.50
2024-10-23,15:46:00,20348.0,BUY,3,0.02h,Stop Loss,$4.50,$129.00,$104060.00,212,$129.00
2024-10-23,16:04:00,20296.0,SELL,3,0.02h,Stop Loss,$12.00,$141.00,$104072.00,212,$141.00
2024-10-23,16:49:00,20273.75,BUY,3,0.02h,Stop Loss,$19.50,$160.50,$104091.50,212,$160.50
2024-10-23,16:52:00,20256.5,SELL,3,0.02h,Stop Loss,$30.00,$190.50,$104121.50,212,$190.50
2024-10-23,18:26:00,20128.0,BUY,3,0.02h,Stop Loss,$27.00,$217.50,$104148.50,212,$217.50
2024-10-23,19:11:00,20166.25,SELL,3,0.02h,Stop Loss,$54.00,$271.50,$104202.50,212,$271.50
2024-10-23,19:19:00,20174.0,BUY,3,0.02h,Stop Loss,$27.00,$298.50,$104229.50,212,$298.50
2024-10-23,20:48:00,20278.0,SELL,3,0.02h,Stop Loss,$-9.00,$289.50,$104220.50,212,$289.50
2024-10-23,20:50:00,20283.25,BUY,3,0.02h,Stop Loss,$-9.00,$280.50,$104211.50,212,$280.50
2024-10-23,20:51:00,20281.0,SELL,3,0.02h,Stop Loss,$-9.00,$271.50,$104202.50,212,$271.50
2024-10-23,20:53:00,20286.25,BUY,3,0.03h,Break Even,$-1.50,$270.00,$104201.00,212,$270.00
2024-10-23,20:56:00,20278.0,SELL,3,0.02h,Stop Loss,$19.50,$289.50,$104220.50,212,$289.50
2024-10-23,23:04:00,20284.75,BUY,3,0.02h,Stop Loss,$-9.00,$280.50,$104211.50,212,$280.50
2024-10-23,23:21:00,20278.75,SELL,3,0.02h,Stop Loss,$-9.00,$271.50,$104202.50,212,$271.50
2024-10-23,23:34:00,20285.75,BUY,3,0.02h,Break Even,$-1.50,$270.00,$104201.00,212,$270.00
,,,,,,,,,,,
2024-10-24,00:05:00,20284.5,SELL,3,0.02h,Stop Loss,$-9.00,$-9.00,$104192.00,213,$-9.00
2024-10-24,00:24:00,20289.5,BUY,3,0.02h,Break Even,$-1.50,$-10.50,$104190.50,213,$-10.50
2024-10-24,01:22:00,20325.25,SELL,3,0.02h,Break Even,$-1.50,$-12.00,$104189.00,213,$-12.00
2024-10-24,01:26:00,20331.5,BUY,3,0.02h,Break Even,$-1.50,$-13.50,$104187.50,213,$-13.50
2024-10-24,01:41:00,20326.25,SELL,3,0.02h,Stop Loss,$-9.00,$-22.50,$104178.50,213,$-22.50
2024-10-24,01:55:00,20331.5,BUY,3,0.02h,Stop Loss,$-9.00,$-31.50,$104169.50,213,$-31.50
2024-10-24,01:58:00,20327.0,SELL,3,0.02h,Break Even,$-1.50,$-33.00,$104168.00,213,$-33.00
2024-10-24,02:16:00,20325.25,BUY,3,0.02h,Stop Loss,$-9.00,$-42.00,$104159.00,213,$-42.00
2024-10-24,02:32:00,20323.25,SELL,3,0.02h,Stop Loss,$-9.00,$-51.00,$104150.00,213,$-51.00
2024-10-24,02:49:00,20327.0,BUY,3,0.02h,Stop Loss,$-9.00,$-60.00,$104141.00,213,$-60.00
2024-10-24,03:09:00,20324.0,SELL,3,0.02h,Break Even,$-1.50,$-61.50,$104139.50,213,$-61.50
2024-10-24,03:21:00,20332.0,BUY,3,0.02h,Stop Loss,$-9.00,$-70.50,$104130.50,213,$-70.50
2024-10-24,03:46:00,20333.25,SELL,3,0.02h,Stop Loss,$-9.00,$-79.50,$104121.50,213,$-79.50
2024-10-24,04:29:00,20323.5,BUY,3,0.02h,Stop Loss,$-9.00,$-88.50,$104112.50,213,$-88.50
2024-10-24,04:32:00,20318.5,SELL,3,0.02h,Break Even,$-1.50,$-90.00,$104111.00,213,$-90.00
2024-10-24,04:56:00,20322.25,BUY,3,0.02h,Stop Loss,$-9.00,$-99.00,$104102.00,213,$-99.00
2024-10-24,05:26:00,20317.25,SELL,3,0.02h,Break Even,$-1.50,$-100.50,$104100.50,213,$-100.50
2024-10-24,05:37:00,20320.0,BUY,3,0.02h,Stop Loss,$-9.00,$-109.50,$104091.50,213,$-109.50
2024-10-24,06:30:00,20328.25,SELL,3,0.02h,Stop Loss,$-9.00,$-118.50,$104082.50,213,$-118.50
2024-10-24,06:33:00,20333.5,BUY,3,0.02h,Break Even,$-1.50,$-120.00,$104081.00,213,$-120.00
2024-10-24,06:44:00,20328.25,SELL,3,0.02h,Stop Loss,$-9.00,$-129.00,$104072.00,213,$-129.00
2024-10-24,07:05:00,20337.25,BUY,3,0.02h,Stop Loss,$12.00,$-117.00,$104084.00,213,$-117.00
2024-10-24,08:36:00,20385.5,SELL,3,0.02h,Stop Loss,$-9.00,$-126.00,$104075.00,213,$-126.00
2024-10-24,09:10:00,20373.5,BUY,3,0.02h,Break Even,$-1.50,$-127.50,$104073.50,213,$-127.50
2024-10-24,09:11:00,20366.5,SELL,3,0.02h,Stop Loss,$3.00,$-124.50,$104076.50,213,$-124.50
2024-10-24,09:16:00,20379.0,BUY,3,0.02h,Break Even,$-1.50,$-126.00,$104075.00,213,$-126.00
2024-10-24,09:29:00,20370.5,SELL,3,0.02h,Break Even,$-1.50,$-127.50,$104073.50,213,$-127.50
2024-10-24,09:38:00,20377.0,BUY,3,0.02h,Stop Loss,$-9.00,$-136.50,$104064.50,213,$-136.50
2024-10-24,09:48:00,20369.0,SELL,3,0.02h,Break Even,$-1.50,$-138.00,$104063.00,213,$-138.00
2024-10-24,10:00:00,20377.0,BUY,3,0.02h,Break Even,$-1.50,$-139.50,$104061.50,213,$-139.50
2024-10-24,10:50:00,20381.25,SELL,3,0.02h,Stop Loss,$-9.00,$-148.50,$104052.50,213,$-148.50
2024-10-24,11:08:00,20391.25,BUY,3,0.02h,Break Even,$-1.50,$-150.00,$104051.00,213,$-150.00
2024-10-24,12:08:00,20401.5,SELL,3,0.02h,Break Even,$-1.50,$-151.50,$104049.50,213,$-151.50
2024-10-24,12:22:00,20409.75,BUY,3,0.02h,Break Even,$-1.50,$-153.00,$104048.00,213,$-153.00
2024-10-24,12:27:00,20406.0,SELL,3,0.02h,Stop Loss,$15.00,$-138.00,$104063.00,213,$-138.00
2024-10-24,12:36:00,20417.75,BUY,3,0.02h,Stop Loss,$-9.00,$-147.00,$104054.00,213,$-147.00
2024-10-24,12:47:00,20403.75,SELL,3,0.02h,Stop Loss,$24.00,$-123.00,$104078.00,213,$-123.00
2024-10-24,13:14:00,20402.5,BUY,3,0.02h,Break Even,$-1.50,$-124.50,$104076.50,213,$-124.50
2024-10-24,13:22:00,20392.75,SELL,3,0.02h,Stop Loss,$7.50,$-117.00,$104084.00,213,$-117.00
2024-10-24,14:02:00,20351.0,BUY,3,0.02h,Stop Loss,$150.00,$33.00,$104234.00,213,$33.00
2024-10-24,14:23:00,20335.25,SELL,3,0.02h,Break Even,$-1.50,$31.50,$104232.50,213,$31.50
2024-10-24,14:25:00,20357.5,BUY,3,0.02h,Break Even,$-1.50,$30.00,$104231.00,213,$30.00
2024-10-24,14:27:00,20330.0,SELL,3,0.02h,Stop Loss,$93.00,$123.00,$104324.00,213,$123.00
2024-10-24,14:34:00,20355.25,BUY,3,0.02h,Stop Loss,$39.00,$162.00,$104363.00,213,$162.00
2024-10-24,14:49:00,20340.5,SELL,3,0.02h,Stop Loss,$34.50,$196.50,$104397.50,213,$196.50
2024-10-24,15:12:00,20340.75,BUY,3,0.02h,Break Even,$-1.50,$195.00,$104396.00,213,$195.00
2024-10-24,15:30:00,20340.25,SELL,3,0.02h,Break Even,$-1.50,$193.50,$104394.50,213,$193.50
2024-10-24,15:32:00,20347.0,BUY,3,0.02h,Break Even,$-1.50,$192.00,$104393.00,213,$192.00
2024-10-24,15:33:00,20341.25,SELL,3,0.02h,Stop Loss,$18.00,$210.00,$104411.00,213,$210.00
2024-10-24,16:00:00,20327.75,BUY,3,0.02h,Stop Loss,$51.00,$261.00,$104462.00,213,$261.00
2024-10-24,16:07:00,20291.5,SELL,3,0.02h,Stop Loss,$48.00,$309.00,$104510.00,213,$309.00
2024-10-24,16:25:00,20307.0,BUY,3,0.02h,Stop Loss,$16.50,$325.50,$104526.50,213,$325.50
2024-10-24,17:23:00,20362.5,SELL,3,0.02h,Stop Loss,$12.00,$337.50,$104538.50,213,$337.50
2024-10-24,17:39:00,20369.75,BUY,3,0.02h,Break Even,$-1.50,$336.00,$104537.00,213,$336.00
2024-10-24,17:52:00,20355.75,SELL,3,0.02h,Stop Loss,$3.00,$339.00,$104540.00,213,$339.00
2024-10-24,18:13:00,20364.75,BUY,3,0.02h,Stop Loss,$9.00,$348.00,$104549.00,213,$348.00
2024-10-24,18:31:00,20364.0,SELL,3,0.02h,Break Even,$-1.50,$346.50,$104547.50,213,$346.50
2024-10-24,18:51:00,20364.0,BUY,3,0.02h,Stop Loss,$12.00,$358.50,$104559.50,213,$358.50
2024-10-24,19:02:00,20349.0,SELL,3,0.02h,Break Even,$-1.50,$357.00,$104558.00,213,$357.00
2024-10-24,19:10:00,20368.0,BUY,3,0.02h,Stop Loss,$12.00,$369.00,$104570.00,213,$369.00
2024-10-24,19:44:00,20379.5,SELL,3,0.02h,Stop Loss,$-9.00,$360.00,$104561.00,213,$360.00
2024-10-24,19:48:00,20396.0,BUY,3,0.02h,Stop Loss,$7.50,$367.50,$104568.50,213,$367.50
2024-10-24,19:54:00,20385.0,SELL,3,0.02h,Break Even,$-1.50,$366.00,$104567.00,213,$366.00
2024-10-24,19:55:00,20397.75,BUY,3,0.02h,Break Even,$-1.50,$364.50,$104565.50,213,$364.50
2024-10-24,19:59:00,20384.5,SELL,3,0.02h,Stop Loss,$37.50,$402.00,$104603.00,213,$402.00
2024-10-24,20:03:00,20391.5,BUY,3,0.02h,Stop Loss,$6.00,$408.00,$104609.00,213,$408.00
2024-10-24,20:23:00,20394.0,SELL,3,0.02h,Stop Loss,$-9.00,$399.00,$104600.00,213,$399.00
2024-10-24,21:00:00,20391.0,BUY,3,2.00h,Stop Loss,$-9.00,$390.00,$104591.00,213,$390.00
2024-10-24,23:00:00,20379.75,SELL,3,0.02h,Stop Loss,$-9.00,$381.00,$104582.00,213,$381.00
2024-10-24,23:27:00,20376.75,BUY,3,0.02h,Stop Loss,$-9.00,$372.00,$104573.00,213,$372.00
2024-10-24,23:30:00,20372.5,SELL,3,0.02h,Stop Loss,$34.50,$406.50,$104607.50,213,$406.50
2024-10-24,23:51:00,20373.0,BUY,3,0.02h,Break Even,$-1.50,$405.00,$104606.00,213,$405.00
,,,,,,,,,,,
2024-10-25,01:36:00,20403.25,SELL,3,0.02h,Stop Loss,$-9.00,$-9.00,$104597.00,214,$-9.00
2024-10-25,01:42:00,20404.5,BUY,3,0.02h,Stop Loss,$-9.00,$-18.00,$104588.00,214,$-18.00
2024-10-25,01:43:00,20400.5,SELL,3,0.02h,Stop Loss,$-9.00,$-27.00,$104579.00,214,$-27.00
2024-10-25,02:15:00,20403.0,BUY,3,0.02h,Break Even,$-1.50,$-28.50,$104577.50,214,$-28.50
2024-10-25,02:57:00,20402.5,SELL,3,0.02h,Stop Loss,$-9.00,$-37.50,$104568.50,214,$-37.50
2024-10-25,04:29:00,20373.75,BUY,3,0.02h,Stop Loss,$-9.00,$-46.50,$104559.50,214,$-46.50
2024-10-25,04:30:00,20371.25,SELL,3,0.02h,Stop Loss,$6.00,$-40.50,$104565.50,214,$-40.50
2024-10-25,04:52:00,20372.25,BUY,3,0.02h,Break Even,$-1.50,$-42.00,$104564.00,214,$-42.00
2024-10-25,05:10:00,20369.75,SELL,3,0.02h,Break Even,$-1.50,$-43.50,$104562.50,214,$-43.50
2024-10-25,05:21:00,20376.0,BUY,3,0.02h,Break Even,$-1.50,$-45.00,$104561.00,214,$-45.00
2024-10-25,06:38:00,20393.75,SELL,3,0.02h,Stop Loss,$7.50,$-37.50,$104568.50,214,$-37.50
2024-10-25,07:06:00,20397.25,BUY,3,0.02h,Stop Loss,$-9.00,$-46.50,$104559.50,214,$-46.50
2024-10-25,07:17:00,20384.0,SELL,3,0.02h,Stop Loss,$-9.00,$-55.50,$104550.50,214,$-55.50
2024-10-25,07:19:00,20400.75,BUY,3,0.02h,Stop Loss,$-9.00,$-64.50,$104541.50,214,$-64.50
2024-10-25,08:07:00,20414.5,SELL,3,0.02h,Stop Loss,$9.00,$-55.50,$104550.50,214,$-55.50
2024-10-25,08:34:00,20416.25,BUY,3,0.02h,Stop Loss,$-9.00,$-64.50,$104541.50,214,$-64.50
2024-10-25,08:38:00,20409.75,SELL,3,0.02h,Stop Loss,$-9.00,$-73.50,$104532.50,214,$-73.50
2024-10-25,08:39:00,20414.25,BUY,3,0.02h,Stop Loss,$-9.00,$-82.50,$104523.50,214,$-82.50
2024-10-25,08:41:00,20412.25,SELL,3,0.02h,Break Even,$-1.50,$-84.00,$104522.00,214,$-84.00
2024-10-25,08:42:00,20414.5,BUY,3,0.05h,Stop Loss,$22.50,$-61.50,$104544.50,214,$-61.50
2024-10-25,08:53:00,20409.0,SELL,3,0.02h,Stop Loss,$-9.00,$-70.50,$104535.50,214,$-70.50
2024-10-25,08:58:00,20417.75,BUY,3,0.02h,Break Even,$-1.50,$-72.00,$104534.00,214,$-72.00
2024-10-25,09:39:00,20434.25,SELL,3,0.02h,Stop Loss,$-9.00,$-81.00,$104525.00,214,$-81.00
2024-10-25,09:53:00,20436.25,BUY,3,0.02h,Stop Loss,$-9.00,$-90.00,$104516.00,214,$-90.00
2024-10-25,09:54:00,20433.25,SELL,3,0.02h,Break Even,$-1.50,$-91.50,$104514.50,214,$-91.50
2024-10-25,10:01:00,20435.0,BUY,3,0.02h,Stop Loss,$-9.00,$-100.50,$104505.50,214,$-100.50
2024-10-25,10:19:00,20430.0,SELL,3,0.02h,Stop Loss,$-9.00,$-109.50,$104496.50,214,$-109.50
2024-10-25,10:27:00,20439.5,BUY,3,0.02h,Stop Loss,$-9.00,$-118.50,$104487.50,214,$-118.50
2024-10-25,10:57:00,20432.5,SELL,3,0.02h,Stop Loss,$7.50,$-111.00,$104495.00,214,$-111.00
2024-10-25,11:26:00,20425.75,BUY,3,0.02h,Stop Loss,$-9.00,$-120.00,$104486.00,214,$-120.00
2024-10-25,12:30:00,20458.75,SELL,3,0.02h,Stop Loss,$27.00,$-93.00,$104513.00,214,$-93.00
2024-10-25,12:37:00,20466.75,BUY,3,0.02h,Break Even,$-1.50,$-94.50,$104511.50,214,$-94.50
2024-10-25,13:30:00,20491.25,SELL,3,0.02h,Stop Loss,$-9.00,$-103.50,$104502.50,214,$-103.50
2024-10-25,13:31:00,20519.25,BUY,3,0.02h,Stop Loss,$81.00,$-22.50,$104583.50,214,$-22.50
2024-10-25,14:44:00,20665.75,SELL,3,0.02h,Stop Loss,$75.00,$52.50,$104658.50,214,$52.50
2024-10-25,15:06:00,20666.25,BUY,3,0.02h,Stop Loss,$43.50,$96.00,$104702.00,214,$96.00
2024-10-25,15:12:00,20645.75,SELL,3,0.02h,Break Even,$-1.50,$94.50,$104700.50,214,$94.50
2024-10-25,15:16:00,20666.0,BUY,3,0.02h,Break Even,$-1.50,$93.00,$104699.00,214,$93.00
2024-10-25,15:27:00,20646.0,SELL,3,0.02h,Stop Loss,$3.00,$96.00,$104702.00,214,$96.00
2024-10-25,16:07:00,20634.75,BUY,3,0.02h,Break Even,$-1.50,$94.50,$104700.50,214,$94.50
2024-10-25,16:50:00,20641.25,SELL,3,0.02h,Stop Loss,$-9.00,$85.50,$104691.50,214,$85.50
2024-10-25,16:54:00,20653.75,BUY,3,0.02h,Stop Loss,$-9.00,$76.50,$104682.50,214,$76.50
2024-10-25,16:57:00,20643.5,SELL,3,0.02h,Stop Loss,$9.00,$85.50,$104691.50,214,$85.50
2024-10-25,17:54:00,20554.25,BUY,3,0.02h,Break Even,$-1.50,$84.00,$104690.00,214,$84.00
2024-10-25,17:56:00,20533.25,SELL,3,0.02h,Break Even,$-1.50,$82.50,$104688.50,214,$82.50
2024-10-25,18:26:00,20514.25,BUY,3,0.02h,Stop Loss,$16.50,$99.00,$104705.00,214,$99.00
2024-10-25,19:05:00,20533.0,SELL,3,0.02h,Stop Loss,$22.50,$121.50,$104727.50,214,$121.50
2024-10-25,19:38:00,20524.5,BUY,3,0.02h,Stop Loss,$6.00,$127.50,$104733.50,214,$127.50
2024-10-25,19:44:00,20515.75,SELL,3,0.02h,Break Even,$-1.50,$126.00,$104732.00,214,$126.00
2024-10-25,19:47:00,20524.0,BUY,3,0.02h,Stop Loss,$-9.00,$117.00,$104723.00,214,$117.00
2024-10-25,19:51:00,20510.5,SELL,3,0.02h,Break Even,$-1.50,$115.50,$104721.50,214,$115.50
,,,,,,,,,,,
2024-10-28,00:00:00,20598.5,BUY,3,0.02h,Stop Loss,$-9.00,$-9.00,$104712.50,215,$-9.00
2024-10-28,00:58:00,20619.5,SELL,3,0.02h,Break Even,$-1.50,$-10.50,$104711.00,215,$-10.50
2024-10-28,01:07:00,20642.0,BUY,3,0.02h,Break Even,$-1.50,$-12.00,$104709.50,215,$-12.00
2024-10-28,01:37:00,20630.5,SELL,3,0.02h,Break Even,$-1.50,$-13.50,$104708.00,215,$-13.50
2024-10-28,02:08:00,20633.75,BUY,3,0.02h,Break Even,$-1.50,$-15.00,$104706.50,215,$-15.00
2024-10-28,02:12:00,20621.25,SELL,3,0.02h,Stop Loss,$-9.00,$-24.00,$104697.50,215,$-24.00
2024-10-28,02:37:00,20627.75,BUY,3,0.02h,Stop Loss,$-9.00,$-33.00,$104688.50,215,$-33.00
2024-10-28,02:58:00,20624.25,SELL,3,0.02h,Break Even,$-1.50,$-34.50,$104687.00,215,$-34.50
2024-10-28,03:01:00,20629.5,BUY,3,0.02h,Stop Loss,$-9.00,$-43.50,$104678.00,215,$-43.50
2024-10-28,03:10:00,20622.0,SELL,3,0.02h,Break Even,$-1.50,$-45.00,$104676.50,215,$-45.00
2024-10-28,03:57:00,20615.75,BUY,3,0.02h,Break Even,$-1.50,$-46.50,$104675.00,215,$-46.50
2024-10-28,04:34:00,20623.0,SELL,3,0.02h,Stop Loss,$-9.00,$-55.50,$104666.00,215,$-55.50
2024-10-28,04:38:00,20625.75,BUY,3,0.05h,Stop Loss,$7.50,$-48.00,$104673.50,215,$-48.00
2024-10-28,05:11:00,20638.25,SELL,3,0.02h,Stop Loss,$-9.00,$-57.00,$104664.50,215,$-57.00
2024-10-28,06:14:00,20623.75,BUY,3,0.02h,Stop Loss,$7.50,$-49.50,$104672.00,215,$-49.50
2024-10-28,06:33:00,20615.5,SELL,3,0.02h,Break Even,$-1.50,$-51.00,$104670.50,215,$-51.00
2024-10-28,06:39:00,20622.5,BUY,3,0.02h,Break Even,$-1.50,$-52.50,$104669.00,215,$-52.50
2024-10-28,06:57:00,20617.0,SELL,3,0.02h,Stop Loss,$-9.00,$-61.50,$104660.00,215,$-61.50
2024-10-28,07:04:00,20630.25,BUY,3,0.02h,Stop Loss,$13.50,$-48.00,$104673.50,215,$-48.00
2024-10-28,07:34:00,20633.0,SELL,3,0.02h,Stop Loss,$6.00,$-42.00,$104679.50,215,$-42.00
2024-10-28,07:49:00,20638.75,BUY,3,0.02h,Break Even,$-1.50,$-43.50,$104678.00,215,$-43.50
2024-10-28,07:50:00,20636.0,SELL,3,0.02h,Break Even,$-1.50,$-45.00,$104676.50,215,$-45.00
2024-10-28,07:58:00,20640.25,BUY,3,0.02h,Break Even,$-1.50,$-46.50,$104675.00,215,$-46.50
2024-10-28,08:00:00,20631.0,SELL,3,0.02h,Stop Loss,$-9.00,$-55.50,$104666.00,215,$-55.50
2024-10-28,08:18:00,20636.25,BUY,3,0.02h,Break Even,$-1.50,$-57.00,$104664.50,215,$-57.00
2024-10-28,09:07:00,20649.25,SELL,3,0.02h,Stop Loss,$-9.00,$-66.00,$104655.50,215,$-66.00
2024-10-28,09:37:00,20659.25,BUY,3,0.02h,Stop Loss,$-9.00,$-75.00,$104646.50,215,$-75.00
2024-10-28,10:10:00,20657.0,SELL,3,0.02h,Stop Loss,$-9.00,$-84.00,$104637.50,215,$-84.00
2024-10-28,10:21:00,20666.5,BUY,3,0.02h,Stop Loss,$-9.00,$-93.00,$104628.50,215,$-93.00
2024-10-28,10:22:00,20656.25,SELL,3,0.02h,Stop Loss,$-9.00,$-102.00,$104619.50,215,$-102.00
2024-10-28,11:43:00,20626.0,BUY,3,0.02h,Stop Loss,$-9.00,$-111.00,$104610.50,215,$-111.00
2024-10-28,11:59:00,20623.75,SELL,3,0.02h,Stop Loss,$12.00,$-99.00,$104622.50,215,$-99.00
2024-10-28,12:18:00,20616.0,BUY,3,0.02h,Break Even,$-1.50,$-100.50,$104621.00,215,$-100.50
2024-10-28,12:29:00,20605.0,SELL,3,0.02h,Stop Loss,$7.50,$-93.00,$104628.50,215,$-93.00
2024-10-28,12:33:00,20617.75,BUY,3,0.02h,Stop Loss,$45.00,$-48.00,$104673.50,215,$-48.00
2024-10-28,13:12:00,20642.25,SELL,3,0.02h,Stop Loss,$3.00,$-45.00,$104676.50,215,$-45.00
2024-10-28,14:08:00,20567.5,BUY,3,0.02h,Stop Loss,$88.50,$43.50,$104765.00,215,$43.50
2024-10-28,14:37:00,20583.0,SELL,3,0.02h,Stop Loss,$12.00,$55.50,$104777.00,215,$55.50
2024-10-28,14:38:00,20589.25,BUY,3,0.02h,Break Even,$-1.50,$54.00,$104775.50,215,$54.00
2024-10-28,14:39:00,20583.75,SELL,3,0.02h,Stop Loss,$-9.00,$45.00,$104766.50,215,$45.00
2024-10-28,14:40:00,20595.25,BUY,3,0.02h,Stop Loss,$22.50,$67.50,$104789.00,215,$67.50
2024-10-28,14:57:00,20589.0,SELL,3,0.02h,Stop Loss,$33.00,$100.50,$104822.00,215,$100.50
2024-10-28,16:11:00,20548.25,BUY,3,0.02h,Break Even,$-1.50,$99.00,$104820.50,215,$99.00
2024-10-28,16:35:00,20537.75,SELL,3,0.02h,Stop Loss,$34.50,$133.50,$104855.00,215,$133.50
2024-10-28,16:46:00,20554.25,BUY,3,0.02h,Break Even,$-1.50,$132.00,$104853.50,215,$132.00
2024-10-28,16:49:00,20535.75,SELL,3,0.02h,Break Even,$-1.50,$130.50,$104852.00,215,$130.50
2024-10-28,17:09:00,20547.25,BUY,3,0.02h,Stop Loss,$-9.00,$121.50,$104843.00,215,$121.50
2024-10-28,17:12:00,20534.5,SELL,3,0.02h,Stop Loss,$75.00,$196.50,$104918.00,215,$196.50
2024-10-28,17:21:00,20549.0,BUY,3,0.02h,Stop Loss,$6.00,$202.50,$104924.00,215,$202.50
2024-10-28,17:51:00,20541.0,SELL,3,0.02h,Stop Loss,$-9.00,$193.50,$104915.00,215,$193.50
2024-10-28,17:52:00,20550.0,BUY,3,0.02h,Stop Loss,$16.50,$210.00,$104931.50,215,$210.00
2024-10-28,18:04:00,20544.25,SELL,3,0.02h,Stop Loss,$-9.00,$201.00,$104922.50,215,$201.00
2024-10-28,18:07:00,20554.25,BUY,3,0.02h,Break Even,$-1.50,$199.50,$104921.00,215,$199.50
2024-10-28,18:14:00,20541.0,SELL,3,0.02h,Break Even,$-1.50,$198.00,$104919.50,215,$198.00
2024-10-28,18:54:00,20541.5,BUY,3,0.02h,Stop Loss,$16.50,$214.50,$104936.00,215,$214.50
2024-10-28,19:05:00,20526.25,SELL,3,0.02h,Stop Loss,$22.50,$237.00,$104958.50,215,$237.00
2024-10-28,19:28:00,20526.5,BUY,3,0.02h,Break Even,$-1.50,$235.50,$104957.00,215,$235.50
2024-10-28,19:44:00,20520.5,SELL,3,0.02h,Break Even,$-1.50,$234.00,$104955.50,215,$234.00
2024-10-28,20:23:00,20508.25,BUY,3,0.02h,Break Even,$-1.50,$232.50,$104954.00,215,$232.50
2024-10-28,20:52:00,20511.75,SELL,3,0.03h,Break Even,$-1.50,$231.00,$104952.50,215,$231.00
2024-10-28,23:24:00,20505.75,BUY,3,0.02h,Break Even,$-1.50,$229.50,$104951.00,215,$229.50
2024-10-28,23:29:00,20503.75,SELL,3,0.02h,Break Even,$-1.50,$228.00,$104949.50,215,$228.00
2024-10-28,23:41:00,20506.0,BUY,3,0.02h,Break Even,$-1.50,$226.50,$104948.00,215,$226.50
2024-10-28,23:49:00,20500.0,SELL,3,0.02h,Stop Loss,$12.00,$238.50,$104960.00,215,$238.50
,,,,,,,,,,,
2024-10-29,00:01:00,20509.25,BUY,3,0.02h,Break Even,$-1.50,$-1.50,$104958.50,216,$-1.50
2024-10-29,00:08:00,20491.5,SELL,3,0.02h,Stop Loss,$76.50,$75.00,$105035.00,216,$75.00
2024-10-29,00:20:00,20503.0,BUY,3,0.02h,Break Even,$-1.50,$73.50,$105033.50,216,$73.50
2024-10-29,01:01:00,20512.25,SELL,3,0.03h,Break Even,$-1.50,$72.00,$105032.00,216,$72.00
2024-10-29,01:24:00,20512.0,BUY,3,0.02h,Stop Loss,$-9.00,$63.00,$105023.00,216,$63.00
2024-10-29,01:46:00,20508.5,SELL,3,0.02h,Break Even,$-1.50,$61.50,$105021.50,216,$61.50
2024-10-29,02:15:00,20505.75,BUY,3,0.02h,Stop Loss,$-9.00,$52.50,$105012.50,216,$52.50
2024-10-29,02:32:00,20499.0,SELL,3,0.02h,Stop Loss,$27.00,$79.50,$105039.50,216,$79.50
2024-10-29,02:52:00,20502.75,BUY,3,0.02h,Stop Loss,$-9.00,$70.50,$105030.50,216,$70.50
2024-10-29,03:24:00,20504.75,SELL,3,0.02h,Break Even,$-1.50,$69.00,$105029.00,216,$69.00
2024-10-29,04:16:00,20480.5,BUY,3,0.02h,Stop Loss,$-9.00,$60.00,$105020.00,216,$60.00
2024-10-29,04:45:00,20480.5,SELL,3,0.02h,Stop Loss,$-9.00,$51.00,$105011.00,216,$51.00
2024-10-29,04:52:00,20486.5,BUY,3,0.02h,Break Even,$-1.50,$49.50,$105009.50,216,$49.50
2024-10-29,05:10:00,20483.5,SELL,3,0.02h,Break Even,$-1.50,$48.00,$105008.00,216,$48.00
2024-10-29,05:14:00,20491.5,BUY,3,0.02h,Stop Loss,$-9.00,$39.00,$104999.00,216,$39.00
2024-10-29,07:10:00,20537.25,SELL,3,0.02h,Stop Loss,$-9.00,$30.00,$104990.00,216,$30.00
2024-10-29,07:21:00,20546.25,BUY,3,0.02h,Stop Loss,$-9.00,$21.00,$104981.00,216,$21.00
2024-10-29,07:54:00,20542.75,SELL,3,0.02h,Stop Loss,$3.00,$24.00,$104984.00,216,$24.00
2024-10-29,08:30:00,20525.5,BUY,3,0.02h,Stop Loss,$31.50,$55.50,$105015.50,216,$55.50
2024-10-29,08:58:00,20516.75,SELL,3,0.02h,Stop Loss,$-9.00,$46.50,$105006.50,216,$46.50
2024-10-29,09:30:00,20512.5,BUY,3,0.02h,Break Even,$-1.50,$45.00,$105005.00,216,$45.00
2024-10-29,09:31:00,20506.75,SELL,3,0.02h,Break Even,$-1.50,$43.50,$105003.50,216,$43.50
2024-10-29,09:34:00,20511.5,BUY,3,0.02h,Break Even,$-1.50,$42.00,$105002.00,216,$42.00
2024-10-29,09:53:00,20509.0,SELL,3,0.02h,Break Even,$-1.50,$40.50,$105000.50,216,$40.50
2024-10-29,09:58:00,20513.0,BUY,3,0.02h,Break Even,$-1.50,$39.00,$104999.00,216,$39.00
2024-10-29,10:06:00,20504.75,SELL,3,0.02h,Stop Loss,$40.50,$79.50,$105039.50,216,$79.50
2024-10-29,10:31:00,20507.25,BUY,3,0.02h,Stop Loss,$24.00,$103.50,$105063.50,216,$103.50
2024-10-29,11:01:00,20498.25,SELL,3,0.02h,Break Even,$-1.50,$102.00,$105062.00,216,$102.00
2024-10-29,11:42:00,20505.75,BUY,3,0.02h,Stop Loss,$21.00,$123.00,$105083.00,216,$123.00
2024-10-29,11:58:00,20493.5,SELL,3,0.02h,Break Even,$-1.50,$121.50,$105081.50,216,$121.50
2024-10-29,12:30:00,20493.75,BUY,3,0.02h,Break Even,$-1.50,$120.00,$105080.00,216,$120.00
2024-10-29,12:51:00,20490.5,SELL,3,0.02h,Break Even,$-1.50,$118.50,$105078.50,216,$118.50
2024-10-29,12:53:00,20500.0,BUY,3,0.02h,Break Even,$-1.50,$117.00,$105077.00,216,$117.00
2024-10-29,13:00:00,20489.0,SELL,3,0.02h,Break Even,$-1.50,$115.50,$105075.50,216,$115.50
2024-10-29,13:06:00,20496.5,BUY,3,0.02h,Stop Loss,$10.50,$126.00,$105086.00,216,$126.00
2024-10-29,13:15:00,20491.75,SELL,3,0.02h,Break Even,$-1.50,$124.50,$105084.50,216,$124.50
2024-10-29,13:29:00,20510.25,BUY,3,0.02h,Break Even,$-1.50,$123.00,$105083.00,216,$123.00
2024-10-29,13:32:00,20479.5,SELL,3,0.02h,Stop Loss,$187.50,$310.50,$105270.50,216,$310.50
2024-10-29,13:46:00,20509.75,BUY,3,0.02h,Stop Loss,$22.50,$333.00,$105293.00,216,$333.00
2024-10-29,15:11:00,20582.5,SELL,3,0.02h,Stop Loss,$10.50,$343.50,$105303.50,216,$343.50
2024-10-29,15:16:00,20596.75,BUY,3,0.02h,Stop Loss,$79.50,$423.00,$105383.00,216,$423.00
2024-10-29,15:36:00,20585.25,SELL,3,0.02h,Stop Loss,$6.00,$429.00,$105389.00,216,$429.00
2024-10-29,15:39:00,20604.25,BUY,3,0.02h,Stop Loss,$-9.00,$420.00,$105380.00,216,$420.00
2024-10-29,16:30:00,20614.75,SELL,3,0.02h,Stop Loss,$-9.00,$411.00,$105371.00,216,$411.00
2024-10-29,16:43:00,20628.5,BUY,3,0.02h,Stop Loss,$30.00,$441.00,$105401.00,216,$441.00
2024-10-29,17:28:00,20659.0,SELL,3,0.02h,Stop Loss,$-9.00,$432.00,$105392.00,216,$432.00
2024-10-29,17:35:00,20676.75,BUY,3,0.02h,Stop Loss,$9.00,$441.00,$105401.00,216,$441.00
2024-10-29,17:44:00,20661.5,SELL,3,0.02h,Stop Loss,$12.00,$453.00,$105413.00,216,$453.00
2024-10-29,17:51:00,20679.5,BUY,3,0.02h,Stop Loss,$-9.00,$444.00,$105404.00,216,$444.00
2024-10-29,18:06:00,20666.0,SELL,3,0.02h,Break Even,$-1.50,$442.50,$105402.50,216,$442.50
2024-10-29,18:20:00,20680.75,BUY,3,0.02h,Break Even,$-1.50,$441.00,$105401.00,216,$441.00
2024-10-29,18:57:00,20695.5,SELL,3,0.02h,Break Even,$-1.50,$439.50,$105399.50,216,$439.50
2024-10-29,19:07:00,20703.0,BUY,3,0.02h,Stop Loss,$4.50,$444.00,$105404.00,216,$444.00
2024-10-29,19:42:00,20721.5,SELL,3,0.02h,Stop Loss,$-9.00,$435.00,$105395.00,216,$435.00
2024-10-29,19:45:00,20734.5,BUY,3,0.02h,Stop Loss,$24.00,$459.00,$105419.00,216,$459.00
2024-10-29,19:52:00,20720.25,SELL,3,0.02h,Break Even,$-1.50,$457.50,$105417.50,216,$457.50
2024-10-29,20:07:00,20731.0,BUY,3,0.02h,Stop Loss,$21.00,$478.50,$105438.50,216,$478.50
2024-10-29,20:19:00,20708.0,SELL,3,0.02h,Stop Loss,$16.50,$495.00,$105455.00,216,$495.00
2024-10-29,20:54:00,20717.25,BUY,3,0.02h,Stop Loss,$-9.00,$486.00,$105446.00,216,$486.00
2024-10-29,20:59:00,20706.0,SELL,3,0.02h,Break Even,$-1.50,$484.50,$105444.50,216,$484.50
2024-10-29,23:00:00,20752.5,BUY,3,0.02h,Break Even,$-1.50,$483.00,$105443.00,216,$483.00
,,,,,,,,,,,
2024-10-30,01:04:00,20761.25,SELL,3,0.02h,Stop Loss,$-9.00,$-9.00,$105434.00,217,$-9.00
2024-10-30,01:19:00,20765.5,BUY,3,0.02h,Break Even,$-1.50,$-10.50,$105432.50,217,$-10.50
2024-10-30,02:04:00,20779.75,SELL,3,0.02h,Break Even,$-1.50,$-12.00,$105431.00,217,$-12.00
2024-10-30,04:14:00,20726.75,BUY,3,0.02h,Stop Loss,$-9.00,$-21.00,$105422.00,217,$-21.00
2024-10-30,04:16:00,20722.75,SELL,3,0.02h,Stop Loss,$-9.00,$-30.00,$105413.00,217,$-30.00
2024-10-30,04:17:00,20725.75,BUY,3,0.02h,Stop Loss,$-9.00,$-39.00,$105404.00,217,$-39.00
2024-10-30,04:18:00,20723.5,SELL,3,0.02h,Stop Loss,$-9.00,$-48.00,$105395.00,217,$-48.00
2024-10-30,04:34:00,20727.25,BUY,3,0.02h,Break Even,$-1.50,$-49.50,$105393.50,217,$-49.50
2024-10-30,04:52:00,20719.5,SELL,3,0.02h,Stop Loss,$-9.00,$-58.50,$105384.50,217,$-58.50
2024-10-30,05:12:00,20723.5,BUY,3,0.02h,Stop Loss,$-9.00,$-67.50,$105375.50,217,$-67.50
2024-10-30,05:15:00,20722.0,SELL,3,0.02h,Break Even,$-1.50,$-69.00,$105374.00,217,$-69.00
2024-10-30,05:19:00,20725.75,BUY,3,0.02h,Break Even,$-1.50,$-70.50,$105372.50,217,$-70.50
2024-10-30,05:31:00,20718.0,SELL,3,0.02h,Break Even,$-1.50,$-72.00,$105371.00,217,$-72.00
2024-10-30,06:06:00,20723.25,BUY,3,0.02h,Break Even,$-1.50,$-73.50,$105369.50,217,$-73.50
2024-10-30,07:14:00,20743.0,SELL,3,0.02h,Stop Loss,$-9.00,$-82.50,$105360.50,217,$-82.50
2024-10-30,07:15:00,20747.5,BUY,3,0.02h,Stop Loss,$21.00,$-61.50,$105381.50,217,$-61.50
2024-10-30,07:43:00,20750.5,SELL,3,0.02h,Break Even,$-1.50,$-63.00,$105380.00,217,$-63.00
2024-10-30,07:49:00,20756.0,BUY,3,0.02h,Stop Loss,$-9.00,$-72.00,$105371.00,217,$-72.00
2024-10-30,07:53:00,20749.0,SELL,3,0.02h,Stop Loss,$-9.00,$-81.00,$105362.00,217,$-81.00
2024-10-30,08:04:00,20758.75,BUY,3,0.02h,Stop Loss,$6.00,$-75.00,$105368.00,217,$-75.00
2024-10-30,08:08:00,20743.25,SELL,3,0.02h,Stop Loss,$13.50,$-61.50,$105381.50,217,$-61.50
2024-10-30,08:24:00,20749.5,BUY,3,0.02h,Stop Loss,$13.50,$-48.00,$105395.00,217,$-48.00
2024-10-30,08:34:00,20738.75,SELL,3,0.02h,Break Even,$-1.50,$-49.50,$105393.50,217,$-49.50
2024-10-30,09:12:00,20728.75,BUY,3,0.02h,Stop Loss,$27.00,$-22.50,$105420.50,217,$-22.50
2024-10-30,09:43:00,20734.75,SELL,3,0.02h,Break Even,$-1.50,$-24.00,$105419.00,217,$-24.00
2024-10-30,10:23:00,20732.5,BUY,3,0.02h,Stop Loss,$-9.00,$-33.00,$105410.00,217,$-33.00
2024-10-30,10:25:00,20728.25,SELL,3,0.02h,Break Even,$-1.50,$-34.50,$105408.50,217,$-34.50
2024-10-30,10:28:00,20730.0,BUY,3,0.02h,Stop Loss,$7.50,$-27.00,$105416.00,217,$-27.00
2024-10-30,10:37:00,20727.5,SELL,3,0.02h,Stop Loss,$-9.00,$-36.00,$105407.00,217,$-36.00
2024-10-30,10:51:00,20731.5,BUY,3,0.02h,Stop Loss,$-9.00,$-45.00,$105398.00,217,$-45.00
2024-10-30,11:07:00,20730.25,SELL,3,0.02h,Break Even,$-1.50,$-46.50,$105396.50,217,$-46.50
2024-10-30,11:09:00,20734.75,BUY,3,0.02h,Break Even,$-1.50,$-48.00,$105395.00,217,$-48.00
2024-10-30,11:34:00,20741.25,SELL,3,0.02h,Stop Loss,$-9.00,$-57.00,$105386.00,217,$-57.00
2024-10-30,12:38:00,20719.5,BUY,3,0.02h,Break Even,$-1.50,$-58.50,$105384.50,217,$-58.50
2024-10-30,12:47:00,20706.0,SELL,3,0.02h,Stop Loss,$4.50,$-54.00,$105389.00,217,$-54.00
2024-10-30,13:57:00,20627.25,BUY,3,0.02h,Stop Loss,$12.00,$-42.00,$105401.00,217,$-42.00
2024-10-30,14:47:00,20671.75,SELL,3,0.02h,Stop Loss,$24.00,$-18.00,$105425.00,217,$-18.00
2024-10-30,15:25:00,20650.5,BUY,3,0.02h,Stop Loss,$21.00,$3.00,$105446.00,217,$3.00
2024-10-30,16:10:00,20659.25,SELL,3,0.02h,Stop Loss,$15.00,$18.00,$105461.00,217,$18.00
2024-10-30,16:41:00,20658.25,BUY,3,0.02h,Stop Loss,$-9.00,$9.00,$105452.00,217,$9.00
2024-10-30,16:42:00,20645.5,SELL,3,0.02h,Stop Loss,$-9.00,$0.00,$105443.00,217,$0.00
2024-10-30,16:46:00,20659.0,BUY,3,0.02h,Break Even,$-1.50,$-1.50,$105441.50,217,$-1.50
2024-10-30,16:57:00,20648.25,SELL,3,0.02h,Stop Loss,$18.00,$16.50,$105459.50,217,$16.50
2024-10-30,18:08:00,20612.75,BUY,3,0.02h,Stop Loss,$10.50,$27.00,$105470.00,217,$27.00
2024-10-30,18:30:00,20596.0,SELL,3,0.02h,Break Even,$-1.50,$25.50,$105468.50,217,$25.50
2024-10-30,18:34:00,20607.5,BUY,3,0.02h,Stop Loss,$4.50,$30.00,$105473.00,217,$30.00
2024-10-30,18:58:00,20609.0,SELL,3,0.02h,Stop Loss,$12.00,$42.00,$105485.00,217,$42.00
2024-10-30,20:05:00,20571.25,BUY,3,0.02h,Break Even,$-1.50,$40.50,$105483.50,217,$40.50
2024-10-30,20:06:00,20533.75,SELL,3,0.02h,Stop Loss,$69.00,$109.50,$105552.50,217,$109.50
2024-10-30,20:30:00,20542.5,BUY,3,0.02h,Stop Loss,$43.50,$153.00,$105596.00,217,$153.00
2024-10-30,20:44:00,20514.0,SELL,3,0.02h,Stop Loss,$-9.00,$144.00,$105587.00,217,$144.00
2024-10-30,20:46:00,20529.0,BUY,3,0.02h,Break Even,$-1.50,$142.50,$105585.50,217,$142.50
2024-10-30,20:51:00,20511.25,SELL,3,0.02h,Break Even,$-1.50,$141.00,$105584.00,217,$141.00
,,,,,,,,,,,
2024-10-31,00:14:00,20435.25,BUY,3,0.02h,Stop Loss,$-9.00,$-9.00,$105575.00,218,$-9.00
2024-10-31,00:37:00,20427.5,SELL,3,0.02h,Stop Loss,$10.50,$1.50,$105585.50,218,$1.50
2024-10-31,00:43:00,20434.25,BUY,3,0.02h,Stop Loss,$-9.00,$-7.50,$105576.50,218,$-7.50
2024-10-31,01:48:00,20452.5,SELL,3,0.02h,Break Even,$-1.50,$-9.00,$105575.00,218,$-9.00
2024-10-31,02:35:00,20439.75,BUY,3,0.02h,Break Even,$-1.50,$-10.50,$105573.50,218,$-10.50
2024-10-31,02:46:00,20437.5,SELL,3,0.02h,Stop Loss,$3.00,$-7.50,$105576.50,218,$-7.50
2024-10-31,03:03:00,20438.5,BUY,3,0.02h,Break Even,$-1.50,$-9.00,$105575.00,218,$-9.00
2024-10-31,03:08:00,20427.75,SELL,3,0.02h,Break Even,$-1.50,$-10.50,$105573.50,218,$-10.50
2024-10-31,03:33:00,20435.5,BUY,3,0.02h,Stop Loss,$-9.00,$-19.50,$105564.50,218,$-19.50
2024-10-31,03:46:00,20429.25,SELL,3,0.03h,Break Even,$-1.50,$-21.00,$105563.00,218,$-21.00
2024-10-31,05:34:00,20396.75,BUY,3,0.02h,Stop Loss,$-9.00,$-30.00,$105554.00,218,$-30.00
2024-10-31,05:46:00,20394.25,SELL,3,0.02h,Stop Loss,$-9.00,$-39.00,$105545.00,218,$-39.00
2024-10-31,05:48:00,20397.0,BUY,3,0.02h,Stop Loss,$-9.00,$-48.00,$105536.00,218,$-48.00
2024-10-31,05:49:00,20394.75,SELL,3,0.02h,Break Even,$-1.50,$-49.50,$105534.50,218,$-49.50
2024-10-31,07:31:00,20338.5,BUY,3,0.02h,Stop Loss,$30.00,$-19.50,$105564.50,218,$-19.50
2024-10-31,07:47:00,20330.5,SELL,3,0.02h,Stop Loss,$28.50,$9.00,$105593.00,218,$9.00
2024-10-31,08:20:00,20320.0,BUY,3,0.02h,Break Even,$-1.50,$7.50,$105591.50,218,$7.50
2024-10-31,08:22:00,20312.75,SELL,3,0.02h,Stop Loss,$10.50,$18.00,$105602.00,218,$18.00
2024-10-31,08:48:00,20316.5,BUY,3,0.02h,Stop Loss,$30.00,$48.00,$105632.00,218,$48.00
2024-10-31,09:07:00,20308.5,SELL,3,0.02h,Break Even,$-1.50,$46.50,$105630.50,218,$46.50
2024-10-31,09:13:00,20318.75,BUY,3,0.02h,Stop Loss,$-9.00,$37.50,$105621.50,218,$37.50
2024-10-31,09:15:00,20314.75,SELL,3,0.02h,Break Even,$-1.50,$36.00,$105620.00,218,$36.00
2024-10-31,09:30:00,20315.25,BUY,3,0.02h,Break Even,$-1.50,$34.50,$105618.50,218,$34.50
2024-10-31,09:31:00,20311.75,SELL,3,0.02h,Break Even,$-1.50,$33.00,$105617.00,218,$33.00
2024-10-31,09:37:00,20316.75,BUY,3,0.02h,Stop Loss,$6.00,$39.00,$105623.00,218,$39.00
2024-10-31,10:06:00,20316.5,SELL,3,0.02h,Stop Loss,$12.00,$51.00,$105635.00,218,$51.00
2024-10-31,10:27:00,20314.25,BUY,3,0.02h,Stop Loss,$10.50,$61.50,$105645.50,218,$61.50
2024-10-31,11:32:00,20349.5,SELL,3,0.02h,Stop Loss,$-9.00,$52.50,$105636.50,218,$52.50
2024-10-31,11:47:00,20361.0,BUY,3,0.02h,Break Even,$-1.50,$51.00,$105635.00,218,$51.00
2024-10-31,12:37:00,20384.75,SELL,3,0.02h,Stop Loss,$13.50,$64.50,$105648.50,218,$64.50
2024-10-31,12:45:00,20404.0,BUY,3,0.02h,Stop Loss,$27.00,$91.50,$105675.50,218,$91.50
2024-10-31,12:50:00,20387.0,SELL,3,0.02h,Stop Loss,$-9.00,$82.50,$105666.50,218,$82.50
2024-10-31,12:52:00,20403.75,BUY,3,0.02h,Stop Loss,$-9.00,$73.50,$105657.50,218,$73.50
2024-10-31,12:55:00,20387.0,SELL,3,0.02h,Stop Loss,$12.00,$85.50,$105669.50,218,$85.50
2024-10-31,13:17:00,20393.75,BUY,3,0.02h,Stop Loss,$-9.00,$76.50,$105660.50,218,$76.50
2024-10-31,13:21:00,20382.25,SELL,3,0.02h,Stop Loss,$-9.00,$67.50,$105651.50,218,$67.50
2024-10-31,13:24:00,20389.75,BUY,3,0.02h,Break Even,$-1.50,$66.00,$105650.00,218,$66.00
2024-10-31,13:26:00,20376.0,SELL,3,0.02h,Break Even,$-1.50,$64.50,$105648.50,218,$64.50
2024-10-31,14:20:00,20187.0,BUY,3,0.02h,Stop Loss,$4.50,$69.00,$105653.00,218,$69.00
2024-10-31,14:28:00,20149.75,SELL,3,0.02h,Stop Loss,$52.50,$121.50,$105705.50,218,$121.50
2024-10-31,15:22:00,20107.0,BUY,3,0.02h,Stop Loss,$7.50,$129.00,$105713.00,218,$129.00
2024-10-31,15:33:00,20076.75,SELL,3,0.02h,Stop Loss,$27.00,$156.00,$105740.00,218,$156.00
2024-10-31,16:02:00,20063.75,BUY,3,0.02h,Stop Loss,$-9.00,$147.00,$105731.00,218,$147.00
2024-10-31,16:03:00,20050.25,SELL,3,0.02h,Stop Loss,$-9.00,$138.00,$105722.00,218,$138.00
2024-10-31,16:05:00,20068.25,BUY,3,0.02h,Stop Loss,$78.00,$216.00,$105800.00,218,$216.00
2024-10-31,16:35:00,20072.75,SELL,3,0.02h,Break Even,$-1.50,$214.50,$105798.50,218,$214.50
2024-10-31,16:41:00,20083.25,BUY,3,0.02h,Stop Loss,$-9.00,$205.50,$105789.50,218,$205.50
2024-10-31,16:42:00,20072.5,SELL,3,0.02h,Stop Loss,$-9.00,$196.50,$105780.50,218,$196.50
2024-10-31,16:44:00,20089.75,BUY,3,0.02h,Stop Loss,$33.00,$229.50,$105813.50,218,$229.50
2024-10-31,17:16:00,20087.5,SELL,3,0.02h,Stop Loss,$6.00,$235.50,$105819.50,218,$235.50
2024-10-31,17:22:00,20098.0,BUY,3,0.02h,Stop Loss,$6.00,$241.50,$105825.50,218,$241.50
2024-10-31,17:27:00,20087.0,SELL,3,0.02h,Stop Loss,$69.00,$310.50,$105894.50,218,$310.50
2024-10-31,18:31:00,20044.5,BUY,3,0.02h,Break Even,$-1.50,$309.00,$105893.00,218,$309.00
2024-10-31,18:34:00,20017.5,SELL,3,0.02h,Stop Loss,$24.00,$333.00,$105917.00,218,$333.00
2024-10-31,18:46:00,20037.0,BUY,3,0.02h,Break Even,$-1.50,$331.50,$105915.50,218,$331.50
2024-10-31,18:49:00,20023.75,SELL,3,0.02h,Stop Loss,$22.50,$354.00,$105938.00,218,$354.00
2024-10-31,18:55:00,20032.75,BUY,3,0.02h,Stop Loss,$19.50,$373.50,$105957.50,218,$373.50
2024-10-31,19:33:00,20064.25,SELL,3,0.02h,Stop Loss,$-9.00,$364.50,$105948.50,218,$364.50
2024-10-31,19:43:00,20085.5,BUY,3,0.02h,Stop Loss,$12.00,$376.50,$105960.50,218,$376.50
2024-10-31,19:55:00,20042.25,SELL,3,0.02h,Stop Loss,$9.00,$385.50,$105969.50,218,$385.50
2024-10-31,20:25:00,20070.75,BUY,3,0.02h,Stop Loss,$16.50,$402.00,$105986.00,218,$402.00
2024-10-31,20:34:00,20028.75,SELL,3,0.02h,Stop Loss,$19.50,$421.50,$106005.50,218,$421.50
2024-10-31,23:00:00,20091.75,BUY,3,0.02h,Stop Loss,$27.00,$448.50,$106032.50,218,$448.50
2024-10-31,23:47:00,20075.5,SELL,3,0.02h,Break Even,$-1.50,$447.00,$106031.00,218,$447.00
,,,,,,,,,,,
2024-11-01,00:24:00,20071.5,BUY,3,0.02h,Stop Loss,$-9.00,$-9.00,$106022.00,219,$-9.00
2024-11-01,00:44:00,20070.5,SELL,3,0.02h,Stop Loss,$-9.00,$-18.00,$106013.00,219,$-18.00
2024-11-01,00:46:00,20076.75,BUY,3,0.02h,Stop Loss,$-9.00,$-27.00,$106004.00,219,$-27.00
2024-11-01,00:59:00,20071.25,SELL,3,0.02h,Stop Loss,$-9.00,$-36.00,$105995.00,219,$-36.00
2024-11-01,01:04:00,20079.75,BUY,3,0.02h,Stop Loss,$-9.00,$-45.00,$105986.00,219,$-45.00
2024-11-01,01:06:00,20071.0,SELL,3,0.02h,Break Even,$-1.50,$-46.50,$105984.50,219,$-46.50
2024-11-01,01:08:00,20077.25,BUY,3,0.02h,Break Even,$-1.50,$-48.00,$105983.00,219,$-48.00
2024-11-01,01:13:00,20071.0,SELL,3,0.02h,Stop Loss,$-9.00,$-57.00,$105974.00,219,$-57.00
2024-11-01,01:22:00,20077.5,BUY,3,0.02h,Stop Loss,$4.50,$-52.50,$105978.50,219,$-52.50
2024-11-01,01:29:00,20070.0,SELL,3,0.02h,Break Even,$-1.50,$-54.00,$105977.00,219,$-54.00
2024-11-01,02:24:00,20050.75,BUY,3,0.02h,Stop Loss,$21.00,$-33.00,$105998.00,219,$-33.00
2024-11-01,03:40:00,20092.25,SELL,3,0.02h,Break Even,$-1.50,$-34.50,$105996.50,219,$-34.50
2024-11-01,03:45:00,20094.0,BUY,3,0.02h,Break Even,$-1.50,$-36.00,$105995.00,219,$-36.00
2024-11-01,03:58:00,20087.5,SELL,3,0.02h,Break Even,$-1.50,$-37.50,$105993.50,219,$-37.50
2024-11-01,04:15:00,20091.5,BUY,3,0.02h,Break Even,$-1.50,$-39.00,$105992.00,219,$-39.00
2024-11-01,04:20:00,20089.75,SELL,3,0.03h,Stop Loss,$-9.00,$-48.00,$105983.00,219,$-48.00
2024-11-01,04:22:00,20091.75,BUY,3,0.02h,Stop Loss,$-9.00,$-57.00,$105974.00,219,$-57.00
2024-11-01,04:23:00,20090.25,SELL,3,0.02h,Break Even,$-1.50,$-58.50,$105972.50,219,$-58.50
2024-11-01,04:29:00,20091.75,BUY,3,0.02h,Stop Loss,$4.50,$-54.00,$105977.00,219,$-54.00
2024-11-01,04:48:00,20087.5,SELL,3,0.02h,Stop Loss,$3.00,$-51.00,$105980.00,219,$-51.00
2024-11-01,05:08:00,20091.5,BUY,3,0.02h,Break Even,$-1.50,$-52.50,$105978.50,219,$-52.50
2024-11-01,05:54:00,20109.0,SELL,3,0.02h,Stop Loss,$-9.00,$-61.50,$105969.50,219,$-61.50
2024-11-01,05:58:00,20121.0,BUY,3,0.02h,Break Even,$-1.50,$-63.00,$105968.00,219,$-63.00
2024-11-01,06:06:00,20112.5,SELL,3,0.02h,Break Even,$-1.50,$-64.50,$105966.50,219,$-64.50
2024-11-01,07:06:00,20087.25,BUY,3,0.02h,Stop Loss,$9.00,$-55.50,$105975.50,219,$-55.50
2024-11-01,07:08:00,20072.75,SELL,3,0.02h,Stop Loss,$7.50,$-48.00,$105983.00,219,$-48.00
2024-11-01,07:17:00,20084.5,BUY,3,0.02h,Break Even,$-1.50,$-49.50,$105981.50,219,$-49.50
2024-11-01,07:24:00,20070.5,SELL,3,0.02h,Stop Loss,$-9.00,$-58.50,$105972.50,219,$-58.50
2024-11-01,07:45:00,20074.75,BUY,3,0.02h,Stop Loss,$19.50,$-39.00,$105992.00,219,$-39.00
2024-11-01,08:25:00,20097.5,SELL,3,0.02h,Stop Loss,$6.00,$-33.00,$105998.00,219,$-33.00
2024-11-01,08:30:00,20105.5,BUY,3,0.02h,Stop Loss,$-9.00,$-42.00,$105989.00,219,$-42.00
2024-11-01,08:37:00,20098.0,SELL,3,0.02h,Stop Loss,$-9.00,$-51.00,$105980.00,219,$-51.00
2024-11-01,08:38:00,20105.5,BUY,3,0.02h,Stop Loss,$18.00,$-33.00,$105998.00,219,$-33.00
2024-11-01,08:43:00,20098.0,SELL,3,0.02h,Stop Loss,$7.50,$-25.50,$106005.50,219,$-25.50
2024-11-01,09:07:00,20098.75,BUY,3,0.02h,Stop Loss,$-9.00,$-34.50,$105996.50,219,$-34.50
2024-11-01,09:08:00,20093.5,SELL,3,0.02h,Break Even,$-1.50,$-36.00,$105995.00,219,$-36.00
2024-11-01,09:10:00,20101.0,BUY,3,0.02h,Stop Loss,$-9.00,$-45.00,$105986.00,219,$-45.00
2024-11-01,09:34:00,20098.0,SELL,3,0.02h,Stop Loss,$6.00,$-39.00,$105992.00,219,$-39.00
2024-11-01,10:04:00,20100.25,BUY,3,0.02h,Break Even,$-1.50,$-40.50,$105990.50,219,$-40.50
2024-11-01,10:40:00,20101.0,SELL,3,0.02h,Break Even,$-1.50,$-42.00,$105989.00,219,$-42.00
2024-11-01,10:50:00,20108.0,BUY,3,0.02h,Stop Loss,$-9.00,$-51.00,$105980.00,219,$-51.00
2024-11-01,11:06:00,20102.75,SELL,3,0.02h,Break Even,$-1.50,$-52.50,$105978.50,219,$-52.50
2024-11-01,11:17:00,20111.25,BUY,3,0.02h,Stop Loss,$-9.00,$-61.50,$105969.50,219,$-61.50
2024-11-01,11:48:00,20108.25,SELL,3,0.02h,Stop Loss,$18.00,$-43.50,$105987.50,219,$-43.50
2024-11-01,12:03:00,20116.75,BUY,3,0.02h,Break Even,$-1.50,$-45.00,$105986.00,219,$-45.00
2024-11-01,12:07:00,20111.75,SELL,3,0.02h,Break Even,$-1.50,$-46.50,$105984.50,219,$-46.50
2024-11-01,12:14:00,20116.75,BUY,3,0.02h,Break Even,$-1.50,$-48.00,$105983.00,219,$-48.00
2024-11-01,12:28:00,20111.5,SELL,3,0.02h,Stop Loss,$72.00,$24.00,$106055.00,219,$24.00
2024-11-01,12:34:00,20120.25,BUY,3,0.02h,Stop Loss,$67.50,$91.50,$106122.50,219,$91.50
2024-11-01,12:49:00,20108.25,SELL,3,0.02h,Stop Loss,$6.00,$97.50,$106128.50,219,$97.50
2024-11-01,12:55:00,20127.0,BUY,3,0.02h,Stop Loss,$9.00,$106.50,$106137.50,219,$106.50
2024-11-01,12:59:00,20113.5,SELL,3,0.02h,Break Even,$-1.50,$105.00,$106136.00,219,$105.00
2024-11-01,13:35:00,20111.75,BUY,3,0.02h,Break Even,$-1.50,$103.50,$106134.50,219,$103.50
2024-11-01,14:42:00,20220.25,SELL,3,0.02h,Stop Loss,$54.00,$157.50,$106188.50,219,$157.50
2024-11-01,15:00:00,20235.25,BUY,3,0.02h,Break Even,$-1.50,$156.00,$106187.00,219,$156.00
2024-11-01,15:42:00,20256.0,SELL,3,0.02h,Stop Loss,$10.50,$166.50,$106197.50,219,$166.50
2024-11-01,16:10:00,20248.25,BUY,3,0.02h,Stop Loss,$4.50,$171.00,$106202.00,219,$171.00
2024-11-01,16:19:00,20232.0,SELL,3,0.02h,Break Even,$-1.50,$169.50,$106200.50,219,$169.50
2024-11-01,16:20:00,20244.5,BUY,3,0.02h,Stop Loss,$-9.00,$160.50,$106191.50,219,$160.50
2024-11-01,16:21:00,20232.0,SELL,3,0.02h,Stop Loss,$30.00,$190.50,$106221.50,219,$190.50
2024-11-01,16:35:00,20250.75,BUY,3,0.02h,Break Even,$-1.50,$189.00,$106220.00,219,$189.00
2024-11-01,16:44:00,20198.25,SELL,3,0.02h,Stop Loss,$3.00,$192.00,$106223.00,219,$192.00
2024-11-01,17:17:00,20219.75,BUY,3,0.02h,Break Even,$-1.50,$190.50,$106221.50,219,$190.50
2024-11-01,17:34:00,20195.25,SELL,3,0.02h,Stop Loss,$39.00,$229.50,$106260.50,219,$229.50
2024-11-01,18:26:00,20165.0,BUY,3,0.02h,Stop Loss,$15.00,$244.50,$106275.50,219,$244.50
2024-11-01,18:43:00,20151.5,SELL,3,0.02h,Break Even,$-1.50,$243.00,$106274.00,219,$243.00
2024-11-01,18:45:00,20165.0,BUY,3,0.02h,Stop Loss,$64.50,$307.50,$106338.50,219,$307.50
2024-11-01,19:04:00,20158.0,SELL,3,0.02h,Stop Loss,$-9.00,$298.50,$106329.50,219,$298.50
2024-11-01,19:05:00,20166.75,BUY,3,0.02h,Break Even,$-1.50,$297.00,$106328.00,219,$297.00
2024-11-01,19:29:00,20170.5,SELL,3,0.02h,Stop Loss,$64.50,$361.50,$106392.50,219,$361.50
2024-11-01,19:44:00,20180.75,BUY,3,0.02h,Stop Loss,$-9.00,$352.50,$106383.50,219,$352.50
2024-11-01,19:45:00,20169.25,SELL,3,0.02h,Stop Loss,$12.00,$364.50,$106395.50,219,$364.50
2024-11-01,19:47:00,20175.75,BUY,3,0.02h,Break Even,$-1.50,$363.00,$106394.00,219,$363.00
2024-11-01,19:49:00,20161.0,SELL,3,0.02h,Stop Loss,$15.00,$378.00,$106409.00,219,$378.00
2024-11-01,20:08:00,20161.5,BUY,3,0.02h,Stop Loss,$-9.00,$369.00,$106400.00,219,$369.00
2024-11-01,20:49:00,20163.0,SELL,3,0.02h,Stop Loss,$-9.00,$360.00,$106391.00,219,$360.00
2024-11-01,21:00:00,20169.5,BUY,3,51.00h,Stop Loss,$-9.00,$351.00,$106382.00,219,$351.00
,,,,,,,,,,,
2024-11-04,00:00:00,20135.0,SELL,3,0.02h,Stop Loss,$3.00,$3.00,$106385.00,220,$3.00
2024-11-04,00:27:00,20142.75,BUY,3,0.02h,Break Even,$-1.50,$1.50,$106383.50,220,$1.50
2024-11-04,00:32:00,20134.0,SELL,3,0.02h,Break Even,$-1.50,$0.00,$106382.00,220,$0.00
2024-11-04,00:55:00,20134.25,BUY,3,0.02h,Stop Loss,$-9.00,$-9.00,$106373.00,220,$-9.00
2024-11-04,01:03:00,20127.75,SELL,3,0.02h,Break Even,$-1.50,$-10.50,$106371.50,220,$-10.50
2024-11-04,01:11:00,20132.5,BUY,3,0.02h,Stop Loss,$-9.00,$-19.50,$106362.50,220,$-19.50
2024-11-04,02:17:00,20186.0,SELL,3,0.02h,Stop Loss,$-9.00,$-28.50,$106353.50,220,$-28.50
2024-11-04,02:19:00,20189.5,BUY,3,0.02h,Stop Loss,$-9.00,$-37.50,$106344.50,220,$-37.50
2024-11-04,02:55:00,20213.5,SELL,3,0.02h,Break Even,$-1.50,$-39.00,$106343.00,220,$-39.00
2024-11-04,03:10:00,20217.75,BUY,3,0.02h,Break Even,$-1.50,$-40.50,$106341.50,220,$-40.50
2024-11-04,03:42:00,20218.25,SELL,3,0.02h,Stop Loss,$10.50,$-30.00,$106352.00,220,$-30.00
2024-11-04,03:53:00,20222.5,BUY,3,0.02h,Stop Loss,$-9.00,$-39.00,$106343.00,220,$-39.00
2024-11-04,03:54:00,20219.75,SELL,3,0.02h,Break Even,$-1.50,$-40.50,$106341.50,220,$-40.50
2024-11-04,04:05:00,20221.75,BUY,3,0.02h,Stop Loss,$-9.00,$-49.50,$106332.50,220,$-49.50
2024-11-04,04:07:00,20218.0,SELL,3,0.02h,Stop Loss,$-9.00,$-58.50,$106323.50,220,$-58.50
2024-11-04,04:08:00,20221.0,BUY,3,0.02h,Stop Loss,$-9.00,$-67.50,$106314.50,220,$-67.50
2024-11-04,04:19:00,20217.75,SELL,3,0.03h,Break Even,$-1.50,$-69.00,$106313.00,220,$-69.00
2024-11-04,04:23:00,20222.5,BUY,3,0.03h,Break Even,$-1.50,$-70.50,$106311.50,220,$-70.50
2024-11-04,05:04:00,20226.25,SELL,3,0.02h,Stop Loss,$-9.00,$-79.50,$106302.50,220,$-79.50
2024-11-04,05:44:00,20225.5,BUY,3,0.02h,Stop Loss,$-9.00,$-88.50,$106293.50,220,$-88.50
2024-11-04,05:46:00,20223.5,SELL,3,0.02h,Break Even,$-1.50,$-90.00,$106292.00,220,$-90.00
2024-11-04,05:52:00,20225.25,BUY,3,0.02h,Stop Loss,$-9.00,$-99.00,$106283.00,220,$-99.00
2024-11-04,05:54:00,20222.75,SELL,3,0.03h,Stop Loss,$-9.00,$-108.00,$106274.00,220,$-108.00
2024-11-04,05:56:00,20225.75,BUY,3,0.02h,Stop Loss,$-9.00,$-117.00,$106265.00,220,$-117.00
2024-11-04,06:52:00,20239.25,SELL,3,0.02h,Break Even,$-1.50,$-118.50,$106263.50,220,$-118.50
2024-11-04,08:16:00,20191.75,BUY,3,0.02h,Stop Loss,$36.00,$-82.50,$106299.50,220,$-82.50
2024-11-04,08:27:00,20180.75,SELL,3,0.02h,Stop Loss,$4.50,$-78.00,$106304.00,220,$-78.00
2024-11-04,08:57:00,20161.75,BUY,3,0.02h,Break Even,$-1.50,$-79.50,$106302.50,220,$-79.50
2024-11-04,09:05:00,20153.75,SELL,3,0.02h,Stop Loss,$-9.00,$-88.50,$106293.50,220,$-88.50
2024-11-04,09:06:00,20159.5,BUY,3,0.02h,Stop Loss,$-9.00,$-97.50,$106284.50,220,$-97.50
2024-11-04,09:14:00,20156.0,SELL,3,0.02h,Break Even,$-1.50,$-99.00,$106283.00,220,$-99.00
2024-11-04,09:21:00,20162.5,BUY,3,0.02h,Break Even,$-1.50,$-100.50,$106281.50,220,$-100.50
2024-11-04,09:24:00,20152.5,SELL,3,0.02h,Stop Loss,$-9.00,$-109.50,$106272.50,220,$-109.50
2024-11-04,09:46:00,20159.25,BUY,3,0.02h,Break Even,$-1.50,$-111.00,$106271.00,220,$-111.00
2024-11-04,10:58:00,20198.0,SELL,3,0.02h,Break Even,$-1.50,$-112.50,$106269.50,220,$-112.50
2024-11-04,11:42:00,20184.25,BUY,3,0.02h,Stop Loss,$9.00,$-103.50,$106278.50,220,$-103.50
2024-11-04,11:56:00,20175.75,SELL,3,0.02h,Stop Loss,$-9.00,$-112.50,$106269.50,220,$-112.50
2024-11-04,12:02:00,20192.75,BUY,3,0.02h,Stop Loss,$-9.00,$-121.50,$106260.50,220,$-121.50
2024-11-04,12:06:00,20175.5,SELL,3,0.02h,Stop Loss,$10.50,$-111.00,$106271.00,220,$-111.00
2024-11-04,12:52:00,20148.0,BUY,3,0.02h,Stop Loss,$-9.00,$-120.00,$106262.00,220,$-120.00
2024-11-04,13:16:00,20143.5,SELL,3,0.02h,Stop Loss,$-9.00,$-129.00,$106253.00,220,$-129.00
2024-11-04,13:21:00,20165.0,BUY,3,0.02h,Stop Loss,$-9.00,$-138.00,$106244.00,220,$-138.00
2024-11-04,13:25:00,20157.0,SELL,3,0.02h,Stop Loss,$15.00,$-123.00,$106259.00,220,$-123.00
2024-11-04,13:30:00,20161.25,BUY,3,0.02h,Stop Loss,$-9.00,$-132.00,$106250.00,220,$-132.00
2024-11-04,13:46:00,20156.5,SELL,3,0.02h,Stop Loss,$-9.00,$-141.00,$106241.00,220,$-141.00
2024-11-04,14:46:00,20125.5,BUY,3,0.02h,Stop Loss,$18.00,$-123.00,$106259.00,220,$-123.00
2024-11-04,16:21:00,20193.25,SELL,3,0.02h,Stop Loss,$46.50,$-76.50,$106305.50,220,$-76.50
2024-11-04,17:22:00,20083.0,BUY,3,0.02h,Stop Loss,$19.50,$-57.00,$106325.00,220,$-57.00
2024-11-04,18:06:00,20119.25,SELL,3,0.02h,Stop Loss,$54.00,$-3.00,$106379.00,220,$-3.00
2024-11-04,18:15:00,20137.75,BUY,3,0.02h,Stop Loss,$28.50,$25.50,$106407.50,220,$25.50
2024-11-04,19:00:00,20148.75,SELL,3,0.02h,Stop Loss,$-9.00,$16.50,$106398.50,220,$16.50
2024-11-04,19:08:00,20163.5,BUY,3,0.02h,Stop Loss,$10.50,$27.00,$106409.00,220,$27.00
2024-11-04,19:11:00,20149.75,SELL,3,0.02h,Stop Loss,$-9.00,$18.00,$106400.00,220,$18.00
2024-11-04,19:15:00,20159.5,BUY,3,0.02h,Break Even,$-1.50,$16.50,$106398.50,220,$16.50
2024-11-04,19:18:00,20151.5,SELL,3,0.02h,Break Even,$-1.50,$15.00,$106397.00,220,$15.00
2024-11-04,19:38:00,20151.75,BUY,3,0.02h,Break Even,$-1.50,$13.50,$106395.50,220,$13.50
2024-11-04,19:46:00,20145.5,SELL,3,0.02h,Stop Loss,$12.00,$25.50,$106407.50,220,$25.50
2024-11-04,20:26:00,20134.75,BUY,3,0.02h,Break Even,$-1.50,$24.00,$106406.00,220,$24.00
2024-11-04,20:29:00,20118.0,SELL,3,0.02h,Break Even,$-1.50,$22.50,$106404.50,220,$22.50
2024-11-04,21:09:00,20107.25,BUY,3,0.02h,Stop Loss,$9.00,$31.50,$106413.50,220,$31.50
2024-11-04,21:38:00,20104.0,SELL,3,0.02h,Break Even,$-1.50,$30.00,$106412.00,220,$30.00
2024-11-04,21:50:00,20110.25,BUY,3,0.02h,Stop Loss,$-9.00,$21.00,$106403.00,220,$21.00
2024-11-04,21:57:00,20105.5,SELL,3,0.02h,Break Even,$-1.50,$19.50,$106401.50,220,$19.50
2024-11-04,23:01:00,20120.5,BUY,3,0.02h,Break Even,$-1.50,$18.00,$106400.00,220,$18.00
2024-11-04,23:15:00,20107.5,SELL,3,0.02h,Stop Loss,$18.00,$36.00,$106418.00,220,$36.00
2024-11-04,23:38:00,20112.25,BUY,3,0.02h,Stop Loss,$-9.00,$27.00,$106409.00,220,$27.00
2024-11-04,23:46:00,20098.75,SELL,3,0.02h,Stop Loss,$33.00,$60.00,$106442.00,220,$60.00
,,,,,,,,,,,
2024-11-05,00:33:00,20086.5,BUY,3,0.02h,Stop Loss,$-9.00,$-9.00,$106433.00,221,$-9.00
2024-11-05,00:42:00,20079.75,SELL,3,0.02h,Stop Loss,$6.00,$-3.00,$106439.00,221,$-3.00
2024-11-05,00:51:00,20086.75,BUY,3,0.02h,Break Even,$-1.50,$-4.50,$106437.50,221,$-4.50
2024-11-05,00:57:00,20078.25,SELL,3,0.02h,Stop Loss,$19.50,$15.00,$106457.00,221,$15.00
2024-11-05,01:46:00,20072.5,BUY,3,0.02h,Stop Loss,$57.00,$72.00,$106514.00,221,$72.00
2024-11-05,02:14:00,20081.25,SELL,3,0.02h,Stop Loss,$-9.00,$63.00,$106505.00,221,$63.00
2024-11-05,02:23:00,20095.0,BUY,3,0.02h,Stop Loss,$9.00,$72.00,$106514.00,221,$72.00
2024-11-05,02:48:00,20098.25,SELL,3,0.02h,Break Even,$-1.50,$70.50,$106512.50,221,$70.50
2024-11-05,02:59:00,20103.0,BUY,3,0.03h,Stop Loss,$-9.00,$61.50,$106503.50,221,$61.50
2024-11-05,03:04:00,20098.25,SELL,3,0.02h,Stop Loss,$-9.00,$52.50,$106494.50,221,$52.50
2024-11-05,03:08:00,20102.0,BUY,3,0.02h,Stop Loss,$-9.00,$43.50,$106485.50,221,$43.50
2024-11-05,03:11:00,20098.75,SELL,3,0.02h,Break Even,$-1.50,$42.00,$106484.00,221,$42.00
2024-11-05,03:15:00,20101.75,BUY,3,0.02h,Break Even,$-1.50,$40.50,$106482.50,221,$40.50
2024-11-05,03:37:00,20099.0,SELL,3,0.02h,Stop Loss,$-9.00,$31.50,$106473.50,221,$31.50
2024-11-05,03:51:00,20111.25,BUY,3,0.02h,Stop Loss,$-9.00,$22.50,$106464.50,221,$22.50
2024-11-05,03:55:00,20100.25,SELL,3,0.02h,Stop Loss,$-9.00,$13.50,$106455.50,221,$13.50
2024-11-05,04:29:00,20102.5,BUY,3,0.02h,Break Even,$-1.50,$12.00,$106454.00,221,$12.00
2024-11-05,04:33:00,20093.0,SELL,3,0.02h,Break Even,$-1.50,$10.50,$106452.50,221,$10.50
2024-11-05,05:06:00,20090.25,BUY,3,0.02h,Break Even,$-1.50,$9.00,$106451.00,221,$9.00
2024-11-05,05:51:00,20101.5,SELL,3,0.02h,Stop Loss,$-9.00,$0.00,$106442.00,221,$0.00
2024-11-05,06:07:00,20105.0,BUY,3,0.02h,Break Even,$-1.50,$-1.50,$106440.50,221,$-1.50
2024-11-05,06:28:00,20101.0,SELL,3,0.02h,Stop Loss,$-9.00,$-10.50,$106431.50,221,$-10.50
2024-11-05,06:31:00,20114.75,BUY,3,0.02h,Break Even,$-1.50,$-12.00,$106430.00,221,$-12.00
2024-11-05,07:02:00,20116.25,SELL,3,0.02h,Break Even,$-1.50,$-13.50,$106428.50,221,$-13.50
2024-11-05,07:08:00,20128.5,BUY,3,0.02h,Break Even,$-1.50,$-15.00,$106427.00,221,$-15.00
2024-11-05,07:30:00,20125.0,SELL,3,0.02h,Break Even,$-1.50,$-16.50,$106425.50,221,$-16.50
2024-11-05,07:57:00,20128.5,BUY,3,0.02h,Break Even,$-1.50,$-18.00,$106424.00,221,$-18.00
2024-11-05,08:02:00,20117.5,SELL,3,0.02h,Break Even,$-1.50,$-19.50,$106422.50,221,$-19.50
2024-11-05,08:27:00,20119.0,BUY,3,0.02h,Break Even,$-1.50,$-21.00,$106421.00,221,$-21.00
2024-11-05,09:33:00,20155.25,SELL,3,0.02h,Stop Loss,$-9.00,$-30.00,$106412.00,221,$-30.00
2024-11-05,09:39:00,20164.25,BUY,3,0.02h,Break Even,$-1.50,$-31.50,$106410.50,221,$-31.50
2024-11-05,09:48:00,20153.25,SELL,3,0.02h,Stop Loss,$-9.00,$-40.50,$106401.50,221,$-40.50
2024-11-05,10:28:00,20141.0,BUY,3,0.02h,Stop Loss,$-9.00,$-49.50,$106392.50,221,$-49.50
2024-11-05,10:43:00,20134.5,SELL,3,0.02h,Break Even,$-1.50,$-51.00,$106391.00,221,$-51.00
2024-11-05,10:45:00,20139.0,BUY,3,0.02h,Stop Loss,$12.00,$-39.00,$106403.00,221,$-39.00
2024-11-05,10:49:00,20131.75,SELL,3,0.02h,Stop Loss,$-9.00,$-48.00,$106394.00,221,$-48.00
2024-11-05,11:00:00,20143.0,BUY,3,0.02h,Stop Loss,$24.00,$-24.00,$106418.00,221,$-24.00
2024-11-05,11:56:00,20158.75,SELL,3,0.02h,Stop Loss,$-9.00,$-33.00,$106409.00,221,$-33.00
2024-11-05,12:19:00,20162.0,BUY,3,0.02h,Stop Loss,$-9.00,$-42.00,$106400.00,221,$-42.00
2024-11-05,12:21:00,20150.25,SELL,3,0.02h,Stop Loss,$12.00,$-30.00,$106412.00,221,$-30.00
2024-11-05,12:51:00,20148.0,BUY,3,0.02h,Stop Loss,$-9.00,$-39.00,$106403.00,221,$-39.00
2024-11-05,13:13:00,20136.5,SELL,3,0.02h,Break Even,$-1.50,$-40.50,$106401.50,221,$-40.50
2024-11-05,13:23:00,20149.25,BUY,3,0.02h,Stop Loss,$-9.00,$-49.50,$106392.50,221,$-49.50
2024-11-05,13:52:00,20152.75,SELL,3,0.02h,Break Even,$-1.50,$-51.00,$106391.00,221,$-51.00
2024-11-05,14:17:00,20142.25,BUY,3,0.02h,Break Even,$-1.50,$-52.50,$106389.50,221,$-52.50
2024-11-05,15:31:00,20275.0,SELL,3,0.02h,Break Even,$-1.50,$-54.00,$106388.00,221,$-54.00
2024-11-05,15:41:00,20286.75,BUY,3,0.02h,Stop Loss,$9.00,$-45.00,$106397.00,221,$-45.00
2024-11-05,15:53:00,20264.25,SELL,3,0.02h,Stop Loss,$22.50,$-22.50,$106419.50,221,$-22.50
2024-11-05,16:09:00,20293.25,BUY,3,0.02h,Stop Loss,$12.00,$-10.50,$106431.50,221,$-10.50
2024-11-05,17:40:00,20349.25,SELL,3,0.02h,Break Even,$-1.50,$-12.00,$106430.00,221,$-12.00
2024-11-05,17:47:00,20363.75,BUY,3,0.02h,Stop Loss,$10.50,$-1.50,$106440.50,221,$-1.50
2024-11-05,17:59:00,20344.5,SELL,3,0.02h,Stop Loss,$-9.00,$-10.50,$106431.50,221,$-10.50
2024-11-05,18:07:00,20365.5,BUY,3,0.02h,Break Even,$-1.50,$-12.00,$106430.00,221,$-12.00
2024-11-05,18:12:00,20347.0,SELL,3,0.02h,Stop Loss,$10.50,$-1.50,$106440.50,221,$-1.50
2024-11-05,19:03:00,20321.0,BUY,3,0.02h,Break Even,$-1.50,$-3.00,$106439.00,221,$-3.00
2024-11-05,19:19:00,20312.75,SELL,3,0.02h,Break Even,$-1.50,$-4.50,$106437.50,221,$-4.50
2024-11-05,19:28:00,20323.25,BUY,3,0.02h,Break Even,$-1.50,$-6.00,$106436.00,221,$-6.00
2024-11-05,19:51:00,20313.0,SELL,3,0.02h,Stop Loss,$40.50,$34.50,$106476.50,221,$34.50
2024-11-05,20:09:00,20316.25,BUY,3,0.02h,Stop Loss,$24.00,$58.50,$106500.50,221,$58.50
2024-11-05,20:44:00,20311.0,SELL,3,0.02h,Stop Loss,$-9.00,$49.50,$106491.50,221,$49.50
2024-11-05,20:59:00,20331.25,BUY,3,0.02h,Stop Loss,$78.00,$127.50,$106569.50,221,$127.50
2024-11-05,21:42:00,20362.25,SELL,3,0.02h,Stop Loss,$-9.00,$118.50,$106560.50,221,$118.50
2024-11-05,23:32:00,20353.75,BUY,3,0.02h,Break Even,$-1.50,$117.00,$106559.00,221,$117.00
2024-11-05,23:40:00,20347.0,SELL,3,0.02h,Break Even,$-1.50,$115.50,$106557.50,221,$115.50
2024-11-05,23:45:00,20350.75,BUY,3,0.02h,Break Even,$-1.50,$114.00,$106556.00,221,$114.00
,,,,,,,,,,,
2024-11-06,00:00:00,20344.0,SELL,3,0.02h,Break Even,$-1.50,$-1.50,$106554.50,222,$-1.50
2024-11-06,00:23:00,20351.25,BUY,3,0.02h,Stop Loss,$76.50,$75.00,$106631.00,222,$75.00
2024-11-06,01:28:00,20394.5,SELL,3,0.02h,Stop Loss,$6.00,$81.00,$106637.00,222,$81.00
2024-11-06,01:57:00,20403.5,BUY,3,0.02h,Break Even,$-1.50,$79.50,$106635.50,222,$79.50
2024-11-06,03:32:00,20586.25,SELL,3,0.02h,Stop Loss,$18.00,$97.50,$106653.50,222,$97.50
2024-11-06,04:00:00,20593.25,BUY,3,0.02h,Stop Loss,$19.50,$117.00,$106673.00,222,$117.00
2024-11-06,04:06:00,20578.0,SELL,3,0.02h,Break Even,$-1.50,$115.50,$106671.50,222,$115.50
2024-11-06,04:14:00,20597.75,BUY,3,0.02h,Stop Loss,$34.50,$150.00,$106706.00,222,$150.00
2024-11-06,04:46:00,20596.75,SELL,3,0.02h,Break Even,$-1.50,$148.50,$106704.50,222,$148.50
2024-11-06,05:32:00,20545.5,BUY,3,0.02h,Stop Loss,$6.00,$154.50,$106710.50,222,$154.50
2024-11-06,07:26:00,20681.5,SELL,3,0.02h,Stop Loss,$25.50,$180.00,$106736.00,222,$180.00
2024-11-06,07:35:00,20692.0,BUY,3,0.02h,Stop Loss,$51.00,$231.00,$106787.00,222,$231.00
2024-11-06,07:41:00,20676.0,SELL,3,0.02h,Stop Loss,$3.00,$234.00,$106790.00,222,$234.00
2024-11-06,07:59:00,20686.75,BUY,3,0.02h,Stop Loss,$-9.00,$225.00,$106781.00,222,$225.00
2024-11-06,08:07:00,20665.5,SELL,3,0.02h,Stop Loss,$15.00,$240.00,$106796.00,222,$240.00
2024-11-06,08:22:00,20683.0,BUY,3,0.02h,Stop Loss,$43.50,$283.50,$106839.50,222,$283.50
2024-11-06,09:05:00,20691.5,SELL,3,0.02h,Stop Loss,$55.50,$339.00,$106895.00,222,$339.00
2024-11-06,09:26:00,20691.75,BUY,3,0.02h,Stop Loss,$28.50,$367.50,$106923.50,222,$367.50
2024-11-06,10:07:00,20695.0,SELL,3,0.02h,Stop Loss,$3.00,$370.50,$106926.50,222,$370.50
2024-11-06,10:31:00,20714.25,BUY,3,0.02h,Break Even,$-1.50,$369.00,$106925.00,222,$369.00
2024-11-06,10:42:00,20702.75,SELL,3,0.02h,Break Even,$-1.50,$367.50,$106923.50,222,$367.50
2024-11-06,11:25:00,20687.5,BUY,3,0.02h,Break Even,$-1.50,$366.00,$106922.00,222,$366.00
2024-11-06,11:30:00,20678.0,SELL,3,0.02h,Stop Loss,$27.00,$393.00,$106949.00,222,$393.00
2024-11-06,12:10:00,20643.75,BUY,3,0.02h,Stop Loss,$42.00,$435.00,$106991.00,222,$435.00
2024-11-06,13:03:00,20665.75,SELL,3,0.02h,Stop Loss,$-9.00,$426.00,$106982.00,222,$426.00
2024-11-06,13:18:00,20683.75,BUY,3,0.02h,Stop Loss,$3.00,$429.00,$106985.00,222,$429.00
2024-11-06,13:46:00,20687.25,SELL,3,0.02h,Stop Loss,$45.00,$474.00,$107030.00,222,$474.00
2024-11-06,14:28:00,20688.5,BUY,3,0.02h,Stop Loss,$-9.00,$465.00,$107021.00,222,$465.00
2024-11-06,14:49:00,20680.5,SELL,3,0.02h,Stop Loss,$90.00,$555.00,$107111.00,222,$555.00
2024-11-06,15:03:00,20725.5,BUY,3,0.02h,Break Even,$-1.50,$553.50,$107109.50,222,$553.50
2024-11-06,15:06:00,20686.5,SELL,3,0.02h,Break Even,$-1.50,$552.00,$107108.00,222,$552.00
2024-11-06,15:11:00,20735.25,BUY,3,0.02h,Stop Loss,$37.50,$589.50,$107145.50,222,$589.50
2024-11-06,15:42:00,20772.25,SELL,3,0.02h,Stop Loss,$132.00,$721.50,$107277.50,222,$721.50
2024-11-06,16:13:00,20747.0,BUY,3,0.02h,Stop Loss,$52.50,$774.00,$107330.00,222,$774.00
2024-11-06,17:22:00,20794.0,SELL,3,0.02h,Break Even,$-1.50,$772.50,$107328.50,222,$772.50
2024-11-06,17:33:00,20801.75,BUY,3,0.02h,Break Even,$-1.50,$771.00,$107327.00,222,$771.00
2024-11-06,17:40:00,20792.0,SELL,3,0.02h,Break Even,$-1.50,$769.50,$107325.50,222,$769.50
2024-11-06,17:43:00,20803.0,BUY,3,0.02h,Break Even,$-1.50,$768.00,$107324.00,222,$768.00
2024-11-06,18:59:00,20853.25,SELL,3,0.02h,Stop Loss,$-9.00,$759.00,$107315.00,222,$759.00
2024-11-06,19:02:00,20873.25,BUY,3,0.02h,Break Even,$-1.50,$757.50,$107313.50,222,$757.50
2024-11-06,19:07:00,20854.0,SELL,3,0.02h,Stop Loss,$12.00,$769.50,$107325.50,222,$769.50
2024-11-06,19:09:00,20869.0,BUY,3,0.02h,Break Even,$-1.50,$768.00,$107324.00,222,$768.00
2024-11-06,19:11:00,20858.25,SELL,3,0.02h,Break Even,$-1.50,$766.50,$107322.50,222,$766.50
2024-11-06,19:14:00,20872.25,BUY,3,0.02h,Stop Loss,$42.00,$808.50,$107364.50,222,$808.50
2024-11-06,19:43:00,20869.0,SELL,3,0.02h,Break Even,$-1.50,$807.00,$107363.00,222,$807.00
2024-11-06,19:48:00,20885.5,BUY,3,0.02h,Stop Loss,$9.00,$816.00,$107372.00,222,$816.00
2024-11-06,19:56:00,20876.5,SELL,3,0.02h,Break Even,$-1.50,$814.50,$107370.50,222,$814.50
2024-11-06,19:58:00,20883.25,BUY,3,0.02h,Break Even,$-1.50,$813.00,$107369.00,222,$813.00
2024-11-06,20:38:00,20897.75,SELL,3,0.02h,Stop Loss,$6.00,$819.00,$107375.00,222,$819.00
2024-11-06,20:45:00,20912.75,BUY,3,0.02h,Break Even,$-1.50,$817.50,$107373.50,222,$817.50
2024-11-06,20:53:00,20881.0,SELL,3,0.02h,Break Even,$-1.50,$816.00,$107372.00,222,$816.00
2024-11-06,21:02:00,20917.75,BUY,3,0.02h,Stop Loss,$28.50,$844.50,$107400.50,222,$844.50
2024-11-06,21:08:00,20897.5,SELL,3,0.02h,Break Even,$-1.50,$843.00,$107399.00,222,$843.00
2024-11-06,21:23:00,20902.25,BUY,3,0.02h,Stop Loss,$51.00,$894.00,$107450.00,222,$894.00
2024-11-06,21:41:00,20901.25,SELL,3,0.02h,Break Even,$-1.50,$892.50,$107448.50,222,$892.50
2024-11-06,21:43:00,20908.0,BUY,3,0.02h,Stop Loss,$22.50,$915.00,$107471.00,222,$915.00
2024-11-06,23:08:00,20910.75,SELL,3,0.02h,Stop Loss,$-9.00,$906.00,$107462.00,222,$906.00
,,,,,,,,,,,
2024-11-07,00:06:00,20902.5,BUY,3,0.02h,Break Even,$-1.50,$-1.50,$107460.50,223,$-1.50
2024-11-07,00:23:00,20888.75,SELL,3,0.02h,Break Even,$-1.50,$-3.00,$107459.00,223,$-3.00
2024-11-07,01:04:00,20874.0,BUY,3,0.02h,Stop Loss,$3.00,$0.00,$107462.00,223,$0.00
2024-11-07,01:06:00,20869.75,SELL,3,0.02h,Break Even,$-1.50,$-1.50,$107460.50,223,$-1.50
2024-11-07,01:13:00,20881.5,BUY,3,0.02h,Stop Loss,$4.50,$3.00,$107465.00,223,$3.00
2024-11-07,02:08:00,20906.0,SELL,3,0.02h,Stop Loss,$-9.00,$-6.00,$107456.00,223,$-6.00
2024-11-07,02:19:00,20911.75,BUY,3,0.02h,Stop Loss,$-9.00,$-15.00,$107447.00,223,$-15.00
2024-11-07,02:32:00,20904.75,SELL,3,0.02h,Break Even,$-1.50,$-16.50,$107445.50,223,$-16.50
2024-11-07,02:51:00,20909.75,BUY,3,0.02h,Stop Loss,$-9.00,$-25.50,$107436.50,223,$-25.50
2024-11-07,03:09:00,20905.75,SELL,3,0.02h,Stop Loss,$-9.00,$-34.50,$107427.50,223,$-34.50
2024-11-07,03:11:00,20914.75,BUY,3,0.02h,Break Even,$-1.50,$-36.00,$107426.00,223,$-36.00
2024-11-07,03:37:00,20914.75,SELL,3,0.02h,Break Even,$-1.50,$-37.50,$107424.50,223,$-37.50
2024-11-07,03:44:00,20926.75,BUY,3,0.02h,Stop Loss,$-9.00,$-46.50,$107415.50,223,$-46.50
2024-11-07,03:55:00,20918.75,SELL,3,0.02h,Break Even,$-1.50,$-48.00,$107414.00,223,$-48.00
2024-11-07,04:45:00,20914.25,BUY,3,0.02h,Break Even,$-1.50,$-49.50,$107412.50,223,$-49.50
2024-11-07,05:42:00,20931.25,SELL,3,0.02h,Stop Loss,$-9.00,$-58.50,$107403.50,223,$-58.50
2024-11-07,05:43:00,20936.25,BUY,3,0.02h,Stop Loss,$-9.00,$-67.50,$107394.50,223,$-67.50
2024-11-07,06:18:00,20944.25,SELL,3,0.02h,Break Even,$-1.50,$-69.00,$107393.00,223,$-69.00
2024-11-07,06:23:00,20953.0,BUY,3,0.02h,Break Even,$-1.50,$-70.50,$107391.50,223,$-70.50
2024-11-07,06:41:00,20947.75,SELL,3,0.02h,Break Even,$-1.50,$-72.00,$107390.00,223,$-72.00
2024-11-07,06:45:00,20958.25,BUY,3,0.02h,Stop Loss,$9.00,$-63.00,$107399.00,223,$-63.00
2024-11-07,06:59:00,20950.0,SELL,3,0.02h,Stop Loss,$-9.00,$-72.00,$107390.00,223,$-72.00
2024-11-07,07:44:00,20928.25,BUY,3,0.02h,Break Even,$-1.50,$-73.50,$107388.50,223,$-73.50
2024-11-07,08:00:00,20923.25,SELL,3,0.02h,Stop Loss,$-9.00,$-82.50,$107379.50,223,$-82.50
2024-11-07,08:08:00,20930.0,BUY,3,0.02h,Stop Loss,$27.00,$-55.50,$107406.50,223,$-55.50
2024-11-07,08:37:00,20933.75,SELL,3,0.02h,Stop Loss,$22.50,$-33.00,$107429.00,223,$-33.00
2024-11-07,09:09:00,20940.75,BUY,3,0.02h,Stop Loss,$9.00,$-24.00,$107438.00,223,$-24.00
2024-11-07,09:40:00,20942.25,SELL,3,0.02h,Stop Loss,$-9.00,$-33.00,$107429.00,223,$-33.00
2024-11-07,10:08:00,20947.0,BUY,3,0.02h,Stop Loss,$-9.00,$-42.00,$107420.00,223,$-42.00
2024-11-07,10:10:00,20943.0,SELL,3,0.02h,Stop Loss,$-9.00,$-51.00,$107411.00,223,$-51.00
2024-11-07,10:11:00,20944.25,BUY,3,0.02h,Break Even,$-1.50,$-52.50,$107409.50,223,$-52.50
2024-11-07,10:26:00,20938.25,SELL,3,0.02h,Stop Loss,$-9.00,$-61.50,$107400.50,223,$-61.50
2024-11-07,10:39:00,20946.75,BUY,3,0.02h,Stop Loss,$-9.00,$-70.50,$107391.50,223,$-70.50
2024-11-07,10:47:00,20940.5,SELL,3,0.02h,Break Even,$-1.50,$-72.00,$107390.00,223,$-72.00
2024-11-07,11:00:00,20945.5,BUY,3,0.02h,Stop Loss,$-9.00,$-81.00,$107381.00,223,$-81.00
2024-11-07,11:01:00,20939.0,SELL,3,0.02h,Stop Loss,$-9.00,$-90.00,$107372.00,223,$-90.00
2024-11-07,11:26:00,20937.75,BUY,3,0.02h,Break Even,$-1.50,$-91.50,$107370.50,223,$-91.50
2024-11-07,11:35:00,20931.0,SELL,3,0.02h,Stop Loss,$7.50,$-84.00,$107378.00,223,$-84.00
2024-11-07,11:42:00,20936.25,BUY,3,0.02h,Stop Loss,$3.00,$-81.00,$107381.00,223,$-81.00
2024-11-07,12:44:00,20960.75,SELL,3,0.02h,Stop Loss,$-9.00,$-90.00,$107372.00,223,$-90.00
2024-11-07,13:00:00,20967.0,BUY,3,0.02h,Stop Loss,$4.50,$-85.50,$107376.50,223,$-85.50
2024-11-07,13:25:00,20978.25,SELL,3,0.02h,Break Even,$-1.50,$-87.00,$107375.00,223,$-87.00
2024-11-07,13:46:00,20989.5,BUY,3,0.02h,Break Even,$-1.50,$-88.50,$107373.50,223,$-88.50
2024-11-07,15:34:00,21092.25,SELL,3,0.02h,Stop Loss,$13.50,$-75.00,$107387.00,223,$-75.00
2024-11-07,15:37:00,21123.5,BUY,3,0.02h,Break Even,$-1.50,$-76.50,$107385.50,223,$-76.50
2024-11-07,15:42:00,21106.0,SELL,3,0.02h,Stop Loss,$-9.00,$-85.50,$107376.50,223,$-85.50
2024-11-07,15:43:00,21111.5,BUY,3,0.02h,Break Even,$-1.50,$-87.00,$107375.00,223,$-87.00
2024-11-07,15:44:00,21106.75,SELL,3,0.02h,Stop Loss,$-9.00,$-96.00,$107366.00,223,$-96.00
2024-11-07,15:45:00,21118.75,BUY,3,0.02h,Stop Loss,$57.00,$-39.00,$107423.00,223,$-39.00
2024-11-07,16:11:00,21132.75,SELL,3,0.02h,Stop Loss,$-9.00,$-48.00,$107414.00,223,$-48.00
2024-11-07,16:12:00,21145.75,BUY,3,0.02h,Break Even,$-1.50,$-49.50,$107412.50,223,$-49.50
2024-11-07,17:05:00,21171.5,SELL,3,0.02h,Stop Loss,$15.00,$-34.50,$107427.50,223,$-34.50
2024-11-07,17:16:00,21179.25,BUY,3,0.02h,Break Even,$-1.50,$-36.00,$107426.00,223,$-36.00
2024-11-07,17:17:00,21173.75,SELL,3,0.02h,Break Even,$-1.50,$-37.50,$107424.50,223,$-37.50
2024-11-07,17:18:00,21177.75,BUY,3,0.02h,Stop Loss,$6.00,$-31.50,$107430.50,223,$-31.50
2024-11-07,17:21:00,21172.0,SELL,3,0.02h,Stop Loss,$-9.00,$-40.50,$107421.50,223,$-40.50
2024-11-07,17:22:00,21183.5,BUY,3,0.02h,Break Even,$-1.50,$-42.00,$107420.00,223,$-42.00
2024-11-07,17:26:00,21172.25,SELL,3,0.02h,Break Even,$-1.50,$-43.50,$107418.50,223,$-43.50
2024-11-07,17:31:00,21184.0,BUY,3,0.02h,Stop Loss,$19.50,$-24.00,$107438.00,223,$-24.00
2024-11-07,17:34:00,21166.5,SELL,3,0.02h,Break Even,$-1.50,$-25.50,$107436.50,223,$-25.50
2024-11-07,17:38:00,21185.0,BUY,3,0.02h,Stop Loss,$4.50,$-21.00,$107441.00,223,$-21.00
2024-11-07,18:08:00,21179.25,SELL,3,0.02h,Stop Loss,$34.50,$13.50,$107475.50,223,$13.50
2024-11-07,18:52:00,21179.25,BUY,3,0.02h,Stop Loss,$12.00,$25.50,$107487.50,223,$25.50
2024-11-07,19:24:00,21179.25,SELL,3,0.02h,Break Even,$-1.50,$24.00,$107486.00,223,$24.00
2024-11-07,19:28:00,21192.0,BUY,3,0.02h,Stop Loss,$-9.00,$15.00,$107477.00,223,$15.00
2024-11-07,19:43:00,21173.75,SELL,3,0.02h,Stop Loss,$12.00,$27.00,$107489.00,223,$27.00
2024-11-07,19:48:00,21199.0,BUY,3,0.02h,Stop Loss,$67.50,$94.50,$107556.50,223,$94.50
2024-11-07,20:35:00,21229.5,SELL,3,0.02h,Break Even,$-1.50,$93.00,$107555.00,223,$93.00
2024-11-07,20:48:00,21243.0,BUY,3,0.02h,Stop Loss,$15.00,$108.00,$107570.00,223,$108.00
2024-11-07,20:52:00,21218.0,SELL,3,0.02h,Stop Loss,$39.00,$147.00,$107609.00,223,$147.00
2024-11-07,21:07:00,21232.5,BUY,3,0.02h,Stop Loss,$15.00,$162.00,$107624.00,223,$162.00
2024-11-07,21:28:00,21232.0,SELL,3,0.02h,Break Even,$-1.50,$160.50,$107622.50,223,$160.50
2024-11-07,21:59:00,21226.75,BUY,3,1.03h,Stop Loss,$4.50,$165.00,$107627.00,223,$165.00
2024-11-07,23:01:00,21215.0,SELL,3,0.02h,Stop Loss,$-9.00,$156.00,$107618.00,223,$156.00
2024-11-07,23:18:00,21222.0,BUY,3,0.02h,Stop Loss,$-9.00,$147.00,$107609.00,223,$147.00
2024-11-07,23:21:00,21216.25,SELL,3,0.02h,Stop Loss,$-9.00,$138.00,$107600.00,223,$138.00
2024-11-07,23:22:00,21218.0,BUY,3,0.02h,Break Even,$-1.50,$136.50,$107598.50,223,$136.50
2024-11-07,23:42:00,21219.75,SELL,3,0.02h,Break Even,$-1.50,$135.00,$107597.00,223,$135.00
2024-11-07,23:52:00,21224.5,BUY,3,0.02h,Stop Loss,$-9.00,$126.00,$107588.00,223,$126.00
,,,,,,,,,,,
2024-11-08,00:25:00,21226.25,SELL,3,0.02h,Stop Loss,$-9.00,$-9.00,$107579.00,224,$-9.00
2024-11-08,00:42:00,21229.0,BUY,3,0.02h,Break Even,$-1.50,$-10.50,$107577.50,224,$-10.50
2024-11-08,00:53:00,21223.25,SELL,3,0.02h,Stop Loss,$-9.00,$-19.50,$107568.50,224,$-19.50
2024-11-08,01:12:00,21227.5,BUY,3,0.02h,Stop Loss,$-9.00,$-28.50,$107559.50,224,$-28.50
2024-11-08,01:15:00,21219.75,SELL,3,0.02h,Break Even,$-1.50,$-30.00,$107558.00,224,$-30.00
2024-11-08,01:44:00,21224.5,BUY,3,0.02h,Stop Loss,$18.00,$-12.00,$107576.00,224,$-12.00
2024-11-08,02:23:00,21232.0,SELL,3,0.02h,Stop Loss,$-9.00,$-21.00,$107567.00,224,$-21.00
2024-11-08,03:10:00,21226.0,BUY,3,0.03h,Break Even,$-1.50,$-22.50,$107565.50,224,$-22.50
2024-11-08,03:26:00,21225.25,SELL,3,0.02h,Stop Loss,$-9.00,$-31.50,$107556.50,224,$-31.50
2024-11-08,03:30:00,21227.0,BUY,3,0.02h,Break Even,$-1.50,$-33.00,$107555.00,224,$-33.00
2024-11-08,04:00:00,21226.75,SELL,3,0.02h,Stop Loss,$4.50,$-28.50,$107559.50,224,$-28.50
2024-11-08,04:17:00,21232.75,BUY,3,0.02h,Stop Loss,$-9.00,$-37.50,$107550.50,224,$-37.50
2024-11-08,04:35:00,21226.5,SELL,3,0.02h,Stop Loss,$-9.00,$-46.50,$107541.50,224,$-46.50
2024-11-08,05:13:00,21227.5,BUY,3,0.02h,Stop Loss,$-9.00,$-55.50,$107532.50,224,$-55.50
2024-11-08,06:08:00,21244.25,SELL,3,0.02h,Break Even,$-1.50,$-57.00,$107531.00,224,$-57.00
2024-11-08,06:55:00,21232.0,BUY,3,0.02h,Stop Loss,$-9.00,$-66.00,$107522.00,224,$-66.00
2024-11-08,07:10:00,21225.5,SELL,3,0.02h,Stop Loss,$-9.00,$-75.00,$107513.00,224,$-75.00
2024-11-08,07:26:00,21233.5,BUY,3,0.02h,Break Even,$-1.50,$-76.50,$107511.50,224,$-76.50
2024-11-08,08:05:00,21237.0,SELL,3,0.02h,Stop Loss,$30.00,$-46.50,$107541.50,224,$-46.50
2024-11-08,08:21:00,21238.75,BUY,3,0.02h,Stop Loss,$7.50,$-39.00,$107549.00,224,$-39.00
2024-11-08,08:27:00,21227.0,SELL,3,0.02h,Stop Loss,$-9.00,$-48.00,$107540.00,224,$-48.00
2024-11-08,08:35:00,21239.25,BUY,3,0.02h,Stop Loss,$-9.00,$-57.00,$107531.00,224,$-57.00
2024-11-08,08:49:00,21232.75,SELL,3,0.02h,Stop Loss,$-9.00,$-66.00,$107522.00,224,$-66.00
2024-11-08,09:11:00,21237.0,BUY,3,0.02h,Break Even,$-1.50,$-67.50,$107520.50,224,$-67.50
2024-11-08,09:35:00,21237.25,SELL,3,0.02h,Stop Loss,$-9.00,$-76.50,$107511.50,224,$-76.50
2024-11-08,09:40:00,21238.75,BUY,3,0.02h,Break Even,$-1.50,$-78.00,$107510.00,224,$-78.00
2024-11-08,09:47:00,21230.5,SELL,3,0.02h,Stop Loss,$-9.00,$-87.00,$107501.00,224,$-87.00
2024-11-08,11:16:00,21145.5,BUY,3,0.02h,Break Even,$-1.50,$-88.50,$107499.50,224,$-88.50
2024-11-08,12:23:00,21159.25,SELL,3,0.02h,Stop Loss,$-9.00,$-97.50,$107490.50,224,$-97.50
2024-11-08,12:28:00,21168.5,BUY,3,0.02h,Break Even,$-1.50,$-99.00,$107489.00,224,$-99.00
2024-11-08,13:13:00,21174.5,SELL,3,0.02h,Stop Loss,$-9.00,$-108.00,$107480.00,224,$-108.00
2024-11-08,13:24:00,21185.25,BUY,3,0.02h,Stop Loss,$-9.00,$-117.00,$107471.00,224,$-117.00
2024-11-08,13:31:00,21174.75,SELL,3,0.02h,Stop Loss,$4.50,$-112.50,$107475.50,224,$-112.50
2024-11-08,14:10:00,21172.75,BUY,3,0.02h,Stop Loss,$10.50,$-102.00,$107486.00,224,$-102.00
2024-11-08,14:47:00,21194.5,SELL,3,0.02h,Stop Loss,$-9.00,$-111.00,$107477.00,224,$-111.00
2024-11-08,14:48:00,21211.75,BUY,3,0.02h,Stop Loss,$6.00,$-105.00,$107483.00,224,$-105.00
2024-11-08,15:05:00,21190.5,SELL,3,0.02h,Stop Loss,$39.00,$-66.00,$107522.00,224,$-66.00
2024-11-08,15:22:00,21199.75,BUY,3,0.02h,Break Even,$-1.50,$-67.50,$107520.50,224,$-67.50
2024-11-08,15:25:00,21181.5,SELL,3,0.02h,Break Even,$-1.50,$-69.00,$107519.00,224,$-69.00
2024-11-08,15:27:00,21193.25,BUY,3,0.02h,Stop Loss,$6.00,$-63.00,$107525.00,224,$-63.00
2024-11-08,15:39:00,21188.0,SELL,3,0.02h,Stop Loss,$4.50,$-58.50,$107529.50,224,$-58.50
2024-11-08,15:51:00,21193.5,BUY,3,0.02h,Stop Loss,$37.50,$-21.00,$107567.00,224,$-21.00
2024-11-08,16:03:00,21173.25,SELL,3,0.02h,Break Even,$-1.50,$-22.50,$107565.50,224,$-22.50
2024-11-08,16:12:00,21197.25,BUY,3,0.02h,Stop Loss,$22.50,$0.00,$107588.00,224,$0.00
2024-11-08,16:44:00,21197.5,SELL,3,0.02h,Break Even,$-1.50,$-1.50,$107586.50,224,$-1.50
2024-11-08,16:51:00,21221.75,BUY,3,0.02h,Break Even,$-1.50,$-3.00,$107585.00,224,$-3.00
2024-11-08,17:06:00,21207.5,SELL,3,0.02h,Stop Loss,$-9.00,$-12.00,$107576.00,224,$-12.00
2024-11-08,17:33:00,21217.25,BUY,3,0.02h,Break Even,$-1.50,$-13.50,$107574.50,224,$-13.50
2024-11-08,18:54:00,21243.5,SELL,3,0.02h,Stop Loss,$25.50,$12.00,$107600.00,224,$12.00
2024-11-08,19:08:00,21253.75,BUY,3,0.02h,Break Even,$-1.50,$10.50,$107598.50,224,$10.50
2024-11-08,19:21:00,21244.5,SELL,3,0.02h,Stop Loss,$-9.00,$1.50,$107589.50,224,$1.50
2024-11-08,19:26:00,21253.0,BUY,3,0.02h,Break Even,$-1.50,$0.00,$107588.00,224,$0.00
2024-11-08,19:49:00,21248.75,SELL,3,0.02h,Break Even,$-1.50,$-1.50,$107586.50,224,$-1.50
2024-11-08,20:54:00,21223.75,BUY,3,0.02h,Stop Loss,$30.00,$28.50,$107616.50,224,$28.50
2024-11-08,20:57:00,21220.5,SELL,3,0.02h,Stop Loss,$-9.00,$19.50,$107607.50,224,$19.50
2024-11-08,20:58:00,21230.5,BUY,3,0.02h,Break Even,$-1.50,$18.00,$107606.00,224,$18.00
2024-11-08,21:32:00,21228.25,SELL,3,0.02h,Break Even,$-1.50,$16.50,$107604.50,224,$16.50
2024-11-08,21:56:00,21235.5,BUY,3,0.02h,Stop Loss,$-9.00,$7.50,$107595.50,224,$7.50
,,,,,,,,,,,
2024-11-11,00:35:00,21289.0,SELL,3,0.02h,Stop Loss,$3.00,$3.00,$107598.50,225,$3.00
2024-11-11,01:31:00,21274.0,BUY,3,0.02h,Stop Loss,$19.50,$22.50,$107618.00,225,$22.50
2024-11-11,02:02:00,21277.25,SELL,3,0.02h,Stop Loss,$10.50,$33.00,$107628.50,225,$33.00
2024-11-11,02:58:00,21271.0,BUY,3,0.02h,Break Even,$-1.50,$31.50,$107627.00,225,$31.50
2024-11-11,03:05:00,21267.25,SELL,3,0.02h,Break Even,$-1.50,$30.00,$107625.50,225,$30.00
2024-11-11,03:10:00,21269.5,BUY,3,0.02h,Stop Loss,$-9.00,$21.00,$107616.50,225,$21.00
2024-11-11,03:33:00,21268.75,SELL,3,0.02h,Stop Loss,$-9.00,$12.00,$107607.50,225,$12.00
2024-11-11,03:43:00,21272.75,BUY,3,0.13h,Stop Loss,$7.50,$19.50,$107615.00,225,$19.50
2024-11-11,04:40:00,21280.75,SELL,3,0.03h,Stop Loss,$-9.00,$10.50,$107606.00,225,$10.50
2024-11-11,04:53:00,21286.25,BUY,3,0.02h,Break Even,$-1.50,$9.00,$107604.50,225,$9.00
2024-11-11,05:32:00,21290.25,SELL,3,0.02h,Break Even,$-1.50,$7.50,$107603.00,225,$7.50
2024-11-11,06:20:00,21290.75,BUY,3,0.02h,Break Even,$-1.50,$6.00,$107601.50,225,$6.00
2024-11-11,06:22:00,21285.0,SELL,3,0.02h,Stop Loss,$-9.00,$-3.00,$107592.50,225,$-3.00
2024-11-11,06:32:00,21289.75,BUY,3,0.02h,Stop Loss,$-9.00,$-12.00,$107583.50,225,$-12.00
2024-11-11,06:58:00,21287.0,SELL,3,0.02h,Stop Loss,$-9.00,$-21.00,$107574.50,225,$-21.00
2024-11-11,07:17:00,21289.75,BUY,3,0.02h,Stop Loss,$-9.00,$-30.00,$107565.50,225,$-30.00
2024-11-11,08:46:00,21306.75,SELL,3,0.02h,Stop Loss,$-9.00,$-39.00,$107556.50,225,$-39.00
2024-11-11,09:18:00,21300.5,BUY,3,0.02h,Break Even,$-1.50,$-40.50,$107555.00,225,$-40.50
2024-11-11,09:41:00,21296.0,SELL,3,0.02h,Stop Loss,$-9.00,$-49.50,$107546.00,225,$-49.50
2024-11-11,09:52:00,21298.75,BUY,3,0.02h,Stop Loss,$-9.00,$-58.50,$107537.00,225,$-58.50
2024-11-11,09:53:00,21297.25,SELL,3,0.02h,Stop Loss,$-9.00,$-67.50,$107528.00,225,$-67.50
2024-11-11,10:07:00,21297.25,BUY,3,0.02h,Break Even,$-1.50,$-69.00,$107526.50,225,$-69.00
2024-11-11,10:10:00,21290.75,SELL,3,0.02h,Stop Loss,$-9.00,$-78.00,$107517.50,225,$-78.00
2024-11-11,11:14:00,21279.25,BUY,3,0.02h,Break Even,$-1.50,$-79.50,$107516.00,225,$-79.50
2024-11-11,11:20:00,21276.0,SELL,3,0.02h,Break Even,$-1.50,$-81.00,$107514.50,225,$-81.00
2024-11-11,11:21:00,21277.0,BUY,3,0.02h,Break Even,$-1.50,$-82.50,$107513.00,225,$-82.50
2024-11-11,11:48:00,21283.25,SELL,3,0.02h,Break Even,$-1.50,$-84.00,$107511.50,225,$-84.00
2024-11-11,11:57:00,21285.5,BUY,3,0.02h,Stop Loss,$-9.00,$-93.00,$107502.50,225,$-93.00
2024-11-11,13:16:00,21317.75,SELL,3,0.02h,Stop Loss,$4.50,$-88.50,$107507.00,225,$-88.50
2024-11-11,14:06:00,21299.75,BUY,3,0.02h,Break Even,$-1.50,$-90.00,$107505.50,225,$-90.00
2024-11-11,14:12:00,21293.25,SELL,3,0.02h,Stop Loss,$7.50,$-82.50,$107513.00,225,$-82.50
2024-11-11,15:16:00,21197.5,BUY,3,0.02h,Break Even,$-1.50,$-84.00,$107511.50,225,$-84.00
2024-11-11,15:17:00,21183.5,SELL,3,0.02h,Stop Loss,$7.50,$-76.50,$107519.00,225,$-76.50
2024-11-11,15:25:00,21197.0,BUY,3,0.02h,Stop Loss,$10.50,$-66.00,$107529.50,225,$-66.00
2024-11-11,15:49:00,21200.0,SELL,3,0.02h,Stop Loss,$-9.00,$-75.00,$107520.50,225,$-75.00
2024-11-11,15:54:00,21221.5,BUY,3,0.02h,Break Even,$-1.50,$-76.50,$107519.00,225,$-76.50
2024-11-11,16:13:00,21211.0,SELL,3,0.02h,Break Even,$-1.50,$-78.00,$107517.50,225,$-78.00
2024-11-11,16:15:00,21222.5,BUY,3,0.02h,Stop Loss,$-9.00,$-87.00,$107508.50,225,$-87.00
2024-11-11,16:16:00,21217.5,SELL,3,0.02h,Stop Loss,$3.00,$-84.00,$107511.50,225,$-84.00
2024-11-11,16:20:00,21228.75,BUY,3,0.02h,Break Even,$-1.50,$-85.50,$107510.00,225,$-85.50
2024-11-11,16:27:00,21209.75,SELL,3,0.02h,Break Even,$-1.50,$-87.00,$107508.50,225,$-87.00
2024-11-11,17:38:00,21181.0,BUY,3,0.02h,Break Even,$-1.50,$-88.50,$107507.00,225,$-88.50
2024-11-11,17:39:00,21176.75,SELL,3,0.02h,Stop Loss,$25.50,$-63.00,$107532.50,225,$-63.00
2024-11-11,18:30:00,21141.5,BUY,3,0.02h,Stop Loss,$-9.00,$-72.00,$107523.50,225,$-72.00
2024-11-11,19:12:00,21164.0,SELL,3,0.02h,Stop Loss,$-9.00,$-81.00,$107514.50,225,$-81.00
2024-11-11,19:35:00,21177.0,BUY,3,0.02h,Stop Loss,$-9.00,$-90.00,$107505.50,225,$-90.00
2024-11-11,19:48:00,21165.75,SELL,3,0.02h,Stop Loss,$-9.00,$-99.00,$107496.50,225,$-99.00
2024-11-11,19:49:00,21173.0,BUY,3,0.02h,Stop Loss,$3.00,$-96.00,$107499.50,225,$-96.00
2024-11-11,19:53:00,21165.25,SELL,3,0.02h,Break Even,$-1.50,$-97.50,$107498.00,225,$-97.50
2024-11-11,20:00:00,21175.0,BUY,3,0.02h,Stop Loss,$-9.00,$-106.50,$107489.00,225,$-106.50
2024-11-11,20:50:00,21192.5,SELL,3,0.02h,Break Even,$-1.50,$-108.00,$107487.50,225,$-108.00
2024-11-11,20:51:00,21207.0,BUY,3,0.02h,Stop Loss,$3.00,$-105.00,$107490.50,225,$-105.00
2024-11-11,21:33:00,21217.5,SELL,3,0.02h,Stop Loss,$-9.00,$-114.00,$107481.50,225,$-114.00
2024-11-11,21:41:00,21223.25,BUY,3,0.02h,Stop Loss,$-9.00,$-123.00,$107472.50,225,$-123.00
2024-11-11,21:51:00,21220.0,SELL,3,0.02h,Stop Loss,$-9.00,$-132.00,$107463.50,225,$-132.00
2024-11-11,21:52:00,21223.5,BUY,3,0.02h,Stop Loss,$-9.00,$-141.00,$107454.50,225,$-141.00
2024-11-11,21:55:00,21219.25,SELL,3,0.02h,Break Even,$-1.50,$-142.50,$107453.00,225,$-142.50
2024-11-11,23:23:00,21214.0,BUY,3,0.02h,Break Even,$-1.50,$-144.00,$107451.50,225,$-144.00
2024-11-11,23:37:00,21207.0,SELL,3,0.02h,Break Even,$-1.50,$-145.50,$107450.00,225,$-145.50
2024-11-11,23:54:00,21213.5,BUY,3,0.03h,Stop Loss,$-9.00,$-154.50,$107441.00,225,$-154.50
,,,,,,,,,,,
2024-11-12,00:12:00,21211.25,SELL,3,0.02h,Break Even,$-1.50,$-1.50,$107439.50,226,$-1.50
2024-11-12,00:14:00,21218.5,BUY,3,0.02h,Break Even,$-1.50,$-3.00,$107438.00,226,$-3.00
2024-11-12,00:22:00,21209.5,SELL,3,0.02h,Stop Loss,$13.50,$10.50,$107451.50,226,$10.50
2024-11-12,00:54:00,21209.0,BUY,3,0.02h,Stop Loss,$9.00,$19.50,$107460.50,226,$19.50
2024-11-12,01:56:00,21230.25,SELL,3,0.02h,Stop Loss,$-9.00,$10.50,$107451.50,226,$10.50
2024-11-12,02:09:00,21239.25,BUY,3,0.02h,Stop Loss,$-9.00,$1.50,$107442.50,226,$1.50
2024-11-12,02:13:00,21233.5,SELL,3,0.02h,Stop Loss,$-9.00,$-7.50,$107433.50,226,$-7.50
2024-11-12,03:12:00,21211.5,BUY,3,0.02h,Break Even,$-1.50,$-9.00,$107432.00,226,$-9.00
2024-11-12,03:18:00,21207.75,SELL,3,0.02h,Break Even,$-1.50,$-10.50,$107430.50,226,$-10.50
2024-11-12,03:24:00,21216.0,BUY,3,0.02h,Stop Loss,$-9.00,$-19.50,$107421.50,226,$-19.50
2024-11-12,03:49:00,21213.25,SELL,3,0.02h,Break Even,$-1.50,$-21.00,$107420.00,226,$-21.00
2024-11-12,04:21:00,21214.0,BUY,3,0.02h,Stop Loss,$-9.00,$-30.00,$107411.00,226,$-30.00
2024-11-12,05:08:00,21211.5,SELL,3,0.02h,Stop Loss,$-9.00,$-39.00,$107402.00,226,$-39.00
2024-11-12,06:09:00,21200.5,BUY,3,0.02h,Break Even,$-1.50,$-40.50,$107400.50,226,$-40.50
2024-11-12,06:43:00,21204.0,SELL,3,0.02h,Break Even,$-1.50,$-42.00,$107399.00,226,$-42.00
2024-11-12,06:51:00,21207.5,BUY,3,0.02h,Stop Loss,$-9.00,$-51.00,$107390.00,226,$-51.00
2024-11-12,07:25:00,21211.75,SELL,3,0.02h,Stop Loss,$85.50,$34.50,$107475.50,226,$34.50
2024-11-12,07:48:00,21206.5,BUY,3,0.02h,Stop Loss,$18.00,$52.50,$107493.50,226,$52.50
2024-11-12,08:12:00,21203.25,SELL,3,0.02h,Break Even,$-1.50,$51.00,$107492.00,226,$51.00
2024-11-12,08:25:00,21211.25,BUY,3,0.02h,Stop Loss,$-9.00,$42.00,$107483.00,226,$42.00
2024-11-12,08:30:00,21203.5,SELL,3,0.02h,Stop Loss,$-9.00,$33.00,$107474.00,226,$33.00
2024-11-12,08:31:00,21209.0,BUY,3,0.02h,Stop Loss,$-9.00,$24.00,$107465.00,226,$24.00
2024-11-12,08:37:00,21201.75,SELL,3,0.02h,Stop Loss,$-9.00,$15.00,$107456.00,226,$15.00
2024-11-12,08:40:00,21206.75,BUY,3,0.02h,Stop Loss,$51.00,$66.00,$107507.00,226,$66.00
2024-11-12,09:05:00,21214.25,SELL,3,0.02h,Stop Loss,$3.00,$69.00,$107510.00,226,$69.00
2024-11-12,09:26:00,21209.25,BUY,3,0.02h,Stop Loss,$-9.00,$60.00,$107501.00,226,$60.00
2024-11-12,09:40:00,21205.0,SELL,3,0.02h,Stop Loss,$9.00,$69.00,$107510.00,226,$69.00
2024-11-12,10:45:00,21165.0,BUY,3,0.02h,Stop Loss,$-9.00,$60.00,$107501.00,226,$60.00
2024-11-12,11:46:00,21180.25,SELL,3,0.02h,Break Even,$-1.50,$58.50,$107499.50,226,$58.50
2024-11-12,12:02:00,21192.5,BUY,3,0.02h,Stop Loss,$-9.00,$49.50,$107490.50,226,$49.50
2024-11-12,12:23:00,21191.5,SELL,3,0.02h,Stop Loss,$-9.00,$40.50,$107481.50,226,$40.50
2024-11-12,12:24:00,21200.25,BUY,3,0.02h,Stop Loss,$-9.00,$31.50,$107472.50,226,$31.50
2024-11-12,12:28:00,21193.0,SELL,3,0.02h,Break Even,$-1.50,$30.00,$107471.00,226,$30.00
2024-11-12,12:42:00,21204.5,BUY,3,0.02h,Break Even,$-1.50,$28.50,$107469.50,226,$28.50
2024-11-12,12:58:00,21193.0,SELL,3,0.02h,Break Even,$-1.50,$27.00,$107468.00,226,$27.00
2024-11-12,13:14:00,21200.75,BUY,3,0.02h,Stop Loss,$-9.00,$18.00,$107459.00,226,$18.00
2024-11-12,14:04:00,21213.5,SELL,3,0.02h,Break Even,$-1.50,$16.50,$107457.50,226,$16.50
2024-11-12,14:30:00,21214.25,BUY,3,0.02h,Stop Loss,$24.00,$40.50,$107481.50,226,$40.50
2024-11-12,14:31:00,21204.5,SELL,3,0.02h,Stop Loss,$48.00,$88.50,$107529.50,226,$88.50
2024-11-12,14:36:00,21229.25,BUY,3,0.02h,Stop Loss,$51.00,$139.50,$107580.50,226,$139.50
2024-11-12,14:48:00,21212.0,SELL,3,0.02h,Break Even,$-1.50,$138.00,$107579.00,226,$138.00
2024-11-12,14:50:00,21220.5,BUY,3,0.02h,Break Even,$-1.50,$136.50,$107577.50,226,$136.50
2024-11-12,15:05:00,21191.75,SELL,3,0.02h,Break Even,$-1.50,$135.00,$107576.00,226,$135.00
2024-11-12,15:16:00,21219.75,BUY,3,0.02h,Stop Loss,$15.00,$150.00,$107591.00,226,$150.00
2024-11-12,15:19:00,21208.0,SELL,3,0.02h,Stop Loss,$3.00,$153.00,$107594.00,226,$153.00
2024-11-12,15:27:00,21224.0,BUY,3,0.02h,Stop Loss,$12.00,$165.00,$107606.00,226,$165.00
2024-11-12,15:45:00,21204.0,SELL,3,0.02h,Stop Loss,$3.00,$168.00,$107609.00,226,$168.00
2024-11-12,16:54:00,21189.75,BUY,3,0.02h,Stop Loss,$7.50,$175.50,$107616.50,226,$175.50
2024-11-12,17:00:00,21154.5,SELL,3,0.02h,Stop Loss,$34.50,$210.00,$107651.00,226,$210.00
2024-11-12,17:30:00,21159.0,BUY,3,0.02h,Break Even,$-1.50,$208.50,$107649.50,226,$208.50
2024-11-12,17:44:00,21140.5,SELL,3,0.02h,Break Even,$-1.50,$207.00,$107648.00,226,$207.00
2024-11-12,18:16:00,21110.0,BUY,3,0.02h,Stop Loss,$25.50,$232.50,$107673.50,226,$232.50
2024-11-12,19:54:00,21195.75,SELL,3,0.02h,Stop Loss,$12.00,$244.50,$107685.50,226,$244.50
2024-11-12,20:38:00,21190.25,BUY,3,0.02h,Stop Loss,$7.50,$252.00,$107693.00,226,$252.00
2024-11-12,20:53:00,21180.5,SELL,3,0.02h,Stop Loss,$7.50,$259.50,$107700.50,226,$259.50
2024-11-12,21:03:00,21194.25,BUY,3,0.02h,Stop Loss,$-9.00,$250.50,$107691.50,226,$250.50
2024-11-12,21:20:00,21190.5,SELL,3,0.02h,Break Even,$-1.50,$249.00,$107690.00,226,$249.00
2024-11-12,21:26:00,21192.5,BUY,3,0.02h,Break Even,$-1.50,$247.50,$107688.50,226,$247.50
2024-11-12,21:38:00,21189.75,SELL,3,0.02h,Break Even,$-1.50,$246.00,$107687.00,226,$246.00
2024-11-12,23:50:00,21155.75,BUY,3,0.02h,Break Even,$-1.50,$244.50,$107685.50,226,$244.50
,,,,,,,,,,,
2024-11-13,00:06:00,21152.75,SELL,3,0.02h,Stop Loss,$3.00,$3.00,$107688.50,227,$3.00
2024-11-13,00:35:00,21149.25,BUY,3,0.02h,Stop Loss,$-9.00,$-6.00,$107679.50,227,$-6.00
2024-11-13,00:37:00,21145.0,SELL,3,0.02h,Stop Loss,$-9.00,$-15.00,$107670.50,227,$-15.00
2024-11-13,00:45:00,21146.75,BUY,3,0.02h,Break Even,$-1.50,$-16.50,$107669.00,227,$-16.50
2024-11-13,00:59:00,21144.25,SELL,3,0.02h,Stop Loss,$-9.00,$-25.50,$107660.00,227,$-25.50
2024-11-13,01:16:00,21149.5,BUY,3,0.02h,Stop Loss,$9.00,$-16.50,$107669.00,227,$-16.50
2024-11-13,01:40:00,21150.25,SELL,3,0.02h,Break Even,$-1.50,$-18.00,$107667.50,227,$-18.00
2024-11-13,02:06:00,21147.25,BUY,3,0.02h,Stop Loss,$-9.00,$-27.00,$107658.50,227,$-27.00
2024-11-13,02:23:00,21142.5,SELL,3,0.02h,Stop Loss,$-9.00,$-36.00,$107649.50,227,$-36.00
2024-11-13,02:49:00,21142.5,BUY,3,0.02h,Break Even,$-1.50,$-37.50,$107648.00,227,$-37.50
2024-11-13,03:37:00,21152.75,SELL,3,0.02h,Break Even,$-1.50,$-39.00,$107646.50,227,$-39.00
2024-11-13,04:27:00,21143.25,BUY,3,0.02h,Break Even,$-1.50,$-40.50,$107645.00,227,$-40.50
2024-11-13,04:39:00,21142.75,SELL,3,0.02h,Break Even,$-1.50,$-42.00,$107643.50,227,$-42.00
2024-11-13,06:03:00,21126.75,BUY,3,0.03h,Break Even,$-1.50,$-43.50,$107642.00,227,$-43.50
2024-11-13,06:13:00,21115.0,SELL,3,0.02h,Break Even,$-1.50,$-45.00,$107640.50,227,$-45.00
2024-11-13,06:49:00,21113.0,BUY,3,0.02h,Break Even,$-1.50,$-46.50,$107639.00,227,$-46.50
2024-11-13,07:14:00,21115.75,SELL,3,0.03h,Stop Loss,$-9.00,$-55.50,$107630.00,227,$-55.50
2024-11-13,07:16:00,21122.75,BUY,3,0.02h,Stop Loss,$-9.00,$-64.50,$107621.00,227,$-64.50
2024-11-13,07:55:00,21130.5,SELL,3,0.02h,Break Even,$-1.50,$-66.00,$107619.50,227,$-66.00
2024-11-13,08:12:00,21136.5,BUY,3,0.02h,Break Even,$-1.50,$-67.50,$107618.00,227,$-67.50
2024-11-13,09:20:00,21167.25,SELL,3,0.02h,Stop Loss,$4.50,$-63.00,$107622.50,227,$-63.00
2024-11-13,09:33:00,21173.5,BUY,3,0.02h,Stop Loss,$-9.00,$-72.00,$107613.50,227,$-72.00
2024-11-13,09:39:00,21169.75,SELL,3,0.02h,Stop Loss,$-9.00,$-81.00,$107604.50,227,$-81.00
2024-11-13,09:44:00,21174.0,BUY,3,0.02h,Break Even,$-1.50,$-82.50,$107603.00,227,$-82.50
2024-11-13,10:03:00,21170.5,SELL,3,0.02h,Stop Loss,$-9.00,$-91.50,$107594.00,227,$-91.50
2024-11-13,10:57:00,21157.25,BUY,3,0.02h,Stop Loss,$-9.00,$-100.50,$107585.00,227,$-100.50
2024-11-13,10:58:00,21154.25,SELL,3,0.02h,Break Even,$-1.50,$-102.00,$107583.50,227,$-102.00
2024-11-13,11:23:00,21149.0,BUY,3,0.03h,Stop Loss,$-9.00,$-111.00,$107574.50,227,$-111.00
2024-11-13,11:26:00,21143.5,SELL,3,0.02h,Stop Loss,$-9.00,$-120.00,$107565.50,227,$-120.00
2024-11-13,12:06:00,21140.25,BUY,3,0.02h,Break Even,$-1.50,$-121.50,$107564.00,227,$-121.50
2024-11-13,12:10:00,21127.75,SELL,3,0.02h,Stop Loss,$-9.00,$-130.50,$107555.00,227,$-130.50
2024-11-13,12:17:00,21137.25,BUY,3,0.02h,Stop Loss,$-9.00,$-139.50,$107546.00,227,$-139.50
2024-11-13,12:39:00,21134.75,SELL,3,0.02h,Break Even,$-1.50,$-141.00,$107544.50,227,$-141.00
2024-11-13,13:11:00,21133.75,BUY,3,0.02h,Break Even,$-1.50,$-142.50,$107543.00,227,$-142.50
2024-11-13,13:56:00,21180.5,SELL,3,0.02h,Stop Loss,$28.50,$-114.00,$107571.50,227,$-114.00
2024-11-13,14:23:00,21188.5,BUY,3,0.02h,Stop Loss,$-9.00,$-123.00,$107562.50,227,$-123.00
2024-11-13,14:28:00,21173.5,SELL,3,0.02h,Stop Loss,$67.50,$-55.50,$107630.00,227,$-55.50
2024-11-13,15:33:00,21123.75,BUY,3,0.02h,Stop Loss,$37.50,$-18.00,$107667.50,227,$-18.00
2024-11-13,15:52:00,21101.75,SELL,3,0.02h,Stop Loss,$4.50,$-13.50,$107672.00,227,$-13.50
2024-11-13,15:56:00,21126.0,BUY,3,0.02h,Break Even,$-1.50,$-15.00,$107670.50,227,$-15.00
2024-11-13,16:04:00,21109.75,SELL,3,0.02h,Break Even,$-1.50,$-16.50,$107669.00,227,$-16.50
2024-11-13,16:11:00,21117.25,BUY,3,0.02h,Stop Loss,$37.50,$21.00,$107706.50,227,$21.00
2024-11-13,16:42:00,21125.5,SELL,3,0.02h,Stop Loss,$111.00,$132.00,$107817.50,227,$132.00
2024-11-13,16:49:00,21153.25,BUY,3,0.02h,Stop Loss,$24.00,$156.00,$107841.50,227,$156.00
2024-11-13,17:45:00,21173.0,SELL,3,0.02h,Stop Loss,$-9.00,$147.00,$107832.50,227,$147.00
2024-11-13,17:48:00,21202.5,BUY,3,0.02h,Stop Loss,$15.00,$162.00,$107847.50,227,$162.00
2024-11-13,18:18:00,21213.5,SELL,3,0.02h,Stop Loss,$7.50,$169.50,$107855.00,227,$169.50
2024-11-13,18:24:00,21229.5,BUY,3,0.02h,Break Even,$-1.50,$168.00,$107853.50,227,$168.00
2024-11-13,19:06:00,21231.5,SELL,3,0.02h,Break Even,$-1.50,$166.50,$107852.00,227,$166.50
2024-11-13,20:15:00,21189.0,BUY,3,0.02h,Stop Loss,$25.50,$192.00,$107877.50,227,$192.00
2024-11-13,20:29:00,21180.25,SELL,3,0.02h,Break Even,$-1.50,$190.50,$107876.00,227,$190.50
2024-11-13,20:35:00,21202.5,BUY,3,0.02h,Stop Loss,$84.00,$274.50,$107960.00,227,$274.50
2024-11-13,20:50:00,21192.5,SELL,3,0.02h,Stop Loss,$135.00,$409.50,$108095.00,227,$409.50
2024-11-13,21:13:00,21169.25,BUY,3,0.02h,Stop Loss,$15.00,$424.50,$108110.00,227,$424.50
2024-11-13,21:49:00,21168.75,SELL,3,0.02h,Break Even,$-1.50,$423.00,$108108.50,227,$423.00
2024-11-13,23:25:00,21164.0,BUY,3,0.02h,Break Even,$-1.50,$421.50,$108107.00,227,$421.50
2024-11-13,23:59:00,21165.25,SELL,3,0.02h,Stop Loss,$-9.00,$412.50,$108098.00,227,$412.50
,,,,,,,,,,,
2024-11-14,00:01:00,21171.0,BUY,3,0.02h,Break Even,$-1.50,$-1.50,$108096.50,228,$-1.50
2024-11-14,00:08:00,21162.75,SELL,3,0.02h,Stop Loss,$24.00,$22.50,$108120.50,228,$22.50
2024-11-14,00:41:00,21156.75,BUY,3,0.02h,Stop Loss,$-9.00,$13.50,$108111.50,228,$13.50
2024-11-14,00:56:00,21151.75,SELL,3,0.02h,Stop Loss,$-9.00,$4.50,$108102.50,228,$4.50
2024-11-14,01:39:00,21139.75,BUY,3,0.02h,Stop Loss,$-9.00,$-4.50,$108093.50,228,$-4.50
2024-11-14,02:00:00,21134.0,SELL,3,0.02h,Stop Loss,$19.50,$15.00,$108113.00,228,$15.00
2024-11-14,02:32:00,21133.0,BUY,3,0.02h,Break Even,$-1.50,$13.50,$108111.50,228,$13.50
2024-11-14,02:44:00,21127.0,SELL,3,0.02h,Stop Loss,$-9.00,$4.50,$108102.50,228,$4.50
2024-11-14,03:07:00,21128.0,BUY,3,0.02h,Break Even,$-1.50,$3.00,$108101.00,228,$3.00
2024-11-14,03:33:00,21128.25,SELL,3,0.02h,Break Even,$-1.50,$1.50,$108099.50,228,$1.50
2024-11-14,03:53:00,21129.0,BUY,3,0.02h,Stop Loss,$-9.00,$-7.50,$108090.50,228,$-7.50
2024-11-14,04:02:00,21125.25,SELL,3,0.02h,Stop Loss,$-9.00,$-16.50,$108081.50,228,$-16.50
2024-11-14,04:04:00,21127.75,BUY,3,0.02h,Break Even,$-1.50,$-18.00,$108080.00,228,$-18.00
2024-11-14,04:43:00,21143.0,SELL,3,0.03h,Stop Loss,$-9.00,$-27.00,$108071.00,228,$-27.00
2024-11-14,05:41:00,21121.0,BUY,3,0.03h,Stop Loss,$-9.00,$-36.00,$108062.00,228,$-36.00
2024-11-14,05:44:00,21116.0,SELL,3,0.02h,Break Even,$-1.50,$-37.50,$108060.50,228,$-37.50
2024-11-14,06:00:00,21121.5,BUY,3,0.02h,Break Even,$-1.50,$-39.00,$108059.00,228,$-39.00
2024-11-14,06:12:00,21117.0,SELL,3,0.02h,Stop Loss,$-9.00,$-48.00,$108050.00,228,$-48.00
2024-11-14,06:17:00,21122.0,BUY,3,0.02h,Break Even,$-1.50,$-49.50,$108048.50,228,$-49.50
2024-11-14,06:22:00,21112.75,SELL,3,0.02h,Stop Loss,$12.00,$-37.50,$108060.50,228,$-37.50
2024-11-14,06:41:00,21118.0,BUY,3,0.02h,Stop Loss,$-9.00,$-46.50,$108051.50,228,$-46.50
2024-11-14,06:49:00,21110.25,SELL,3,0.02h,Break Even,$-1.50,$-48.00,$108050.00,228,$-48.00
2024-11-14,07:24:00,21103.0,BUY,3,0.02h,Stop Loss,$-9.00,$-57.00,$108041.00,228,$-57.00
2024-11-14,08:50:00,21153.25,SELL,3,0.02h,Stop Loss,$-9.00,$-66.00,$108032.00,228,$-66.00
2024-11-14,09:00:00,21166.0,BUY,3,0.02h,Stop Loss,$33.00,$-33.00,$108065.00,228,$-33.00
2024-11-14,09:18:00,21162.25,SELL,3,0.02h,Break Even,$-1.50,$-34.50,$108063.50,228,$-34.50
2024-11-14,09:40:00,21173.0,BUY,3,0.02h,Stop Loss,$-9.00,$-43.50,$108054.50,228,$-43.50
2024-11-14,09:43:00,21166.75,SELL,3,0.02h,Stop Loss,$-9.00,$-52.50,$108045.50,228,$-52.50
2024-11-14,09:47:00,21171.75,BUY,3,0.02h,Stop Loss,$-9.00,$-61.50,$108036.50,228,$-61.50
2024-11-14,09:48:00,21165.0,SELL,3,0.02h,Stop Loss,$9.00,$-52.50,$108045.50,228,$-52.50
2024-11-14,10:15:00,21163.75,BUY,3,0.02h,Stop Loss,$-9.00,$-61.50,$108036.50,228,$-61.50
2024-11-14,10:44:00,21165.5,SELL,3,0.02h,Break Even,$-1.50,$-63.00,$108035.00,228,$-63.00
2024-11-14,11:05:00,21167.25,BUY,3,0.02h,Break Even,$-1.50,$-64.50,$108033.50,228,$-64.50
2024-11-14,11:14:00,21159.75,SELL,3,0.02h,Stop Loss,$-9.00,$-73.50,$108024.50,228,$-73.50
2024-11-14,11:17:00,21170.0,BUY,3,0.02h,Break Even,$-1.50,$-75.00,$108023.00,228,$-75.00
2024-11-14,11:36:00,21167.5,SELL,3,0.02h,Break Even,$-1.50,$-76.50,$108021.50,228,$-76.50
2024-11-14,11:44:00,21173.5,BUY,3,0.02h,Stop Loss,$-9.00,$-85.50,$108012.50,228,$-85.50
2024-11-14,12:06:00,21171.0,SELL,3,0.02h,Break Even,$-1.50,$-87.00,$108011.00,228,$-87.00
2024-11-14,12:34:00,21175.0,BUY,3,0.02h,Break Even,$-1.50,$-88.50,$108009.50,228,$-88.50
2024-11-14,12:49:00,21164.75,SELL,3,0.02h,Break Even,$-1.50,$-90.00,$108008.00,228,$-90.00
2024-11-14,13:15:00,21169.5,BUY,3,0.02h,Break Even,$-1.50,$-91.50,$108006.50,228,$-91.50
2024-11-14,13:32:00,21135.0,SELL,3,0.02h,Stop Loss,$-9.00,$-100.50,$107997.50,228,$-100.50
2024-11-14,14:14:00,21139.75,BUY,3,0.02h,Break Even,$-1.50,$-102.00,$107996.00,228,$-102.00
2024-11-14,14:19:00,21133.25,SELL,3,0.02h,Break Even,$-1.50,$-103.50,$107994.50,228,$-103.50
2024-11-14,14:31:00,21161.0,BUY,3,0.02h,Stop Loss,$7.50,$-96.00,$108002.00,228,$-96.00
2024-11-14,14:42:00,21098.75,SELL,3,0.02h,Break Even,$-1.50,$-97.50,$108000.50,228,$-97.50
2024-11-14,15:15:00,21107.0,BUY,3,0.02h,Break Even,$-1.50,$-99.00,$107999.00,228,$-99.00
2024-11-14,15:18:00,21091.5,SELL,3,0.02h,Stop Loss,$130.50,$31.50,$108129.50,228,$31.50
2024-11-14,15:31:00,21097.0,BUY,3,0.02h,Break Even,$-1.50,$30.00,$108128.00,228,$30.00
2024-11-14,15:59:00,21094.5,SELL,3,0.02h,Stop Loss,$54.00,$84.00,$108182.00,228,$84.00
2024-11-14,16:25:00,21112.5,BUY,3,0.02h,Stop Loss,$12.00,$96.00,$108194.00,228,$96.00
2024-11-14,16:54:00,21110.5,SELL,3,0.02h,Stop Loss,$28.50,$124.50,$108222.50,228,$124.50
2024-11-14,17:42:00,21074.25,BUY,3,0.02h,Break Even,$-1.50,$123.00,$108221.00,228,$123.00
2024-11-14,17:49:00,21054.5,SELL,3,0.02h,Stop Loss,$198.00,$321.00,$108419.00,228,$321.00
2024-11-14,17:56:00,21077.5,BUY,3,0.02h,Stop Loss,$3.00,$324.00,$108422.00,228,$324.00
2024-11-14,18:33:00,21089.5,SELL,3,0.02h,Stop Loss,$21.00,$345.00,$108443.00,228,$345.00
2024-11-14,19:06:00,21078.75,BUY,3,0.02h,Stop Loss,$15.00,$360.00,$108458.00,228,$360.00
2024-11-14,19:14:00,21055.75,SELL,3,0.02h,Stop Loss,$13.50,$373.50,$108471.50,228,$373.50
2024-11-14,19:30:00,21066.0,BUY,3,0.02h,Break Even,$-1.50,$372.00,$108470.00,228,$372.00
2024-11-14,19:48:00,21057.25,SELL,3,0.02h,Stop Loss,$16.50,$388.50,$108486.50,228,$388.50
2024-11-14,19:53:00,21077.25,BUY,3,0.02h,Stop Loss,$58.50,$447.00,$108545.00,228,$447.00
2024-11-14,20:01:00,21042.25,SELL,3,0.02h,Stop Loss,$28.50,$475.50,$108573.50,228,$475.50
2024-11-14,20:29:00,21032.25,BUY,3,0.02h,Stop Loss,$24.00,$499.50,$108597.50,228,$499.50
2024-11-14,20:31:00,21016.0,SELL,3,0.02h,Stop Loss,$42.00,$541.50,$108639.50,228,$541.50
2024-11-14,21:00:00,21008.75,BUY,3,0.02h,Stop Loss,$3.00,$544.50,$108642.50,228,$544.50
2024-11-14,21:05:00,20994.75,SELL,3,0.02h,Break Even,$-1.50,$543.00,$108641.00,228,$543.00
2024-11-14,21:36:00,20982.0,BUY,3,0.02h,Stop Loss,$-9.00,$534.00,$108632.00,228,$534.00
2024-11-14,23:01:00,20964.5,SELL,3,0.02h,Stop Loss,$30.00,$564.00,$108662.00,228,$564.00
2024-11-14,23:35:00,20958.0,BUY,3,0.02h,Break Even,$-1.50,$562.50,$108660.50,228,$562.50
2024-11-14,23:48:00,20947.75,SELL,3,0.02h,Stop Loss,$-9.00,$553.50,$108651.50,228,$553.50
,,,,,,,,,,,
2024-11-15,00:04:00,20953.25,BUY,3,0.02h,Break Even,$-1.50,$-1.50,$108650.00,229,$-1.50
2024-11-15,00:10:00,20948.75,SELL,3,0.02h,Stop Loss,$-9.00,$-10.50,$108641.00,229,$-10.50
2024-11-15,00:11:00,20954.5,BUY,3,0.02h,Stop Loss,$-9.00,$-19.50,$108632.00,229,$-19.50
2024-11-15,00:22:00,20943.25,SELL,3,0.02h,Stop Loss,$-9.00,$-28.50,$108623.00,229,$-28.50
2024-11-15,01:58:00,20896.5,BUY,3,0.02h,Break Even,$-1.50,$-30.00,$108621.50,229,$-30.00
2024-11-15,01:59:00,20893.0,SELL,3,0.02h,Stop Loss,$13.50,$-16.50,$108635.00,229,$-16.50
2024-11-15,02:10:00,20895.5,BUY,3,0.02h,Stop Loss,$3.00,$-13.50,$108638.00,229,$-13.50
2024-11-15,03:03:00,20905.75,SELL,3,0.02h,Stop Loss,$-9.00,$-22.50,$108629.00,229,$-22.50
2024-11-15,03:07:00,20914.5,BUY,3,0.02h,Stop Loss,$-9.00,$-31.50,$108620.00,229,$-31.50
2024-11-15,03:09:00,20909.25,SELL,3,0.02h,Stop Loss,$-9.00,$-40.50,$108611.00,229,$-40.50
2024-11-15,03:10:00,20912.0,BUY,3,0.02h,Stop Loss,$3.00,$-37.50,$108614.00,229,$-37.50
2024-11-15,03:46:00,20914.75,SELL,3,0.02h,Break Even,$-1.50,$-39.00,$108612.50,229,$-39.00
2024-11-15,04:24:00,20904.5,BUY,3,0.02h,Break Even,$-1.50,$-40.50,$108611.00,229,$-40.50
2024-11-15,04:48:00,20904.5,SELL,3,0.02h,Stop Loss,$-9.00,$-49.50,$108602.00,229,$-49.50
2024-11-15,04:49:00,20907.0,BUY,3,0.02h,Stop Loss,$-9.00,$-58.50,$108593.00,229,$-58.50
2024-11-15,04:50:00,20905.0,SELL,3,0.03h,Break Even,$-1.50,$-60.00,$108591.50,229,$-60.00
2024-11-15,04:53:00,20907.25,BUY,3,0.02h,Break Even,$-1.50,$-61.50,$108590.00,229,$-61.50
2024-11-15,05:32:00,20919.0,SELL,3,0.02h,Break Even,$-1.50,$-63.00,$108588.50,229,$-63.00
2024-11-15,06:41:00,20857.0,BUY,3,0.02h,Break Even,$-1.50,$-64.50,$108587.00,229,$-64.50
2024-11-15,07:13:00,20864.25,SELL,3,0.02h,Break Even,$-1.50,$-66.00,$108585.50,229,$-66.00
2024-11-15,07:16:00,20869.5,BUY,3,0.02h,Break Even,$-1.50,$-67.50,$108584.00,229,$-67.50
2024-11-15,07:23:00,20855.25,SELL,3,0.02h,Break Even,$-1.50,$-69.00,$108582.50,229,$-69.00
2024-11-15,08:40:00,20817.75,BUY,3,0.02h,Stop Loss,$25.50,$-43.50,$108608.00,229,$-43.50
2024-11-15,09:09:00,20824.25,SELL,3,0.02h,Break Even,$-1.50,$-45.00,$108606.50,229,$-45.00
2024-11-15,09:27:00,20829.25,BUY,3,0.02h,Stop Loss,$-9.00,$-54.00,$108597.50,229,$-54.00
2024-11-15,09:31:00,20817.25,SELL,3,0.02h,Break Even,$-1.50,$-55.50,$108596.00,229,$-55.50
2024-11-15,09:37:00,20831.25,BUY,3,0.02h,Break Even,$-1.50,$-57.00,$108594.50,229,$-57.00
2024-11-15,09:49:00,20821.0,SELL,3,0.02h,Break Even,$-1.50,$-58.50,$108593.00,229,$-58.50
2024-11-15,10:04:00,20827.5,BUY,3,0.02h,Stop Loss,$-9.00,$-67.50,$108584.00,229,$-67.50
2024-11-15,10:15:00,20816.75,SELL,3,0.02h,Stop Loss,$-9.00,$-76.50,$108575.00,229,$-76.50
2024-11-15,10:26:00,20822.5,BUY,3,0.02h,Break Even,$-1.50,$-78.00,$108573.50,229,$-78.00
2024-11-15,10:41:00,20820.0,SELL,3,0.02h,Break Even,$-1.50,$-79.50,$108572.00,229,$-79.50
2024-11-15,10:47:00,20825.0,BUY,3,0.02h,Stop Loss,$-9.00,$-88.50,$108563.00,229,$-88.50
2024-11-15,11:43:00,20846.5,SELL,3,0.02h,Stop Loss,$12.00,$-76.50,$108575.00,229,$-76.50
2024-11-15,12:05:00,20848.75,BUY,3,0.02h,Stop Loss,$9.00,$-67.50,$108584.00,229,$-67.50
2024-11-15,12:21:00,20848.75,SELL,3,0.02h,Stop Loss,$-9.00,$-76.50,$108575.00,229,$-76.50
2024-11-15,12:40:00,20850.0,BUY,3,0.02h,Stop Loss,$4.50,$-72.00,$108579.50,229,$-72.00
2024-11-15,13:08:00,20851.75,SELL,3,0.02h,Stop Loss,$3.00,$-69.00,$108582.50,229,$-69.00
2024-11-15,16:19:00,20566.75,BUY,3,0.02h,Stop Loss,$25.50,$-43.50,$108608.00,229,$-43.50
2024-11-15,16:38:00,20550.5,SELL,3,0.02h,Stop Loss,$22.50,$-21.00,$108630.50,229,$-21.00
2024-11-15,17:45:00,20502.75,BUY,3,0.02h,Stop Loss,$34.50,$13.50,$108665.00,229,$13.50
2024-11-15,17:51:00,20467.25,SELL,3,0.02h,Stop Loss,$-9.00,$4.50,$108656.00,229,$4.50
2024-11-15,19:08:00,20440.25,BUY,3,0.02h,Stop Loss,$70.50,$75.00,$108726.50,229,$75.00
2024-11-15,19:21:00,20434.75,SELL,3,0.02h,Stop Loss,$3.00,$78.00,$108729.50,229,$78.00
2024-11-15,19:41:00,20444.5,BUY,3,0.02h,Stop Loss,$30.00,$108.00,$108759.50,229,$108.00
2024-11-15,20:42:00,20468.75,SELL,3,0.02h,Stop Loss,$21.00,$129.00,$108780.50,229,$129.00
2024-11-15,20:55:00,20500.75,BUY,3,0.02h,Stop Loss,$57.00,$186.00,$108837.50,229,$186.00
2024-11-15,21:24:00,20497.25,SELL,3,0.02h,Break Even,$-1.50,$184.50,$108836.00,229,$184.50
2024-11-15,21:41:00,20499.0,BUY,3,0.02h,Stop Loss,$-9.00,$175.50,$108827.00,229,$175.50
2024-11-15,21:46:00,20495.5,SELL,3,0.02h,Stop Loss,$-9.00,$166.50,$108818.00,229,$166.50
2024-11-15,21:47:00,20498.0,BUY,3,0.02h,Stop Loss,$3.00,$169.50,$108821.00,229,$169.50
,,,,,,,,,,,
2024-11-18,01:15:00,20612.5,SELL,3,0.02h,Break Even,$-1.50,$-1.50,$108819.50,230,$-1.50
2024-11-18,01:17:00,20620.0,BUY,3,0.02h,Break Even,$-1.50,$-3.00,$108818.00,230,$-3.00
2024-11-18,01:42:00,20621.0,SELL,3,0.02h,Stop Loss,$-9.00,$-12.00,$108809.00,230,$-12.00
2024-11-18,02:13:00,20615.0,BUY,3,0.02h,Break Even,$-1.50,$-13.50,$108807.50,230,$-13.50
2024-11-18,03:19:00,20626.5,SELL,3,0.02h,Break Even,$-1.50,$-15.00,$108806.00,230,$-15.00
2024-11-18,03:36:00,20632.0,BUY,3,0.02h,Stop Loss,$-9.00,$-24.00,$108797.00,230,$-24.00
2024-11-18,03:44:00,20622.5,SELL,3,0.02h,Break Even,$-1.50,$-25.50,$108795.50,230,$-25.50
2024-11-18,03:54:00,20628.0,BUY,3,0.02h,Stop Loss,$-9.00,$-34.50,$108786.50,230,$-34.50
2024-11-18,05:12:00,20646.25,SELL,3,0.02h,Break Even,$-1.50,$-36.00,$108785.00,230,$-36.00
2024-11-18,05:59:00,20640.0,BUY,3,0.03h,Stop Loss,$-9.00,$-45.00,$108776.00,230,$-45.00
2024-11-18,06:02:00,20634.5,SELL,3,0.02h,Break Even,$-1.50,$-46.50,$108774.50,230,$-46.50
2024-11-18,06:17:00,20636.75,BUY,3,0.03h,Stop Loss,$-9.00,$-55.50,$108765.50,230,$-55.50
2024-11-18,07:04:00,20641.0,SELL,3,0.02h,Break Even,$-1.50,$-57.00,$108764.00,230,$-57.00
2024-11-18,08:15:00,20603.5,BUY,3,0.02h,Stop Loss,$28.50,$-28.50,$108792.50,230,$-28.50
2024-11-18,09:02:00,20616.25,SELL,3,0.02h,Stop Loss,$28.50,$0.00,$108821.00,230,$0.00
2024-11-18,10:07:00,20568.0,BUY,3,0.02h,Break Even,$-1.50,$-1.50,$108819.50,230,$-1.50
2024-11-18,10:15:00,20556.5,SELL,3,0.02h,Stop Loss,$-9.00,$-10.50,$108810.50,230,$-10.50
2024-11-18,10:22:00,20569.0,BUY,3,0.02h,Break Even,$-1.50,$-12.00,$108809.00,230,$-12.00
2024-11-18,11:15:00,20580.0,SELL,3,0.02h,Stop Loss,$12.00,$0.00,$108821.00,230,$0.00
2024-11-18,11:56:00,20569.5,BUY,3,0.02h,Break Even,$-1.50,$-1.50,$108819.50,230,$-1.50
2024-11-18,12:13:00,20556.5,SELL,3,0.02h,Break Even,$-1.50,$-3.00,$108818.00,230,$-3.00
2024-11-18,12:39:00,20571.5,BUY,3,0.02h,Stop Loss,$12.00,$9.00,$108830.00,230,$9.00
2024-11-18,12:53:00,20564.25,SELL,3,0.02h,Break Even,$-1.50,$7.50,$108828.50,230,$7.50
2024-11-18,13:36:00,20531.25,BUY,3,0.02h,Stop Loss,$9.00,$16.50,$108837.50,230,$16.50
2024-11-18,14:30:00,20557.25,SELL,3,0.02h,Stop Loss,$123.00,$139.50,$108960.50,230,$139.50
2024-11-18,15:03:00,20565.75,BUY,3,0.02h,Break Even,$-1.50,$138.00,$108959.00,230,$138.00
2024-11-18,16:49:00,20684.0,SELL,3,0.02h,Stop Loss,$46.50,$184.50,$109005.50,230,$184.50
2024-11-18,17:28:00,20663.25,BUY,3,0.02h,Stop Loss,$-9.00,$175.50,$108996.50,230,$175.50
2024-11-18,17:31:00,20651.0,SELL,3,0.02h,Break Even,$-1.50,$174.00,$108995.00,230,$174.00
2024-11-18,17:59:00,20656.75,BUY,3,0.02h,Stop Loss,$12.00,$186.00,$109007.00,230,$186.00
2024-11-18,18:27:00,20653.25,SELL,3,0.02h,Break Even,$-1.50,$184.50,$109005.50,230,$184.50
2024-11-18,18:58:00,20646.25,BUY,3,0.02h,Stop Loss,$31.50,$216.00,$109037.00,230,$216.00
2024-11-18,19:11:00,20628.75,SELL,3,0.02h,Stop Loss,$7.50,$223.50,$109044.50,230,$223.50
2024-11-18,19:42:00,20616.75,BUY,3,0.02h,Stop Loss,$9.00,$232.50,$109053.50,230,$232.50
2024-11-18,20:34:00,20632.5,SELL,3,0.02h,Break Even,$-1.50,$231.00,$109052.00,230,$231.00
2024-11-18,20:50:00,20645.25,BUY,3,0.02h,Stop Loss,$-9.00,$222.00,$109043.00,230,$222.00
2024-11-18,20:51:00,20630.5,SELL,3,0.02h,Stop Loss,$4.50,$226.50,$109047.50,230,$226.50
2024-11-18,21:03:00,20645.5,BUY,3,0.02h,Break Even,$-1.50,$225.00,$109046.00,230,$225.00
2024-11-18,21:10:00,20626.25,SELL,3,0.02h,Break Even,$-1.50,$223.50,$109044.50,230,$223.50
2024-11-18,21:44:00,20632.75,BUY,3,0.02h,Stop Loss,$-9.00,$214.50,$109035.50,230,$214.50
2024-11-18,23:01:00,20620.25,SELL,3,0.02h,Break Even,$-1.50,$213.00,$109034.00,230,$213.00
2024-11-18,23:26:00,20619.0,BUY,3,0.02h,Break Even,$-1.50,$211.50,$109032.50,230,$211.50
2024-11-18,23:50:00,20618.75,SELL,3,0.02h,Stop Loss,$-9.00,$202.50,$109023.50,230,$202.50
2024-11-18,23:51:00,20620.5,BUY,3,0.02h,Break Even,$-1.50,$201.00,$109022.00,230,$201.00
,,,,,,,,,,,
2024-11-19,00:35:00,20629.5,SELL,3,0.02h,Stop Loss,$-9.00,$-9.00,$109013.00,231,$-9.00
2024-11-19,01:31:00,20618.75,BUY,3,0.02h,Stop Loss,$-9.00,$-18.00,$109004.00,231,$-18.00
2024-11-19,01:32:00,20613.0,SELL,3,0.02h,Stop Loss,$4.50,$-13.50,$109008.50,231,$-13.50
2024-11-19,01:39:00,20617.75,BUY,3,0.02h,Stop Loss,$-9.00,$-22.50,$108999.50,231,$-22.50
2024-11-19,01:42:00,20615.5,SELL,3,0.02h,Stop Loss,$-9.00,$-31.50,$108990.50,231,$-31.50
2024-11-19,01:43:00,20617.75,BUY,3,0.02h,Break Even,$-1.50,$-33.00,$108989.00,231,$-33.00
2024-11-19,03:49:00,20675.25,SELL,3,0.02h,Stop Loss,$-9.00,$-42.00,$108980.00,231,$-42.00
2024-11-19,03:52:00,20681.75,BUY,3,0.02h,Break Even,$-1.50,$-43.50,$108978.50,231,$-43.50
2024-11-19,03:55:00,20676.5,SELL,3,0.02h,Stop Loss,$-9.00,$-52.50,$108969.50,231,$-52.50
2024-11-19,03:56:00,20678.5,BUY,3,0.02h,Stop Loss,$-9.00,$-61.50,$108960.50,231,$-61.50
2024-11-19,04:39:00,20685.5,SELL,3,0.02h,Stop Loss,$-9.00,$-70.50,$108951.50,231,$-70.50
2024-11-19,06:00:00,20669.5,BUY,3,0.02h,Break Even,$-1.50,$-72.00,$108950.00,231,$-72.00
2024-11-19,06:15:00,20665.25,SELL,3,0.02h,Stop Loss,$-9.00,$-81.00,$108941.00,231,$-81.00
2024-11-19,06:19:00,20672.75,BUY,3,0.02h,Break Even,$-1.50,$-82.50,$108939.50,231,$-82.50
2024-11-19,07:00:00,20677.0,SELL,3,0.02h,Stop Loss,$18.00,$-64.50,$108957.50,231,$-64.50
2024-11-19,07:25:00,20669.75,BUY,3,0.02h,Stop Loss,$-9.00,$-73.50,$108948.50,231,$-73.50
2024-11-19,08:11:00,20674.0,SELL,3,0.02h,Stop Loss,$7.50,$-66.00,$108956.00,231,$-66.00
2024-11-19,08:57:00,20620.25,BUY,3,0.02h,Stop Loss,$22.50,$-43.50,$108978.50,231,$-43.50
2024-11-19,09:17:00,20621.0,SELL,3,0.02h,Stop Loss,$73.50,$30.00,$109052.00,231,$30.00
2024-11-19,09:55:00,20552.0,BUY,3,0.02h,Stop Loss,$16.50,$46.50,$109068.50,231,$46.50
2024-11-19,10:32:00,20557.25,SELL,3,0.02h,Break Even,$-1.50,$45.00,$109067.00,231,$45.00
2024-11-19,10:40:00,20574.75,BUY,3,0.02h,Break Even,$-1.50,$43.50,$109065.50,231,$43.50
2024-11-19,11:07:00,20575.25,SELL,3,0.02h,Break Even,$-1.50,$42.00,$109064.00,231,$42.00
2024-11-19,11:08:00,20580.0,BUY,3,0.02h,Stop Loss,$-9.00,$33.00,$109055.00,231,$33.00
2024-11-19,11:12:00,20566.5,SELL,3,0.02h,Break Even,$-1.50,$31.50,$109053.50,231,$31.50
2024-11-19,11:15:00,20582.25,BUY,3,0.02h,Stop Loss,$-9.00,$22.50,$109044.50,231,$22.50
2024-11-19,11:16:00,20573.25,SELL,3,0.02h,Break Even,$-1.50,$21.00,$109043.00,231,$21.00
2024-11-19,11:40:00,20572.0,BUY,3,0.02h,Stop Loss,$-9.00,$12.00,$109034.00,231,$12.00
2024-11-19,12:34:00,20596.25,SELL,3,0.02h,Stop Loss,$7.50,$19.50,$109041.50,231,$19.50
2024-11-19,12:50:00,20603.25,BUY,3,0.02h,Stop Loss,$-9.00,$10.50,$109032.50,231,$10.50
2024-11-19,12:51:00,20596.25,SELL,3,0.02h,Break Even,$-1.50,$9.00,$109031.00,231,$9.00
2024-11-19,12:54:00,20606.25,BUY,3,0.02h,Stop Loss,$10.50,$19.50,$109041.50,231,$19.50
2024-11-19,13:10:00,20602.0,SELL,3,0.02h,Break Even,$-1.50,$18.00,$109040.00,231,$18.00
2024-11-19,14:12:00,20481.75,BUY,3,0.02h,Stop Loss,$9.00,$27.00,$109049.00,231,$27.00
2024-11-19,15:01:00,20526.5,SELL,3,0.02h,Stop Loss,$-9.00,$18.00,$109040.00,231,$18.00
2024-11-19,15:02:00,20552.5,BUY,3,0.02h,Break Even,$-1.50,$16.50,$109038.50,231,$16.50
2024-11-19,15:03:00,20524.75,SELL,3,0.02h,Stop Loss,$-9.00,$7.50,$109029.50,231,$7.50
2024-11-19,15:07:00,20560.75,BUY,3,0.02h,Stop Loss,$4.50,$12.00,$109034.00,231,$12.00
2024-11-19,16:54:00,20671.0,SELL,3,0.02h,Stop Loss,$27.00,$39.00,$109061.00,231,$39.00
2024-11-19,17:14:00,20675.75,BUY,3,0.02h,Break Even,$-1.50,$37.50,$109059.50,231,$37.50
2024-11-19,17:22:00,20660.75,SELL,3,0.02h,Stop Loss,$87.00,$124.50,$109146.50,231,$124.50
2024-11-19,17:30:00,20685.0,BUY,3,0.02h,Stop Loss,$-9.00,$115.50,$109137.50,231,$115.50
2024-11-19,17:54:00,20684.5,SELL,3,0.02h,Stop Loss,$-9.00,$106.50,$109128.50,231,$106.50
2024-11-19,17:56:00,20693.75,BUY,3,0.02h,Stop Loss,$-9.00,$97.50,$109119.50,231,$97.50
2024-11-19,18:02:00,20683.75,SELL,3,0.02h,Break Even,$-1.50,$96.00,$109118.00,231,$96.00
2024-11-19,18:04:00,20691.75,BUY,3,0.02h,Stop Loss,$9.00,$105.00,$109127.00,231,$105.00
2024-11-19,19:18:00,20765.25,SELL,3,0.02h,Stop Loss,$9.00,$114.00,$109136.00,231,$114.00
2024-11-19,19:54:00,20744.75,BUY,3,0.02h,Stop Loss,$15.00,$129.00,$109151.00,231,$129.00
2024-11-19,20:04:00,20729.0,SELL,3,0.02h,Break Even,$-1.50,$127.50,$109149.50,231,$127.50
2024-11-19,20:07:00,20743.5,BUY,3,0.02h,Break Even,$-1.50,$126.00,$109148.00,231,$126.00
2024-11-19,21:22:00,20768.0,SELL,3,0.02h,Break Even,$-1.50,$124.50,$109146.50,231,$124.50
2024-11-19,23:06:00,20773.0,BUY,3,0.02h,Stop Loss,$15.00,$139.50,$109161.50,231,$139.50
2024-11-19,23:32:00,20772.75,SELL,3,0.02h,Break Even,$-1.50,$138.00,$109160.00,231,$138.00
2024-11-19,23:35:00,20781.75,BUY,3,0.02h,Break Even,$-1.50,$136.50,$109158.50,231,$136.50
,,,,,,,,,,,
2024-11-20,00:56:00,20819.25,SELL,3,0.02h,Break Even,$-1.50,$-1.50,$109157.00,232,$-1.50
2024-11-20,01:39:00,20816.25,BUY,3,0.02h,Break Even,$-1.50,$-3.00,$109155.50,232,$-3.00
2024-11-20,01:43:00,20807.5,SELL,3,0.02h,Stop Loss,$-9.00,$-12.00,$109146.50,232,$-12.00
2024-11-20,02:24:00,20795.5,BUY,3,0.02h,Stop Loss,$-9.00,$-21.00,$109137.50,232,$-21.00
2024-11-20,03:10:00,20807.0,SELL,3,0.02h,Stop Loss,$7.50,$-13.50,$109145.00,232,$-13.50
2024-11-20,03:45:00,20793.0,BUY,3,0.02h,Break Even,$-1.50,$-15.00,$109143.50,232,$-15.00
2024-11-20,03:47:00,20787.25,SELL,3,0.02h,Break Even,$-1.50,$-16.50,$109142.00,232,$-16.50
2024-11-20,04:04:00,20790.5,BUY,3,0.02h,Stop Loss,$15.00,$-1.50,$109157.00,232,$-1.50
2024-11-20,04:45:00,20798.0,SELL,3,0.02h,Stop Loss,$-9.00,$-10.50,$109148.00,232,$-10.50
2024-11-20,04:57:00,20803.5,BUY,3,0.02h,Stop Loss,$-9.00,$-19.50,$109139.00,232,$-19.50
2024-11-20,05:05:00,20797.75,SELL,3,0.02h,Break Even,$-1.50,$-21.00,$109137.50,232,$-21.00
2024-11-20,05:19:00,20801.75,BUY,3,0.02h,Break Even,$-1.50,$-22.50,$109136.00,232,$-22.50
2024-11-20,05:23:00,20797.0,SELL,3,0.02h,Break Even,$-1.50,$-24.00,$109134.50,232,$-24.00
2024-11-20,05:27:00,20800.25,BUY,3,0.02h,Stop Loss,$-9.00,$-33.00,$109125.50,232,$-33.00
2024-11-20,05:31:00,20794.5,SELL,3,0.02h,Stop Loss,$-9.00,$-42.00,$109116.50,232,$-42.00
2024-11-20,05:56:00,20795.25,BUY,3,0.02h,Break Even,$-1.50,$-43.50,$109115.00,232,$-43.50
2024-11-20,07:12:00,20819.75,SELL,3,0.02h,Stop Loss,$6.00,$-37.50,$109121.00,232,$-37.50
2024-11-20,07:38:00,20821.75,BUY,3,0.02h,Break Even,$-1.50,$-39.00,$109119.50,232,$-39.00
2024-11-20,08:02:00,20812.0,SELL,3,0.02h,Break Even,$-1.50,$-40.50,$109118.00,232,$-40.50
2024-11-20,08:18:00,20832.25,BUY,3,0.02h,Stop Loss,$12.00,$-28.50,$109130.00,232,$-28.50
2024-11-20,08:32:00,20819.5,SELL,3,0.02h,Stop Loss,$12.00,$-16.50,$109142.00,232,$-16.50
2024-11-20,09:12:00,20815.75,BUY,3,0.02h,Stop Loss,$16.50,$0.00,$109158.50,232,$0.00
2024-11-20,09:32:00,20812.75,SELL,3,0.02h,Stop Loss,$15.00,$15.00,$109173.50,232,$15.00
2024-11-20,10:40:00,20787.25,BUY,3,0.02h,Break Even,$-1.50,$13.50,$109172.00,232,$13.50
2024-11-20,11:01:00,20773.5,SELL,3,0.02h,Break Even,$-1.50,$12.00,$109170.50,232,$12.00
2024-11-20,11:05:00,20790.25,BUY,3,0.02h,Break Even,$-1.50,$10.50,$109169.00,232,$10.50
2024-11-20,11:34:00,20792.75,SELL,3,0.02h,Stop Loss,$4.50,$15.00,$109173.50,232,$15.00
2024-11-20,11:49:00,20791.75,BUY,3,0.02h,Break Even,$-1.50,$13.50,$109172.00,232,$13.50
2024-11-20,12:35:00,20804.0,SELL,3,0.02h,Stop Loss,$-9.00,$4.50,$109163.00,232,$4.50
2024-11-20,12:46:00,20814.25,BUY,3,0.02h,Break Even,$-1.50,$3.00,$109161.50,232,$3.00
2024-11-20,13:14:00,20814.25,SELL,3,0.02h,Break Even,$-1.50,$1.50,$109160.00,232,$1.50
2024-11-20,13:20:00,20823.25,BUY,3,0.02h,Stop Loss,$4.50,$6.00,$109164.50,232,$6.00
2024-11-20,13:28:00,20817.5,SELL,3,0.02h,Break Even,$-1.50,$4.50,$109163.00,232,$4.50
2024-11-20,15:34:00,20561.25,BUY,3,0.02h,Stop Loss,$48.00,$52.50,$109211.00,232,$52.50
2024-11-20,16:12:00,20586.75,SELL,3,0.02h,Stop Loss,$6.00,$58.50,$109217.00,232,$58.50
2024-11-20,16:41:00,20610.0,BUY,3,0.02h,Stop Loss,$28.50,$87.00,$109245.50,232,$87.00
2024-11-20,17:11:00,20660.25,SELL,3,0.02h,Stop Loss,$34.50,$121.50,$109280.00,232,$121.50
2024-11-20,17:35:00,20637.75,BUY,3,0.02h,Stop Loss,$19.50,$141.00,$109299.50,232,$141.00
2024-11-20,17:55:00,20609.0,SELL,3,0.02h,Stop Loss,$-9.00,$132.00,$109290.50,232,$132.00
2024-11-20,18:28:00,20625.0,BUY,3,0.02h,Stop Loss,$21.00,$153.00,$109311.50,232,$153.00
2024-11-20,18:35:00,20605.75,SELL,3,0.02h,Stop Loss,$6.00,$159.00,$109317.50,232,$159.00
2024-11-20,19:03:00,20589.75,BUY,3,0.02h,Stop Loss,$13.50,$172.50,$109331.00,232,$172.50
2024-11-20,19:07:00,20570.75,SELL,3,0.02h,Stop Loss,$16.50,$189.00,$109347.50,232,$189.00
2024-11-20,19:35:00,20583.75,BUY,3,0.02h,Stop Loss,$6.00,$195.00,$109353.50,232,$195.00
2024-11-20,20:08:00,20598.25,SELL,3,0.02h,Break Even,$-1.50,$193.50,$109352.00,232,$193.50
2024-11-20,20:10:00,20610.5,BUY,3,0.02h,Stop Loss,$13.50,$207.00,$109365.50,232,$207.00
2024-11-20,21:21:00,20644.25,SELL,3,0.02h,Stop Loss,$198.00,$405.00,$109563.50,232,$405.00
2024-11-20,21:45:00,20711.75,BUY,3,0.02h,Stop Loss,$106.50,$511.50,$109670.00,232,$511.50
2024-11-20,23:14:00,20711.5,SELL,3,0.02h,Stop Loss,$6.00,$517.50,$109676.00,232,$517.50
2024-11-20,23:27:00,20729.75,BUY,3,0.02h,Stop Loss,$-9.00,$508.50,$109667.00,232,$508.50
,,,,,,,,,,,
2024-11-21,00:03:00,20738.75,SELL,3,0.02h,Stop Loss,$30.00,$30.00,$109697.00,233,$30.00
2024-11-21,01:31:00,20663.25,BUY,3,0.02h,Stop Loss,$18.00,$48.00,$109715.00,233,$48.00
2024-11-21,01:40:00,20646.5,SELL,3,0.02h,Stop Loss,$-9.00,$39.00,$109706.00,233,$39.00
2024-11-21,01:48:00,20667.75,BUY,3,0.02h,Stop Loss,$-9.00,$30.00,$109697.00,233,$30.00
2024-11-21,01:51:00,20646.25,SELL,3,0.02h,Stop Loss,$33.00,$63.00,$109730.00,233,$63.00
2024-11-21,02:14:00,20642.75,BUY,3,0.02h,Break Even,$-1.50,$61.50,$109728.50,233,$61.50
2024-11-21,02:44:00,20643.75,SELL,3,0.02h,Stop Loss,$31.50,$93.00,$109760.00,233,$93.00
2024-11-21,02:49:00,20651.25,BUY,3,0.02h,Break Even,$-1.50,$91.50,$109758.50,233,$91.50
2024-11-21,02:55:00,20645.0,SELL,3,0.02h,Break Even,$-1.50,$90.00,$109757.00,233,$90.00
2024-11-21,03:02:00,20654.5,BUY,3,0.02h,Stop Loss,$7.50,$97.50,$109764.50,233,$97.50
2024-11-21,03:45:00,20674.0,SELL,3,0.02h,Stop Loss,$13.50,$111.00,$109778.00,233,$111.00
2024-11-21,04:11:00,20668.25,BUY,3,0.02h,Stop Loss,$19.50,$130.50,$109797.50,233,$130.50
2024-11-21,04:32:00,20670.0,SELL,3,0.02h,Stop Loss,$-9.00,$121.50,$109788.50,233,$121.50
2024-11-21,04:33:00,20677.5,BUY,3,0.02h,Break Even,$-1.50,$120.00,$109787.00,233,$120.00
2024-11-21,05:04:00,20677.5,SELL,3,0.02h,Stop Loss,$-9.00,$111.00,$109778.00,233,$111.00
2024-11-21,05:05:00,20680.0,BUY,3,0.02h,Stop Loss,$7.50,$118.50,$109785.50,233,$118.50
2024-11-21,05:36:00,20684.25,SELL,3,0.02h,Stop Loss,$16.50,$135.00,$109802.00,233,$135.00
2024-11-21,06:15:00,20679.5,BUY,3,0.02h,Stop Loss,$12.00,$147.00,$109814.00,233,$147.00
2024-11-21,06:18:00,20672.5,SELL,3,0.02h,Stop Loss,$-9.00,$138.00,$109805.00,233,$138.00
2024-11-21,06:28:00,20680.0,BUY,3,0.02h,Stop Loss,$21.00,$159.00,$109826.00,233,$159.00
2024-11-21,06:55:00,20684.25,SELL,3,0.02h,Break Even,$-1.50,$157.50,$109824.50,233,$157.50
2024-11-21,06:57:00,20687.75,BUY,3,0.03h,Stop Loss,$9.00,$166.50,$109833.50,233,$166.50
2024-11-21,07:23:00,20693.5,SELL,3,0.02h,Stop Loss,$6.00,$172.50,$109839.50,233,$172.50
2024-11-21,07:49:00,20672.25,BUY,3,0.02h,Stop Loss,$22.50,$195.00,$109862.00,233,$195.00
2024-11-21,08:18:00,20656.25,SELL,3,0.02h,Stop Loss,$28.50,$223.50,$109890.50,233,$223.50
2024-11-21,08:22:00,20689.0,BUY,3,0.02h,Stop Loss,$4.50,$228.00,$109895.00,233,$228.00
2024-11-21,08:23:00,20671.25,SELL,3,0.02h,Stop Loss,$7.50,$235.50,$109902.50,233,$235.50
2024-11-21,08:52:00,20667.75,BUY,3,0.02h,Break Even,$-1.50,$234.00,$109901.00,233,$234.00
2024-11-21,09:04:00,20652.75,SELL,3,0.02h,Stop Loss,$48.00,$282.00,$109949.00,233,$282.00
2024-11-21,09:42:00,20634.0,BUY,3,0.02h,Stop Loss,$57.00,$339.00,$110006.00,233,$339.00
2024-11-21,10:27:00,20650.25,SELL,3,0.02h,Break Even,$-1.50,$337.50,$110004.50,233,$337.50
2024-11-21,10:29:00,20658.25,BUY,3,0.02h,Stop Loss,$18.00,$355.50,$110022.50,233,$355.50
2024-11-21,11:34:00,20710.25,SELL,3,0.02h,Stop Loss,$-9.00,$346.50,$110013.50,233,$346.50
2024-11-21,11:35:00,20729.5,BUY,3,0.02h,Stop Loss,$24.00,$370.50,$110037.50,233,$370.50
2024-11-21,11:39:00,20717.5,SELL,3,0.02h,Stop Loss,$22.50,$393.00,$110060.00,233,$393.00
2024-11-21,11:46:00,20727.0,BUY,3,0.02h,Stop Loss,$16.50,$409.50,$110076.50,233,$409.50
2024-11-21,12:37:00,20773.25,SELL,3,0.02h,Break Even,$-1.50,$408.00,$110075.00,233,$408.00
2024-11-21,12:43:00,20799.0,BUY,3,0.02h,Stop Loss,$37.50,$445.50,$110112.50,233,$445.50
2024-11-21,12:50:00,20774.25,SELL,3,0.02h,Stop Loss,$3.00,$448.50,$110115.50,233,$448.50
2024-11-21,13:13:00,20777.5,BUY,3,0.02h,Stop Loss,$42.00,$490.50,$110157.50,233,$490.50
2024-11-21,14:34:00,20837.0,SELL,3,0.02h,Stop Loss,$321.00,$811.50,$110478.50,233,$811.50
2024-11-21,15:17:00,20706.25,BUY,3,0.02h,Stop Loss,$-9.00,$802.50,$110469.50,233,$802.50
2024-11-21,15:24:00,20618.0,SELL,3,0.02h,Stop Loss,$150.00,$952.50,$110619.50,233,$952.50
2024-11-21,15:47:00,20615.75,BUY,3,0.02h,Stop Loss,$109.50,$1062.00,$110729.00,233,$1062.00
2024-11-21,16:47:00,20728.0,SELL,3,0.02h,Stop Loss,$91.50,$1153.50,$110820.50,233,$1153.50
2024-11-21,17:10:00,20741.5,BUY,3,0.02h,Stop Loss,$31.50,$1185.00,$110852.00,233,$1185.00
2024-11-21,18:19:00,20822.0,SELL,3,0.02h,Break Even,$-1.50,$1183.50,$110850.50,233,$1183.50
2024-11-21,18:24:00,20834.25,BUY,3,0.02h,Stop Loss,$30.00,$1213.50,$110880.50,233,$1213.50
2024-11-21,18:42:00,20831.0,SELL,3,0.02h,Stop Loss,$-9.00,$1204.50,$110871.50,233,$1204.50
2024-11-21,18:45:00,20849.75,BUY,3,0.02h,Stop Loss,$7.50,$1212.00,$110879.00,233,$1212.00
2024-11-21,18:53:00,20837.75,SELL,3,0.02h,Stop Loss,$12.00,$1224.00,$110891.00,233,$1224.00
2024-11-21,18:55:00,20852.5,BUY,3,0.02h,Stop Loss,$52.50,$1276.50,$110943.50,233,$1276.50
2024-11-21,19:07:00,20845.0,SELL,3,0.02h,Stop Loss,$79.50,$1356.00,$111023.00,233,$1356.00
2024-11-21,19:27:00,20844.5,BUY,3,0.02h,Stop Loss,$-9.00,$1347.00,$111014.00,233,$1347.00
2024-11-21,19:51:00,20826.5,SELL,3,0.02h,Stop Loss,$15.00,$1362.00,$111029.00,233,$1362.00
2024-11-21,19:59:00,20844.0,BUY,3,0.02h,Stop Loss,$16.50,$1378.50,$111045.50,233,$1378.50
2024-11-21,20:35:00,20852.0,SELL,3,0.02h,Stop Loss,$79.50,$1458.00,$111125.00,233,$1458.00
2024-11-21,21:52:00,20808.5,BUY,3,0.02h,Stop Loss,$-9.00,$1449.00,$111116.00,233,$1449.00
2024-11-21,21:54:00,20798.5,SELL,3,0.02h,Stop Loss,$-9.00,$1440.00,$111107.00,233,$1440.00
2024-11-21,21:55:00,20801.0,BUY,3,0.02h,Stop Loss,$-9.00,$1431.00,$111098.00,233,$1431.00
2024-11-21,21:59:00,20795.5,SELL,3,1.03h,Stop Loss,$115.50,$1546.50,$111213.50,233,$1546.50
2024-11-21,23:27:00,20798.75,BUY,3,0.02h,Break Even,$-1.50,$1545.00,$111212.00,233,$1545.00
2024-11-21,23:46:00,20789.75,SELL,3,0.02h,Stop Loss,$10.50,$1555.50,$111222.50,233,$1555.50
,,,,,,,,,,,
2024-11-22,00:07:00,20790.5,BUY,3,0.02h,Break Even,$-1.50,$-1.50,$111221.00,234,$-1.50
2024-11-22,00:13:00,20777.0,SELL,3,0.02h,Break Even,$-1.50,$-3.00,$111219.50,234,$-3.00
2024-11-22,00:20:00,20784.5,BUY,3,0.02h,Stop Loss,$4.50,$1.50,$111224.00,234,$1.50
2024-11-22,00:34:00,20776.75,SELL,3,0.02h,Break Even,$-1.50,$0.00,$111222.50,234,$0.00
2024-11-22,01:02:00,20784.75,BUY,3,0.02h,Break Even,$-1.50,$-1.50,$111221.00,234,$-1.50
2024-11-22,01:47:00,20798.0,SELL,3,0.02h,Break Even,$-1.50,$-3.00,$111219.50,234,$-3.00
2024-11-22,01:52:00,20809.25,BUY,3,0.02h,Break Even,$-1.50,$-4.50,$111218.00,234,$-4.50
2024-11-22,02:01:00,20800.5,SELL,3,0.02h,Stop Loss,$-9.00,$-13.50,$111209.00,234,$-13.50
2024-11-22,02:03:00,20805.75,BUY,3,0.02h,Break Even,$-1.50,$-15.00,$111207.50,234,$-15.00
2024-11-22,02:09:00,20800.5,SELL,3,0.02h,Stop Loss,$9.00,$-6.00,$111216.50,234,$-6.00
2024-11-22,02:21:00,20804.5,BUY,3,0.03h,Stop Loss,$-9.00,$-15.00,$111207.50,234,$-15.00
2024-11-22,03:31:00,20825.0,SELL,3,0.02h,Stop Loss,$25.50,$10.50,$111233.00,234,$10.50
2024-11-22,04:02:00,20800.75,BUY,3,0.02h,Break Even,$-1.50,$9.00,$111231.50,234,$9.00
2024-11-22,04:10:00,20783.75,SELL,3,0.02h,Break Even,$-1.50,$7.50,$111230.00,234,$7.50
2024-11-22,04:17:00,20796.5,BUY,3,0.02h,Stop Loss,$-9.00,$-1.50,$111221.00,234,$-1.50
2024-11-22,05:03:00,20803.25,SELL,3,0.02h,Stop Loss,$6.00,$4.50,$111227.00,234,$4.50
2024-11-22,06:06:00,20789.5,BUY,3,0.02h,Stop Loss,$7.50,$12.00,$111234.50,234,$12.00
2024-11-22,06:34:00,20791.75,SELL,3,0.02h,Stop Loss,$-9.00,$3.00,$111225.50,234,$3.00
2024-11-22,06:46:00,20802.5,BUY,3,0.02h,Break Even,$-1.50,$1.50,$111224.00,234,$1.50
2024-11-22,06:52:00,20795.75,SELL,3,0.02h,Stop Loss,$-9.00,$-7.50,$111215.00,234,$-7.50
2024-11-22,06:59:00,20802.25,BUY,3,0.02h,Break Even,$-1.50,$-9.00,$111213.50,234,$-9.00
2024-11-22,07:04:00,20789.5,SELL,3,0.02h,Stop Loss,$-9.00,$-18.00,$111204.50,234,$-18.00
2024-11-22,07:08:00,20802.0,BUY,3,0.02h,Stop Loss,$10.50,$-7.50,$111215.00,234,$-7.50
2024-11-22,07:20:00,20799.5,SELL,3,0.02h,Break Even,$-1.50,$-9.00,$111213.50,234,$-9.00
2024-11-22,07:26:00,20810.75,BUY,3,0.02h,Stop Loss,$-9.00,$-18.00,$111204.50,234,$-18.00
2024-11-22,07:53:00,20812.5,SELL,3,0.02h,Stop Loss,$-9.00,$-27.00,$111195.50,234,$-27.00
2024-11-22,08:01:00,20825.25,BUY,3,0.02h,Break Even,$-1.50,$-28.50,$111194.00,234,$-28.50
2024-11-22,08:16:00,20806.0,SELL,3,0.02h,Stop Loss,$7.50,$-21.00,$111201.50,234,$-21.00
2024-11-22,08:39:00,20814.75,BUY,3,0.02h,Break Even,$-1.50,$-22.50,$111200.00,234,$-22.50
2024-11-22,09:00:00,20806.75,SELL,3,0.02h,Stop Loss,$67.50,$45.00,$111267.50,234,$45.00
2024-11-22,09:51:00,20740.5,BUY,3,0.02h,Stop Loss,$-9.00,$36.00,$111258.50,234,$36.00
2024-11-22,10:08:00,20719.5,SELL,3,0.02h,Break Even,$-1.50,$34.50,$111257.00,234,$34.50
2024-11-22,10:32:00,20731.75,BUY,3,0.02h,Stop Loss,$43.50,$78.00,$111300.50,234,$78.00
2024-11-22,11:01:00,20732.75,SELL,3,0.02h,Stop Loss,$7.50,$85.50,$111308.00,234,$85.50
2024-11-22,11:03:00,20753.0,BUY,3,0.02h,Stop Loss,$-9.00,$76.50,$111299.00,234,$76.50
2024-11-22,11:13:00,20721.75,SELL,3,0.02h,Stop Loss,$-9.00,$67.50,$111290.00,234,$67.50
2024-11-22,11:26:00,20751.25,BUY,3,0.02h,Stop Loss,$-9.00,$58.50,$111281.00,234,$58.50
2024-11-22,11:37:00,20729.5,SELL,3,0.02h,Stop Loss,$16.50,$75.00,$111297.50,234,$75.00
2024-11-22,11:43:00,20750.75,BUY,3,0.02h,Stop Loss,$-9.00,$66.00,$111288.50,234,$66.00
2024-11-22,12:45:00,20783.0,SELL,3,0.02h,Break Even,$-1.50,$64.50,$111287.00,234,$64.50
2024-11-22,12:46:00,20787.0,BUY,3,0.02h,Break Even,$-1.50,$63.00,$111285.50,234,$63.00
2024-11-22,13:16:00,20785.25,SELL,3,0.02h,Stop Loss,$-9.00,$54.00,$111276.50,234,$54.00
2024-11-22,13:21:00,20800.25,BUY,3,0.02h,Stop Loss,$73.50,$127.50,$111350.00,234,$127.50
2024-11-22,13:33:00,20790.5,SELL,3,0.02h,Break Even,$-1.50,$126.00,$111348.50,234,$126.00
2024-11-22,14:08:00,20790.5,BUY,3,0.02h,Stop Loss,$-9.00,$117.00,$111339.50,234,$117.00
2024-11-22,14:23:00,20785.75,SELL,3,0.02h,Stop Loss,$25.50,$142.50,$111365.00,234,$142.50
2024-11-22,14:33:00,20811.25,BUY,3,0.02h,Stop Loss,$43.50,$186.00,$111408.50,234,$186.00
2024-11-22,14:54:00,20798.25,SELL,3,0.02h,Stop Loss,$-9.00,$177.00,$111399.50,234,$177.00
2024-11-22,14:57:00,20835.75,BUY,3,0.02h,Stop Loss,$21.00,$198.00,$111420.50,234,$198.00
2024-11-22,15:06:00,20805.5,SELL,3,0.02h,Stop Loss,$-9.00,$189.00,$111411.50,234,$189.00
2024-11-22,15:40:00,20815.5,BUY,3,0.02h,Stop Loss,$25.50,$214.50,$111437.00,234,$214.50
2024-11-22,16:10:00,20808.5,SELL,3,0.02h,Stop Loss,$39.00,$253.50,$111476.00,234,$253.50
2024-11-22,16:40:00,20804.0,BUY,3,0.02h,Break Even,$-1.50,$252.00,$111474.50,234,$252.00
2024-11-22,16:44:00,20763.75,SELL,3,0.02h,Stop Loss,$15.00,$267.00,$111489.50,234,$267.00
2024-11-22,16:50:00,20794.25,BUY,3,0.02h,Stop Loss,$12.00,$279.00,$111501.50,234,$279.00
2024-11-22,17:36:00,20823.0,SELL,3,0.02h,Stop Loss,$25.50,$304.50,$111527.00,234,$304.50
2024-11-22,17:48:00,20827.5,BUY,3,0.02h,Stop Loss,$33.00,$337.50,$111560.00,234,$337.50
2024-11-22,18:30:00,20851.5,SELL,3,0.02h,Break Even,$-1.50,$336.00,$111558.50,234,$336.00
2024-11-22,18:32:00,20868.0,BUY,3,0.02h,Stop Loss,$12.00,$348.00,$111570.50,234,$348.00
2024-11-22,18:35:00,20857.5,SELL,3,0.02h,Break Even,$-1.50,$346.50,$111569.00,234,$346.50
2024-11-22,19:29:00,20830.5,BUY,3,0.02h,Stop Loss,$-9.00,$337.50,$111560.00,234,$337.50
2024-11-22,20:04:00,20819.25,SELL,3,0.02h,Stop Loss,$85.50,$423.00,$111645.50,234,$423.00
2024-11-22,20:26:00,20827.25,BUY,3,0.02h,Break Even,$-1.50,$421.50,$111644.00,234,$421.50
2024-11-22,20:40:00,20823.0,SELL,3,0.02h,Stop Loss,$9.00,$430.50,$111653.00,234,$430.50
2024-11-22,20:48:00,20833.0,BUY,3,0.02h,Break Even,$-1.50,$429.00,$111651.50,234,$429.00
,,,,,,,,,,,
2024-11-25,01:45:00,20960.0,SELL,3,0.02h,Stop Loss,$-9.00,$-9.00,$111642.50,235,$-9.00
2024-11-25,02:09:00,20960.75,BUY,3,0.02h,Break Even,$-1.50,$-10.50,$111641.00,235,$-10.50
2024-11-25,02:32:00,20960.0,SELL,3,0.02h,Stop Loss,$-9.00,$-19.50,$111632.00,235,$-19.50
2024-11-25,02:49:00,20961.75,BUY,3,0.02h,Stop Loss,$-9.00,$-28.50,$111623.00,235,$-28.50
2024-11-25,02:51:00,20956.75,SELL,3,0.03h,Stop Loss,$-9.00,$-37.50,$111614.00,235,$-37.50
2024-11-25,02:57:00,20960.25,BUY,3,0.03h,Break Even,$-1.50,$-39.00,$111612.50,235,$-39.00
2024-11-25,03:28:00,20957.5,SELL,3,0.02h,Stop Loss,$-9.00,$-48.00,$111603.50,235,$-48.00
2024-11-25,03:54:00,20958.5,BUY,3,0.03h,Break Even,$-1.50,$-49.50,$111602.00,235,$-49.50
2024-11-25,04:50:00,20963.75,SELL,3,0.02h,Break Even,$-1.50,$-51.00,$111600.50,235,$-51.00
2024-11-25,04:59:00,20967.0,BUY,3,0.02h,Stop Loss,$-9.00,$-60.00,$111591.50,235,$-60.00
2024-11-25,05:01:00,20963.75,SELL,3,0.02h,Stop Loss,$-9.00,$-69.00,$111582.50,235,$-69.00
2024-11-25,05:13:00,20966.5,BUY,3,0.03h,Stop Loss,$-9.00,$-78.00,$111573.50,235,$-78.00
2024-11-25,05:18:00,20962.25,SELL,3,0.02h,Stop Loss,$-9.00,$-87.00,$111564.50,235,$-87.00
2024-11-25,05:39:00,20965.5,BUY,3,0.02h,Break Even,$-1.50,$-88.50,$111563.00,235,$-88.50
2024-11-25,06:05:00,20959.75,SELL,3,0.02h,Stop Loss,$7.50,$-81.00,$111570.50,235,$-81.00
2024-11-25,06:26:00,20965.5,BUY,3,0.02h,Stop Loss,$-9.00,$-90.00,$111561.50,235,$-90.00
2024-11-25,06:36:00,20960.25,SELL,3,0.02h,Break Even,$-1.50,$-91.50,$111560.00,235,$-91.50
2024-11-25,06:38:00,20962.5,BUY,3,0.02h,Stop Loss,$-9.00,$-100.50,$111551.00,235,$-100.50
2024-11-25,06:48:00,20960.75,SELL,3,0.02h,Break Even,$-1.50,$-102.00,$111549.50,235,$-102.00
2024-11-25,07:10:00,20964.0,BUY,3,0.02h,Break Even,$-1.50,$-103.50,$111548.00,235,$-103.50
2024-11-25,07:25:00,20959.0,SELL,3,0.02h,Stop Loss,$-9.00,$-112.50,$111539.00,235,$-112.50
2024-11-25,07:54:00,20959.75,BUY,3,0.02h,Break Even,$-1.50,$-114.00,$111537.50,235,$-114.00
2024-11-25,08:18:00,20955.5,SELL,3,0.02h,Stop Loss,$-9.00,$-123.00,$111528.50,235,$-123.00
2024-11-25,08:40:00,20952.0,BUY,3,0.02h,Stop Loss,$-9.00,$-132.00,$111519.50,235,$-132.00
2024-11-25,09:05:00,20947.0,SELL,3,0.02h,Break Even,$-1.50,$-133.50,$111518.00,235,$-133.50
2024-11-25,09:12:00,20957.5,BUY,3,0.02h,Break Even,$-1.50,$-135.00,$111516.50,235,$-135.00
2024-11-25,09:34:00,20955.0,SELL,3,0.02h,Break Even,$-1.50,$-136.50,$111515.00,235,$-136.50
2024-11-25,09:40:00,20958.5,BUY,3,0.02h,Stop Loss,$3.00,$-133.50,$111518.00,235,$-133.50
2024-11-25,10:14:00,20964.25,SELL,3,0.02h,Stop Loss,$-9.00,$-142.50,$111509.00,235,$-142.50
2024-11-25,10:17:00,20967.25,BUY,3,0.02h,Break Even,$-1.50,$-144.00,$111507.50,235,$-144.00
2024-11-25,11:12:00,20971.75,SELL,3,0.02h,Break Even,$-1.50,$-145.50,$111506.00,235,$-145.50
2024-11-25,11:33:00,20973.5,BUY,3,0.02h,Stop Loss,$-9.00,$-154.50,$111497.00,235,$-154.50
2024-11-25,11:36:00,20968.5,SELL,3,0.02h,Break Even,$-1.50,$-156.00,$111495.50,235,$-156.00
2024-11-25,12:20:00,20968.75,BUY,3,0.02h,Break Even,$-1.50,$-157.50,$111494.00,235,$-157.50
2024-11-25,12:26:00,20956.25,SELL,3,0.02h,Stop Loss,$36.00,$-121.50,$111530.00,235,$-121.50
2024-11-25,12:39:00,20964.25,BUY,3,0.02h,Break Even,$-1.50,$-123.00,$111528.50,235,$-123.00
2024-11-25,12:51:00,20956.5,SELL,3,0.02h,Break Even,$-1.50,$-124.50,$111527.00,235,$-124.50
2024-11-25,12:53:00,20963.0,BUY,3,0.02h,Stop Loss,$-9.00,$-133.50,$111518.00,235,$-133.50
2024-11-25,13:00:00,20955.5,SELL,3,0.02h,Break Even,$-1.50,$-135.00,$111516.50,235,$-135.00
2024-11-25,13:27:00,20955.75,BUY,3,0.02h,Break Even,$-1.50,$-136.50,$111515.00,235,$-136.50
2024-11-25,13:32:00,20949.0,SELL,3,0.02h,Stop Loss,$-9.00,$-145.50,$111506.00,235,$-145.50
2024-11-25,13:35:00,20953.5,BUY,3,0.02h,Break Even,$-1.50,$-147.00,$111504.50,235,$-147.00
2024-11-25,14:30:00,21016.25,SELL,3,0.02h,Stop Loss,$223.50,$76.50,$111728.00,235,$76.50
2024-11-25,14:40:00,21054.75,BUY,3,0.02h,Stop Loss,$40.50,$117.00,$111768.50,235,$117.00
2024-11-25,14:52:00,20973.25,SELL,3,0.02h,Stop Loss,$154.50,$271.50,$111923.00,235,$271.50
2024-11-25,15:31:00,20940.25,BUY,3,0.02h,Stop Loss,$-9.00,$262.50,$111914.00,235,$262.50
2024-11-25,15:34:00,20890.75,SELL,3,0.02h,Stop Loss,$49.50,$312.00,$111963.50,235,$312.00
2024-11-25,15:44:00,20936.0,BUY,3,0.02h,Stop Loss,$33.00,$345.00,$111996.50,235,$345.00
2024-11-25,15:56:00,20911.25,SELL,3,0.02h,Stop Loss,$76.50,$421.50,$112073.00,235,$421.50
2024-11-25,16:13:00,20917.5,BUY,3,0.02h,Stop Loss,$7.50,$429.00,$112080.50,235,$429.00
2024-11-25,16:37:00,20907.0,SELL,3,0.02h,Stop Loss,$40.50,$469.50,$112121.00,235,$469.50
2024-11-25,17:54:00,20845.0,BUY,3,0.02h,Stop Loss,$13.50,$483.00,$112134.50,235,$483.00
2024-11-25,18:32:00,20864.5,SELL,3,0.02h,Stop Loss,$-9.00,$474.00,$112125.50,235,$474.00
2024-11-25,18:33:00,20874.75,BUY,3,0.02h,Stop Loss,$42.00,$516.00,$112167.50,235,$516.00
2024-11-25,18:44:00,20866.25,SELL,3,0.02h,Stop Loss,$45.00,$561.00,$112212.50,235,$561.00
2024-11-25,19:11:00,20864.25,BUY,3,0.02h,Break Even,$-1.50,$559.50,$112211.00,235,$559.50
2024-11-25,19:23:00,20844.25,SELL,3,0.02h,Stop Loss,$91.50,$651.00,$112302.50,235,$651.00
2024-11-25,19:44:00,20857.25,BUY,3,0.02h,Break Even,$-1.50,$649.50,$112301.00,235,$649.50
2024-11-25,20:03:00,20848.75,SELL,3,0.02h,Stop Loss,$31.50,$681.00,$112332.50,235,$681.00
2024-11-25,20:26:00,20856.5,BUY,3,0.02h,Break Even,$-1.50,$679.50,$112331.00,235,$679.50
2024-11-25,21:42:00,20897.5,SELL,3,0.02h,Stop Loss,$-9.00,$670.50,$112322.00,235,$670.50
2024-11-25,21:58:00,20902.5,BUY,3,0.02h,Stop Loss,$-9.00,$661.50,$112313.00,235,$661.50
2024-11-25,23:38:00,20910.75,SELL,3,0.02h,Stop Loss,$-9.00,$652.50,$112304.00,235,$652.50
,,,,,,,,,,,
2024-11-26,00:29:00,20815.5,BUY,3,0.02h,Stop Loss,$40.50,$40.50,$112344.50,236,$40.50
2024-11-26,00:39:00,20799.75,SELL,3,0.02h,Break Even,$-1.50,$39.00,$112343.00,236,$39.00
2024-11-26,00:46:00,20813.0,BUY,3,0.02h,Stop Loss,$24.00,$63.00,$112367.00,236,$63.00
2024-11-26,00:54:00,20797.5,SELL,3,0.02h,Stop Loss,$19.50,$82.50,$112386.50,236,$82.50
2024-11-26,01:21:00,20797.5,BUY,3,0.02h,Stop Loss,$3.00,$85.50,$112389.50,236,$85.50
2024-11-26,02:32:00,20852.0,SELL,3,0.02h,Break Even,$-1.50,$84.00,$112388.00,236,$84.00
2024-11-26,02:37:00,20863.0,BUY,3,0.02h,Break Even,$-1.50,$82.50,$112386.50,236,$82.50
2024-11-26,03:08:00,20868.0,SELL,3,0.02h,Stop Loss,$-9.00,$73.50,$112377.50,236,$73.50
2024-11-26,03:09:00,20873.25,BUY,3,0.02h,Stop Loss,$3.00,$76.50,$112380.50,236,$76.50
2024-11-26,04:09:00,20897.5,SELL,3,0.02h,Stop Loss,$-9.00,$67.50,$112371.50,236,$67.50
2024-11-26,04:22:00,20902.75,BUY,3,0.02h,Stop Loss,$-9.00,$58.50,$112362.50,236,$58.50
2024-11-26,04:42:00,20898.25,SELL,3,0.02h,Stop Loss,$-9.00,$49.50,$112353.50,236,$49.50
2024-11-26,05:01:00,20902.75,BUY,3,0.02h,Break Even,$-1.50,$48.00,$112352.00,236,$48.00
2024-11-26,05:14:00,20896.25,SELL,3,0.02h,Stop Loss,$-9.00,$39.00,$112343.00,236,$39.00
2024-11-26,06:02:00,20887.75,BUY,3,0.02h,Stop Loss,$-9.00,$30.00,$112334.00,236,$30.00
2024-11-26,06:59:00,20905.75,SELL,3,0.02h,Break Even,$-1.50,$28.50,$112332.50,236,$28.50
2024-11-26,07:20:00,20903.0,BUY,3,0.02h,Stop Loss,$-9.00,$19.50,$112323.50,236,$19.50
2024-11-26,07:35:00,20895.25,SELL,3,0.02h,Stop Loss,$73.50,$93.00,$112397.00,236,$93.00
2024-11-26,08:20:00,20890.0,BUY,3,0.02h,Stop Loss,$-9.00,$84.00,$112388.00,236,$84.00
2024-11-26,08:26:00,20878.75,SELL,3,0.02h,Stop Loss,$15.00,$99.00,$112403.00,236,$99.00
2024-11-26,08:49:00,20878.5,BUY,3,0.02h,Stop Loss,$-9.00,$90.00,$112394.00,236,$90.00
2024-11-26,09:00:00,20869.75,SELL,3,0.02h,Stop Loss,$3.00,$93.00,$112397.00,236,$93.00
2024-11-26,09:05:00,20884.25,BUY,3,0.02h,Stop Loss,$40.50,$133.50,$112437.50,236,$133.50
2024-11-26,09:33:00,20881.0,SELL,3,0.02h,Stop Loss,$7.50,$141.00,$112445.00,236,$141.00
2024-11-26,09:44:00,20892.75,BUY,3,0.02h,Stop Loss,$-9.00,$132.00,$112436.00,236,$132.00
2024-11-26,09:55:00,20880.5,SELL,3,0.02h,Stop Loss,$-9.00,$123.00,$112427.00,236,$123.00
2024-11-26,10:01:00,20894.75,BUY,3,0.02h,Stop Loss,$-9.00,$114.00,$112418.00,236,$114.00
2024-11-26,10:26:00,20887.5,SELL,3,0.02h,Stop Loss,$19.50,$133.50,$112437.50,236,$133.50
2024-11-26,10:49:00,20883.0,BUY,3,0.02h,Break Even,$-1.50,$132.00,$112436.00,236,$132.00
2024-11-26,11:27:00,20886.25,SELL,3,0.02h,Break Even,$-1.50,$130.50,$112434.50,236,$130.50
2024-11-26,11:38:00,20896.5,BUY,3,0.02h,Break Even,$-1.50,$129.00,$112433.00,236,$129.00
2024-11-26,12:27:00,20934.0,SELL,3,0.02h,Stop Loss,$-9.00,$120.00,$112424.00,236,$120.00
2024-11-26,12:37:00,20944.0,BUY,3,0.02h,Stop Loss,$9.00,$129.00,$112433.00,236,$129.00
2024-11-26,12:58:00,20938.25,SELL,3,0.02h,Stop Loss,$-9.00,$120.00,$112424.00,236,$120.00
2024-11-26,12:59:00,20947.25,BUY,3,0.02h,Break Even,$-1.50,$118.50,$112422.50,236,$118.50
2024-11-26,13:02:00,20941.75,SELL,3,0.02h,Stop Loss,$18.00,$136.50,$112440.50,236,$136.50
2024-11-26,13:34:00,20936.5,BUY,3,0.02h,Stop Loss,$-9.00,$127.50,$112431.50,236,$127.50
2024-11-26,14:24:00,20947.0,SELL,3,0.02h,Break Even,$-1.50,$126.00,$112430.00,236,$126.00
2024-11-26,14:33:00,20981.0,BUY,3,0.02h,Stop Loss,$31.50,$157.50,$112461.50,236,$157.50
2024-11-26,14:57:00,20957.0,SELL,3,0.02h,Break Even,$-1.50,$156.00,$112460.00,236,$156.00
2024-11-26,15:32:00,20966.0,BUY,3,0.02h,Stop Loss,$28.50,$184.50,$112488.50,236,$184.50
2024-11-26,15:54:00,20957.5,SELL,3,0.02h,Stop Loss,$-9.00,$175.50,$112479.50,236,$175.50
2024-11-26,15:58:00,20971.0,BUY,3,0.02h,Stop Loss,$22.50,$198.00,$112502.00,236,$198.00
2024-11-26,16:00:00,20950.0,SELL,3,0.02h,Stop Loss,$-9.00,$189.00,$112493.00,236,$189.00
2024-11-26,16:03:00,20977.5,BUY,3,0.02h,Stop Loss,$16.50,$205.50,$112509.50,236,$205.50
2024-11-26,16:12:00,20957.5,SELL,3,0.02h,Stop Loss,$12.00,$217.50,$112521.50,236,$217.50
2024-11-26,16:33:00,20960.5,BUY,3,0.02h,Stop Loss,$-9.00,$208.50,$112512.50,236,$208.50
2024-11-26,16:34:00,20953.75,SELL,3,0.02h,Break Even,$-1.50,$207.00,$112511.00,236,$207.00
2024-11-26,16:35:00,20959.25,BUY,3,0.02h,Stop Loss,$-9.00,$198.00,$112502.00,236,$198.00
2024-11-26,16:36:00,20956.0,SELL,3,0.02h,Stop Loss,$52.50,$250.50,$112554.50,236,$250.50
2024-11-26,16:40:00,20963.75,BUY,3,0.02h,Stop Loss,$-9.00,$241.50,$112545.50,236,$241.50
2024-11-26,16:42:00,20948.5,SELL,3,0.02h,Break Even,$-1.50,$240.00,$112544.00,236,$240.00
2024-11-26,16:55:00,20961.0,BUY,3,0.02h,Stop Loss,$9.00,$249.00,$112553.00,236,$249.00
2024-11-26,17:07:00,20945.75,SELL,3,0.02h,Break Even,$-1.50,$247.50,$112551.50,236,$247.50
2024-11-26,17:11:00,20958.25,BUY,3,0.02h,Stop Loss,$-9.00,$238.50,$112542.50,236,$238.50
2024-11-26,17:13:00,20943.5,SELL,3,0.02h,Stop Loss,$7.50,$246.00,$112550.00,236,$246.00
2024-11-26,17:33:00,20947.0,BUY,3,0.02h,Stop Loss,$22.50,$268.50,$112572.50,236,$268.50
2024-11-26,18:11:00,20965.5,SELL,3,0.02h,Break Even,$-1.50,$267.00,$112571.00,236,$267.00
2024-11-26,18:34:00,20966.25,BUY,3,0.02h,Break Even,$-1.50,$265.50,$112569.50,236,$265.50
2024-11-26,18:37:00,20954.75,SELL,3,0.02h,Stop Loss,$3.00,$268.50,$112572.50,236,$268.50
2024-11-26,18:41:00,20966.75,BUY,3,0.02h,Stop Loss,$24.00,$292.50,$112596.50,236,$292.50
2024-11-26,18:58:00,20963.0,SELL,3,0.02h,Stop Loss,$-9.00,$283.50,$112587.50,236,$283.50
2024-11-26,18:59:00,20968.25,BUY,3,0.02h,Break Even,$-1.50,$282.00,$112586.00,236,$282.00
2024-11-26,19:08:00,20958.75,SELL,3,0.02h,Break Even,$-1.50,$280.50,$112584.50,236,$280.50
2024-11-26,19:41:00,20933.25,BUY,3,0.02h,Stop Loss,$30.00,$310.50,$112614.50,236,$310.50
2024-11-26,19:44:00,20925.75,SELL,3,0.02h,Stop Loss,$-9.00,$301.50,$112605.50,236,$301.50
2024-11-26,19:49:00,20935.0,BUY,3,0.02h,Break Even,$-1.50,$300.00,$112604.00,236,$300.00
2024-11-26,19:55:00,20925.75,SELL,3,0.02h,Break Even,$-1.50,$298.50,$112602.50,236,$298.50
2024-11-26,20:02:00,20936.75,BUY,3,0.02h,Break Even,$-1.50,$297.00,$112601.00,236,$297.00
2024-11-26,20:23:00,20938.5,SELL,3,0.02h,Break Even,$-1.50,$295.50,$112599.50,236,$295.50
2024-11-26,20:25:00,20945.0,BUY,3,0.02h,Stop Loss,$21.00,$316.50,$112620.50,236,$316.50
2024-11-26,21:33:00,20993.5,SELL,3,0.02h,Break Even,$-1.50,$315.00,$112619.00,236,$315.00
2024-11-26,21:38:00,21001.0,BUY,3,0.02h,Break Even,$-1.50,$313.50,$112617.50,236,$313.50
2024-11-26,23:01:00,20971.0,SELL,3,0.02h,Break Even,$-1.50,$312.00,$112616.00,236,$312.00
2024-11-26,23:15:00,20995.75,BUY,3,0.02h,Stop Loss,$-9.00,$303.00,$112607.00,236,$303.00
2024-11-26,23:16:00,20991.5,SELL,3,0.02h,Stop Loss,$-9.00,$294.00,$112598.00,236,$294.00
2024-11-26,23:17:00,20994.75,BUY,3,0.02h,Stop Loss,$-9.00,$285.00,$112589.00,236,$285.00
2024-11-26,23:18:00,20990.0,SELL,3,0.02h,Break Even,$-1.50,$283.50,$112587.50,236,$283.50
2024-11-26,23:35:00,20995.0,BUY,3,0.02h,Break Even,$-1.50,$282.00,$112586.00,236,$282.00
2024-11-26,23:42:00,20987.25,SELL,3,0.02h,Stop Loss,$-9.00,$273.00,$112577.00,236,$273.00
2024-11-26,23:48:00,20993.0,BUY,3,0.02h,Stop Loss,$-9.00,$264.00,$112568.00,236,$264.00
2024-11-26,23:52:00,20989.0,SELL,3,0.02h,Stop Loss,$-9.00,$255.00,$112559.00,236,$255.00
2024-11-26,23:53:00,20990.25,BUY,3,0.02h,Stop Loss,$-9.00,$246.00,$112550.00,236,$246.00
2024-11-26,23:54:00,20989.5,SELL,3,0.02h,Break Even,$-1.50,$244.50,$112548.50,236,$244.50
,,,,,,,,,,,
2024-11-27,00:36:00,20983.0,BUY,3,0.02h,Stop Loss,$-9.00,$-9.00,$112539.50,237,$-9.00
2024-11-27,00:44:00,20976.0,SELL,3,0.03h,Break Even,$-1.50,$-10.50,$112538.00,237,$-10.50
2024-11-27,00:53:00,20983.25,BUY,3,0.02h,Break Even,$-1.50,$-12.00,$112536.50,237,$-12.00
2024-11-27,01:29:00,20984.75,SELL,3,0.02h,Stop Loss,$-9.00,$-21.00,$112527.50,237,$-21.00
2024-11-27,01:34:00,20988.25,BUY,3,0.02h,Stop Loss,$-9.00,$-30.00,$112518.50,237,$-30.00
2024-11-27,01:35:00,20987.25,SELL,3,0.02h,Stop Loss,$-9.00,$-39.00,$112509.50,237,$-39.00
2024-11-27,01:36:00,20989.75,BUY,3,0.02h,Stop Loss,$-9.00,$-48.00,$112500.50,237,$-48.00
2024-11-27,02:56:00,21006.0,SELL,3,0.02h,Stop Loss,$-9.00,$-57.00,$112491.50,237,$-57.00
2024-11-27,05:30:00,20964.0,BUY,3,0.02h,Stop Loss,$-9.00,$-66.00,$112482.50,237,$-66.00
2024-11-27,05:50:00,20965.75,SELL,3,0.02h,Break Even,$-1.50,$-67.50,$112481.00,237,$-67.50
2024-11-27,06:11:00,20966.75,BUY,3,0.03h,Stop Loss,$-9.00,$-76.50,$112472.00,237,$-76.50
2024-11-27,06:38:00,20967.0,SELL,3,0.02h,Stop Loss,$-9.00,$-85.50,$112463.00,237,$-85.50
2024-11-27,06:43:00,20972.25,BUY,3,0.02h,Break Even,$-1.50,$-87.00,$112461.50,237,$-87.00
2024-11-27,07:00:00,20970.0,SELL,3,0.02h,Stop Loss,$-9.00,$-96.00,$112452.50,237,$-96.00
2024-11-27,07:06:00,20977.25,BUY,3,0.02h,Stop Loss,$-9.00,$-105.00,$112443.50,237,$-105.00
2024-11-27,07:49:00,20980.5,SELL,3,0.02h,Stop Loss,$-9.00,$-114.00,$112434.50,237,$-114.00
2024-11-27,07:56:00,20985.25,BUY,3,0.02h,Stop Loss,$-9.00,$-123.00,$112425.50,237,$-123.00
2024-11-27,07:57:00,20981.25,SELL,3,0.02h,Break Even,$-1.50,$-124.50,$112424.00,237,$-124.50
2024-11-27,09:03:00,20944.25,BUY,3,0.02h,Stop Loss,$13.50,$-111.00,$112437.50,237,$-111.00
2024-11-27,09:12:00,20935.0,SELL,3,0.02h,Stop Loss,$-9.00,$-120.00,$112428.50,237,$-120.00
2024-11-27,09:57:00,20921.5,BUY,3,0.02h,Stop Loss,$-9.00,$-129.00,$112419.50,237,$-129.00
2024-11-27,10:10:00,20913.25,SELL,3,0.02h,Break Even,$-1.50,$-130.50,$112418.00,237,$-130.50
2024-11-27,10:15:00,20921.75,BUY,3,0.02h,Stop Loss,$10.50,$-120.00,$112428.50,237,$-120.00
2024-11-27,10:45:00,20919.0,SELL,3,0.02h,Break Even,$-1.50,$-121.50,$112427.00,237,$-121.50
2024-11-27,10:55:00,20926.5,BUY,3,0.02h,Stop Loss,$15.00,$-106.50,$112442.00,237,$-106.50
2024-11-27,11:12:00,20923.5,SELL,3,0.02h,Stop Loss,$-9.00,$-115.50,$112433.00,237,$-115.50
2024-11-27,11:37:00,20922.25,BUY,3,0.02h,Stop Loss,$-9.00,$-124.50,$112424.00,237,$-124.50
2024-11-27,12:09:00,20924.25,SELL,3,0.02h,Break Even,$-1.50,$-126.00,$112422.50,237,$-126.00
2024-11-27,12:14:00,20929.75,BUY,3,0.02h,Stop Loss,$-9.00,$-135.00,$112413.50,237,$-135.00
2024-11-27,13:35:00,20947.0,SELL,3,0.02h,Stop Loss,$7.50,$-127.50,$112421.00,237,$-127.50
2024-11-27,13:44:00,20962.25,BUY,3,0.02h,Stop Loss,$-9.00,$-136.50,$112412.00,237,$-136.50
2024-11-27,13:48:00,20949.5,SELL,3,0.02h,Break Even,$-1.50,$-138.00,$112410.50,237,$-138.00
2024-11-27,13:55:00,20959.25,BUY,3,0.02h,Break Even,$-1.50,$-139.50,$112409.00,237,$-139.50
2024-11-27,13:59:00,20951.25,SELL,3,0.02h,Stop Loss,$-9.00,$-148.50,$112400.00,237,$-148.50
2024-11-27,14:18:00,20950.75,BUY,3,0.02h,Stop Loss,$-9.00,$-157.50,$112391.00,237,$-157.50
2024-11-27,14:25:00,20945.0,SELL,3,0.02h,Stop Loss,$-9.00,$-166.50,$112382.00,237,$-166.50
2024-11-27,14:27:00,20953.0,BUY,3,0.02h,Stop Loss,$-9.00,$-175.50,$112373.00,237,$-175.50
2024-11-27,14:28:00,20941.5,SELL,3,0.02h,Stop Loss,$31.50,$-144.00,$112404.50,237,$-144.00
2024-11-27,16:33:00,20736.75,BUY,3,0.02h,Break Even,$-1.50,$-145.50,$112403.00,237,$-145.50
2024-11-27,16:47:00,20714.25,SELL,3,0.02h,Stop Loss,$10.50,$-135.00,$112413.50,237,$-135.00
2024-11-27,17:20:00,20717.0,BUY,3,0.02h,Stop Loss,$30.00,$-105.00,$112443.50,237,$-105.00
2024-11-27,19:30:00,20801.5,SELL,3,0.02h,Break Even,$-1.50,$-106.50,$112442.00,237,$-106.50
2024-11-27,19:43:00,20810.25,BUY,3,0.02h,Stop Loss,$27.00,$-79.50,$112469.00,237,$-79.50
2024-11-27,20:00:00,20804.25,SELL,3,0.02h,Break Even,$-1.50,$-81.00,$112467.50,237,$-81.00
2024-11-27,20:05:00,20823.25,BUY,3,0.02h,Stop Loss,$19.50,$-61.50,$112487.00,237,$-61.50
2024-11-27,20:19:00,20808.5,SELL,3,0.02h,Stop Loss,$22.50,$-39.00,$112509.50,237,$-39.00
2024-11-27,20:50:00,20803.5,BUY,3,0.02h,Stop Loss,$39.00,$0.00,$112548.50,237,$0.00
2024-11-27,21:17:00,20803.0,SELL,3,0.02h,Stop Loss,$-9.00,$-9.00,$112539.50,237,$-9.00
2024-11-27,21:23:00,20811.0,BUY,3,0.02h,Break Even,$-1.50,$-10.50,$112538.00,237,$-10.50
2024-11-27,21:28:00,20806.5,SELL,3,0.02h,Stop Loss,$-9.00,$-19.50,$112529.00,237,$-19.50
2024-11-27,21:50:00,20806.25,BUY,3,0.02h,Stop Loss,$-9.00,$-28.50,$112520.00,237,$-28.50
2024-11-27,23:49:00,20823.0,SELL,3,0.02h,Stop Loss,$-9.00,$-37.50,$112511.00,237,$-37.50
2024-11-27,23:52:00,20825.5,BUY,3,0.02h,Break Even,$-1.50,$-39.00,$112509.50,237,$-39.00
2024-11-27,23:54:00,20820.25,SELL,3,0.02h,Stop Loss,$-9.00,$-48.00,$112500.50,237,$-48.00
,,,,,,,,,,,
2024-11-28,00:02:00,20824.75,BUY,3,0.02h,Break Even,$-1.50,$-1.50,$112499.00,238,$-1.50
2024-11-28,00:48:00,20845.25,SELL,3,0.02h,Stop Loss,$-9.00,$-10.50,$112490.00,238,$-10.50
2024-11-28,00:49:00,20847.25,BUY,3,0.02h,Stop Loss,$-9.00,$-19.50,$112481.00,238,$-19.50
2024-11-28,00:50:00,20843.5,SELL,3,0.02h,Break Even,$-1.50,$-21.00,$112479.50,238,$-21.00
2024-11-28,00:57:00,20846.75,BUY,3,0.03h,Stop Loss,$-9.00,$-30.00,$112470.50,238,$-30.00
2024-11-28,01:03:00,20843.75,SELL,3,0.02h,Break Even,$-1.50,$-31.50,$112469.00,238,$-31.50
2024-11-28,01:11:00,20848.75,BUY,3,0.02h,Stop Loss,$-9.00,$-40.50,$112460.00,238,$-40.50
2024-11-28,01:25:00,20843.75,SELL,3,0.02h,Stop Loss,$-9.00,$-49.50,$112451.00,238,$-49.50
2024-11-28,01:47:00,20847.75,BUY,3,0.02h,Stop Loss,$12.00,$-37.50,$112463.00,238,$-37.50
2024-11-28,01:56:00,20842.25,SELL,3,0.02h,Stop Loss,$9.00,$-28.50,$112472.00,238,$-28.50
2024-11-28,02:11:00,20845.25,BUY,3,0.02h,Stop Loss,$-9.00,$-37.50,$112463.00,238,$-37.50
2024-11-28,02:39:00,20844.0,SELL,3,0.02h,Break Even,$-1.50,$-39.00,$112461.50,238,$-39.00
2024-11-28,02:45:00,20846.25,BUY,3,0.03h,Break Even,$-1.50,$-40.50,$112460.00,238,$-40.50
2024-11-28,03:07:00,20845.75,SELL,3,0.03h,Stop Loss,$-9.00,$-49.50,$112451.00,238,$-49.50
2024-11-28,03:27:00,20848.75,BUY,3,0.02h,Stop Loss,$-9.00,$-58.50,$112442.00,238,$-58.50
2024-11-28,03:56:00,20850.75,SELL,3,0.02h,Stop Loss,$-9.00,$-67.50,$112433.00,238,$-67.50
2024-11-28,04:02:00,20854.75,BUY,3,0.02h,Stop Loss,$-9.00,$-76.50,$112424.00,238,$-76.50
2024-11-28,04:06:00,20852.0,SELL,3,0.02h,Break Even,$-1.50,$-78.00,$112422.50,238,$-78.00
2024-11-28,04:12:00,20854.5,BUY,3,0.02h,Stop Loss,$-9.00,$-87.00,$112413.50,238,$-87.00
2024-11-28,04:49:00,20855.75,SELL,3,0.02h,Stop Loss,$-9.00,$-96.00,$112404.50,238,$-96.00
2024-11-28,05:30:00,20855.0,BUY,3,0.03h,Stop Loss,$-9.00,$-105.00,$112395.50,238,$-105.00
2024-11-28,06:02:00,20854.75,SELL,3,0.02h,Break Even,$-1.50,$-106.50,$112394.00,238,$-106.50
2024-11-28,06:29:00,20857.0,BUY,3,0.03h,Stop Loss,$-9.00,$-115.50,$112385.00,238,$-115.50
2024-11-28,07:33:00,20862.5,SELL,3,0.02h,Stop Loss,$10.50,$-105.00,$112395.50,238,$-105.00
2024-11-28,07:50:00,20863.0,BUY,3,0.02h,Stop Loss,$-9.00,$-114.00,$112386.50,238,$-114.00
2024-11-28,08:09:00,20860.0,SELL,3,0.02h,Break Even,$-1.50,$-115.50,$112385.00,238,$-115.50
2024-11-28,08:38:00,20857.5,BUY,3,0.02h,Stop Loss,$-9.00,$-124.50,$112376.00,238,$-124.50
2024-11-28,08:46:00,20854.25,SELL,3,0.02h,Stop Loss,$-9.00,$-133.50,$112367.00,238,$-133.50
2024-11-28,09:01:00,20856.5,BUY,3,0.02h,Break Even,$-1.50,$-135.00,$112365.50,238,$-135.00
2024-11-28,09:10:00,20851.25,SELL,3,0.02h,Break Even,$-1.50,$-136.50,$112364.00,238,$-136.50
2024-11-28,09:19:00,20853.75,BUY,3,0.03h,Break Even,$-1.50,$-138.00,$112362.50,238,$-138.00
2024-11-28,09:50:00,20855.5,SELL,3,0.02h,Stop Loss,$-9.00,$-147.00,$112353.50,238,$-147.00
2024-11-28,09:55:00,20858.25,BUY,3,0.02h,Stop Loss,$-9.00,$-156.00,$112344.50,238,$-156.00
2024-11-28,10:05:00,20854.75,SELL,3,0.02h,Stop Loss,$-9.00,$-165.00,$112335.50,238,$-165.00
2024-11-28,10:12:00,20858.25,BUY,3,0.03h,Stop Loss,$-9.00,$-174.00,$112326.50,238,$-174.00
2024-11-28,10:25:00,20856.75,SELL,3,0.02h,Break Even,$-1.50,$-175.50,$112325.00,238,$-175.50
2024-11-28,10:46:00,20857.0,BUY,3,0.02h,Break Even,$-1.50,$-177.00,$112323.50,238,$-177.00
2024-11-28,11:17:00,20857.75,SELL,3,0.02h,Stop Loss,$-9.00,$-186.00,$112314.50,238,$-186.00
2024-11-28,11:49:00,20854.5,BUY,3,0.03h,Break Even,$-1.50,$-187.50,$112313.00,238,$-187.50
2024-11-28,13:19:00,20869.75,SELL,3,0.02h,Break Even,$-1.50,$-189.00,$112311.50,238,$-189.00
2024-11-28,13:41:00,20872.25,BUY,3,0.03h,Break Even,$-1.50,$-190.50,$112310.00,238,$-190.50
2024-11-28,14:02:00,20871.5,SELL,3,0.02h,Stop Loss,$3.00,$-187.50,$112313.00,238,$-187.50
2024-11-28,14:16:00,20874.0,BUY,3,0.02h,Break Even,$-1.50,$-189.00,$112311.50,238,$-189.00
2024-11-28,15:11:00,20885.5,SELL,3,0.02h,Stop Loss,$-9.00,$-198.00,$112302.50,238,$-198.00
2024-11-28,15:19:00,20894.75,BUY,3,0.02h,Break Even,$-1.50,$-199.50,$112301.00,238,$-199.50
2024-11-28,15:38:00,20889.25,SELL,3,0.02h,Break Even,$-1.50,$-201.00,$112299.50,238,$-201.00
2024-11-28,15:46:00,20898.25,BUY,3,0.02h,Break Even,$-1.50,$-202.50,$112298.00,238,$-202.50
2024-11-28,16:25:00,20901.0,SELL,3,0.02h,Break Even,$-1.50,$-204.00,$112296.50,238,$-204.00
2024-11-28,17:03:00,20888.25,BUY,3,0.02h,Break Even,$-1.50,$-205.50,$112295.00,238,$-205.50
2024-11-28,17:47:00,20888.25,SELL,3,0.02h,Stop Loss,$10.50,$-195.00,$112305.50,238,$-195.00
2024-11-28,23:24:00,20883.75,BUY,3,0.02h,Break Even,$-1.50,$-196.50,$112304.00,238,$-196.50
2024-11-28,23:35:00,20881.5,SELL,3,0.02h,Break Even,$-1.50,$-198.00,$112302.50,238,$-198.00
2024-11-28,23:40:00,20884.75,BUY,3,0.02h,Stop Loss,$3.00,$-195.00,$112305.50,238,$-195.00
2024-11-28,23:49:00,20881.5,SELL,3,0.03h,Stop Loss,$-9.00,$-204.00,$112296.50,238,$-204.00
2024-11-28,23:54:00,20885.0,BUY,3,0.02h,Break Even,$-1.50,$-205.50,$112295.00,238,$-205.50
,,,,,,,,,,,
2024-11-29,00:04:00,20882.0,SELL,3,0.02h,Stop Loss,$10.50,$10.50,$112305.50,239,$10.50
2024-11-29,01:17:00,20845.5,BUY,3,0.02h,Break Even,$-1.50,$9.00,$112304.00,239,$9.00
2024-11-29,02:47:00,20889.0,SELL,3,0.02h,Stop Loss,$-9.00,$0.00,$112295.00,239,$0.00
2024-11-29,02:55:00,20896.5,BUY,3,0.02h,Stop Loss,$-9.00,$-9.00,$112286.00,239,$-9.00
2024-11-29,03:40:00,20907.75,SELL,3,0.02h,Break Even,$-1.50,$-10.50,$112284.50,239,$-10.50
2024-11-29,03:56:00,20915.0,BUY,3,0.02h,Stop Loss,$-9.00,$-19.50,$112275.50,239,$-19.50
2024-11-29,04:34:00,20925.5,SELL,3,0.02h,Stop Loss,$-9.00,$-28.50,$112266.50,239,$-28.50
2024-11-29,04:48:00,20928.0,BUY,3,0.03h,Break Even,$-1.50,$-30.00,$112265.00,239,$-30.00
2024-11-29,04:52:00,20924.5,SELL,3,0.02h,Stop Loss,$-9.00,$-39.00,$112256.00,239,$-39.00
2024-11-29,04:57:00,20930.25,BUY,3,0.03h,Break Even,$-1.50,$-40.50,$112254.50,239,$-40.50
2024-11-29,05:07:00,20924.5,SELL,3,0.02h,Stop Loss,$-9.00,$-49.50,$112245.50,239,$-49.50
2024-11-29,06:32:00,20908.25,BUY,3,0.02h,Stop Loss,$-9.00,$-58.50,$112236.50,239,$-58.50
2024-11-29,06:51:00,20903.0,SELL,3,0.02h,Break Even,$-1.50,$-60.00,$112235.00,239,$-60.00
2024-11-29,07:00:00,20906.25,BUY,3,0.02h,Break Even,$-1.50,$-61.50,$112233.50,239,$-61.50
2024-11-29,07:02:00,20898.5,SELL,3,0.02h,Stop Loss,$24.00,$-37.50,$112257.50,239,$-37.50
2024-11-29,07:45:00,20879.0,BUY,3,0.02h,Break Even,$-1.50,$-39.00,$112256.00,239,$-39.00
2024-11-29,08:16:00,20885.25,SELL,3,0.02h,Stop Loss,$-9.00,$-48.00,$112247.00,239,$-48.00
2024-11-29,08:26:00,20898.0,BUY,3,0.02h,Stop Loss,$-9.00,$-57.00,$112238.00,239,$-57.00
2024-11-29,08:45:00,20889.25,SELL,3,0.02h,Stop Loss,$-9.00,$-66.00,$112229.00,239,$-66.00
2024-11-29,08:52:00,20901.0,BUY,3,0.02h,Break Even,$-1.50,$-67.50,$112227.50,239,$-67.50
2024-11-29,09:34:00,20898.75,SELL,3,0.02h,Break Even,$-1.50,$-69.00,$112226.00,239,$-69.00
2024-11-29,09:40:00,20907.75,BUY,3,0.02h,Stop Loss,$-9.00,$-78.00,$112217.00,239,$-78.00
2024-11-29,09:44:00,20902.0,SELL,3,0.02h,Stop Loss,$6.00,$-72.00,$112223.00,239,$-72.00
2024-11-29,10:14:00,20903.75,BUY,3,0.02h,Stop Loss,$-9.00,$-81.00,$112214.00,239,$-81.00
2024-11-29,10:27:00,20893.75,SELL,3,0.02h,Break Even,$-1.50,$-82.50,$112212.50,239,$-82.50
2024-11-29,10:52:00,20896.25,BUY,3,0.02h,Break Even,$-1.50,$-84.00,$112211.00,239,$-84.00
2024-11-29,11:02:00,20890.75,SELL,3,0.02h,Break Even,$-1.50,$-85.50,$112209.50,239,$-85.50
2024-11-29,11:30:00,20886.25,BUY,3,0.02h,Break Even,$-1.50,$-87.00,$112208.00,239,$-87.00
2024-11-29,11:41:00,20882.5,SELL,3,0.02h,Break Even,$-1.50,$-88.50,$112206.50,239,$-88.50
2024-11-29,11:46:00,20889.0,BUY,3,0.02h,Stop Loss,$-9.00,$-97.50,$112197.50,239,$-97.50
2024-11-29,11:55:00,20882.0,SELL,3,0.02h,Stop Loss,$-9.00,$-106.50,$112188.50,239,$-106.50
2024-11-29,11:59:00,20887.25,BUY,3,0.02h,Stop Loss,$-9.00,$-115.50,$112179.50,239,$-115.50
2024-11-29,12:00:00,20884.5,SELL,3,0.02h,Stop Loss,$19.50,$-96.00,$112199.00,239,$-96.00
2024-11-29,13:10:00,20860.0,BUY,3,0.02h,Break Even,$-1.50,$-97.50,$112197.50,239,$-97.50
2024-11-29,13:17:00,20845.75,SELL,3,0.02h,Break Even,$-1.50,$-99.00,$112196.00,239,$-99.00
2024-11-29,14:02:00,20842.0,BUY,3,0.02h,Stop Loss,$6.00,$-93.00,$112202.00,239,$-93.00
2024-11-29,14:29:00,20828.0,SELL,3,0.02h,Stop Loss,$15.00,$-78.00,$112217.00,239,$-78.00
2024-11-29,14:40:00,20865.25,BUY,3,0.02h,Stop Loss,$-9.00,$-87.00,$112208.00,239,$-87.00
2024-11-29,15:50:00,20943.5,SELL,3,0.02h,Stop Loss,$21.00,$-66.00,$112229.00,239,$-66.00
2024-11-29,16:02:00,20965.5,BUY,3,0.02h,Stop Loss,$18.00,$-48.00,$112247.00,239,$-48.00
2024-11-29,16:36:00,20976.0,SELL,3,0.02h,Stop Loss,$25.50,$-22.50,$112272.50,239,$-22.50
2024-11-29,16:45:00,20986.0,BUY,3,0.02h,Break Even,$-1.50,$-24.00,$112271.00,239,$-24.00
2024-11-29,17:03:00,20983.0,SELL,3,0.02h,Stop Loss,$-9.00,$-33.00,$112262.00,239,$-33.00
2024-11-29,17:09:00,20996.0,BUY,3,0.02h,Stop Loss,$12.00,$-21.00,$112274.00,239,$-21.00
2024-11-29,17:15:00,20991.0,SELL,3,0.02h,Break Even,$-1.50,$-22.50,$112272.50,239,$-22.50
2024-11-29,17:16:00,20996.75,BUY,3,0.02h,Break Even,$-1.50,$-24.00,$112271.00,239,$-24.00
2024-11-29,17:28:00,20984.25,SELL,3,0.02h,Stop Loss,$4.50,$-19.50,$112275.50,239,$-19.50
2024-11-29,17:34:00,21000.75,BUY,3,0.02h,Stop Loss,$4.50,$-15.00,$112280.00,239,$-15.00
2024-11-29,17:47:00,20993.25,SELL,3,0.02h,Stop Loss,$7.50,$-7.50,$112287.50,239,$-7.50
2024-11-29,17:51:00,21015.25,BUY,3,0.02h,Break Even,$-1.50,$-9.00,$112286.00,239,$-9.00
2024-11-29,18:00:00,20991.25,SELL,3,0.02h,Stop Loss,$7.50,$-1.50,$112293.50,239,$-1.50
,,,,,,,,,,,
2024-12-02,00:26:00,20980.25,BUY,3,0.02h,Stop Loss,$-9.00,$-9.00,$112284.50,240,$-9.00
2024-12-02,00:30:00,20970.5,SELL,3,0.02h,Stop Loss,$-9.00,$-18.00,$112275.50,240,$-18.00
2024-12-02,00:57:00,20959.75,BUY,3,0.02h,Break Even,$-1.50,$-19.50,$112274.00,240,$-19.50
2024-12-02,01:02:00,20954.25,SELL,3,0.02h,Break Even,$-1.50,$-21.00,$112272.50,240,$-21.00
2024-12-02,01:10:00,20961.75,BUY,3,0.02h,Stop Loss,$22.50,$1.50,$112295.00,240,$1.50
2024-12-02,01:22:00,20957.25,SELL,3,0.02h,Stop Loss,$3.00,$4.50,$112298.00,240,$4.50
2024-12-02,01:28:00,20963.25,BUY,3,0.02h,Stop Loss,$-9.00,$-4.50,$112289.00,240,$-4.50
2024-12-02,01:52:00,20964.0,SELL,3,0.02h,Stop Loss,$-9.00,$-13.50,$112280.00,240,$-13.50
2024-12-02,02:20:00,20960.0,BUY,3,0.02h,Break Even,$-1.50,$-15.00,$112278.50,240,$-15.00
2024-12-02,02:24:00,20954.5,SELL,3,0.02h,Stop Loss,$-9.00,$-24.00,$112269.50,240,$-24.00
2024-12-02,02:31:00,20958.0,BUY,3,0.02h,Stop Loss,$-9.00,$-33.00,$112260.50,240,$-33.00
2024-12-02,02:33:00,20954.75,SELL,3,0.02h,Break Even,$-1.50,$-34.50,$112259.00,240,$-34.50
2024-12-02,02:50:00,20958.75,BUY,3,0.02h,Stop Loss,$-9.00,$-43.50,$112250.00,240,$-43.50
2024-12-02,02:58:00,20954.25,SELL,3,0.03h,Break Even,$-1.50,$-45.00,$112248.50,240,$-45.00
2024-12-02,03:03:00,20956.5,BUY,3,0.02h,Stop Loss,$-9.00,$-54.00,$112239.50,240,$-54.00
2024-12-02,03:04:00,20955.0,SELL,3,0.02h,Break Even,$-1.50,$-55.50,$112238.00,240,$-55.50
2024-12-02,03:19:00,20957.75,BUY,3,0.02h,Stop Loss,$-9.00,$-64.50,$112229.00,240,$-64.50
2024-12-02,03:50:00,20956.25,SELL,3,0.02h,Stop Loss,$-9.00,$-73.50,$112220.00,240,$-73.50
2024-12-02,04:06:00,20957.0,BUY,3,0.02h,Stop Loss,$-9.00,$-82.50,$112211.00,240,$-82.50
2024-12-02,04:07:00,20953.25,SELL,3,0.02h,Break Even,$-1.50,$-84.00,$112209.50,240,$-84.00
2024-12-02,04:28:00,20953.75,BUY,3,0.02h,Break Even,$-1.50,$-85.50,$112208.00,240,$-85.50
2024-12-02,04:55:00,20954.25,SELL,3,0.02h,Stop Loss,$-9.00,$-94.50,$112199.00,240,$-94.50
2024-12-02,05:06:00,20962.5,BUY,3,0.02h,Stop Loss,$-9.00,$-103.50,$112190.00,240,$-103.50
2024-12-02,05:17:00,20958.0,SELL,3,0.02h,Break Even,$-1.50,$-105.00,$112188.50,240,$-105.00
2024-12-02,05:35:00,20958.25,BUY,3,0.02h,Stop Loss,$-9.00,$-114.00,$112179.50,240,$-114.00
2024-12-02,05:59:00,20956.25,SELL,3,0.02h,Break Even,$-1.50,$-115.50,$112178.00,240,$-115.50
2024-12-02,06:51:00,20947.5,BUY,3,0.02h,Stop Loss,$-9.00,$-124.50,$112169.00,240,$-124.50
2024-12-02,07:17:00,20948.75,SELL,3,0.02h,Stop Loss,$-9.00,$-133.50,$112160.00,240,$-133.50
2024-12-02,07:27:00,20954.25,BUY,3,0.02h,Break Even,$-1.50,$-135.00,$112158.50,240,$-135.00
2024-12-02,07:33:00,20948.25,SELL,3,0.02h,Stop Loss,$-9.00,$-144.00,$112149.50,240,$-144.00
2024-12-02,07:41:00,20953.5,BUY,3,0.02h,Stop Loss,$-9.00,$-153.00,$112140.50,240,$-153.00
2024-12-02,08:14:00,20956.5,SELL,3,0.02h,Break Even,$-1.50,$-154.50,$112139.00,240,$-154.50
2024-12-02,08:20:00,20963.25,BUY,3,0.02h,Stop Loss,$-9.00,$-163.50,$112130.00,240,$-163.50
2024-12-02,08:23:00,20958.25,SELL,3,0.02h,Break Even,$-1.50,$-165.00,$112128.50,240,$-165.00
2024-12-02,08:25:00,20962.5,BUY,3,0.02h,Stop Loss,$-9.00,$-174.00,$112119.50,240,$-174.00
2024-12-02,08:28:00,20958.0,SELL,3,0.02h,Break Even,$-1.50,$-175.50,$112118.00,240,$-175.50
2024-12-02,08:44:00,20960.25,BUY,3,0.02h,Break Even,$-1.50,$-177.00,$112116.50,240,$-177.00
2024-12-02,09:07:00,20958.5,SELL,3,0.02h,Break Even,$-1.50,$-178.50,$112115.00,240,$-178.50
2024-12-02,09:12:00,20968.0,BUY,3,0.02h,Stop Loss,$-9.00,$-187.50,$112106.00,240,$-187.50
2024-12-02,09:31:00,20962.25,SELL,3,0.03h,Stop Loss,$-9.00,$-196.50,$112097.00,240,$-196.50
2024-12-02,10:17:00,20955.5,BUY,3,0.02h,Stop Loss,$6.00,$-190.50,$112103.00,240,$-190.50
2024-12-02,10:42:00,20953.75,SELL,3,0.02h,Stop Loss,$-9.00,$-199.50,$112094.00,240,$-199.50
2024-12-02,11:03:00,20955.25,BUY,3,0.03h,Break Even,$-1.50,$-201.00,$112092.50,240,$-201.00
2024-12-02,11:08:00,20951.25,SELL,3,0.02h,Break Even,$-1.50,$-202.50,$112091.00,240,$-202.50
2024-12-02,11:15:00,20954.25,BUY,3,0.02h,Break Even,$-1.50,$-204.00,$112089.50,240,$-204.00
2024-12-02,11:35:00,20953.75,SELL,3,0.02h,Break Even,$-1.50,$-205.50,$112088.00,240,$-205.50
2024-12-02,11:40:00,20959.25,BUY,3,0.02h,Stop Loss,$9.00,$-196.50,$112097.00,240,$-196.50
2024-12-02,13:41:00,21021.0,SELL,3,0.02h,Stop Loss,$42.00,$-154.50,$112139.00,240,$-154.50
2024-12-02,13:59:00,21024.75,BUY,3,0.02h,Break Even,$-1.50,$-156.00,$112137.50,240,$-156.00
2024-12-02,14:27:00,21027.75,SELL,3,0.02h,Stop Loss,$-9.00,$-165.00,$112128.50,240,$-165.00
2024-12-02,14:30:00,21043.0,BUY,3,0.02h,Stop Loss,$100.50,$-64.50,$112229.00,240,$-64.50
2024-12-02,15:49:00,21181.0,SELL,3,0.02h,Stop Loss,$12.00,$-52.50,$112241.00,240,$-52.50
2024-12-02,16:08:00,21181.5,BUY,3,0.02h,Break Even,$-1.50,$-54.00,$112239.50,240,$-54.00
2024-12-02,16:26:00,21177.25,SELL,3,0.02h,Stop Loss,$-9.00,$-63.00,$112230.50,240,$-63.00
2024-12-02,16:27:00,21183.75,BUY,3,0.02h,Break Even,$-1.50,$-64.50,$112229.00,240,$-64.50
2024-12-02,17:30:00,21233.5,SELL,3,0.02h,Stop Loss,$27.00,$-37.50,$112256.00,240,$-37.50
2024-12-02,17:47:00,21244.5,BUY,3,0.02h,Stop Loss,$-9.00,$-46.50,$112247.00,240,$-46.50
2024-12-02,17:55:00,21235.5,SELL,3,0.02h,Break Even,$-1.50,$-48.00,$112245.50,240,$-48.00
2024-12-02,18:25:00,21232.75,BUY,3,0.02h,Stop Loss,$-9.00,$-57.00,$112236.50,240,$-57.00
2024-12-02,18:30:00,21212.25,SELL,3,0.02h,Stop Loss,$73.50,$16.50,$112310.00,240,$16.50
2024-12-02,18:43:00,21221.5,BUY,3,0.02h,Break Even,$-1.50,$15.00,$112308.50,240,$15.00
2024-12-02,18:54:00,21211.25,SELL,3,0.02h,Break Even,$-1.50,$13.50,$112307.00,240,$13.50
2024-12-02,19:33:00,21198.75,BUY,3,0.02h,Stop Loss,$-9.00,$4.50,$112298.00,240,$4.50
2024-12-02,20:45:00,21224.0,SELL,3,0.02h,Break Even,$-1.50,$3.00,$112296.50,240,$3.00
2024-12-02,21:07:00,21225.5,BUY,3,0.02h,Break Even,$-1.50,$1.50,$112295.00,240,$1.50
2024-12-02,21:30:00,21225.0,SELL,3,0.02h,Break Even,$-1.50,$0.00,$112293.50,240,$0.00
2024-12-02,21:40:00,21229.0,BUY,3,0.02h,Stop Loss,$-9.00,$-9.00,$112284.50,240,$-9.00
2024-12-02,21:43:00,21218.0,SELL,3,0.02h,Stop Loss,$19.50,$10.50,$112304.00,240,$10.50
2024-12-02,23:17:00,21216.25,BUY,3,0.02h,Stop Loss,$-9.00,$1.50,$112295.00,240,$1.50
2024-12-02,23:40:00,21210.5,SELL,3,0.02h,Stop Loss,$-9.00,$-7.50,$112286.00,240,$-7.50
2024-12-02,23:54:00,21217.0,BUY,3,0.02h,Stop Loss,$-9.00,$-16.50,$112277.00,240,$-16.50
,,,,,,,,,,,
2024-12-03,00:20:00,21212.75,SELL,3,0.02h,Stop Loss,$-9.00,$-9.00,$112268.00,241,$-9.00
2024-12-03,00:53:00,21212.5,BUY,3,0.02h,Stop Loss,$-9.00,$-18.00,$112259.00,241,$-18.00
2024-12-03,00:54:00,21209.25,SELL,3,0.02h,Stop Loss,$-9.00,$-27.00,$112250.00,241,$-27.00
2024-12-03,00:57:00,21212.75,BUY,3,0.02h,Stop Loss,$-9.00,$-36.00,$112241.00,241,$-36.00
2024-12-03,01:01:00,21206.0,SELL,3,0.02h,Break Even,$-1.50,$-37.50,$112239.50,241,$-37.50
2024-12-03,01:13:00,21212.5,BUY,3,0.02h,Break Even,$-1.50,$-39.00,$112238.00,241,$-39.00
2024-12-03,01:57:00,21218.25,SELL,3,0.02h,Break Even,$-1.50,$-40.50,$112236.50,241,$-40.50
2024-12-03,02:37:00,21219.5,BUY,3,0.02h,Stop Loss,$-9.00,$-49.50,$112227.50,241,$-49.50
2024-12-03,03:57:00,21229.5,SELL,3,0.02h,Stop Loss,$-9.00,$-58.50,$112218.50,241,$-58.50
2024-12-03,04:05:00,21234.75,BUY,3,0.03h,Break Even,$-1.50,$-60.00,$112217.00,241,$-60.00
2024-12-03,04:31:00,21232.5,SELL,3,0.10h,Stop Loss,$15.00,$-45.00,$112232.00,241,$-45.00
2024-12-03,05:20:00,21226.75,BUY,3,0.17h,Stop Loss,$3.00,$-42.00,$112235.00,241,$-42.00
2024-12-03,06:21:00,21231.5,SELL,3,0.02h,Stop Loss,$-9.00,$-51.00,$112226.00,241,$-51.00
2024-12-03,06:38:00,21233.75,BUY,3,0.02h,Stop Loss,$-9.00,$-60.00,$112217.00,241,$-60.00
2024-12-03,06:43:00,21229.75,SELL,3,0.02h,Break Even,$-1.50,$-61.50,$112215.50,241,$-61.50
2024-12-03,07:13:00,21229.75,BUY,3,0.02h,Break Even,$-1.50,$-63.00,$112214.00,241,$-63.00
2024-12-03,07:41:00,21226.75,SELL,3,0.02h,Stop Loss,$-9.00,$-72.00,$112205.00,241,$-72.00
2024-12-03,08:02:00,21233.0,BUY,3,0.02h,Break Even,$-1.50,$-73.50,$112203.50,241,$-73.50
2024-12-03,08:15:00,21218.5,SELL,3,0.02h,Stop Loss,$-9.00,$-82.50,$112194.50,241,$-82.50
2024-12-03,08:45:00,21222.0,BUY,3,0.02h,Stop Loss,$-9.00,$-91.50,$112185.50,241,$-91.50
2024-12-03,08:53:00,21215.0,SELL,3,0.02h,Break Even,$-1.50,$-93.00,$112184.00,241,$-93.00
2024-12-03,09:11:00,21221.5,BUY,3,0.02h,Break Even,$-1.50,$-94.50,$112182.50,241,$-94.50
2024-12-03,09:24:00,21217.5,SELL,3,0.02h,Break Even,$-1.50,$-96.00,$112181.00,241,$-96.00
2024-12-03,09:26:00,21220.5,BUY,3,0.02h,Stop Loss,$-9.00,$-105.00,$112172.00,241,$-105.00
2024-12-03,09:27:00,21214.25,SELL,3,0.02h,Stop Loss,$-9.00,$-114.00,$112163.00,241,$-114.00
2024-12-03,09:54:00,21216.75,BUY,3,0.02h,Stop Loss,$-9.00,$-123.00,$112154.00,241,$-123.00
2024-12-03,10:05:00,21214.75,SELL,3,0.03h,Stop Loss,$-9.00,$-132.00,$112145.00,241,$-132.00
2024-12-03,10:14:00,21217.75,BUY,3,0.02h,Break Even,$-1.50,$-133.50,$112143.50,241,$-133.50
2024-12-03,10:28:00,21215.25,SELL,3,0.02h,Break Even,$-1.50,$-135.00,$112142.00,241,$-135.00
2024-12-03,11:22:00,21204.25,BUY,3,0.02h,Stop Loss,$-9.00,$-144.00,$112133.00,241,$-144.00
2024-12-03,11:28:00,21193.5,SELL,3,0.02h,Stop Loss,$-9.00,$-153.00,$112124.00,241,$-153.00
2024-12-03,11:38:00,21203.0,BUY,3,0.02h,Stop Loss,$-9.00,$-162.00,$112115.00,241,$-162.00
2024-12-03,12:12:00,21198.0,SELL,3,0.02h,Break Even,$-1.50,$-163.50,$112113.50,241,$-163.50
2024-12-03,12:25:00,21209.0,BUY,3,0.02h,Stop Loss,$-9.00,$-172.50,$112104.50,241,$-172.50
2024-12-03,12:50:00,21209.5,SELL,3,0.02h,Stop Loss,$-9.00,$-181.50,$112095.50,241,$-181.50
2024-12-03,13:09:00,21213.25,BUY,3,0.02h,Stop Loss,$-9.00,$-190.50,$112086.50,241,$-190.50
2024-12-03,13:10:00,21207.75,SELL,3,0.02h,Stop Loss,$-9.00,$-199.50,$112077.50,241,$-199.50
2024-12-03,13:11:00,21211.0,BUY,3,0.02h,Break Even,$-1.50,$-201.00,$112076.00,241,$-201.00
2024-12-03,13:19:00,21204.75,SELL,3,0.02h,Stop Loss,$-9.00,$-210.00,$112067.00,241,$-210.00
2024-12-03,13:26:00,21213.0,BUY,3,0.02h,Stop Loss,$-9.00,$-219.00,$112058.00,241,$-219.00
2024-12-03,13:28:00,21208.5,SELL,3,0.02h,Stop Loss,$-9.00,$-228.00,$112049.00,241,$-228.00
2024-12-03,13:29:00,21209.75,BUY,3,0.02h,Break Even,$-1.50,$-229.50,$112047.50,241,$-229.50
2024-12-03,13:30:00,21207.0,SELL,3,0.02h,Break Even,$-1.50,$-231.00,$112046.00,241,$-231.00
2024-12-03,13:36:00,21211.25,BUY,3,0.02h,Stop Loss,$-9.00,$-240.00,$112037.00,241,$-240.00
2024-12-03,13:57:00,21209.0,SELL,3,0.02h,Stop Loss,$19.50,$-220.50,$112056.50,241,$-220.50
2024-12-03,14:36:00,21186.0,BUY,3,0.02h,Stop Loss,$36.00,$-184.50,$112092.50,241,$-184.50
2024-12-03,15:21:00,21188.5,SELL,3,0.02h,Stop Loss,$27.00,$-157.50,$112119.50,241,$-157.50
2024-12-03,15:37:00,21207.0,BUY,3,0.02h,Stop Loss,$-9.00,$-166.50,$112110.50,241,$-166.50
2024-12-03,15:43:00,21192.75,SELL,3,0.02h,Stop Loss,$28.50,$-138.00,$112139.00,241,$-138.00
2024-12-03,16:00:00,21207.5,BUY,3,0.02h,Stop Loss,$10.50,$-127.50,$112149.50,241,$-127.50
2024-12-03,16:38:00,21216.5,SELL,3,0.02h,Stop Loss,$3.00,$-124.50,$112152.50,241,$-124.50
2024-12-03,16:55:00,21223.75,BUY,3,0.02h,Break Even,$-1.50,$-126.00,$112151.00,241,$-126.00
2024-12-03,16:58:00,21217.0,SELL,3,0.02h,Stop Loss,$18.00,$-108.00,$112169.00,241,$-108.00
2024-12-03,17:23:00,21215.0,BUY,3,0.02h,Stop Loss,$-9.00,$-117.00,$112160.00,241,$-117.00
2024-12-03,17:25:00,21206.25,SELL,3,0.02h,Break Even,$-1.50,$-118.50,$112158.50,241,$-118.50
2024-12-03,17:45:00,21208.75,BUY,3,0.02h,Stop Loss,$10.50,$-108.00,$112169.00,241,$-108.00
2024-12-03,18:30:00,21227.5,SELL,3,0.02h,Stop Loss,$4.50,$-103.50,$112173.50,241,$-103.50
2024-12-03,18:54:00,21235.25,BUY,3,0.02h,Break Even,$-1.50,$-105.00,$112172.00,241,$-105.00
2024-12-03,19:05:00,21226.75,SELL,3,0.02h,Break Even,$-1.50,$-106.50,$112170.50,241,$-106.50
2024-12-03,19:10:00,21233.75,BUY,3,0.02h,Stop Loss,$-9.00,$-115.50,$112161.50,241,$-115.50
2024-12-03,19:17:00,21226.25,SELL,3,0.02h,Break Even,$-1.50,$-117.00,$112160.00,241,$-117.00
2024-12-03,19:19:00,21232.75,BUY,3,0.02h,Break Even,$-1.50,$-118.50,$112158.50,241,$-118.50
2024-12-03,20:19:00,21250.75,SELL,3,0.02h,Stop Loss,$-9.00,$-127.50,$112149.50,241,$-127.50
2024-12-03,20:21:00,21257.0,BUY,3,0.02h,Break Even,$-1.50,$-129.00,$112148.00,241,$-129.00
2024-12-03,20:33:00,21251.0,SELL,3,0.02h,Stop Loss,$-9.00,$-138.00,$112139.00,241,$-138.00
2024-12-03,20:50:00,21256.0,BUY,3,0.02h,Stop Loss,$42.00,$-96.00,$112181.00,241,$-96.00
2024-12-03,23:01:00,21311.25,SELL,3,0.02h,Stop Loss,$6.00,$-90.00,$112187.00,241,$-90.00
2024-12-03,23:24:00,21318.5,BUY,3,0.02h,Stop Loss,$-9.00,$-99.00,$112178.00,241,$-99.00
,,,,,,,,,,,
2024-12-04,00:11:00,21328.25,SELL,3,0.02h,Stop Loss,$-9.00,$-9.00,$112169.00,242,$-9.00
2024-12-04,00:50:00,21326.0,BUY,3,0.02h,Break Even,$-1.50,$-10.50,$112167.50,242,$-10.50
2024-12-04,01:02:00,21321.25,SELL,3,0.02h,Stop Loss,$-9.00,$-19.50,$112158.50,242,$-19.50
2024-12-04,01:14:00,21323.25,BUY,3,0.02h,Break Even,$-1.50,$-21.00,$112157.00,242,$-21.00
2024-12-04,01:33:00,21324.5,SELL,3,0.02h,Break Even,$-1.50,$-22.50,$112155.50,242,$-22.50
2024-12-04,01:40:00,21328.0,BUY,3,0.02h,Stop Loss,$-9.00,$-31.50,$112146.50,242,$-31.50
2024-12-04,01:41:00,21322.25,SELL,3,0.02h,Stop Loss,$-9.00,$-40.50,$112137.50,242,$-40.50
2024-12-04,01:44:00,21327.0,BUY,3,0.02h,Stop Loss,$-9.00,$-49.50,$112128.50,242,$-49.50
2024-12-04,01:45:00,21326.0,SELL,3,0.02h,Break Even,$-1.50,$-51.00,$112127.00,242,$-51.00
2024-12-04,01:52:00,21329.0,BUY,3,0.02h,Stop Loss,$-9.00,$-60.00,$112118.00,242,$-60.00
2024-12-04,01:59:00,21323.0,SELL,3,0.02h,Stop Loss,$-9.00,$-69.00,$112109.00,242,$-69.00
2024-12-04,02:03:00,21327.0,BUY,3,0.02h,Stop Loss,$-9.00,$-78.00,$112100.00,242,$-78.00
2024-12-04,02:44:00,21327.5,SELL,3,0.02h,Stop Loss,$-9.00,$-87.00,$112091.00,242,$-87.00
2024-12-04,02:48:00,21330.0,BUY,3,0.05h,Break Even,$-1.50,$-88.50,$112089.50,242,$-88.50
2024-12-04,03:22:00,21329.25,SELL,3,0.03h,Stop Loss,$-9.00,$-97.50,$112080.50,242,$-97.50
2024-12-04,03:38:00,21337.25,BUY,3,0.02h,Break Even,$-1.50,$-99.00,$112079.00,242,$-99.00
2024-12-04,05:12:00,21346.5,SELL,3,0.02h,Stop Loss,$-9.00,$-108.00,$112070.00,242,$-108.00
2024-12-04,05:18:00,21351.0,BUY,3,0.02h,Break Even,$-1.50,$-109.50,$112068.50,242,$-109.50
2024-12-04,05:54:00,21358.75,SELL,3,0.02h,Break Even,$-1.50,$-111.00,$112067.00,242,$-111.00
2024-12-04,06:47:00,21347.75,BUY,3,0.03h,Break Even,$-1.50,$-112.50,$112065.50,242,$-112.50
2024-12-04,07:22:00,21350.5,SELL,3,0.02h,Stop Loss,$-9.00,$-121.50,$112056.50,242,$-121.50
2024-12-04,07:45:00,21355.5,BUY,3,0.02h,Stop Loss,$-9.00,$-130.50,$112047.50,242,$-130.50
2024-12-04,07:51:00,21347.25,SELL,3,0.02h,Stop Loss,$-9.00,$-139.50,$112038.50,242,$-139.50
2024-12-04,08:02:00,21355.25,BUY,3,0.02h,Stop Loss,$21.00,$-118.50,$112059.50,242,$-118.50
2024-12-04,08:11:00,21348.75,SELL,3,0.02h,Stop Loss,$-9.00,$-127.50,$112050.50,242,$-127.50
2024-12-04,08:13:00,21354.75,BUY,3,0.02h,Stop Loss,$-9.00,$-136.50,$112041.50,242,$-136.50
2024-12-04,09:36:00,21387.0,SELL,3,0.02h,Stop Loss,$-9.00,$-145.50,$112032.50,242,$-145.50
2024-12-04,09:43:00,21394.75,BUY,3,0.02h,Break Even,$-1.50,$-147.00,$112031.00,242,$-147.00
2024-12-04,10:15:00,21393.0,SELL,3,0.02h,Stop Loss,$-9.00,$-156.00,$112022.00,242,$-156.00
2024-12-04,10:35:00,21394.5,BUY,3,0.02h,Stop Loss,$-9.00,$-165.00,$112013.00,242,$-165.00
2024-12-04,10:36:00,21392.75,SELL,3,0.02h,Stop Loss,$-9.00,$-174.00,$112004.00,242,$-174.00
2024-12-04,10:37:00,21394.5,BUY,3,0.02h,Break Even,$-1.50,$-175.50,$112002.50,242,$-175.50
2024-12-04,11:29:00,21412.5,SELL,3,0.03h,Stop Loss,$12.00,$-163.50,$112014.50,242,$-163.50
2024-12-04,11:33:00,21416.75,BUY,3,0.02h,Stop Loss,$9.00,$-154.50,$112023.50,242,$-154.50
2024-12-04,11:48:00,21414.5,SELL,3,0.02h,Stop Loss,$-9.00,$-163.50,$112014.50,242,$-163.50
2024-12-04,11:55:00,21419.0,BUY,3,0.02h,Stop Loss,$-9.00,$-172.50,$112005.50,242,$-172.50
2024-12-04,12:12:00,21414.0,SELL,3,0.02h,Break Even,$-1.50,$-174.00,$112004.00,242,$-174.00
2024-12-04,12:33:00,21418.75,BUY,3,0.02h,Break Even,$-1.50,$-175.50,$112002.50,242,$-175.50
2024-12-04,12:44:00,21416.0,SELL,3,0.02h,Stop Loss,$-9.00,$-184.50,$111993.50,242,$-184.50
2024-12-04,12:46:00,21420.25,BUY,3,0.02h,Break Even,$-1.50,$-186.00,$111992.00,242,$-186.00
2024-12-04,12:55:00,21417.5,SELL,3,0.02h,Break Even,$-1.50,$-187.50,$111990.50,242,$-187.50
2024-12-04,13:09:00,21420.75,BUY,3,0.02h,Break Even,$-1.50,$-189.00,$111989.00,242,$-189.00
2024-12-04,14:21:00,21437.75,SELL,3,0.02h,Stop Loss,$13.50,$-175.50,$112002.50,242,$-175.50
2024-12-04,14:51:00,21430.5,BUY,3,0.02h,Stop Loss,$-9.00,$-184.50,$111993.50,242,$-184.50
2024-12-04,15:01:00,21397.75,SELL,3,0.02h,Break Even,$-1.50,$-186.00,$111992.00,242,$-186.00
2024-12-04,15:06:00,21434.0,BUY,3,0.02h,Break Even,$-1.50,$-187.50,$111990.50,242,$-187.50
2024-12-04,16:17:00,21474.5,SELL,3,0.02h,Break Even,$-1.50,$-189.00,$111989.00,242,$-189.00
2024-12-04,16:53:00,21464.25,BUY,3,0.02h,Break Even,$-1.50,$-190.50,$111987.50,242,$-190.50
2024-12-04,17:33:00,21470.25,SELL,3,0.02h,Stop Loss,$7.50,$-183.00,$111995.00,242,$-183.00
2024-12-04,17:51:00,21480.5,BUY,3,0.02h,Break Even,$-1.50,$-184.50,$111993.50,242,$-184.50
2024-12-04,18:18:00,21479.0,SELL,3,0.02h,Break Even,$-1.50,$-186.00,$111992.00,242,$-186.00
2024-12-04,18:49:00,21468.5,BUY,3,0.02h,Break Even,$-1.50,$-187.50,$111990.50,242,$-187.50
2024-12-04,21:03:00,21525.25,SELL,3,0.02h,Stop Loss,$13.50,$-174.00,$112004.00,242,$-174.00
2024-12-04,21:43:00,21519.5,BUY,3,0.02h,Break Even,$-1.50,$-175.50,$112002.50,242,$-175.50
2024-12-04,21:45:00,21516.0,SELL,3,0.02h,Stop Loss,$21.00,$-154.50,$112023.50,242,$-154.50
2024-12-04,21:59:00,21516.5,BUY,3,1.03h,Stop Loss,$-9.00,$-163.50,$112014.50,242,$-163.50
2024-12-04,23:01:00,21506.25,SELL,3,0.02h,Break Even,$-1.50,$-165.00,$112013.00,242,$-165.00
2024-12-04,23:16:00,21514.75,BUY,3,0.02h,Stop Loss,$7.50,$-157.50,$112020.50,242,$-157.50
2024-12-04,23:39:00,21514.75,SELL,3,0.02h,Stop Loss,$9.00,$-148.50,$112029.50,242,$-148.50
,,,,,,,,,,,
2024-12-05,00:26:00,21508.75,BUY,3,0.02h,Stop Loss,$-9.00,$-9.00,$112020.50,243,$-9.00
2024-12-05,00:27:00,21507.0,SELL,3,0.02h,Stop Loss,$-9.00,$-18.00,$112011.50,243,$-18.00
2024-12-05,01:09:00,21505.25,BUY,3,0.02h,Stop Loss,$-9.00,$-27.00,$112002.50,243,$-27.00
2024-12-05,01:54:00,21511.5,SELL,3,0.02h,Stop Loss,$-9.00,$-36.00,$111993.50,243,$-36.00
2024-12-05,01:56:00,21516.75,BUY,3,0.03h,Stop Loss,$-9.00,$-45.00,$111984.50,243,$-45.00
2024-12-05,02:02:00,21511.75,SELL,3,0.02h,Break Even,$-1.50,$-46.50,$111983.00,243,$-46.50
2024-12-05,02:05:00,21515.25,BUY,3,0.02h,Stop Loss,$-9.00,$-55.50,$111974.00,243,$-55.50
2024-12-05,02:11:00,21512.0,SELL,3,0.02h,Stop Loss,$-9.00,$-64.50,$111965.00,243,$-64.50
2024-12-05,02:19:00,21516.25,BUY,3,0.02h,Stop Loss,$-9.00,$-73.50,$111956.00,243,$-73.50
2024-12-05,02:26:00,21510.5,SELL,3,0.02h,Stop Loss,$-9.00,$-82.50,$111947.00,243,$-82.50
2024-12-05,02:33:00,21515.5,BUY,3,0.03h,Break Even,$-1.50,$-84.00,$111945.50,243,$-84.00
2024-12-05,02:49:00,21512.75,SELL,3,0.02h,Break Even,$-1.50,$-85.50,$111944.00,243,$-85.50
2024-12-05,03:09:00,21517.25,BUY,3,0.02h,Stop Loss,$-9.00,$-94.50,$111935.00,243,$-94.50
2024-12-05,03:22:00,21511.5,SELL,3,0.02h,Break Even,$-1.50,$-96.00,$111933.50,243,$-96.00
2024-12-05,03:30:00,21513.25,BUY,3,0.08h,Stop Loss,$-9.00,$-105.00,$111924.50,243,$-105.00
2024-12-05,03:36:00,21510.5,SELL,3,0.02h,Stop Loss,$-9.00,$-114.00,$111915.50,243,$-114.00
2024-12-05,03:39:00,21514.0,BUY,3,0.02h,Stop Loss,$-9.00,$-123.00,$111906.50,243,$-123.00
2024-12-05,04:02:00,21513.75,SELL,3,0.02h,Break Even,$-1.50,$-124.50,$111905.00,243,$-124.50
2024-12-05,04:51:00,21510.5,BUY,3,0.02h,Break Even,$-1.50,$-126.00,$111903.50,243,$-126.00
2024-12-05,05:31:00,21510.5,SELL,3,0.02h,Stop Loss,$-9.00,$-135.00,$111894.50,243,$-135.00
2024-12-05,05:35:00,21513.5,BUY,3,0.02h,Stop Loss,$-9.00,$-144.00,$111885.50,243,$-144.00
2024-12-05,05:43:00,21511.0,SELL,3,0.02h,Break Even,$-1.50,$-145.50,$111884.00,243,$-145.50
2024-12-05,05:58:00,21513.25,BUY,3,0.02h,Break Even,$-1.50,$-147.00,$111882.50,243,$-147.00
2024-12-05,06:15:00,21511.25,SELL,3,0.02h,Stop Loss,$-9.00,$-156.00,$111873.50,243,$-156.00
2024-12-05,07:31:00,21503.75,BUY,3,0.02h,Stop Loss,$-9.00,$-165.00,$111864.50,243,$-165.00
2024-12-05,07:33:00,21498.0,SELL,3,0.02h,Stop Loss,$-9.00,$-174.00,$111855.50,243,$-174.00
2024-12-05,07:51:00,21502.5,BUY,3,0.02h,Stop Loss,$-9.00,$-183.00,$111846.50,243,$-183.00
2024-12-05,07:59:00,21496.5,SELL,3,0.02h,Break Even,$-1.50,$-184.50,$111845.00,243,$-184.50
2024-12-05,08:03:00,21499.75,BUY,3,0.02h,Break Even,$-1.50,$-186.00,$111843.50,243,$-186.00
2024-12-05,08:07:00,21496.0,SELL,3,0.02h,Stop Loss,$-9.00,$-195.00,$111834.50,243,$-195.00
2024-12-05,08:09:00,21502.0,BUY,3,0.02h,Stop Loss,$-9.00,$-204.00,$111825.50,243,$-204.00
2024-12-05,08:36:00,21501.75,SELL,3,0.02h,Stop Loss,$6.00,$-198.00,$111831.50,243,$-198.00
2024-12-05,08:49:00,21504.25,BUY,3,0.02h,Stop Loss,$-9.00,$-207.00,$111822.50,243,$-207.00
2024-12-05,08:55:00,21499.5,SELL,3,0.02h,Break Even,$-1.50,$-208.50,$111821.00,243,$-208.50
2024-12-05,09:02:00,21502.75,BUY,3,0.02h,Break Even,$-1.50,$-210.00,$111819.50,243,$-210.00
2024-12-05,09:07:00,21493.75,SELL,3,0.02h,Stop Loss,$-9.00,$-219.00,$111810.50,243,$-219.00
2024-12-05,09:18:00,21504.5,BUY,3,0.02h,Stop Loss,$-9.00,$-228.00,$111801.50,243,$-228.00
2024-12-05,10:27:00,21509.75,SELL,3,0.02h,Break Even,$-1.50,$-229.50,$111800.00,243,$-229.50
2024-12-05,10:33:00,21512.25,BUY,3,0.02h,Break Even,$-1.50,$-231.00,$111798.50,243,$-231.00
2024-12-05,10:37:00,21508.25,SELL,3,0.02h,Stop Loss,$-9.00,$-240.00,$111789.50,243,$-240.00
2024-12-05,11:08:00,21509.25,BUY,3,0.03h,Stop Loss,$-9.00,$-249.00,$111780.50,243,$-249.00
2024-12-05,12:29:00,21521.25,SELL,3,0.02h,Stop Loss,$-9.00,$-258.00,$111771.50,243,$-258.00
2024-12-05,12:36:00,21526.5,BUY,3,0.02h,Stop Loss,$-9.00,$-267.00,$111762.50,243,$-267.00
2024-12-05,13:07:00,21526.75,SELL,3,0.02h,Break Even,$-1.50,$-268.50,$111761.00,243,$-268.50
2024-12-05,13:31:00,21530.5,BUY,3,0.02h,Break Even,$-1.50,$-270.00,$111759.50,243,$-270.00
2024-12-05,13:44:00,21523.5,SELL,3,0.02h,Stop Loss,$15.00,$-255.00,$111774.50,243,$-255.00
2024-12-05,13:58:00,21529.25,BUY,3,0.02h,Stop Loss,$-9.00,$-264.00,$111765.50,243,$-264.00
2024-12-05,14:42:00,21520.75,SELL,3,0.02h,Stop Loss,$-9.00,$-273.00,$111756.50,243,$-273.00
2024-12-05,14:46:00,21537.25,BUY,3,0.02h,Stop Loss,$15.00,$-258.00,$111771.50,243,$-258.00
2024-12-05,14:50:00,21517.5,SELL,3,0.02h,Stop Loss,$36.00,$-222.00,$111807.50,243,$-222.00
2024-12-05,15:10:00,21530.75,BUY,3,0.02h,Break Even,$-1.50,$-223.50,$111806.00,243,$-223.50
2024-12-05,15:23:00,21512.75,SELL,3,0.02h,Break Even,$-1.50,$-225.00,$111804.50,243,$-225.00
2024-12-05,15:34:00,21523.25,BUY,3,0.02h,Stop Loss,$-9.00,$-234.00,$111795.50,243,$-234.00
2024-12-05,15:42:00,21513.25,SELL,3,0.02h,Break Even,$-1.50,$-235.50,$111794.00,243,$-235.50
2024-12-05,15:45:00,21527.75,BUY,3,0.02h,Break Even,$-1.50,$-237.00,$111792.50,243,$-237.00
2024-12-05,15:49:00,21508.25,SELL,3,0.02h,Stop Loss,$34.50,$-202.50,$111827.00,243,$-202.50
2024-12-05,16:13:00,21513.75,BUY,3,0.02h,Stop Loss,$-9.00,$-211.50,$111818.00,243,$-211.50
2024-12-05,16:40:00,21518.5,SELL,3,0.02h,Break Even,$-1.50,$-213.00,$111816.50,243,$-213.00
2024-12-05,16:52:00,21525.75,BUY,3,0.02h,Stop Loss,$-9.00,$-222.00,$111807.50,243,$-222.00
2024-12-05,16:54:00,21521.75,SELL,3,0.02h,Break Even,$-1.50,$-223.50,$111806.00,243,$-223.50
2024-12-05,17:00:00,21530.0,BUY,3,0.02h,Break Even,$-1.50,$-225.00,$111804.50,243,$-225.00
2024-12-05,18:03:00,21549.0,SELL,3,0.02h,Stop Loss,$4.50,$-220.50,$111809.00,243,$-220.50
2024-12-05,18:42:00,21523.25,BUY,3,0.02h,Stop Loss,$-9.00,$-229.50,$111800.00,243,$-229.50
2024-12-05,18:50:00,21510.5,SELL,3,0.02h,Stop Loss,$28.50,$-201.00,$111828.50,243,$-201.00
2024-12-05,19:14:00,21503.0,BUY,3,0.02h,Stop Loss,$6.00,$-195.00,$111834.50,243,$-195.00
2024-12-05,19:31:00,21495.5,SELL,3,0.02h,Stop Loss,$-9.00,$-204.00,$111825.50,243,$-204.00
2024-12-05,20:05:00,21497.0,BUY,3,0.02h,Stop Loss,$37.50,$-166.50,$111863.00,243,$-166.50
2024-12-05,20:16:00,21491.0,SELL,3,0.02h,Stop Loss,$10.50,$-156.00,$111873.50,243,$-156.00
2024-12-05,20:42:00,21486.25,BUY,3,0.02h,Break Even,$-1.50,$-157.50,$111872.00,243,$-157.50
2024-12-05,20:55:00,21469.75,SELL,3,0.02h,Stop Loss,$21.00,$-136.50,$111893.00,243,$-136.50
2024-12-05,21:32:00,21456.25,BUY,3,0.02h,Break Even,$-1.50,$-138.00,$111891.50,243,$-138.00
2024-12-05,21:57:00,21455.25,SELL,3,0.03h,Break Even,$-1.50,$-139.50,$111890.00,243,$-139.50
2024-12-05,23:26:00,21450.25,BUY,3,0.02h,Break Even,$-1.50,$-141.00,$111888.50,243,$-141.00
,,,,,,,,,,,
2024-12-06,00:03:00,21449.25,SELL,3,0.02h,Break Even,$-1.50,$-1.50,$111887.00,244,$-1.50
2024-12-06,00:17:00,21454.5,BUY,3,0.02h,Break Even,$-1.50,$-3.00,$111885.50,244,$-3.00
2024-12-06,00:38:00,21450.25,SELL,3,0.02h,Break Even,$-1.50,$-4.50,$111884.00,244,$-4.50
2024-12-06,00:42:00,21454.75,BUY,3,0.02h,Stop Loss,$-9.00,$-13.50,$111875.00,244,$-13.50
2024-12-06,01:02:00,21451.75,SELL,3,0.02h,Break Even,$-1.50,$-15.00,$111873.50,244,$-15.00
2024-12-06,01:12:00,21458.5,BUY,3,0.02h,Break Even,$-1.50,$-16.50,$111872.00,244,$-16.50
2024-12-06,01:22:00,21452.75,SELL,3,0.02h,Stop Loss,$-9.00,$-25.50,$111863.00,244,$-25.50
2024-12-06,01:27:00,21458.0,BUY,3,0.02h,Stop Loss,$-9.00,$-34.50,$111854.00,244,$-34.50
2024-12-06,01:52:00,21462.0,SELL,3,0.02h,Break Even,$-1.50,$-36.00,$111852.50,244,$-36.00
2024-12-06,02:04:00,21464.75,BUY,3,0.02h,Stop Loss,$-9.00,$-45.00,$111843.50,244,$-45.00
2024-12-06,02:17:00,21460.5,SELL,3,0.02h,Stop Loss,$-9.00,$-54.00,$111834.50,244,$-54.00
2024-12-06,02:19:00,21466.25,BUY,3,0.02h,Stop Loss,$-9.00,$-63.00,$111825.50,244,$-63.00
2024-12-06,03:05:00,21474.5,SELL,3,0.02h,Stop Loss,$-9.00,$-72.00,$111816.50,244,$-72.00
2024-12-06,03:06:00,21476.75,BUY,3,0.02h,Stop Loss,$-9.00,$-81.00,$111807.50,244,$-81.00
2024-12-06,03:08:00,21473.75,SELL,3,0.02h,Stop Loss,$-9.00,$-90.00,$111798.50,244,$-90.00
2024-12-06,03:12:00,21476.25,BUY,3,0.02h,Stop Loss,$-9.00,$-99.00,$111789.50,244,$-99.00
2024-12-06,03:16:00,21472.0,SELL,3,0.03h,Stop Loss,$-9.00,$-108.00,$111780.50,244,$-108.00
2024-12-06,03:45:00,21473.75,BUY,3,0.02h,Stop Loss,$-9.00,$-117.00,$111771.50,244,$-117.00
2024-12-06,03:46:00,21470.75,SELL,3,0.03h,Break Even,$-1.50,$-118.50,$111770.00,244,$-118.50
2024-12-06,04:34:00,21465.25,BUY,3,0.02h,Stop Loss,$-9.00,$-127.50,$111761.00,244,$-127.50
2024-12-06,05:10:00,21469.25,SELL,3,0.02h,Stop Loss,$-9.00,$-136.50,$111752.00,244,$-136.50
2024-12-06,05:14:00,21471.25,BUY,3,0.02h,Break Even,$-1.50,$-138.00,$111750.50,244,$-138.00
2024-12-06,05:44:00,21470.0,SELL,3,0.02h,Stop Loss,$-9.00,$-147.00,$111741.50,244,$-147.00
2024-12-06,05:55:00,21475.75,BUY,3,0.02h,Stop Loss,$-9.00,$-156.00,$111732.50,244,$-156.00
2024-12-06,06:38:00,21476.75,SELL,3,0.02h,Stop Loss,$-9.00,$-165.00,$111723.50,244,$-165.00
2024-12-06,06:49:00,21481.25,BUY,3,0.03h,Stop Loss,$-9.00,$-174.00,$111714.50,244,$-174.00
2024-12-06,06:58:00,21477.75,SELL,3,0.02h,Break Even,$-1.50,$-175.50,$111713.00,244,$-175.50
2024-12-06,07:07:00,21479.75,BUY,3,0.02h,Stop Loss,$-9.00,$-184.50,$111704.00,244,$-184.50
2024-12-06,07:25:00,21477.5,SELL,3,0.02h,Stop Loss,$-9.00,$-193.50,$111695.00,244,$-193.50
2024-12-06,08:03:00,21478.0,BUY,3,0.02h,Break Even,$-1.50,$-195.00,$111693.50,244,$-195.00
2024-12-06,08:32:00,21478.75,SELL,3,0.02h,Break Even,$-1.50,$-196.50,$111692.00,244,$-196.50
2024-12-06,08:35:00,21483.25,BUY,3,0.02h,Break Even,$-1.50,$-198.00,$111690.50,244,$-198.00
2024-12-06,09:01:00,21486.0,SELL,3,0.02h,Stop Loss,$10.50,$-187.50,$111701.00,244,$-187.50
2024-12-06,09:39:00,21474.0,BUY,3,0.02h,Break Even,$-1.50,$-189.00,$111699.50,244,$-189.00
2024-12-06,09:56:00,21473.25,SELL,3,0.02h,Break Even,$-1.50,$-190.50,$111698.00,244,$-190.50
2024-12-06,10:28:00,21466.75,BUY,3,0.02h,Break Even,$-1.50,$-192.00,$111696.50,244,$-192.00
2024-12-06,10:48:00,21467.5,SELL,3,0.02h,Stop Loss,$-9.00,$-201.00,$111687.50,244,$-201.00
2024-12-06,11:52:00,21458.5,BUY,3,0.02h,Stop Loss,$-9.00,$-210.00,$111678.50,244,$-210.00
2024-12-06,12:41:00,21471.75,SELL,3,0.02h,Stop Loss,$-9.00,$-219.00,$111669.50,244,$-219.00
2024-12-06,12:47:00,21477.75,BUY,3,0.02h,Break Even,$-1.50,$-220.50,$111668.00,244,$-220.50
2024-12-06,12:51:00,21472.5,SELL,3,0.02h,Stop Loss,$-9.00,$-229.50,$111659.00,244,$-229.50
2024-12-06,12:54:00,21477.25,BUY,3,0.02h,Break Even,$-1.50,$-231.00,$111657.50,244,$-231.00
2024-12-06,13:15:00,21478.0,SELL,3,0.02h,Stop Loss,$-9.00,$-240.00,$111648.50,244,$-240.00
2024-12-06,13:16:00,21479.0,BUY,3,0.02h,Break Even,$-1.50,$-241.50,$111647.00,244,$-241.50
2024-12-06,13:18:00,21478.0,SELL,3,0.02h,Stop Loss,$-9.00,$-250.50,$111638.00,244,$-250.50
2024-12-06,13:31:00,21508.0,BUY,3,0.02h,Stop Loss,$27.00,$-223.50,$111665.00,244,$-223.50
2024-12-06,13:51:00,21490.75,SELL,3,0.02h,Break Even,$-1.50,$-225.00,$111663.50,244,$-225.00
2024-12-06,14:03:00,21505.5,BUY,3,0.02h,Break Even,$-1.50,$-226.50,$111662.00,244,$-226.50
2024-12-06,14:07:00,21496.25,SELL,3,0.02h,Stop Loss,$-9.00,$-235.50,$111653.00,244,$-235.50
2024-12-06,14:09:00,21504.0,BUY,3,0.02h,Stop Loss,$4.50,$-231.00,$111657.50,244,$-231.00
2024-12-06,14:30:00,21491.75,SELL,3,0.02h,Stop Loss,$19.50,$-211.50,$111677.00,244,$-211.50
2024-12-06,14:32:00,21513.25,BUY,3,0.02h,Stop Loss,$31.50,$-180.00,$111708.50,244,$-180.00
2024-12-06,15:45:00,21619.75,SELL,3,0.02h,Stop Loss,$13.50,$-166.50,$111722.00,244,$-166.50
2024-12-06,16:03:00,21625.75,BUY,3,0.02h,Stop Loss,$-9.00,$-175.50,$111713.00,244,$-175.50
2024-12-06,16:11:00,21612.0,SELL,3,0.02h,Stop Loss,$36.00,$-139.50,$111749.00,244,$-139.50
2024-12-06,16:30:00,21620.25,BUY,3,0.02h,Stop Loss,$6.00,$-133.50,$111755.00,244,$-133.50
2024-12-06,16:48:00,21605.25,SELL,3,0.02h,Stop Loss,$-9.00,$-142.50,$111746.00,244,$-142.50
2024-12-06,17:10:00,21624.25,BUY,3,0.02h,Break Even,$-1.50,$-144.00,$111744.50,244,$-144.00
2024-12-06,17:38:00,21622.5,SELL,3,0.02h,Break Even,$-1.50,$-145.50,$111743.00,244,$-145.50
2024-12-06,17:55:00,21630.25,BUY,3,0.02h,Stop Loss,$-9.00,$-154.50,$111734.00,244,$-154.50
2024-12-06,18:34:00,21647.0,SELL,3,0.02h,Break Even,$-1.50,$-156.00,$111732.50,244,$-156.00
2024-12-06,18:53:00,21653.5,BUY,3,0.02h,Break Even,$-1.50,$-157.50,$111731.00,244,$-157.50
2024-12-06,19:04:00,21642.0,SELL,3,0.02h,Stop Loss,$-9.00,$-166.50,$111722.00,244,$-166.50
2024-12-06,19:41:00,21629.0,BUY,3,0.02h,Stop Loss,$-9.00,$-175.50,$111713.00,244,$-175.50
2024-12-06,19:43:00,21626.25,SELL,3,0.02h,Stop Loss,$-9.00,$-184.50,$111704.00,244,$-184.50
2024-12-06,19:44:00,21632.5,BUY,3,0.02h,Break Even,$-1.50,$-186.00,$111702.50,244,$-186.00
2024-12-06,20:02:00,21631.5,SELL,3,0.02h,Break Even,$-1.50,$-187.50,$111701.00,244,$-187.50
2024-12-06,20:08:00,21640.25,BUY,3,0.02h,Stop Loss,$-9.00,$-196.50,$111692.00,244,$-196.50
2024-12-06,20:50:00,21643.25,SELL,3,0.02h,Stop Loss,$18.00,$-178.50,$111710.00,244,$-178.50
2024-12-06,20:51:00,21653.25,BUY,3,0.02h,Stop Loss,$3.00,$-175.50,$111713.00,244,$-175.50
2024-12-06,21:03:00,21645.5,SELL,3,0.02h,Break Even,$-1.50,$-177.00,$111711.50,244,$-177.00
2024-12-06,21:55:00,21635.5,BUY,3,0.02h,Stop Loss,$-9.00,$-186.00,$111702.50,244,$-186.00
2024-12-06,21:56:00,21633.0,SELL,3,0.02h,Stop Loss,$-9.00,$-195.00,$111693.50,244,$-195.00
,,,,,,,,,,,
2024-12-09,00:00:00,21657.75,BUY,3,0.02h,Stop Loss,$-9.00,$-9.00,$111684.50,245,$-9.00
2024-12-09,00:27:00,21646.0,SELL,3,0.02h,Stop Loss,$24.00,$15.00,$111708.50,245,$15.00
2024-12-09,00:47:00,21650.75,BUY,3,0.02h,Stop Loss,$3.00,$18.00,$111711.50,245,$18.00
2024-12-09,00:56:00,21646.25,SELL,3,0.02h,Stop Loss,$-9.00,$9.00,$111702.50,245,$9.00
2024-12-09,00:58:00,21648.5,BUY,3,0.02h,Break Even,$-1.50,$7.50,$111701.00,245,$7.50
2024-12-09,01:00:00,21643.25,SELL,3,0.02h,Break Even,$-1.50,$6.00,$111699.50,245,$6.00
2024-12-09,01:25:00,21640.5,BUY,3,0.02h,Stop Loss,$-9.00,$-3.00,$111690.50,245,$-3.00
2024-12-09,01:27:00,21637.25,SELL,3,0.02h,Stop Loss,$-9.00,$-12.00,$111681.50,245,$-12.00
2024-12-09,01:30:00,21640.5,BUY,3,0.02h,Stop Loss,$3.00,$-9.00,$111684.50,245,$-9.00
2024-12-09,02:15:00,21649.25,SELL,3,0.05h,Break Even,$-1.50,$-10.50,$111683.00,245,$-10.50
2024-12-09,02:22:00,21654.0,BUY,3,0.02h,Break Even,$-1.50,$-12.00,$111681.50,245,$-12.00
2024-12-09,02:28:00,21649.75,SELL,3,0.02h,Stop Loss,$-9.00,$-21.00,$111672.50,245,$-21.00
2024-12-09,02:50:00,21649.75,BUY,3,0.02h,Stop Loss,$-9.00,$-30.00,$111663.50,245,$-30.00
2024-12-09,03:17:00,21649.5,SELL,3,0.02h,Stop Loss,$-9.00,$-39.00,$111654.50,245,$-39.00
2024-12-09,03:18:00,21651.75,BUY,3,0.02h,Stop Loss,$-9.00,$-48.00,$111645.50,245,$-48.00
2024-12-09,03:19:00,21649.75,SELL,3,0.02h,Stop Loss,$-9.00,$-57.00,$111636.50,245,$-57.00
2024-12-09,03:43:00,21649.5,BUY,3,0.02h,Stop Loss,$-9.00,$-66.00,$111627.50,245,$-66.00
2024-12-09,03:47:00,21646.75,SELL,3,0.10h,Break Even,$-1.50,$-67.50,$111626.00,245,$-67.50
2024-12-09,04:15:00,21645.5,BUY,3,0.02h,Break Even,$-1.50,$-69.00,$111624.50,245,$-69.00
2024-12-09,04:24:00,21644.25,SELL,3,0.07h,Break Even,$-1.50,$-70.50,$111623.00,245,$-70.50
2024-12-09,04:55:00,21641.25,BUY,3,0.02h,Stop Loss,$-9.00,$-79.50,$111614.00,245,$-79.50
2024-12-09,04:56:00,21638.5,SELL,3,0.02h,Break Even,$-1.50,$-81.00,$111612.50,245,$-81.00
2024-12-09,05:05:00,21639.5,BUY,3,0.02h,Stop Loss,$-9.00,$-90.00,$111603.50,245,$-90.00
2024-12-09,05:57:00,21644.75,SELL,3,0.02h,Stop Loss,$-9.00,$-99.00,$111594.50,245,$-99.00
2024-12-09,05:59:00,21648.25,BUY,3,0.05h,Break Even,$-1.50,$-100.50,$111593.00,245,$-100.50
2024-12-09,06:58:00,21652.0,SELL,3,0.02h,Break Even,$-1.50,$-102.00,$111591.50,245,$-102.00
2024-12-09,07:21:00,21659.5,BUY,3,0.02h,Break Even,$-1.50,$-103.50,$111590.00,245,$-103.50
2024-12-09,08:09:00,21688.25,SELL,3,0.02h,Break Even,$-1.50,$-105.00,$111588.50,245,$-105.00
2024-12-09,08:14:00,21697.25,BUY,3,0.02h,Stop Loss,$-9.00,$-114.00,$111579.50,245,$-114.00
2024-12-09,08:21:00,21689.0,SELL,3,0.02h,Stop Loss,$-9.00,$-123.00,$111570.50,245,$-123.00
2024-12-09,08:39:00,21696.5,BUY,3,0.02h,Break Even,$-1.50,$-124.50,$111569.00,245,$-124.50
2024-12-09,09:02:00,21684.75,SELL,3,0.02h,Stop Loss,$37.50,$-87.00,$111606.50,245,$-87.00
2024-12-09,10:33:00,21635.5,BUY,3,0.02h,Stop Loss,$-9.00,$-96.00,$111597.50,245,$-96.00
2024-12-09,10:41:00,21624.25,SELL,3,0.02h,Break Even,$-1.50,$-97.50,$111596.00,245,$-97.50
2024-12-09,11:24:00,21620.25,BUY,3,0.03h,Break Even,$-1.50,$-99.00,$111594.50,245,$-99.00
2024-12-09,11:35:00,21596.5,SELL,3,0.02h,Break Even,$-1.50,$-100.50,$111593.00,245,$-100.50
2024-12-09,11:57:00,21609.5,BUY,3,0.02h,Break Even,$-1.50,$-102.00,$111591.50,245,$-102.00
2024-12-09,12:20:00,21610.25,SELL,3,0.02h,Stop Loss,$-9.00,$-111.00,$111582.50,245,$-111.00
2024-12-09,12:24:00,21616.0,BUY,3,0.02h,Stop Loss,$-9.00,$-120.00,$111573.50,245,$-120.00
2024-12-09,12:43:00,21618.5,SELL,3,0.02h,Stop Loss,$4.50,$-115.50,$111578.00,245,$-115.50
2024-12-09,12:57:00,21622.0,BUY,3,0.02h,Stop Loss,$4.50,$-111.00,$111582.50,245,$-111.00
2024-12-09,13:11:00,21614.5,SELL,3,0.02h,Break Even,$-1.50,$-112.50,$111581.00,245,$-112.50
2024-12-09,13:23:00,21620.75,BUY,3,0.02h,Stop Loss,$-9.00,$-121.50,$111572.00,245,$-121.50
2024-12-09,13:34:00,21616.0,SELL,3,0.02h,Stop Loss,$-9.00,$-130.50,$111563.00,245,$-130.50
2024-12-09,13:40:00,21623.0,BUY,3,0.02h,Break Even,$-1.50,$-132.00,$111561.50,245,$-132.00
2024-12-09,14:01:00,21617.0,SELL,3,0.02h,Stop Loss,$-9.00,$-141.00,$111552.50,245,$-141.00
2024-12-09,14:19:00,21621.25,BUY,3,0.02h,Stop Loss,$10.50,$-130.50,$111563.00,245,$-130.50
2024-12-09,14:31:00,21592.0,SELL,3,0.02h,Break Even,$-1.50,$-132.00,$111561.50,245,$-132.00
2024-12-09,14:44:00,21620.25,BUY,3,0.02h,Stop Loss,$31.50,$-100.50,$111593.00,245,$-100.50
2024-12-09,15:00:00,21623.5,SELL,3,0.02h,Break Even,$-1.50,$-102.00,$111591.50,245,$-102.00
2024-12-09,15:01:00,21628.5,BUY,3,0.02h,Break Even,$-1.50,$-103.50,$111590.00,245,$-103.50
2024-12-09,15:03:00,21618.0,SELL,3,0.02h,Break Even,$-1.50,$-105.00,$111588.50,245,$-105.00
2024-12-09,16:23:00,21498.0,BUY,3,0.02h,Stop Loss,$15.00,$-90.00,$111603.50,245,$-90.00
2024-12-09,16:43:00,21491.5,SELL,3,0.02h,Stop Loss,$21.00,$-69.00,$111624.50,245,$-69.00
2024-12-09,16:53:00,21509.75,BUY,3,0.02h,Break Even,$-1.50,$-70.50,$111623.00,245,$-70.50
2024-12-09,17:07:00,21498.25,SELL,3,0.02h,Break Even,$-1.50,$-72.00,$111621.50,245,$-72.00
2024-12-09,17:09:00,21510.25,BUY,3,0.02h,Stop Loss,$24.00,$-48.00,$111645.50,245,$-48.00
2024-12-09,17:17:00,21493.75,SELL,3,0.02h,Stop Loss,$3.00,$-45.00,$111648.50,245,$-45.00
2024-12-09,17:40:00,21502.75,BUY,3,0.02h,Stop Loss,$46.50,$1.50,$111695.00,245,$1.50
2024-12-09,17:58:00,21492.0,SELL,3,0.02h,Break Even,$-1.50,$0.00,$111693.50,245,$0.00
2024-12-09,18:18:00,21495.25,BUY,3,0.02h,Stop Loss,$18.00,$18.00,$111711.50,245,$18.00
2024-12-09,19:00:00,21529.75,SELL,3,0.02h,Stop Loss,$30.00,$48.00,$111741.50,245,$48.00
2024-12-09,20:00:00,21476.75,BUY,3,0.02h,Break Even,$-1.50,$46.50,$111740.00,245,$46.50
2024-12-09,20:02:00,21462.5,SELL,3,0.02h,Break Even,$-1.50,$45.00,$111738.50,245,$45.00
2024-12-09,20:34:00,21459.75,BUY,3,0.02h,Stop Loss,$-9.00,$36.00,$111729.50,245,$36.00
2024-12-09,20:35:00,21450.5,SELL,3,0.02h,Stop Loss,$-9.00,$27.00,$111720.50,245,$27.00
2024-12-09,20:36:00,21454.0,BUY,3,0.02h,Break Even,$-1.50,$25.50,$111719.00,245,$25.50
2024-12-09,20:46:00,21449.0,SELL,3,0.02h,Stop Loss,$-9.00,$16.50,$111710.00,245,$16.50
2024-12-09,20:51:00,21471.0,BUY,3,0.02h,Stop Loss,$-9.00,$7.50,$111701.00,245,$7.50
2024-12-09,21:48:00,21473.25,SELL,3,0.02h,Break Even,$-1.50,$6.00,$111699.50,245,$6.00
2024-12-09,21:55:00,21477.0,BUY,3,0.02h,Stop Loss,$21.00,$27.00,$111720.50,245,$27.00
2024-12-09,23:05:00,21473.0,SELL,3,0.02h,Stop Loss,$-9.00,$18.00,$111711.50,245,$18.00
2024-12-09,23:28:00,21478.75,BUY,3,0.02h,Stop Loss,$-9.00,$9.00,$111702.50,245,$9.00
2024-12-09,23:36:00,21470.0,SELL,3,0.03h,Stop Loss,$6.00,$15.00,$111708.50,245,$15.00
2024-12-09,23:51:00,21469.25,BUY,3,0.02h,Break Even,$-1.50,$13.50,$111707.00,245,$13.50
2024-12-09,23:53:00,21467.25,SELL,3,0.02h,Stop Loss,$-9.00,$4.50,$111698.00,245,$4.50
2024-12-09,23:54:00,21468.5,BUY,3,0.02h,Stop Loss,$-9.00,$-4.50,$111689.00,245,$-4.50
2024-12-09,23:55:00,21467.0,SELL,3,0.03h,Stop Loss,$-9.00,$-13.50,$111680.00,245,$-13.50
,,,,,,,,,,,
2024-12-10,00:16:00,21468.75,BUY,3,0.02h,Stop Loss,$-9.00,$-9.00,$111671.00,246,$-9.00
2024-12-10,00:21:00,21465.0,SELL,3,0.02h,Break Even,$-1.50,$-10.50,$111669.50,246,$-10.50
2024-12-10,00:23:00,21467.0,BUY,3,0.02h,Break Even,$-1.50,$-12.00,$111668.00,246,$-12.00
2024-12-10,00:28:00,21464.0,SELL,3,0.02h,Stop Loss,$-9.00,$-21.00,$111659.00,246,$-21.00
2024-12-10,00:30:00,21469.5,BUY,3,0.02h,Break Even,$-1.50,$-22.50,$111657.50,246,$-22.50
2024-12-10,00:47:00,21467.0,SELL,3,0.02h,Stop Loss,$-9.00,$-31.50,$111648.50,246,$-31.50
2024-12-10,00:51:00,21470.25,BUY,3,0.02h,Break Even,$-1.50,$-33.00,$111647.00,246,$-33.00
2024-12-10,01:25:00,21475.0,SELL,3,0.02h,Break Even,$-1.50,$-34.50,$111645.50,246,$-34.50
2024-12-10,02:01:00,21469.5,BUY,3,0.02h,Break Even,$-1.50,$-36.00,$111644.00,246,$-36.00
2024-12-10,02:27:00,21469.0,SELL,3,0.02h,Stop Loss,$-9.00,$-45.00,$111635.00,246,$-45.00
2024-12-10,02:39:00,21471.5,BUY,3,0.02h,Stop Loss,$-9.00,$-54.00,$111626.00,246,$-54.00
2024-12-10,02:40:00,21469.75,SELL,3,0.02h,Stop Loss,$-9.00,$-63.00,$111617.00,246,$-63.00
2024-12-10,02:44:00,21471.75,BUY,3,0.03h,Stop Loss,$-9.00,$-72.00,$111608.00,246,$-72.00
2024-12-10,02:47:00,21469.5,SELL,3,0.05h,Break Even,$-1.50,$-73.50,$111606.50,246,$-73.50
2024-12-10,03:04:00,21470.0,BUY,3,0.02h,Stop Loss,$-9.00,$-82.50,$111597.50,246,$-82.50
2024-12-10,03:05:00,21468.25,SELL,3,0.05h,Stop Loss,$-9.00,$-91.50,$111588.50,246,$-91.50
2024-12-10,03:15:00,21469.5,BUY,3,0.03h,Stop Loss,$-9.00,$-100.50,$111579.50,246,$-100.50
2024-12-10,03:18:00,21467.25,SELL,3,0.02h,Break Even,$-1.50,$-102.00,$111578.00,246,$-102.00
2024-12-10,03:24:00,21470.75,BUY,3,0.03h,Stop Loss,$-9.00,$-111.00,$111569.00,246,$-111.00
2024-12-10,03:29:00,21467.0,SELL,3,0.02h,Stop Loss,$-9.00,$-120.00,$111560.00,246,$-120.00
2024-12-10,03:36:00,21469.5,BUY,3,0.02h,Stop Loss,$-9.00,$-129.00,$111551.00,246,$-129.00
2024-12-10,03:40:00,21467.0,SELL,3,0.02h,Break Even,$-1.50,$-130.50,$111549.50,246,$-130.50
2024-12-10,03:43:00,21469.25,BUY,3,0.03h,Break Even,$-1.50,$-132.00,$111548.00,246,$-132.00
2024-12-10,04:17:00,21473.0,SELL,3,0.02h,Stop Loss,$-9.00,$-141.00,$111539.00,246,$-141.00
2024-12-10,04:46:00,21473.75,BUY,3,0.02h,Stop Loss,$-9.00,$-150.00,$111530.00,246,$-150.00
2024-12-10,04:49:00,21471.25,SELL,3,0.02h,Break Even,$-1.50,$-151.50,$111528.50,246,$-151.50
2024-12-10,05:04:00,21472.5,BUY,3,0.07h,Stop Loss,$-9.00,$-160.50,$111519.50,246,$-160.50
2024-12-10,05:31:00,21462.5,SELL,3,0.02h,Stop Loss,$-9.00,$-169.50,$111510.50,246,$-169.50
2024-12-10,06:26:00,21461.75,BUY,3,0.02h,Break Even,$-1.50,$-171.00,$111509.00,246,$-171.00
2024-12-10,06:45:00,21458.5,SELL,3,0.02h,Break Even,$-1.50,$-172.50,$111507.50,246,$-172.50
2024-12-10,07:02:00,21462.0,BUY,3,0.02h,Stop Loss,$-9.00,$-181.50,$111498.50,246,$-181.50
2024-12-10,07:17:00,21457.75,SELL,3,0.02h,Break Even,$-1.50,$-183.00,$111497.00,246,$-183.00
2024-12-10,07:29:00,21461.25,BUY,3,0.02h,Stop Loss,$-9.00,$-192.00,$111488.00,246,$-192.00
2024-12-10,07:50:00,21460.75,SELL,3,0.02h,Break Even,$-1.50,$-193.50,$111486.50,246,$-193.50
2024-12-10,08:04:00,21462.5,BUY,3,0.02h,Stop Loss,$-9.00,$-202.50,$111477.50,246,$-202.50
2024-12-10,08:12:00,21455.0,SELL,3,0.02h,Stop Loss,$-9.00,$-211.50,$111468.50,246,$-211.50
2024-12-10,08:35:00,21460.5,BUY,3,0.02h,Stop Loss,$-9.00,$-220.50,$111459.50,246,$-220.50
2024-12-10,09:04:00,21457.5,SELL,3,0.02h,Break Even,$-1.50,$-222.00,$111458.00,246,$-222.00
2024-12-10,09:20:00,21460.5,BUY,3,0.02h,Stop Loss,$-9.00,$-231.00,$111449.00,246,$-231.00
2024-12-10,09:39:00,21456.0,SELL,3,0.02h,Break Even,$-1.50,$-232.50,$111447.50,246,$-232.50
2024-12-10,09:56:00,21459.5,BUY,3,0.02h,Break Even,$-1.50,$-234.00,$111446.00,246,$-234.00
2024-12-10,10:48:00,21484.25,SELL,3,0.02h,Stop Loss,$-9.00,$-243.00,$111437.00,246,$-243.00
2024-12-10,10:55:00,21492.0,BUY,3,0.02h,Stop Loss,$-9.00,$-252.00,$111428.00,246,$-252.00
2024-12-10,12:03:00,21508.5,SELL,3,0.03h,Stop Loss,$-9.00,$-261.00,$111419.00,246,$-261.00
2024-12-10,12:07:00,21512.75,BUY,3,0.02h,Stop Loss,$-9.00,$-270.00,$111410.00,246,$-270.00
2024-12-10,12:10:00,21508.75,SELL,3,0.02h,Stop Loss,$-9.00,$-279.00,$111401.00,246,$-279.00
2024-12-10,12:11:00,21512.75,BUY,3,0.02h,Stop Loss,$-9.00,$-288.00,$111392.00,246,$-288.00
2024-12-10,12:57:00,21523.25,SELL,3,0.02h,Break Even,$-1.50,$-289.50,$111390.50,246,$-289.50
2024-12-10,13:01:00,21529.0,BUY,3,0.02h,Break Even,$-1.50,$-291.00,$111389.00,246,$-291.00
2024-12-10,13:21:00,21523.5,SELL,3,0.02h,Stop Loss,$-9.00,$-300.00,$111380.00,246,$-300.00
2024-12-10,14:08:00,21512.75,BUY,3,0.02h,Break Even,$-1.50,$-301.50,$111378.50,246,$-301.50
2024-12-10,14:34:00,21517.0,SELL,3,0.02h,Break Even,$-1.50,$-303.00,$111377.00,246,$-303.00
2024-12-10,14:35:00,21526.25,BUY,3,0.02h,Break Even,$-1.50,$-304.50,$111375.50,246,$-304.50
2024-12-10,14:56:00,21524.0,SELL,3,0.02h,Stop Loss,$31.50,$-273.00,$111407.00,246,$-273.00
2024-12-10,15:03:00,21569.25,BUY,3,0.02h,Break Even,$-1.50,$-274.50,$111405.50,246,$-274.50
2024-12-10,15:28:00,21575.0,SELL,3,0.02h,Stop Loss,$16.50,$-258.00,$111422.00,246,$-258.00
2024-12-10,16:57:00,21481.5,BUY,3,0.02h,Stop Loss,$-9.00,$-267.00,$111413.00,246,$-267.00
2024-12-10,17:14:00,21463.0,SELL,3,0.02h,Stop Loss,$40.50,$-226.50,$111453.50,246,$-226.50
2024-12-10,17:24:00,21485.0,BUY,3,0.02h,Stop Loss,$9.00,$-217.50,$111462.50,246,$-217.50
2024-12-10,17:52:00,21478.0,SELL,3,0.02h,Stop Loss,$16.50,$-201.00,$111479.00,246,$-201.00
2024-12-10,18:22:00,21474.0,BUY,3,0.02h,Stop Loss,$-9.00,$-210.00,$111470.00,246,$-210.00
2024-12-10,18:45:00,21467.0,SELL,3,0.02h,Break Even,$-1.50,$-211.50,$111468.50,246,$-211.50
2024-12-10,19:24:00,21452.75,BUY,3,0.02h,Stop Loss,$3.00,$-208.50,$111471.50,246,$-208.50
2024-12-10,19:33:00,21445.75,SELL,3,0.02h,Stop Loss,$6.00,$-202.50,$111477.50,246,$-202.50
2024-12-10,20:42:00,21397.25,BUY,3,0.02h,Stop Loss,$-9.00,$-211.50,$111468.50,246,$-211.50
2024-12-10,23:04:00,21431.0,SELL,3,0.02h,Stop Loss,$-9.00,$-220.50,$111459.50,246,$-220.50
2024-12-10,23:38:00,21426.5,BUY,3,0.02h,Stop Loss,$-9.00,$-229.50,$111450.50,246,$-229.50
2024-12-10,23:43:00,21420.75,SELL,3,0.02h,Stop Loss,$-9.00,$-238.50,$111441.50,246,$-238.50
2024-12-10,23:47:00,21426.5,BUY,3,0.02h,Break Even,$-1.50,$-240.00,$111440.00,246,$-240.00
,,,,,,,,,,,
2024-12-11,00:04:00,21421.5,SELL,3,0.02h,Break Even,$-1.50,$-1.50,$111438.50,247,$-1.50
2024-12-11,00:39:00,21421.75,BUY,3,0.07h,Break Even,$-1.50,$-3.00,$111437.00,247,$-3.00
2024-12-11,01:09:00,21420.0,SELL,3,0.02h,Stop Loss,$-9.00,$-12.00,$111428.00,247,$-12.00
2024-12-11,01:11:00,21425.5,BUY,3,0.02h,Break Even,$-1.50,$-13.50,$111426.50,247,$-13.50
2024-12-11,01:33:00,21427.25,SELL,3,0.02h,Break Even,$-1.50,$-15.00,$111425.00,247,$-15.00
2024-12-11,01:39:00,21430.0,BUY,3,0.02h,Stop Loss,$-9.00,$-24.00,$111416.00,247,$-24.00
2024-12-11,01:42:00,21428.0,SELL,3,0.02h,Stop Loss,$-9.00,$-33.00,$111407.00,247,$-33.00
2024-12-11,01:43:00,21429.0,BUY,3,0.02h,Stop Loss,$-9.00,$-42.00,$111398.00,247,$-42.00
2024-12-11,01:44:00,21428.0,SELL,3,0.03h,Stop Loss,$-9.00,$-51.00,$111389.00,247,$-51.00
2024-12-11,01:50:00,21431.25,BUY,3,0.02h,Break Even,$-1.50,$-52.50,$111387.50,247,$-52.50
2024-12-11,02:04:00,21426.75,SELL,3,0.02h,Stop Loss,$-9.00,$-61.50,$111378.50,247,$-61.50
2024-12-11,02:14:00,21430.75,BUY,3,0.02h,Stop Loss,$-9.00,$-70.50,$111369.50,247,$-70.50
2024-12-11,02:17:00,21427.75,SELL,3,0.02h,Break Even,$-1.50,$-72.00,$111368.00,247,$-72.00
2024-12-11,02:52:00,21425.25,BUY,3,0.02h,Break Even,$-1.50,$-73.50,$111366.50,247,$-73.50
2024-12-11,03:35:00,21430.25,SELL,3,0.02h,Stop Loss,$-9.00,$-82.50,$111357.50,247,$-82.50
2024-12-11,03:37:00,21432.5,BUY,3,0.02h,Stop Loss,$-9.00,$-91.50,$111348.50,247,$-91.50
2024-12-11,03:38:00,21430.75,SELL,3,0.03h,Stop Loss,$-9.00,$-100.50,$111339.50,247,$-100.50
2024-12-11,04:54:00,21425.0,BUY,3,0.02h,Break Even,$-1.50,$-102.00,$111338.00,247,$-102.00
2024-12-11,05:26:00,21426.5,SELL,3,0.02h,Stop Loss,$-9.00,$-111.00,$111329.00,247,$-111.00
2024-12-11,05:49:00,21429.25,BUY,3,0.07h,Break Even,$-1.50,$-112.50,$111327.50,247,$-112.50
2024-12-11,06:26:00,21431.5,SELL,3,0.02h,Stop Loss,$-9.00,$-121.50,$111318.50,247,$-121.50
2024-12-11,06:27:00,21434.0,BUY,3,0.02h,Break Even,$-1.50,$-123.00,$111317.00,247,$-123.00
2024-12-11,06:51:00,21436.75,SELL,3,0.02h,Stop Loss,$-9.00,$-132.00,$111308.00,247,$-132.00
2024-12-11,06:53:00,21439.25,BUY,3,0.10h,Stop Loss,$28.50,$-103.50,$111336.50,247,$-103.50
2024-12-11,07:11:00,21429.75,SELL,3,0.02h,Break Even,$-1.50,$-105.00,$111335.00,247,$-105.00
2024-12-11,07:51:00,21424.25,BUY,3,0.02h,Break Even,$-1.50,$-106.50,$111333.50,247,$-106.50
2024-12-11,08:01:00,21418.0,SELL,3,0.02h,Stop Loss,$-9.00,$-115.50,$111324.50,247,$-115.50
2024-12-11,08:04:00,21428.75,BUY,3,0.02h,Stop Loss,$3.00,$-112.50,$111327.50,247,$-112.50
2024-12-11,08:55:00,21437.25,SELL,3,0.02h,Break Even,$-1.50,$-114.00,$111326.00,247,$-114.00
2024-12-11,09:05:00,21442.5,BUY,3,0.02h,Break Even,$-1.50,$-115.50,$111324.50,247,$-115.50
2024-12-11,09:22:00,21440.0,SELL,3,0.02h,Stop Loss,$-9.00,$-124.50,$111315.50,247,$-124.50
2024-12-11,09:24:00,21447.5,BUY,3,0.02h,Stop Loss,$-9.00,$-133.50,$111306.50,247,$-133.50
2024-12-11,09:27:00,21441.75,SELL,3,0.02h,Break Even,$-1.50,$-135.00,$111305.00,247,$-135.00
2024-12-11,09:30:00,21447.75,BUY,3,0.02h,Break Even,$-1.50,$-136.50,$111303.50,247,$-136.50
2024-12-11,09:51:00,21447.0,SELL,3,0.02h,Stop Loss,$-9.00,$-145.50,$111294.50,247,$-145.50
2024-12-11,09:52:00,21449.0,BUY,3,0.02h,Break Even,$-1.50,$-147.00,$111293.00,247,$-147.00
2024-12-11,10:12:00,21445.5,SELL,3,0.02h,Stop Loss,$-9.00,$-156.00,$111284.00,247,$-156.00
2024-12-11,10:15:00,21450.25,BUY,3,0.02h,Stop Loss,$-9.00,$-165.00,$111275.00,247,$-165.00
2024-12-11,10:17:00,21449.0,SELL,3,0.02h,Stop Loss,$18.00,$-147.00,$111293.00,247,$-147.00
2024-12-11,10:38:00,21445.0,BUY,3,0.02h,Stop Loss,$-9.00,$-156.00,$111284.00,247,$-156.00
2024-12-11,10:42:00,21441.0,SELL,3,0.02h,Stop Loss,$-9.00,$-165.00,$111275.00,247,$-165.00
2024-12-11,10:49:00,21445.0,BUY,3,0.02h,Break Even,$-1.50,$-166.50,$111273.50,247,$-166.50
2024-12-11,11:37:00,21453.5,SELL,3,0.02h,Stop Loss,$-9.00,$-175.50,$111264.50,247,$-175.50
2024-12-11,12:21:00,21443.75,BUY,3,0.02h,Break Even,$-1.50,$-177.00,$111263.00,247,$-177.00
2024-12-11,12:35:00,21438.25,SELL,3,0.02h,Stop Loss,$21.00,$-156.00,$111284.00,247,$-156.00
2024-12-11,12:49:00,21442.0,BUY,3,0.02h,Break Even,$-1.50,$-157.50,$111282.50,247,$-157.50
2024-12-11,12:59:00,21438.75,SELL,3,0.02h,Stop Loss,$-9.00,$-166.50,$111273.50,247,$-166.50
2024-12-11,13:04:00,21445.0,BUY,3,0.02h,Break Even,$-1.50,$-168.00,$111272.00,247,$-168.00
2024-12-11,15:30:00,21691.75,SELL,3,0.02h,Break Even,$-1.50,$-169.50,$111270.50,247,$-169.50
2024-12-11,15:34:00,21716.25,BUY,3,0.02h,Stop Loss,$46.50,$-123.00,$111317.00,247,$-123.00
2024-12-11,15:50:00,21706.25,SELL,3,0.02h,Stop Loss,$-9.00,$-132.00,$111308.00,247,$-132.00
2024-12-11,16:06:00,21717.0,BUY,3,0.02h,Stop Loss,$40.50,$-91.50,$111348.50,247,$-91.50
2024-12-11,16:53:00,21744.0,SELL,3,0.02h,Break Even,$-1.50,$-93.00,$111347.00,247,$-93.00
2024-12-11,17:00:00,21760.0,BUY,3,0.02h,Stop Loss,$31.50,$-61.50,$111378.50,247,$-61.50
2024-12-11,17:32:00,21764.5,SELL,3,0.02h,Stop Loss,$-9.00,$-70.50,$111369.50,247,$-70.50
2024-12-11,17:41:00,21784.0,BUY,3,0.02h,Stop Loss,$10.50,$-60.00,$111380.00,247,$-60.00
2024-12-11,17:53:00,21772.0,SELL,3,0.02h,Break Even,$-1.50,$-61.50,$111378.50,247,$-61.50
2024-12-11,18:03:00,21790.25,BUY,3,0.02h,Stop Loss,$7.50,$-54.00,$111386.00,247,$-54.00
2024-12-11,18:55:00,21794.25,SELL,3,0.02h,Stop Loss,$7.50,$-46.50,$111393.50,247,$-46.50
2024-12-11,19:21:00,21795.25,BUY,3,0.02h,Break Even,$-1.50,$-48.00,$111392.00,247,$-48.00
2024-12-11,19:48:00,21795.5,SELL,3,0.02h,Break Even,$-1.50,$-49.50,$111390.50,247,$-49.50
2024-12-11,20:03:00,21805.0,BUY,3,0.02h,Break Even,$-1.50,$-51.00,$111389.00,247,$-51.00
2024-12-11,20:36:00,21807.5,SELL,3,0.02h,Break Even,$-1.50,$-52.50,$111387.50,247,$-52.50
2024-12-11,23:01:00,21757.75,BUY,3,0.02h,Stop Loss,$-9.00,$-61.50,$111378.50,247,$-61.50
2024-12-11,23:02:00,21748.5,SELL,3,0.02h,Stop Loss,$-9.00,$-70.50,$111369.50,247,$-70.50
2024-12-11,23:05:00,21758.5,BUY,3,0.02h,Stop Loss,$18.00,$-52.50,$111387.50,247,$-52.50
2024-12-11,23:25:00,21754.25,SELL,3,0.02h,Stop Loss,$-9.00,$-61.50,$111378.50,247,$-61.50
2024-12-11,23:35:00,21759.5,BUY,3,0.02h,Break Even,$-1.50,$-63.00,$111377.00,247,$-63.00
2024-12-11,23:37:00,21757.5,SELL,3,0.03h,Break Even,$-1.50,$-64.50,$111375.50,247,$-64.50
2024-12-11,23:51:00,21760.0,BUY,3,0.02h,Break Even,$-1.50,$-66.00,$111374.00,247,$-66.00
,,,,,,,,,,,
2024-12-12,00:08:00,21756.75,SELL,3,0.02h,Break Even,$-1.50,$-1.50,$111372.50,248,$-1.50
2024-12-12,00:59:00,21750.5,BUY,3,0.02h,Break Even,$-1.50,$-3.00,$111371.00,248,$-3.00
2024-12-12,01:51:00,21752.5,SELL,3,0.02h,Break Even,$-1.50,$-4.50,$111369.50,248,$-4.50
2024-12-12,02:02:00,21758.25,BUY,3,0.03h,Stop Loss,$-9.00,$-13.50,$111360.50,248,$-13.50
2024-12-12,02:08:00,21752.5,SELL,3,0.08h,Break Even,$-1.50,$-15.00,$111359.00,248,$-15.00
2024-12-12,02:28:00,21754.0,BUY,3,0.07h,Break Even,$-1.50,$-16.50,$111357.50,248,$-16.50
2024-12-12,02:48:00,21752.5,SELL,3,0.02h,Stop Loss,$-9.00,$-25.50,$111348.50,248,$-25.50
2024-12-12,03:02:00,21755.25,BUY,3,0.02h,Break Even,$-1.50,$-27.00,$111347.00,248,$-27.00
2024-12-12,03:21:00,21756.5,SELL,3,0.02h,Stop Loss,$-9.00,$-36.00,$111338.00,248,$-36.00
2024-12-12,03:26:00,22027.75,BUY,3,0.02h,Stop Loss,$-9.00,$-45.00,$111329.00,248,$-45.00
2024-12-12,03:35:00,21762.25,SELL,3,0.02h,Stop Loss,$-9.00,$-54.00,$111320.00,248,$-54.00
2024-12-12,03:36:00,22031.25,BUY,3,0.02h,Stop Loss,$-9.00,$-63.00,$111311.00,248,$-63.00
2024-12-12,03:38:00,21758.75,SELL,3,0.03h,Break Even,$-1.50,$-64.50,$111309.50,248,$-64.50
2024-12-12,03:42:00,22026.0,BUY,3,0.03h,Stop Loss,$-9.00,$-73.50,$111300.50,248,$-73.50
2024-12-12,03:50:00,21757.25,SELL,3,0.05h,Stop Loss,$-9.00,$-82.50,$111291.50,248,$-82.50
2024-12-12,04:01:00,22030.0,BUY,3,0.02h,Stop Loss,$-9.00,$-91.50,$111282.50,248,$-91.50
2024-12-12,04:02:00,21759.75,SELL,3,0.08h,Stop Loss,$-9.00,$-100.50,$111273.50,248,$-100.50
2024-12-12,04:07:00,22030.5,BUY,3,0.02h,Stop Loss,$-9.00,$-109.50,$111264.50,248,$-109.50
2024-12-12,04:20:00,21758.25,SELL,3,0.02h,Stop Loss,$-9.00,$-118.50,$111255.50,248,$-118.50
2024-12-12,04:25:00,22031.5,BUY,3,0.02h,Stop Loss,$-9.00,$-127.50,$111246.50,248,$-127.50
2024-12-12,04:26:00,21759.5,SELL,3,0.02h,Stop Loss,$-9.00,$-136.50,$111237.50,248,$-136.50
2024-12-12,04:28:00,22031.5,BUY,3,0.02h,Stop Loss,$-9.00,$-145.50,$111228.50,248,$-145.50
2024-12-12,04:29:00,21761.0,SELL,3,0.03h,Stop Loss,$-9.00,$-154.50,$111219.50,248,$-154.50
2024-12-12,04:31:00,22031.5,BUY,3,0.02h,Stop Loss,$-9.00,$-163.50,$111210.50,248,$-163.50
2024-12-12,04:36:00,21760.5,SELL,3,0.03h,Stop Loss,$-9.00,$-172.50,$111201.50,248,$-172.50
2024-12-12,04:39:00,22031.75,BUY,3,0.03h,Stop Loss,$-9.00,$-181.50,$111192.50,248,$-181.50
2024-12-12,04:42:00,21761.75,SELL,3,0.02h,Stop Loss,$-9.00,$-190.50,$111183.50,248,$-190.50
2024-12-12,04:57:00,22031.75,BUY,3,0.02h,Stop Loss,$-9.00,$-199.50,$111174.50,248,$-199.50
2024-12-12,04:59:00,21761.5,SELL,3,0.03h,Stop Loss,$-9.00,$-208.50,$111165.50,248,$-208.50
2024-12-12,05:02:00,22033.0,BUY,3,0.02h,Stop Loss,$-9.00,$-217.50,$111156.50,248,$-217.50
2024-12-12,05:07:00,21759.5,SELL,3,0.02h,Break Even,$-1.50,$-219.00,$111155.00,248,$-219.00
2024-12-12,05:09:00,22031.0,BUY,3,0.02h,Stop Loss,$-9.00,$-228.00,$111146.00,248,$-228.00
2024-12-12,05:17:00,21759.5,SELL,3,0.02h,Break Even,$-1.50,$-229.50,$111144.50,248,$-229.50
2024-12-12,05:24:00,22030.5,BUY,3,0.02h,Stop Loss,$-9.00,$-238.50,$111135.50,248,$-238.50
2024-12-12,05:25:00,21758.75,SELL,3,0.02h,Stop Loss,$-9.00,$-247.50,$111126.50,248,$-247.50
2024-12-12,05:27:00,22029.25,BUY,3,0.02h,Stop Loss,$-9.00,$-256.50,$111117.50,248,$-256.50
2024-12-12,05:29:00,21758.75,SELL,3,0.03h,Stop Loss,$-9.00,$-265.50,$111108.50,248,$-265.50
2024-12-12,05:31:00,22030.5,BUY,3,0.02h,Stop Loss,$-9.00,$-274.50,$111099.50,248,$-274.50
2024-12-12,05:38:00,21761.25,SELL,3,0.03h,Break Even,$-1.50,$-276.00,$111098.00,248,$-276.00
2024-12-12,05:44:00,22028.75,BUY,3,0.02h,Stop Loss,$-9.00,$-285.00,$111089.00,248,$-285.00
2024-12-12,05:45:00,21760.0,SELL,3,0.02h,Stop Loss,$-9.00,$-294.00,$111080.00,248,$-294.00
2024-12-12,05:46:00,22031.75,BUY,3,0.02h,Stop Loss,$-9.00,$-303.00,$111071.00,248,$-303.00
2024-12-12,05:48:00,21761.25,SELL,3,0.03h,Stop Loss,$-9.00,$-312.00,$111062.00,248,$-312.00
2024-12-12,05:50:00,22031.75,BUY,3,0.02h,Stop Loss,$-9.00,$-321.00,$111053.00,248,$-321.00
2024-12-12,05:52:00,21763.0,SELL,3,0.02h,Break Even,$-1.50,$-322.50,$111051.50,248,$-322.50
2024-12-12,05:56:00,22034.5,BUY,3,0.02h,Stop Loss,$-9.00,$-331.50,$111042.50,248,$-331.50
2024-12-12,06:14:00,21759.75,SELL,3,0.02h,Stop Loss,$-9.00,$-340.50,$111033.50,248,$-340.50
2024-12-12,06:24:00,22029.5,BUY,3,0.03h,Break Even,$-1.50,$-342.00,$111032.00,248,$-342.00
2024-12-12,06:32:00,21758.0,SELL,3,0.02h,Stop Loss,$-9.00,$-351.00,$111023.00,248,$-351.00
2024-12-12,06:33:00,22028.5,BUY,3,0.02h,Stop Loss,$-9.00,$-360.00,$111014.00,248,$-360.00
2024-12-12,06:34:00,21755.25,SELL,3,0.02h,Stop Loss,$-9.00,$-369.00,$111005.00,248,$-369.00
2024-12-12,06:36:00,22030.0,BUY,3,0.02h,Stop Loss,$-9.00,$-378.00,$110996.00,248,$-378.00
2024-12-12,06:37:00,21759.5,SELL,3,0.02h,Stop Loss,$-9.00,$-387.00,$110987.00,248,$-387.00
2024-12-12,06:38:00,22029.75,BUY,3,0.02h,Stop Loss,$-9.00,$-396.00,$110978.00,248,$-396.00
2024-12-12,06:39:00,21759.75,SELL,3,0.02h,Break Even,$-1.50,$-397.50,$110976.50,248,$-397.50
2024-12-12,06:47:00,22028.25,BUY,3,0.03h,Break Even,$-1.50,$-399.00,$110975.00,248,$-399.00
2024-12-12,06:55:00,21761.25,SELL,3,0.02h,Stop Loss,$-9.00,$-408.00,$110966.00,248,$-408.00
2024-12-12,07:06:00,22035.0,BUY,3,0.02h,Stop Loss,$-9.00,$-417.00,$110957.00,248,$-417.00
2024-12-12,07:07:00,21762.0,SELL,3,0.02h,Stop Loss,$-9.00,$-426.00,$110948.00,248,$-426.00
2024-12-12,07:08:00,22034.0,BUY,3,0.02h,Stop Loss,$-9.00,$-435.00,$110939.00,248,$-435.00
2024-12-12,07:19:00,21761.5,SELL,3,0.02h,Break Even,$-1.50,$-436.50,$110937.50,248,$-436.50
2024-12-12,07:21:00,22029.5,BUY,3,0.03h,Break Even,$-1.50,$-438.00,$110936.00,248,$-438.00
2024-12-12,07:26:00,21762.5,SELL,3,0.02h,Break Even,$-1.50,$-439.50,$110934.50,248,$-439.50
2024-12-12,07:36:00,22031.75,BUY,3,0.02h,Stop Loss,$-9.00,$-448.50,$110925.50,248,$-448.50
2024-12-12,07:37:00,21763.0,SELL,3,0.02h,Stop Loss,$-9.00,$-457.50,$110916.50,248,$-457.50
2024-12-12,07:41:00,22035.25,BUY,3,0.02h,Stop Loss,$-9.00,$-466.50,$110907.50,248,$-466.50
2024-12-12,07:42:00,21762.0,SELL,3,0.02h,Stop Loss,$-9.00,$-475.50,$110898.50,248,$-475.50
2024-12-12,07:43:00,22030.5,BUY,3,0.03h,Break Even,$-1.50,$-477.00,$110897.00,248,$-477.00
2024-12-12,07:48:00,21760.0,SELL,3,0.02h,Stop Loss,$-9.00,$-486.00,$110888.00,248,$-486.00
2024-12-12,07:49:00,22030.0,BUY,3,0.02h,Stop Loss,$-9.00,$-495.00,$110879.00,248,$-495.00
2024-12-12,07:50:00,21761.5,SELL,3,0.02h,Break Even,$-1.50,$-496.50,$110877.50,248,$-496.50
2024-12-12,07:52:00,22031.25,BUY,3,0.02h,Stop Loss,$-9.00,$-505.50,$110868.50,248,$-505.50
2024-12-12,07:59:00,21752.0,SELL,3,0.02h,Stop Loss,$-9.00,$-514.50,$110859.50,248,$-514.50
2024-12-12,08:00:00,22024.0,BUY,3,0.02h,Stop Loss,$-9.00,$-523.50,$110850.50,248,$-523.50
2024-12-12,08:01:00,21759.25,SELL,3,0.02h,Stop Loss,$-9.00,$-532.50,$110841.50,248,$-532.50
2024-12-12,08:02:00,22032.5,BUY,3,0.03h,Break Even,$-1.50,$-534.00,$110840.00,248,$-534.00
2024-12-12,08:05:00,21763.0,SELL,3,0.02h,Stop Loss,$12.00,$-522.00,$110852.00,248,$-522.00
2024-12-12,08:13:00,22030.0,BUY,3,0.02h,Stop Loss,$-9.00,$-531.00,$110843.00,248,$-531.00
2024-12-12,08:14:00,21757.0,SELL,3,0.02h,Break Even,$-1.50,$-532.50,$110841.50,248,$-532.50
2024-12-12,08:24:00,22031.75,BUY,3,0.02h,Stop Loss,$-9.00,$-541.50,$110832.50,248,$-541.50
2024-12-12,08:25:00,21759.75,SELL,3,0.02h,Stop Loss,$-9.00,$-550.50,$110823.50,248,$-550.50
2024-12-12,08:26:00,22031.75,BUY,3,0.02h,Stop Loss,$-9.00,$-559.50,$110814.50,248,$-559.50
2024-12-12,08:36:00,21750.0,SELL,3,0.02h,Break Even,$-1.50,$-561.00,$110813.00,248,$-561.00
2024-12-12,08:40:00,22019.0,BUY,3,0.02h,Stop Loss,$-9.00,$-570.00,$110804.00,248,$-570.00
2024-12-12,08:51:00,21750.75,SELL,3,0.05h,Break Even,$-1.50,$-571.50,$110802.50,248,$-571.50
2024-12-12,08:57:00,22024.25,BUY,3,0.02h,Stop Loss,$-9.00,$-580.50,$110793.50,248,$-580.50
2024-12-12,08:58:00,21752.5,SELL,3,0.02h,Stop Loss,$-9.00,$-589.50,$110784.50,248,$-589.50
2024-12-12,08:59:00,22024.75,BUY,3,0.02h,Stop Loss,$-9.00,$-598.50,$110775.50,248,$-598.50
2024-12-12,09:07:00,21754.25,SELL,3,0.02h,Stop Loss,$3.00,$-595.50,$110778.50,248,$-595.50
2024-12-12,09:25:00,22021.5,BUY,3,0.02h,Stop Loss,$-9.00,$-604.50,$110769.50,248,$-604.50
2024-12-12,09:26:00,21749.5,SELL,3,0.02h,Stop Loss,$-9.00,$-613.50,$110760.50,248,$-613.50
2024-12-12,09:27:00,22019.0,BUY,3,0.02h,Stop Loss,$-9.00,$-622.50,$110751.50,248,$-622.50
2024-12-12,09:29:00,21745.25,SELL,3,0.02h,Stop Loss,$-9.00,$-631.50,$110742.50,248,$-631.50
2024-12-12,09:34:00,22009.5,BUY,3,0.02h,Stop Loss,$-9.00,$-640.50,$110733.50,248,$-640.50
2024-12-12,09:35:00,21739.75,SELL,3,0.02h,Stop Loss,$-9.00,$-649.50,$110724.50,248,$-649.50
2024-12-12,09:37:00,22009.25,BUY,3,0.02h,Stop Loss,$-9.00,$-658.50,$110715.50,248,$-658.50
2024-12-12,09:43:00,21738.5,SELL,3,0.02h,Break Even,$-1.50,$-660.00,$110714.00,248,$-660.00
2024-12-12,09:49:00,22010.25,BUY,3,0.03h,Break Even,$-1.50,$-661.50,$110712.50,248,$-661.50
2024-12-12,09:54:00,21739.0,SELL,3,0.02h,Break Even,$-1.50,$-663.00,$110711.00,248,$-663.00
2024-12-12,09:56:00,22009.0,BUY,3,0.02h,Stop Loss,$-9.00,$-672.00,$110702.00,248,$-672.00
2024-12-12,09:57:00,21731.5,SELL,3,0.02h,Stop Loss,$-9.00,$-681.00,$110693.00,248,$-681.00
2024-12-12,09:59:00,22006.0,BUY,3,0.02h,Stop Loss,$-9.00,$-690.00,$110684.00,248,$-690.00
2024-12-12,10:00:00,21734.0,SELL,3,0.02h,Stop Loss,$-9.00,$-699.00,$110675.00,248,$-699.00
2024-12-12,10:01:00,22000.5,BUY,3,0.05h,Break Even,$-1.50,$-700.50,$110673.50,248,$-700.50
2024-12-12,10:16:00,21733.5,SELL,3,0.02h,Stop Loss,$-9.00,$-709.50,$110664.50,248,$-709.50
2024-12-12,10:17:00,22003.75,BUY,3,0.03h,Stop Loss,$-9.00,$-718.50,$110655.50,248,$-718.50
2024-12-12,10:19:00,21732.75,SELL,3,0.02h,Break Even,$-1.50,$-720.00,$110654.00,248,$-720.00
2024-12-12,10:22:00,22003.75,BUY,3,0.02h,Stop Loss,$-9.00,$-729.00,$110645.00,248,$-729.00
2024-12-12,10:23:00,21732.25,SELL,3,0.02h,Stop Loss,$-9.00,$-738.00,$110636.00,248,$-738.00
2024-12-12,10:27:00,22017.5,BUY,3,0.02h,Stop Loss,$-9.00,$-747.00,$110627.00,248,$-747.00
2024-12-12,10:28:00,21742.5,SELL,3,0.03h,Stop Loss,$-9.00,$-756.00,$110618.00,248,$-756.00
2024-12-12,10:36:00,22012.5,BUY,3,0.02h,Stop Loss,$-9.00,$-765.00,$110609.00,248,$-765.00
2024-12-12,10:49:00,21740.25,SELL,3,0.03h,Stop Loss,$-9.00,$-774.00,$110600.00,248,$-774.00
2024-12-12,10:52:00,22011.75,BUY,3,0.03h,Break Even,$-1.50,$-775.50,$110598.50,248,$-775.50
2024-12-12,10:55:00,21739.25,SELL,3,0.02h,Stop Loss,$-9.00,$-784.50,$110589.50,248,$-784.50
2024-12-12,11:04:00,22013.0,BUY,3,0.02h,Stop Loss,$-9.00,$-793.50,$110580.50,248,$-793.50
2024-12-12,11:05:00,21741.75,SELL,3,0.02h,Break Even,$-1.50,$-795.00,$110579.00,248,$-795.00
2024-12-12,11:07:00,22016.75,BUY,3,0.02h,Stop Loss,$-9.00,$-804.00,$110570.00,248,$-804.00
2024-12-12,11:11:00,21736.25,SELL,3,0.02h,Stop Loss,$4.50,$-799.50,$110574.50,248,$-799.50
2024-12-12,11:21:00,22006.75,BUY,3,0.02h,Stop Loss,$-9.00,$-808.50,$110565.50,248,$-808.50
2024-12-12,11:26:00,21729.5,SELL,3,0.02h,Break Even,$-1.50,$-810.00,$110564.00,248,$-810.00
2024-12-12,11:30:00,22002.25,BUY,3,0.02h,Stop Loss,$-9.00,$-819.00,$110555.00,248,$-819.00
2024-12-12,11:31:00,21733.75,SELL,3,0.02h,Stop Loss,$-9.00,$-828.00,$110546.00,248,$-828.00
2024-12-12,11:32:00,22006.0,BUY,3,0.02h,Break Even,$-1.50,$-829.50,$110544.50,248,$-829.50
2024-12-12,11:37:00,21731.5,SELL,3,0.02h,Stop Loss,$-9.00,$-838.50,$110535.50,248,$-838.50
2024-12-12,11:39:00,22001.0,BUY,3,0.03h,Stop Loss,$-9.00,$-847.50,$110526.50,248,$-847.50
2024-12-12,11:41:00,21733.75,SELL,3,0.02h,Stop Loss,$-9.00,$-856.50,$110517.50,248,$-856.50
2024-12-12,11:42:00,22007.0,BUY,3,0.02h,Stop Loss,$-9.00,$-865.50,$110508.50,248,$-865.50
2024-12-12,11:43:00,21733.25,SELL,3,0.02h,Stop Loss,$-9.00,$-874.50,$110499.50,248,$-874.50
2024-12-12,11:59:00,21998.5,BUY,3,0.02h,Stop Loss,$-9.00,$-883.50,$110490.50,248,$-883.50
2024-12-12,12:08:00,21726.0,SELL,3,0.02h,Stop Loss,$-9.00,$-892.50,$110481.50,248,$-892.50
2024-12-12,12:09:00,21997.75,BUY,3,0.02h,Stop Loss,$-9.00,$-901.50,$110472.50,248,$-901.50
2024-12-12,12:15:00,21727.0,SELL,3,0.02h,Stop Loss,$-9.00,$-910.50,$110463.50,248,$-910.50
2024-12-12,12:16:00,21993.0,BUY,3,0.02h,Stop Loss,$-9.00,$-919.50,$110454.50,248,$-919.50
2024-12-12,12:17:00,21723.0,SELL,3,0.02h,Break Even,$-1.50,$-921.00,$110453.00,248,$-921.00
2024-12-12,12:23:00,21994.75,BUY,3,0.02h,Stop Loss,$-9.00,$-930.00,$110444.00,248,$-930.00
2024-12-12,12:24:00,21723.25,SELL,3,0.02h,Stop Loss,$-9.00,$-939.00,$110435.00,248,$-939.00
2024-12-12,12:26:00,21991.75,BUY,3,0.02h,Stop Loss,$-9.00,$-948.00,$110426.00,248,$-948.00
2024-12-12,12:27:00,21724.25,SELL,3,0.02h,Stop Loss,$-9.00,$-957.00,$110417.00,248,$-957.00
2024-12-12,12:29:00,21996.25,BUY,3,0.02h,Stop Loss,$-9.00,$-966.00,$110408.00,248,$-966.00
2024-12-12,12:30:00,21721.5,SELL,3,0.02h,Stop Loss,$-9.00,$-975.00,$110399.00,248,$-975.00
2024-12-12,12:32:00,21985.25,BUY,3,0.02h,Break Even,$-1.50,$-976.50,$110397.50,248,$-976.50
2024-12-12,12:36:00,21709.25,SELL,3,0.02h,Stop Loss,$9.00,$-967.50,$110406.50,248,$-967.50
2024-12-12,12:41:00,21977.75,BUY,3,0.02h,Stop Loss,$-9.00,$-976.50,$110397.50,248,$-976.50
2024-12-12,12:42:00,21706.0,SELL,3,0.02h,Stop Loss,$-9.00,$-985.50,$110388.50,248,$-985.50
2024-12-12,12:43:00,21975.5,BUY,3,0.02h,Stop Loss,$-9.00,$-994.50,$110379.50,248,$-994.50
2024-12-12,12:44:00,21704.25,SELL,3,0.02h,Stop Loss,$-9.00,$-1003.50,$110370.50,248,$-1003.50
2024-12-12,12:45:00,21976.25,BUY,3,0.02h,Stop Loss,$-9.00,$-1012.50,$110361.50,248,$-1012.50
2024-12-12,12:48:00,21707.0,SELL,3,0.02h,Stop Loss,$-9.00,$-1021.50,$110352.50,248,$-1021.50
2024-12-12,12:49:00,21980.75,BUY,3,0.02h,Stop Loss,$-9.00,$-1030.50,$110343.50,248,$-1030.50
2024-12-12,12:54:00,21703.5,SELL,3,0.02h,Stop Loss,$-9.00,$-1039.50,$110334.50,248,$-1039.50
2024-12-12,12:55:00,21966.75,BUY,3,0.02h,Stop Loss,$-9.00,$-1048.50,$110325.50,248,$-1048.50
2024-12-12,12:56:00,21697.25,SELL,3,0.02h,Stop Loss,$-9.00,$-1057.50,$110316.50,248,$-1057.50
2024-12-12,12:59:00,21969.0,BUY,3,0.03h,Stop Loss,$6.00,$-1051.50,$110322.50,248,$-1051.50
2024-12-12,13:05:00,21689.5,SELL,3,0.02h,Stop Loss,$-9.00,$-1060.50,$110313.50,248,$-1060.50
2024-12-12,13:06:00,21970.25,BUY,3,0.02h,Stop Loss,$-9.00,$-1069.50,$110304.50,248,$-1069.50
2024-12-12,13:07:00,21702.25,SELL,3,0.02h,Break Even,$-1.50,$-1071.00,$110303.00,248,$-1071.00
2024-12-12,13:12:00,21975.25,BUY,3,0.02h,Break Even,$-1.50,$-1072.50,$110301.50,248,$-1072.50
2024-12-12,13:16:00,21716.0,SELL,3,0.02h,Break Even,$-1.50,$-1074.00,$110300.00,248,$-1074.00
2024-12-12,13:21:00,21985.25,BUY,3,0.02h,Stop Loss,$-9.00,$-1083.00,$110291.00,248,$-1083.00
2024-12-12,13:22:00,21715.75,SELL,3,0.02h,Stop Loss,$-9.00,$-1092.00,$110282.00,248,$-1092.00
2024-12-12,13:24:00,21990.25,BUY,3,0.02h,Stop Loss,$-9.00,$-1101.00,$110273.00,248,$-1101.00
2024-12-12,13:25:00,21716.0,SELL,3,0.02h,Stop Loss,$25.50,$-1075.50,$110298.50,248,$-1075.50
2024-12-12,13:27:00,21980.25,BUY,3,0.03h,Stop Loss,$-9.00,$-1084.50,$110289.50,248,$-1084.50
2024-12-12,13:30:00,21710.75,SELL,3,0.02h,Stop Loss,$-9.00,$-1093.50,$110280.50,248,$-1093.50
2024-12-12,13:31:00,21972.25,BUY,3,0.02h,Stop Loss,$-9.00,$-1102.50,$110271.50,248,$-1102.50
2024-12-12,13:32:00,21685.75,SELL,3,0.02h,Stop Loss,$-9.00,$-1111.50,$110262.50,248,$-1111.50
2024-12-12,13:33:00,21959.25,BUY,3,0.02h,Stop Loss,$4.50,$-1107.00,$110267.00,248,$-1107.00
2024-12-12,13:39:00,21675.25,SELL,3,0.02h,Stop Loss,$-9.00,$-1116.00,$110258.00,248,$-1116.00
2024-12-12,13:40:00,21939.0,BUY,3,0.02h,Stop Loss,$-9.00,$-1125.00,$110249.00,248,$-1125.00
2024-12-12,13:41:00,21666.75,SELL,3,0.02h,Break Even,$-1.50,$-1126.50,$110247.50,248,$-1126.50
2024-12-12,13:57:00,21938.75,BUY,3,0.02h,Stop Loss,$-9.00,$-1135.50,$110238.50,248,$-1135.50
2024-12-12,14:05:00,21682.5,SELL,3,0.02h,Break Even,$-1.50,$-1137.00,$110237.00,248,$-1137.00
2024-12-12,14:07:00,21957.5,BUY,3,0.02h,Stop Loss,$-9.00,$-1146.00,$110228.00,248,$-1146.00
2024-12-12,14:08:00,21691.25,SELL,3,0.02h,Stop Loss,$-9.00,$-1155.00,$110219.00,248,$-1155.00
2024-12-12,14:12:00,21953.0,BUY,3,0.02h,Stop Loss,$-9.00,$-1164.00,$110210.00,248,$-1164.00
2024-12-12,14:13:00,21676.75,SELL,3,0.02h,Stop Loss,$-9.00,$-1173.00,$110201.00,248,$-1173.00
2024-12-12,14:16:00,21950.75,BUY,3,0.02h,Stop Loss,$16.50,$-1156.50,$110217.50,248,$-1156.50
2024-12-12,14:21:00,21682.5,SELL,3,0.02h,Stop Loss,$-9.00,$-1165.50,$110208.50,248,$-1165.50
2024-12-12,14:22:00,21955.75,BUY,3,0.02h,Stop Loss,$-9.00,$-1174.50,$110199.50,248,$-1174.50
2024-12-12,14:24:00,21689.75,SELL,3,0.02h,Stop Loss,$13.50,$-1161.00,$110213.00,248,$-1161.00
2024-12-12,14:28:00,21964.25,BUY,3,0.02h,Stop Loss,$-9.00,$-1170.00,$110204.00,248,$-1170.00
2024-12-12,14:29:00,21695.0,SELL,3,0.02h,Break Even,$-1.50,$-1171.50,$110202.50,248,$-1171.50
2024-12-12,14:35:00,21947.5,BUY,3,0.02h,Stop Loss,$-9.00,$-1180.50,$110193.50,248,$-1180.50
2024-12-12,14:36:00,21663.0,SELL,3,0.02h,Stop Loss,$18.00,$-1162.50,$110211.50,248,$-1162.50
2024-12-12,14:39:00,21957.0,BUY,3,0.02h,Break Even,$-1.50,$-1164.00,$110210.00,248,$-1164.00
2024-12-12,14:54:00,21673.5,SELL,3,0.02h,Stop Loss,$-9.00,$-1173.00,$110201.00,248,$-1173.00
2024-12-12,14:55:00,21935.75,BUY,3,0.02h,Stop Loss,$-9.00,$-1182.00,$110192.00,248,$-1182.00
2024-12-12,14:56:00,21668.75,SELL,3,0.02h,Stop Loss,$-9.00,$-1191.00,$110183.00,248,$-1191.00
2024-12-12,15:02:00,21937.5,BUY,3,0.02h,Stop Loss,$-9.00,$-1200.00,$110174.00,248,$-1200.00
2024-12-12,15:03:00,21666.25,SELL,3,0.02h,Stop Loss,$16.50,$-1183.50,$110190.50,248,$-1183.50
2024-12-12,15:15:00,21918.0,BUY,3,0.02h,Break Even,$-1.50,$-1185.00,$110189.00,248,$-1185.00
2024-12-12,15:18:00,21651.0,SELL,3,0.02h,Stop Loss,$-9.00,$-1194.00,$110180.00,248,$-1194.00
2024-12-12,15:19:00,21937.25,BUY,3,0.02h,Stop Loss,$75.00,$-1119.00,$110255.00,248,$-1119.00
2024-12-12,15:28:00,21699.75,SELL,3,0.02h,Stop Loss,$45.00,$-1074.00,$110300.00,248,$-1074.00
2024-12-12,15:30:00,21977.25,BUY,3,0.02h,Stop Loss,$-9.00,$-1083.00,$110291.00,248,$-1083.00
2024-12-12,15:39:00,21717.0,SELL,3,0.02h,Stop Loss,$-9.00,$-1092.00,$110282.00,248,$-1092.00
2024-12-12,15:40:00,21985.75,BUY,3,0.02h,Stop Loss,$-9.00,$-1101.00,$110273.00,248,$-1101.00
2024-12-12,15:41:00,21717.0,SELL,3,0.02h,Stop Loss,$45.00,$-1056.00,$110318.00,248,$-1056.00
2024-12-12,15:51:00,21985.0,BUY,3,0.02h,Break Even,$-1.50,$-1057.50,$110316.50,248,$-1057.50
2024-12-12,15:59:00,21712.0,SELL,3,0.02h,Break Even,$-1.50,$-1059.00,$110315.00,248,$-1059.00
2024-12-12,16:04:00,22002.0,BUY,3,0.02h,Stop Loss,$9.00,$-1050.00,$110324.00,248,$-1050.00
2024-12-12,16:13:00,21723.5,SELL,3,0.02h,Stop Loss,$-9.00,$-1059.00,$110315.00,248,$-1059.00
2024-12-12,16:14:00,22001.0,BUY,3,0.02h,Stop Loss,$-9.00,$-1068.00,$110306.00,248,$-1068.00
2024-12-12,16:16:00,21719.0,SELL,3,0.02h,Stop Loss,$-9.00,$-1077.00,$110297.00,248,$-1077.00
2024-12-12,16:17:00,21990.25,BUY,3,0.02h,Stop Loss,$-9.00,$-1086.00,$110288.00,248,$-1086.00
2024-12-12,16:18:00,21729.25,SELL,3,0.02h,Stop Loss,$-9.00,$-1095.00,$110279.00,248,$-1095.00
2024-12-12,16:19:00,21997.25,BUY,3,0.02h,Stop Loss,$-9.00,$-1104.00,$110270.00,248,$-1104.00
2024-12-12,16:20:00,21730.5,SELL,3,0.02h,Stop Loss,$45.00,$-1059.00,$110315.00,248,$-1059.00
2024-12-12,16:29:00,21988.25,BUY,3,0.02h,Stop Loss,$-9.00,$-1068.00,$110306.00,248,$-1068.00
2024-12-12,16:30:00,21716.25,SELL,3,0.02h,Stop Loss,$-9.00,$-1077.00,$110297.00,248,$-1077.00
2024-12-12,16:31:00,21981.5,BUY,3,0.02h,Stop Loss,$-9.00,$-1086.00,$110288.00,248,$-1086.00
2024-12-12,16:32:00,21710.0,SELL,3,0.02h,Stop Loss,$-9.00,$-1095.00,$110279.00,248,$-1095.00
2024-12-12,16:34:00,21982.0,BUY,3,0.02h,Stop Loss,$-9.00,$-1104.00,$110270.00,248,$-1104.00
2024-12-12,16:35:00,21710.25,SELL,3,0.02h,Break Even,$-1.50,$-1105.50,$110268.50,248,$-1105.50
2024-12-12,16:41:00,21969.0,BUY,3,0.02h,Stop Loss,$-9.00,$-1114.50,$110259.50,248,$-1114.50
2024-12-12,16:48:00,21677.0,SELL,3,0.02h,Stop Loss,$-9.00,$-1123.50,$110250.50,248,$-1123.50
2024-12-12,16:49:00,21955.0,BUY,3,0.02h,Stop Loss,$51.00,$-1072.50,$110301.50,248,$-1072.50
2024-12-12,17:00:00,21673.75,SELL,3,0.02h,Stop Loss,$7.50,$-1065.00,$110309.00,248,$-1065.00
2024-12-12,17:11:00,21985.5,BUY,3,0.02h,Stop Loss,$25.50,$-1039.50,$110334.50,248,$-1039.50
2024-12-12,17:16:00,21723.0,SELL,3,0.02h,Stop Loss,$-9.00,$-1048.50,$110325.50,248,$-1048.50
2024-12-12,17:17:00,21996.5,BUY,3,0.02h,Stop Loss,$-9.00,$-1057.50,$110316.50,248,$-1057.50
2024-12-12,17:24:00,21707.25,SELL,3,0.02h,Stop Loss,$7.50,$-1050.00,$110324.00,248,$-1050.00
2024-12-12,17:30:00,21986.25,BUY,3,0.02h,Break Even,$-1.50,$-1051.50,$110322.50,248,$-1051.50
2024-12-12,17:37:00,21692.5,SELL,3,0.02h,Break Even,$-1.50,$-1053.00,$110321.00,248,$-1053.00
2024-12-12,17:43:00,21967.25,BUY,3,0.03h,Stop Loss,$3.00,$-1050.00,$110324.00,248,$-1050.00
2024-12-12,17:46:00,21713.25,SELL,3,0.02h,Break Even,$-1.50,$-1051.50,$110322.50,248,$-1051.50
2024-12-12,17:50:00,21983.75,BUY,3,0.03h,Stop Loss,$27.00,$-1024.50,$110349.50,248,$-1024.50
2024-12-12,17:56:00,21728.5,SELL,3,0.02h,Break Even,$-1.50,$-1026.00,$110348.00,248,$-1026.00
2024-12-12,18:07:00,22004.75,BUY,3,0.02h,Stop Loss,$-9.00,$-1035.00,$110339.00,248,$-1035.00
2024-12-12,18:09:00,21717.75,SELL,3,0.02h,Stop Loss,$-9.00,$-1044.00,$110330.00,248,$-1044.00
2024-12-12,18:10:00,21993.5,BUY,3,0.02h,Stop Loss,$18.00,$-1026.00,$110348.00,248,$-1026.00
2024-12-12,18:21:00,21739.25,SELL,3,0.02h,Stop Loss,$21.00,$-1005.00,$110369.00,248,$-1005.00
2024-12-12,18:26:00,22006.5,BUY,3,0.02h,Stop Loss,$-9.00,$-1014.00,$110360.00,248,$-1014.00
2024-12-12,18:27:00,21742.25,SELL,3,0.02h,Stop Loss,$-9.00,$-1023.00,$110351.00,248,$-1023.00
2024-12-12,18:28:00,22011.5,BUY,3,0.02h,Stop Loss,$-9.00,$-1032.00,$110342.00,248,$-1032.00
2024-12-12,18:38:00,21714.75,SELL,3,0.02h,Stop Loss,$25.50,$-1006.50,$110367.50,248,$-1006.50
2024-12-12,18:47:00,21980.25,BUY,3,0.02h,Stop Loss,$-9.00,$-1015.50,$110358.50,248,$-1015.50
2024-12-12,18:48:00,21712.0,SELL,3,0.02h,Stop Loss,$4.50,$-1011.00,$110363.00,248,$-1011.00
2024-12-12,18:51:00,21980.25,BUY,3,0.02h,Stop Loss,$-9.00,$-1020.00,$110354.00,248,$-1020.00
2024-12-12,18:52:00,21708.5,SELL,3,0.02h,Stop Loss,$10.50,$-1009.50,$110364.50,248,$-1009.50
2024-12-12,18:57:00,21968.75,BUY,3,0.03h,Stop Loss,$13.50,$-996.00,$110378.00,248,$-996.00
2024-12-12,18:59:00,21696.75,SELL,3,0.02h,Break Even,$-1.50,$-997.50,$110376.50,248,$-997.50
2024-12-12,19:02:00,21961.0,BUY,3,0.02h,Stop Loss,$27.00,$-970.50,$110403.50,248,$-970.50
2024-12-12,19:04:00,21697.25,SELL,3,0.02h,Stop Loss,$-9.00,$-979.50,$110394.50,248,$-979.50
2024-12-12,19:05:00,21971.75,BUY,3,0.02h,Stop Loss,$-9.00,$-988.50,$110385.50,248,$-988.50
2024-12-12,19:06:00,21711.0,SELL,3,0.02h,Stop Loss,$-9.00,$-997.50,$110376.50,248,$-997.50
2024-12-12,19:07:00,21976.0,BUY,3,0.02h,Stop Loss,$-9.00,$-1006.50,$110367.50,248,$-1006.50
2024-12-12,19:08:00,21701.0,SELL,3,0.02h,Break Even,$-1.50,$-1008.00,$110366.00,248,$-1008.00
2024-12-12,19:26:00,21941.0,BUY,3,0.02h,Stop Loss,$-9.00,$-1017.00,$110357.00,248,$-1017.00
2024-12-12,19:27:00,21677.5,SELL,3,0.02h,Stop Loss,$-9.00,$-1026.00,$110348.00,248,$-1026.00
2024-12-12,19:28:00,21947.75,BUY,3,0.02h,Stop Loss,$-9.00,$-1035.00,$110339.00,248,$-1035.00
2024-12-12,19:29:00,21674.0,SELL,3,0.02h,Stop Loss,$-9.00,$-1044.00,$110330.00,248,$-1044.00
2024-12-12,19:30:00,21935.25,BUY,3,0.02h,Stop Loss,$-9.00,$-1053.00,$110321.00,248,$-1053.00
2024-12-12,19:35:00,21686.0,SELL,3,0.02h,Stop Loss,$-9.00,$-1062.00,$110312.00,248,$-1062.00
2024-12-12,19:36:00,21952.5,BUY,3,0.02h,Stop Loss,$9.00,$-1053.00,$110321.00,248,$-1053.00
2024-12-12,19:44:00,21679.0,SELL,3,0.02h,Stop Loss,$-9.00,$-1062.00,$110312.00,248,$-1062.00
2024-12-12,19:45:00,21953.25,BUY,3,0.02h,Stop Loss,$-9.00,$-1071.00,$110303.00,248,$-1071.00
2024-12-12,19:46:00,21692.25,SELL,3,0.02h,Break Even,$-1.50,$-1072.50,$110301.50,248,$-1072.50
2024-12-12,19:55:00,21955.5,BUY,3,0.02h,Stop Loss,$-9.00,$-1081.50,$110292.50,248,$-1081.50
2024-12-12,20:09:00,21675.75,SELL,3,0.02h,Break Even,$-1.50,$-1083.00,$110291.00,248,$-1083.00
2024-12-12,20:19:00,21936.5,BUY,3,0.02h,Stop Loss,$-9.00,$-1092.00,$110282.00,248,$-1092.00
2024-12-12,20:28:00,21651.5,SELL,3,0.02h,Stop Loss,$-9.00,$-1101.00,$110273.00,248,$-1101.00
2024-12-12,20:31:00,21928.5,BUY,3,0.02h,Stop Loss,$21.00,$-1080.00,$110294.00,248,$-1080.00
2024-12-12,20:37:00,21666.5,SELL,3,0.02h,Break Even,$-1.50,$-1081.50,$110292.50,248,$-1081.50
2024-12-12,20:40:00,21931.0,BUY,3,0.02h,Stop Loss,$-9.00,$-1090.50,$110283.50,248,$-1090.50
2024-12-12,20:44:00,21660.25,SELL,3,0.02h,Stop Loss,$-9.00,$-1099.50,$110274.50,248,$-1099.50
2024-12-12,20:47:00,21939.75,BUY,3,0.03h,Break Even,$-1.50,$-1101.00,$110273.00,248,$-1101.00
2024-12-12,20:54:00,21673.25,SELL,3,0.02h,Stop Loss,$42.00,$-1059.00,$110315.00,248,$-1059.00
2024-12-12,21:05:00,21890.5,BUY,3,0.02h,Stop Loss,$-9.00,$-1068.00,$110306.00,248,$-1068.00
2024-12-12,21:07:00,21618.75,SELL,3,0.02h,Stop Loss,$-9.00,$-1077.00,$110297.00,248,$-1077.00
2024-12-12,21:08:00,21887.75,BUY,3,0.02h,Stop Loss,$34.50,$-1042.50,$110331.50,248,$-1042.50
2024-12-12,21:11:00,21616.75,SELL,3,0.02h,Stop Loss,$-9.00,$-1051.50,$110322.50,248,$-1051.50
2024-12-12,21:12:00,21882.5,BUY,3,0.02h,Stop Loss,$-9.00,$-1060.50,$110313.50,248,$-1060.50
2024-12-12,21:13:00,21614.75,SELL,3,0.02h,Stop Loss,$-9.00,$-1069.50,$110304.50,248,$-1069.50
2024-12-12,21:15:00,21879.75,BUY,3,0.02h,Stop Loss,$366.00,$-703.50,$110670.50,248,$-703.50
2024-12-12,21:18:00,21659.0,SELL,3,0.02h,Stop Loss,$-9.00,$-712.50,$110661.50,248,$-712.50
2024-12-12,21:19:00,21941.25,BUY,3,0.02h,Stop Loss,$-9.00,$-721.50,$110652.50,248,$-721.50
2024-12-12,21:20:00,21673.5,SELL,3,0.02h,Stop Loss,$-9.00,$-730.50,$110643.50,248,$-730.50
2024-12-12,21:21:00,21930.75,BUY,3,0.02h,Stop Loss,$-9.00,$-739.50,$110634.50,248,$-739.50
2024-12-12,21:22:00,21657.25,SELL,3,0.02h,Stop Loss,$-9.00,$-748.50,$110625.50,248,$-748.50
2024-12-12,21:23:00,21934.5,BUY,3,0.02h,Stop Loss,$-9.00,$-757.50,$110616.50,248,$-757.50
2024-12-12,21:24:00,21664.5,SELL,3,0.02h,Stop Loss,$-9.00,$-766.50,$110607.50,248,$-766.50
2024-12-12,21:25:00,21936.25,BUY,3,0.02h,Stop Loss,$-9.00,$-775.50,$110598.50,248,$-775.50
2024-12-12,21:26:00,21676.5,SELL,3,0.02h,Stop Loss,$37.50,$-738.00,$110636.00,248,$-738.00
2024-12-12,21:35:00,21934.5,BUY,3,0.02h,Stop Loss,$-9.00,$-747.00,$110627.00,248,$-747.00
2024-12-12,21:36:00,21654.0,SELL,3,0.02h,Break Even,$-1.50,$-748.50,$110625.50,248,$-748.50
2024-12-12,21:41:00,21920.75,BUY,3,0.02h,Stop Loss,$-9.00,$-757.50,$110616.50,248,$-757.50
2024-12-12,21:42:00,21647.75,SELL,3,0.02h,Break Even,$-1.50,$-759.00,$110615.00,248,$-759.00
2024-12-12,21:44:00,21917.25,BUY,3,0.02h,Stop Loss,$-9.00,$-768.00,$110606.00,248,$-768.00
2024-12-12,21:59:00,21636.5,SELL,3,1.03h,Stop Loss,$-9.00,$-777.00,$110597.00,248,$-777.00
2024-12-12,23:01:00,21997.0,BUY,3,0.02h,Break Even,$-1.50,$-778.50,$110595.50,248,$-778.50
2024-12-12,23:04:00,21731.0,SELL,3,0.02h,Break Even,$-1.50,$-780.00,$110594.00,248,$-780.00
2024-12-12,23:07:00,21991.75,BUY,3,0.02h,Stop Loss,$-9.00,$-789.00,$110585.00,248,$-789.00
2024-12-12,23:08:00,21723.25,SELL,3,0.02h,Stop Loss,$9.00,$-780.00,$110594.00,248,$-780.00
2024-12-12,23:14:00,21993.25,BUY,3,0.02h,Stop Loss,$-9.00,$-789.00,$110585.00,248,$-789.00
2024-12-12,23:16:00,21731.75,SELL,3,0.02h,Stop Loss,$-9.00,$-798.00,$110576.00,248,$-798.00
2024-12-12,23:17:00,21996.0,BUY,3,0.02h,Stop Loss,$-9.00,$-807.00,$110567.00,248,$-807.00
2024-12-12,23:27:00,21733.25,SELL,3,0.02h,Break Even,$-1.50,$-808.50,$110565.50,248,$-808.50
2024-12-12,23:29:00,22002.0,BUY,3,0.02h,Break Even,$-1.50,$-810.00,$110564.00,248,$-810.00
2024-12-12,23:42:00,21743.75,SELL,3,0.02h,Stop Loss,$-9.00,$-819.00,$110555.00,248,$-819.00
2024-12-12,23:45:00,22014.5,BUY,3,0.02h,Break Even,$-1.50,$-820.50,$110553.50,248,$-820.50
2024-12-12,23:50:00,21741.75,SELL,3,0.02h,Break Even,$-1.50,$-822.00,$110552.00,248,$-822.00
2024-12-12,23:57:00,22013.25,BUY,3,0.02h,Stop Loss,$-9.00,$-831.00,$110543.00,248,$-831.00
2024-12-12,23:58:00,21742.25,SELL,3,0.02h,Stop Loss,$-9.00,$-840.00,$110534.00,248,$-840.00
,,,,,,,,,,,
2024-12-13,00:00:00,22011.75,BUY,3,0.02h,Break Even,$-1.50,$-1.50,$110532.50,249,$-1.50
2024-12-13,00:11:00,21751.25,SELL,3,0.02h,Stop Loss,$-9.00,$-10.50,$110523.50,249,$-10.50
2024-12-13,00:21:00,22027.75,BUY,3,0.02h,Stop Loss,$-9.00,$-19.50,$110514.50,249,$-19.50
2024-12-13,00:39:00,21763.0,SELL,3,0.02h,Stop Loss,$-9.00,$-28.50,$110505.50,249,$-28.50
2024-12-13,00:40:00,22030.25,BUY,3,0.02h,Stop Loss,$-9.00,$-37.50,$110496.50,249,$-37.50
2024-12-13,00:41:00,21763.0,SELL,3,0.02h,Break Even,$-1.50,$-39.00,$110495.00,249,$-39.00
2024-12-13,00:45:00,22031.0,BUY,3,0.02h,Stop Loss,$-9.00,$-48.00,$110486.00,249,$-48.00
2024-12-13,00:46:00,21762.0,SELL,3,0.02h,Stop Loss,$-9.00,$-57.00,$110477.00,249,$-57.00
2024-12-13,00:47:00,22028.0,BUY,3,0.02h,Stop Loss,$-9.00,$-66.00,$110468.00,249,$-66.00
2024-12-13,00:49:00,21756.25,SELL,3,0.03h,Break Even,$-1.50,$-67.50,$110466.50,249,$-67.50
2024-12-13,00:58:00,22025.5,BUY,3,0.02h,Stop Loss,$-9.00,$-76.50,$110457.50,249,$-76.50
2024-12-13,00:59:00,21758.5,SELL,3,0.02h,Stop Loss,$-9.00,$-85.50,$110448.50,249,$-85.50
2024-12-13,01:00:00,22022.5,BUY,3,0.02h,Stop Loss,$-9.00,$-94.50,$110439.50,249,$-94.50
2024-12-13,01:01:00,21752.0,SELL,3,0.02h,Stop Loss,$-9.00,$-103.50,$110430.50,249,$-103.50
2024-12-13,01:03:00,22023.0,BUY,3,0.02h,Break Even,$-1.50,$-105.00,$110429.00,249,$-105.00
2024-12-13,01:11:00,21759.0,SELL,3,0.02h,Stop Loss,$-9.00,$-114.00,$110420.00,249,$-114.00
2024-12-13,01:12:00,22026.75,BUY,3,0.02h,Stop Loss,$-9.00,$-123.00,$110411.00,249,$-123.00
2024-12-13,01:13:00,21756.0,SELL,3,0.02h,Stop Loss,$-9.00,$-132.00,$110402.00,249,$-132.00
2024-12-13,01:14:00,22028.0,BUY,3,0.02h,Stop Loss,$-9.00,$-141.00,$110393.00,249,$-141.00
2024-12-13,01:16:00,21751.5,SELL,3,0.02h,Stop Loss,$13.50,$-127.50,$110406.50,249,$-127.50
2024-12-13,01:22:00,22017.25,BUY,3,0.02h,Stop Loss,$-9.00,$-136.50,$110397.50,249,$-136.50
2024-12-13,01:24:00,21747.0,SELL,3,0.02h,Stop Loss,$3.00,$-133.50,$110400.50,249,$-133.50
2024-12-13,01:28:00,22011.5,BUY,3,0.02h,Stop Loss,$-9.00,$-142.50,$110391.50,249,$-142.50
2024-12-13,01:29:00,21742.25,SELL,3,0.02h,Stop Loss,$-9.00,$-151.50,$110382.50,249,$-151.50
2024-12-13,01:30:00,22006.75,BUY,3,0.02h,Stop Loss,$-9.00,$-160.50,$110373.50,249,$-160.50
2024-12-13,01:31:00,21744.25,SELL,3,0.02h,Break Even,$-1.50,$-162.00,$110372.00,249,$-162.00
2024-12-13,01:42:00,22012.0,BUY,3,0.02h,Stop Loss,$-9.00,$-171.00,$110363.00,249,$-171.00
2024-12-13,01:43:00,21744.0,SELL,3,0.02h,Stop Loss,$-9.00,$-180.00,$110354.00,249,$-180.00
2024-12-13,01:44:00,22010.5,BUY,3,0.03h,Break Even,$-1.50,$-181.50,$110352.50,249,$-181.50
2024-12-13,01:53:00,21741.75,SELL,3,0.02h,Stop Loss,$19.50,$-162.00,$110372.00,249,$-162.00
2024-12-13,01:56:00,22004.5,BUY,3,0.02h,Break Even,$-1.50,$-163.50,$110370.50,249,$-163.50
2024-12-13,02:02:00,21726.25,SELL,3,0.02h,Stop Loss,$-9.00,$-172.50,$110361.50,249,$-172.50
2024-12-13,02:14:00,21984.25,BUY,3,0.03h,Stop Loss,$10.50,$-162.00,$110372.00,249,$-162.00
2024-12-13,02:19:00,21721.0,SELL,3,0.02h,Stop Loss,$-9.00,$-171.00,$110363.00,249,$-171.00
2024-12-13,02:22:00,21993.5,BUY,3,0.02h,Stop Loss,$-9.00,$-180.00,$110354.00,249,$-180.00
2024-12-13,02:23:00,21727.0,SELL,3,0.02h,Break Even,$-1.50,$-181.50,$110352.50,249,$-181.50
2024-12-13,02:30:00,21999.5,BUY,3,0.02h,Stop Loss,$-9.00,$-190.50,$110343.50,249,$-190.50
2024-12-13,02:31:00,21727.25,SELL,3,0.02h,Stop Loss,$-9.00,$-199.50,$110334.50,249,$-199.50
2024-12-13,02:32:00,21999.75,BUY,3,0.02h,Stop Loss,$-9.00,$-208.50,$110325.50,249,$-208.50
2024-12-13,02:37:00,21728.75,SELL,3,0.02h,Stop Loss,$-9.00,$-217.50,$110316.50,249,$-217.50
2024-12-13,02:38:00,21996.75,BUY,3,0.02h,Stop Loss,$-9.00,$-226.50,$110307.50,249,$-226.50
2024-12-13,02:45:00,21720.75,SELL,3,0.02h,Stop Loss,$-9.00,$-235.50,$110298.50,249,$-235.50
2024-12-13,02:47:00,21993.75,BUY,3,0.02h,Stop Loss,$-9.00,$-244.50,$110289.50,249,$-244.50
2024-12-13,02:56:00,21722.25,SELL,3,0.02h,Stop Loss,$-9.00,$-253.50,$110280.50,249,$-253.50
2024-12-13,03:14:00,21985.25,BUY,3,0.02h,Stop Loss,$-9.00,$-262.50,$110271.50,249,$-262.50
2024-12-13,03:15:00,21715.25,SELL,3,0.03h,Stop Loss,$-9.00,$-271.50,$110262.50,249,$-271.50
2024-12-13,03:17:00,21982.5,BUY,3,0.02h,Stop Loss,$-9.00,$-280.50,$110253.50,249,$-280.50
2024-12-13,03:25:00,21711.75,SELL,3,0.03h,Stop Loss,$34.50,$-246.00,$110288.00,249,$-246.00
2024-12-13,03:30:00,21970.75,BUY,3,0.02h,Stop Loss,$6.00,$-240.00,$110294.00,249,$-240.00
2024-12-13,03:36:00,21705.25,SELL,3,0.03h,Stop Loss,$-9.00,$-249.00,$110285.00,249,$-249.00
2024-12-13,03:39:00,21979.75,BUY,3,0.02h,Stop Loss,$-9.00,$-258.00,$110276.00,249,$-258.00
2024-12-13,03:40:00,21710.0,SELL,3,0.02h,Break Even,$-1.50,$-259.50,$110274.50,249,$-259.50
2024-12-13,03:42:00,21972.0,BUY,3,0.02h,Stop Loss,$-9.00,$-268.50,$110265.50,249,$-268.50
2024-12-13,03:43:00,21705.75,SELL,3,0.02h,Break Even,$-1.50,$-270.00,$110264.00,249,$-270.00
2024-12-13,03:50:00,21979.5,BUY,3,0.02h,Stop Loss,$-9.00,$-279.00,$110255.00,249,$-279.00
2024-12-13,03:56:00,21707.75,SELL,3,0.02h,Stop Loss,$3.00,$-276.00,$110258.00,249,$-276.00
2024-12-13,03:58:00,21974.25,BUY,3,0.02h,Stop Loss,$-9.00,$-285.00,$110249.00,249,$-285.00
2024-12-13,03:59:00,21705.25,SELL,3,0.02h,Stop Loss,$-9.00,$-294.00,$110240.00,249,$-294.00
2024-12-13,04:00:00,21972.75,BUY,3,0.02h,Break Even,$-1.50,$-295.50,$110238.50,249,$-295.50
2024-12-13,04:02:00,21697.75,SELL,3,0.02h,Stop Loss,$-9.00,$-304.50,$110229.50,249,$-304.50
2024-12-13,04:03:00,21971.5,BUY,3,0.02h,Stop Loss,$-9.00,$-313.50,$110220.50,249,$-313.50
2024-12-13,04:04:00,21701.0,SELL,3,0.02h,Stop Loss,$-9.00,$-322.50,$110211.50,249,$-322.50
2024-12-13,04:08:00,21971.25,BUY,3,0.03h,Break Even,$-1.50,$-324.00,$110210.00,249,$-324.00
2024-12-13,04:12:00,21704.5,SELL,3,0.02h,Stop Loss,$-9.00,$-333.00,$110201.00,249,$-333.00
2024-12-13,04:19:00,21973.0,BUY,3,0.02h,Stop Loss,$-9.00,$-342.00,$110192.00,249,$-342.00
2024-12-13,04:33:00,21711.0,SELL,3,0.02h,Stop Loss,$-9.00,$-351.00,$110183.00,249,$-351.00
2024-12-13,04:35:00,21978.5,BUY,3,0.07h,Stop Loss,$19.50,$-331.50,$110202.50,249,$-331.50
2024-12-13,04:43:00,21711.25,SELL,3,0.02h,Stop Loss,$-9.00,$-340.50,$110193.50,249,$-340.50
2024-12-13,04:44:00,21980.5,BUY,3,0.03h,Stop Loss,$-9.00,$-349.50,$110184.50,249,$-349.50
2024-12-13,04:46:00,21714.75,SELL,3,0.02h,Stop Loss,$-9.00,$-358.50,$110175.50,249,$-358.50
2024-12-13,04:49:00,21985.5,BUY,3,0.03h,Stop Loss,$-9.00,$-367.50,$110166.50,249,$-367.50
2024-12-13,04:51:00,21716.25,SELL,3,0.02h,Stop Loss,$-9.00,$-376.50,$110157.50,249,$-376.50
2024-12-13,04:52:00,21984.5,BUY,3,0.05h,Stop Loss,$3.00,$-373.50,$110160.50,249,$-373.50
2024-12-13,04:55:00,21717.75,SELL,3,0.02h,Stop Loss,$-9.00,$-382.50,$110151.50,249,$-382.50
2024-12-13,04:56:00,21985.75,BUY,3,0.08h,Break Even,$-1.50,$-384.00,$110150.00,249,$-384.00
2024-12-13,05:05:00,21718.5,SELL,3,0.02h,Stop Loss,$-9.00,$-393.00,$110141.00,249,$-393.00
2024-12-13,05:06:00,21988.25,BUY,3,0.03h,Stop Loss,$-9.00,$-402.00,$110132.00,249,$-402.00
2024-12-13,05:09:00,21715.0,SELL,3,0.02h,Stop Loss,$-9.00,$-411.00,$110123.00,249,$-411.00
2024-12-13,05:11:00,21979.5,BUY,3,0.02h,Stop Loss,$-9.00,$-420.00,$110114.00,249,$-420.00
2024-12-13,05:13:00,21709.25,SELL,3,0.02h,Stop Loss,$-9.00,$-429.00,$110105.00,249,$-429.00
2024-12-13,05:33:00,21985.75,BUY,3,0.05h,Break Even,$-1.50,$-430.50,$110103.50,249,$-430.50
2024-12-13,05:40:00,21717.0,SELL,3,0.02h,Stop Loss,$-9.00,$-439.50,$110094.50,249,$-439.50
2024-12-13,05:41:00,21987.75,BUY,3,0.03h,Break Even,$-1.50,$-441.00,$110093.00,249,$-441.00
2024-12-13,05:43:00,21719.75,SELL,3,0.02h,Stop Loss,$-9.00,$-450.00,$110084.00,249,$-450.00
2024-12-13,05:44:00,21990.0,BUY,3,0.02h,Stop Loss,$-9.00,$-459.00,$110075.00,249,$-459.00
2024-12-13,05:45:00,21720.5,SELL,3,0.02h,Stop Loss,$-9.00,$-468.00,$110066.00,249,$-468.00
2024-12-13,05:46:00,21988.75,BUY,3,0.03h,Break Even,$-1.50,$-469.50,$110064.50,249,$-469.50
2024-12-13,05:50:00,21722.75,SELL,3,0.02h,Break Even,$-1.50,$-471.00,$110063.00,249,$-471.00
2024-12-13,06:01:00,21997.0,BUY,3,0.02h,Stop Loss,$-9.00,$-480.00,$110054.00,249,$-480.00
2024-12-13,06:02:00,21729.0,SELL,3,0.02h,Stop Loss,$-9.00,$-489.00,$110045.00,249,$-489.00
2024-12-13,06:03:00,21999.75,BUY,3,0.02h,Stop Loss,$-9.00,$-498.00,$110036.00,249,$-498.00
2024-12-13,06:08:00,21731.0,SELL,3,0.02h,Break Even,$-1.50,$-499.50,$110034.50,249,$-499.50
2024-12-13,06:19:00,22001.5,BUY,3,0.10h,Stop Loss,$12.00,$-487.50,$110046.50,249,$-487.50
2024-12-13,06:27:00,21737.5,SELL,3,0.02h,Break Even,$-1.50,$-489.00,$110045.00,249,$-489.00
2024-12-13,06:34:00,22007.25,BUY,3,0.02h,Stop Loss,$-9.00,$-498.00,$110036.00,249,$-498.00
2024-12-13,06:39:00,21735.25,SELL,3,0.02h,Stop Loss,$-9.00,$-507.00,$110027.00,249,$-507.00
2024-12-13,06:42:00,22009.75,BUY,3,0.02h,Stop Loss,$-9.00,$-516.00,$110018.00,249,$-516.00
2024-12-13,06:43:00,21736.75,SELL,3,0.02h,Stop Loss,$-9.00,$-525.00,$110009.00,249,$-525.00
2024-12-13,06:44:00,22008.75,BUY,3,0.03h,Stop Loss,$-9.00,$-534.00,$110000.00,249,$-534.00
2024-12-13,06:56:00,21744.0,SELL,3,0.02h,Stop Loss,$-9.00,$-543.00,$109991.00,249,$-543.00
2024-12-13,07:05:00,22008.75,BUY,3,0.02h,Stop Loss,$-9.00,$-552.00,$109982.00,249,$-552.00
2024-12-13,07:06:00,21733.0,SELL,3,0.02h,Stop Loss,$6.00,$-546.00,$109988.00,249,$-546.00
2024-12-13,07:08:00,22005.0,BUY,3,0.02h,Stop Loss,$13.50,$-532.50,$110001.50,249,$-532.50
2024-12-13,07:17:00,21730.75,SELL,3,0.02h,Break Even,$-1.50,$-534.00,$110000.00,249,$-534.00
2024-12-13,07:23:00,22005.0,BUY,3,0.03h,Stop Loss,$3.00,$-531.00,$110003.00,249,$-531.00
2024-12-13,07:33:00,21745.0,SELL,3,0.02h,Stop Loss,$3.00,$-528.00,$110006.00,249,$-528.00
2024-12-13,07:36:00,22011.0,BUY,3,0.03h,Break Even,$-1.50,$-529.50,$110004.50,249,$-529.50
2024-12-13,07:43:00,21735.0,SELL,3,0.02h,Stop Loss,$-9.00,$-538.50,$109995.50,249,$-538.50
2024-12-13,07:48:00,22004.25,BUY,3,0.03h,Stop Loss,$-9.00,$-547.50,$109986.50,249,$-547.50
2024-12-13,07:50:00,21736.25,SELL,3,0.02h,Stop Loss,$-9.00,$-556.50,$109977.50,249,$-556.50
2024-12-13,07:54:00,22008.25,BUY,3,0.02h,Stop Loss,$-9.00,$-565.50,$109968.50,249,$-565.50
2024-12-13,07:56:00,21735.5,SELL,3,0.02h,Stop Loss,$-9.00,$-574.50,$109959.50,249,$-574.50
2024-12-13,07:57:00,22008.25,BUY,3,0.02h,Stop Loss,$-9.00,$-583.50,$109950.50,249,$-583.50
2024-12-13,07:59:00,21736.25,SELL,3,0.02h,Break Even,$-1.50,$-585.00,$109949.00,249,$-585.00
2024-12-13,08:02:00,22005.25,BUY,3,0.02h,Stop Loss,$-9.00,$-594.00,$109940.00,249,$-594.00
2024-12-13,08:03:00,21737.0,SELL,3,0.02h,Stop Loss,$-9.00,$-603.00,$109931.00,249,$-603.00
2024-12-13,08:04:00,22008.75,BUY,3,0.03h,Stop Loss,$15.00,$-588.00,$109946.00,249,$-588.00
2024-12-13,08:12:00,21743.25,SELL,3,0.02h,Break Even,$-1.50,$-589.50,$109944.50,249,$-589.50
2024-12-13,08:16:00,22018.75,BUY,3,0.02h,Stop Loss,$-9.00,$-598.50,$109935.50,249,$-598.50
2024-12-13,08:17:00,21748.5,SELL,3,0.02h,Stop Loss,$-9.00,$-607.50,$109926.50,249,$-607.50
2024-12-13,08:20:00,22022.75,BUY,3,0.02h,Break Even,$-1.50,$-609.00,$109925.00,249,$-609.00
2024-12-13,08:22:00,21755.25,SELL,3,0.02h,Stop Loss,$-9.00,$-618.00,$109916.00,249,$-618.00
2024-12-13,08:27:00,22032.5,BUY,3,0.02h,Stop Loss,$-9.00,$-627.00,$109907.00,249,$-627.00
2024-12-13,08:28:00,21765.5,SELL,3,0.02h,Stop Loss,$-9.00,$-636.00,$109898.00,249,$-636.00
2024-12-13,08:29:00,22035.75,BUY,3,0.02h,Stop Loss,$-9.00,$-645.00,$109889.00,249,$-645.00
2024-12-13,08:46:00,21752.5,SELL,3,0.02h,Stop Loss,$-9.00,$-654.00,$109880.00,249,$-654.00
2024-12-13,08:51:00,22022.75,BUY,3,0.02h,Break Even,$-1.50,$-655.50,$109878.50,249,$-655.50
2024-12-13,08:53:00,21753.0,SELL,3,0.02h,Stop Loss,$-9.00,$-664.50,$109869.50,249,$-664.50
2024-12-13,09:11:00,22029.0,BUY,3,0.02h,Stop Loss,$-9.00,$-673.50,$109860.50,249,$-673.50
2024-12-13,09:12:00,21762.5,SELL,3,0.02h,Break Even,$-1.50,$-675.00,$109859.00,249,$-675.00
2024-12-13,09:17:00,22032.25,BUY,3,0.02h,Stop Loss,$-9.00,$-684.00,$109850.00,249,$-684.00
2024-12-13,09:18:00,21763.5,SELL,3,0.02h,Stop Loss,$-9.00,$-693.00,$109841.00,249,$-693.00
2024-12-13,09:20:00,22033.5,BUY,3,0.02h,Stop Loss,$-9.00,$-702.00,$109832.00,249,$-702.00
2024-12-13,09:33:00,21762.5,SELL,3,0.02h,Stop Loss,$-9.00,$-711.00,$109823.00,249,$-711.00
2024-12-13,09:34:00,22032.5,BUY,3,0.02h,Stop Loss,$-9.00,$-720.00,$109814.00,249,$-720.00
2024-12-13,09:36:00,21760.5,SELL,3,0.02h,Stop Loss,$-9.00,$-729.00,$109805.00,249,$-729.00
2024-12-13,09:44:00,22044.75,BUY,3,0.02h,Stop Loss,$27.00,$-702.00,$109832.00,249,$-702.00
2024-12-13,09:50:00,21781.0,SELL,3,0.02h,Break Even,$-1.50,$-703.50,$109830.50,249,$-703.50
2024-12-13,09:56:00,22051.5,BUY,3,0.02h,Stop Loss,$4.50,$-699.00,$109835.00,249,$-699.00
2024-12-13,10:05:00,21794.25,SELL,3,0.02h,Stop Loss,$4.50,$-694.50,$109839.50,249,$-694.50
2024-12-13,10:08:00,22063.0,BUY,3,0.02h,Stop Loss,$-9.00,$-703.50,$109830.50,249,$-703.50
2024-12-13,10:09:00,21788.5,SELL,3,0.02h,Stop Loss,$-9.00,$-712.50,$109821.50,249,$-712.50
2024-12-13,10:10:00,22057.25,BUY,3,0.02h,Stop Loss,$7.50,$-705.00,$109829.00,249,$-705.00
2024-12-13,10:17:00,21783.25,SELL,3,0.02h,Stop Loss,$-9.00,$-714.00,$109820.00,249,$-714.00
2024-12-13,10:18:00,22055.0,BUY,3,0.02h,Break Even,$-1.50,$-715.50,$109818.50,249,$-715.50
2024-12-13,10:21:00,21784.5,SELL,3,0.02h,Stop Loss,$-9.00,$-724.50,$109809.50,249,$-724.50
2024-12-13,10:22:00,22060.0,BUY,3,0.02h,Break Even,$-1.50,$-726.00,$109808.00,249,$-726.00
2024-12-13,10:24:00,21788.75,SELL,3,0.02h,Stop Loss,$-9.00,$-735.00,$109799.00,249,$-735.00
2024-12-13,10:25:00,22060.75,BUY,3,0.05h,Break Even,$-1.50,$-736.50,$109797.50,249,$-736.50
2024-12-13,10:29:00,21791.5,SELL,3,0.02h,Stop Loss,$-9.00,$-745.50,$109788.50,249,$-745.50
2024-12-13,10:30:00,22065.25,BUY,3,0.02h,Stop Loss,$-9.00,$-754.50,$109779.50,249,$-754.50
2024-12-13,10:34:00,21788.75,SELL,3,0.02h,Break Even,$-1.50,$-756.00,$109778.00,249,$-756.00
2024-12-13,10:55:00,22064.75,BUY,3,0.02h,Stop Loss,$-9.00,$-765.00,$109769.00,249,$-765.00
2024-12-13,11:11:00,21791.75,SELL,3,0.02h,Stop Loss,$-9.00,$-774.00,$109760.00,249,$-774.00
2024-12-13,11:12:00,22059.5,BUY,3,0.02h,Break Even,$-1.50,$-775.50,$109758.50,249,$-775.50
2024-12-13,11:15:00,21790.0,SELL,3,0.02h,Stop Loss,$-9.00,$-784.50,$109749.50,249,$-784.50
2024-12-13,11:16:00,22064.25,BUY,3,0.02h,Stop Loss,$-9.00,$-793.50,$109740.50,249,$-793.50
2024-12-13,11:17:00,21788.75,SELL,3,0.02h,Stop Loss,$-9.00,$-802.50,$109731.50,249,$-802.50
2024-12-13,11:18:00,22060.0,BUY,3,0.02h,Stop Loss,$31.50,$-771.00,$109763.00,249,$-771.00
2024-12-13,11:21:00,21801.0,SELL,3,0.02h,Stop Loss,$-9.00,$-780.00,$109754.00,249,$-780.00
2024-12-13,11:22:00,22069.5,BUY,3,0.02h,Stop Loss,$-9.00,$-789.00,$109745.00,249,$-789.00
2024-12-13,11:23:00,21796.75,SELL,3,0.02h,Stop Loss,$-9.00,$-798.00,$109736.00,249,$-798.00
2024-12-13,11:24:00,22071.25,BUY,3,0.02h,Stop Loss,$-9.00,$-807.00,$109727.00,249,$-807.00
2024-12-13,11:25:00,21799.5,SELL,3,0.02h,Stop Loss,$-9.00,$-816.00,$109718.00,249,$-816.00
2024-12-13,11:41:00,22066.25,BUY,3,0.02h,Stop Loss,$-9.00,$-825.00,$109709.00,249,$-825.00
2024-12-13,11:50:00,21795.0,SELL,3,0.02h,Stop Loss,$-9.00,$-834.00,$109700.00,249,$-834.00
2024-12-13,11:51:00,22067.75,BUY,3,0.02h,Stop Loss,$-9.00,$-843.00,$109691.00,249,$-843.00
2024-12-13,11:56:00,21789.25,SELL,3,0.02h,Stop Loss,$-9.00,$-852.00,$109682.00,249,$-852.00
2024-12-13,11:58:00,22063.25,BUY,3,0.02h,Stop Loss,$-9.00,$-861.00,$109673.00,249,$-861.00
2024-12-13,12:00:00,21788.25,SELL,3,0.02h,Stop Loss,$-9.00,$-870.00,$109664.00,249,$-870.00
2024-12-13,12:01:00,22056.25,BUY,3,0.02h,Break Even,$-1.50,$-871.50,$109662.50,249,$-871.50
2024-12-13,12:03:00,21790.5,SELL,3,0.02h,Stop Loss,$-9.00,$-880.50,$109653.50,249,$-880.50
2024-12-13,12:05:00,22070.0,BUY,3,0.02h,Break Even,$-1.50,$-882.00,$109652.00,249,$-882.00
2024-12-13,12:07:00,21800.0,SELL,3,0.02h,Stop Loss,$-9.00,$-891.00,$109643.00,249,$-891.00
2024-12-13,12:12:00,22076.25,BUY,3,0.02h,Break Even,$-1.50,$-892.50,$109641.50,249,$-892.50
2024-12-13,12:16:00,21811.25,SELL,3,0.02h,Stop Loss,$-9.00,$-901.50,$109632.50,249,$-901.50
2024-12-13,12:17:00,22083.25,BUY,3,0.02h,Stop Loss,$-9.00,$-910.50,$109623.50,249,$-910.50
2024-12-13,12:24:00,21821.75,SELL,3,0.02h,Stop Loss,$-9.00,$-919.50,$109614.50,249,$-919.50
2024-12-13,12:27:00,22094.0,BUY,3,0.03h,Stop Loss,$-9.00,$-928.50,$109605.50,249,$-928.50
2024-12-13,12:30:00,21821.75,SELL,3,0.02h,Stop Loss,$7.50,$-921.00,$109613.00,249,$-921.00
2024-12-13,12:41:00,22091.25,BUY,3,0.02h,Break Even,$-1.50,$-922.50,$109611.50,249,$-922.50
2024-12-13,12:47:00,21824.0,SELL,3,0.02h,Stop Loss,$-9.00,$-931.50,$109602.50,249,$-931.50
2024-12-13,12:48:00,22096.75,BUY,3,0.02h,Stop Loss,$-9.00,$-940.50,$109593.50,249,$-940.50
2024-12-13,12:49:00,21824.5,SELL,3,0.02h,Break Even,$-1.50,$-942.00,$109592.00,249,$-942.00
2024-12-13,12:55:00,22100.0,BUY,3,0.02h,Stop Loss,$-9.00,$-951.00,$109583.00,249,$-951.00
2024-12-13,12:56:00,21833.0,SELL,3,0.02h,Stop Loss,$4.50,$-946.50,$109587.50,249,$-946.50
2024-12-13,12:58:00,22107.25,BUY,3,0.02h,Stop Loss,$-9.00,$-955.50,$109578.50,249,$-955.50
2024-12-13,13:01:00,21838.25,SELL,3,0.02h,Stop Loss,$-9.00,$-964.50,$109569.50,249,$-964.50
2024-12-13,13:04:00,22105.0,BUY,3,0.02h,Stop Loss,$-9.00,$-973.50,$109560.50,249,$-973.50
2024-12-13,13:05:00,21828.0,SELL,3,0.02h,Break Even,$-1.50,$-975.00,$109559.00,249,$-975.00
2024-12-13,13:07:00,22108.75,BUY,3,0.02h,Stop Loss,$-9.00,$-984.00,$109550.00,249,$-984.00
2024-12-13,13:10:00,21831.0,SELL,3,0.02h,Break Even,$-1.50,$-985.50,$109548.50,249,$-985.50
2024-12-13,13:14:00,22108.0,BUY,3,0.02h,Stop Loss,$-9.00,$-994.50,$109539.50,249,$-994.50
2024-12-13,13:15:00,21835.5,SELL,3,0.02h,Stop Loss,$-9.00,$-1003.50,$109530.50,249,$-1003.50
2024-12-13,13:16:00,22109.0,BUY,3,0.03h,Break Even,$-1.50,$-1005.00,$109529.00,249,$-1005.00
2024-12-13,13:23:00,21835.0,SELL,3,0.02h,Stop Loss,$-9.00,$-1014.00,$109520.00,249,$-1014.00
2024-12-13,13:25:00,22108.0,BUY,3,0.02h,Stop Loss,$-9.00,$-1023.00,$109511.00,249,$-1023.00
2024-12-13,13:26:00,21837.5,SELL,3,0.02h,Break Even,$-1.50,$-1024.50,$109509.50,249,$-1024.50
2024-12-13,13:32:00,22109.5,BUY,3,0.02h,Stop Loss,$-9.00,$-1033.50,$109500.50,249,$-1033.50
2024-12-13,13:34:00,21838.5,SELL,3,0.02h,Break Even,$-1.50,$-1035.00,$109499.00,249,$-1035.00
2024-12-13,13:36:00,22109.5,BUY,3,0.02h,Stop Loss,$-9.00,$-1044.00,$109490.00,249,$-1044.00
2024-12-13,13:41:00,21830.5,SELL,3,0.02h,Break Even,$-1.50,$-1045.50,$109488.50,249,$-1045.50
2024-12-13,13:43:00,22099.25,BUY,3,0.02h,Stop Loss,$-9.00,$-1054.50,$109479.50,249,$-1054.50
2024-12-13,13:44:00,21832.75,SELL,3,0.02h,Stop Loss,$-9.00,$-1063.50,$109470.50,249,$-1063.50
2024-12-13,13:45:00,22104.0,BUY,3,0.02h,Stop Loss,$-9.00,$-1072.50,$109461.50,249,$-1072.50
2024-12-13,13:56:00,21822.5,SELL,3,0.02h,Stop Loss,$-9.00,$-1081.50,$109452.50,249,$-1081.50
2024-12-13,13:57:00,22091.0,BUY,3,0.02h,Stop Loss,$-9.00,$-1090.50,$109443.50,249,$-1090.50
2024-12-13,14:00:00,21821.25,SELL,3,0.02h,Stop Loss,$-9.00,$-1099.50,$109434.50,249,$-1099.50
2024-12-13,14:01:00,22087.75,BUY,3,0.02h,Stop Loss,$-9.00,$-1108.50,$109425.50,249,$-1108.50
2024-12-13,14:02:00,21813.25,SELL,3,0.02h,Stop Loss,$13.50,$-1095.00,$109439.00,249,$-1095.00
2024-12-13,14:14:00,22082.5,BUY,3,0.02h,Stop Loss,$-9.00,$-1104.00,$109430.00,249,$-1104.00
2024-12-13,14:15:00,21802.75,SELL,3,0.02h,Stop Loss,$25.50,$-1078.50,$109455.50,249,$-1078.50
2024-12-13,14:26:00,22053.25,BUY,3,0.02h,Stop Loss,$-9.00,$-1087.50,$109446.50,249,$-1087.50
2024-12-13,14:27:00,21786.75,SELL,3,0.02h,Stop Loss,$7.50,$-1080.00,$109454.00,249,$-1080.00
2024-12-13,14:31:00,22079.25,BUY,3,0.02h,Stop Loss,$27.00,$-1053.00,$109481.00,249,$-1053.00
2024-12-13,14:34:00,21814.25,SELL,3,0.02h,Break Even,$-1.50,$-1054.50,$109479.50,249,$-1054.50
2024-12-13,14:38:00,22116.25,BUY,3,0.02h,Stop Loss,$-9.00,$-1063.50,$109470.50,249,$-1063.50
2024-12-13,14:50:00,21885.25,SELL,3,0.02h,Stop Loss,$-9.00,$-1072.50,$109461.50,249,$-1072.50
2024-12-13,14:55:00,22153.25,BUY,3,0.02h,Stop Loss,$-9.00,$-1081.50,$109452.50,249,$-1081.50
2024-12-13,14:57:00,21875.5,SELL,3,0.02h,Break Even,$-1.50,$-1083.00,$109451.00,249,$-1083.00
2024-12-13,14:59:00,22162.25,BUY,3,0.02h,Break Even,$-1.50,$-1084.50,$109449.50,249,$-1084.50
2024-12-13,15:10:00,21847.0,SELL,3,0.02h,Stop Loss,$-9.00,$-1093.50,$109440.50,249,$-1093.50
2024-12-13,15:11:00,22127.0,BUY,3,0.02h,Stop Loss,$-9.00,$-1102.50,$109431.50,249,$-1102.50
2024-12-13,15:12:00,21865.0,SELL,3,0.02h,Stop Loss,$-9.00,$-1111.50,$109422.50,249,$-1111.50
2024-12-13,15:14:00,22154.25,BUY,3,0.02h,Stop Loss,$7.50,$-1104.00,$109430.00,249,$-1104.00
2024-12-13,15:20:00,21828.0,SELL,3,0.02h,Stop Loss,$-9.00,$-1113.00,$109421.00,249,$-1113.00
2024-12-13,15:21:00,22108.25,BUY,3,0.02h,Stop Loss,$49.50,$-1063.50,$109470.50,249,$-1063.50
2024-12-13,15:24:00,21840.25,SELL,3,0.02h,Stop Loss,$-9.00,$-1072.50,$109461.50,249,$-1072.50
2024-12-13,15:25:00,22108.75,BUY,3,0.02h,Break Even,$-1.50,$-1074.00,$109460.00,249,$-1074.00
2024-12-13,15:27:00,21810.0,SELL,3,0.02h,Stop Loss,$-9.00,$-1083.00,$109451.00,249,$-1083.00
2024-12-13,15:29:00,22094.5,BUY,3,0.02h,Stop Loss,$-9.00,$-1092.00,$109442.00,249,$-1092.00
2024-12-13,15:35:00,21811.0,SELL,3,0.02h,Stop Loss,$-9.00,$-1101.00,$109433.00,249,$-1101.00
2024-12-13,15:37:00,22085.5,BUY,3,0.02h,Stop Loss,$-9.00,$-1110.00,$109424.00,249,$-1110.00
2024-12-13,15:41:00,21759.75,SELL,3,0.02h,Stop Loss,$105.00,$-1005.00,$109529.00,249,$-1005.00
2024-12-13,15:57:00,21987.5,BUY,3,0.02h,Stop Loss,$45.00,$-960.00,$109574.00,249,$-960.00
2024-12-13,16:04:00,21691.5,SELL,3,0.02h,Stop Loss,$31.50,$-928.50,$109605.50,249,$-928.50
2024-12-13,16:16:00,21969.75,BUY,3,0.02h,Stop Loss,$-9.00,$-937.50,$109596.50,249,$-937.50
2024-12-13,16:17:00,21713.0,SELL,3,0.02h,Break Even,$-1.50,$-939.00,$109595.00,249,$-939.00
2024-12-13,16:30:00,21976.5,BUY,3,0.02h,Stop Loss,$106.50,$-832.50,$109701.50,249,$-832.50
2024-12-13,16:41:00,21703.5,SELL,3,0.02h,Break Even,$-1.50,$-834.00,$109700.00,249,$-834.00
2024-12-13,16:48:00,21988.75,BUY,3,0.02h,Stop Loss,$-9.00,$-843.00,$109691.00,249,$-843.00
2024-12-13,16:49:00,21721.75,SELL,3,0.02h,Stop Loss,$52.50,$-790.50,$109743.50,249,$-790.50
2024-12-13,16:52:00,21982.5,BUY,3,0.02h,Stop Loss,$4.50,$-786.00,$109748.00,249,$-786.00
2024-12-13,17:01:00,21701.25,SELL,3,0.02h,Stop Loss,$-9.00,$-795.00,$109739.00,249,$-795.00
2024-12-13,17:02:00,21983.75,BUY,3,0.02h,Stop Loss,$15.00,$-780.00,$109754.00,249,$-780.00
2024-12-13,17:06:00,21718.75,SELL,3,0.02h,Stop Loss,$-9.00,$-789.00,$109745.00,249,$-789.00
2024-12-13,17:07:00,21997.75,BUY,3,0.02h,Stop Loss,$-9.00,$-798.00,$109736.00,249,$-798.00
2024-12-13,17:08:00,21720.25,SELL,3,0.02h,Stop Loss,$15.00,$-783.00,$109751.00,249,$-783.00
2024-12-13,17:18:00,21998.75,BUY,3,0.02h,Stop Loss,$-9.00,$-792.00,$109742.00,249,$-792.00
2024-12-13,17:19:00,21721.75,SELL,3,0.02h,Stop Loss,$-9.00,$-801.00,$109733.00,249,$-801.00
2024-12-13,17:20:00,22005.75,BUY,3,0.02h,Break Even,$-1.50,$-802.50,$109731.50,249,$-802.50
2024-12-13,17:25:00,21709.5,SELL,3,0.02h,Stop Loss,$-9.00,$-811.50,$109722.50,249,$-811.50
2024-12-13,17:26:00,21978.0,BUY,3,0.02h,Stop Loss,$-9.00,$-820.50,$109713.50,249,$-820.50
2024-12-13,17:27:00,21705.0,SELL,3,0.02h,Stop Loss,$-9.00,$-829.50,$109704.50,249,$-829.50
2024-12-13,17:28:00,21971.0,BUY,3,0.02h,Break Even,$-1.50,$-831.00,$109703.00,249,$-831.00
2024-12-13,17:34:00,21687.0,SELL,3,0.02h,Stop Loss,$-9.00,$-840.00,$109694.00,249,$-840.00
2024-12-13,17:35:00,21971.25,BUY,3,0.02h,Stop Loss,$19.50,$-820.50,$109713.50,249,$-820.50
2024-12-13,17:40:00,21700.5,SELL,3,0.02h,Stop Loss,$61.50,$-759.00,$109775.00,249,$-759.00
2024-12-13,17:43:00,21976.0,BUY,3,0.02h,Stop Loss,$6.00,$-753.00,$109781.00,249,$-753.00
2024-12-13,17:46:00,21698.0,SELL,3,0.02h,Stop Loss,$12.00,$-741.00,$109793.00,249,$-741.00
2024-12-13,18:04:00,21982.5,BUY,3,0.02h,Stop Loss,$-9.00,$-750.00,$109784.00,249,$-750.00
2024-12-13,18:05:00,21707.5,SELL,3,0.02h,Stop Loss,$33.00,$-717.00,$109817.00,249,$-717.00
2024-12-13,18:09:00,21996.0,BUY,3,0.02h,Break Even,$-1.50,$-718.50,$109815.50,249,$-718.50
2024-12-13,18:18:00,21728.75,SELL,3,0.02h,Stop Loss,$18.00,$-700.50,$109833.50,249,$-700.50
2024-12-13,18:24:00,21993.75,BUY,3,0.02h,Stop Loss,$10.50,$-690.00,$109844.00,249,$-690.00
2024-12-13,18:33:00,21731.5,SELL,3,0.02h,Break Even,$-1.50,$-691.50,$109842.50,249,$-691.50
2024-12-13,18:37:00,22020.5,BUY,3,0.02h,Stop Loss,$27.00,$-664.50,$109869.50,249,$-664.50
2024-12-13,18:46:00,21750.5,SELL,3,0.02h,Stop Loss,$13.50,$-651.00,$109883.00,249,$-651.00
2024-12-13,18:48:00,22041.25,BUY,3,0.02h,Stop Loss,$37.50,$-613.50,$109920.50,249,$-613.50
2024-12-13,18:55:00,21773.75,SELL,3,0.02h,Stop Loss,$-9.00,$-622.50,$109911.50,249,$-622.50
2024-12-13,18:56:00,22057.0,BUY,3,0.02h,Stop Loss,$-9.00,$-631.50,$109902.50,249,$-631.50
2024-12-13,19:06:00,21769.75,SELL,3,0.02h,Stop Loss,$-9.00,$-640.50,$109893.50,249,$-640.50
2024-12-13,19:16:00,22063.0,BUY,3,0.02h,Stop Loss,$-9.00,$-649.50,$109884.50,249,$-649.50
2024-12-13,19:17:00,21780.0,SELL,3,0.02h,Stop Loss,$-9.00,$-658.50,$109875.50,249,$-658.50
2024-12-13,19:18:00,22064.0,BUY,3,0.02h,Stop Loss,$-9.00,$-667.50,$109866.50,249,$-667.50
2024-12-13,19:19:00,21783.25,SELL,3,0.02h,Stop Loss,$-9.00,$-676.50,$109857.50,249,$-676.50
2024-12-13,19:20:00,22069.5,BUY,3,0.02h,Stop Loss,$-9.00,$-685.50,$109848.50,249,$-685.50
2024-12-13,19:21:00,21785.5,SELL,3,0.02h,Stop Loss,$-9.00,$-694.50,$109839.50,249,$-694.50
2024-12-13,19:22:00,22073.5,BUY,3,0.02h,Stop Loss,$-9.00,$-703.50,$109830.50,249,$-703.50
2024-12-13,19:23:00,21796.0,SELL,3,0.02h,Stop Loss,$3.00,$-700.50,$109833.50,249,$-700.50
2024-12-13,19:31:00,22095.5,BUY,3,0.02h,Stop Loss,$-9.00,$-709.50,$109824.50,249,$-709.50
2024-12-13,19:41:00,21807.0,SELL,3,0.02h,Stop Loss,$-9.00,$-718.50,$109815.50,249,$-718.50
2024-12-13,19:43:00,22090.5,BUY,3,0.02h,Stop Loss,$-9.00,$-727.50,$109806.50,249,$-727.50
2024-12-13,19:54:00,21797.5,SELL,3,0.02h,Stop Loss,$-9.00,$-736.50,$109797.50,249,$-736.50
2024-12-13,19:55:00,22086.25,BUY,3,0.02h,Stop Loss,$-9.00,$-745.50,$109788.50,249,$-745.50
2024-12-13,19:56:00,21802.25,SELL,3,0.02h,Break Even,$-1.50,$-747.00,$109787.00,249,$-747.00
2024-12-13,20:00:00,22083.25,BUY,3,0.02h,Stop Loss,$-9.00,$-756.00,$109778.00,249,$-756.00
2024-12-13,20:01:00,21805.5,SELL,3,0.02h,Stop Loss,$-9.00,$-765.00,$109769.00,249,$-765.00
2024-12-13,20:02:00,22086.0,BUY,3,0.02h,Stop Loss,$-9.00,$-774.00,$109760.00,249,$-774.00
2024-12-13,20:03:00,21805.0,SELL,3,0.02h,Stop Loss,$-9.00,$-783.00,$109751.00,249,$-783.00
2024-12-13,20:14:00,22085.0,BUY,3,0.02h,Break Even,$-1.50,$-784.50,$109749.50,249,$-784.50
2024-12-13,20:20:00,21784.75,SELL,3,0.02h,Stop Loss,$-9.00,$-793.50,$109740.50,249,$-793.50
2024-12-13,20:21:00,22067.0,BUY,3,0.02h,Break Even,$-1.50,$-795.00,$109739.00,249,$-795.00
2024-12-13,20:30:00,21811.0,SELL,3,0.02h,Stop Loss,$-9.00,$-804.00,$109730.00,249,$-804.00
2024-12-13,20:31:00,22094.0,BUY,3,0.02h,Break Even,$-1.50,$-805.50,$109728.50,249,$-805.50
2024-12-13,20:40:00,21816.0,SELL,3,0.02h,Stop Loss,$9.00,$-796.50,$109737.50,249,$-796.50
2024-12-13,20:43:00,22088.0,BUY,3,0.02h,Stop Loss,$-9.00,$-805.50,$109728.50,249,$-805.50
2024-12-13,20:45:00,21796.25,SELL,3,0.02h,Stop Loss,$-9.00,$-814.50,$109719.50,249,$-814.50
2024-12-13,20:46:00,22087.25,BUY,3,0.02h,Stop Loss,$-9.00,$-823.50,$109710.50,249,$-823.50
2024-12-13,20:47:00,21811.5,SELL,3,0.02h,Stop Loss,$15.00,$-808.50,$109725.50,249,$-808.50
2024-12-13,20:54:00,22078.25,BUY,3,0.02h,Stop Loss,$-9.00,$-817.50,$109716.50,249,$-817.50
2024-12-13,20:55:00,21795.25,SELL,3,0.02h,Break Even,$-1.50,$-819.00,$109715.00,249,$-819.00
2024-12-13,21:04:00,22061.75,BUY,3,0.02h,Break Even,$-1.50,$-820.50,$109713.50,249,$-820.50
2024-12-13,21:08:00,21780.75,SELL,3,0.02h,Stop Loss,$-9.00,$-829.50,$109704.50,249,$-829.50
2024-12-13,21:09:00,22069.5,BUY,3,0.02h,Stop Loss,$-9.00,$-838.50,$109695.50,249,$-838.50
2024-12-13,21:10:00,21780.75,SELL,3,0.02h,Break Even,$-1.50,$-840.00,$109694.00,249,$-840.00
2024-12-13,21:14:00,22062.75,BUY,3,0.02h,Stop Loss,$-9.00,$-849.00,$109685.00,249,$-849.00
2024-12-13,21:15:00,21769.5,SELL,3,0.02h,Stop Loss,$-9.00,$-858.00,$109676.00,249,$-858.00
2024-12-13,21:16:00,22059.25,BUY,3,0.02h,Stop Loss,$-9.00,$-867.00,$109667.00,249,$-867.00
2024-12-13,21:19:00,21769.25,SELL,3,0.02h,Stop Loss,$-9.00,$-876.00,$109658.00,249,$-876.00
2024-12-13,21:20:00,22054.0,BUY,3,0.02h,Break Even,$-1.50,$-877.50,$109656.50,249,$-877.50
2024-12-13,21:26:00,21764.25,SELL,3,0.02h,Stop Loss,$-9.00,$-886.50,$109647.50,249,$-886.50
2024-12-13,21:27:00,22043.5,BUY,3,0.02h,Break Even,$-1.50,$-888.00,$109646.00,249,$-888.00
2024-12-13,21:29:00,21759.5,SELL,3,0.02h,Stop Loss,$-9.00,$-897.00,$109637.00,249,$-897.00
2024-12-13,21:30:00,22044.25,BUY,3,0.02h,Stop Loss,$-9.00,$-906.00,$109628.00,249,$-906.00
2024-12-13,21:32:00,21755.75,SELL,3,0.02h,Stop Loss,$-9.00,$-915.00,$109619.00,249,$-915.00
2024-12-13,21:33:00,22042.5,BUY,3,0.05h,Stop Loss,$4.50,$-910.50,$109623.50,249,$-910.50
2024-12-13,21:41:00,21765.0,SELL,3,0.02h,Break Even,$-1.50,$-912.00,$109622.00,249,$-912.00
2024-12-13,21:51:00,22048.0,BUY,3,0.02h,Stop Loss,$-9.00,$-921.00,$109613.00,249,$-921.00
2024-12-13,21:52:00,21762.5,SELL,3,0.02h,Stop Loss,$-9.00,$-930.00,$109604.00,249,$-930.00
2024-12-13,21:53:00,22051.5,BUY,3,0.02h,Stop Loss,$-9.00,$-939.00,$109595.00,249,$-939.00
2024-12-13,21:54:00,21763.5,SELL,3,0.02h,Break Even,$-1.50,$-940.50,$109593.50,249,$-940.50
,,,,,,,,,,,
2024-12-16,00:00:00,22078.0,BUY,3,0.02h,Stop Loss,$16.50,$16.50,$109610.00,250,$16.50
2024-12-16,01:14:00,22088.25,SELL,3,0.02h,Stop Loss,$-9.00,$7.50,$109601.00,250,$7.50
2024-12-16,01:53:00,22086.5,BUY,3,0.02h,Stop Loss,$-9.00,$-1.50,$109592.00,250,$-1.50
2024-12-16,02:39:00,22100.75,SELL,3,0.02h,Stop Loss,$-9.00,$-10.50,$109583.00,250,$-10.50
2024-12-16,02:40:00,22102.75,BUY,3,0.02h,Break Even,$-1.50,$-12.00,$109581.50,250,$-12.00
2024-12-16,03:06:00,22105.25,SELL,3,0.02h,Stop Loss,$-9.00,$-21.00,$109572.50,250,$-21.00
2024-12-16,03:07:00,22106.75,BUY,3,0.08h,Stop Loss,$-9.00,$-30.00,$109563.50,250,$-30.00
2024-12-16,03:12:00,22104.25,SELL,3,0.03h,Stop Loss,$-9.00,$-39.00,$109554.50,250,$-39.00
2024-12-16,03:29:00,22108.0,BUY,3,0.03h,Stop Loss,$-9.00,$-48.00,$109545.50,250,$-48.00
2024-12-16,03:44:00,22103.0,SELL,3,0.02h,Break Even,$-1.50,$-49.50,$109544.00,250,$-49.50
2024-12-16,04:14:00,22100.5,BUY,3,0.03h,Stop Loss,$3.00,$-46.50,$109547.00,250,$-46.50
2024-12-16,04:32:00,22098.75,SELL,3,0.03h,Stop Loss,$-9.00,$-55.50,$109538.00,250,$-55.50
2024-12-16,04:35:00,22101.0,BUY,3,0.05h,Stop Loss,$-9.00,$-64.50,$109529.00,250,$-64.50
2024-12-16,04:38:00,22097.25,SELL,3,0.02h,Break Even,$-1.50,$-66.00,$109527.50,250,$-66.00
2024-12-16,05:10:00,22093.5,BUY,3,0.02h,Stop Loss,$-9.00,$-75.00,$109518.50,250,$-75.00
2024-12-16,05:18:00,22091.25,SELL,3,0.07h,Stop Loss,$27.00,$-48.00,$109545.50,250,$-48.00
2024-12-16,06:03:00,22088.0,BUY,3,0.02h,Break Even,$-1.50,$-49.50,$109544.00,250,$-49.50
2024-12-16,06:35:00,22089.25,SELL,3,0.02h,Stop Loss,$-9.00,$-58.50,$109535.00,250,$-58.50
2024-12-16,06:49:00,22093.0,BUY,3,0.02h,Break Even,$-1.50,$-60.00,$109533.50,250,$-60.00
2024-12-16,07:16:00,22090.0,SELL,3,0.03h,Stop Loss,$-9.00,$-69.00,$109524.50,250,$-69.00
2024-12-16,07:25:00,22096.5,BUY,3,0.02h,Break Even,$-1.50,$-70.50,$109523.00,250,$-70.50
2024-12-16,07:35:00,22094.25,SELL,3,0.02h,Break Even,$-1.50,$-72.00,$109521.50,250,$-72.00
2024-12-16,07:51:00,22094.5,BUY,3,0.02h,Stop Loss,$-9.00,$-81.00,$109512.50,250,$-81.00
2024-12-16,07:55:00,22089.5,SELL,3,0.02h,Stop Loss,$-9.00,$-90.00,$109503.50,250,$-90.00
2024-12-16,07:57:00,22093.5,BUY,3,0.02h,Stop Loss,$9.00,$-81.00,$109512.50,250,$-81.00
2024-12-16,08:15:00,22091.75,SELL,3,0.02h,Break Even,$-1.50,$-82.50,$109511.00,250,$-82.50
2024-12-16,08:23:00,22100.25,BUY,3,0.02h,Stop Loss,$10.50,$-72.00,$109521.50,250,$-72.00
2024-12-16,08:28:00,22091.75,SELL,3,0.02h,Stop Loss,$-9.00,$-81.00,$109512.50,250,$-81.00
2024-12-16,08:33:00,22099.25,BUY,3,0.02h,Stop Loss,$-9.00,$-90.00,$109503.50,250,$-90.00
2024-12-16,09:06:00,22104.0,SELL,3,0.02h,Stop Loss,$-9.00,$-99.00,$109494.50,250,$-99.00
2024-12-16,09:07:00,22107.5,BUY,3,0.02h,Stop Loss,$6.00,$-93.00,$109500.50,250,$-93.00
2024-12-16,11:02:00,22145.75,SELL,3,0.02h,Stop Loss,$-9.00,$-102.00,$109491.50,250,$-102.00
2024-12-16,11:30:00,22147.75,BUY,3,0.02h,Stop Loss,$-9.00,$-111.00,$109482.50,250,$-111.00
2024-12-16,11:37:00,22138.5,SELL,3,0.02h,Break Even,$-1.50,$-112.50,$109481.00,250,$-112.50
2024-12-16,11:44:00,22146.0,BUY,3,0.02h,Stop Loss,$-9.00,$-121.50,$109472.00,250,$-121.50
2024-12-16,12:47:00,22168.0,SELL,3,0.02h,Stop Loss,$-9.00,$-130.50,$109463.00,250,$-130.50
2024-12-16,13:13:00,22178.25,BUY,3,0.02h,Stop Loss,$18.00,$-112.50,$109481.00,250,$-112.50
2024-12-16,13:56:00,22199.75,SELL,3,0.02h,Break Even,$-1.50,$-114.00,$109479.50,250,$-114.00
2024-12-16,13:59:00,22207.25,BUY,3,0.02h,Stop Loss,$-9.00,$-123.00,$109470.50,250,$-123.00
2024-12-16,14:06:00,22196.0,SELL,3,0.02h,Stop Loss,$18.00,$-105.00,$109488.50,250,$-105.00
2024-12-16,14:31:00,22218.5,BUY,3,0.02h,Stop Loss,$60.00,$-45.00,$109548.50,250,$-45.00
2024-12-16,15:19:00,22256.5,SELL,3,0.02h,Stop Loss,$72.00,$27.00,$109620.50,250,$27.00
2024-12-16,15:26:00,22275.25,BUY,3,0.02h,Break Even,$-1.50,$25.50,$109619.00,250,$25.50
2024-12-16,15:54:00,22281.25,SELL,3,0.02h,Break Even,$-1.50,$24.00,$109617.50,250,$24.00
2024-12-16,15:57:00,22301.75,BUY,3,0.02h,Break Even,$-1.50,$22.50,$109616.00,250,$22.50
2024-12-16,16:00:00,22287.25,SELL,3,0.02h,Break Even,$-1.50,$21.00,$109614.50,250,$21.00
2024-12-16,16:01:00,22307.0,BUY,3,0.02h,Break Even,$-1.50,$19.50,$109613.00,250,$19.50
2024-12-16,16:35:00,22314.0,SELL,3,0.02h,Stop Loss,$6.00,$25.50,$109619.00,250,$25.50
2024-12-16,16:52:00,22326.25,BUY,3,0.02h,Break Even,$-1.50,$24.00,$109617.50,250,$24.00
2024-12-16,18:55:00,22412.5,SELL,3,0.02h,Break Even,$-1.50,$22.50,$109616.00,250,$22.50
2024-12-16,18:56:00,22415.75,BUY,3,0.02h,Break Even,$-1.50,$21.00,$109614.50,250,$21.00
2024-12-16,19:01:00,22404.0,SELL,3,0.02h,Break Even,$-1.50,$19.50,$109613.00,250,$19.50
2024-12-16,19:11:00,22417.5,BUY,3,0.02h,Stop Loss,$-9.00,$10.50,$109604.00,250,$10.50
2024-12-16,19:32:00,22422.75,SELL,3,0.02h,Break Even,$-1.50,$9.00,$109602.50,250,$9.00
2024-12-16,19:38:00,22430.5,BUY,3,0.02h,Stop Loss,$4.50,$13.50,$109607.00,250,$13.50
2024-12-16,20:00:00,22421.0,SELL,3,0.02h,Stop Loss,$-9.00,$4.50,$109598.00,250,$4.50
2024-12-16,20:06:00,22439.5,BUY,3,0.02h,Break Even,$-1.50,$3.00,$109596.50,250,$3.00
2024-12-16,20:34:00,22429.25,SELL,3,0.02h,Break Even,$-1.50,$1.50,$109595.00,250,$1.50
2024-12-16,21:37:00,22402.75,BUY,3,0.02h,Break Even,$-1.50,$0.00,$109593.50,250,$0.00
2024-12-16,23:05:00,22403.5,SELL,3,0.02h,Stop Loss,$-9.00,$-9.00,$109584.50,250,$-9.00
2024-12-16,23:06:00,22407.0,BUY,3,0.02h,Stop Loss,$6.00,$-3.00,$109590.50,250,$-3.00
2024-12-16,23:08:00,22401.0,SELL,3,0.02h,Stop Loss,$67.50,$64.50,$109658.00,250,$64.50
2024-12-16,23:39:00,22395.0,BUY,3,0.02h,Stop Loss,$-9.00,$55.50,$109649.00,250,$55.50
,,,,,,,,,,,
2024-12-17,00:02:00,22391.0,SELL,3,0.02h,Stop Loss,$-9.00,$-9.00,$109640.00,251,$-9.00
2024-12-17,00:43:00,22390.75,BUY,3,0.02h,Break Even,$-1.50,$-10.50,$109638.50,251,$-10.50
2024-12-17,00:55:00,22383.75,SELL,3,0.02h,Stop Loss,$-9.00,$-19.50,$109629.50,251,$-19.50
2024-12-17,01:08:00,22390.75,BUY,3,0.02h,Break Even,$-1.50,$-21.00,$109628.00,251,$-21.00
2024-12-17,02:28:00,22412.5,SELL,3,0.02h,Stop Loss,$-9.00,$-30.00,$109619.00,251,$-30.00
2024-12-17,02:45:00,22417.25,BUY,3,0.08h,Break Even,$-1.50,$-31.50,$109617.50,251,$-31.50
2024-12-17,03:04:00,22416.0,SELL,3,0.02h,Stop Loss,$-9.00,$-40.50,$109608.50,251,$-40.50
2024-12-17,03:16:00,22418.25,BUY,3,0.07h,Stop Loss,$-9.00,$-49.50,$109599.50,251,$-49.50
2024-12-17,03:49:00,22417.75,SELL,3,0.02h,Stop Loss,$-9.00,$-58.50,$109590.50,251,$-58.50
2024-12-17,04:07:00,22421.0,BUY,3,0.02h,Break Even,$-1.50,$-60.00,$109589.00,251,$-60.00
2024-12-17,04:36:00,22421.0,SELL,3,0.23h,Stop Loss,$16.50,$-43.50,$109605.50,251,$-43.50
2024-12-17,05:30:00,22415.75,BUY,3,0.02h,Stop Loss,$-9.00,$-52.50,$109596.50,251,$-52.50
2024-12-17,05:34:00,22411.0,SELL,3,0.02h,Break Even,$-1.50,$-54.00,$109595.00,251,$-54.00
2024-12-17,06:03:00,22409.0,BUY,3,0.02h,Break Even,$-1.50,$-55.50,$109593.50,251,$-55.50
2024-12-17,06:14:00,22404.75,SELL,3,0.02h,Stop Loss,$-9.00,$-64.50,$109584.50,251,$-64.50
2024-12-17,07:01:00,22395.5,BUY,3,0.02h,Stop Loss,$-9.00,$-73.50,$109575.50,251,$-73.50
2024-12-17,07:33:00,22393.0,SELL,3,0.02h,Break Even,$-1.50,$-75.00,$109574.00,251,$-75.00
2024-12-17,08:21:00,22355.5,BUY,3,0.02h,Break Even,$-1.50,$-76.50,$109572.50,251,$-76.50
2024-12-17,08:40:00,22343.0,SELL,3,0.02h,Stop Loss,$6.00,$-70.50,$109578.50,251,$-70.50
2024-12-17,09:04:00,22355.5,BUY,3,0.02h,Stop Loss,$10.50,$-60.00,$109589.00,251,$-60.00
2024-12-17,09:28:00,22357.0,SELL,3,0.02h,Break Even,$-1.50,$-61.50,$109587.50,251,$-61.50
2024-12-17,09:32:00,22370.0,BUY,3,0.02h,Break Even,$-1.50,$-63.00,$109586.00,251,$-63.00
2024-12-17,10:18:00,22380.25,SELL,3,0.02h,Break Even,$-1.50,$-64.50,$109584.50,251,$-64.50
2024-12-17,10:26:00,22389.75,BUY,3,0.02h,Stop Loss,$-9.00,$-73.50,$109575.50,251,$-73.50
2024-12-17,11:05:00,22396.25,SELL,3,0.02h,Break Even,$-1.50,$-75.00,$109574.00,251,$-75.00
2024-12-17,11:15:00,22405.25,BUY,3,0.02h,Break Even,$-1.50,$-76.50,$109572.50,251,$-76.50
2024-12-17,11:35:00,22407.25,SELL,3,0.02h,Stop Loss,$-9.00,$-85.50,$109563.50,251,$-85.50
2024-12-17,12:45:00,22366.25,BUY,3,0.02h,Stop Loss,$-9.00,$-94.50,$109554.50,251,$-94.50
2024-12-17,12:48:00,22360.5,SELL,3,0.02h,Stop Loss,$-9.00,$-103.50,$109545.50,251,$-103.50
2024-12-17,13:22:00,22342.75,BUY,3,0.02h,Stop Loss,$27.00,$-76.50,$109572.50,251,$-76.50
2024-12-17,13:38:00,22339.5,SELL,3,0.02h,Stop Loss,$-9.00,$-85.50,$109563.50,251,$-85.50
2024-12-17,13:39:00,22351.25,BUY,3,0.02h,Stop Loss,$9.00,$-76.50,$109572.50,251,$-76.50
2024-12-17,13:41:00,22340.25,SELL,3,0.02h,Stop Loss,$7.50,$-69.00,$109580.00,251,$-69.00
2024-12-17,13:57:00,22348.75,BUY,3,0.03h,Stop Loss,$28.50,$-40.50,$109608.50,251,$-40.50
2024-12-17,14:25:00,22348.25,SELL,3,0.02h,Stop Loss,$13.50,$-27.00,$109622.00,251,$-27.00
2024-12-17,14:45:00,22360.0,BUY,3,0.02h,Stop Loss,$22.50,$-4.50,$109644.50,251,$-4.50
2024-12-17,15:00:00,22308.0,SELL,3,0.02h,Stop Loss,$111.00,$106.50,$109755.50,251,$106.50
2024-12-17,15:40:00,22286.5,BUY,3,0.02h,Stop Loss,$43.50,$150.00,$109799.00,251,$150.00
2024-12-17,16:54:00,22341.75,SELL,3,0.02h,Stop Loss,$19.50,$169.50,$109818.50,251,$169.50
2024-12-17,17:30:00,22340.25,BUY,3,0.02h,Stop Loss,$-9.00,$160.50,$109809.50,251,$160.50
2024-12-17,17:57:00,22333.5,SELL,3,0.02h,Break Even,$-1.50,$159.00,$109808.00,251,$159.00
2024-12-17,18:10:00,22346.25,BUY,3,0.02h,Break Even,$-1.50,$157.50,$109806.50,251,$157.50
2024-12-17,18:17:00,22327.5,SELL,3,0.02h,Stop Loss,$10.50,$168.00,$109817.00,251,$168.00
2024-12-17,18:43:00,22331.0,BUY,3,0.02h,Stop Loss,$3.00,$171.00,$109820.00,251,$171.00
2024-12-17,18:48:00,22310.75,SELL,3,0.02h,Stop Loss,$6.00,$177.00,$109826.00,251,$177.00
2024-12-17,19:57:00,22287.0,BUY,3,0.02h,Break Even,$-1.50,$175.50,$109824.50,251,$175.50
2024-12-17,20:06:00,22277.0,SELL,3,0.02h,Break Even,$-1.50,$174.00,$109823.00,251,$174.00
2024-12-17,20:16:00,22284.5,BUY,3,0.02h,Stop Loss,$-9.00,$165.00,$109814.00,251,$165.00
2024-12-17,20:17:00,22274.5,SELL,3,0.02h,Break Even,$-1.50,$163.50,$109812.50,251,$163.50
2024-12-17,20:38:00,22277.5,BUY,3,0.02h,Stop Loss,$6.00,$169.50,$109818.50,251,$169.50
2024-12-17,21:05:00,22288.0,SELL,3,0.02h,Break Even,$-1.50,$168.00,$109817.00,251,$168.00
2024-12-17,21:23:00,22311.75,BUY,3,0.02h,Break Even,$-1.50,$166.50,$109815.50,251,$166.50
2024-12-17,21:39:00,22298.5,SELL,3,0.02h,Break Even,$-1.50,$165.00,$109814.00,251,$165.00
2024-12-17,21:54:00,22304.25,BUY,3,0.02h,Stop Loss,$-9.00,$156.00,$109805.00,251,$156.00
2024-12-17,23:01:00,22280.0,SELL,3,0.02h,Stop Loss,$78.00,$234.00,$109883.00,251,$234.00
2024-12-17,23:31:00,22263.0,BUY,3,0.02h,Break Even,$-1.50,$232.50,$109881.50,251,$232.50
,,,,,,,,,,,
2024-12-18,00:33:00,22285.0,SELL,3,0.02h,Break Even,$-1.50,$-1.50,$109880.00,252,$-1.50
2024-12-18,00:45:00,22289.0,BUY,3,0.02h,Stop Loss,$-9.00,$-10.50,$109871.00,252,$-10.50
2024-12-18,00:48:00,22284.5,SELL,3,0.02h,Stop Loss,$-9.00,$-19.50,$109862.00,252,$-19.50
2024-12-18,00:52:00,22288.0,BUY,3,0.05h,Break Even,$-1.50,$-21.00,$109860.50,252,$-21.00
2024-12-18,00:57:00,22282.0,SELL,3,0.02h,Break Even,$-1.50,$-22.50,$109859.00,252,$-22.50
2024-12-18,01:02:00,22290.75,BUY,3,0.02h,Stop Loss,$-9.00,$-31.50,$109850.00,252,$-31.50
2024-12-18,02:36:00,22323.5,SELL,3,0.03h,Break Even,$-1.50,$-33.00,$109848.50,252,$-33.00
2024-12-18,02:44:00,22326.25,BUY,3,0.02h,Stop Loss,$-9.00,$-42.00,$109839.50,252,$-42.00
2024-12-18,03:00:00,22323.5,SELL,3,0.02h,Break Even,$-1.50,$-43.50,$109838.00,252,$-43.50
2024-12-18,03:41:00,22318.75,BUY,3,0.02h,Stop Loss,$3.00,$-40.50,$109841.00,252,$-40.50
2024-12-18,03:55:00,22309.5,SELL,3,0.02h,Stop Loss,$-9.00,$-49.50,$109832.00,252,$-49.50
2024-12-18,04:04:00,22315.25,BUY,3,0.02h,Stop Loss,$-9.00,$-58.50,$109823.00,252,$-58.50
2024-12-18,04:07:00,22311.5,SELL,3,0.02h,Stop Loss,$-9.00,$-67.50,$109814.00,252,$-67.50
2024-12-18,04:19:00,22314.0,BUY,3,0.03h,Stop Loss,$9.00,$-58.50,$109823.00,252,$-58.50
2024-12-18,05:01:00,22328.25,SELL,3,0.02h,Break Even,$-1.50,$-60.00,$109821.50,252,$-60.00
2024-12-18,05:22:00,22333.5,BUY,3,0.02h,Break Even,$-1.50,$-61.50,$109820.00,252,$-61.50
2024-12-18,05:31:00,22328.5,SELL,3,0.02h,Stop Loss,$-9.00,$-70.50,$109811.00,252,$-70.50
2024-12-18,05:40:00,22330.75,BUY,3,0.03h,Break Even,$-1.50,$-72.00,$109809.50,252,$-72.00
2024-12-18,06:24:00,22338.25,SELL,3,0.02h,Stop Loss,$-9.00,$-81.00,$109800.50,252,$-81.00
2024-12-18,06:52:00,22330.75,BUY,3,0.02h,Stop Loss,$-9.00,$-90.00,$109791.50,252,$-90.00
2024-12-18,07:04:00,22323.25,SELL,3,0.02h,Stop Loss,$-9.00,$-99.00,$109782.50,252,$-99.00
2024-12-18,07:23:00,22332.0,BUY,3,0.02h,Stop Loss,$-9.00,$-108.00,$109773.50,252,$-108.00
2024-12-18,07:42:00,22324.0,SELL,3,0.02h,Stop Loss,$-9.00,$-117.00,$109764.50,252,$-117.00
2024-12-18,08:01:00,22339.5,BUY,3,0.02h,Break Even,$-1.50,$-118.50,$109763.00,252,$-118.50
2024-12-18,08:40:00,22345.5,SELL,3,0.02h,Break Even,$-1.50,$-120.00,$109761.50,252,$-120.00
2024-12-18,09:33:00,22335.5,BUY,3,0.02h,Stop Loss,$10.50,$-109.50,$109772.00,252,$-109.50
2024-12-18,10:34:00,22354.75,SELL,3,0.02h,Stop Loss,$-9.00,$-118.50,$109763.00,252,$-118.50
2024-12-18,10:58:00,22366.25,BUY,3,0.02h,Break Even,$-1.50,$-120.00,$109761.50,252,$-120.00
2024-12-18,11:41:00,22374.75,SELL,3,0.02h,Stop Loss,$-9.00,$-129.00,$109752.50,252,$-129.00
2024-12-18,11:42:00,22377.25,BUY,3,0.02h,Break Even,$-1.50,$-130.50,$109751.00,252,$-130.50
2024-12-18,11:44:00,22373.5,SELL,3,0.02h,Break Even,$-1.50,$-132.00,$109749.50,252,$-132.00
2024-12-18,12:06:00,22373.75,BUY,3,0.02h,Break Even,$-1.50,$-133.50,$109748.00,252,$-133.50
2024-12-18,12:30:00,22374.0,SELL,3,0.02h,Stop Loss,$-9.00,$-142.50,$109739.00,252,$-142.50
2024-12-18,12:52:00,22379.0,BUY,3,0.02h,Stop Loss,$-9.00,$-151.50,$109730.00,252,$-151.50
2024-12-18,13:02:00,22369.0,SELL,3,0.02h,Break Even,$-1.50,$-153.00,$109728.50,252,$-153.00
2024-12-18,14:51:00,22262.75,BUY,3,0.02h,Break Even,$-1.50,$-154.50,$109727.00,252,$-154.50
2024-12-18,14:52:00,22258.75,SELL,3,0.02h,Stop Loss,$10.50,$-144.00,$109737.50,252,$-144.00
2024-12-18,14:54:00,22272.5,BUY,3,0.02h,Stop Loss,$100.50,$-43.50,$109838.00,252,$-43.50
2024-12-18,16:11:00,22322.75,SELL,3,0.02h,Stop Loss,$49.50,$6.00,$109887.50,252,$6.00
2024-12-18,16:31:00,22311.5,BUY,3,0.02h,Stop Loss,$-9.00,$-3.00,$109878.50,252,$-3.00
2024-12-18,17:00:00,22305.0,SELL,3,0.02h,Stop Loss,$30.00,$27.00,$109908.50,252,$27.00
2024-12-18,17:21:00,22313.0,BUY,3,0.02h,Break Even,$-1.50,$25.50,$109907.00,252,$25.50
2024-12-18,17:31:00,22295.75,SELL,3,0.02h,Stop Loss,$21.00,$46.50,$109928.00,252,$46.50
2024-12-18,17:56:00,22301.75,BUY,3,0.02h,Stop Loss,$-9.00,$37.50,$109919.00,252,$37.50
2024-12-18,18:29:00,22297.0,SELL,3,0.02h,Stop Loss,$30.00,$67.50,$109949.00,252,$67.50
2024-12-18,18:56:00,22302.5,BUY,3,0.02h,Stop Loss,$-9.00,$58.50,$109940.00,252,$58.50
2024-12-18,19:01:00,22232.25,SELL,3,0.02h,Stop Loss,$172.50,$231.00,$110112.50,252,$231.00
2024-12-18,20:55:00,21685.75,BUY,3,0.02h,Stop Loss,$-9.00,$222.00,$110103.50,252,$222.00
2024-12-18,20:57:00,21578.75,SELL,3,0.02h,Stop Loss,$66.00,$288.00,$110169.50,252,$288.00
2024-12-18,21:25:00,21479.25,BUY,3,0.02h,Break Even,$-1.50,$286.50,$110168.00,252,$286.50
2024-12-18,21:38:00,21425.5,SELL,3,0.02h,Stop Loss,$28.50,$315.00,$110196.50,252,$315.00
2024-12-18,21:49:00,21448.0,BUY,3,0.02h,Stop Loss,$93.00,$408.00,$110289.50,252,$408.00
2024-12-18,23:39:00,21507.75,SELL,3,0.02h,Stop Loss,$58.50,$466.50,$110348.00,252,$466.50
,,,,,,,,,,,
2024-12-19,00:16:00,21492.5,BUY,3,0.02h,Stop Loss,$6.00,$6.00,$110354.00,253,$6.00
2024-12-19,01:18:00,21531.5,SELL,3,0.02h,Break Even,$-1.50,$4.50,$110352.50,253,$4.50
2024-12-19,01:57:00,21498.5,BUY,3,0.02h,Stop Loss,$12.00,$16.50,$110364.50,253,$16.50
2024-12-19,02:03:00,21483.25,SELL,3,0.02h,Stop Loss,$18.00,$34.50,$110382.50,253,$34.50
2024-12-19,02:19:00,21495.25,BUY,3,0.02h,Stop Loss,$-9.00,$25.50,$110373.50,253,$25.50
2024-12-19,02:20:00,21485.75,SELL,3,0.02h,Stop Loss,$-9.00,$16.50,$110364.50,253,$16.50
2024-12-19,02:22:00,21490.25,BUY,3,0.02h,Stop Loss,$45.00,$61.50,$110409.50,253,$61.50
2024-12-19,02:32:00,21482.75,SELL,3,0.02h,Stop Loss,$13.50,$75.00,$110423.00,253,$75.00
2024-12-19,03:20:00,21467.5,BUY,3,0.02h,Break Even,$-1.50,$73.50,$110421.50,253,$73.50
2024-12-19,04:05:00,21473.0,SELL,3,0.02h,Break Even,$-1.50,$72.00,$110420.00,253,$72.00
2024-12-19,04:08:00,21483.0,BUY,3,0.02h,Break Even,$-1.50,$70.50,$110418.50,253,$70.50
2024-12-19,04:41:00,21472.25,SELL,3,0.02h,Break Even,$-1.50,$69.00,$110417.00,253,$69.00
2024-12-19,04:55:00,21487.75,BUY,3,0.02h,Break Even,$-1.50,$67.50,$110415.50,253,$67.50
2024-12-19,05:26:00,21488.75,SELL,3,0.02h,Stop Loss,$7.50,$75.00,$110423.00,253,$75.00
2024-12-19,06:08:00,21477.5,BUY,3,0.02h,Stop Loss,$16.50,$91.50,$110439.50,253,$91.50
2024-12-19,06:34:00,21464.25,SELL,3,0.02h,Break Even,$-1.50,$90.00,$110438.00,253,$90.00
2024-12-19,06:38:00,21481.75,BUY,3,0.02h,Break Even,$-1.50,$88.50,$110436.50,253,$88.50
2024-12-19,07:46:00,21530.75,SELL,3,0.02h,Stop Loss,$21.00,$109.50,$110457.50,253,$109.50
2024-12-19,07:49:00,21547.5,BUY,3,0.02h,Stop Loss,$-9.00,$100.50,$110448.50,253,$100.50
2024-12-19,08:11:00,21534.0,SELL,3,0.02h,Stop Loss,$4.50,$105.00,$110453.00,253,$105.00
2024-12-19,08:23:00,21553.25,BUY,3,0.02h,Break Even,$-1.50,$103.50,$110451.50,253,$103.50
2024-12-19,09:11:00,21566.25,SELL,3,0.02h,Stop Loss,$-9.00,$94.50,$110442.50,253,$94.50
2024-12-19,09:38:00,21573.75,BUY,3,0.02h,Stop Loss,$-9.00,$85.50,$110433.50,253,$85.50
2024-12-19,09:58:00,21561.5,SELL,3,0.02h,Stop Loss,$10.50,$96.00,$110444.00,253,$96.00
2024-12-19,10:03:00,21572.0,BUY,3,0.02h,Stop Loss,$-9.00,$87.00,$110435.00,253,$87.00
2024-12-19,10:37:00,21585.75,SELL,3,0.02h,Stop Loss,$7.50,$94.50,$110442.50,253,$94.50
2024-12-19,11:04:00,21576.75,BUY,3,0.02h,Break Even,$-1.50,$93.00,$110441.00,253,$93.00
2024-12-19,11:17:00,21566.25,SELL,3,0.02h,Stop Loss,$-9.00,$84.00,$110432.00,253,$84.00
2024-12-19,11:45:00,21569.25,BUY,3,0.02h,Break Even,$-1.50,$82.50,$110430.50,253,$82.50
2024-12-19,13:09:00,21652.0,SELL,3,0.02h,Stop Loss,$-9.00,$73.50,$110421.50,253,$73.50
2024-12-19,13:13:00,21671.5,BUY,3,0.02h,Break Even,$-1.50,$72.00,$110420.00,253,$72.00
2024-12-19,13:28:00,21657.5,SELL,3,0.02h,Stop Loss,$-9.00,$63.00,$110411.00,253,$63.00
2024-12-19,14:09:00,21651.0,BUY,3,0.02h,Stop Loss,$6.00,$69.00,$110417.00,253,$69.00
2024-12-19,14:37:00,21613.75,SELL,3,0.02h,Stop Loss,$253.50,$322.50,$110670.50,253,$322.50
2024-12-19,15:14:00,21637.25,BUY,3,0.02h,Stop Loss,$-9.00,$313.50,$110661.50,253,$313.50
2024-12-19,15:23:00,21541.5,SELL,3,0.02h,Stop Loss,$25.50,$339.00,$110687.00,253,$339.00
2024-12-19,15:46:00,21548.0,BUY,3,0.02h,Stop Loss,$15.00,$354.00,$110702.00,253,$354.00
2024-12-19,16:03:00,21500.0,SELL,3,0.02h,Stop Loss,$-9.00,$345.00,$110693.00,253,$345.00
2024-12-19,16:21:00,21534.5,BUY,3,0.02h,Stop Loss,$105.00,$450.00,$110798.00,253,$450.00
2024-12-19,16:52:00,21574.25,SELL,3,0.02h,Stop Loss,$34.50,$484.50,$110832.50,253,$484.50
2024-12-19,17:57:00,21495.0,BUY,3,0.02h,Stop Loss,$81.00,$565.50,$110913.50,253,$565.50
2024-12-19,18:04:00,21441.75,SELL,3,0.02h,Break Even,$-1.50,$564.00,$110912.00,253,$564.00
2024-12-19,18:10:00,21490.25,BUY,3,0.02h,Stop Loss,$36.00,$600.00,$110948.00,253,$600.00
2024-12-19,19:10:00,21530.75,SELL,3,0.02h,Stop Loss,$112.50,$712.50,$111060.50,253,$712.50
2024-12-19,20:18:00,21489.5,BUY,3,0.02h,Stop Loss,$22.50,$735.00,$111083.00,253,$735.00
2024-12-19,20:34:00,21460.0,SELL,3,0.02h,Stop Loss,$106.50,$841.50,$111189.50,253,$841.50
2024-12-19,21:30:00,21383.0,BUY,3,0.02h,Stop Loss,$52.50,$894.00,$111242.00,253,$894.00
2024-12-19,23:06:00,21401.25,SELL,3,0.02h,Stop Loss,$79.50,$973.50,$111321.50,253,$973.50
2024-12-19,23:21:00,21408.0,BUY,3,0.02h,Break Even,$-1.50,$972.00,$111320.00,253,$972.00
2024-12-19,23:31:00,21394.75,SELL,3,0.02h,Stop Loss,$13.50,$985.50,$111333.50,253,$985.50
,,,,,,,,,,,
2024-12-20,01:30:00,21288.5,BUY,3,0.02h,Stop Loss,$7.50,$7.50,$111341.00,254,$7.50
2024-12-20,01:43:00,21276.0,SELL,3,0.02h,Stop Loss,$12.00,$19.50,$111353.00,254,$19.50
2024-12-20,01:54:00,21284.25,BUY,3,0.02h,Break Even,$-1.50,$18.00,$111351.50,254,$18.00
2024-12-20,01:55:00,21280.0,SELL,3,0.02h,Stop Loss,$-9.00,$9.00,$111342.50,254,$9.00
2024-12-20,01:56:00,21281.75,BUY,3,0.02h,Break Even,$-1.50,$7.50,$111341.00,254,$7.50
2024-12-20,01:59:00,21272.25,SELL,3,0.02h,Stop Loss,$34.50,$42.00,$111375.50,254,$42.00
2024-12-20,02:40:00,21245.75,BUY,3,0.02h,Break Even,$-1.50,$40.50,$111374.00,254,$40.50
2024-12-20,02:41:00,21236.5,SELL,3,0.02h,Stop Loss,$-9.00,$31.50,$111365.00,254,$31.50
2024-12-20,02:44:00,21244.0,BUY,3,0.02h,Stop Loss,$30.00,$61.50,$111395.00,254,$61.50
2024-12-20,03:19:00,21258.25,SELL,3,0.02h,Break Even,$-1.50,$60.00,$111393.50,254,$60.00
2024-12-20,03:23:00,21265.25,BUY,3,0.02h,Break Even,$-1.50,$58.50,$111392.00,254,$58.50
2024-12-20,03:28:00,21257.25,SELL,3,0.02h,Break Even,$-1.50,$57.00,$111390.50,254,$57.00
2024-12-20,04:02:00,21240.25,BUY,3,0.02h,Stop Loss,$22.50,$79.50,$111413.00,254,$79.50
2024-12-20,04:19:00,21226.25,SELL,3,0.02h,Stop Loss,$4.50,$84.00,$111417.50,254,$84.00
2024-12-20,04:48:00,21236.0,BUY,3,0.02h,Break Even,$-1.50,$82.50,$111416.00,254,$82.50
2024-12-20,05:33:00,21244.0,SELL,3,0.02h,Break Even,$-1.50,$81.00,$111414.50,254,$81.00
2024-12-20,05:43:00,21254.5,BUY,3,0.02h,Stop Loss,$-9.00,$72.00,$111405.50,254,$72.00
2024-12-20,06:09:00,21241.5,SELL,3,0.02h,Stop Loss,$13.50,$85.50,$111419.00,254,$85.50
2024-12-20,06:17:00,21260.0,BUY,3,0.02h,Break Even,$-1.50,$84.00,$111417.50,254,$84.00
2024-12-20,07:14:00,21284.5,SELL,3,0.02h,Stop Loss,$-9.00,$75.00,$111408.50,254,$75.00
2024-12-20,07:15:00,21290.25,BUY,3,0.02h,Stop Loss,$-9.00,$66.00,$111399.50,254,$66.00
2024-12-20,07:16:00,21281.5,SELL,3,0.02h,Stop Loss,$13.50,$79.50,$111413.00,254,$79.50
2024-12-20,07:44:00,21289.0,BUY,3,0.02h,Stop Loss,$10.50,$90.00,$111423.50,254,$90.00
2024-12-20,07:52:00,21267.25,SELL,3,0.02h,Stop Loss,$22.50,$112.50,$111446.00,254,$112.50
2024-12-20,08:03:00,21281.0,BUY,3,0.02h,Stop Loss,$33.00,$145.50,$111479.00,254,$145.50
2024-12-20,08:07:00,21263.75,SELL,3,0.02h,Stop Loss,$16.50,$162.00,$111495.50,254,$162.00
2024-12-20,08:56:00,21198.25,BUY,3,0.02h,Stop Loss,$40.50,$202.50,$111536.00,254,$202.50
2024-12-20,09:00:00,21190.75,SELL,3,0.02h,Stop Loss,$34.50,$237.00,$111570.50,254,$237.00
2024-12-20,10:02:00,21139.0,BUY,3,0.02h,Stop Loss,$6.00,$243.00,$111576.50,254,$243.00
2024-12-20,10:13:00,21115.25,SELL,3,0.02h,Stop Loss,$16.50,$259.50,$111593.00,254,$259.50
2024-12-20,10:28:00,21130.5,BUY,3,0.02h,Stop Loss,$-9.00,$250.50,$111584.00,254,$250.50
2024-12-20,10:45:00,21119.75,SELL,3,0.02h,Stop Loss,$69.00,$319.50,$111653.00,254,$319.50
2024-12-20,10:55:00,21126.5,BUY,3,0.02h,Stop Loss,$16.50,$336.00,$111669.50,254,$336.00
2024-12-20,10:58:00,21110.25,SELL,3,0.02h,Stop Loss,$19.50,$355.50,$111689.00,254,$355.50
2024-12-20,11:16:00,21113.5,BUY,3,0.02h,Break Even,$-1.50,$354.00,$111687.50,254,$354.00
2024-12-20,11:23:00,21100.5,SELL,3,0.02h,Stop Loss,$27.00,$381.00,$111714.50,254,$381.00
2024-12-20,11:33:00,21111.0,BUY,3,0.02h,Break Even,$-1.50,$379.50,$111713.00,254,$379.50
2024-12-20,11:37:00,21094.25,SELL,3,0.02h,Break Even,$-1.50,$378.00,$111711.50,254,$378.00
2024-12-20,12:37:00,21040.5,BUY,3,0.02h,Stop Loss,$25.50,$403.50,$111737.00,254,$403.50
2024-12-20,13:18:00,21075.25,SELL,3,0.02h,Break Even,$-1.50,$402.00,$111735.50,254,$402.00
2024-12-20,13:27:00,21096.75,BUY,3,0.02h,Break Even,$-1.50,$400.50,$111734.00,254,$400.50
2024-12-20,14:34:00,21193.75,SELL,3,0.02h,Stop Loss,$13.50,$414.00,$111747.50,254,$414.00
2024-12-20,14:39:00,21253.25,BUY,3,0.02h,Stop Loss,$315.00,$729.00,$112062.50,254,$729.00
2024-12-20,14:50:00,21198.5,SELL,3,0.02h,Stop Loss,$208.50,$937.50,$112271.00,254,$937.50
2024-12-20,14:56:00,21251.0,BUY,3,0.02h,Stop Loss,$31.50,$969.00,$112302.50,254,$969.00
2024-12-20,17:35:00,21756.5,SELL,3,0.02h,Stop Loss,$10.50,$979.50,$112313.00,254,$979.50
2024-12-20,17:39:00,21782.0,BUY,3,0.02h,Stop Loss,$57.00,$1036.50,$112370.00,254,$1036.50
2024-12-20,17:59:00,21768.25,SELL,3,0.02h,Stop Loss,$45.00,$1081.50,$112415.00,254,$1081.50
2024-12-20,18:56:00,21708.0,BUY,3,0.02h,Stop Loss,$9.00,$1090.50,$112424.00,254,$1090.50
2024-12-20,19:01:00,21665.75,SELL,3,0.02h,Stop Loss,$10.50,$1101.00,$112434.50,254,$1101.00
2024-12-20,19:19:00,21687.0,BUY,3,0.02h,Break Even,$-1.50,$1099.50,$112433.00,254,$1099.50
2024-12-20,19:52:00,21702.0,SELL,3,0.02h,Stop Loss,$10.50,$1110.00,$112443.50,254,$1110.00
2024-12-20,21:05:00,21609.25,BUY,3,0.02h,Break Even,$-1.50,$1108.50,$112442.00,254,$1108.50
2024-12-20,21:08:00,21569.5,SELL,3,0.02h,Break Even,$-1.50,$1107.00,$112440.50,254,$1107.00
2024-12-20,21:54:00,21547.5,BUY,3,0.02h,Break Even,$-1.50,$1105.50,$112439.00,254,$1105.50
,,,,,,,,,,,
2024-12-23,00:27:00,21602.5,SELL,3,0.02h,Stop Loss,$30.00,$30.00,$112469.00,255,$30.00
2024-12-23,00:40:00,21622.5,BUY,3,0.02h,Stop Loss,$4.50,$34.50,$112473.50,255,$34.50
2024-12-23,00:44:00,21606.25,SELL,3,0.02h,Stop Loss,$-9.00,$25.50,$112464.50,255,$25.50
2024-12-23,00:49:00,21633.75,BUY,3,0.02h,Break Even,$-1.50,$24.00,$112463.00,255,$24.00
2024-12-23,01:04:00,21620.0,SELL,3,0.02h,Stop Loss,$13.50,$37.50,$112476.50,255,$37.50
2024-12-23,01:06:00,21626.0,BUY,3,0.02h,Stop Loss,$13.50,$51.00,$112490.00,255,$51.00
2024-12-23,02:15:00,21674.75,SELL,3,0.02h,Stop Loss,$15.00,$66.00,$112505.00,255,$66.00
2024-12-23,02:25:00,21683.25,BUY,3,0.02h,Break Even,$-1.50,$64.50,$112503.50,255,$64.50
2024-12-23,02:30:00,21676.0,SELL,3,0.02h,Stop Loss,$-9.00,$55.50,$112494.50,255,$55.50
2024-12-23,02:31:00,21681.5,BUY,3,0.02h,Stop Loss,$-9.00,$46.50,$112485.50,255,$46.50
2024-12-23,02:45:00,21668.75,SELL,3,0.02h,Stop Loss,$-9.00,$37.50,$112476.50,255,$37.50
2024-12-23,03:17:00,21673.0,BUY,3,0.02h,Stop Loss,$-9.00,$28.50,$112467.50,255,$28.50
2024-12-23,03:20:00,21664.25,SELL,3,0.02h,Break Even,$-1.50,$27.00,$112466.00,255,$27.00
2024-12-23,03:41:00,21673.5,BUY,3,0.02h,Stop Loss,$-9.00,$18.00,$112457.00,255,$18.00
2024-12-23,05:17:00,21702.5,SELL,3,0.02h,Break Even,$-1.50,$16.50,$112455.50,255,$16.50
2024-12-23,05:29:00,21718.25,BUY,3,0.02h,Stop Loss,$15.00,$31.50,$112470.50,255,$31.50
2024-12-23,06:03:00,21718.0,SELL,3,0.02h,Stop Loss,$-9.00,$22.50,$112461.50,255,$22.50
2024-12-23,06:07:00,21730.0,BUY,3,0.02h,Stop Loss,$7.50,$30.00,$112469.00,255,$30.00
2024-12-23,06:36:00,21731.25,SELL,3,0.02h,Break Even,$-1.50,$28.50,$112467.50,255,$28.50
2024-12-23,06:58:00,21736.25,BUY,3,0.02h,Stop Loss,$-9.00,$19.50,$112458.50,255,$19.50
2024-12-23,07:02:00,21719.75,SELL,3,0.02h,Stop Loss,$-9.00,$10.50,$112449.50,255,$10.50
2024-12-23,07:32:00,21716.25,BUY,3,0.02h,Stop Loss,$-9.00,$1.50,$112440.50,255,$1.50
2024-12-23,07:33:00,21710.0,SELL,3,0.02h,Stop Loss,$22.50,$24.00,$112463.00,255,$24.00
2024-12-23,07:43:00,21716.25,BUY,3,0.02h,Break Even,$-1.50,$22.50,$112461.50,255,$22.50
2024-12-23,08:00:00,21711.75,SELL,3,0.02h,Stop Loss,$73.50,$96.00,$112535.00,255,$96.00
2024-12-23,08:19:00,21710.5,BUY,3,0.02h,Stop Loss,$6.00,$102.00,$112541.00,255,$102.00
2024-12-23,08:20:00,21699.25,SELL,3,0.02h,Stop Loss,$22.50,$124.50,$112563.50,255,$124.50
2024-12-23,08:45:00,21693.5,BUY,3,0.02h,Break Even,$-1.50,$123.00,$112562.00,255,$123.00
2024-12-23,08:57:00,21685.0,SELL,3,0.02h,Break Even,$-1.50,$121.50,$112560.50,255,$121.50
2024-12-23,09:12:00,21688.75,BUY,3,0.02h,Stop Loss,$-9.00,$112.50,$112551.50,255,$112.50
2024-12-23,09:13:00,21679.5,SELL,3,0.02h,Stop Loss,$24.00,$136.50,$112575.50,255,$136.50
2024-12-23,09:34:00,21671.0,BUY,3,0.02h,Stop Loss,$6.00,$142.50,$112581.50,255,$142.50
2024-12-23,09:55:00,21670.0,SELL,3,0.02h,Break Even,$-1.50,$141.00,$112580.00,255,$141.00
2024-12-23,11:45:00,21599.0,BUY,3,0.02h,Stop Loss,$-9.00,$132.00,$112571.00,255,$132.00
2024-12-23,11:48:00,21584.0,SELL,3,0.02h,Stop Loss,$48.00,$180.00,$112619.00,255,$180.00
2024-12-23,11:53:00,21596.75,BUY,3,0.02h,Stop Loss,$7.50,$187.50,$112626.50,255,$187.50
2024-12-23,11:55:00,21584.25,SELL,3,0.02h,Stop Loss,$-9.00,$178.50,$112617.50,255,$178.50
2024-12-23,12:01:00,21604.25,BUY,3,0.02h,Break Even,$-1.50,$177.00,$112616.00,255,$177.00
2024-12-23,13:05:00,21646.25,SELL,3,0.02h,Stop Loss,$-9.00,$168.00,$112607.00,255,$168.00
2024-12-23,13:08:00,21666.25,BUY,3,0.02h,Stop Loss,$-9.00,$159.00,$112598.00,255,$159.00
2024-12-23,13:10:00,21656.0,SELL,3,0.02h,Stop Loss,$-9.00,$150.00,$112589.00,255,$150.00
2024-12-23,13:26:00,21661.0,BUY,3,0.02h,Stop Loss,$10.50,$160.50,$112599.50,255,$160.50
2024-12-23,13:32:00,21638.0,SELL,3,0.02h,Stop Loss,$40.50,$201.00,$112640.00,255,$201.00
2024-12-23,14:06:00,21591.25,BUY,3,0.02h,Break Even,$-1.50,$199.50,$112638.50,255,$199.50
2024-12-23,14:18:00,21583.0,SELL,3,0.02h,Stop Loss,$36.00,$235.50,$112674.50,255,$235.50
2024-12-23,14:22:00,21593.25,BUY,3,0.02h,Stop Loss,$13.50,$249.00,$112688.00,255,$249.00
2024-12-23,14:47:00,21592.25,SELL,3,0.02h,Stop Loss,$-9.00,$240.00,$112679.00,255,$240.00
2024-12-23,15:00:00,21629.75,BUY,3,0.02h,Stop Loss,$64.50,$304.50,$112743.50,255,$304.50
2024-12-23,15:03:00,21583.75,SELL,3,0.02h,Stop Loss,$-9.00,$295.50,$112734.50,255,$295.50
2024-12-23,15:39:00,21584.75,BUY,3,0.02h,Stop Loss,$24.00,$319.50,$112758.50,255,$319.50
2024-12-23,15:49:00,21551.75,SELL,3,0.02h,Stop Loss,$28.50,$348.00,$112787.00,255,$348.00
2024-12-23,15:56:00,21575.75,BUY,3,0.02h,Stop Loss,$58.50,$406.50,$112845.50,255,$406.50
2024-12-23,17:15:00,21671.5,SELL,3,0.02h,Stop Loss,$48.00,$454.50,$112893.50,255,$454.50
2024-12-23,17:29:00,21687.0,BUY,3,0.02h,Break Even,$-1.50,$453.00,$112892.00,255,$453.00
2024-12-23,17:30:00,21671.75,SELL,3,0.02h,Break Even,$-1.50,$451.50,$112890.50,255,$451.50
2024-12-23,17:33:00,21685.75,BUY,3,0.02h,Stop Loss,$12.00,$463.50,$112902.50,255,$463.50
2024-12-23,17:37:00,21661.5,SELL,3,0.02h,Stop Loss,$-9.00,$454.50,$112893.50,255,$454.50
2024-12-23,17:38:00,21676.75,BUY,3,0.02h,Stop Loss,$58.50,$513.00,$112952.00,255,$513.00
2024-12-23,19:34:00,21752.25,SELL,3,0.02h,Break Even,$-1.50,$511.50,$112950.50,255,$511.50
2024-12-23,20:29:00,21707.25,BUY,3,0.02h,Break Even,$-1.50,$510.00,$112949.00,255,$510.00
2024-12-23,21:05:00,21723.25,SELL,3,0.02h,Stop Loss,$-9.00,$501.00,$112940.00,255,$501.00
2024-12-23,21:12:00,21749.5,BUY,3,0.02h,Stop Loss,$-9.00,$492.00,$112931.00,255,$492.00
2024-12-23,21:19:00,21741.75,SELL,3,0.02h,Stop Loss,$3.00,$495.00,$112934.00,255,$495.00
2024-12-23,21:20:00,21744.5,BUY,3,0.02h,Stop Loss,$-9.00,$486.00,$112925.00,255,$486.00
2024-12-23,21:22:00,21740.75,SELL,3,0.02h,Stop Loss,$33.00,$519.00,$112958.00,255,$519.00
2024-12-23,21:47:00,21741.5,BUY,3,0.02h,Break Even,$-1.50,$517.50,$112956.50,255,$517.50
2024-12-23,21:53:00,21731.0,SELL,3,0.02h,Stop Loss,$-9.00,$508.50,$112947.50,255,$508.50
2024-12-23,21:58:00,21739.5,BUY,3,0.02h,Stop Loss,$-9.00,$499.50,$112938.50,255,$499.50
2024-12-23,23:34:00,21743.25,SELL,3,0.02h,Stop Loss,$45.00,$544.50,$112983.50,255,$544.50
,,,,,,,,,,,
2024-12-24,00:00:00,21737.25,BUY,3,0.02h,Break Even,$-1.50,$-1.50,$112982.00,256,$-1.50
2024-12-24,00:01:00,21732.25,SELL,3,0.02h,Stop Loss,$42.00,$40.50,$113024.00,256,$40.50
2024-12-24,00:24:00,21731.25,BUY,3,0.02h,Stop Loss,$-9.00,$31.50,$113015.00,256,$31.50
2024-12-24,00:30:00,21716.5,SELL,3,0.02h,Break Even,$-1.50,$30.00,$113013.50,256,$30.00
2024-12-24,00:34:00,21727.5,BUY,3,0.02h,Stop Loss,$-9.00,$21.00,$113004.50,256,$21.00
2024-12-24,01:04:00,21726.75,SELL,3,0.02h,Stop Loss,$-9.00,$12.00,$112995.50,256,$12.00
2024-12-24,01:07:00,21734.0,BUY,3,0.02h,Stop Loss,$-9.00,$3.00,$112986.50,256,$3.00
2024-12-24,01:13:00,21724.75,SELL,3,0.02h,Stop Loss,$-9.00,$-6.00,$112977.50,256,$-6.00
2024-12-24,01:26:00,21732.25,BUY,3,0.02h,Stop Loss,$46.50,$40.50,$113024.00,256,$40.50
2024-12-24,01:54:00,21732.75,SELL,3,0.02h,Break Even,$-1.50,$39.00,$113022.50,256,$39.00
2024-12-24,02:01:00,21737.75,BUY,3,0.02h,Stop Loss,$-9.00,$30.00,$113013.50,256,$30.00
2024-12-24,02:02:00,21733.25,SELL,3,0.02h,Stop Loss,$-9.00,$21.00,$113004.50,256,$21.00
2024-12-24,02:12:00,21739.5,BUY,3,0.02h,Stop Loss,$-9.00,$12.00,$112995.50,256,$12.00
2024-12-24,02:33:00,21741.5,SELL,3,0.02h,Stop Loss,$-9.00,$3.00,$112986.50,256,$3.00
2024-12-24,02:34:00,21743.0,BUY,3,0.02h,Stop Loss,$-9.00,$-6.00,$112977.50,256,$-6.00
2024-12-24,02:35:00,21741.5,SELL,3,0.02h,Stop Loss,$-9.00,$-15.00,$112968.50,256,$-15.00
2024-12-24,02:45:00,21743.5,BUY,3,0.02h,Break Even,$-1.50,$-16.50,$112967.00,256,$-16.50
2024-12-24,03:17:00,21746.25,SELL,3,0.02h,Stop Loss,$36.00,$19.50,$113003.00,256,$19.50
2024-12-24,03:43:00,21747.0,BUY,3,0.02h,Stop Loss,$-9.00,$10.50,$112994.00,256,$10.50
2024-12-24,03:53:00,21741.0,SELL,3,0.02h,Stop Loss,$-9.00,$1.50,$112985.00,256,$1.50
2024-12-24,03:57:00,21745.0,BUY,3,0.02h,Stop Loss,$-9.00,$-7.50,$112976.00,256,$-7.50
2024-12-24,04:04:00,21739.5,SELL,3,0.02h,Break Even,$-1.50,$-9.00,$112974.50,256,$-9.00
2024-12-24,04:30:00,21739.5,BUY,3,0.02h,Break Even,$-1.50,$-10.50,$112973.00,256,$-10.50
2024-12-24,05:08:00,21745.75,SELL,3,0.05h,Stop Loss,$-9.00,$-19.50,$112964.00,256,$-19.50
2024-12-24,05:12:00,21748.0,BUY,3,0.02h,Stop Loss,$-9.00,$-28.50,$112955.00,256,$-28.50
2024-12-24,05:15:00,21744.5,SELL,3,0.02h,Stop Loss,$-9.00,$-37.50,$112946.00,256,$-37.50
2024-12-24,05:22:00,21747.25,BUY,3,0.02h,Stop Loss,$-9.00,$-46.50,$112937.00,256,$-46.50
2024-12-24,05:27:00,21744.5,SELL,3,0.02h,Stop Loss,$-9.00,$-55.50,$112928.00,256,$-55.50
2024-12-24,05:48:00,21749.0,BUY,3,0.02h,Stop Loss,$-9.00,$-64.50,$112919.00,256,$-64.50
2024-12-24,06:00:00,21746.0,SELL,3,0.02h,Stop Loss,$-9.00,$-73.50,$112910.00,256,$-73.50
2024-12-24,06:28:00,21748.0,BUY,3,0.02h,Break Even,$-1.50,$-75.00,$112908.50,256,$-75.00
2024-12-24,07:54:00,21779.0,SELL,3,0.02h,Stop Loss,$-9.00,$-84.00,$112899.50,256,$-84.00
2024-12-24,08:35:00,21763.25,BUY,3,0.02h,Stop Loss,$-9.00,$-93.00,$112890.50,256,$-93.00
2024-12-24,08:49:00,21751.75,SELL,3,0.02h,Stop Loss,$9.00,$-84.00,$112899.50,256,$-84.00
2024-12-24,09:01:00,21762.5,BUY,3,0.02h,Stop Loss,$39.00,$-45.00,$112938.50,256,$-45.00
2024-12-24,09:31:00,21778.75,SELL,3,0.02h,Break Even,$-1.50,$-46.50,$112937.00,256,$-46.50
2024-12-24,09:36:00,21790.0,BUY,3,0.02h,Stop Loss,$-9.00,$-55.50,$112928.00,256,$-55.50
2024-12-24,09:39:00,21779.75,SELL,3,0.02h,Stop Loss,$-9.00,$-64.50,$112919.00,256,$-64.50
2024-12-24,09:41:00,21789.25,BUY,3,0.02h,Stop Loss,$-9.00,$-73.50,$112910.00,256,$-73.50
2024-12-24,10:15:00,21789.0,SELL,3,0.02h,Break Even,$-1.50,$-75.00,$112908.50,256,$-75.00
2024-12-24,10:27:00,21795.75,BUY,3,0.02h,Break Even,$-1.50,$-76.50,$112907.00,256,$-76.50
2024-12-24,10:28:00,21790.75,SELL,3,0.02h,Stop Loss,$10.50,$-66.00,$112917.50,256,$-66.00
2024-12-24,10:53:00,21794.5,BUY,3,0.02h,Break Even,$-1.50,$-67.50,$112916.00,256,$-67.50
2024-12-24,11:18:00,21792.25,SELL,3,0.02h,Break Even,$-1.50,$-69.00,$112914.50,256,$-69.00
2024-12-24,11:59:00,21785.25,BUY,3,0.02h,Break Even,$-1.50,$-70.50,$112913.00,256,$-70.50
2024-12-24,12:39:00,21788.75,SELL,3,0.02h,Stop Loss,$-9.00,$-79.50,$112904.00,256,$-79.50
2024-12-24,12:50:00,21795.25,BUY,3,0.02h,Break Even,$-1.50,$-81.00,$112902.50,256,$-81.00
2024-12-24,12:51:00,21792.0,SELL,3,0.02h,Stop Loss,$-9.00,$-90.00,$112893.50,256,$-90.00
2024-12-24,12:52:00,21796.75,BUY,3,0.02h,Stop Loss,$-9.00,$-99.00,$112884.50,256,$-99.00
2024-12-24,13:02:00,21790.5,SELL,3,0.02h,Stop Loss,$-9.00,$-108.00,$112875.50,256,$-108.00
2024-12-24,13:06:00,21795.5,BUY,3,0.02h,Break Even,$-1.50,$-109.50,$112874.00,256,$-109.50
2024-12-24,13:19:00,21795.0,SELL,3,0.02h,Break Even,$-1.50,$-111.00,$112872.50,256,$-111.00
2024-12-24,13:20:00,21798.0,BUY,3,0.02h,Stop Loss,$-9.00,$-120.00,$112863.50,256,$-120.00
2024-12-24,13:21:00,21795.0,SELL,3,0.02h,Break Even,$-1.50,$-121.50,$112862.00,256,$-121.50
2024-12-24,13:22:00,21797.5,BUY,3,0.02h,Stop Loss,$-9.00,$-130.50,$112853.00,256,$-130.50
2024-12-24,14:25:00,21824.5,SELL,3,0.02h,Stop Loss,$6.00,$-124.50,$112859.00,256,$-124.50
2024-12-24,14:38:00,21843.5,BUY,3,0.02h,Stop Loss,$24.00,$-100.50,$112883.00,256,$-100.50
2024-12-24,16:54:00,21964.5,SELL,3,0.02h,Stop Loss,$48.00,$-52.50,$112931.00,256,$-52.50
2024-12-24,17:13:00,21983.75,BUY,3,0.02h,Break Even,$-1.50,$-54.00,$112929.50,256,$-54.00
2024-12-24,17:35:00,21964.25,SELL,3,0.02h,Stop Loss,$37.50,$-16.50,$112967.00,256,$-16.50
2024-12-24,17:51:00,21988.25,BUY,3,0.02h,Break Even,$-1.50,$-18.00,$112965.50,256,$-18.00
,,,,,,,,,,,
2024-12-25,23:31:00,22054.75,SELL,3,0.02h,Stop Loss,$3.00,$3.00,$112968.50,257,$3.00
2024-12-25,23:43:00,22062.0,BUY,3,0.02h,Break Even,$-1.50,$1.50,$112967.00,257,$1.50
2024-12-25,23:45:00,22058.75,SELL,3,0.02h,Stop Loss,$4.50,$6.00,$112971.50,257,$6.00
,,,,,,,,,,,
2024-12-26,00:00:00,22060.0,BUY,3,0.02h,Stop Loss,$-9.00,$-9.00,$112962.50,258,$-9.00
2024-12-26,00:09:00,22051.75,SELL,3,0.02h,Break Even,$-1.50,$-10.50,$112961.00,258,$-10.50
2024-12-26,00:38:00,22055.5,BUY,3,0.02h,Break Even,$-1.50,$-12.00,$112959.50,258,$-12.00
2024-12-26,00:56:00,22053.25,SELL,3,0.02h,Stop Loss,$-9.00,$-21.00,$112950.50,258,$-21.00
2024-12-26,01:16:00,22060.25,BUY,3,0.02h,Stop Loss,$-9.00,$-30.00,$112941.50,258,$-30.00
2024-12-26,02:00:00,22059.5,SELL,3,0.02h,Stop Loss,$-9.00,$-39.00,$112932.50,258,$-39.00
2024-12-26,02:19:00,22059.5,BUY,3,0.02h,Break Even,$-1.50,$-40.50,$112931.00,258,$-40.50
2024-12-26,02:38:00,22058.25,SELL,3,0.02h,Stop Loss,$-9.00,$-49.50,$112922.00,258,$-49.50
2024-12-26,02:40:00,22060.25,BUY,3,0.02h,Break Even,$-1.50,$-51.00,$112920.50,258,$-51.00
2024-12-26,04:13:00,22103.5,SELL,3,0.02h,Break Even,$-1.50,$-52.50,$112919.00,258,$-52.50
2024-12-26,04:17:00,22107.0,BUY,3,0.02h,Stop Loss,$-9.00,$-61.50,$112910.00,258,$-61.50
2024-12-26,04:21:00,22103.25,SELL,3,0.02h,Break Even,$-1.50,$-63.00,$112908.50,258,$-63.00
2024-12-26,04:44:00,22098.75,BUY,3,0.02h,Break Even,$-1.50,$-64.50,$112907.00,258,$-64.50
2024-12-26,04:57:00,22096.0,SELL,3,0.02h,Break Even,$-1.50,$-66.00,$112905.50,258,$-66.00
2024-12-26,05:28:00,22086.0,BUY,3,0.02h,Stop Loss,$-9.00,$-75.00,$112896.50,258,$-75.00
2024-12-26,05:58:00,22088.25,SELL,3,0.03h,Stop Loss,$-9.00,$-84.00,$112887.50,258,$-84.00
2024-12-26,06:03:00,22096.75,BUY,3,0.02h,Break Even,$-1.50,$-85.50,$112886.00,258,$-85.50
2024-12-26,06:10:00,22086.0,SELL,3,0.02h,Stop Loss,$-9.00,$-94.50,$112877.00,258,$-94.50
2024-12-26,07:41:00,22074.25,BUY,3,0.03h,Break Even,$-1.50,$-96.00,$112875.50,258,$-96.00
2024-12-26,08:03:00,22055.75,SELL,3,0.02h,Stop Loss,$-9.00,$-105.00,$112866.50,258,$-105.00
2024-12-26,09:33:00,21978.25,BUY,3,0.02h,Stop Loss,$4.50,$-100.50,$112871.00,258,$-100.50
2024-12-26,09:51:00,21957.25,SELL,3,0.02h,Stop Loss,$63.00,$-37.50,$112934.00,258,$-37.50
2024-12-26,10:30:00,21926.0,BUY,3,0.02h,Break Even,$-1.50,$-39.00,$112932.50,258,$-39.00
2024-12-26,10:53:00,21924.5,SELL,3,0.02h,Stop Loss,$45.00,$6.00,$112977.50,258,$6.00
2024-12-26,10:59:00,21938.25,BUY,3,0.02h,Stop Loss,$-9.00,$-3.00,$112968.50,258,$-3.00
2024-12-26,11:01:00,21921.5,SELL,3,0.02h,Stop Loss,$-9.00,$-12.00,$112959.50,258,$-12.00
2024-12-26,11:02:00,21930.5,BUY,3,0.02h,Stop Loss,$3.00,$-9.00,$112962.50,258,$-9.00
2024-12-26,11:16:00,21921.5,SELL,3,0.02h,Break Even,$-1.50,$-10.50,$112961.00,258,$-10.50
2024-12-26,11:25:00,21933.75,BUY,3,0.02h,Stop Loss,$54.00,$43.50,$113015.00,258,$43.50
2024-12-26,12:24:00,21952.75,SELL,3,0.02h,Stop Loss,$-9.00,$34.50,$113006.00,258,$34.50
2024-12-26,12:54:00,21957.5,BUY,3,0.02h,Stop Loss,$-9.00,$25.50,$112997.00,258,$25.50
2024-12-26,13:03:00,21945.5,SELL,3,0.02h,Stop Loss,$7.50,$33.00,$113004.50,258,$33.00
2024-12-26,13:08:00,21954.75,BUY,3,0.02h,Stop Loss,$-9.00,$24.00,$112995.50,258,$24.00
2024-12-26,13:25:00,21947.0,SELL,3,0.02h,Stop Loss,$18.00,$42.00,$113013.50,258,$42.00
2024-12-26,13:39:00,21955.0,BUY,3,0.02h,Stop Loss,$-9.00,$33.00,$113004.50,258,$33.00
2024-12-26,13:43:00,21935.25,SELL,3,0.02h,Break Even,$-1.50,$31.50,$113003.00,258,$31.50
2024-12-26,13:50:00,21953.25,BUY,3,0.02h,Stop Loss,$-9.00,$22.50,$112994.00,258,$22.50
2024-12-26,13:52:00,21946.5,SELL,3,0.02h,Stop Loss,$3.00,$25.50,$112997.00,258,$25.50
2024-12-26,13:54:00,21957.25,BUY,3,0.02h,Break Even,$-1.50,$24.00,$112995.50,258,$24.00
2024-12-26,14:21:00,21946.25,SELL,3,0.02h,Stop Loss,$16.50,$40.50,$113012.00,258,$40.50
2024-12-26,14:30:00,21960.75,BUY,3,0.02h,Stop Loss,$130.50,$171.00,$113142.50,258,$171.00
2024-12-26,14:50:00,21953.25,SELL,3,0.02h,Stop Loss,$118.50,$289.50,$113261.00,258,$289.50
2024-12-26,15:04:00,21965.25,BUY,3,0.02h,Stop Loss,$42.00,$331.50,$113303.00,258,$331.50
2024-12-26,15:10:00,21929.5,SELL,3,0.02h,Break Even,$-1.50,$330.00,$113301.50,258,$330.00
2024-12-26,15:23:00,21974.25,BUY,3,0.02h,Stop Loss,$6.00,$336.00,$113307.50,258,$336.00
2024-12-26,16:25:00,21989.5,SELL,3,0.02h,Stop Loss,$43.50,$379.50,$113351.00,258,$379.50
2024-12-26,16:35:00,22006.25,BUY,3,0.02h,Stop Loss,$15.00,$394.50,$113366.00,258,$394.50
2024-12-26,17:28:00,22033.0,SELL,3,0.02h,Stop Loss,$33.00,$427.50,$113399.00,258,$427.50
2024-12-26,18:07:00,22020.25,BUY,3,0.02h,Stop Loss,$18.00,$445.50,$113417.00,258,$445.50
2024-12-26,18:15:00,22010.0,SELL,3,0.02h,Break Even,$-1.50,$444.00,$113415.50,258,$444.00
2024-12-26,18:16:00,22018.5,BUY,3,0.02h,Stop Loss,$24.00,$468.00,$113439.50,258,$468.00
2024-12-26,18:36:00,22025.25,SELL,3,0.02h,Stop Loss,$24.00,$492.00,$113463.50,258,$492.00
2024-12-26,18:55:00,22027.25,BUY,3,0.02h,Stop Loss,$10.50,$502.50,$113474.00,258,$502.50
2024-12-26,18:58:00,22009.0,SELL,3,0.02h,Break Even,$-1.50,$501.00,$113472.50,258,$501.00
2024-12-26,19:28:00,22014.25,BUY,3,0.02h,Stop Loss,$-9.00,$492.00,$113463.50,258,$492.00
2024-12-26,19:37:00,22004.25,SELL,3,0.02h,Break Even,$-1.50,$490.50,$113462.00,258,$490.50
2024-12-26,19:39:00,22011.75,BUY,3,0.02h,Stop Loss,$21.00,$511.50,$113483.00,258,$511.50
2024-12-26,20:17:00,22034.5,SELL,3,0.02h,Break Even,$-1.50,$510.00,$113481.50,258,$510.00
2024-12-26,20:23:00,22044.5,BUY,3,0.02h,Break Even,$-1.50,$508.50,$113480.00,258,$508.50
2024-12-26,20:51:00,22039.75,SELL,3,0.02h,Stop Loss,$22.50,$531.00,$113502.50,258,$531.00
2024-12-26,23:02:00,21998.5,BUY,3,0.02h,Stop Loss,$-9.00,$522.00,$113493.50,258,$522.00
2024-12-26,23:11:00,21978.0,SELL,3,0.02h,Stop Loss,$-9.00,$513.00,$113484.50,258,$513.00
2024-12-26,23:22:00,21994.5,BUY,3,0.02h,Stop Loss,$-9.00,$504.00,$113475.50,258,$504.00
2024-12-26,23:36:00,21987.0,SELL,3,0.02h,Stop Loss,$-9.00,$495.00,$113466.50,258,$495.00
2024-12-26,23:37:00,21992.0,BUY,3,0.02h,Break Even,$-1.50,$493.50,$113465.00,258,$493.50
,,,,,,,,,,,
2024-12-27,00:11:00,21998.75,SELL,3,0.02h,Break Even,$-1.50,$-1.50,$113463.50,259,$-1.50
2024-12-27,00:50:00,21979.0,BUY,3,0.02h,Stop Loss,$-9.00,$-10.50,$113454.50,259,$-10.50
2024-12-27,00:58:00,21970.75,SELL,3,0.02h,Stop Loss,$-9.00,$-19.50,$113445.50,259,$-19.50
2024-12-27,01:01:00,21974.75,BUY,3,0.02h,Stop Loss,$-9.00,$-28.50,$113436.50,259,$-28.50
2024-12-27,01:04:00,21969.75,SELL,3,0.02h,Stop Loss,$-9.00,$-37.50,$113427.50,259,$-37.50
2024-12-27,01:44:00,21970.0,BUY,3,0.02h,Break Even,$-1.50,$-39.00,$113426.00,259,$-39.00
2024-12-27,02:01:00,21958.0,SELL,3,0.02h,Break Even,$-1.50,$-40.50,$113424.50,259,$-40.50
2024-12-27,02:12:00,21969.0,BUY,3,0.02h,Stop Loss,$-9.00,$-49.50,$113415.50,259,$-49.50
2024-12-27,02:18:00,21961.5,SELL,3,0.02h,Break Even,$-1.50,$-51.00,$113414.00,259,$-51.00
2024-12-27,02:20:00,21965.5,BUY,3,0.02h,Stop Loss,$-9.00,$-60.00,$113405.00,259,$-60.00
2024-12-27,02:45:00,21964.75,SELL,3,0.03h,Stop Loss,$-9.00,$-69.00,$113396.00,259,$-69.00
2024-12-27,03:15:00,21966.0,BUY,3,0.02h,Break Even,$-1.50,$-70.50,$113394.50,259,$-70.50
2024-12-27,03:17:00,21961.0,SELL,3,0.02h,Break Even,$-1.50,$-72.00,$113393.00,259,$-72.00
2024-12-27,03:51:00,21956.75,BUY,3,0.02h,Stop Loss,$-9.00,$-81.00,$113384.00,259,$-81.00
2024-12-27,04:20:00,21950.75,SELL,3,0.02h,Stop Loss,$-9.00,$-90.00,$113375.00,259,$-90.00
2024-12-27,04:26:00,21955.5,BUY,3,0.02h,Stop Loss,$-9.00,$-99.00,$113366.00,259,$-99.00
2024-12-27,04:54:00,21952.25,SELL,3,0.02h,Break Even,$-1.50,$-100.50,$113364.50,259,$-100.50
2024-12-27,05:09:00,21954.25,BUY,3,0.02h,Stop Loss,$-9.00,$-109.50,$113355.50,259,$-109.50
2024-12-27,05:39:00,21956.0,SELL,3,0.02h,Stop Loss,$-9.00,$-118.50,$113346.50,259,$-118.50
2024-12-27,06:56:00,21937.5,BUY,3,0.02h,Stop Loss,$-9.00,$-127.50,$113337.50,259,$-127.50
2024-12-27,07:09:00,21930.25,SELL,3,0.02h,Stop Loss,$30.00,$-97.50,$113367.50,259,$-97.50
2024-12-27,07:21:00,21941.0,BUY,3,0.02h,Stop Loss,$-9.00,$-106.50,$113358.50,259,$-106.50
2024-12-27,07:48:00,21936.0,SELL,3,0.02h,Break Even,$-1.50,$-108.00,$113357.00,259,$-108.00
2024-12-27,08:18:00,21931.0,BUY,3,0.02h,Stop Loss,$-9.00,$-117.00,$113348.00,259,$-117.00
2024-12-27,08:22:00,21920.0,SELL,3,0.02h,Stop Loss,$-9.00,$-126.00,$113339.00,259,$-126.00
2024-12-27,08:24:00,21931.0,BUY,3,0.02h,Stop Loss,$6.00,$-120.00,$113345.00,259,$-120.00
2024-12-27,08:34:00,21917.5,SELL,3,0.02h,Break Even,$-1.50,$-121.50,$113343.50,259,$-121.50
2024-12-27,09:13:00,21910.5,BUY,3,0.02h,Break Even,$-1.50,$-123.00,$113342.00,259,$-123.00
2024-12-27,09:52:00,21910.5,SELL,3,0.02h,Break Even,$-1.50,$-124.50,$113340.50,259,$-124.50
2024-12-27,10:08:00,21915.75,BUY,3,0.02h,Stop Loss,$-9.00,$-133.50,$113331.50,259,$-133.50
2024-12-27,10:09:00,21914.5,SELL,3,0.02h,Break Even,$-1.50,$-135.00,$113330.00,259,$-135.00
2024-12-27,10:12:00,21919.25,BUY,3,0.02h,Break Even,$-1.50,$-136.50,$113328.50,259,$-136.50
2024-12-27,10:36:00,21912.0,SELL,3,0.02h,Break Even,$-1.50,$-138.00,$113327.00,259,$-138.00
2024-12-27,10:44:00,21921.75,BUY,3,0.02h,Stop Loss,$-9.00,$-147.00,$113318.00,259,$-147.00
2024-12-27,10:48:00,21914.5,SELL,3,0.02h,Break Even,$-1.50,$-148.50,$113316.50,259,$-148.50
2024-12-27,10:53:00,21919.25,BUY,3,0.03h,Stop Loss,$19.50,$-129.00,$113336.00,259,$-129.00
2024-12-27,11:18:00,21919.75,SELL,3,0.02h,Stop Loss,$-9.00,$-138.00,$113327.00,259,$-138.00
2024-12-27,11:34:00,21922.75,BUY,3,0.02h,Stop Loss,$-9.00,$-147.00,$113318.00,259,$-147.00
2024-12-27,12:28:00,21941.75,SELL,3,0.02h,Stop Loss,$-9.00,$-156.00,$113309.00,259,$-156.00
2024-12-27,12:33:00,21949.5,BUY,3,0.02h,Stop Loss,$-9.00,$-165.00,$113300.00,259,$-165.00
2024-12-27,12:40:00,21936.0,SELL,3,0.02h,Break Even,$-1.50,$-166.50,$113298.50,259,$-166.50
2024-12-27,13:55:00,21914.0,BUY,3,0.02h,Break Even,$-1.50,$-168.00,$113297.00,259,$-168.00
2024-12-27,13:59:00,21904.25,SELL,3,0.02h,Stop Loss,$45.00,$-123.00,$113342.00,259,$-123.00
2024-12-27,15:43:00,21567.5,BUY,3,0.02h,Stop Loss,$121.50,$-1.50,$113463.50,259,$-1.50
2024-12-27,16:05:00,21555.75,SELL,3,0.02h,Stop Loss,$30.00,$28.50,$113493.50,259,$28.50
2024-12-27,16:25:00,21573.0,BUY,3,0.02h,Stop Loss,$130.50,$159.00,$113624.00,259,$159.00
2024-12-27,16:45:00,21581.75,SELL,3,0.02h,Break Even,$-1.50,$157.50,$113622.50,259,$157.50
2024-12-27,17:31:00,21547.25,BUY,3,0.02h,Stop Loss,$144.00,$301.50,$113766.50,259,$301.50
2024-12-27,17:39:00,21511.5,SELL,3,0.02h,Stop Loss,$-9.00,$292.50,$113757.50,259,$292.50
2024-12-27,17:43:00,21545.75,BUY,3,0.02h,Stop Loss,$31.50,$324.00,$113789.00,259,$324.00
2024-12-27,19:24:00,21639.75,SELL,3,0.02h,Stop Loss,$-9.00,$315.00,$113780.00,259,$315.00
2024-12-27,19:35:00,21665.75,BUY,3,0.02h,Stop Loss,$64.50,$379.50,$113844.50,259,$379.50
2024-12-27,20:06:00,21678.25,SELL,3,0.02h,Stop Loss,$70.50,$450.00,$113915.00,259,$450.00
2024-12-27,20:51:00,21678.25,BUY,3,0.02h,Stop Loss,$150.00,$600.00,$114065.00,259,$600.00
2024-12-27,21:42:00,21716.75,SELL,3,0.02h,Break Even,$-1.50,$598.50,$114063.50,259,$598.50
2024-12-27,21:57:00,21722.0,BUY,3,0.02h,Stop Loss,$-9.00,$589.50,$114054.50,259,$589.50
,,,,,,,,,,,
2024-12-30,00:00:00,21702.5,SELL,3,0.02h,Stop Loss,$25.50,$25.50,$114080.00,260,$25.50
2024-12-30,00:25:00,21707.0,BUY,3,0.02h,Break Even,$-1.50,$24.00,$114078.50,260,$24.00
2024-12-30,00:41:00,21701.0,SELL,3,0.02h,Break Even,$-1.50,$22.50,$114077.00,260,$22.50
2024-12-30,00:44:00,21712.25,BUY,3,0.02h,Break Even,$-1.50,$21.00,$114075.50,260,$21.00
2024-12-30,01:01:00,21708.25,SELL,3,0.02h,Break Even,$-1.50,$19.50,$114074.00,260,$19.50
2024-12-30,01:28:00,21704.25,BUY,3,0.02h,Stop Loss,$-9.00,$10.50,$114065.00,260,$10.50
2024-12-30,01:37:00,21695.5,SELL,3,0.02h,Stop Loss,$16.50,$27.00,$114081.50,260,$27.00
2024-12-30,01:43:00,21700.75,BUY,3,0.02h,Break Even,$-1.50,$25.50,$114080.00,260,$25.50
2024-12-30,02:17:00,21701.25,SELL,3,0.02h,Stop Loss,$16.50,$42.00,$114096.50,260,$42.00
2024-12-30,03:23:00,21686.25,BUY,3,0.02h,Stop Loss,$-9.00,$33.00,$114087.50,260,$33.00
2024-12-30,03:24:00,21684.0,SELL,3,0.02h,Stop Loss,$-9.00,$24.00,$114078.50,260,$24.00
2024-12-30,03:25:00,21688.0,BUY,3,0.02h,Stop Loss,$-9.00,$15.00,$114069.50,260,$15.00
2024-12-30,03:51:00,21686.0,SELL,3,0.02h,Stop Loss,$-9.00,$6.00,$114060.50,260,$6.00
2024-12-30,04:08:00,21688.5,BUY,3,0.02h,Break Even,$-1.50,$4.50,$114059.00,260,$4.50
2024-12-30,04:17:00,21680.25,SELL,3,0.02h,Break Even,$-1.50,$3.00,$114057.50,260,$3.00
2024-12-30,04:35:00,21687.0,BUY,3,0.02h,Stop Loss,$-9.00,$-6.00,$114048.50,260,$-6.00
2024-12-30,05:03:00,21683.75,SELL,3,0.02h,Stop Loss,$3.00,$-3.00,$114051.50,260,$-3.00
2024-12-30,05:11:00,21689.25,BUY,3,0.02h,Stop Loss,$-9.00,$-12.00,$114042.50,260,$-12.00
2024-12-30,05:12:00,21682.0,SELL,3,0.02h,Break Even,$-1.50,$-13.50,$114041.00,260,$-13.50
2024-12-30,06:04:00,21664.25,BUY,3,0.02h,Stop Loss,$6.00,$-7.50,$114047.00,260,$-7.50
2024-12-30,06:42:00,21675.25,SELL,3,0.02h,Stop Loss,$-9.00,$-16.50,$114038.00,260,$-16.50
2024-12-30,07:47:00,21635.75,BUY,3,0.02h,Stop Loss,$10.50,$-6.00,$114048.50,260,$-6.00
2024-12-30,07:56:00,21626.5,SELL,3,0.02h,Stop Loss,$-9.00,$-15.00,$114039.50,260,$-15.00
2024-12-30,07:57:00,21633.25,BUY,3,0.02h,Stop Loss,$7.50,$-7.50,$114047.00,260,$-7.50
2024-12-30,08:49:00,21657.5,SELL,3,0.02h,Stop Loss,$31.50,$24.00,$114078.50,260,$24.00
2024-12-30,09:28:00,21653.0,BUY,3,0.02h,Stop Loss,$4.50,$28.50,$114083.00,260,$28.50
2024-12-30,09:43:00,21637.0,SELL,3,0.02h,Stop Loss,$-9.00,$19.50,$114074.00,260,$19.50
2024-12-30,09:51:00,21648.25,BUY,3,0.02h,Break Even,$-1.50,$18.00,$114072.50,260,$18.00
2024-12-30,10:30:00,21652.5,SELL,3,0.02h,Stop Loss,$-9.00,$9.00,$114063.50,260,$9.00
2024-12-30,10:31:00,21657.5,BUY,3,0.02h,Stop Loss,$-9.00,$0.00,$114054.50,260,$0.00
2024-12-30,10:38:00,21653.0,SELL,3,0.02h,Stop Loss,$-9.00,$-9.00,$114045.50,260,$-9.00
2024-12-30,10:57:00,21653.5,BUY,3,0.02h,Stop Loss,$-9.00,$-18.00,$114036.50,260,$-18.00
2024-12-30,10:58:00,21651.0,SELL,3,0.02h,Stop Loss,$-9.00,$-27.00,$114027.50,260,$-27.00
2024-12-30,10:59:00,21653.5,BUY,3,0.02h,Stop Loss,$-9.00,$-36.00,$114018.50,260,$-36.00
2024-12-30,11:00:00,21650.0,SELL,3,0.02h,Stop Loss,$-9.00,$-45.00,$114009.50,260,$-45.00
2024-12-30,11:01:00,21653.75,BUY,3,0.02h,Break Even,$-1.50,$-46.50,$114008.00,260,$-46.50
2024-12-30,11:12:00,21649.0,SELL,3,0.02h,Stop Loss,$-9.00,$-55.50,$113999.00,260,$-55.50
2024-12-30,11:16:00,21656.25,BUY,3,0.02h,Stop Loss,$-9.00,$-64.50,$113990.00,260,$-64.50
2024-12-30,11:46:00,21659.0,SELL,3,0.02h,Stop Loss,$-9.00,$-73.50,$113981.00,260,$-73.50
2024-12-30,14:07:00,21410.25,BUY,3,0.02h,Break Even,$-1.50,$-75.00,$113979.50,260,$-75.00
2024-12-30,14:25:00,21388.25,SELL,3,0.02h,Stop Loss,$9.00,$-66.00,$113988.50,260,$-66.00
2024-12-30,14:28:00,21405.25,BUY,3,0.02h,Stop Loss,$42.00,$-24.00,$114030.50,260,$-24.00
2024-12-30,14:32:00,21392.0,SELL,3,0.02h,Stop Loss,$60.00,$36.00,$114090.50,260,$36.00
2024-12-30,15:14:00,21325.75,BUY,3,0.02h,Stop Loss,$151.50,$187.50,$114242.00,260,$187.50
2024-12-30,15:19:00,21301.0,SELL,3,0.02h,Break Even,$-1.50,$186.00,$114240.50,260,$186.00
2024-12-30,15:39:00,21324.0,BUY,3,0.02h,Stop Loss,$252.00,$438.00,$114492.50,260,$438.00
2024-12-30,17:58:00,21508.75,SELL,3,0.02h,Stop Loss,$12.00,$450.00,$114504.50,260,$450.00
2024-12-30,18:00:00,21552.75,BUY,3,0.02h,Break Even,$-1.50,$448.50,$114503.00,260,$448.50
2024-12-30,18:01:00,21522.0,SELL,3,0.02h,Break Even,$-1.50,$447.00,$114501.50,260,$447.00
2024-12-30,18:02:00,21534.25,BUY,3,0.02h,Break Even,$-1.50,$445.50,$114500.00,260,$445.50
2024-12-30,18:03:00,21516.25,SELL,3,0.02h,Stop Loss,$-9.00,$436.50,$114491.00,260,$436.50
2024-12-30,18:11:00,21536.75,BUY,3,0.02h,Stop Loss,$58.50,$495.00,$114549.50,260,$495.00
2024-12-30,18:25:00,21511.0,SELL,3,0.02h,Break Even,$-1.50,$493.50,$114548.00,260,$493.50
2024-12-30,18:35:00,21547.0,BUY,3,0.02h,Stop Loss,$42.00,$535.50,$114590.00,260,$535.50
2024-12-30,19:02:00,21536.25,SELL,3,0.02h,Stop Loss,$4.50,$540.00,$114594.50,260,$540.00
2024-12-30,19:32:00,21535.25,BUY,3,0.02h,Stop Loss,$-9.00,$531.00,$114585.50,260,$531.00
2024-12-30,20:06:00,21515.5,SELL,3,0.02h,Stop Loss,$67.50,$598.50,$114653.00,260,$598.50
2024-12-30,20:15:00,21527.25,BUY,3,0.02h,Break Even,$-1.50,$597.00,$114651.50,260,$597.00
2024-12-30,20:26:00,21506.75,SELL,3,0.02h,Stop Loss,$37.50,$634.50,$114689.00,260,$634.50
2024-12-30,20:53:00,21493.25,BUY,3,0.02h,Stop Loss,$-9.00,$625.50,$114680.00,260,$625.50
2024-12-30,20:55:00,21466.0,SELL,3,0.02h,Stop Loss,$27.00,$652.50,$114707.00,260,$652.50
2024-12-30,21:46:00,21388.0,BUY,3,0.02h,Stop Loss,$4.50,$657.00,$114711.50,260,$657.00
2024-12-30,23:02:00,21379.25,SELL,3,0.02h,Break Even,$-1.50,$655.50,$114710.00,260,$655.50
2024-12-30,23:24:00,21374.5,BUY,3,0.02h,Stop Loss,$-9.00,$646.50,$114701.00,260,$646.50
,,,,,,,,,,,
2024-12-31,00:22:00,21390.5,SELL,3,0.02h,Stop Loss,$6.00,$6.00,$114707.00,261,$6.00
2024-12-31,01:07:00,21383.5,BUY,3,0.02h,Stop Loss,$-9.00,$-3.00,$114698.00,261,$-3.00
2024-12-31,02:50:00,21440.5,SELL,3,0.02h,Stop Loss,$-9.00,$-12.00,$114689.00,261,$-12.00
2024-12-31,03:28:00,21419.5,BUY,3,0.02h,Stop Loss,$12.00,$0.00,$114701.00,261,$0.00
2024-12-31,03:37:00,21406.5,SELL,3,0.02h,Break Even,$-1.50,$-1.50,$114699.50,261,$-1.50
2024-12-31,03:58:00,21411.5,BUY,3,0.02h,Break Even,$-1.50,$-3.00,$114698.00,261,$-3.00
2024-12-31,04:05:00,21400.0,SELL,3,0.02h,Stop Loss,$15.00,$12.00,$114713.00,261,$12.00
2024-12-31,04:50:00,21392.25,BUY,3,0.02h,Stop Loss,$16.50,$28.50,$114729.50,261,$28.50
2024-12-31,05:20:00,21401.75,SELL,3,0.02h,Stop Loss,$-9.00,$19.50,$114720.50,261,$19.50
2024-12-31,05:22:00,21410.25,BUY,3,0.02h,Break Even,$-1.50,$18.00,$114719.00,261,$18.00
2024-12-31,05:32:00,21394.5,SELL,3,0.02h,Stop Loss,$-9.00,$9.00,$114710.00,261,$9.00
2024-12-31,05:52:00,21403.5,BUY,3,0.02h,Stop Loss,$7.50,$16.50,$114717.50,261,$16.50
2024-12-31,06:06:00,21391.75,SELL,3,0.02h,Stop Loss,$30.00,$46.50,$114747.50,261,$46.50
2024-12-31,06:20:00,21399.25,BUY,3,0.02h,Break Even,$-1.50,$45.00,$114746.00,261,$45.00
2024-12-31,06:24:00,21391.25,SELL,3,0.02h,Stop Loss,$-9.00,$36.00,$114737.00,261,$36.00
2024-12-31,07:06:00,21384.0,BUY,3,0.02h,Stop Loss,$-9.00,$27.00,$114728.00,261,$27.00
2024-12-31,07:08:00,21382.0,SELL,3,0.02h,Stop Loss,$-9.00,$18.00,$114719.00,261,$18.00
2024-12-31,07:09:00,21386.75,BUY,3,0.02h,Break Even,$-1.50,$16.50,$114717.50,261,$16.50
2024-12-31,07:32:00,21375.75,SELL,3,0.02h,Stop Loss,$-9.00,$7.50,$114708.50,261,$7.50
2024-12-31,07:42:00,21404.25,BUY,3,0.02h,Stop Loss,$-9.00,$-1.50,$114699.50,261,$-1.50
2024-12-31,07:57:00,21390.75,SELL,3,0.02h,Break Even,$-1.50,$-3.00,$114698.00,261,$-3.00
2024-12-31,08:04:00,21401.0,BUY,3,0.02h,Stop Loss,$-9.00,$-12.00,$114689.00,261,$-12.00
2024-12-31,08:06:00,21391.75,SELL,3,0.02h,Break Even,$-1.50,$-13.50,$114687.50,261,$-13.50
2024-12-31,08:08:00,21399.75,BUY,3,0.02h,Stop Loss,$-9.00,$-22.50,$114678.50,261,$-22.50
2024-12-31,08:13:00,21391.25,SELL,3,0.02h,Break Even,$-1.50,$-24.00,$114677.00,261,$-24.00
2024-12-31,08:35:00,21386.25,BUY,3,0.02h,Stop Loss,$-9.00,$-33.00,$114668.00,261,$-33.00
2024-12-31,08:48:00,21375.25,SELL,3,0.02h,Break Even,$-1.50,$-34.50,$114666.50,261,$-34.50
2024-12-31,08:52:00,21389.75,BUY,3,0.02h,Stop Loss,$13.50,$-21.00,$114680.00,261,$-21.00
2024-12-31,10:01:00,21485.75,SELL,3,0.02h,Stop Loss,$13.50,$-7.50,$114693.50,261,$-7.50
2024-12-31,10:26:00,21491.0,BUY,3,0.02h,Stop Loss,$-9.00,$-16.50,$114684.50,261,$-16.50
2024-12-31,10:28:00,21479.75,SELL,3,0.02h,Stop Loss,$-9.00,$-25.50,$114675.50,261,$-25.50
2024-12-31,10:38:00,21488.5,BUY,3,0.02h,Stop Loss,$27.00,$1.50,$114702.50,261,$1.50
2024-12-31,11:15:00,21493.0,SELL,3,0.02h,Stop Loss,$-9.00,$-7.50,$114693.50,261,$-7.50
2024-12-31,11:39:00,21498.0,BUY,3,0.02h,Break Even,$-1.50,$-9.00,$114692.00,261,$-9.00
2024-12-31,12:36:00,21505.25,SELL,3,0.02h,Stop Loss,$7.50,$-1.50,$114699.50,261,$-1.50
2024-12-31,13:16:00,21482.0,BUY,3,0.02h,Stop Loss,$-9.00,$-10.50,$114690.50,261,$-10.50
2024-12-31,13:22:00,21459.0,SELL,3,0.02h,Stop Loss,$3.00,$-7.50,$114693.50,261,$-7.50
2024-12-31,13:25:00,21475.0,BUY,3,0.02h,Stop Loss,$7.50,$0.00,$114701.00,261,$0.00
2024-12-31,13:27:00,21467.0,SELL,3,0.02h,Stop Loss,$-9.00,$-9.00,$114692.00,261,$-9.00
2024-12-31,13:28:00,21471.75,BUY,3,0.02h,Stop Loss,$12.00,$3.00,$114704.00,261,$3.00
2024-12-31,13:49:00,21469.5,SELL,3,0.02h,Stop Loss,$16.50,$19.50,$114720.50,261,$19.50
2024-12-31,14:12:00,21471.25,BUY,3,0.02h,Stop Loss,$13.50,$33.00,$114734.00,261,$33.00
2024-12-31,14:29:00,21464.25,SELL,3,0.02h,Stop Loss,$39.00,$72.00,$114773.00,261,$72.00
2024-12-31,15:01:00,21432.25,BUY,3,0.02h,Stop Loss,$27.00,$99.00,$114800.00,261,$99.00
2024-12-31,15:07:00,21402.0,SELL,3,0.02h,Stop Loss,$241.50,$340.50,$115041.50,261,$340.50
2024-12-31,15:21:00,21409.25,BUY,3,0.02h,Stop Loss,$78.00,$418.50,$115119.50,261,$418.50
2024-12-31,15:35:00,21386.5,SELL,3,0.02h,Stop Loss,$18.00,$436.50,$115137.50,261,$436.50
2024-12-31,16:44:00,21330.25,BUY,3,0.02h,Stop Loss,$4.50,$441.00,$115142.00,261,$441.00
2024-12-31,17:02:00,21314.25,SELL,3,0.02h,Stop Loss,$63.00,$504.00,$115205.00,261,$504.00
2024-12-31,17:09:00,21338.75,BUY,3,0.02h,Stop Loss,$12.00,$516.00,$115217.00,261,$516.00
2024-12-31,17:13:00,21308.5,SELL,3,0.02h,Stop Loss,$12.00,$528.00,$115229.00,261,$528.00
2024-12-31,17:21:00,21329.0,BUY,3,0.02h,Stop Loss,$-9.00,$519.00,$115220.00,261,$519.00
2024-12-31,17:22:00,21301.0,SELL,3,0.02h,Stop Loss,$4.50,$523.50,$115224.50,261,$523.50
2024-12-31,17:56:00,21271.5,BUY,3,0.02h,Stop Loss,$76.50,$600.00,$115301.00,261,$600.00
2024-12-31,18:20:00,21269.0,SELL,3,0.02h,Stop Loss,$15.00,$615.00,$115316.00,261,$615.00
2024-12-31,18:50:00,21242.25,BUY,3,0.02h,Stop Loss,$123.00,$738.00,$115439.00,261,$738.00
2024-12-31,18:55:00,21233.0,SELL,3,0.02h,Break Even,$-1.50,$736.50,$115437.50,261,$736.50
2024-12-31,19:09:00,21249.5,BUY,3,0.02h,Stop Loss,$24.00,$760.50,$115461.50,261,$760.50
2024-12-31,19:21:00,21215.0,SELL,3,0.02h,Stop Loss,$52.50,$813.00,$115514.00,261,$813.00
2024-12-31,19:51:00,21213.25,BUY,3,0.02h,Stop Loss,$57.00,$870.00,$115571.00,261,$870.00
2024-12-31,20:14:00,21215.0,SELL,3,0.02h,Stop Loss,$-9.00,$861.00,$115562.00,261,$861.00
2024-12-31,20:22:00,21271.25,BUY,3,0.02h,Stop Loss,$82.50,$943.50,$115644.50,261,$943.50
2024-12-31,20:45:00,21267.0,SELL,3,0.02h,Stop Loss,$99.00,$1042.50,$115743.50,261,$1042.50
2024-12-31,21:14:00,21241.25,BUY,3,0.02h,Break Even,$-1.50,$1041.00,$115742.00,261,$1041.00
2024-12-31,21:16:00,21231.5,SELL,3,0.02h,Stop Loss,$-9.00,$1032.00,$115733.00,261,$1032.00
2024-12-31,21:19:00,21245.75,BUY,3,0.02h,Stop Loss,$-9.00,$1023.00,$115724.00,261,$1023.00
2024-12-31,21:25:00,21236.25,SELL,3,0.02h,Break Even,$-1.50,$1021.50,$115722.50,261,$1021.50
2024-12-31,21:38:00,21244.0,BUY,3,0.02h,Stop Loss,$6.00,$1027.50,$115728.50,261,$1027.50
2024-12-31,21:53:00,21237.5,SELL,3,0.02h,Break Even,$-1.50,$1026.00,$115727.00,261,$1026.00
2024-12-31,21:54:00,21239.5,BUY,3,0.02h,Break Even,$-1.50,$1024.50,$115725.50,261,$1024.50
2024-12-31,21:56:00,21233.0,SELL,3,0.02h,Stop Loss,$-9.00,$1015.50,$115716.50,261,$1015.50
,,,,,,,,,,,
2025-01-01,23:01:00,21263.0,BUY,3,0.02h,Stop Loss,$40.50,$40.50,$115757.00,262,$40.50
2025-01-01,23:36:00,21280.25,SELL,3,0.02h,Stop Loss,$31.50,$72.00,$115788.50,262,$72.00
,,,,,,,,,,,
2025-01-02,00:40:00,21184.5,BUY,3,0.02h,Break Even,$-1.50,$-1.50,$115787.00,263,$-1.50
2025-01-02,02:05:00,21295.5,SELL,3,0.02h,Stop Loss,$-9.00,$-10.50,$115778.00,263,$-10.50
2025-01-02,02:06:00,21297.5,BUY,3,0.02h,Stop Loss,$42.00,$31.50,$115820.00,263,$31.50
2025-01-02,02:16:00,21288.5,SELL,3,0.02h,Stop Loss,$-9.00,$22.50,$115811.00,263,$22.50
2025-01-02,02:21:00,21299.25,BUY,3,0.02h,Break Even,$-1.50,$21.00,$115809.50,263,$21.00
2025-01-02,03:03:00,21317.25,SELL,3,0.02h,Stop Loss,$3.00,$24.00,$115812.50,263,$24.00
2025-01-02,03:22:00,21320.75,BUY,3,0.02h,Break Even,$-1.50,$22.50,$115811.00,263,$22.50
2025-01-02,03:40:00,21318.0,SELL,3,0.02h,Stop Loss,$7.50,$30.00,$115818.50,263,$30.00
2025-01-02,04:04:00,21313.0,BUY,3,0.02h,Stop Loss,$-9.00,$21.00,$115809.50,263,$21.00
2025-01-02,04:05:00,21308.75,SELL,3,0.02h,Stop Loss,$27.00,$48.00,$115836.50,263,$48.00
2025-01-02,04:12:00,21314.25,BUY,3,0.02h,Stop Loss,$-9.00,$39.00,$115827.50,263,$39.00
2025-01-02,04:14:00,21306.5,SELL,3,0.02h,Stop Loss,$15.00,$54.00,$115842.50,263,$54.00
2025-01-02,04:32:00,21313.0,BUY,3,0.02h,Break Even,$-1.50,$52.50,$115841.00,263,$52.50
2025-01-02,06:29:00,21358.5,SELL,3,0.02h,Break Even,$-1.50,$51.00,$115839.50,263,$51.00
2025-01-02,06:33:00,21383.0,BUY,3,0.02h,Stop Loss,$13.50,$64.50,$115853.00,263,$64.50
2025-01-02,07:12:00,21383.75,SELL,3,0.02h,Stop Loss,$-9.00,$55.50,$115844.00,263,$55.50
2025-01-02,08:02:00,21377.25,BUY,3,0.02h,Stop Loss,$63.00,$118.50,$115907.00,263,$118.50
2025-01-02,08:26:00,21367.0,SELL,3,0.02h,Stop Loss,$16.50,$135.00,$115923.50,263,$135.00
2025-01-02,08:49:00,21366.0,BUY,3,0.02h,Stop Loss,$7.50,$142.50,$115931.00,263,$142.50
2025-01-02,09:37:00,21382.5,SELL,3,0.02h,Stop Loss,$18.00,$160.50,$115949.00,263,$160.50
2025-01-02,09:48:00,21396.5,BUY,3,0.02h,Break Even,$-1.50,$159.00,$115947.50,263,$159.00
2025-01-02,10:08:00,21385.75,SELL,3,0.02h,Stop Loss,$4.50,$163.50,$115952.00,263,$163.50
2025-01-02,10:30:00,21385.75,BUY,3,0.02h,Break Even,$-1.50,$162.00,$115950.50,263,$162.00
2025-01-02,10:52:00,21380.75,SELL,3,0.02h,Stop Loss,$67.50,$229.50,$116018.00,263,$229.50
2025-01-02,11:11:00,21394.5,BUY,3,0.02h,Stop Loss,$-9.00,$220.50,$116009.00,263,$220.50
2025-01-02,11:33:00,21392.75,SELL,3,0.02h,Stop Loss,$18.00,$238.50,$116027.00,263,$238.50
2025-01-02,11:39:00,21404.0,BUY,3,0.02h,Stop Loss,$-9.00,$229.50,$116018.00,263,$229.50
2025-01-02,12:42:00,21458.75,SELL,3,0.02h,Stop Loss,$21.00,$250.50,$116039.00,263,$250.50
2025-01-02,13:35:00,21442.5,BUY,3,0.02h,Break Even,$-1.50,$249.00,$116037.50,263,$249.00
2025-01-02,13:51:00,21420.0,SELL,3,0.02h,Stop Loss,$12.00,$261.00,$116049.50,263,$261.00
2025-01-02,14:52:00,21309.5,BUY,3,0.02h,Stop Loss,$130.50,$391.50,$116180.00,263,$391.50
2025-01-02,15:21:00,21324.0,SELL,3,0.02h,Stop Loss,$192.00,$583.50,$116372.00,263,$583.50
2025-01-02,15:52:00,21312.0,BUY,3,0.02h,Stop Loss,$91.50,$675.00,$116463.50,263,$675.00
2025-01-02,16:03:00,21240.0,SELL,3,0.02h,Stop Loss,$129.00,$804.00,$116592.50,263,$804.00
2025-01-02,16:20:00,21271.0,BUY,3,0.02h,Stop Loss,$15.00,$819.00,$116607.50,263,$819.00
2025-01-02,16:23:00,21231.25,SELL,3,0.02h,Break Even,$-1.50,$817.50,$116606.00,263,$817.50
2025-01-02,16:24:00,21264.25,BUY,3,0.02h,Stop Loss,$202.50,$1020.00,$116808.50,263,$1020.00
2025-01-02,17:08:00,21298.25,SELL,3,0.02h,Stop Loss,$93.00,$1113.00,$116901.50,263,$1113.00
2025-01-02,17:14:00,21339.0,BUY,3,0.02h,Break Even,$-1.50,$1111.50,$116900.00,263,$1111.50
2025-01-02,17:18:00,21303.5,SELL,3,0.02h,Stop Loss,$45.00,$1156.50,$116945.00,263,$1156.50
2025-01-02,18:24:00,21052.25,BUY,3,0.02h,Break Even,$-1.50,$1155.00,$116943.50,263,$1155.00
2025-01-02,18:27:00,21031.5,SELL,3,0.02h,Break Even,$-1.50,$1153.50,$116942.00,263,$1153.50
2025-01-02,18:28:00,21052.25,BUY,3,0.02h,Stop Loss,$12.00,$1165.50,$116954.00,263,$1165.50
2025-01-02,18:32:00,20999.75,SELL,3,0.02h,Stop Loss,$33.00,$1198.50,$116987.00,263,$1198.50
2025-01-02,18:45:00,21064.25,BUY,3,0.02h,Stop Loss,$-9.00,$1189.50,$116978.00,263,$1189.50
2025-01-02,18:51:00,21013.0,SELL,3,0.02h,Stop Loss,$9.00,$1198.50,$116987.00,263,$1198.50
2025-01-02,19:00:00,21048.0,BUY,3,0.02h,Stop Loss,$18.00,$1216.50,$117005.00,263,$1216.50
2025-01-02,19:47:00,21068.75,SELL,3,0.02h,Stop Loss,$6.00,$1222.50,$117011.00,263,$1222.50
2025-01-02,19:49:00,21130.25,BUY,3,0.02h,Stop Loss,$48.00,$1270.50,$117059.00,263,$1270.50
2025-01-02,20:00:00,21063.25,SELL,3,0.02h,Stop Loss,$-9.00,$1261.50,$117050.00,263,$1261.50
2025-01-02,20:05:00,21128.5,BUY,3,0.02h,Stop Loss,$-9.00,$1252.50,$117041.00,263,$1252.50
2025-01-02,20:38:00,21134.5,SELL,3,0.02h,Stop Loss,$13.50,$1266.00,$117054.50,263,$1266.00
2025-01-02,20:48:00,21161.25,BUY,3,0.02h,Stop Loss,$28.50,$1294.50,$117083.00,263,$1294.50
2025-01-02,21:40:00,21187.5,SELL,3,0.02h,Break Even,$-1.50,$1293.00,$117081.50,263,$1293.00
2025-01-02,23:20:00,21179.5,BUY,3,0.02h,Break Even,$-1.50,$1291.50,$117080.00,263,$1291.50
2025-01-02,23:22:00,21172.0,SELL,3,0.02h,Stop Loss,$12.00,$1303.50,$117092.00,263,$1303.50
2025-01-02,23:56:00,21164.0,BUY,3,0.02h,Stop Loss,$-9.00,$1294.50,$117083.00,263,$1294.50
,,,,,,,,,,,
2025-01-03,01:22:00,21232.25,SELL,3,0.02h,Stop Loss,$10.50,$10.50,$117093.50,264,$10.50
2025-01-03,01:55:00,21230.75,BUY,3,0.02h,Break Even,$-1.50,$9.00,$117092.00,264,$9.00
2025-01-03,02:34:00,21231.25,SELL,3,0.02h,Stop Loss,$-9.00,$0.00,$117083.00,264,$0.00
2025-01-03,03:00:00,21242.5,BUY,3,0.02h,Break Even,$-1.50,$-1.50,$117081.50,264,$-1.50
2025-01-03,03:39:00,21250.5,SELL,3,0.02h,Break Even,$-1.50,$-3.00,$117080.00,264,$-3.00
2025-01-03,03:43:00,21252.25,BUY,3,0.02h,Stop Loss,$-9.00,$-12.00,$117071.00,264,$-12.00
2025-01-03,03:46:00,21248.5,SELL,3,0.02h,Stop Loss,$-9.00,$-21.00,$117062.00,264,$-21.00
2025-01-03,03:50:00,21254.75,BUY,3,0.02h,Stop Loss,$-9.00,$-30.00,$117053.00,264,$-30.00
2025-01-03,03:52:00,21249.25,SELL,3,0.02h,Break Even,$-1.50,$-31.50,$117051.50,264,$-31.50
2025-01-03,04:28:00,21243.75,BUY,3,0.02h,Stop Loss,$-9.00,$-40.50,$117042.50,264,$-40.50
2025-01-03,04:32:00,21242.0,SELL,3,0.02h,Stop Loss,$-9.00,$-49.50,$117033.50,264,$-49.50
2025-01-03,04:34:00,21244.25,BUY,3,0.03h,Stop Loss,$-9.00,$-58.50,$117024.50,264,$-58.50
2025-01-03,04:37:00,21239.5,SELL,3,0.02h,Break Even,$-1.50,$-60.00,$117023.00,264,$-60.00
2025-01-03,05:31:00,21223.0,BUY,3,0.02h,Stop Loss,$-9.00,$-69.00,$117014.00,264,$-69.00
2025-01-03,05:54:00,21220.25,SELL,3,0.02h,Break Even,$-1.50,$-70.50,$117012.50,264,$-70.50
2025-01-03,06:02:00,21227.5,BUY,3,0.02h,Stop Loss,$-9.00,$-79.50,$117003.50,264,$-79.50
2025-01-03,06:07:00,21223.25,SELL,3,0.02h,Break Even,$-1.50,$-81.00,$117002.00,264,$-81.00
2025-01-03,06:10:00,21225.75,BUY,3,0.02h,Stop Loss,$-9.00,$-90.00,$116993.00,264,$-90.00
2025-01-03,06:11:00,21223.75,SELL,3,0.02h,Stop Loss,$13.50,$-76.50,$117006.50,264,$-76.50
2025-01-03,06:14:00,21229.0,BUY,3,0.02h,Break Even,$-1.50,$-78.00,$117005.00,264,$-78.00
2025-01-03,06:50:00,21239.75,SELL,3,0.02h,Break Even,$-1.50,$-79.50,$117003.50,264,$-79.50
2025-01-03,06:57:00,21246.5,BUY,3,0.02h,Stop Loss,$-9.00,$-88.50,$116994.50,264,$-88.50
2025-01-03,06:59:00,21237.75,SELL,3,0.02h,Break Even,$-1.50,$-90.00,$116993.00,264,$-90.00
2025-01-03,07:20:00,21239.0,BUY,3,0.02h,Stop Loss,$-9.00,$-99.00,$116984.00,264,$-99.00
2025-01-03,07:22:00,21225.5,SELL,3,0.02h,Stop Loss,$-9.00,$-108.00,$116975.00,264,$-108.00
2025-01-03,07:30:00,21233.75,BUY,3,0.02h,Break Even,$-1.50,$-109.50,$116973.50,264,$-109.50
2025-01-03,07:31:00,21230.0,SELL,3,0.02h,Stop Loss,$-9.00,$-118.50,$116964.50,264,$-118.50
2025-01-03,07:32:00,21235.0,BUY,3,0.02h,Stop Loss,$6.00,$-112.50,$116970.50,264,$-112.50
2025-01-03,08:23:00,21256.5,SELL,3,0.02h,Stop Loss,$13.50,$-99.00,$116984.00,264,$-99.00
2025-01-03,08:57:00,21233.25,BUY,3,0.02h,Stop Loss,$10.50,$-88.50,$116994.50,264,$-88.50
2025-01-03,09:39:00,21267.0,SELL,3,0.02h,Stop Loss,$-9.00,$-97.50,$116985.50,264,$-97.50
2025-01-03,09:41:00,21276.0,BUY,3,0.02h,Break Even,$-1.50,$-99.00,$116984.00,264,$-99.00
2025-01-03,09:53:00,21271.0,SELL,3,0.02h,Stop Loss,$-9.00,$-108.00,$116975.00,264,$-108.00
2025-01-03,09:56:00,21274.5,BUY,3,0.02h,Break Even,$-1.50,$-109.50,$116973.50,264,$-109.50
2025-01-03,10:01:00,21264.25,SELL,3,0.02h,Stop Loss,$19.50,$-90.00,$116993.00,264,$-90.00
2025-01-03,10:48:00,21255.5,BUY,3,0.02h,Stop Loss,$-9.00,$-99.00,$116984.00,264,$-99.00
2025-01-03,10:49:00,21246.75,SELL,3,0.02h,Break Even,$-1.50,$-100.50,$116982.50,264,$-100.50
2025-01-03,11:22:00,21234.0,BUY,3,0.02h,Stop Loss,$18.00,$-82.50,$117000.50,264,$-82.50
2025-01-03,11:52:00,21242.25,SELL,3,0.02h,Stop Loss,$-9.00,$-91.50,$116991.50,264,$-91.50
2025-01-03,11:53:00,21246.0,BUY,3,0.02h,Break Even,$-1.50,$-93.00,$116990.00,264,$-93.00
2025-01-03,12:01:00,21234.75,SELL,3,0.02h,Stop Loss,$-9.00,$-102.00,$116981.00,264,$-102.00
2025-01-03,12:30:00,21235.5,BUY,3,0.02h,Break Even,$-1.50,$-103.50,$116979.50,264,$-103.50
2025-01-03,12:36:00,21222.0,SELL,3,0.02h,Stop Loss,$-9.00,$-112.50,$116970.50,264,$-112.50
2025-01-03,12:39:00,21229.0,BUY,3,0.02h,Break Even,$-1.50,$-114.00,$116969.00,264,$-114.00
2025-01-03,12:45:00,21224.25,SELL,3,0.02h,Break Even,$-1.50,$-115.50,$116967.50,264,$-115.50
2025-01-03,12:48:00,21232.0,BUY,3,0.02h,Stop Loss,$4.50,$-111.00,$116972.00,264,$-111.00
2025-01-03,13:22:00,21249.5,SELL,3,0.02h,Stop Loss,$-9.00,$-120.00,$116963.00,264,$-120.00
2025-01-03,13:25:00,21258.5,BUY,3,0.02h,Stop Loss,$-9.00,$-129.00,$116954.00,264,$-129.00
2025-01-03,13:47:00,21256.5,SELL,3,0.02h,Stop Loss,$48.00,$-81.00,$117002.00,264,$-81.00
2025-01-03,14:09:00,21256.75,BUY,3,0.02h,Stop Loss,$-9.00,$-90.00,$116993.00,264,$-90.00
2025-01-03,15:15:00,21349.0,SELL,3,0.02h,Stop Loss,$69.00,$-21.00,$117062.00,264,$-21.00
2025-01-03,15:36:00,21366.0,BUY,3,0.02h,Stop Loss,$91.50,$70.50,$117153.50,264,$70.50
2025-01-03,16:09:00,21351.0,SELL,3,0.02h,Stop Loss,$15.00,$85.50,$117168.50,264,$85.50
2025-01-03,16:20:00,21380.0,BUY,3,0.02h,Stop Loss,$64.50,$150.00,$117233.00,264,$150.00
2025-01-03,17:14:00,21469.75,SELL,3,0.02h,Stop Loss,$85.50,$235.50,$117318.50,264,$235.50
2025-01-03,17:52:00,21464.75,BUY,3,0.02h,Break Even,$-1.50,$234.00,$117317.00,264,$234.00
2025-01-03,19:52:00,21537.5,SELL,3,0.02h,Stop Loss,$18.00,$252.00,$117335.00,264,$252.00
2025-01-03,20:59:00,21511.0,BUY,3,0.02h,Stop Loss,$76.50,$328.50,$117411.50,264,$328.50
2025-01-03,21:03:00,21493.5,SELL,3,0.02h,Break Even,$-1.50,$327.00,$117410.00,264,$327.00
2025-01-03,21:39:00,21489.75,BUY,3,0.02h,Stop Loss,$-9.00,$318.00,$117401.00,264,$318.00
2025-01-03,21:46:00,21485.25,SELL,3,0.02h,Break Even,$-1.50,$316.50,$117399.50,264,$316.50
2025-01-03,21:59:00,21489.25,BUY,3,50.02h,Stop Loss,$213.00,$529.50,$117612.50,264,$529.50
,,,,,,,,,,,
2025-01-06,00:19:00,21503.75,SELL,3,0.02h,Stop Loss,$4.50,$4.50,$117617.00,265,$4.50
2025-01-06,00:53:00,21497.0,BUY,3,0.02h,Break Even,$-1.50,$3.00,$117615.50,265,$3.00
2025-01-06,01:09:00,21488.5,SELL,3,0.02h,Break Even,$-1.50,$1.50,$117614.00,265,$1.50
2025-01-06,01:13:00,21498.75,BUY,3,0.02h,Stop Loss,$-9.00,$-7.50,$117605.00,265,$-7.50
2025-01-06,01:24:00,21490.75,SELL,3,0.02h,Break Even,$-1.50,$-9.00,$117603.50,265,$-9.00
2025-01-06,01:56:00,21498.0,BUY,3,0.02h,Stop Loss,$-9.00,$-18.00,$117594.50,265,$-18.00
2025-01-06,02:05:00,21487.25,SELL,3,0.02h,Stop Loss,$-9.00,$-27.00,$117585.50,265,$-27.00
2025-01-06,02:11:00,21501.5,BUY,3,0.02h,Break Even,$-1.50,$-28.50,$117584.00,265,$-28.50
2025-01-06,02:34:00,21506.5,SELL,3,0.02h,Break Even,$-1.50,$-30.00,$117582.50,265,$-30.00
2025-01-06,02:39:00,21510.0,BUY,3,0.02h,Break Even,$-1.50,$-31.50,$117581.00,265,$-31.50
2025-01-06,02:43:00,21505.0,SELL,3,0.02h,Stop Loss,$-9.00,$-40.50,$117572.00,265,$-40.50
2025-01-06,02:52:00,21509.0,BUY,3,0.02h,Stop Loss,$-9.00,$-49.50,$117563.00,265,$-49.50
2025-01-06,03:09:00,21503.75,SELL,3,0.02h,Stop Loss,$-9.00,$-58.50,$117554.00,265,$-58.50
2025-01-06,03:14:00,21510.75,BUY,3,0.03h,Break Even,$-1.50,$-60.00,$117552.50,265,$-60.00
2025-01-06,03:26:00,21505.5,SELL,3,0.02h,Stop Loss,$9.00,$-51.00,$117561.50,265,$-51.00
2025-01-06,03:34:00,21511.25,BUY,3,0.02h,Stop Loss,$-9.00,$-60.00,$117552.50,265,$-60.00
2025-01-06,03:48:00,21509.0,SELL,3,0.02h,Stop Loss,$-9.00,$-69.00,$117543.50,265,$-69.00
2025-01-06,04:12:00,21510.75,BUY,3,0.02h,Stop Loss,$-9.00,$-78.00,$117534.50,265,$-78.00
2025-01-06,04:16:00,21506.25,SELL,3,0.02h,Break Even,$-1.50,$-79.50,$117533.00,265,$-79.50
2025-01-06,04:20:00,21512.25,BUY,3,0.02h,Stop Loss,$-9.00,$-88.50,$117524.00,265,$-88.50
2025-01-06,05:48:00,21536.5,SELL,3,0.02h,Stop Loss,$-9.00,$-97.50,$117515.00,265,$-97.50
2025-01-06,06:25:00,21541.5,BUY,3,0.02h,Stop Loss,$-9.00,$-106.50,$117506.00,265,$-106.50
2025-01-06,07:06:00,21546.75,SELL,3,0.03h,Stop Loss,$21.00,$-85.50,$117527.00,265,$-85.50
2025-01-06,07:12:00,21554.0,BUY,3,0.02h,Break Even,$-1.50,$-87.00,$117525.50,265,$-87.00
2025-01-06,07:58:00,21567.5,SELL,3,0.03h,Stop Loss,$12.00,$-75.00,$117537.50,265,$-75.00
2025-01-06,08:05:00,21579.0,BUY,3,0.02h,Stop Loss,$12.00,$-63.00,$117549.50,265,$-63.00
2025-01-06,08:25:00,21575.75,SELL,3,0.02h,Stop Loss,$37.50,$-25.50,$117587.00,265,$-25.50
2025-01-06,08:33:00,21586.0,BUY,3,0.02h,Break Even,$-1.50,$-27.00,$117585.50,265,$-27.00
2025-01-06,09:42:00,21638.0,SELL,3,0.02h,Stop Loss,$-9.00,$-36.00,$117576.50,265,$-36.00
2025-01-06,09:44:00,21644.0,BUY,3,0.02h,Break Even,$-1.50,$-37.50,$117575.00,265,$-37.50
2025-01-06,10:33:00,21673.5,SELL,3,0.02h,Stop Loss,$22.50,$-15.00,$117597.50,265,$-15.00
2025-01-06,10:41:00,21682.75,BUY,3,0.02h,Stop Loss,$-9.00,$-24.00,$117588.50,265,$-24.00
2025-01-06,10:46:00,21672.0,SELL,3,0.02h,Stop Loss,$10.50,$-13.50,$117599.00,265,$-13.50
2025-01-06,11:08:00,21677.25,BUY,3,0.02h,Stop Loss,$-9.00,$-22.50,$117590.00,265,$-22.50
2025-01-06,11:51:00,21711.25,SELL,3,0.02h,Break Even,$-1.50,$-24.00,$117588.50,265,$-24.00
2025-01-06,11:56:00,21727.0,BUY,3,0.02h,Break Even,$-1.50,$-25.50,$117587.00,265,$-25.50
2025-01-06,12:11:00,21718.75,SELL,3,0.02h,Break Even,$-1.50,$-27.00,$117585.50,265,$-27.00
2025-01-06,12:25:00,21730.0,BUY,3,0.02h,Stop Loss,$-9.00,$-36.00,$117576.50,265,$-36.00
2025-01-06,12:35:00,21720.0,SELL,3,0.02h,Stop Loss,$10.50,$-25.50,$117587.00,265,$-25.50
2025-01-06,12:44:00,21729.0,BUY,3,0.02h,Break Even,$-1.50,$-27.00,$117585.50,265,$-27.00
2025-01-06,13:02:00,21729.75,SELL,3,0.02h,Stop Loss,$-9.00,$-36.00,$117576.50,265,$-36.00
2025-01-06,13:29:00,21735.75,BUY,3,0.02h,Stop Loss,$18.00,$-18.00,$117594.50,265,$-18.00
2025-01-06,13:41:00,21724.25,SELL,3,0.02h,Stop Loss,$48.00,$30.00,$117642.50,265,$30.00
2025-01-06,13:50:00,21734.25,BUY,3,0.02h,Stop Loss,$-9.00,$21.00,$117633.50,265,$21.00
2025-01-06,14:08:00,21734.0,SELL,3,0.02h,Break Even,$-1.50,$19.50,$117632.00,265,$19.50
2025-01-06,14:30:00,21732.0,BUY,3,0.02h,Stop Loss,$204.00,$223.50,$117836.00,265,$223.50
2025-01-06,16:19:00,21867.75,SELL,3,0.02h,Stop Loss,$-9.00,$214.50,$117827.00,265,$214.50
2025-01-06,16:21:00,21888.75,BUY,3,0.02h,Break Even,$-1.50,$213.00,$117825.50,265,$213.00
2025-01-06,16:22:00,21874.5,SELL,3,0.02h,Break Even,$-1.50,$211.50,$117824.00,265,$211.50
2025-01-06,16:29:00,21889.25,BUY,3,0.02h,Break Even,$-1.50,$210.00,$117822.50,265,$210.00
2025-01-06,16:36:00,21870.5,SELL,3,0.02h,Stop Loss,$21.00,$231.00,$117843.50,265,$231.00
2025-01-06,18:26:00,21783.5,BUY,3,0.02h,Break Even,$-1.50,$229.50,$117842.00,265,$229.50
2025-01-06,18:33:00,21765.0,SELL,3,0.02h,Stop Loss,$3.00,$232.50,$117845.00,265,$232.50
2025-01-06,19:26:00,21715.25,BUY,3,0.02h,Stop Loss,$28.50,$261.00,$117873.50,265,$261.00
2025-01-06,19:32:00,21702.0,SELL,3,0.02h,Stop Loss,$36.00,$297.00,$117909.50,265,$297.00
2025-01-06,19:49:00,21716.25,BUY,3,0.02h,Break Even,$-1.50,$295.50,$117908.00,265,$295.50
2025-01-06,19:52:00,21699.0,SELL,3,0.02h,Stop Loss,$40.50,$336.00,$117948.50,265,$336.00
2025-01-06,20:14:00,21698.5,BUY,3,0.02h,Stop Loss,$-9.00,$327.00,$117939.50,265,$327.00
2025-01-06,20:47:00,21716.5,SELL,3,0.02h,Stop Loss,$88.50,$415.50,$118028.00,265,$415.50
2025-01-06,20:54:00,21733.5,BUY,3,0.02h,Stop Loss,$42.00,$457.50,$118070.00,265,$457.50
2025-01-06,23:19:00,21781.5,SELL,3,0.02h,Break Even,$-1.50,$456.00,$118068.50,265,$456.00
,,,,,,,,,,,
2025-01-07,00:34:00,21774.25,BUY,3,0.03h,Stop Loss,$10.50,$10.50,$118079.00,266,$10.50
2025-01-07,00:56:00,21755.25,SELL,3,0.02h,Stop Loss,$-9.00,$1.50,$118070.00,266,$1.50
2025-01-07,01:44:00,21756.25,BUY,3,0.02h,Stop Loss,$-9.00,$-7.50,$118061.00,266,$-7.50
2025-01-07,02:35:00,21773.25,SELL,3,0.02h,Stop Loss,$-9.00,$-16.50,$118052.00,266,$-16.50
2025-01-07,03:21:00,21740.5,BUY,3,0.02h,Break Even,$-1.50,$-18.00,$118050.50,266,$-18.00
2025-01-07,03:45:00,21739.5,SELL,3,0.02h,Stop Loss,$4.50,$-13.50,$118055.00,266,$-13.50
2025-01-07,03:56:00,21743.75,BUY,3,0.02h,Stop Loss,$-9.00,$-22.50,$118046.00,266,$-22.50
2025-01-07,04:07:00,21737.75,SELL,3,0.02h,Stop Loss,$-9.00,$-31.50,$118037.00,266,$-31.50
2025-01-07,04:29:00,21740.25,BUY,3,0.02h,Break Even,$-1.50,$-33.00,$118035.50,266,$-33.00
2025-01-07,04:34:00,21732.75,SELL,3,0.02h,Stop Loss,$-9.00,$-42.00,$118026.50,266,$-42.00
2025-01-07,05:51:00,21702.25,BUY,3,0.02h,Stop Loss,$13.50,$-28.50,$118040.00,266,$-28.50
2025-01-07,06:29:00,21704.75,SELL,3,0.02h,Stop Loss,$-9.00,$-37.50,$118031.00,266,$-37.50
2025-01-07,06:31:00,21708.5,BUY,3,0.02h,Break Even,$-1.50,$-39.00,$118029.50,266,$-39.00
2025-01-07,06:32:00,21705.75,SELL,3,0.02h,Break Even,$-1.50,$-40.50,$118028.00,266,$-40.50
2025-01-07,07:04:00,21708.5,BUY,3,0.02h,Break Even,$-1.50,$-42.00,$118026.50,266,$-42.00
2025-01-07,07:30:00,21711.25,SELL,3,0.02h,Stop Loss,$-9.00,$-51.00,$118017.50,266,$-51.00
2025-01-07,07:32:00,21717.25,BUY,3,0.02h,Break Even,$-1.50,$-52.50,$118016.00,266,$-52.50
2025-01-07,07:39:00,21710.75,SELL,3,0.02h,Stop Loss,$-9.00,$-61.50,$118007.00,266,$-61.50
2025-01-07,07:48:00,21719.5,BUY,3,0.02h,Stop Loss,$-9.00,$-70.50,$117998.00,266,$-70.50
2025-01-07,08:15:00,21714.25,SELL,3,0.02h,Stop Loss,$25.50,$-45.00,$118023.50,266,$-45.00
2025-01-07,08:35:00,21729.75,BUY,3,0.02h,Stop Loss,$9.00,$-36.00,$118032.50,266,$-36.00
2025-01-07,09:18:00,21750.5,SELL,3,0.02h,Stop Loss,$3.00,$-33.00,$118035.50,266,$-33.00
2025-01-07,09:37:00,21761.0,BUY,3,0.02h,Stop Loss,$9.00,$-24.00,$118044.50,266,$-24.00
2025-01-07,09:45:00,21753.0,SELL,3,0.02h,Stop Loss,$36.00,$12.00,$118080.50,266,$12.00
2025-01-07,10:11:00,21748.0,BUY,3,0.02h,Stop Loss,$-9.00,$3.00,$118071.50,266,$3.00
2025-01-07,10:49:00,21753.75,SELL,3,0.02h,Stop Loss,$-9.00,$-6.00,$118062.50,266,$-6.00
2025-01-07,10:53:00,21767.0,BUY,3,0.02h,Stop Loss,$-9.00,$-15.00,$118053.50,266,$-15.00
2025-01-07,11:04:00,21752.5,SELL,3,0.02h,Stop Loss,$-9.00,$-24.00,$118044.50,266,$-24.00
2025-01-07,11:25:00,21761.0,BUY,3,0.02h,Stop Loss,$13.50,$-10.50,$118058.00,266,$-10.50
2025-01-07,11:32:00,21747.5,SELL,3,0.02h,Stop Loss,$9.00,$-1.50,$118067.00,266,$-1.50
2025-01-07,12:08:00,21737.75,BUY,3,0.02h,Stop Loss,$-9.00,$-10.50,$118058.00,266,$-10.50
2025-01-07,12:26:00,21731.0,SELL,3,0.02h,Stop Loss,$3.00,$-7.50,$118061.00,266,$-7.50
2025-01-07,12:34:00,21745.25,BUY,3,0.03h,Stop Loss,$3.00,$-4.50,$118064.00,266,$-4.50
2025-01-07,12:59:00,21740.75,SELL,3,0.02h,Break Even,$-1.50,$-6.00,$118062.50,266,$-6.00
2025-01-07,13:16:00,21752.75,BUY,3,0.02h,Break Even,$-1.50,$-7.50,$118061.00,266,$-7.50
2025-01-07,13:27:00,21738.5,SELL,3,0.02h,Stop Loss,$-9.00,$-16.50,$118052.00,266,$-16.50
2025-01-07,13:35:00,21750.75,BUY,3,0.02h,Stop Loss,$-9.00,$-25.50,$118043.00,266,$-25.50
2025-01-07,14:23:00,21776.5,SELL,3,0.02h,Stop Loss,$-9.00,$-34.50,$118034.00,266,$-34.50
2025-01-07,14:28:00,21785.0,BUY,3,0.02h,Stop Loss,$25.50,$-9.00,$118059.50,266,$-9.00
2025-01-07,14:34:00,21764.25,SELL,3,0.02h,Stop Loss,$84.00,$75.00,$118143.50,266,$75.00
2025-01-07,14:49:00,21775.5,BUY,3,0.02h,Break Even,$-1.50,$73.50,$118142.00,266,$73.50
2025-01-07,14:57:00,21734.5,SELL,3,0.02h,Stop Loss,$108.00,$181.50,$118250.00,266,$181.50
2025-01-07,15:29:00,21611.0,BUY,3,0.02h,Stop Loss,$9.00,$190.50,$118259.00,266,$190.50
2025-01-07,15:30:00,21577.5,SELL,3,0.02h,Stop Loss,$174.00,$364.50,$118433.00,266,$364.50
2025-01-07,15:58:00,21521.75,BUY,3,0.02h,Stop Loss,$90.00,$454.50,$118523.00,266,$454.50
2025-01-07,16:36:00,21499.75,SELL,3,0.02h,Stop Loss,$126.00,$580.50,$118649.00,266,$580.50
2025-01-07,16:41:00,21550.75,BUY,3,0.02h,Stop Loss,$3.00,$583.50,$118652.00,266,$583.50
2025-01-07,16:42:00,21516.75,SELL,3,0.02h,Stop Loss,$48.00,$631.50,$118700.00,266,$631.50
2025-01-07,17:20:00,21462.5,BUY,3,0.02h,Break Even,$-1.50,$630.00,$118698.50,266,$630.00
2025-01-07,17:23:00,21437.25,SELL,3,0.02h,Stop Loss,$19.50,$649.50,$118718.00,266,$649.50
2025-01-07,17:35:00,21454.0,BUY,3,0.02h,Break Even,$-1.50,$648.00,$118716.50,266,$648.00
2025-01-07,17:36:00,21442.5,SELL,3,0.02h,Stop Loss,$7.50,$655.50,$118724.00,266,$655.50
2025-01-07,17:37:00,21445.0,BUY,3,0.02h,Stop Loss,$13.50,$669.00,$118737.50,266,$669.00
2025-01-07,17:38:00,21431.5,SELL,3,0.02h,Stop Loss,$60.00,$729.00,$118797.50,266,$729.00
2025-01-07,18:00:00,21445.0,BUY,3,0.02h,Stop Loss,$33.00,$762.00,$118830.50,266,$762.00
2025-01-07,18:37:00,21475.25,SELL,3,0.02h,Stop Loss,$63.00,$825.00,$118893.50,266,$825.00
2025-01-07,19:09:00,21464.5,BUY,3,0.02h,Break Even,$-1.50,$823.50,$118892.00,266,$823.50
2025-01-07,19:20:00,21449.5,SELL,3,0.02h,Stop Loss,$27.00,$850.50,$118919.00,266,$850.50
2025-01-07,20:49:00,21340.0,BUY,3,0.02h,Stop Loss,$52.50,$903.00,$118971.50,266,$903.00
2025-01-07,21:38:00,21379.0,SELL,3,0.02h,Break Even,$-1.50,$901.50,$118970.00,266,$901.50
2025-01-07,21:50:00,21380.5,BUY,3,0.02h,Stop Loss,$-9.00,$892.50,$118961.00,266,$892.50
2025-01-07,21:53:00,21371.75,SELL,3,0.02h,Break Even,$-1.50,$891.00,$118959.50,266,$891.00
2025-01-07,23:22:00,21366.0,BUY,3,0.02h,Stop Loss,$-9.00,$882.00,$118950.50,266,$882.00
,,,,,,,,,,,
2025-01-08,00:54:00,21400.25,SELL,3,0.02h,Stop Loss,$-9.00,$-9.00,$118941.50,267,$-9.00
2025-01-08,01:01:00,21409.5,BUY,3,0.02h,Stop Loss,$13.50,$4.50,$118955.00,267,$4.50
2025-01-08,01:06:00,21398.25,SELL,3,0.02h,Stop Loss,$-9.00,$-4.50,$118946.00,267,$-4.50
2025-01-08,01:13:00,21408.25,BUY,3,0.02h,Stop Loss,$-9.00,$-13.50,$118937.00,267,$-13.50
2025-01-08,01:14:00,21404.5,SELL,3,0.02h,Stop Loss,$-9.00,$-22.50,$118928.00,267,$-22.50
2025-01-08,01:28:00,21408.5,BUY,3,0.02h,Stop Loss,$-9.00,$-31.50,$118919.00,267,$-31.50
2025-01-08,02:23:00,21426.25,SELL,3,0.02h,Break Even,$-1.50,$-33.00,$118917.50,267,$-33.00
2025-01-08,02:53:00,21418.25,BUY,3,0.02h,Break Even,$-1.50,$-34.50,$118916.00,267,$-34.50
2025-01-08,03:04:00,21410.5,SELL,3,0.02h,Break Even,$-1.50,$-36.00,$118914.50,267,$-36.00
2025-01-08,03:47:00,21406.75,BUY,3,0.02h,Break Even,$-1.50,$-37.50,$118913.00,267,$-37.50
2025-01-08,03:54:00,21400.25,SELL,3,0.02h,Stop Loss,$-9.00,$-46.50,$118904.00,267,$-46.50
2025-01-08,03:57:00,21407.0,BUY,3,0.02h,Stop Loss,$-9.00,$-55.50,$118895.00,267,$-55.50
2025-01-08,04:25:00,21409.5,SELL,3,0.02h,Stop Loss,$-9.00,$-64.50,$118886.00,267,$-64.50
2025-01-08,04:32:00,21414.0,BUY,3,0.02h,Break Even,$-1.50,$-66.00,$118884.50,267,$-66.00
2025-01-08,04:42:00,21411.0,SELL,3,0.02h,Break Even,$-1.50,$-67.50,$118883.00,267,$-67.50
2025-01-08,05:14:00,21401.25,BUY,3,0.02h,Stop Loss,$3.00,$-64.50,$118886.00,267,$-64.50
2025-01-08,06:17:00,21426.25,SELL,3,0.02h,Break Even,$-1.50,$-66.00,$118884.50,267,$-66.00
2025-01-08,07:38:00,21383.5,BUY,3,0.02h,Break Even,$-1.50,$-67.50,$118883.00,267,$-67.50
2025-01-08,08:30:00,21393.25,SELL,3,0.02h,Stop Loss,$13.50,$-54.00,$118896.50,267,$-54.00
2025-01-08,08:40:00,21399.0,BUY,3,0.02h,Stop Loss,$49.50,$-4.50,$118946.00,267,$-4.50
2025-01-08,09:29:00,21419.25,SELL,3,0.02h,Break Even,$-1.50,$-6.00,$118944.50,267,$-6.00
2025-01-08,09:58:00,21423.0,BUY,3,0.02h,Stop Loss,$15.00,$9.00,$118959.50,267,$9.00
2025-01-08,10:35:00,21428.5,SELL,3,0.02h,Stop Loss,$-9.00,$0.00,$118950.50,267,$0.00
2025-01-08,10:45:00,21437.0,BUY,3,0.02h,Stop Loss,$-9.00,$-9.00,$118941.50,267,$-9.00
2025-01-08,11:12:00,21435.75,SELL,3,0.02h,Stop Loss,$10.50,$1.50,$118952.00,267,$1.50
2025-01-08,11:53:00,21356.25,BUY,3,0.02h,Stop Loss,$-9.00,$-7.50,$118943.00,267,$-7.50
2025-01-08,12:04:00,21327.5,SELL,3,0.02h,Stop Loss,$54.00,$46.50,$118997.00,267,$46.50
2025-01-08,12:43:00,21281.0,BUY,3,0.02h,Break Even,$-1.50,$45.00,$118995.50,267,$45.00
2025-01-08,12:51:00,21258.25,SELL,3,0.02h,Break Even,$-1.50,$43.50,$118994.00,267,$43.50
2025-01-08,13:01:00,21311.25,BUY,3,0.02h,Stop Loss,$241.50,$285.00,$119235.50,267,$285.00
2025-01-08,13:39:00,21327.75,SELL,3,0.02h,Stop Loss,$18.00,$303.00,$119253.50,267,$303.00
2025-01-08,13:51:00,21349.5,BUY,3,0.02h,Stop Loss,$-9.00,$294.00,$119244.50,267,$294.00
2025-01-08,14:14:00,21349.5,SELL,3,0.02h,Stop Loss,$52.50,$346.50,$119297.00,267,$346.50
2025-01-08,14:29:00,21361.25,BUY,3,0.02h,Stop Loss,$15.00,$361.50,$119312.00,267,$361.50
2025-01-08,14:31:00,21334.0,SELL,3,0.02h,Stop Loss,$82.50,$444.00,$119394.50,267,$444.00
2025-01-08,14:32:00,21363.25,BUY,3,0.02h,Stop Loss,$25.50,$469.50,$119420.00,267,$469.50
2025-01-08,14:34:00,21326.0,SELL,3,0.02h,Stop Loss,$31.50,$501.00,$119451.50,267,$501.00
2025-01-08,14:35:00,21371.75,BUY,3,0.02h,Stop Loss,$57.00,$558.00,$119508.50,267,$558.00
2025-01-08,14:39:00,21324.25,SELL,3,0.02h,Stop Loss,$148.50,$706.50,$119657.00,267,$706.50
2025-01-08,14:50:00,21368.25,BUY,3,0.02h,Stop Loss,$60.00,$766.50,$119717.00,267,$766.50
2025-01-08,14:54:00,21295.5,SELL,3,0.02h,Stop Loss,$42.00,$808.50,$119759.00,267,$808.50
2025-01-08,15:01:00,21369.0,BUY,3,0.02h,Stop Loss,$40.50,$849.00,$119799.50,267,$849.00
2025-01-08,15:11:00,21308.5,SELL,3,0.02h,Stop Loss,$48.00,$897.00,$119847.50,267,$897.00
2025-01-08,15:36:00,21332.75,BUY,3,0.02h,Stop Loss,$114.00,$1011.00,$119961.50,267,$1011.00
2025-01-08,15:48:00,21299.25,SELL,3,0.02h,Break Even,$-1.50,$1009.50,$119960.00,267,$1009.50
2025-01-08,15:50:00,21317.25,BUY,3,0.02h,Stop Loss,$84.00,$1093.50,$120044.00,267,$1093.50
2025-01-08,16:06:00,21315.25,SELL,3,0.02h,Stop Loss,$121.50,$1215.00,$120165.50,267,$1215.00
2025-01-08,16:15:00,21335.5,BUY,3,0.02h,Stop Loss,$10.50,$1225.50,$120176.00,267,$1225.50
2025-01-08,17:02:00,21382.0,SELL,3,0.02h,Stop Loss,$135.00,$1360.50,$120311.00,267,$1360.50
2025-01-08,17:53:00,21261.0,BUY,3,0.02h,Stop Loss,$-9.00,$1351.50,$120302.00,267,$1351.50
2025-01-08,18:48:00,21346.5,SELL,3,0.02h,Break Even,$-1.50,$1350.00,$120300.50,267,$1350.00
2025-01-08,19:09:00,21380.75,BUY,3,0.02h,Stop Loss,$57.00,$1407.00,$120357.50,267,$1407.00
2025-01-08,19:37:00,21346.0,SELL,3,0.02h,Break Even,$-1.50,$1405.50,$120356.00,267,$1405.50
2025-01-08,20:05:00,21353.0,BUY,3,0.02h,Break Even,$-1.50,$1404.00,$120354.50,267,$1404.00
2025-01-08,20:07:00,21337.25,SELL,3,0.02h,Stop Loss,$42.00,$1446.00,$120396.50,267,$1446.00
2025-01-08,20:21:00,21343.25,BUY,3,0.02h,Break Even,$-1.50,$1444.50,$120395.00,267,$1444.50
2025-01-08,20:37:00,21332.75,SELL,3,0.02h,Stop Loss,$21.00,$1465.50,$120416.00,267,$1465.50
2025-01-08,20:46:00,21346.25,BUY,3,0.02h,Break Even,$-1.50,$1464.00,$120414.50,267,$1464.00
2025-01-08,21:14:00,21347.0,SELL,3,0.02h,Stop Loss,$-9.00,$1455.00,$120405.50,267,$1455.00
2025-01-08,21:28:00,21360.75,BUY,3,0.02h,Break Even,$-1.50,$1453.50,$120404.00,267,$1453.50
2025-01-08,21:35:00,21336.5,SELL,3,0.02h,Stop Loss,$144.00,$1597.50,$120548.00,267,$1597.50
2025-01-08,23:12:00,21338.5,BUY,3,0.02h,Stop Loss,$9.00,$1606.50,$120557.00,267,$1606.50
2025-01-08,23:45:00,21336.0,SELL,3,0.02h,Break Even,$-1.50,$1605.00,$120555.50,267,$1605.00
,,,,,,,,,,,
2025-01-09,00:52:00,21299.5,BUY,3,0.02h,Break Even,$-1.50,$-1.50,$120554.00,268,$-1.50
2025-01-09,01:49:00,21312.5,SELL,3,0.02h,Stop Loss,$-9.00,$-10.50,$120545.00,268,$-10.50
2025-01-09,01:56:00,21319.0,BUY,3,0.02h,Break Even,$-1.50,$-12.00,$120543.50,268,$-12.00
2025-01-09,01:57:00,21317.25,SELL,3,0.02h,Stop Loss,$-9.00,$-21.00,$120534.50,268,$-21.00
2025-01-09,02:04:00,21320.0,BUY,3,0.02h,Stop Loss,$-9.00,$-30.00,$120525.50,268,$-30.00
2025-01-09,03:08:00,21337.5,SELL,3,0.03h,Stop Loss,$-9.00,$-39.00,$120516.50,268,$-39.00
2025-01-09,03:37:00,21342.5,BUY,3,0.02h,Stop Loss,$-9.00,$-48.00,$120507.50,268,$-48.00
2025-01-09,03:47:00,21333.5,SELL,3,0.03h,Stop Loss,$12.00,$-36.00,$120519.50,268,$-36.00
2025-01-09,04:39:00,21304.25,BUY,3,0.02h,Break Even,$-1.50,$-37.50,$120518.00,268,$-37.50
2025-01-09,05:28:00,21309.5,SELL,3,0.02h,Stop Loss,$-9.00,$-46.50,$120509.00,268,$-46.50
2025-01-09,05:46:00,21320.75,BUY,3,0.02h,Stop Loss,$-9.00,$-55.50,$120500.00,268,$-55.50
2025-01-09,06:16:00,21320.0,SELL,3,0.02h,Stop Loss,$-9.00,$-64.50,$120491.00,268,$-64.50
2025-01-09,06:32:00,21322.5,BUY,3,0.02h,Break Even,$-1.50,$-66.00,$120489.50,268,$-66.00
2025-01-09,06:39:00,21313.0,SELL,3,0.02h,Break Even,$-1.50,$-67.50,$120488.00,268,$-67.50
2025-01-09,06:56:00,21317.75,BUY,3,0.03h,Stop Loss,$-9.00,$-76.50,$120479.00,268,$-76.50
2025-01-09,07:01:00,21308.5,SELL,3,0.02h,Break Even,$-1.50,$-78.00,$120477.50,268,$-78.00
2025-01-09,08:18:00,21253.75,BUY,3,0.02h,Stop Loss,$28.50,$-49.50,$120506.00,268,$-49.50
2025-01-09,09:04:00,21285.75,SELL,3,0.02h,Stop Loss,$7.50,$-42.00,$120513.50,268,$-42.00
2025-01-09,09:18:00,21293.75,BUY,3,0.02h,Stop Loss,$36.00,$-6.00,$120549.50,268,$-6.00
2025-01-09,09:25:00,21284.25,SELL,3,0.02h,Stop Loss,$7.50,$1.50,$120557.00,268,$1.50
2025-01-09,09:28:00,21290.25,BUY,3,0.02h,Break Even,$-1.50,$0.00,$120555.50,268,$0.00
2025-01-09,09:57:00,21297.25,SELL,3,0.02h,Stop Loss,$-9.00,$-9.00,$120546.50,268,$-9.00
2025-01-09,09:58:00,21306.5,BUY,3,0.02h,Stop Loss,$15.00,$6.00,$120561.50,268,$6.00
2025-01-09,10:47:00,21316.25,SELL,3,0.02h,Break Even,$-1.50,$4.50,$120560.00,268,$4.50
2025-01-09,10:51:00,21325.5,BUY,3,0.02h,Break Even,$-1.50,$3.00,$120558.50,268,$3.00
2025-01-09,11:04:00,21305.5,SELL,3,0.02h,Stop Loss,$4.50,$7.50,$120563.00,268,$7.50
2025-01-09,11:25:00,21304.75,BUY,3,0.02h,Stop Loss,$4.50,$12.00,$120567.50,268,$12.00
2025-01-09,11:33:00,21297.0,SELL,3,0.02h,Break Even,$-1.50,$10.50,$120566.00,268,$10.50
2025-01-09,11:37:00,21308.25,BUY,3,0.02h,Break Even,$-1.50,$9.00,$120564.50,268,$9.00
2025-01-09,11:38:00,21304.75,SELL,3,0.02h,Stop Loss,$52.50,$61.50,$120617.00,268,$61.50
2025-01-09,11:51:00,21306.25,BUY,3,0.02h,Stop Loss,$-9.00,$52.50,$120608.00,268,$52.50
2025-01-09,12:21:00,21296.0,SELL,3,0.02h,Stop Loss,$4.50,$57.00,$120612.50,268,$57.00
2025-01-09,12:38:00,21303.75,BUY,3,0.02h,Stop Loss,$-9.00,$48.00,$120603.50,268,$48.00
2025-01-09,12:40:00,21293.5,SELL,3,0.02h,Break Even,$-1.50,$46.50,$120602.00,268,$46.50
2025-01-09,12:50:00,21305.25,BUY,3,0.02h,Stop Loss,$6.00,$52.50,$120608.00,268,$52.50
2025-01-09,13:25:00,21309.0,SELL,3,0.02h,Break Even,$-1.50,$51.00,$120606.50,268,$51.00
2025-01-09,13:28:00,21322.0,BUY,3,0.02h,Break Even,$-1.50,$49.50,$120605.00,268,$49.50
2025-01-09,13:31:00,21311.5,SELL,3,0.02h,Break Even,$-1.50,$48.00,$120603.50,268,$48.00
2025-01-09,13:36:00,21327.5,BUY,3,0.02h,Stop Loss,$12.00,$60.00,$120615.50,268,$60.00
2025-01-09,13:50:00,21319.5,SELL,3,0.02h,Stop Loss,$-9.00,$51.00,$120606.50,268,$51.00
2025-01-09,14:22:00,21294.5,BUY,3,0.02h,Break Even,$-1.50,$49.50,$120605.00,268,$49.50
2025-01-09,23:06:00,21277.5,SELL,3,0.02h,Stop Loss,$34.50,$84.00,$120639.50,268,$84.00
,,,,,,,,,,,
2025-01-10,00:49:00,21209.25,BUY,3,0.02h,Stop Loss,$-9.00,$-9.00,$120630.50,269,$-9.00
2025-01-10,01:00:00,21196.0,SELL,3,0.02h,Break Even,$-1.50,$-10.50,$120629.00,269,$-10.50
2025-01-10,01:02:00,21212.25,BUY,3,0.02h,Stop Loss,$21.00,$10.50,$120650.00,269,$10.50
2025-01-10,02:06:00,21243.75,SELL,3,0.02h,Break Even,$-1.50,$9.00,$120648.50,269,$9.00
2025-01-10,02:12:00,21251.5,BUY,3,0.02h,Break Even,$-1.50,$7.50,$120647.00,269,$7.50
2025-01-10,04:07:00,21295.25,SELL,3,0.02h,Stop Loss,$3.00,$10.50,$120650.00,269,$10.50
2025-01-10,04:40:00,21289.5,BUY,3,0.02h,Break Even,$-1.50,$9.00,$120648.50,269,$9.00
2025-01-10,05:42:00,21307.5,SELL,3,0.02h,Break Even,$-1.50,$7.50,$120647.00,269,$7.50
2025-01-10,07:15:00,21265.25,BUY,3,0.02h,Stop Loss,$27.00,$34.50,$120674.00,269,$34.50
2025-01-10,07:50:00,21276.25,SELL,3,0.02h,Stop Loss,$9.00,$43.50,$120683.00,269,$43.50
2025-01-10,08:13:00,21278.5,BUY,3,0.02h,Stop Loss,$27.00,$70.50,$120710.00,269,$70.50
2025-01-10,08:48:00,21285.5,SELL,3,0.02h,Stop Loss,$-9.00,$61.50,$120701.00,269,$61.50
2025-01-10,09:17:00,21278.75,BUY,3,0.02h,Break Even,$-1.50,$60.00,$120699.50,269,$60.00
2025-01-10,09:47:00,21275.0,SELL,3,0.02h,Stop Loss,$34.50,$94.50,$120734.00,269,$94.50
2025-01-10,10:01:00,21283.25,BUY,3,0.02h,Stop Loss,$4.50,$99.00,$120738.50,269,$99.00
2025-01-10,10:09:00,21276.0,SELL,3,0.02h,Break Even,$-1.50,$97.50,$120737.00,269,$97.50
2025-01-10,10:13:00,21281.5,BUY,3,0.02h,Stop Loss,$6.00,$103.50,$120743.00,269,$103.50
2025-01-10,11:32:00,21339.0,SELL,3,0.02h,Stop Loss,$6.00,$109.50,$120749.00,269,$109.50
2025-01-10,11:40:00,21352.5,BUY,3,0.02h,Break Even,$-1.50,$108.00,$120747.50,269,$108.00
2025-01-10,11:44:00,21338.0,SELL,3,0.02h,Break Even,$-1.50,$106.50,$120746.00,269,$106.50
2025-01-10,12:34:00,21299.75,BUY,3,0.02h,Stop Loss,$10.50,$117.00,$120756.50,269,$117.00
2025-01-10,13:12:00,21300.0,SELL,3,0.02h,Stop Loss,$19.50,$136.50,$120776.00,269,$136.50
2025-01-10,14:06:00,21146.25,BUY,3,0.02h,Stop Loss,$103.50,$240.00,$120879.50,269,$240.00
2025-01-10,14:32:00,21141.75,SELL,3,0.02h,Stop Loss,$45.00,$285.00,$120924.50,269,$285.00
2025-01-10,15:24:00,20987.0,BUY,3,0.02h,Stop Loss,$79.50,$364.50,$121004.00,269,$364.50
2025-01-10,15:56:00,21014.0,SELL,3,0.02h,Stop Loss,$88.50,$453.00,$121092.50,269,$453.00
2025-01-10,16:45:00,20968.75,BUY,3,0.02h,Stop Loss,$61.50,$514.50,$121154.00,269,$514.50
2025-01-10,16:57:00,20924.25,SELL,3,0.02h,Stop Loss,$27.00,$541.50,$121181.00,269,$541.50
2025-01-10,17:20:00,20929.25,BUY,3,0.02h,Stop Loss,$25.50,$567.00,$121206.50,269,$567.00
2025-01-10,17:24:00,20903.5,SELL,3,0.02h,Break Even,$-1.50,$565.50,$121205.00,269,$565.50
2025-01-10,17:25:00,20918.5,BUY,3,0.02h,Stop Loss,$87.00,$652.50,$121292.00,269,$652.50
2025-01-10,19:06:00,21091.75,SELL,3,0.02h,Stop Loss,$30.00,$682.50,$121322.00,269,$682.50
2025-01-10,19:30:00,21096.0,BUY,3,0.02h,Break Even,$-1.50,$681.00,$121320.50,269,$681.00
2025-01-10,19:31:00,21078.5,SELL,3,0.02h,Stop Loss,$81.00,$762.00,$121401.50,269,$762.00
2025-01-10,19:56:00,21092.25,BUY,3,0.02h,Break Even,$-1.50,$760.50,$121400.00,269,$760.50
2025-01-10,20:12:00,21070.5,SELL,3,0.02h,Stop Loss,$79.50,$840.00,$121479.50,269,$840.00
2025-01-10,20:53:00,21029.75,BUY,3,0.02h,Break Even,$-1.50,$838.50,$121478.00,269,$838.50
2025-01-10,21:07:00,21007.75,SELL,3,0.02h,Stop Loss,$16.50,$855.00,$121494.50,269,$855.00
,,,,,,,,,,,
2025-01-13,00:01:00,21014.25,BUY,3,0.02h,Stop Loss,$3.00,$3.00,$121497.50,270,$3.00
2025-01-13,00:31:00,21018.25,SELL,3,0.02h,Break Even,$-1.50,$1.50,$121496.00,270,$1.50
2025-01-13,02:08:00,20930.5,BUY,3,0.02h,Break Even,$-1.50,$0.00,$121494.50,270,$0.00
2025-01-13,02:13:00,20920.0,SELL,3,0.02h,Stop Loss,$10.50,$10.50,$121505.00,270,$10.50
2025-01-13,02:18:00,20929.0,BUY,3,0.02h,Break Even,$-1.50,$9.00,$121503.50,270,$9.00
2025-01-13,02:44:00,20927.25,SELL,3,0.02h,Break Even,$-1.50,$7.50,$121502.00,270,$7.50
2025-01-13,03:03:00,20932.0,BUY,3,0.02h,Stop Loss,$7.50,$15.00,$121509.50,270,$15.00
2025-01-13,03:11:00,20917.25,SELL,3,0.02h,Break Even,$-1.50,$13.50,$121508.00,270,$13.50
2025-01-13,03:50:00,20888.25,BUY,3,0.02h,Stop Loss,$-9.00,$4.50,$121499.00,270,$4.50
2025-01-13,03:55:00,20877.5,SELL,3,0.02h,Stop Loss,$46.50,$51.00,$121545.50,270,$51.00
2025-01-13,04:02:00,20888.5,BUY,3,0.02h,Stop Loss,$24.00,$75.00,$121569.50,270,$75.00
2025-01-13,04:19:00,20884.5,SELL,3,0.02h,Stop Loss,$-9.00,$66.00,$121560.50,270,$66.00
2025-01-13,04:20:00,20890.5,BUY,3,0.02h,Stop Loss,$-9.00,$57.00,$121551.50,270,$57.00
2025-01-13,04:21:00,20886.0,SELL,3,0.02h,Stop Loss,$-9.00,$48.00,$121542.50,270,$48.00
2025-01-13,04:24:00,20890.25,BUY,3,0.02h,Stop Loss,$-9.00,$39.00,$121533.50,270,$39.00
2025-01-13,04:25:00,20884.5,SELL,3,0.02h,Stop Loss,$-9.00,$30.00,$121524.50,270,$30.00
2025-01-13,04:28:00,20890.25,BUY,3,0.02h,Break Even,$-1.50,$28.50,$121523.00,270,$28.50
2025-01-13,04:32:00,20883.75,SELL,3,0.02h,Stop Loss,$12.00,$40.50,$121535.00,270,$40.50
2025-01-13,04:46:00,20887.75,BUY,3,0.02h,Break Even,$-1.50,$39.00,$121533.50,270,$39.00
2025-01-13,05:14:00,20890.25,SELL,3,0.02h,Break Even,$-1.50,$37.50,$121532.00,270,$37.50
2025-01-13,05:51:00,20886.0,BUY,3,0.02h,Stop Loss,$7.50,$45.00,$121539.50,270,$45.00
2025-01-13,06:37:00,20904.0,SELL,3,0.02h,Stop Loss,$10.50,$55.50,$121550.00,270,$55.50
2025-01-13,06:54:00,20912.75,BUY,3,0.02h,Stop Loss,$-9.00,$46.50,$121541.00,270,$46.50
2025-01-13,06:57:00,20905.5,SELL,3,0.02h,Stop Loss,$-9.00,$37.50,$121532.00,270,$37.50
2025-01-13,07:03:00,20912.5,BUY,3,0.02h,Break Even,$-1.50,$36.00,$121530.50,270,$36.00
2025-01-13,07:06:00,20900.5,SELL,3,0.02h,Stop Loss,$18.00,$54.00,$121548.50,270,$54.00
2025-01-13,07:51:00,20887.25,BUY,3,0.02h,Stop Loss,$51.00,$105.00,$121599.50,270,$105.00
2025-01-13,07:59:00,20873.5,SELL,3,0.02h,Break Even,$-1.50,$103.50,$121598.00,270,$103.50
2025-01-13,08:02:00,20894.5,BUY,3,0.02h,Stop Loss,$-9.00,$94.50,$121589.00,270,$94.50
2025-01-13,08:17:00,20883.75,SELL,3,0.02h,Stop Loss,$54.00,$148.50,$121643.00,270,$148.50
2025-01-13,09:40:00,20735.0,BUY,3,0.02h,Stop Loss,$31.50,$180.00,$121674.50,270,$180.00
2025-01-13,09:42:00,20720.75,SELL,3,0.02h,Stop Loss,$16.50,$196.50,$121691.00,270,$196.50
2025-01-13,10:01:00,20722.75,BUY,3,0.02h,Stop Loss,$24.00,$220.50,$121715.00,270,$220.50
2025-01-13,10:08:00,20711.25,SELL,3,0.02h,Stop Loss,$-9.00,$211.50,$121706.00,270,$211.50
2025-01-13,10:13:00,20727.75,BUY,3,0.02h,Stop Loss,$25.50,$237.00,$121731.50,270,$237.00
2025-01-13,10:57:00,20742.0,SELL,3,0.02h,Stop Loss,$13.50,$250.50,$121745.00,270,$250.50
2025-01-13,11:05:00,20765.5,BUY,3,0.02h,Stop Loss,$36.00,$286.50,$121781.00,270,$286.50
2025-01-13,11:12:00,20747.0,SELL,3,0.02h,Stop Loss,$21.00,$307.50,$121802.00,270,$307.50
2025-01-13,11:17:00,20763.0,BUY,3,0.02h,Stop Loss,$-9.00,$298.50,$121793.00,270,$298.50
2025-01-13,11:32:00,20752.0,SELL,3,0.02h,Break Even,$-1.50,$297.00,$121791.50,270,$297.00
2025-01-13,11:34:00,20758.75,BUY,3,0.02h,Stop Loss,$13.50,$310.50,$121805.00,270,$310.50
2025-01-13,12:04:00,20749.75,SELL,3,0.02h,Stop Loss,$33.00,$343.50,$121838.00,270,$343.50
2025-01-13,12:21:00,20775.75,BUY,3,0.02h,Stop Loss,$6.00,$349.50,$121844.00,270,$349.50
2025-01-13,13:04:00,20813.75,SELL,3,0.02h,Stop Loss,$15.00,$364.50,$121859.00,270,$364.50
2025-01-13,13:19:00,20820.5,BUY,3,0.02h,Break Even,$-1.50,$363.00,$121857.50,270,$363.00
2025-01-13,13:51:00,20818.25,SELL,3,0.02h,Break Even,$-1.50,$361.50,$121856.00,270,$361.50
2025-01-13,14:52:00,20774.25,BUY,3,0.02h,Stop Loss,$9.00,$370.50,$121865.00,270,$370.50
2025-01-13,15:15:00,20772.75,SELL,3,0.02h,Stop Loss,$85.50,$456.00,$121950.50,270,$456.00
2025-01-13,15:38:00,20800.25,BUY,3,0.02h,Stop Loss,$81.00,$537.00,$122031.50,270,$537.00
2025-01-13,15:59:00,20799.5,SELL,3,0.02h,Stop Loss,$10.50,$547.50,$122042.00,270,$547.50
2025-01-13,16:36:00,20802.5,BUY,3,0.02h,Stop Loss,$16.50,$564.00,$122058.50,270,$564.00
2025-01-13,16:56:00,20757.25,SELL,3,0.02h,Stop Loss,$48.00,$612.00,$122106.50,270,$612.00
2025-01-13,17:11:00,20788.0,BUY,3,0.02h,Stop Loss,$57.00,$669.00,$122163.50,270,$669.00
2025-01-13,17:44:00,20823.5,SELL,3,0.02h,Stop Loss,$15.00,$684.00,$122178.50,270,$684.00
2025-01-13,17:48:00,20842.5,BUY,3,0.02h,Stop Loss,$27.00,$711.00,$122205.50,270,$711.00
2025-01-13,18:21:00,20866.0,SELL,3,0.02h,Stop Loss,$15.00,$726.00,$122220.50,270,$726.00
2025-01-13,18:30:00,20892.25,BUY,3,0.02h,Stop Loss,$73.50,$799.50,$122294.00,270,$799.50
2025-01-13,18:45:00,20868.25,SELL,3,0.02h,Break Even,$-1.50,$798.00,$122292.50,270,$798.00
2025-01-13,18:48:00,20895.0,BUY,3,0.02h,Stop Loss,$6.00,$804.00,$122298.50,270,$804.00
2025-01-13,18:57:00,20882.25,SELL,3,0.02h,Stop Loss,$-9.00,$795.00,$122289.50,270,$795.00
2025-01-13,19:00:00,20892.25,BUY,3,0.02h,Stop Loss,$6.00,$801.00,$122295.50,270,$801.00
2025-01-13,19:04:00,20877.25,SELL,3,0.02h,Break Even,$-1.50,$799.50,$122294.00,270,$799.50
2025-01-13,19:29:00,20886.25,BUY,3,0.02h,Stop Loss,$31.50,$831.00,$122325.50,270,$831.00
2025-01-13,19:52:00,20881.25,SELL,3,0.02h,Stop Loss,$52.50,$883.50,$122378.00,270,$883.50
2025-01-13,19:57:00,20909.75,BUY,3,0.02h,Stop Loss,$-9.00,$874.50,$122369.00,270,$874.50
2025-01-13,20:05:00,20888.25,SELL,3,0.02h,Break Even,$-1.50,$873.00,$122367.50,270,$873.00
2025-01-13,20:06:00,20898.75,BUY,3,0.02h,Stop Loss,$12.00,$885.00,$122379.50,270,$885.00
2025-01-13,20:15:00,20893.0,SELL,3,0.02h,Stop Loss,$10.50,$895.50,$122390.00,270,$895.50
2025-01-13,20:16:00,20905.0,BUY,3,0.02h,Stop Loss,$7.50,$903.00,$122397.50,270,$903.00
2025-01-13,20:25:00,20879.5,SELL,3,0.02h,Stop Loss,$6.00,$909.00,$122403.50,270,$909.00
2025-01-13,20:38:00,20902.5,BUY,3,0.02h,Stop Loss,$4.50,$913.50,$122408.00,270,$913.50
2025-01-13,20:40:00,20883.5,SELL,3,0.02h,Stop Loss,$-9.00,$904.50,$122399.00,270,$904.50
2025-01-13,20:43:00,20897.75,BUY,3,0.02h,Break Even,$-1.50,$903.00,$122397.50,270,$903.00
2025-01-13,21:56:00,20979.25,SELL,3,0.02h,Stop Loss,$-9.00,$894.00,$122388.50,270,$894.00
2025-01-13,21:57:00,20983.0,BUY,3,0.02h,Break Even,$-1.50,$892.50,$122387.00,270,$892.50
2025-01-13,23:55:00,21056.5,SELL,3,0.02h,Stop Loss,$3.00,$895.50,$122390.00,270,$895.50
,,,,,,,,,,,
2025-01-14,00:22:00,21045.75,BUY,3,0.02h,Stop Loss,$-9.00,$-9.00,$122381.00,271,$-9.00
2025-01-14,00:23:00,21040.5,SELL,3,0.02h,Stop Loss,$12.00,$3.00,$122393.00,271,$3.00
2025-01-14,00:48:00,21040.25,BUY,3,0.02h,Stop Loss,$16.50,$19.50,$122409.50,271,$19.50
2025-01-14,01:03:00,21036.25,SELL,3,0.02h,Stop Loss,$10.50,$30.00,$122420.00,271,$30.00
2025-01-14,02:26:00,21017.75,BUY,3,0.02h,Stop Loss,$10.50,$40.50,$122430.50,271,$40.50
2025-01-14,03:23:00,21036.5,SELL,3,0.02h,Break Even,$-1.50,$39.00,$122429.00,271,$39.00
2025-01-14,03:35:00,21038.25,BUY,3,0.02h,Stop Loss,$-9.00,$30.00,$122420.00,271,$30.00
2025-01-14,03:36:00,21033.75,SELL,3,0.02h,Stop Loss,$4.50,$34.50,$122424.50,271,$34.50
2025-01-14,04:24:00,21031.25,BUY,3,0.02h,Break Even,$-1.50,$33.00,$122423.00,271,$33.00
2025-01-14,05:06:00,21038.0,SELL,3,0.02h,Stop Loss,$-9.00,$24.00,$122414.00,271,$24.00
2025-01-14,05:08:00,21045.25,BUY,3,0.02h,Break Even,$-1.50,$22.50,$122412.50,271,$22.50
2025-01-14,05:17:00,21040.25,SELL,3,0.02h,Break Even,$-1.50,$21.00,$122411.00,271,$21.00
2025-01-14,05:37:00,21046.75,BUY,3,0.02h,Stop Loss,$-9.00,$12.00,$122402.00,271,$12.00
2025-01-14,06:31:00,21054.5,SELL,3,0.02h,Break Even,$-1.50,$10.50,$122400.50,271,$10.50
2025-01-14,07:19:00,21047.75,BUY,3,0.02h,Break Even,$-1.50,$9.00,$122399.00,271,$9.00
2025-01-14,08:12:00,21058.25,SELL,3,0.02h,Break Even,$-1.50,$7.50,$122397.50,271,$7.50
2025-01-14,08:13:00,21064.0,BUY,3,0.02h,Break Even,$-1.50,$6.00,$122396.00,271,$6.00
2025-01-14,09:08:00,21113.0,SELL,3,0.02h,Stop Loss,$6.00,$12.00,$122402.00,271,$12.00
2025-01-14,09:38:00,21107.0,BUY,3,0.02h,Stop Loss,$-9.00,$3.00,$122393.00,271,$3.00
2025-01-14,09:53:00,21101.5,SELL,3,0.02h,Break Even,$-1.50,$1.50,$122391.50,271,$1.50
2025-01-14,10:07:00,21105.75,BUY,3,0.02h,Break Even,$-1.50,$0.00,$122390.00,271,$0.00
2025-01-14,10:12:00,21097.25,SELL,3,0.02h,Stop Loss,$4.50,$4.50,$122394.50,271,$4.50
2025-01-14,10:36:00,21095.0,BUY,3,0.02h,Stop Loss,$-9.00,$-4.50,$122385.50,271,$-4.50
2025-01-14,10:42:00,21082.5,SELL,3,0.02h,Stop Loss,$-9.00,$-13.50,$122376.50,271,$-13.50
2025-01-14,10:46:00,21094.75,BUY,3,0.02h,Stop Loss,$4.50,$-9.00,$122381.00,271,$-9.00
2025-01-14,11:02:00,21090.25,SELL,3,0.02h,Break Even,$-1.50,$-10.50,$122379.50,271,$-10.50
2025-01-14,12:05:00,21054.25,BUY,3,0.02h,Stop Loss,$4.50,$-6.00,$122384.00,271,$-6.00
2025-01-14,12:07:00,21043.0,SELL,3,0.02h,Stop Loss,$154.50,$148.50,$122538.50,271,$148.50
2025-01-14,12:35:00,21021.0,BUY,3,0.02h,Stop Loss,$3.00,$151.50,$122541.50,271,$151.50
2025-01-14,12:52:00,21009.0,SELL,3,0.02h,Stop Loss,$45.00,$196.50,$122586.50,271,$196.50
2025-01-14,13:31:00,21116.75,BUY,3,0.02h,Stop Loss,$112.50,$309.00,$122699.00,271,$309.00
2025-01-14,14:00:00,21057.0,SELL,3,0.02h,Stop Loss,$9.00,$318.00,$122708.00,271,$318.00
2025-01-14,14:19:00,21071.0,BUY,3,0.02h,Stop Loss,$34.50,$352.50,$122742.50,271,$352.50
2025-01-14,14:32:00,21023.25,SELL,3,0.02h,Stop Loss,$10.50,$363.00,$122753.00,271,$363.00
2025-01-14,14:36:00,21087.25,BUY,3,0.02h,Stop Loss,$64.50,$427.50,$122817.50,271,$427.50
2025-01-14,14:50:00,21075.25,SELL,3,0.02h,Stop Loss,$142.50,$570.00,$122960.00,271,$570.00
2025-01-14,15:10:00,21065.75,BUY,3,0.02h,Break Even,$-1.50,$568.50,$122958.50,271,$568.50
2025-01-14,15:25:00,21040.5,SELL,3,0.02h,Stop Loss,$-9.00,$559.50,$122949.50,271,$559.50
2025-01-14,16:26:00,20933.0,BUY,3,0.02h,Stop Loss,$60.00,$619.50,$123009.50,271,$619.50
2025-01-14,16:33:00,20916.75,SELL,3,0.02h,Stop Loss,$13.50,$633.00,$123023.00,271,$633.00
2025-01-14,17:12:00,20869.0,BUY,3,0.02h,Break Even,$-1.50,$631.50,$123021.50,271,$631.50
2025-01-14,17:23:00,20833.25,SELL,3,0.02h,Break Even,$-1.50,$630.00,$123020.00,271,$630.00
2025-01-14,17:44:00,20871.25,BUY,3,0.02h,Stop Loss,$7.50,$637.50,$123027.50,271,$637.50
2025-01-14,19:30:00,20981.75,SELL,3,0.02h,Stop Loss,$18.00,$655.50,$123045.50,271,$655.50
2025-01-14,19:37:00,21001.75,BUY,3,0.02h,Stop Loss,$-9.00,$646.50,$123036.50,271,$646.50
2025-01-14,19:45:00,20983.0,SELL,3,0.02h,Stop Loss,$28.50,$675.00,$123065.00,271,$675.00
2025-01-14,20:30:00,20834.75,BUY,3,0.02h,Stop Loss,$100.50,$775.50,$123165.50,271,$775.50
2025-01-14,20:40:00,20801.75,SELL,3,0.02h,Break Even,$-1.50,$774.00,$123164.00,271,$774.00
2025-01-14,20:46:00,20836.75,BUY,3,0.02h,Stop Loss,$70.50,$844.50,$123234.50,271,$844.50
2025-01-14,21:49:00,20973.5,SELL,3,0.02h,Break Even,$-1.50,$843.00,$123233.00,271,$843.00
2025-01-14,23:58:00,20947.75,BUY,3,0.02h,Stop Loss,$-9.00,$834.00,$123224.00,271,$834.00
,,,,,,,,,,,
2025-01-15,00:04:00,20945.0,SELL,3,0.02h,Break Even,$-1.50,$-1.50,$123222.50,272,$-1.50
2025-01-15,00:21:00,20950.0,BUY,3,0.02h,Stop Loss,$-9.00,$-10.50,$123213.50,272,$-10.50
2025-01-15,00:31:00,20942.25,SELL,3,0.02h,Stop Loss,$-9.00,$-19.50,$123204.50,272,$-19.50
2025-01-15,00:38:00,20947.0,BUY,3,0.02h,Stop Loss,$-9.00,$-28.50,$123195.50,272,$-28.50
2025-01-15,00:49:00,20944.0,SELL,3,0.02h,Stop Loss,$-9.00,$-37.50,$123186.50,272,$-37.50
2025-01-15,00:50:00,20948.75,BUY,3,0.03h,Stop Loss,$-9.00,$-46.50,$123177.50,272,$-46.50
2025-01-15,01:26:00,20952.5,SELL,3,0.02h,Stop Loss,$-9.00,$-55.50,$123168.50,272,$-55.50
2025-01-15,01:29:00,20957.25,BUY,3,0.02h,Break Even,$-1.50,$-57.00,$123167.00,272,$-57.00
2025-01-15,01:30:00,20955.25,SELL,3,0.02h,Break Even,$-1.50,$-58.50,$123165.50,272,$-58.50
2025-01-15,01:54:00,20954.75,BUY,3,0.02h,Stop Loss,$-9.00,$-67.50,$123156.50,272,$-67.50
2025-01-15,02:08:00,20951.25,SELL,3,0.02h,Break Even,$-1.50,$-69.00,$123155.00,272,$-69.00
2025-01-15,02:28:00,20951.25,BUY,3,0.05h,Stop Loss,$-9.00,$-78.00,$123146.00,272,$-78.00
2025-01-15,02:32:00,20947.5,SELL,3,0.02h,Break Even,$-1.50,$-79.50,$123144.50,272,$-79.50
2025-01-15,03:15:00,20939.0,BUY,3,0.02h,Break Even,$-1.50,$-81.00,$123143.00,272,$-81.00
2025-01-15,03:32:00,20934.0,SELL,3,0.02h,Stop Loss,$-9.00,$-90.00,$123134.00,272,$-90.00
2025-01-15,03:39:00,20939.75,BUY,3,0.02h,Break Even,$-1.50,$-91.50,$123132.50,272,$-91.50
2025-01-15,03:45:00,20934.75,SELL,3,0.02h,Stop Loss,$-9.00,$-100.50,$123123.50,272,$-100.50
2025-01-15,04:23:00,20934.5,BUY,3,0.03h,Stop Loss,$-9.00,$-109.50,$123114.50,272,$-109.50
2025-01-15,05:03:00,20938.75,SELL,3,0.02h,Break Even,$-1.50,$-111.00,$123113.00,272,$-111.00
2025-01-15,05:08:00,20943.5,BUY,3,0.02h,Break Even,$-1.50,$-112.50,$123111.50,272,$-112.50
2025-01-15,05:22:00,20940.0,SELL,3,0.02h,Stop Loss,$-9.00,$-121.50,$123102.50,272,$-121.50
2025-01-15,05:25:00,20943.75,BUY,3,0.02h,Stop Loss,$-9.00,$-130.50,$123093.50,272,$-130.50
2025-01-15,05:26:00,20941.5,SELL,3,0.02h,Stop Loss,$-9.00,$-139.50,$123084.50,272,$-139.50
2025-01-15,05:29:00,20944.25,BUY,3,0.03h,Stop Loss,$4.50,$-135.00,$123089.00,272,$-135.00
2025-01-15,05:42:00,20941.75,SELL,3,0.02h,Break Even,$-1.50,$-136.50,$123087.50,272,$-136.50
2025-01-15,05:46:00,20946.75,BUY,3,0.03h,Stop Loss,$-9.00,$-145.50,$123078.50,272,$-145.50
2025-01-15,05:58:00,20942.75,SELL,3,0.02h,Stop Loss,$-9.00,$-154.50,$123069.50,272,$-154.50
2025-01-15,06:05:00,20946.0,BUY,3,0.02h,Break Even,$-1.50,$-156.00,$123068.00,272,$-156.00
2025-01-15,06:07:00,20943.0,SELL,3,0.02h,Stop Loss,$-9.00,$-165.00,$123059.00,272,$-165.00
2025-01-15,06:21:00,20945.5,BUY,3,0.02h,Stop Loss,$-9.00,$-174.00,$123050.00,272,$-174.00
2025-01-15,06:56:00,20947.75,SELL,3,0.02h,Stop Loss,$-9.00,$-183.00,$123041.00,272,$-183.00
2025-01-15,07:02:00,20952.5,BUY,3,0.02h,Stop Loss,$9.00,$-174.00,$123050.00,272,$-174.00
2025-01-15,07:24:00,20952.5,SELL,3,0.02h,Break Even,$-1.50,$-175.50,$123048.50,272,$-175.50
2025-01-15,08:24:00,20933.75,BUY,3,0.02h,Stop Loss,$-9.00,$-184.50,$123039.50,272,$-184.50
2025-01-15,08:53:00,20935.5,SELL,3,0.02h,Break Even,$-1.50,$-186.00,$123038.00,272,$-186.00
2025-01-15,09:08:00,20944.0,BUY,3,0.02h,Stop Loss,$-9.00,$-195.00,$123029.00,272,$-195.00
2025-01-15,09:22:00,20937.0,SELL,3,0.02h,Break Even,$-1.50,$-196.50,$123027.50,272,$-196.50
2025-01-15,09:24:00,20944.25,BUY,3,0.02h,Stop Loss,$-9.00,$-205.50,$123018.50,272,$-205.50
2025-01-15,09:27:00,20940.25,SELL,3,0.02h,Break Even,$-1.50,$-207.00,$123017.00,272,$-207.00
2025-01-15,09:28:00,20944.25,BUY,3,0.02h,Break Even,$-1.50,$-208.50,$123015.50,272,$-208.50
2025-01-15,10:10:00,20955.25,SELL,3,0.02h,Stop Loss,$-9.00,$-217.50,$123006.50,272,$-217.50
2025-01-15,10:28:00,20956.75,BUY,3,0.02h,Break Even,$-1.50,$-219.00,$123005.00,272,$-219.00
2025-01-15,12:23:00,20997.0,SELL,3,0.02h,Stop Loss,$24.00,$-195.00,$123029.00,272,$-195.00
2025-01-15,12:41:00,21001.25,BUY,3,0.02h,Stop Loss,$-9.00,$-204.00,$123020.00,272,$-204.00
2025-01-15,12:56:00,20986.0,SELL,3,0.02h,Break Even,$-1.50,$-205.50,$123018.50,272,$-205.50
2025-01-15,13:04:00,20999.5,BUY,3,0.02h,Break Even,$-1.50,$-207.00,$123017.00,272,$-207.00
2025-01-15,13:12:00,20991.5,SELL,3,0.02h,Break Even,$-1.50,$-208.50,$123015.50,272,$-208.50
2025-01-15,13:25:00,20999.5,BUY,3,0.02h,Break Even,$-1.50,$-210.00,$123014.00,272,$-210.00
2025-01-15,14:12:00,21250.75,SELL,3,0.02h,Stop Loss,$-9.00,$-219.00,$123005.00,272,$-219.00
2025-01-15,14:42:00,21282.5,BUY,3,0.02h,Stop Loss,$36.00,$-183.00,$123041.00,272,$-183.00
2025-01-15,15:36:00,21365.5,SELL,3,0.02h,Stop Loss,$79.50,$-103.50,$123120.50,272,$-103.50
2025-01-15,15:42:00,21385.75,BUY,3,0.02h,Stop Loss,$15.00,$-88.50,$123135.50,272,$-88.50
2025-01-15,15:44:00,21375.5,SELL,3,0.02h,Stop Loss,$51.00,$-37.50,$123186.50,272,$-37.50
2025-01-15,17:06:00,21291.0,BUY,3,0.02h,Stop Loss,$93.00,$55.50,$123279.50,272,$55.50
2025-01-15,17:56:00,21330.25,SELL,3,0.02h,Stop Loss,$-9.00,$46.50,$123270.50,272,$46.50
2025-01-15,18:04:00,21354.5,BUY,3,0.02h,Stop Loss,$-9.00,$37.50,$123261.50,272,$37.50
2025-01-15,19:51:00,21407.0,SELL,3,0.02h,Break Even,$-1.50,$36.00,$123260.00,272,$36.00
2025-01-15,19:53:00,21419.75,BUY,3,0.02h,Stop Loss,$-9.00,$27.00,$123251.00,272,$27.00
2025-01-15,20:38:00,21426.25,SELL,3,0.02h,Stop Loss,$9.00,$36.00,$123260.00,272,$36.00
2025-01-15,23:01:00,21384.25,BUY,3,0.02h,Break Even,$-1.50,$34.50,$123258.50,272,$34.50
2025-01-15,23:54:00,21410.0,SELL,3,0.02h,Stop Loss,$-9.00,$25.50,$123249.50,272,$25.50
,,,,,,,,,,,
2025-01-16,00:00:00,21415.5,BUY,3,0.02h,Stop Loss,$18.00,$18.00,$123267.50,273,$18.00
2025-01-16,00:50:00,21426.75,SELL,3,0.02h,Break Even,$-1.50,$16.50,$123266.00,273,$16.50
2025-01-16,01:33:00,21422.5,BUY,3,0.02h,Break Even,$-1.50,$15.00,$123264.50,273,$15.00
2025-01-16,01:53:00,21414.25,SELL,3,0.02h,Stop Loss,$-9.00,$6.00,$123255.50,273,$6.00
2025-01-16,02:39:00,21397.75,BUY,3,0.02h,Break Even,$-1.50,$4.50,$123254.00,273,$4.50
2025-01-16,02:58:00,21397.25,SELL,3,0.02h,Stop Loss,$-9.00,$-4.50,$123245.00,273,$-4.50
2025-01-16,03:06:00,21404.0,BUY,3,0.02h,Stop Loss,$-9.00,$-13.50,$123236.00,273,$-13.50
2025-01-16,03:26:00,21400.0,SELL,3,0.02h,Stop Loss,$13.50,$0.00,$123249.50,273,$0.00
2025-01-16,04:08:00,21396.5,BUY,3,0.02h,Stop Loss,$-9.00,$-9.00,$123240.50,273,$-9.00
2025-01-16,04:27:00,21393.0,SELL,3,0.02h,Break Even,$-1.50,$-10.50,$123239.00,273,$-10.50
2025-01-16,04:56:00,21390.0,BUY,3,0.02h,Stop Loss,$-9.00,$-19.50,$123230.00,273,$-19.50
2025-01-16,05:04:00,21383.75,SELL,3,0.02h,Break Even,$-1.50,$-21.00,$123228.50,273,$-21.00
2025-01-16,05:34:00,21388.75,BUY,3,0.02h,Break Even,$-1.50,$-22.50,$123227.00,273,$-22.50
2025-01-16,05:38:00,21374.25,SELL,3,0.02h,Stop Loss,$63.00,$40.50,$123290.00,273,$40.50
2025-01-16,06:11:00,21377.75,BUY,3,0.02h,Stop Loss,$6.00,$46.50,$123296.00,273,$46.50
2025-01-16,08:08:00,21532.5,SELL,3,0.02h,Stop Loss,$36.00,$82.50,$123332.00,273,$82.50
2025-01-16,08:38:00,21526.25,BUY,3,0.02h,Stop Loss,$60.00,$142.50,$123392.00,273,$142.50
2025-01-16,09:03:00,21523.75,SELL,3,0.02h,Stop Loss,$78.00,$220.50,$123470.00,273,$220.50
2025-01-16,09:56:00,21482.5,BUY,3,0.02h,Stop Loss,$-9.00,$211.50,$123461.00,273,$211.50
2025-01-16,10:01:00,21467.25,SELL,3,0.02h,Stop Loss,$4.50,$216.00,$123465.50,273,$216.00
2025-01-16,10:17:00,21471.5,BUY,3,0.02h,Stop Loss,$4.50,$220.50,$123470.00,273,$220.50
2025-01-16,10:58:00,21495.25,SELL,3,0.02h,Break Even,$-1.50,$219.00,$123468.50,273,$219.00
2025-01-16,11:08:00,21505.5,BUY,3,0.02h,Break Even,$-1.50,$217.50,$123467.00,273,$217.50
2025-01-16,11:11:00,21494.5,SELL,3,0.02h,Stop Loss,$-9.00,$208.50,$123458.00,273,$208.50
2025-01-16,11:14:00,21503.0,BUY,3,0.02h,Stop Loss,$-9.00,$199.50,$123449.00,273,$199.50
2025-01-16,11:15:00,21497.0,SELL,3,0.02h,Break Even,$-1.50,$198.00,$123447.50,273,$198.00
2025-01-16,11:30:00,21503.5,BUY,3,0.02h,Stop Loss,$-9.00,$189.00,$123438.50,273,$189.00
2025-01-16,11:41:00,21498.0,SELL,3,0.02h,Stop Loss,$4.50,$193.50,$123443.00,273,$193.50
2025-01-16,11:51:00,21504.0,BUY,3,0.02h,Stop Loss,$31.50,$225.00,$123474.50,273,$225.00
2025-01-16,12:02:00,21487.25,SELL,3,0.02h,Stop Loss,$6.00,$231.00,$123480.50,273,$231.00
2025-01-16,13:18:00,21444.25,BUY,3,0.02h,Stop Loss,$-9.00,$222.00,$123471.50,273,$222.00
2025-01-16,13:20:00,21429.25,SELL,3,0.02h,Stop Loss,$15.00,$237.00,$123486.50,273,$237.00
2025-01-16,13:24:00,21449.0,BUY,3,0.02h,Stop Loss,$3.00,$240.00,$123489.50,273,$240.00
2025-01-16,14:08:00,21458.5,SELL,3,0.02h,Stop Loss,$12.00,$252.00,$123501.50,273,$252.00
2025-01-16,14:14:00,21479.0,BUY,3,0.02h,Stop Loss,$15.00,$267.00,$123516.50,273,$267.00
2025-01-16,14:32:00,21450.75,SELL,3,0.02h,Stop Loss,$76.50,$343.50,$123593.00,273,$343.50
2025-01-16,15:21:00,21399.25,BUY,3,0.02h,Stop Loss,$72.00,$415.50,$123665.00,273,$415.50
2025-01-16,15:28:00,21371.75,SELL,3,0.02h,Break Even,$-1.50,$414.00,$123663.50,273,$414.00
2025-01-16,15:56:00,21385.0,BUY,3,0.02h,Stop Loss,$72.00,$486.00,$123735.50,273,$486.00
2025-01-16,16:21:00,21395.5,SELL,3,0.02h,Stop Loss,$33.00,$519.00,$123768.50,273,$519.00
2025-01-16,16:59:00,21399.75,BUY,3,0.02h,Stop Loss,$9.00,$528.00,$123777.50,273,$528.00
2025-01-16,17:18:00,21383.0,SELL,3,0.02h,Stop Loss,$43.50,$571.50,$123821.00,273,$571.50
2025-01-16,17:19:00,21397.0,BUY,3,0.02h,Break Even,$-1.50,$570.00,$123819.50,273,$570.00
2025-01-16,17:20:00,21383.75,SELL,3,0.02h,Break Even,$-1.50,$568.50,$123818.00,273,$568.50
2025-01-16,17:25:00,21404.75,BUY,3,0.02h,Stop Loss,$15.00,$583.50,$123833.00,273,$583.50
2025-01-16,17:39:00,21392.0,SELL,3,0.02h,Stop Loss,$15.00,$598.50,$123848.00,273,$598.50
2025-01-16,17:59:00,21399.0,BUY,3,0.02h,Stop Loss,$-9.00,$589.50,$123839.00,273,$589.50
2025-01-16,18:00:00,21385.5,SELL,3,0.02h,Break Even,$-1.50,$588.00,$123837.50,273,$588.00
2025-01-16,18:04:00,21399.75,BUY,3,0.02h,Stop Loss,$18.00,$606.00,$123855.50,273,$606.00
2025-01-16,18:16:00,21388.0,SELL,3,0.02h,Stop Loss,$27.00,$633.00,$123882.50,273,$633.00
2025-01-16,19:06:00,21320.75,BUY,3,0.02h,Stop Loss,$48.00,$681.00,$123930.50,273,$681.00
2025-01-16,20:18:00,21355.75,SELL,3,0.02h,Stop Loss,$49.50,$730.50,$123980.00,273,$730.50
2025-01-16,21:41:00,21208.25,BUY,3,0.02h,Break Even,$-1.50,$729.00,$123978.50,273,$729.00
2025-01-16,21:45:00,21201.5,SELL,3,0.02h,Stop Loss,$-9.00,$720.00,$123969.50,273,$720.00
2025-01-16,21:46:00,21211.0,BUY,3,0.02h,Stop Loss,$-9.00,$711.00,$123960.50,273,$711.00
2025-01-16,21:53:00,21203.0,SELL,3,0.02h,Break Even,$-1.50,$709.50,$123959.00,273,$709.50
2025-01-16,21:56:00,21210.5,BUY,3,0.02h,Stop Loss,$3.00,$712.50,$123962.00,273,$712.50
2025-01-16,23:48:00,21228.75,SELL,3,0.02h,Stop Loss,$7.50,$720.00,$123969.50,273,$720.00
,,,,,,,,,,,
2025-01-17,00:00:00,21234.5,BUY,3,0.02h,Break Even,$-1.50,$-1.50,$123968.00,274,$-1.50
2025-01-17,00:17:00,21228.25,SELL,3,0.02h,Stop Loss,$-9.00,$-10.50,$123959.00,274,$-10.50
2025-01-17,00:28:00,21235.25,BUY,3,0.02h,Stop Loss,$-9.00,$-19.50,$123950.00,274,$-19.50
2025-01-17,00:51:00,21235.75,SELL,3,0.02h,Stop Loss,$-9.00,$-28.50,$123941.00,274,$-28.50
2025-01-17,00:52:00,21239.0,BUY,3,0.02h,Break Even,$-1.50,$-30.00,$123939.50,274,$-30.00
2025-01-17,02:38:00,21269.5,SELL,3,0.02h,Stop Loss,$21.00,$-9.00,$123960.50,274,$-9.00
2025-01-17,03:31:00,21260.75,BUY,3,0.02h,Stop Loss,$10.50,$1.50,$123971.00,274,$1.50
2025-01-17,04:41:00,21292.25,SELL,3,0.02h,Break Even,$-1.50,$0.00,$123969.50,274,$0.00
2025-01-17,05:04:00,21293.5,BUY,3,0.02h,Break Even,$-1.50,$-1.50,$123968.00,274,$-1.50
2025-01-17,05:42:00,21294.5,SELL,3,0.02h,Stop Loss,$3.00,$1.50,$123971.00,274,$1.50
2025-01-17,06:00:00,21298.75,BUY,3,0.02h,Stop Loss,$-9.00,$-7.50,$123962.00,274,$-7.50
2025-01-17,06:02:00,21295.0,SELL,3,0.02h,Break Even,$-1.50,$-9.00,$123960.50,274,$-9.00
2025-01-17,06:24:00,21295.0,BUY,3,0.02h,Break Even,$-1.50,$-10.50,$123959.00,274,$-10.50
2025-01-17,06:37:00,21286.5,SELL,3,0.02h,Break Even,$-1.50,$-12.00,$123957.50,274,$-12.00
2025-01-17,06:58:00,21288.75,BUY,3,0.03h,Break Even,$-1.50,$-13.50,$123956.00,274,$-13.50
2025-01-17,07:01:00,21286.25,SELL,3,0.02h,Stop Loss,$-9.00,$-22.50,$123947.00,274,$-22.50
2025-01-17,07:50:00,21274.5,BUY,3,0.02h,Break Even,$-1.50,$-24.00,$123945.50,274,$-24.00
2025-01-17,08:23:00,21272.75,SELL,3,0.02h,Stop Loss,$-9.00,$-33.00,$123936.50,274,$-33.00
2025-01-17,08:28:00,21283.25,BUY,3,0.02h,Stop Loss,$9.00,$-24.00,$123945.50,274,$-24.00
2025-01-17,09:40:00,21336.25,SELL,3,0.02h,Stop Loss,$-9.00,$-33.00,$123936.50,274,$-33.00
2025-01-17,09:43:00,21344.5,BUY,3,0.02h,Break Even,$-1.50,$-34.50,$123935.00,274,$-34.50
2025-01-17,09:45:00,21341.25,SELL,3,0.02h,Stop Loss,$3.00,$-31.50,$123938.00,274,$-31.50
2025-01-17,09:56:00,21345.5,BUY,3,0.02h,Stop Loss,$-9.00,$-40.50,$123929.00,274,$-40.50
2025-01-17,09:59:00,21338.75,SELL,3,0.02h,Stop Loss,$-9.00,$-49.50,$123920.00,274,$-49.50
2025-01-17,10:16:00,21341.75,BUY,3,0.02h,Stop Loss,$7.50,$-42.00,$123927.50,274,$-42.00
2025-01-17,10:29:00,21336.75,SELL,3,0.02h,Break Even,$-1.50,$-43.50,$123926.00,274,$-43.50
2025-01-17,10:48:00,21338.5,BUY,3,0.02h,Stop Loss,$10.50,$-33.00,$123936.50,274,$-33.00
2025-01-17,10:51:00,21330.0,SELL,3,0.02h,Break Even,$-1.50,$-34.50,$123935.00,274,$-34.50
2025-01-17,10:57:00,21342.0,BUY,3,0.02h,Stop Loss,$-9.00,$-43.50,$123926.00,274,$-43.50
2025-01-17,11:00:00,21333.75,SELL,3,0.02h,Stop Loss,$-9.00,$-52.50,$123917.00,274,$-52.50
2025-01-17,11:01:00,21344.0,BUY,3,0.02h,Stop Loss,$-9.00,$-61.50,$123908.00,274,$-61.50
2025-01-17,11:48:00,21348.0,SELL,3,0.02h,Break Even,$-1.50,$-63.00,$123906.50,274,$-63.00
2025-01-17,12:14:00,21337.0,BUY,3,0.02h,Stop Loss,$-9.00,$-72.00,$123897.50,274,$-72.00
2025-01-17,12:36:00,21333.0,SELL,3,0.02h,Stop Loss,$-9.00,$-81.00,$123888.50,274,$-81.00
2025-01-17,12:46:00,21342.25,BUY,3,0.02h,Break Even,$-1.50,$-82.50,$123887.00,274,$-82.50
2025-01-17,12:50:00,21335.75,SELL,3,0.02h,Stop Loss,$-9.00,$-91.50,$123878.00,274,$-91.50
2025-01-17,12:51:00,21341.5,BUY,3,0.02h,Break Even,$-1.50,$-93.00,$123876.50,274,$-93.00
2025-01-17,14:34:00,21566.75,SELL,3,0.02h,Stop Loss,$90.00,$-3.00,$123966.50,274,$-3.00
2025-01-17,15:06:00,21563.75,BUY,3,0.02h,Stop Loss,$87.00,$84.00,$124053.50,274,$84.00
2025-01-17,15:23:00,21501.25,SELL,3,0.02h,Break Even,$-1.50,$82.50,$124052.00,274,$82.50
2025-01-17,15:35:00,21549.5,BUY,3,0.02h,Stop Loss,$111.00,$193.50,$124163.00,274,$193.50
2025-01-17,16:44:00,21594.75,SELL,3,0.02h,Stop Loss,$-9.00,$184.50,$124154.00,274,$184.50
2025-01-17,17:11:00,21596.5,BUY,3,0.02h,Stop Loss,$-9.00,$175.50,$124145.00,274,$175.50
2025-01-17,18:34:00,21643.25,SELL,3,0.02h,Break Even,$-1.50,$174.00,$124143.50,274,$174.00
2025-01-17,19:23:00,21639.0,BUY,3,0.02h,Stop Loss,$13.50,$187.50,$124157.00,274,$187.50
2025-01-17,19:34:00,21626.25,SELL,3,0.02h,Break Even,$-1.50,$186.00,$124155.50,274,$186.00
2025-01-17,19:36:00,21636.5,BUY,3,0.02h,Stop Loss,$-9.00,$177.00,$124146.50,274,$177.00
2025-01-17,19:51:00,21629.25,SELL,3,0.02h,Stop Loss,$-9.00,$168.00,$124137.50,274,$168.00
2025-01-17,20:22:00,21616.5,BUY,3,0.02h,Stop Loss,$9.00,$177.00,$124146.50,274,$177.00
2025-01-17,20:29:00,21602.0,SELL,3,0.02h,Break Even,$-1.50,$175.50,$124145.00,274,$175.50
2025-01-17,20:35:00,21618.25,BUY,3,0.02h,Stop Loss,$25.50,$201.00,$124170.50,274,$201.00
2025-01-17,20:52:00,21605.0,SELL,3,0.02h,Stop Loss,$-9.00,$192.00,$124161.50,274,$192.00
2025-01-17,20:54:00,21622.5,BUY,3,0.02h,Stop Loss,$76.50,$268.50,$124238.00,274,$268.50
2025-01-17,20:56:00,21603.25,SELL,3,0.02h,Stop Loss,$85.50,$354.00,$124323.50,274,$354.00
2025-01-17,21:27:00,21592.5,BUY,3,0.02h,Stop Loss,$-9.00,$345.00,$124314.50,274,$345.00
2025-01-17,21:36:00,21585.5,SELL,3,0.02h,Stop Loss,$13.50,$358.50,$124328.00,274,$358.50
2025-01-17,21:45:00,21589.0,BUY,3,0.02h,Stop Loss,$-9.00,$349.50,$124319.00,274,$349.50
2025-01-17,21:46:00,21583.0,SELL,3,0.02h,Break Even,$-1.50,$348.00,$124317.50,274,$348.00
,,,,,,,,,,,
2025-01-20,00:56:00,21554.0,BUY,3,0.02h,Break Even,$-1.50,$-1.50,$124316.00,275,$-1.50
2025-01-20,01:19:00,21548.75,SELL,3,0.02h,Stop Loss,$-9.00,$-10.50,$124307.00,275,$-10.50
2025-01-20,01:36:00,21562.75,BUY,3,0.02h,Break Even,$-1.50,$-12.00,$124305.50,275,$-12.00
2025-01-20,02:04:00,21561.0,SELL,3,0.02h,Break Even,$-1.50,$-13.50,$124304.00,275,$-13.50
2025-01-20,02:14:00,21565.0,BUY,3,0.02h,Stop Loss,$-9.00,$-22.50,$124295.00,275,$-22.50
2025-01-20,02:40:00,21563.25,SELL,3,0.02h,Break Even,$-1.50,$-24.00,$124293.50,275,$-24.00
2025-01-20,02:44:00,21568.0,BUY,3,0.02h,Stop Loss,$-9.00,$-33.00,$124284.50,275,$-33.00
2025-01-20,02:50:00,21560.0,SELL,3,0.02h,Stop Loss,$3.00,$-30.00,$124287.50,275,$-30.00
2025-01-20,03:13:00,21563.5,BUY,3,0.02h,Stop Loss,$-9.00,$-39.00,$124278.50,275,$-39.00
2025-01-20,03:28:00,21558.75,SELL,3,0.02h,Stop Loss,$-9.00,$-48.00,$124269.50,275,$-48.00
2025-01-20,03:59:00,21560.5,BUY,3,0.03h,Stop Loss,$-9.00,$-57.00,$124260.50,275,$-57.00
2025-01-20,04:23:00,21561.25,SELL,3,0.02h,Break Even,$-1.50,$-58.50,$124259.00,275,$-58.50
2025-01-20,04:47:00,21560.75,BUY,3,0.02h,Break Even,$-1.50,$-60.00,$124257.50,275,$-60.00
2025-01-20,05:32:00,21565.5,SELL,3,0.02h,Stop Loss,$-9.00,$-69.00,$124248.50,275,$-69.00
2025-01-20,05:45:00,21569.75,BUY,3,0.02h,Stop Loss,$-9.00,$-78.00,$124239.50,275,$-78.00
2025-01-20,05:49:00,21565.25,SELL,3,0.03h,Stop Loss,$-9.00,$-87.00,$124230.50,275,$-87.00
2025-01-20,05:58:00,21568.25,BUY,3,0.02h,Stop Loss,$-9.00,$-96.00,$124221.50,275,$-96.00
2025-01-20,07:07:00,21589.75,SELL,3,0.02h,Break Even,$-1.50,$-97.50,$124220.00,275,$-97.50
2025-01-20,07:11:00,21596.0,BUY,3,0.02h,Break Even,$-1.50,$-99.00,$124218.50,275,$-99.00
2025-01-20,07:28:00,21593.25,SELL,3,0.02h,Break Even,$-1.50,$-100.50,$124217.00,275,$-100.50
2025-01-20,07:34:00,21597.0,BUY,3,0.02h,Stop Loss,$-9.00,$-109.50,$124208.00,275,$-109.50
2025-01-20,08:26:00,21620.75,SELL,3,0.02h,Stop Loss,$24.00,$-85.50,$124232.00,275,$-85.50
2025-01-20,08:48:00,21620.0,BUY,3,0.02h,Break Even,$-1.50,$-87.00,$124230.50,275,$-87.00
2025-01-20,09:24:00,21621.0,SELL,3,0.02h,Break Even,$-1.50,$-88.50,$124229.00,275,$-88.50
2025-01-20,09:32:00,21626.0,BUY,3,0.02h,Break Even,$-1.50,$-90.00,$124227.50,275,$-90.00
2025-01-20,09:35:00,21616.5,SELL,3,0.02h,Break Even,$-1.50,$-91.50,$124226.00,275,$-91.50
2025-01-20,09:58:00,21622.5,BUY,3,0.02h,Break Even,$-1.50,$-93.00,$124224.50,275,$-93.00
2025-01-20,10:09:00,21614.25,SELL,3,0.02h,Break Even,$-1.50,$-94.50,$124223.00,275,$-94.50
2025-01-20,10:22:00,21622.5,BUY,3,0.02h,Stop Loss,$10.50,$-84.00,$124233.50,275,$-84.00
2025-01-20,10:36:00,21616.75,SELL,3,0.02h,Stop Loss,$-9.00,$-93.00,$124224.50,275,$-93.00
2025-01-20,10:41:00,21623.0,BUY,3,0.02h,Break Even,$-1.50,$-94.50,$124223.00,275,$-94.50
2025-01-20,11:02:00,21622.75,SELL,3,0.02h,Stop Loss,$-9.00,$-103.50,$124214.00,275,$-103.50
2025-01-20,11:07:00,21628.0,BUY,3,0.02h,Break Even,$-1.50,$-105.00,$124212.50,275,$-105.00
2025-01-20,11:12:00,21622.5,SELL,3,0.02h,Stop Loss,$-9.00,$-114.00,$124203.50,275,$-114.00
2025-01-20,11:34:00,21628.0,BUY,3,0.02h,Stop Loss,$-9.00,$-123.00,$124194.50,275,$-123.00
2025-01-20,11:43:00,21618.5,SELL,3,0.02h,Stop Loss,$-9.00,$-132.00,$124185.50,275,$-132.00
2025-01-20,11:46:00,21627.75,BUY,3,0.02h,Stop Loss,$-9.00,$-141.00,$124176.50,275,$-141.00
2025-01-20,12:02:00,21619.25,SELL,3,0.02h,Stop Loss,$16.50,$-124.50,$124193.00,275,$-124.50
2025-01-20,13:32:00,21625.25,BUY,3,0.02h,Stop Loss,$52.50,$-72.00,$124245.50,275,$-72.00
2025-01-20,14:17:00,21661.25,SELL,3,0.02h,Break Even,$-1.50,$-73.50,$124244.00,275,$-73.50
2025-01-20,14:22:00,21700.0,BUY,3,0.02h,Stop Loss,$27.00,$-46.50,$124271.00,275,$-46.50
2025-01-20,14:59:00,21736.75,SELL,3,0.02h,Stop Loss,$-9.00,$-55.50,$124262.00,275,$-55.50
2025-01-20,15:58:00,21683.5,BUY,3,0.02h,Break Even,$-1.50,$-57.00,$124260.50,275,$-57.00
2025-01-20,15:59:00,21678.25,SELL,3,0.02h,Break Even,$-1.50,$-58.50,$124259.00,275,$-58.50
2025-01-20,16:00:00,21682.75,BUY,3,0.02h,Stop Loss,$19.50,$-39.00,$124278.50,275,$-39.00
2025-01-20,16:59:00,21700.0,SELL,3,0.02h,Stop Loss,$57.00,$18.00,$124335.50,275,$18.00
2025-01-20,17:38:00,21693.75,BUY,3,0.02h,Stop Loss,$25.50,$43.50,$124361.00,275,$43.50
2025-01-20,17:44:00,21680.0,SELL,3,0.02h,Break Even,$-1.50,$42.00,$124359.50,275,$42.00
2025-01-20,17:47:00,21692.75,BUY,3,0.02h,Stop Loss,$13.50,$55.50,$124373.00,275,$55.50
2025-01-20,17:53:00,21683.5,SELL,3,0.02h,Break Even,$-1.50,$54.00,$124371.50,275,$54.00
2025-01-20,17:55:00,21702.5,BUY,3,0.02h,Stop Loss,$4.50,$58.50,$124376.00,275,$58.50
2025-01-20,18:00:00,21680.5,SELL,3,5.02h,Stop Loss,$-9.00,$49.50,$124367.00,275,$49.50
2025-01-20,23:01:00,21692.5,BUY,3,0.02h,Break Even,$-1.50,$48.00,$124365.50,275,$48.00
2025-01-20,23:02:00,21681.5,SELL,3,0.02h,Stop Loss,$-9.00,$39.00,$124356.50,275,$39.00
2025-01-20,23:05:00,21695.5,BUY,3,0.02h,Stop Loss,$30.00,$69.00,$124386.50,275,$69.00
2025-01-20,23:38:00,21707.75,SELL,3,0.02h,Break Even,$-1.50,$67.50,$124385.00,275,$67.50
2025-01-20,23:47:00,21733.0,BUY,3,0.02h,Break Even,$-1.50,$66.00,$124383.50,275,$66.00
,,,,,,,,,,,
2025-01-21,00:18:00,21721.25,SELL,3,0.02h,Stop Loss,$-9.00,$-9.00,$124374.50,276,$-9.00
2025-01-21,01:17:00,21601.75,BUY,3,0.02h,Break Even,$-1.50,$-10.50,$124373.00,276,$-10.50
2025-01-21,01:35:00,21564.5,SELL,3,0.02h,Stop Loss,$114.00,$103.50,$124487.00,276,$103.50
2025-01-21,01:44:00,21574.75,BUY,3,0.02h,Stop Loss,$48.00,$151.50,$124535.00,276,$151.50
2025-01-21,02:17:00,21583.25,SELL,3,0.02h,Stop Loss,$7.50,$159.00,$124542.50,276,$159.00
2025-01-21,02:26:00,21593.0,BUY,3,0.02h,Stop Loss,$4.50,$163.50,$124547.00,276,$163.50
2025-01-21,02:29:00,21583.75,SELL,3,0.02h,Stop Loss,$57.00,$220.50,$124604.00,276,$220.50
2025-01-21,02:47:00,21589.5,BUY,3,0.02h,Stop Loss,$-9.00,$211.50,$124595.00,276,$211.50
2025-01-21,03:42:00,21623.25,SELL,3,0.02h,Stop Loss,$-9.00,$202.50,$124586.00,276,$202.50
2025-01-21,03:58:00,21630.25,BUY,3,0.02h,Stop Loss,$-9.00,$193.50,$124577.00,276,$193.50
2025-01-21,04:02:00,21621.5,SELL,3,0.02h,Stop Loss,$4.50,$198.00,$124581.50,276,$198.00
2025-01-21,04:21:00,21629.25,BUY,3,0.02h,Break Even,$-1.50,$196.50,$124580.00,276,$196.50
2025-01-21,04:31:00,21609.0,SELL,3,0.02h,Stop Loss,$28.50,$225.00,$124608.50,276,$225.00
2025-01-21,04:54:00,21617.75,BUY,3,0.02h,Stop Loss,$-9.00,$216.00,$124599.50,276,$216.00
2025-01-21,04:55:00,21611.75,SELL,3,0.02h,Stop Loss,$9.00,$225.00,$124608.50,276,$225.00
2025-01-21,05:25:00,21611.5,BUY,3,0.02h,Stop Loss,$-9.00,$216.00,$124599.50,276,$216.00
2025-01-21,05:28:00,21606.75,SELL,3,0.02h,Stop Loss,$-9.00,$207.00,$124590.50,276,$207.00
2025-01-21,05:29:00,21608.5,BUY,3,0.02h,Stop Loss,$-9.00,$198.00,$124581.50,276,$198.00
2025-01-21,05:32:00,21587.5,SELL,3,0.02h,Stop Loss,$3.00,$201.00,$124584.50,276,$201.00
2025-01-21,05:45:00,21608.75,BUY,3,0.02h,Stop Loss,$-9.00,$192.00,$124575.50,276,$192.00
2025-01-21,05:52:00,21597.0,SELL,3,0.02h,Stop Loss,$28.50,$220.50,$124604.00,276,$220.50
2025-01-21,06:09:00,21602.75,BUY,3,0.02h,Break Even,$-1.50,$219.00,$124602.50,276,$219.00
2025-01-21,06:39:00,21602.5,SELL,3,0.02h,Stop Loss,$-9.00,$210.00,$124593.50,276,$210.00
2025-01-21,07:12:00,21604.75,BUY,3,0.02h,Break Even,$-1.50,$208.50,$124592.00,276,$208.50
2025-01-21,07:22:00,21596.5,SELL,3,0.02h,Stop Loss,$4.50,$213.00,$124596.50,276,$213.00
2025-01-21,07:27:00,21608.25,BUY,3,0.02h,Stop Loss,$22.50,$235.50,$124619.00,276,$235.50
2025-01-21,08:02:00,21614.0,SELL,3,0.02h,Stop Loss,$15.00,$250.50,$124634.00,276,$250.50
2025-01-21,08:12:00,21632.25,BUY,3,0.02h,Stop Loss,$-9.00,$241.50,$124625.00,276,$241.50
2025-01-21,08:59:00,21648.0,SELL,3,0.02h,Stop Loss,$4.50,$246.00,$124629.50,276,$246.00
2025-01-21,09:06:00,21662.5,BUY,3,0.02h,Break Even,$-1.50,$244.50,$124628.00,276,$244.50
2025-01-21,10:22:00,21704.5,SELL,3,0.02h,Stop Loss,$-9.00,$235.50,$124619.00,276,$235.50
2025-01-21,10:27:00,21712.75,BUY,3,0.02h,Stop Loss,$3.00,$238.50,$124622.00,276,$238.50
2025-01-21,10:46:00,21708.25,SELL,3,0.02h,Stop Loss,$4.50,$243.00,$124626.50,276,$243.00
2025-01-21,11:10:00,21706.75,BUY,3,0.02h,Stop Loss,$-9.00,$234.00,$124617.50,276,$234.00
2025-01-21,11:18:00,21688.0,SELL,3,0.02h,Stop Loss,$3.00,$237.00,$124620.50,276,$237.00
2025-01-21,11:40:00,21690.0,BUY,3,0.02h,Stop Loss,$6.00,$243.00,$124626.50,276,$243.00
2025-01-21,11:54:00,21686.5,SELL,3,0.02h,Break Even,$-1.50,$241.50,$124625.00,276,$241.50
2025-01-21,12:17:00,21682.5,BUY,3,0.02h,Stop Loss,$-9.00,$232.50,$124616.00,276,$232.50
2025-01-21,12:50:00,21687.0,SELL,3,0.02h,Stop Loss,$4.50,$237.00,$124620.50,276,$237.00
2025-01-21,13:00:00,21694.5,BUY,3,0.02h,Stop Loss,$-9.00,$228.00,$124611.50,276,$228.00
2025-01-21,13:01:00,21685.0,SELL,3,0.02h,Break Even,$-1.50,$226.50,$124610.00,276,$226.50
2025-01-21,13:04:00,21694.5,BUY,3,0.02h,Stop Loss,$21.00,$247.50,$124631.00,276,$247.50
2025-01-21,13:29:00,21694.75,SELL,3,0.02h,Stop Loss,$9.00,$256.50,$124640.00,276,$256.50
2025-01-21,13:33:00,21705.0,BUY,3,0.02h,Stop Loss,$15.00,$271.50,$124655.00,276,$271.50
2025-01-21,14:13:00,21718.75,SELL,3,0.02h,Break Even,$-1.50,$270.00,$124653.50,276,$270.00
2025-01-21,14:15:00,21724.5,BUY,3,0.02h,Break Even,$-1.50,$268.50,$124652.00,276,$268.50
2025-01-21,14:19:00,21713.75,SELL,3,0.02h,Stop Loss,$16.50,$285.00,$124668.50,276,$285.00
2025-01-21,15:24:00,21605.75,BUY,3,0.02h,Stop Loss,$51.00,$336.00,$124719.50,276,$336.00
2025-01-21,15:52:00,21604.0,SELL,3,0.02h,Stop Loss,$91.50,$427.50,$124811.00,276,$427.50
2025-01-21,15:58:00,21623.5,BUY,3,0.02h,Stop Loss,$52.50,$480.00,$124863.50,276,$480.00
2025-01-21,16:02:00,21611.25,SELL,3,0.02h,Stop Loss,$18.00,$498.00,$124881.50,276,$498.00
2025-01-21,16:07:00,21638.75,BUY,3,0.02h,Break Even,$-1.50,$496.50,$124880.00,276,$496.50
2025-01-21,16:26:00,21626.0,SELL,3,0.02h,Stop Loss,$4.50,$501.00,$124884.50,276,$501.00
2025-01-21,16:34:00,21638.0,BUY,3,0.02h,Break Even,$-1.50,$499.50,$124883.00,276,$499.50
2025-01-21,16:37:00,21620.75,SELL,3,0.02h,Stop Loss,$49.50,$549.00,$124932.50,276,$549.00
2025-01-21,16:50:00,21637.5,BUY,3,0.02h,Stop Loss,$7.50,$556.50,$124940.00,276,$556.50
2025-01-21,17:20:00,21658.75,SELL,3,0.02h,Break Even,$-1.50,$555.00,$124938.50,276,$555.00
2025-01-21,17:23:00,21673.75,BUY,3,0.02h,Break Even,$-1.50,$553.50,$124937.00,276,$553.50
2025-01-21,18:43:00,21744.25,SELL,3,0.02h,Stop Loss,$-9.00,$544.50,$124928.00,276,$544.50
2025-01-21,18:56:00,21753.0,BUY,3,0.02h,Stop Loss,$15.00,$559.50,$124943.00,276,$559.50
2025-01-21,19:15:00,21745.25,SELL,3,0.02h,Stop Loss,$55.50,$615.00,$124998.50,276,$615.00
2025-01-21,19:59:00,21723.75,BUY,3,0.02h,Break Even,$-1.50,$613.50,$124997.00,276,$613.50
2025-01-21,20:38:00,21718.75,SELL,3,0.02h,Stop Loss,$-9.00,$604.50,$124988.00,276,$604.50
2025-01-21,20:40:00,21735.5,BUY,3,0.02h,Break Even,$-1.50,$603.00,$124986.50,276,$603.00
2025-01-21,20:42:00,21720.5,SELL,3,0.02h,Stop Loss,$-9.00,$594.00,$124977.50,276,$594.00
2025-01-21,21:01:00,21752.75,BUY,3,0.02h,Stop Loss,$112.50,$706.50,$125090.00,276,$706.50
2025-01-21,23:30:00,21781.75,SELL,3,0.02h,Stop Loss,$-9.00,$697.50,$125081.00,276,$697.50
2025-01-21,23:34:00,21793.75,BUY,3,0.02h,Break Even,$-1.50,$696.00,$125079.50,276,$696.00
,,,,,,,,,,,
2025-01-22,01:02:00,21825.75,SELL,3,0.02h,Stop Loss,$3.00,$3.00,$125082.50,277,$3.00
2025-01-22,01:22:00,21827.0,BUY,3,0.02h,Break Even,$-1.50,$1.50,$125081.00,277,$1.50
2025-01-22,02:31:00,21838.25,SELL,3,0.02h,Break Even,$-1.50,$0.00,$125079.50,277,$0.00
2025-01-22,02:34:00,21840.75,BUY,3,0.02h,Stop Loss,$19.50,$19.50,$125099.00,277,$19.50
2025-01-22,02:44:00,21834.25,SELL,3,0.02h,Break Even,$-1.50,$18.00,$125097.50,277,$18.00
2025-01-22,03:05:00,21838.0,BUY,3,0.02h,Stop Loss,$-9.00,$9.00,$125088.50,277,$9.00
2025-01-22,03:06:00,21834.0,SELL,3,0.02h,Stop Loss,$-9.00,$0.00,$125079.50,277,$0.00
2025-01-22,03:08:00,21837.75,BUY,3,0.02h,Stop Loss,$-9.00,$-9.00,$125070.50,277,$-9.00
2025-01-22,04:24:00,21853.5,SELL,3,0.02h,Stop Loss,$-9.00,$-18.00,$125061.50,277,$-18.00
2025-01-22,04:25:00,21854.75,BUY,3,0.03h,Stop Loss,$-9.00,$-27.00,$125052.50,277,$-27.00
2025-01-22,04:29:00,21854.0,SELL,3,0.03h,Stop Loss,$-9.00,$-36.00,$125043.50,277,$-36.00
2025-01-22,04:31:00,21857.75,BUY,3,0.02h,Stop Loss,$3.00,$-33.00,$125046.50,277,$-33.00
2025-01-22,05:08:00,21865.25,SELL,3,0.02h,Stop Loss,$-9.00,$-42.00,$125037.50,277,$-42.00
2025-01-22,05:47:00,21860.75,BUY,3,0.02h,Stop Loss,$-9.00,$-51.00,$125028.50,277,$-51.00
2025-01-22,05:50:00,21858.25,SELL,3,0.02h,Stop Loss,$-9.00,$-60.00,$125019.50,277,$-60.00
2025-01-22,06:08:00,21862.0,BUY,3,0.02h,Stop Loss,$-9.00,$-69.00,$125010.50,277,$-69.00
2025-01-22,06:09:00,21857.5,SELL,3,0.02h,Stop Loss,$-9.00,$-78.00,$125001.50,277,$-78.00
2025-01-22,06:12:00,21860.5,BUY,3,0.02h,Break Even,$-1.50,$-79.50,$125000.00,277,$-79.50
2025-01-22,06:22:00,21857.25,SELL,3,0.02h,Stop Loss,$7.50,$-72.00,$125007.50,277,$-72.00
2025-01-22,07:09:00,21852.5,BUY,3,0.02h,Stop Loss,$-9.00,$-81.00,$124998.50,277,$-81.00
2025-01-22,07:50:00,21857.75,SELL,3,0.02h,Stop Loss,$9.00,$-72.00,$125007.50,277,$-72.00
2025-01-22,08:02:00,21865.25,BUY,3,0.02h,Break Even,$-1.50,$-73.50,$125006.00,277,$-73.50
2025-01-22,09:05:00,21881.5,SELL,3,0.02h,Break Even,$-1.50,$-75.00,$125004.50,277,$-75.00
2025-01-22,09:15:00,21893.25,BUY,3,0.02h,Stop Loss,$15.00,$-60.00,$125019.50,277,$-60.00
2025-01-22,09:42:00,21886.75,SELL,3,0.02h,Stop Loss,$6.00,$-54.00,$125025.50,277,$-54.00
2025-01-22,10:28:00,21883.5,BUY,3,0.02h,Stop Loss,$-9.00,$-63.00,$125016.50,277,$-63.00
2025-01-22,11:02:00,21886.5,SELL,3,0.02h,Stop Loss,$-9.00,$-72.00,$125007.50,277,$-72.00
2025-01-22,11:07:00,21891.5,BUY,3,0.02h,Break Even,$-1.50,$-73.50,$125006.00,277,$-73.50
2025-01-22,11:31:00,21893.75,SELL,3,0.02h,Stop Loss,$13.50,$-60.00,$125019.50,277,$-60.00
2025-01-22,11:45:00,21896.5,BUY,3,0.02h,Stop Loss,$-9.00,$-69.00,$125010.50,277,$-69.00
2025-01-22,11:48:00,21892.5,SELL,3,0.02h,Break Even,$-1.50,$-70.50,$125009.00,277,$-70.50
2025-01-22,12:11:00,21900.5,BUY,3,0.02h,Stop Loss,$-9.00,$-79.50,$125000.00,277,$-79.50
2025-01-22,13:05:00,21904.25,SELL,3,0.02h,Stop Loss,$-9.00,$-88.50,$124991.00,277,$-88.50
2025-01-22,13:07:00,21910.75,BUY,3,0.02h,Break Even,$-1.50,$-90.00,$124989.50,277,$-90.00
2025-01-22,14:04:00,21922.5,SELL,3,0.02h,Break Even,$-1.50,$-91.50,$124988.00,277,$-91.50
2025-01-22,14:32:00,21953.0,BUY,3,0.02h,Stop Loss,$153.00,$61.50,$125141.00,277,$61.50
2025-01-22,15:27:00,22009.5,SELL,3,0.02h,Stop Loss,$22.50,$84.00,$125163.50,277,$84.00
2025-01-22,15:29:00,22018.25,BUY,3,0.02h,Stop Loss,$7.50,$91.50,$125171.00,277,$91.50
2025-01-22,15:30:00,22012.75,SELL,3,0.02h,Stop Loss,$22.50,$114.00,$125193.50,277,$114.00
2025-01-22,15:31:00,22017.5,BUY,3,0.02h,Stop Loss,$37.50,$151.50,$125231.00,277,$151.50
2025-01-22,15:52:00,22014.25,SELL,3,0.02h,Stop Loss,$25.50,$177.00,$125256.50,277,$177.00
2025-01-22,16:09:00,22028.25,BUY,3,0.02h,Stop Loss,$-9.00,$168.00,$125247.50,277,$168.00
2025-01-22,16:11:00,22003.5,SELL,3,0.02h,Break Even,$-1.50,$166.50,$125246.00,277,$166.50
2025-01-22,16:18:00,22020.25,BUY,3,0.02h,Stop Loss,$22.50,$189.00,$125268.50,277,$189.00
2025-01-22,17:16:00,22067.75,SELL,3,0.02h,Break Even,$-1.50,$187.50,$125267.00,277,$187.50
2025-01-22,17:55:00,22067.0,BUY,3,0.02h,Stop Loss,$-9.00,$178.50,$125258.00,277,$178.50
2025-01-22,17:56:00,22061.0,SELL,3,0.02h,Stop Loss,$30.00,$208.50,$125288.00,277,$208.50
2025-01-22,18:41:00,22032.0,BUY,3,0.02h,Stop Loss,$3.00,$211.50,$125291.00,277,$211.50
2025-01-22,18:58:00,22022.5,SELL,3,0.02h,Stop Loss,$-9.00,$202.50,$125282.00,277,$202.50
2025-01-22,19:16:00,22033.0,BUY,3,0.02h,Break Even,$-1.50,$201.00,$125280.50,277,$201.00
2025-01-22,19:27:00,22023.5,SELL,3,0.02h,Break Even,$-1.50,$199.50,$125279.00,277,$199.50
2025-01-22,19:50:00,22029.5,BUY,3,0.02h,Break Even,$-1.50,$198.00,$125277.50,277,$198.00
2025-01-22,20:08:00,22026.5,SELL,3,0.02h,Break Even,$-1.50,$196.50,$125276.00,277,$196.50
2025-01-22,20:36:00,22026.0,BUY,3,0.02h,Stop Loss,$-9.00,$187.50,$125267.00,277,$187.50
2025-01-22,20:37:00,22014.5,SELL,3,0.02h,Stop Loss,$4.50,$192.00,$125271.50,277,$192.00
2025-01-22,21:56:00,21975.25,BUY,3,0.02h,Break Even,$-1.50,$190.50,$125270.00,277,$190.50
2025-01-22,23:10:00,21967.0,SELL,3,0.02h,Stop Loss,$-9.00,$181.50,$125261.00,277,$181.50
2025-01-22,23:45:00,21970.25,BUY,3,0.02h,Stop Loss,$-9.00,$172.50,$125252.00,277,$172.50
2025-01-22,23:48:00,21963.5,SELL,3,0.02h,Stop Loss,$-9.00,$163.50,$125243.00,277,$163.50
2025-01-22,23:50:00,21968.25,BUY,3,0.02h,Break Even,$-1.50,$162.00,$125241.50,277,$162.00
,,,,,,,,,,,
2025-01-23,00:01:00,21966.0,SELL,3,0.02h,Stop Loss,$-9.00,$-9.00,$125232.50,278,$-9.00
2025-01-23,00:02:00,21969.0,BUY,3,0.02h,Break Even,$-1.50,$-10.50,$125231.00,278,$-10.50
2025-01-23,00:13:00,21966.0,SELL,3,0.02h,Stop Loss,$-9.00,$-19.50,$125222.00,278,$-19.50
2025-01-23,00:17:00,21968.75,BUY,3,0.02h,Stop Loss,$-9.00,$-28.50,$125213.00,278,$-28.50
2025-01-23,00:18:00,21966.25,SELL,3,0.03h,Stop Loss,$-9.00,$-37.50,$125204.00,278,$-37.50
2025-01-23,01:02:00,21956.0,BUY,3,0.03h,Break Even,$-1.50,$-39.00,$125202.50,278,$-39.00
2025-01-23,01:27:00,21956.75,SELL,3,0.02h,Stop Loss,$-9.00,$-48.00,$125193.50,278,$-48.00
2025-01-23,01:31:00,21961.75,BUY,3,0.02h,Break Even,$-1.50,$-49.50,$125192.00,278,$-49.50
2025-01-23,01:36:00,21957.5,SELL,3,0.02h,Break Even,$-1.50,$-51.00,$125190.50,278,$-51.00
2025-01-23,01:39:00,21962.5,BUY,3,0.02h,Break Even,$-1.50,$-52.50,$125189.00,278,$-52.50
2025-01-23,01:46:00,21956.75,SELL,3,0.02h,Stop Loss,$9.00,$-43.50,$125198.00,278,$-43.50
2025-01-23,02:20:00,21947.5,BUY,3,0.02h,Stop Loss,$-9.00,$-52.50,$125189.00,278,$-52.50
2025-01-23,02:23:00,21944.0,SELL,3,0.02h,Stop Loss,$-9.00,$-61.50,$125180.00,278,$-61.50
2025-01-23,02:30:00,21946.5,BUY,3,0.02h,Break Even,$-1.50,$-63.00,$125178.50,278,$-63.00
2025-01-23,03:16:00,21946.25,SELL,3,0.02h,Break Even,$-1.50,$-64.50,$125177.00,278,$-64.50
2025-01-23,03:35:00,21957.25,BUY,3,0.02h,Break Even,$-1.50,$-66.00,$125175.50,278,$-66.00
2025-01-23,03:49:00,21948.75,SELL,3,0.02h,Stop Loss,$-9.00,$-75.00,$125166.50,278,$-75.00
2025-01-23,04:04:00,21956.25,BUY,3,0.02h,Stop Loss,$-9.00,$-84.00,$125157.50,278,$-84.00
2025-01-23,04:43:00,21958.5,SELL,3,0.02h,Stop Loss,$-9.00,$-93.00,$125148.50,278,$-93.00
2025-01-23,04:48:00,21962.0,BUY,3,0.03h,Break Even,$-1.50,$-94.50,$125147.00,278,$-94.50
2025-01-23,05:27:00,21964.25,SELL,3,0.02h,Stop Loss,$6.00,$-88.50,$125153.00,278,$-88.50
2025-01-23,06:14:00,21958.75,BUY,3,0.02h,Break Even,$-1.50,$-90.00,$125151.50,278,$-90.00
2025-01-23,06:25:00,21949.0,SELL,3,0.02h,Stop Loss,$-9.00,$-99.00,$125142.50,278,$-99.00
2025-01-23,07:03:00,21945.75,BUY,3,0.02h,Break Even,$-1.50,$-100.50,$125141.00,278,$-100.50
2025-01-23,07:06:00,21940.75,SELL,3,0.02h,Break Even,$-1.50,$-102.00,$125139.50,278,$-102.00
2025-01-23,07:24:00,21943.5,BUY,3,0.02h,Break Even,$-1.50,$-103.50,$125138.00,278,$-103.50
2025-01-23,07:37:00,21938.25,SELL,3,0.02h,Stop Loss,$-9.00,$-112.50,$125129.00,278,$-112.50
2025-01-23,09:08:00,21891.0,BUY,3,0.02h,Stop Loss,$-9.00,$-121.50,$125120.00,278,$-121.50
2025-01-23,09:26:00,21875.75,SELL,3,0.02h,Stop Loss,$-9.00,$-130.50,$125111.00,278,$-130.50
2025-01-23,09:36:00,21885.75,BUY,3,0.02h,Stop Loss,$6.00,$-124.50,$125117.00,278,$-124.50
2025-01-23,10:06:00,21885.75,SELL,3,0.02h,Break Even,$-1.50,$-126.00,$125115.50,278,$-126.00
2025-01-23,10:11:00,21893.75,BUY,3,0.02h,Stop Loss,$6.00,$-120.00,$125121.50,278,$-120.00
2025-01-23,10:28:00,21895.25,SELL,3,0.02h,Stop Loss,$-9.00,$-129.00,$125112.50,278,$-129.00
2025-01-23,10:29:00,21900.75,BUY,3,0.02h,Stop Loss,$-9.00,$-138.00,$125103.50,278,$-138.00
2025-01-23,10:36:00,21891.5,SELL,3,0.02h,Stop Loss,$-9.00,$-147.00,$125094.50,278,$-147.00
2025-01-23,11:04:00,21892.5,BUY,3,0.02h,Break Even,$-1.50,$-148.50,$125093.00,278,$-148.50
2025-01-23,11:11:00,21883.5,SELL,3,0.02h,Stop Loss,$-9.00,$-157.50,$125084.00,278,$-157.50
2025-01-23,11:23:00,21887.75,BUY,3,0.02h,Break Even,$-1.50,$-159.00,$125082.50,278,$-159.00
2025-01-23,11:24:00,21883.25,SELL,3,0.02h,Stop Loss,$-9.00,$-168.00,$125073.50,278,$-168.00
2025-01-23,11:25:00,21885.5,BUY,3,0.02h,Break Even,$-1.50,$-169.50,$125072.00,278,$-169.50
2025-01-23,11:26:00,21882.75,SELL,3,0.02h,Stop Loss,$31.50,$-138.00,$125103.50,278,$-138.00
2025-01-23,11:34:00,21885.5,BUY,3,0.02h,Break Even,$-1.50,$-139.50,$125102.00,278,$-139.50
2025-01-23,11:36:00,21880.75,SELL,3,0.02h,Break Even,$-1.50,$-141.00,$125100.50,278,$-141.00
2025-01-23,11:40:00,21885.25,BUY,3,0.02h,Break Even,$-1.50,$-142.50,$125099.00,278,$-142.50
2025-01-23,12:03:00,21887.5,SELL,3,0.02h,Stop Loss,$-9.00,$-151.50,$125090.00,278,$-151.50
2025-01-23,12:28:00,21892.75,BUY,3,0.02h,Stop Loss,$-9.00,$-160.50,$125081.00,278,$-160.50
2025-01-23,12:50:00,21888.75,SELL,3,0.02h,Stop Loss,$-9.00,$-169.50,$125072.00,278,$-169.50
2025-01-23,12:51:00,21895.75,BUY,3,0.02h,Stop Loss,$18.00,$-151.50,$125090.00,278,$-151.50
2025-01-23,13:11:00,21882.5,SELL,3,0.02h,Stop Loss,$-9.00,$-160.50,$125081.00,278,$-160.50
2025-01-23,13:27:00,21898.5,BUY,3,0.02h,Break Even,$-1.50,$-162.00,$125079.50,278,$-162.00
2025-01-23,13:37:00,21890.5,SELL,3,0.02h,Stop Loss,$28.50,$-133.50,$125108.00,278,$-133.50
2025-01-23,13:47:00,21897.0,BUY,3,0.02h,Break Even,$-1.50,$-135.00,$125106.50,278,$-135.00
2025-01-23,14:06:00,21892.75,SELL,3,0.02h,Break Even,$-1.50,$-136.50,$125105.00,278,$-136.50
2025-01-23,14:35:00,21897.75,BUY,3,0.02h,Stop Loss,$34.50,$-102.00,$125139.50,278,$-102.00
2025-01-23,14:57:00,21881.25,SELL,3,0.02h,Stop Loss,$-9.00,$-111.00,$125130.50,278,$-111.00
2025-01-23,15:14:00,21898.5,BUY,3,0.02h,Stop Loss,$9.00,$-102.00,$125139.50,278,$-102.00
2025-01-23,15:20:00,21882.25,SELL,3,0.02h,Break Even,$-1.50,$-103.50,$125138.00,278,$-103.50
2025-01-23,15:24:00,21907.75,BUY,3,0.02h,Stop Loss,$-9.00,$-112.50,$125129.00,278,$-112.50
2025-01-23,16:10:00,21919.25,SELL,3,0.02h,Stop Loss,$-9.00,$-121.50,$125120.00,278,$-121.50
2025-01-23,16:15:00,21939.5,BUY,3,0.02h,Stop Loss,$21.00,$-100.50,$125141.00,278,$-100.50
2025-01-23,16:18:00,21922.5,SELL,3,0.02h,Stop Loss,$22.50,$-78.00,$125163.50,278,$-78.00
2025-01-23,16:28:00,21937.75,BUY,3,0.02h,Stop Loss,$22.50,$-55.50,$125186.00,278,$-55.50
2025-01-23,17:01:00,21935.5,SELL,3,0.02h,Break Even,$-1.50,$-57.00,$125184.50,278,$-57.00
2025-01-23,17:19:00,21944.75,BUY,3,0.02h,Stop Loss,$-9.00,$-66.00,$125175.50,278,$-66.00
2025-01-23,17:24:00,21934.5,SELL,3,0.02h,Break Even,$-1.50,$-67.50,$125174.00,278,$-67.50
2025-01-23,17:49:00,21925.25,BUY,3,0.02h,Break Even,$-1.50,$-69.00,$125172.50,278,$-69.00
2025-01-23,18:48:00,21960.25,SELL,3,0.02h,Break Even,$-1.50,$-70.50,$125171.00,278,$-70.50
2025-01-23,19:27:00,21947.5,BUY,3,0.02h,Break Even,$-1.50,$-72.00,$125169.50,278,$-72.00
2025-01-23,19:55:00,21948.75,SELL,3,0.02h,Stop Loss,$3.00,$-69.00,$125172.50,278,$-69.00
2025-01-23,19:57:00,21955.75,BUY,3,0.02h,Stop Loss,$18.00,$-51.00,$125190.50,278,$-51.00
2025-01-23,20:02:00,21945.5,SELL,3,0.02h,Stop Loss,$-9.00,$-60.00,$125181.50,278,$-60.00
2025-01-23,20:08:00,21958.25,BUY,3,0.02h,Stop Loss,$4.50,$-55.50,$125186.00,278,$-55.50
2025-01-23,20:36:00,21962.0,SELL,3,0.02h,Break Even,$-1.50,$-57.00,$125184.50,278,$-57.00
2025-01-23,20:37:00,21970.5,BUY,3,0.02h,Stop Loss,$16.50,$-40.50,$125201.00,278,$-40.50
2025-01-23,20:42:00,21962.0,SELL,3,0.02h,Break Even,$-1.50,$-42.00,$125199.50,278,$-42.00
2025-01-23,20:48:00,21976.75,BUY,3,0.02h,Break Even,$-1.50,$-43.50,$125198.00,278,$-43.50
2025-01-23,21:22:00,22011.25,SELL,3,0.02h,Stop Loss,$-9.00,$-52.50,$125189.00,278,$-52.50
2025-01-23,21:38:00,22019.0,BUY,3,0.02h,Stop Loss,$-9.00,$-61.50,$125180.00,278,$-61.50
2025-01-23,21:49:00,22013.75,SELL,3,0.02h,Stop Loss,$-9.00,$-70.50,$125171.00,278,$-70.50
2025-01-23,21:53:00,22016.75,BUY,3,0.02h,Break Even,$-1.50,$-72.00,$125169.50,278,$-72.00
2025-01-23,23:02:00,22008.5,SELL,3,0.02h,Stop Loss,$7.50,$-64.50,$125177.00,278,$-64.50
2025-01-23,23:31:00,22008.5,BUY,3,0.02h,Stop Loss,$-9.00,$-73.50,$125168.00,278,$-73.50
,,,,,,,,,,,
2025-01-24,00:11:00,22006.5,SELL,3,0.02h,Stop Loss,$-9.00,$-9.00,$125159.00,279,$-9.00
2025-01-24,00:25:00,22011.75,BUY,3,0.03h,Stop Loss,$-9.00,$-18.00,$125150.00,279,$-18.00
2025-01-24,00:30:00,22007.75,SELL,3,0.02h,Break Even,$-1.50,$-19.50,$125148.50,279,$-19.50
2025-01-24,01:01:00,22009.25,BUY,3,0.02h,Stop Loss,$-9.00,$-28.50,$125139.50,279,$-28.50
2025-01-24,01:32:00,22020.25,SELL,3,0.02h,Break Even,$-1.50,$-30.00,$125138.00,279,$-30.00
2025-01-24,02:04:00,22014.25,BUY,3,0.02h,Stop Loss,$13.50,$-16.50,$125151.50,279,$-16.50
2025-01-24,03:10:00,22045.0,SELL,3,0.02h,Stop Loss,$12.00,$-4.50,$125163.50,279,$-4.50
2025-01-24,04:38:00,21995.25,BUY,3,0.02h,Stop Loss,$-9.00,$-13.50,$125154.50,279,$-13.50
2025-01-24,05:56:00,21999.75,SELL,3,0.02h,Break Even,$-1.50,$-15.00,$125153.00,279,$-15.00
2025-01-24,06:11:00,22006.25,BUY,3,0.02h,Break Even,$-1.50,$-16.50,$125151.50,279,$-16.50
2025-01-24,06:38:00,22007.0,SELL,3,0.02h,Break Even,$-1.50,$-18.00,$125150.00,279,$-18.00
2025-01-24,07:48:00,21991.25,BUY,3,0.02h,Break Even,$-1.50,$-19.50,$125148.50,279,$-19.50
2025-01-24,07:51:00,21982.75,SELL,3,0.02h,Stop Loss,$19.50,$0.00,$125168.00,279,$0.00
2025-01-24,08:05:00,21989.25,BUY,3,0.02h,Break Even,$-1.50,$-1.50,$125166.50,279,$-1.50
2025-01-24,08:44:00,21994.25,SELL,3,0.02h,Stop Loss,$-9.00,$-10.50,$125157.50,279,$-10.50
2025-01-24,09:05:00,22001.25,BUY,3,0.02h,Break Even,$-1.50,$-12.00,$125156.00,279,$-12.00
2025-01-24,09:41:00,22006.0,SELL,3,0.02h,Break Even,$-1.50,$-13.50,$125154.50,279,$-13.50
2025-01-24,10:53:00,22003.0,BUY,3,0.02h,Stop Loss,$-9.00,$-22.50,$125145.50,279,$-22.50
2025-01-24,11:12:00,21998.0,SELL,3,0.02h,Stop Loss,$-9.00,$-31.50,$125136.50,279,$-31.50
2025-01-24,11:28:00,22009.0,BUY,3,0.02h,Stop Loss,$-9.00,$-40.50,$125127.50,279,$-40.50
2025-01-24,11:31:00,21995.25,SELL,3,0.02h,Stop Loss,$-9.00,$-49.50,$125118.50,279,$-49.50
2025-01-24,11:33:00,22004.25,BUY,3,0.02h,Break Even,$-1.50,$-51.00,$125117.00,279,$-51.00
2025-01-24,11:35:00,21999.75,SELL,3,0.02h,Stop Loss,$13.50,$-37.50,$125130.50,279,$-37.50
2025-01-24,11:47:00,22004.25,BUY,3,0.02h,Stop Loss,$-9.00,$-46.50,$125121.50,279,$-46.50
2025-01-24,12:40:00,22026.25,SELL,3,0.02h,Stop Loss,$-9.00,$-55.50,$125112.50,279,$-55.50
2025-01-24,13:01:00,22029.0,BUY,3,0.02h,Stop Loss,$-9.00,$-64.50,$125103.50,279,$-64.50
2025-01-24,13:05:00,22023.75,SELL,3,0.02h,Stop Loss,$-9.00,$-73.50,$125094.50,279,$-73.50
2025-01-24,13:06:00,22026.25,BUY,3,0.02h,Break Even,$-1.50,$-75.00,$125093.00,279,$-75.00
2025-01-24,13:09:00,22020.25,SELL,3,0.02h,Stop Loss,$36.00,$-39.00,$125129.00,279,$-39.00
2025-01-24,13:57:00,22007.75,BUY,3,0.02h,Break Even,$-1.50,$-40.50,$125127.50,279,$-40.50
2025-01-24,14:33:00,22017.75,SELL,3,0.02h,Stop Loss,$15.00,$-25.50,$125142.50,279,$-25.50
2025-01-24,14:46:00,22048.75,BUY,3,0.02h,Stop Loss,$16.50,$-9.00,$125159.00,279,$-9.00
2025-01-24,15:04:00,22030.25,SELL,3,0.02h,Stop Loss,$58.50,$49.50,$125217.50,279,$49.50
2025-01-24,16:11:00,22000.25,BUY,3,0.02h,Stop Loss,$13.50,$63.00,$125231.00,279,$63.00
2025-01-24,16:18:00,21988.0,SELL,3,0.02h,Break Even,$-1.50,$61.50,$125229.50,279,$61.50
2025-01-24,16:21:00,22003.5,BUY,3,0.02h,Stop Loss,$6.00,$67.50,$125235.50,279,$67.50
2025-01-24,16:57:00,21995.0,SELL,3,0.02h,Break Even,$-1.50,$66.00,$125234.00,279,$66.00
2025-01-24,17:23:00,22001.0,BUY,3,0.02h,Stop Loss,$24.00,$90.00,$125258.00,279,$90.00
2025-01-24,17:29:00,21979.75,SELL,3,0.02h,Stop Loss,$66.00,$156.00,$125324.00,279,$156.00
2025-01-24,18:24:00,21947.75,BUY,3,0.02h,Stop Loss,$-9.00,$147.00,$125315.00,279,$147.00
2025-01-24,18:30:00,21935.0,SELL,3,0.02h,Stop Loss,$13.50,$160.50,$125328.50,279,$160.50
2025-01-24,18:32:00,21943.5,BUY,3,0.02h,Stop Loss,$-9.00,$151.50,$125319.50,279,$151.50
2025-01-24,18:33:00,21937.0,SELL,3,0.02h,Stop Loss,$45.00,$196.50,$125364.50,279,$196.50
2025-01-24,19:27:00,21875.0,BUY,3,0.02h,Stop Loss,$3.00,$199.50,$125367.50,279,$199.50
2025-01-24,20:01:00,21866.5,SELL,3,0.02h,Break Even,$-1.50,$198.00,$125366.00,279,$198.00
2025-01-24,20:04:00,21885.75,BUY,3,0.02h,Break Even,$-1.50,$196.50,$125364.50,279,$196.50
2025-01-24,20:11:00,21874.75,SELL,3,0.02h,Stop Loss,$-9.00,$187.50,$125355.50,279,$187.50
2025-01-24,20:12:00,21885.0,BUY,3,0.02h,Stop Loss,$15.00,$202.50,$125370.50,279,$202.50
2025-01-24,20:20:00,21871.75,SELL,3,0.02h,Break Even,$-1.50,$201.00,$125369.00,279,$201.00
2025-01-24,20:37:00,21875.75,BUY,3,0.02h,Stop Loss,$6.00,$207.00,$125375.00,279,$207.00
2025-01-24,20:40:00,21874.25,SELL,3,0.02h,Stop Loss,$24.00,$231.00,$125399.00,279,$231.00
2025-01-24,20:49:00,21876.5,BUY,3,0.02h,Stop Loss,$7.50,$238.50,$125406.50,279,$238.50
2025-01-24,21:16:00,21897.0,SELL,3,0.02h,Break Even,$-1.50,$237.00,$125405.00,279,$237.00
2025-01-24,21:27:00,21900.75,BUY,3,0.05h,Break Even,$-1.50,$235.50,$125403.50,279,$235.50
2025-01-24,21:42:00,21898.25,SELL,3,0.02h,Stop Loss,$-9.00,$226.50,$125394.50,279,$226.50
2025-01-24,21:47:00,21904.75,BUY,3,0.02h,Stop Loss,$-9.00,$217.50,$125385.50,279,$217.50
,,,,,,,,,,,
2025-01-27,00:00:00,21666.0,SELL,3,0.02h,Stop Loss,$4.50,$4.50,$125390.00,280,$4.50
2025-01-27,01:13:00,21614.5,BUY,3,0.02h,Break Even,$-1.50,$3.00,$125388.50,280,$3.00
2025-01-27,01:23:00,21580.0,SELL,3,0.02h,Break Even,$-1.50,$1.50,$125387.00,280,$1.50
2025-01-27,02:26:00,21525.25,BUY,3,0.02h,Break Even,$-1.50,$0.00,$125385.50,280,$0.00
2025-01-27,02:59:00,21527.75,SELL,3,0.02h,Stop Loss,$15.00,$15.00,$125400.50,280,$15.00
2025-01-27,03:04:00,21539.5,BUY,3,0.02h,Stop Loss,$-9.00,$6.00,$125391.50,280,$6.00
2025-01-27,03:35:00,21539.0,SELL,3,0.02h,Stop Loss,$70.50,$76.50,$125462.00,280,$76.50
2025-01-27,03:44:00,21547.25,BUY,3,0.02h,Break Even,$-1.50,$75.00,$125460.50,280,$75.00
2025-01-27,03:45:00,21541.0,SELL,3,0.02h,Stop Loss,$15.00,$90.00,$125475.50,280,$90.00
2025-01-27,04:58:00,21499.25,BUY,3,0.02h,Stop Loss,$-9.00,$81.00,$125466.50,280,$81.00
2025-01-27,05:09:00,21480.25,SELL,3,0.02h,Break Even,$-1.50,$79.50,$125465.00,280,$79.50
2025-01-27,06:20:00,21432.25,BUY,3,0.02h,Stop Loss,$-9.00,$70.50,$125456.00,280,$70.50
2025-01-27,06:23:00,21417.75,SELL,3,0.02h,Stop Loss,$16.50,$87.00,$125472.50,280,$87.00
2025-01-27,06:57:00,21397.0,BUY,3,0.02h,Stop Loss,$24.00,$111.00,$125496.50,280,$111.00
2025-01-27,07:09:00,21383.75,SELL,3,0.02h,Stop Loss,$3.00,$114.00,$125499.50,280,$114.00
2025-01-27,07:46:00,21346.75,BUY,3,0.02h,Stop Loss,$-9.00,$105.00,$125490.50,280,$105.00
2025-01-27,07:47:00,21334.5,SELL,3,0.02h,Stop Loss,$-9.00,$96.00,$125481.50,280,$96.00
2025-01-27,07:51:00,21351.25,BUY,3,0.02h,Break Even,$-1.50,$94.50,$125480.00,280,$94.50
2025-01-27,07:55:00,21334.5,SELL,3,0.02h,Stop Loss,$118.50,$213.00,$125598.50,280,$213.00
2025-01-27,08:36:00,21260.75,BUY,3,0.02h,Stop Loss,$64.50,$277.50,$125663.00,280,$277.50
2025-01-27,08:39:00,21243.5,SELL,3,0.02h,Stop Loss,$115.50,$393.00,$125778.50,280,$393.00
2025-01-27,09:09:00,21247.5,BUY,3,0.02h,Stop Loss,$34.50,$427.50,$125813.00,280,$427.50
2025-01-27,09:22:00,21229.5,SELL,3,0.02h,Stop Loss,$6.00,$433.50,$125819.00,280,$433.50
2025-01-27,11:08:00,20960.25,BUY,3,0.02h,Stop Loss,$58.50,$492.00,$125877.50,280,$492.00
2025-01-27,11:27:00,20921.25,SELL,3,0.02h,Stop Loss,$52.50,$544.50,$125930.00,280,$544.50
2025-01-27,11:34:00,20973.75,BUY,3,0.02h,Stop Loss,$108.00,$652.50,$126038.00,280,$652.50
2025-01-27,13:02:00,21050.5,SELL,3,0.02h,Stop Loss,$82.50,$735.00,$126120.50,280,$735.00
2025-01-27,13:07:00,21099.25,BUY,3,0.02h,Stop Loss,$72.00,$807.00,$126192.50,280,$807.00
2025-01-27,13:44:00,21130.5,SELL,3,0.02h,Break Even,$-1.50,$805.50,$126191.00,280,$805.50
2025-01-27,13:47:00,21144.5,BUY,3,0.02h,Stop Loss,$24.00,$829.50,$126215.00,280,$829.50
2025-01-27,14:08:00,21140.5,SELL,3,0.02h,Stop Loss,$22.50,$852.00,$126237.50,280,$852.00
2025-01-27,14:31:00,21172.5,BUY,3,0.02h,Stop Loss,$478.50,$1330.50,$126716.00,280,$1330.50
2025-01-27,15:16:00,21282.25,SELL,3,0.02h,Stop Loss,$129.00,$1459.50,$126845.00,280,$1459.50
2025-01-27,15:26:00,21318.5,BUY,3,0.02h,Stop Loss,$79.50,$1539.00,$126924.50,280,$1539.00
2025-01-27,15:53:00,21351.5,SELL,3,0.02h,Stop Loss,$90.00,$1629.00,$127014.50,280,$1629.00
2025-01-27,16:48:00,21268.5,BUY,3,0.02h,Stop Loss,$25.50,$1654.50,$127040.00,280,$1654.50
2025-01-27,16:55:00,21193.25,SELL,3,0.02h,Stop Loss,$34.50,$1689.00,$127074.50,280,$1689.00
2025-01-27,17:03:00,21250.25,BUY,3,0.02h,Stop Loss,$82.50,$1771.50,$127157.00,280,$1771.50
2025-01-27,17:10:00,21204.25,SELL,3,0.02h,Stop Loss,$25.50,$1797.00,$127182.50,280,$1797.00
2025-01-27,17:30:00,21227.0,BUY,3,0.02h,Stop Loss,$-9.00,$1788.00,$127173.50,280,$1788.00
2025-01-27,17:46:00,21206.25,SELL,3,0.02h,Stop Loss,$57.00,$1845.00,$127230.50,280,$1845.00
2025-01-27,18:17:00,21186.0,BUY,3,0.02h,Stop Loss,$10.50,$1855.50,$127241.00,280,$1855.50
2025-01-27,18:19:00,21161.25,SELL,3,0.02h,Stop Loss,$19.50,$1875.00,$127260.50,280,$1875.00
2025-01-27,18:21:00,21178.5,BUY,3,0.02h,Break Even,$-1.50,$1873.50,$127259.00,280,$1873.50
2025-01-27,18:22:00,21166.5,SELL,3,0.02h,Stop Loss,$3.00,$1876.50,$127262.00,280,$1876.50
2025-01-27,18:34:00,21194.25,BUY,3,0.02h,Stop Loss,$27.00,$1903.50,$127289.00,280,$1903.50
2025-01-27,18:55:00,21180.25,SELL,3,0.02h,Stop Loss,$57.00,$1960.50,$127346.00,280,$1960.50
2025-01-27,19:14:00,21180.0,BUY,3,0.02h,Stop Loss,$18.00,$1978.50,$127364.00,280,$1978.50
2025-01-27,19:15:00,21171.5,SELL,3,0.02h,Stop Loss,$3.00,$1981.50,$127367.00,280,$1981.50
2025-01-27,19:16:00,21187.75,BUY,3,0.02h,Stop Loss,$16.50,$1998.00,$127383.50,280,$1998.00
2025-01-27,19:41:00,21205.0,SELL,3,0.02h,Stop Loss,$75.00,$2073.00,$127458.50,280,$2073.00
2025-01-27,20:09:00,21172.25,BUY,3,0.02h,Stop Loss,$57.00,$2130.00,$127515.50,280,$2130.00
2025-01-27,21:44:00,21305.0,SELL,3,0.02h,Break Even,$-1.50,$2128.50,$127514.00,280,$2128.50
2025-01-27,23:01:00,21353.75,BUY,3,0.02h,Stop Loss,$-9.00,$2119.50,$127505.00,280,$2119.50
2025-01-27,23:17:00,21307.0,SELL,3,0.02h,Break Even,$-1.50,$2118.00,$127503.50,280,$2118.00
2025-01-27,23:43:00,21303.5,BUY,3,0.02h,Stop Loss,$-9.00,$2109.00,$127494.50,280,$2109.00
,,,,,,,,,,,
2025-01-28,00:14:00,21308.75,SELL,3,0.02h,Stop Loss,$-9.00,$-9.00,$127485.50,281,$-9.00
2025-01-28,01:02:00,21292.5,BUY,3,0.02h,Stop Loss,$-9.00,$-18.00,$127476.50,281,$-18.00
2025-01-28,01:47:00,21302.25,SELL,3,0.02h,Stop Loss,$61.50,$43.50,$127538.00,281,$43.50
2025-01-28,02:14:00,21293.5,BUY,3,0.02h,Break Even,$-1.50,$42.00,$127536.50,281,$42.00
2025-01-28,02:39:00,21285.25,SELL,3,0.02h,Stop Loss,$21.00,$63.00,$127557.50,281,$63.00
2025-01-28,02:56:00,21291.0,BUY,3,0.02h,Break Even,$-1.50,$61.50,$127556.00,281,$61.50
2025-01-28,03:41:00,21304.5,SELL,3,0.02h,Break Even,$-1.50,$60.00,$127554.50,281,$60.00
2025-01-28,04:14:00,21299.0,BUY,3,0.02h,Break Even,$-1.50,$58.50,$127553.00,281,$58.50
2025-01-28,04:21:00,21285.0,SELL,3,0.02h,Stop Loss,$-9.00,$49.50,$127544.00,281,$49.50
2025-01-28,04:23:00,21297.0,BUY,3,0.02h,Stop Loss,$-9.00,$40.50,$127535.00,281,$40.50
2025-01-28,04:27:00,21290.0,SELL,3,0.02h,Stop Loss,$51.00,$91.50,$127586.00,281,$91.50
2025-01-28,04:37:00,21297.75,BUY,3,0.02h,Break Even,$-1.50,$90.00,$127584.50,281,$90.00
2025-01-28,04:52:00,21292.0,SELL,3,0.02h,Stop Loss,$-9.00,$81.00,$127575.50,281,$81.00
2025-01-28,04:53:00,21295.75,BUY,3,0.02h,Stop Loss,$-9.00,$72.00,$127566.50,281,$72.00
2025-01-28,04:56:00,21293.5,SELL,3,0.02h,Stop Loss,$-9.00,$63.00,$127557.50,281,$63.00
2025-01-28,04:58:00,21295.75,BUY,3,0.02h,Stop Loss,$33.00,$96.00,$127590.50,281,$96.00
2025-01-28,05:09:00,21290.75,SELL,3,0.02h,Break Even,$-1.50,$94.50,$127589.00,281,$94.50
2025-01-28,05:59:00,21283.5,BUY,3,0.02h,Stop Loss,$37.50,$132.00,$127626.50,281,$132.00
2025-01-28,06:27:00,21289.25,SELL,3,0.02h,Break Even,$-1.50,$130.50,$127625.00,281,$130.50
2025-01-28,06:31:00,21307.5,BUY,3,0.02h,Stop Loss,$9.00,$139.50,$127634.00,281,$139.50
2025-01-28,06:40:00,21279.25,SELL,3,0.02h,Stop Loss,$46.50,$186.00,$127680.50,281,$186.00
2025-01-28,06:59:00,21289.0,BUY,3,0.02h,Break Even,$-1.50,$184.50,$127679.00,281,$184.50
2025-01-28,07:03:00,21283.5,SELL,3,0.02h,Stop Loss,$3.00,$187.50,$127682.00,281,$187.50
2025-01-28,07:06:00,21290.25,BUY,3,0.02h,Stop Loss,$19.50,$207.00,$127701.50,281,$207.00
2025-01-28,07:54:00,21326.0,SELL,3,0.02h,Break Even,$-1.50,$205.50,$127700.00,281,$205.50
2025-01-28,08:00:00,21341.0,BUY,3,0.02h,Stop Loss,$22.50,$228.00,$127722.50,281,$228.00
2025-01-28,08:07:00,21315.0,SELL,3,0.02h,Stop Loss,$-9.00,$219.00,$127713.50,281,$219.00
2025-01-28,08:34:00,21325.0,BUY,3,0.02h,Stop Loss,$3.00,$222.00,$127716.50,281,$222.00
2025-01-28,09:20:00,21375.0,SELL,3,0.02h,Stop Loss,$6.00,$228.00,$127722.50,281,$228.00
2025-01-28,09:44:00,21374.75,BUY,3,0.02h,Break Even,$-1.50,$226.50,$127721.00,281,$226.50
2025-01-28,10:35:00,21403.75,SELL,3,0.02h,Break Even,$-1.50,$225.00,$127719.50,281,$225.00
2025-01-28,10:52:00,21408.0,BUY,3,0.02h,Stop Loss,$-9.00,$216.00,$127710.50,281,$216.00
2025-01-28,10:53:00,21400.25,SELL,3,0.02h,Stop Loss,$-9.00,$207.00,$127701.50,281,$207.00
2025-01-28,11:08:00,21402.75,BUY,3,0.02h,Stop Loss,$-9.00,$198.00,$127692.50,281,$198.00
2025-01-28,11:10:00,21397.5,SELL,3,0.02h,Stop Loss,$-9.00,$189.00,$127683.50,281,$189.00
2025-01-28,11:14:00,21402.75,BUY,3,0.02h,Stop Loss,$36.00,$225.00,$127719.50,281,$225.00
2025-01-28,11:19:00,21390.0,SELL,3,0.02h,Stop Loss,$9.00,$234.00,$127728.50,281,$234.00
2025-01-28,12:48:00,21286.25,BUY,3,0.02h,Break Even,$-1.50,$232.50,$127727.00,281,$232.50
2025-01-28,13:10:00,21296.75,SELL,3,0.02h,Break Even,$-1.50,$231.00,$127725.50,281,$231.00
2025-01-28,13:11:00,21302.5,BUY,3,0.02h,Stop Loss,$4.50,$235.50,$127730.00,281,$235.50
2025-01-28,13:36:00,21299.5,SELL,3,0.02h,Stop Loss,$9.00,$244.50,$127739.00,281,$244.50
2025-01-28,14:26:00,21307.25,BUY,3,0.02h,Break Even,$-1.50,$243.00,$127737.50,281,$243.00
2025-01-28,14:32:00,21251.75,SELL,3,0.02h,Stop Loss,$45.00,$288.00,$127782.50,281,$288.00
2025-01-28,14:55:00,21265.0,BUY,3,0.02h,Stop Loss,$27.00,$315.00,$127809.50,281,$315.00
2025-01-28,15:54:00,21415.75,SELL,3,0.02h,Stop Loss,$30.00,$345.00,$127839.50,281,$345.00
2025-01-28,15:59:00,21451.0,BUY,3,0.02h,Stop Loss,$25.50,$370.50,$127865.00,281,$370.50
2025-01-28,16:21:00,21444.25,SELL,3,0.02h,Stop Loss,$31.50,$402.00,$127896.50,281,$402.00
2025-01-28,16:48:00,21436.0,BUY,3,0.02h,Stop Loss,$46.50,$448.50,$127943.00,281,$448.50
2025-01-28,17:44:00,21531.0,SELL,3,0.02h,Break Even,$-1.50,$447.00,$127941.50,281,$447.00
2025-01-28,17:56:00,21552.25,BUY,3,0.02h,Stop Loss,$-9.00,$438.00,$127932.50,281,$438.00
2025-01-28,18:27:00,21551.75,SELL,3,0.02h,Stop Loss,$10.50,$448.50,$127943.00,281,$448.50
2025-01-28,19:19:00,21545.75,BUY,3,0.02h,Stop Loss,$36.00,$484.50,$127979.00,281,$484.50
2025-01-28,20:06:00,21594.75,SELL,3,0.02h,Stop Loss,$18.00,$502.50,$127997.00,281,$502.50
2025-01-28,20:16:00,21608.5,BUY,3,0.02h,Stop Loss,$31.50,$534.00,$128028.50,281,$534.00
2025-01-28,20:38:00,21600.75,SELL,3,0.02h,Stop Loss,$3.00,$537.00,$128031.50,281,$537.00
2025-01-28,21:49:00,21562.25,BUY,3,0.02h,Break Even,$-1.50,$535.50,$128030.00,281,$535.50
2025-01-28,21:57:00,21558.0,SELL,3,0.02h,Break Even,$-1.50,$534.00,$128028.50,281,$534.00
2025-01-28,23:16:00,21556.5,BUY,3,0.02h,Stop Loss,$33.00,$567.00,$128061.50,281,$567.00
2025-01-28,23:35:00,21558.75,SELL,3,0.02h,Break Even,$-1.50,$565.50,$128060.00,281,$565.50
,,,,,,,,,,,
2025-01-29,00:07:00,21571.5,BUY,3,0.02h,Stop Loss,$-9.00,$-9.00,$128051.00,282,$-9.00
2025-01-29,00:15:00,21553.0,SELL,3,0.02h,Stop Loss,$-9.00,$-18.00,$128042.00,282,$-18.00
2025-01-29,00:32:00,21557.25,BUY,3,0.02h,Stop Loss,$-9.00,$-27.00,$128033.00,282,$-27.00
2025-01-29,00:37:00,21551.25,SELL,3,0.02h,Stop Loss,$9.00,$-18.00,$128042.00,282,$-18.00
2025-01-29,00:44:00,21556.5,BUY,3,0.02h,Break Even,$-1.50,$-19.50,$128040.50,282,$-19.50
2025-01-29,01:09:00,21555.0,SELL,3,0.02h,Stop Loss,$-9.00,$-28.50,$128031.50,282,$-28.50
2025-01-29,01:16:00,21564.0,BUY,3,0.02h,Stop Loss,$-9.00,$-37.50,$128022.50,282,$-37.50
2025-01-29,01:57:00,21568.5,SELL,3,0.02h,Break Even,$-1.50,$-39.00,$128021.00,282,$-39.00
2025-01-29,02:31:00,21571.0,BUY,3,0.02h,Break Even,$-1.50,$-40.50,$128019.50,282,$-40.50
2025-01-29,03:08:00,21572.25,SELL,3,0.05h,Stop Loss,$12.00,$-28.50,$128031.50,282,$-28.50
2025-01-29,03:40:00,21570.5,BUY,3,0.02h,Break Even,$-1.50,$-30.00,$128030.00,282,$-30.00
2025-01-29,04:42:00,21597.25,SELL,3,0.02h,Stop Loss,$-9.00,$-39.00,$128021.00,282,$-39.00
2025-01-29,04:43:00,21605.75,BUY,3,0.02h,Stop Loss,$-9.00,$-48.00,$128012.00,282,$-48.00
2025-01-29,04:56:00,21596.5,SELL,3,0.02h,Stop Loss,$-9.00,$-57.00,$128003.00,282,$-57.00
2025-01-29,05:18:00,21602.0,BUY,3,0.02h,Stop Loss,$-9.00,$-66.00,$127994.00,282,$-66.00
2025-01-29,05:31:00,21596.0,SELL,3,0.03h,Stop Loss,$13.50,$-52.50,$128007.50,282,$-52.50
2025-01-29,06:01:00,21643.0,BUY,3,0.02h,Stop Loss,$199.50,$147.00,$128207.00,282,$147.00
2025-01-29,07:00:00,21662.75,SELL,3,0.02h,Stop Loss,$31.50,$178.50,$128238.50,282,$178.50
2025-01-29,07:34:00,21659.25,BUY,3,0.02h,Stop Loss,$-9.00,$169.50,$128229.50,282,$169.50
2025-01-29,07:41:00,21651.0,SELL,3,0.02h,Break Even,$-1.50,$168.00,$128228.00,282,$168.00
2025-01-29,07:52:00,21658.5,BUY,3,0.02h,Stop Loss,$9.00,$177.00,$128237.00,282,$177.00
2025-01-29,08:39:00,21672.5,SELL,3,0.02h,Stop Loss,$-9.00,$168.00,$128228.00,282,$168.00
2025-01-29,09:14:00,21673.0,BUY,3,0.02h,Break Even,$-1.50,$166.50,$128226.50,282,$166.50
2025-01-29,09:18:00,21650.75,SELL,3,0.02h,Break Even,$-1.50,$165.00,$128225.00,282,$165.00
2025-01-29,09:44:00,21658.25,BUY,3,0.02h,Stop Loss,$-9.00,$156.00,$128216.00,282,$156.00
2025-01-29,10:05:00,21657.25,SELL,3,0.02h,Break Even,$-1.50,$154.50,$128214.50,282,$154.50
2025-01-29,10:13:00,21666.75,BUY,3,0.02h,Stop Loss,$-9.00,$145.50,$128205.50,282,$145.50
2025-01-29,10:19:00,21658.5,SELL,3,0.02h,Break Even,$-1.50,$144.00,$128204.00,282,$144.00
2025-01-29,10:37:00,21667.0,BUY,3,0.02h,Stop Loss,$19.50,$163.50,$128223.50,282,$163.50
2025-01-29,11:01:00,21660.25,SELL,3,0.02h,Break Even,$-1.50,$162.00,$128222.00,282,$162.00
2025-01-29,11:42:00,21661.25,BUY,3,0.02h,Stop Loss,$18.00,$180.00,$128240.00,282,$180.00
2025-01-29,12:08:00,21666.25,SELL,3,0.02h,Stop Loss,$22.50,$202.50,$128262.50,282,$202.50
2025-01-29,12:26:00,21672.5,BUY,3,0.02h,Break Even,$-1.50,$201.00,$128261.00,282,$201.00
2025-01-29,12:34:00,21662.75,SELL,3,0.02h,Stop Loss,$7.50,$208.50,$128268.50,282,$208.50
2025-01-29,13:58:00,21588.0,BUY,3,0.02h,Stop Loss,$45.00,$253.50,$128313.50,282,$253.50
2025-01-29,14:31:00,21583.5,SELL,3,0.02h,Stop Loss,$93.00,$346.50,$128406.50,282,$346.50
2025-01-29,15:03:00,21556.5,BUY,3,0.02h,Stop Loss,$6.00,$352.50,$128412.50,282,$352.50
2025-01-29,15:05:00,21529.5,SELL,3,0.02h,Break Even,$-1.50,$351.00,$128411.00,282,$351.00
2025-01-29,15:07:00,21547.75,BUY,3,0.02h,Stop Loss,$48.00,$399.00,$128459.00,282,$399.00
2025-01-29,15:14:00,21522.25,SELL,3,0.02h,Stop Loss,$-9.00,$390.00,$128450.00,282,$390.00
2025-01-29,15:23:00,21547.25,BUY,3,0.02h,Break Even,$-1.50,$388.50,$128448.50,282,$388.50
2025-01-29,15:26:00,21507.0,SELL,3,0.02h,Stop Loss,$87.00,$475.50,$128535.50,282,$475.50
2025-01-29,15:54:00,21518.25,BUY,3,0.02h,Stop Loss,$48.00,$523.50,$128583.50,282,$523.50
2025-01-29,16:08:00,21492.25,SELL,3,0.02h,Stop Loss,$28.50,$552.00,$128612.00,282,$552.00
2025-01-29,16:26:00,21509.25,BUY,3,0.02h,Stop Loss,$-9.00,$543.00,$128603.00,282,$543.00
2025-01-29,16:31:00,21488.0,SELL,3,0.02h,Stop Loss,$16.50,$559.50,$128619.50,282,$559.50
2025-01-29,16:36:00,21502.5,BUY,3,0.02h,Stop Loss,$22.50,$582.00,$128642.00,282,$582.00
2025-01-29,16:39:00,21486.75,SELL,3,0.02h,Stop Loss,$78.00,$660.00,$128720.00,282,$660.00
2025-01-29,16:50:00,21505.25,BUY,3,0.02h,Stop Loss,$4.50,$664.50,$128724.50,282,$664.50
2025-01-29,16:57:00,21472.75,SELL,3,0.02h,Stop Loss,$6.00,$670.50,$128730.50,282,$670.50
2025-01-29,17:02:00,21514.0,BUY,3,0.02h,Break Even,$-1.50,$669.00,$128729.00,282,$669.00
2025-01-29,17:46:00,21515.5,SELL,3,0.02h,Stop Loss,$36.00,$705.00,$128765.00,282,$705.00
2025-01-29,18:27:00,21468.5,BUY,3,0.02h,Stop Loss,$18.00,$723.00,$128783.00,282,$723.00
2025-01-29,18:43:00,21458.5,SELL,3,0.02h,Break Even,$-1.50,$721.50,$128781.50,282,$721.50
2025-01-29,18:49:00,21487.75,BUY,3,0.02h,Stop Loss,$18.00,$739.50,$128799.50,282,$739.50
2025-01-29,19:01:00,21416.5,SELL,3,0.02h,Stop Loss,$31.50,$771.00,$128831.00,282,$771.00
2025-01-29,19:33:00,21469.0,BUY,3,0.02h,Stop Loss,$31.50,$802.50,$128862.50,282,$802.50
2025-01-29,19:37:00,21400.0,SELL,3,0.02h,Stop Loss,$9.00,$811.50,$128871.50,282,$811.50
2025-01-29,19:38:00,21445.75,BUY,3,0.02h,Stop Loss,$249.00,$1060.50,$129120.50,282,$1060.50
2025-01-29,20:05:00,21496.25,SELL,3,0.02h,Stop Loss,$30.00,$1090.50,$129150.50,282,$1090.50
2025-01-29,20:12:00,21527.25,BUY,3,0.02h,Stop Loss,$16.50,$1107.00,$129167.00,282,$1107.00
2025-01-29,20:14:00,21499.5,SELL,3,0.02h,Stop Loss,$100.50,$1207.50,$129267.50,282,$1207.50
2025-01-29,20:23:00,21551.5,BUY,3,0.02h,Stop Loss,$30.00,$1237.50,$129297.50,282,$1237.50
2025-01-29,20:40:00,21521.5,SELL,3,0.02h,Stop Loss,$12.00,$1249.50,$129309.50,282,$1249.50
2025-01-29,21:17:00,21511.25,BUY,3,0.02h,Stop Loss,$4.50,$1254.00,$129314.00,282,$1254.00
2025-01-29,21:19:00,21484.25,SELL,3,0.02h,Break Even,$-1.50,$1252.50,$129312.50,282,$1252.50
2025-01-29,21:20:00,21507.75,BUY,3,0.02h,Stop Loss,$70.50,$1323.00,$129383.00,282,$1323.00
2025-01-29,23:01:00,21537.5,SELL,3,0.02h,Stop Loss,$-9.00,$1314.00,$129374.00,282,$1314.00
2025-01-29,23:46:00,21541.0,BUY,3,0.02h,Stop Loss,$4.50,$1318.50,$129378.50,282,$1318.50
,,,,,,,,,,,
2025-01-30,00:03:00,21529.5,SELL,3,0.02h,Break Even,$-1.50,$-1.50,$129377.00,283,$-1.50
2025-01-30,00:08:00,21539.75,BUY,3,0.02h,Stop Loss,$34.50,$33.00,$129411.50,283,$33.00
2025-01-30,02:44:00,21663.75,SELL,3,0.02h,Stop Loss,$-9.00,$24.00,$129402.50,283,$24.00
2025-01-30,03:13:00,21663.75,BUY,3,0.02h,Break Even,$-1.50,$22.50,$129401.00,283,$22.50
2025-01-30,03:36:00,21658.0,SELL,3,0.02h,Stop Loss,$-9.00,$13.50,$129392.00,283,$13.50
2025-01-30,03:51:00,21667.5,BUY,3,0.02h,Break Even,$-1.50,$12.00,$129390.50,283,$12.00
2025-01-30,04:29:00,21673.25,SELL,3,0.02h,Break Even,$-1.50,$10.50,$129389.00,283,$10.50
2025-01-30,05:27:00,21657.75,BUY,3,0.02h,Break Even,$-1.50,$9.00,$129387.50,283,$9.00
2025-01-30,05:33:00,21649.25,SELL,3,0.02h,Stop Loss,$-9.00,$0.00,$129378.50,283,$0.00
2025-01-30,05:45:00,21659.5,BUY,3,0.02h,Stop Loss,$-9.00,$-9.00,$129369.50,283,$-9.00
2025-01-30,06:10:00,21652.25,SELL,3,0.02h,Stop Loss,$-9.00,$-18.00,$129360.50,283,$-18.00
2025-01-30,06:55:00,21642.25,BUY,3,0.02h,Stop Loss,$-9.00,$-27.00,$129351.50,283,$-27.00
2025-01-30,07:01:00,21626.25,SELL,3,0.02h,Break Even,$-1.50,$-28.50,$129350.00,283,$-28.50
2025-01-30,07:17:00,21636.0,BUY,3,0.02h,Stop Loss,$10.50,$-18.00,$129360.50,283,$-18.00
2025-01-30,08:36:00,21686.75,SELL,3,0.02h,Break Even,$-1.50,$-19.50,$129359.00,283,$-19.50
2025-01-30,08:48:00,21695.5,BUY,3,0.02h,Stop Loss,$-9.00,$-28.50,$129350.00,283,$-28.50
2025-01-30,09:03:00,21681.75,SELL,3,0.02h,Break Even,$-1.50,$-30.00,$129348.50,283,$-30.00
2025-01-30,10:34:00,21636.25,BUY,3,0.02h,Break Even,$-1.50,$-31.50,$129347.00,283,$-31.50
2025-01-30,10:53:00,21625.0,SELL,3,0.02h,Break Even,$-1.50,$-33.00,$129345.50,283,$-33.00
2025-01-30,11:05:00,21630.75,BUY,3,0.02h,Break Even,$-1.50,$-34.50,$129344.00,283,$-34.50
2025-01-30,11:07:00,21626.0,SELL,3,0.02h,Stop Loss,$-9.00,$-43.50,$129335.00,283,$-43.50
2025-01-30,11:09:00,21637.0,BUY,3,0.02h,Break Even,$-1.50,$-45.00,$129333.50,283,$-45.00
2025-01-30,11:47:00,21646.75,SELL,3,0.02h,Stop Loss,$3.00,$-42.00,$129336.50,283,$-42.00
2025-01-30,12:38:00,21616.0,BUY,3,0.02h,Stop Loss,$-9.00,$-51.00,$129327.50,283,$-51.00
2025-01-30,13:25:00,21630.5,SELL,3,0.02h,Stop Loss,$-9.00,$-60.00,$129318.50,283,$-60.00
2025-01-30,13:31:00,21639.25,BUY,3,0.02h,Stop Loss,$133.50,$73.50,$129452.00,283,$73.50
2025-01-30,13:38:00,21620.5,SELL,3,0.02h,Stop Loss,$27.00,$100.50,$129479.00,283,$100.50
2025-01-30,13:53:00,21636.5,BUY,3,0.02h,Stop Loss,$34.50,$135.00,$129513.50,283,$135.00
2025-01-30,14:17:00,21640.25,SELL,3,0.02h,Stop Loss,$37.50,$172.50,$129551.00,283,$172.50
2025-01-30,14:32:00,21661.75,BUY,3,0.02h,Stop Loss,$21.00,$193.50,$129572.00,283,$193.50
2025-01-30,14:35:00,21619.75,SELL,3,0.02h,Stop Loss,$114.00,$307.50,$129686.00,283,$307.50
2025-01-30,14:41:00,21654.25,BUY,3,0.02h,Break Even,$-1.50,$306.00,$129684.50,283,$306.00
2025-01-30,14:43:00,21627.25,SELL,3,0.02h,Stop Loss,$28.50,$334.50,$129713.00,283,$334.50
2025-01-30,14:44:00,21647.25,BUY,3,0.02h,Stop Loss,$15.00,$349.50,$129728.00,283,$349.50
2025-01-30,15:02:00,21648.0,SELL,3,0.02h,Stop Loss,$325.50,$675.00,$130053.50,283,$675.00
2025-01-30,15:49:00,21579.25,BUY,3,0.02h,Stop Loss,$-9.00,$666.00,$130044.50,283,$666.00
2025-01-30,15:51:00,21557.0,SELL,3,0.02h,Stop Loss,$51.00,$717.00,$130095.50,283,$717.00
2025-01-30,16:23:00,21500.5,BUY,3,0.02h,Stop Loss,$84.00,$801.00,$130179.50,283,$801.00
2025-01-30,17:13:00,21571.25,SELL,3,0.02h,Stop Loss,$105.00,$906.00,$130284.50,283,$906.00
2025-01-30,17:49:00,21540.5,BUY,3,0.02h,Stop Loss,$-9.00,$897.00,$130275.50,283,$897.00
2025-01-30,19:32:00,21602.5,SELL,3,0.02h,Stop Loss,$6.00,$903.00,$130281.50,283,$903.00
2025-01-30,19:39:00,21611.75,BUY,3,0.02h,Stop Loss,$9.00,$912.00,$130290.50,283,$912.00
2025-01-30,20:37:00,21653.0,SELL,3,0.02h,Stop Loss,$196.50,$1108.50,$130487.00,283,$1108.50
2025-01-30,20:57:00,21648.25,BUY,3,0.02h,Stop Loss,$31.50,$1140.00,$130518.50,283,$1140.00
2025-01-30,21:20:00,21628.75,SELL,3,0.02h,Break Even,$-1.50,$1138.50,$130517.00,283,$1138.50
2025-01-30,21:31:00,21643.75,BUY,3,0.02h,Stop Loss,$82.50,$1221.00,$130599.50,283,$1221.00
2025-01-30,21:34:00,21619.5,SELL,3,0.02h,Stop Loss,$36.00,$1257.00,$130635.50,283,$1257.00
2025-01-30,23:01:00,21689.0,BUY,3,0.02h,Break Even,$-1.50,$1255.50,$130634.00,283,$1255.50
2025-01-30,23:28:00,21673.25,SELL,3,0.02h,Break Even,$-1.50,$1254.00,$130632.50,283,$1254.00
2025-01-30,23:48:00,21685.5,BUY,3,0.02h,Break Even,$-1.50,$1252.50,$130631.00,283,$1252.50
,,,,,,,,,,,
2025-01-31,00:09:00,21683.5,SELL,3,0.02h,Stop Loss,$-9.00,$-9.00,$130622.00,284,$-9.00
2025-01-31,00:10:00,21690.0,BUY,3,0.02h,Stop Loss,$22.50,$13.50,$130644.50,284,$13.50
2025-01-31,01:01:00,21699.5,SELL,3,0.02h,Stop Loss,$12.00,$25.50,$130656.50,284,$25.50
2025-01-31,01:16:00,21710.25,BUY,3,0.02h,Stop Loss,$12.00,$37.50,$130668.50,284,$37.50
2025-01-31,02:15:00,21761.75,SELL,3,0.02h,Break Even,$-1.50,$36.00,$130667.00,284,$36.00
2025-01-31,02:53:00,21750.5,BUY,3,0.02h,Stop Loss,$10.50,$46.50,$130677.50,284,$46.50
2025-01-31,02:57:00,21744.25,SELL,3,0.02h,Stop Loss,$-9.00,$37.50,$130668.50,284,$37.50
2025-01-31,03:13:00,21748.0,BUY,3,0.02h,Stop Loss,$-9.00,$28.50,$130659.50,284,$28.50
2025-01-31,03:28:00,21745.25,SELL,3,0.02h,Break Even,$-1.50,$27.00,$130658.00,284,$27.00
2025-01-31,03:52:00,21748.0,BUY,3,0.02h,Stop Loss,$-9.00,$18.00,$130649.00,284,$18.00
2025-01-31,04:01:00,21737.25,SELL,3,0.02h,Stop Loss,$-9.00,$9.00,$130640.00,284,$9.00
2025-01-31,04:14:00,21741.5,BUY,3,0.02h,Break Even,$-1.50,$7.50,$130638.50,284,$7.50
2025-01-31,04:28:00,21739.75,SELL,3,0.02h,Break Even,$-1.50,$6.00,$130637.00,284,$6.00
2025-01-31,05:04:00,21735.0,BUY,3,0.02h,Break Even,$-1.50,$4.50,$130635.50,284,$4.50
2025-01-31,05:32:00,21736.5,SELL,3,0.02h,Break Even,$-1.50,$3.00,$130634.00,284,$3.00
2025-01-31,05:51:00,21738.0,BUY,3,0.02h,Stop Loss,$-9.00,$-6.00,$130625.00,284,$-6.00
2025-01-31,05:52:00,21735.75,SELL,3,0.03h,Break Even,$-1.50,$-7.50,$130623.50,284,$-7.50
2025-01-31,05:56:00,21739.0,BUY,3,0.02h,Stop Loss,$-9.00,$-16.50,$130614.50,284,$-16.50
2025-01-31,06:01:00,21733.0,SELL,3,0.02h,Break Even,$-1.50,$-18.00,$130613.00,284,$-18.00
2025-01-31,06:05:00,21739.5,BUY,3,0.02h,Break Even,$-1.50,$-19.50,$130611.50,284,$-19.50
2025-01-31,06:59:00,21761.25,SELL,3,0.02h,Stop Loss,$-9.00,$-28.50,$130602.50,284,$-28.50
2025-01-31,07:08:00,21772.75,BUY,3,0.02h,Break Even,$-1.50,$-30.00,$130601.00,284,$-30.00
2025-01-31,07:37:00,21784.75,SELL,3,0.02h,Break Even,$-1.50,$-31.50,$130599.50,284,$-31.50
2025-01-31,07:39:00,21790.0,BUY,3,0.02h,Stop Loss,$9.00,$-22.50,$130608.50,284,$-22.50
2025-01-31,07:44:00,21782.5,SELL,3,0.02h,Stop Loss,$3.00,$-19.50,$130611.50,284,$-19.50
2025-01-31,07:47:00,21793.0,BUY,3,0.02h,Stop Loss,$-9.00,$-28.50,$130602.50,284,$-28.50
2025-01-31,07:54:00,21785.0,SELL,3,0.02h,Break Even,$-1.50,$-30.00,$130601.00,284,$-30.00
2025-01-31,08:21:00,21793.0,BUY,3,0.02h,Stop Loss,$-9.00,$-39.00,$130592.00,284,$-39.00
2025-01-31,08:29:00,21772.0,SELL,3,0.02h,Break Even,$-1.50,$-40.50,$130590.50,284,$-40.50
2025-01-31,08:34:00,21784.75,BUY,3,0.02h,Stop Loss,$7.50,$-33.00,$130598.00,284,$-33.00
2025-01-31,08:43:00,21775.5,SELL,3,0.02h,Stop Loss,$4.50,$-28.50,$130602.50,284,$-28.50
2025-01-31,09:06:00,21774.0,BUY,3,0.02h,Stop Loss,$13.50,$-15.00,$130616.00,284,$-15.00
2025-01-31,09:45:00,21783.0,SELL,3,0.02h,Stop Loss,$-9.00,$-24.00,$130607.00,284,$-24.00
2025-01-31,10:11:00,21787.5,BUY,3,0.02h,Break Even,$-1.50,$-25.50,$130605.50,284,$-25.50
2025-01-31,10:13:00,21777.5,SELL,3,0.02h,Stop Loss,$6.00,$-19.50,$130611.50,284,$-19.50
2025-01-31,10:25:00,21786.0,BUY,3,0.02h,Stop Loss,$-9.00,$-28.50,$130602.50,284,$-28.50
2025-01-31,10:53:00,21781.0,SELL,3,0.02h,Stop Loss,$13.50,$-15.00,$130616.00,284,$-15.00
2025-01-31,11:06:00,21784.75,BUY,3,0.02h,Break Even,$-1.50,$-16.50,$130614.50,284,$-16.50
2025-01-31,11:53:00,21797.0,SELL,3,0.02h,Stop Loss,$-9.00,$-25.50,$130605.50,284,$-25.50
2025-01-31,11:56:00,21801.25,BUY,3,0.02h,Stop Loss,$40.50,$15.00,$130646.00,284,$15.00
2025-01-31,12:13:00,21797.0,SELL,3,0.02h,Stop Loss,$10.50,$25.50,$130656.50,284,$25.50
2025-01-31,12:21:00,21804.0,BUY,3,0.02h,Stop Loss,$-9.00,$16.50,$130647.50,284,$16.50
2025-01-31,12:25:00,21797.75,SELL,3,0.02h,Break Even,$-1.50,$15.00,$130646.00,284,$15.00
2025-01-31,12:50:00,21794.75,BUY,3,0.02h,Stop Loss,$-9.00,$6.00,$130637.00,284,$6.00
2025-01-31,12:51:00,21792.5,SELL,3,0.02h,Stop Loss,$-9.00,$-3.00,$130628.00,284,$-3.00
2025-01-31,12:53:00,21794.5,BUY,3,0.02h,Break Even,$-1.50,$-4.50,$130626.50,284,$-4.50
2025-01-31,12:56:00,21790.5,SELL,3,0.02h,Stop Loss,$3.00,$-1.50,$130629.50,284,$-1.50
2025-01-31,13:19:00,21789.0,BUY,3,0.02h,Stop Loss,$3.00,$1.50,$130632.50,284,$1.50
2025-01-31,13:33:00,21780.75,SELL,3,0.02h,Break Even,$-1.50,$0.00,$130631.00,284,$0.00
2025-01-31,13:49:00,21797.75,BUY,3,0.02h,Stop Loss,$3.00,$3.00,$130634.00,284,$3.00
2025-01-31,14:02:00,21780.5,SELL,3,0.02h,Stop Loss,$28.50,$31.50,$130662.50,284,$31.50
2025-01-31,14:30:00,21775.0,BUY,3,0.02h,Stop Loss,$84.00,$115.50,$130746.50,284,$115.50
2025-01-31,16:21:00,21935.5,SELL,3,0.02h,Stop Loss,$48.00,$163.50,$130794.50,284,$163.50
2025-01-31,17:15:00,21912.0,BUY,3,0.02h,Stop Loss,$-9.00,$154.50,$130785.50,284,$154.50
2025-01-31,17:44:00,21917.0,SELL,3,0.02h,Stop Loss,$12.00,$166.50,$130797.50,284,$166.50
2025-01-31,17:51:00,21927.25,BUY,3,0.02h,Stop Loss,$6.00,$172.50,$130803.50,284,$172.50
2025-01-31,17:59:00,21914.0,SELL,3,0.02h,Break Even,$-1.50,$171.00,$130802.00,284,$171.00
2025-01-31,18:07:00,21923.0,BUY,3,0.02h,Break Even,$-1.50,$169.50,$130800.50,284,$169.50
2025-01-31,18:10:00,21911.75,SELL,3,0.02h,Break Even,$-1.50,$168.00,$130799.00,284,$168.00
2025-01-31,20:00:00,21661.75,BUY,3,0.02h,Stop Loss,$-9.00,$159.00,$130790.00,284,$159.00
2025-01-31,20:01:00,21631.0,SELL,3,0.02h,Stop Loss,$60.00,$219.00,$130850.00,284,$219.00
2025-01-31,20:48:00,21593.25,BUY,3,0.02h,Stop Loss,$111.00,$330.00,$130961.00,284,$330.00
2025-01-31,21:03:00,21565.25,SELL,3,0.02h,Stop Loss,$150.00,$480.00,$131111.00,284,$480.00
2025-01-31,21:22:00,21578.75,BUY,3,0.02h,Break Even,$-1.50,$478.50,$131109.50,284,$478.50
2025-01-31,21:31:00,21562.5,SELL,3,0.02h,Stop Loss,$16.50,$495.00,$131126.00,284,$495.00
2025-01-31,21:51:00,21575.5,BUY,3,0.02h,Break Even,$-1.50,$493.50,$131124.50,284,$493.50
2025-01-31,21:56:00,21557.75,SELL,3,0.02h,Stop Loss,$3.00,$496.50,$131127.50,284,$496.50
,,,,,,,,,,,
2025-02-03,01:01:00,21118.75,BUY,3,0.02h,Break Even,$-1.50,$-1.50,$131126.00,285,$-1.50
2025-02-03,01:04:00,21106.5,SELL,3,0.02h,Stop Loss,$31.50,$30.00,$131157.50,285,$30.00
2025-02-03,01:17:00,21114.25,BUY,3,0.02h,Break Even,$-1.50,$28.50,$131156.00,285,$28.50
2025-02-03,01:43:00,21118.0,SELL,3,0.02h,Stop Loss,$93.00,$121.50,$131249.00,285,$121.50
2025-02-03,03:00:00,21029.25,BUY,3,0.02h,Stop Loss,$-9.00,$112.50,$131240.00,285,$112.50
2025-02-03,03:06:00,21008.75,SELL,3,0.02h,Stop Loss,$4.50,$117.00,$131244.50,285,$117.00
2025-02-03,03:19:00,21021.0,BUY,3,0.02h,Stop Loss,$-9.00,$108.00,$131235.50,285,$108.00
2025-02-03,03:45:00,21027.25,SELL,3,0.02h,Stop Loss,$33.00,$141.00,$131268.50,285,$141.00
2025-02-03,03:52:00,21035.75,BUY,3,0.02h,Break Even,$-1.50,$139.50,$131267.00,285,$139.50
2025-02-03,04:07:00,21023.0,SELL,3,0.02h,Break Even,$-1.50,$138.00,$131265.50,285,$138.00
2025-02-03,04:51:00,21008.75,BUY,3,0.02h,Break Even,$-1.50,$136.50,$131264.00,285,$136.50
2025-02-03,05:36:00,21022.0,SELL,3,0.02h,Break Even,$-1.50,$135.00,$131262.50,285,$135.00
2025-02-03,05:41:00,21032.75,BUY,3,0.02h,Stop Loss,$-9.00,$126.00,$131253.50,285,$126.00
2025-02-03,06:15:00,21054.5,SELL,3,0.02h,Stop Loss,$27.00,$153.00,$131280.50,285,$153.00
2025-02-03,06:34:00,21060.5,BUY,3,0.02h,Break Even,$-1.50,$151.50,$131279.00,285,$151.50
2025-02-03,06:58:00,21063.75,SELL,3,0.02h,Stop Loss,$9.00,$160.50,$131288.00,285,$160.50
2025-02-03,07:01:00,21074.25,BUY,3,0.02h,Stop Loss,$55.50,$216.00,$131343.50,285,$216.00
2025-02-03,07:38:00,21087.25,SELL,3,0.02h,Stop Loss,$-9.00,$207.00,$131334.50,285,$207.00
2025-02-03,07:41:00,21107.25,BUY,3,0.02h,Stop Loss,$7.50,$214.50,$131342.00,285,$214.50
2025-02-03,08:43:00,21203.25,SELL,3,0.02h,Stop Loss,$40.50,$255.00,$131382.50,285,$255.00
2025-02-03,08:57:00,21208.0,BUY,3,0.02h,Stop Loss,$9.00,$264.00,$131391.50,285,$264.00
2025-02-03,09:01:00,21191.25,SELL,3,0.02h,Break Even,$-1.50,$262.50,$131390.00,285,$262.50
2025-02-03,09:03:00,21218.5,BUY,3,0.02h,Stop Loss,$27.00,$289.50,$131417.00,285,$289.50
2025-02-03,09:10:00,21191.0,SELL,3,0.02h,Stop Loss,$3.00,$292.50,$131420.00,285,$292.50
2025-02-03,09:31:00,21204.5,BUY,3,0.02h,Stop Loss,$60.00,$352.50,$131480.00,285,$352.50
2025-02-03,09:44:00,21189.75,SELL,3,0.02h,Stop Loss,$7.50,$360.00,$131487.50,285,$360.00
2025-02-03,10:10:00,21198.75,BUY,3,0.02h,Stop Loss,$45.00,$405.00,$131532.50,285,$405.00
2025-02-03,11:24:00,21244.0,SELL,3,0.02h,Break Even,$-1.50,$403.50,$131531.00,285,$403.50
2025-02-03,12:25:00,21207.5,BUY,3,0.02h,Break Even,$-1.50,$402.00,$131529.50,285,$402.00
2025-02-03,12:33:00,21195.75,SELL,3,0.02h,Break Even,$-1.50,$400.50,$131528.00,285,$400.50
2025-02-03,13:04:00,21206.75,BUY,3,0.02h,Stop Loss,$3.00,$403.50,$131531.00,285,$403.50
2025-02-03,13:35:00,21203.5,SELL,3,0.02h,Stop Loss,$72.00,$475.50,$131603.00,285,$475.50
2025-02-03,14:00:00,21202.25,BUY,3,0.02h,Stop Loss,$19.50,$495.00,$131622.50,285,$495.00
2025-02-03,14:11:00,21190.0,SELL,3,0.02h,Stop Loss,$16.50,$511.50,$131639.00,285,$511.50
2025-02-03,14:12:00,21206.5,BUY,3,0.02h,Stop Loss,$130.50,$642.00,$131769.50,285,$642.00
2025-02-03,14:27:00,21188.75,SELL,3,0.02h,Stop Loss,$21.00,$663.00,$131790.50,285,$663.00
2025-02-03,14:32:00,21228.75,BUY,3,0.02h,Stop Loss,$138.00,$801.00,$131928.50,285,$801.00
2025-02-03,14:49:00,21214.0,SELL,3,0.02h,Stop Loss,$21.00,$822.00,$131949.50,285,$822.00
2025-02-03,15:24:00,21229.75,BUY,3,0.02h,Stop Loss,$562.50,$1384.50,$132512.00,285,$1384.50
2025-02-03,16:06:00,21346.25,SELL,3,0.02h,Stop Loss,$9.00,$1393.50,$132521.00,285,$1393.50
2025-02-03,16:07:00,21411.5,BUY,3,0.02h,Break Even,$-1.50,$1392.00,$132519.50,285,$1392.00
2025-02-03,16:29:00,21409.25,SELL,3,0.02h,Stop Loss,$85.50,$1477.50,$132605.00,285,$1477.50
2025-02-03,16:40:00,21433.25,BUY,3,0.02h,Stop Loss,$43.50,$1521.00,$132648.50,285,$1521.00
2025-02-03,16:43:00,21408.5,SELL,3,0.02h,Stop Loss,$40.50,$1561.50,$132689.00,285,$1561.50
2025-02-03,16:46:00,21433.5,BUY,3,0.02h,Stop Loss,$76.50,$1638.00,$132765.50,285,$1638.00
2025-02-03,16:58:00,21383.5,SELL,3,0.02h,Stop Loss,$78.00,$1716.00,$132843.50,285,$1716.00
2025-02-03,17:22:00,21414.5,BUY,3,0.02h,Stop Loss,$30.00,$1746.00,$132873.50,285,$1746.00
2025-02-03,17:32:00,21383.0,SELL,3,0.02h,Stop Loss,$34.50,$1780.50,$132908.00,285,$1780.50
2025-02-03,17:52:00,21401.5,BUY,3,0.02h,Stop Loss,$12.00,$1792.50,$132920.00,285,$1792.50
2025-02-03,18:02:00,21371.25,SELL,3,0.02h,Stop Loss,$102.00,$1894.50,$133022.00,285,$1894.50
2025-02-03,18:05:00,21407.0,BUY,3,0.02h,Break Even,$-1.50,$1893.00,$133020.50,285,$1893.00
2025-02-03,18:11:00,21369.0,SELL,3,0.02h,Stop Loss,$45.00,$1938.00,$133065.50,285,$1938.00
2025-02-03,18:14:00,21417.75,BUY,3,0.02h,Stop Loss,$13.50,$1951.50,$133079.00,285,$1951.50
2025-02-03,19:37:00,21486.75,SELL,3,0.02h,Stop Loss,$33.00,$1984.50,$133112.00,285,$1984.50
2025-02-03,19:42:00,21504.75,BUY,3,0.02h,Break Even,$-1.50,$1983.00,$133110.50,285,$1983.00
2025-02-03,19:58:00,21486.0,SELL,3,0.02h,Stop Loss,$33.00,$2016.00,$133143.50,285,$2016.00
2025-02-03,20:22:00,21491.75,BUY,3,0.02h,Break Even,$-1.50,$2014.50,$133142.00,285,$2014.50
2025-02-03,20:27:00,21471.75,SELL,3,0.02h,Stop Loss,$16.50,$2031.00,$133158.50,285,$2031.00
2025-02-03,21:13:00,21434.0,BUY,3,0.02h,Stop Loss,$-9.00,$2022.00,$133149.50,285,$2022.00
2025-02-03,23:30:00,21566.75,SELL,3,0.02h,Stop Loss,$15.00,$2037.00,$133164.50,285,$2037.00
2025-02-03,23:41:00,21573.0,BUY,3,0.02h,Stop Loss,$-9.00,$2028.00,$133155.50,285,$2028.00
2025-02-03,23:50:00,21565.25,SELL,3,0.02h,Stop Loss,$36.00,$2064.00,$133191.50,285,$2064.00
2025-02-03,23:59:00,21573.0,BUY,3,0.02h,Stop Loss,$-9.00,$2055.00,$133182.50,285,$2055.00
,,,,,,,,,,,
2025-02-04,00:03:00,21562.0,SELL,3,0.02h,Stop Loss,$-9.00,$-9.00,$133173.50,286,$-9.00
2025-02-04,00:32:00,21554.5,BUY,3,0.02h,Stop Loss,$19.50,$10.50,$133193.00,286,$10.50
2025-02-04,00:50:00,21547.75,SELL,3,0.02h,Stop Loss,$4.50,$15.00,$133197.50,286,$15.00
2025-02-04,01:52:00,21502.0,BUY,3,0.02h,Stop Loss,$16.50,$31.50,$133214.00,286,$31.50
2025-02-04,02:19:00,21504.75,SELL,3,0.02h,Stop Loss,$-9.00,$22.50,$133205.00,286,$22.50
2025-02-04,03:26:00,21470.5,BUY,3,0.02h,Stop Loss,$-9.00,$13.50,$133196.00,286,$13.50
2025-02-04,03:34:00,21459.75,SELL,3,0.02h,Stop Loss,$-9.00,$4.50,$133187.00,286,$4.50
2025-02-04,04:00:00,21450.25,BUY,3,0.02h,Stop Loss,$18.00,$22.50,$133205.00,286,$22.50
2025-02-04,04:35:00,21459.75,SELL,3,0.02h,Break Even,$-1.50,$21.00,$133203.50,286,$21.00
2025-02-04,04:47:00,21465.75,BUY,3,0.02h,Stop Loss,$-9.00,$12.00,$133194.50,286,$12.00
2025-02-04,04:48:00,21461.5,SELL,3,0.02h,Stop Loss,$25.50,$37.50,$133220.00,286,$37.50
2025-02-04,05:33:00,21338.5,BUY,3,0.02h,Stop Loss,$6.00,$43.50,$133226.00,286,$43.50
2025-02-04,06:11:00,21337.25,SELL,3,0.02h,Stop Loss,$-9.00,$34.50,$133217.00,286,$34.50
2025-02-04,06:27:00,21369.25,BUY,3,0.02h,Stop Loss,$-9.00,$25.50,$133208.00,286,$25.50
2025-02-04,06:31:00,21347.0,SELL,3,0.02h,Stop Loss,$28.50,$54.00,$133236.50,286,$54.00
2025-02-04,06:43:00,21369.0,BUY,3,0.02h,Break Even,$-1.50,$52.50,$133235.00,286,$52.50
2025-02-04,07:44:00,21398.25,SELL,3,0.02h,Break Even,$-1.50,$51.00,$133233.50,286,$51.00
2025-02-04,07:49:00,21416.25,BUY,3,0.02h,Break Even,$-1.50,$49.50,$133232.00,286,$49.50
2025-02-04,07:58:00,21401.25,SELL,3,0.02h,Break Even,$-1.50,$48.00,$133230.50,286,$48.00
2025-02-04,08:24:00,21395.75,BUY,3,0.02h,Stop Loss,$51.00,$99.00,$133281.50,286,$99.00
2025-02-04,08:28:00,21375.5,SELL,3,0.02h,Stop Loss,$34.50,$133.50,$133316.00,286,$133.50
2025-02-04,08:58:00,21354.5,BUY,3,0.02h,Stop Loss,$9.00,$142.50,$133325.00,286,$142.50
2025-02-04,09:38:00,21371.5,SELL,3,0.02h,Break Even,$-1.50,$141.00,$133323.50,286,$141.00
2025-02-04,10:08:00,21372.25,BUY,3,0.02h,Break Even,$-1.50,$139.50,$133322.00,286,$139.50
2025-02-04,10:10:00,21366.25,SELL,3,0.02h,Stop Loss,$-9.00,$130.50,$133313.00,286,$130.50
2025-02-04,10:13:00,21376.25,BUY,3,0.02h,Stop Loss,$54.00,$184.50,$133367.00,286,$184.50
2025-02-04,10:35:00,21381.75,SELL,3,0.02h,Stop Loss,$-9.00,$175.50,$133358.00,286,$175.50
2025-02-04,10:38:00,21388.75,BUY,3,0.02h,Stop Loss,$10.50,$186.00,$133368.50,286,$186.00
2025-02-04,10:40:00,21384.25,SELL,3,0.02h,Stop Loss,$33.00,$219.00,$133401.50,286,$219.00
2025-02-04,10:49:00,21395.25,BUY,3,0.02h,Break Even,$-1.50,$217.50,$133400.00,286,$217.50
2025-02-04,11:19:00,21390.5,SELL,3,0.02h,Break Even,$-1.50,$216.00,$133398.50,286,$216.00
2025-02-04,11:28:00,21408.25,BUY,3,0.02h,Break Even,$-1.50,$214.50,$133397.00,286,$214.50
2025-02-04,11:55:00,21405.25,SELL,3,0.02h,Stop Loss,$34.50,$249.00,$133431.50,286,$249.00
2025-02-04,12:02:00,21423.25,BUY,3,0.02h,Stop Loss,$-9.00,$240.00,$133422.50,286,$240.00
2025-02-04,12:51:00,21442.5,SELL,3,0.02h,Break Even,$-1.50,$238.50,$133421.00,286,$238.50
2025-02-04,12:55:00,21453.75,BUY,3,0.02h,Stop Loss,$-9.00,$229.50,$133412.00,286,$229.50
2025-02-04,12:58:00,21447.25,SELL,3,0.02h,Stop Loss,$-9.00,$220.50,$133403.00,286,$220.50
2025-02-04,12:59:00,21477.25,BUY,3,0.02h,Stop Loss,$12.00,$232.50,$133415.00,286,$232.50
2025-02-04,13:02:00,21427.0,SELL,3,0.02h,Stop Loss,$-9.00,$223.50,$133406.00,286,$223.50
2025-02-04,13:09:00,21456.75,BUY,3,0.02h,Stop Loss,$55.50,$279.00,$133461.50,286,$279.00
2025-02-04,13:30:00,21459.0,SELL,3,0.02h,Stop Loss,$40.50,$319.50,$133502.00,286,$319.50
2025-02-04,14:08:00,21443.0,BUY,3,0.02h,Stop Loss,$4.50,$324.00,$133506.50,286,$324.00
2025-02-04,14:16:00,21422.25,SELL,3,0.02h,Break Even,$-1.50,$322.50,$133505.00,286,$322.50
2025-02-04,14:34:00,21449.0,BUY,3,0.02h,Stop Loss,$73.50,$396.00,$133578.50,286,$396.00
2025-02-04,15:52:00,21645.75,SELL,3,0.02h,Stop Loss,$9.00,$405.00,$133587.50,286,$405.00
2025-02-04,16:04:00,21657.0,BUY,3,0.02h,Stop Loss,$45.00,$450.00,$133632.50,286,$450.00
2025-02-04,16:24:00,21642.5,SELL,3,0.02h,Stop Loss,$-9.00,$441.00,$133623.50,286,$441.00
2025-02-04,16:28:00,21659.5,BUY,3,0.02h,Stop Loss,$82.50,$523.50,$133706.00,286,$523.50
2025-02-04,16:49:00,21663.5,SELL,3,0.02h,Stop Loss,$90.00,$613.50,$133796.00,286,$613.50
2025-02-04,17:47:00,21595.25,BUY,3,0.02h,Break Even,$-1.50,$612.00,$133794.50,286,$612.00
2025-02-04,17:49:00,21584.0,SELL,3,0.02h,Break Even,$-1.50,$610.50,$133793.00,286,$610.50
2025-02-04,17:51:00,21597.5,BUY,3,0.02h,Stop Loss,$-9.00,$601.50,$133784.00,286,$601.50
2025-02-04,18:06:00,21571.5,SELL,3,0.02h,Stop Loss,$-9.00,$592.50,$133775.00,286,$592.50
2025-02-04,18:14:00,21605.75,BUY,3,0.02h,Break Even,$-1.50,$591.00,$133773.50,286,$591.00
2025-02-04,18:59:00,21626.25,SELL,3,0.02h,Stop Loss,$4.50,$595.50,$133778.00,286,$595.50
2025-02-04,19:06:00,21645.5,BUY,3,0.02h,Stop Loss,$22.50,$618.00,$133800.50,286,$618.00
2025-02-04,19:48:00,21652.5,SELL,3,0.02h,Stop Loss,$6.00,$624.00,$133806.50,286,$624.00
2025-02-04,20:13:00,21651.25,BUY,3,0.02h,Break Even,$-1.50,$622.50,$133805.00,286,$622.50
2025-02-04,20:21:00,21637.0,SELL,3,0.02h,Stop Loss,$3.00,$625.50,$133808.00,286,$625.50
2025-02-04,20:38:00,21650.5,BUY,3,0.02h,Break Even,$-1.50,$624.00,$133806.50,286,$624.00
2025-02-04,21:03:00,21613.5,SELL,3,0.02h,Stop Loss,$111.00,$735.00,$133917.50,286,$735.00
2025-02-04,23:18:00,21592.0,BUY,3,0.02h,Stop Loss,$-9.00,$726.00,$133908.50,286,$726.00
2025-02-04,23:37:00,21575.0,SELL,3,0.02h,Stop Loss,$-9.00,$717.00,$133899.50,286,$717.00
,,,,,,,,,,,
2025-02-05,00:12:00,21580.75,BUY,3,0.02h,Break Even,$-1.50,$-1.50,$133898.00,287,$-1.50
2025-02-05,00:53:00,21597.5,SELL,3,0.02h,Stop Loss,$-9.00,$-10.50,$133889.00,287,$-10.50
2025-02-05,00:56:00,21602.25,BUY,3,0.02h,Stop Loss,$-9.00,$-19.50,$133880.00,287,$-19.50
2025-02-05,00:57:00,21598.0,SELL,3,0.02h,Break Even,$-1.50,$-21.00,$133878.50,287,$-21.00
2025-02-05,01:04:00,21605.0,BUY,3,0.02h,Stop Loss,$-9.00,$-30.00,$133869.50,287,$-30.00
2025-02-05,01:31:00,21594.25,SELL,3,0.02h,Stop Loss,$16.50,$-13.50,$133886.00,287,$-13.50
2025-02-05,02:36:00,21570.75,BUY,3,0.02h,Break Even,$-1.50,$-15.00,$133884.50,287,$-15.00
2025-02-05,02:58:00,21566.0,SELL,3,0.02h,Stop Loss,$6.00,$-9.00,$133890.50,287,$-9.00
2025-02-05,03:40:00,21567.25,BUY,3,0.02h,Stop Loss,$-9.00,$-18.00,$133881.50,287,$-18.00
2025-02-05,03:43:00,21564.0,SELL,3,0.02h,Stop Loss,$-9.00,$-27.00,$133872.50,287,$-27.00
2025-02-05,03:44:00,21568.0,BUY,3,0.02h,Break Even,$-1.50,$-28.50,$133871.00,287,$-28.50
2025-02-05,03:49:00,21560.75,SELL,3,0.02h,Break Even,$-1.50,$-30.00,$133869.50,287,$-30.00
2025-02-05,04:23:00,21548.5,BUY,3,0.03h,Stop Loss,$-9.00,$-39.00,$133860.50,287,$-39.00
2025-02-05,04:27:00,21543.75,SELL,3,0.02h,Stop Loss,$-9.00,$-48.00,$133851.50,287,$-48.00
2025-02-05,04:30:00,21549.0,BUY,3,0.02h,Break Even,$-1.50,$-49.50,$133850.00,287,$-49.50
2025-02-05,05:20:00,21558.25,SELL,3,0.02h,Break Even,$-1.50,$-51.00,$133848.50,287,$-51.00
2025-02-05,06:20:00,21538.75,BUY,3,0.02h,Stop Loss,$10.50,$-40.50,$133859.00,287,$-40.50
2025-02-05,06:36:00,21534.25,SELL,3,0.02h,Stop Loss,$16.50,$-24.00,$133875.50,287,$-24.00
2025-02-05,07:23:00,21513.0,BUY,3,0.02h,Stop Loss,$-9.00,$-33.00,$133866.50,287,$-33.00
2025-02-05,07:32:00,21503.75,SELL,3,0.02h,Stop Loss,$13.50,$-19.50,$133880.00,287,$-19.50
2025-02-05,07:45:00,21506.25,BUY,3,0.02h,Break Even,$-1.50,$-21.00,$133878.50,287,$-21.00
2025-02-05,08:15:00,21512.25,SELL,3,0.02h,Break Even,$-1.50,$-22.50,$133877.00,287,$-22.50
2025-02-05,08:23:00,21519.0,BUY,3,0.02h,Stop Loss,$36.00,$13.50,$133913.00,287,$13.50
2025-02-05,08:38:00,21508.0,SELL,3,0.02h,Stop Loss,$36.00,$49.50,$133949.00,287,$49.50
2025-02-05,09:05:00,21495.0,BUY,3,0.02h,Stop Loss,$-9.00,$40.50,$133940.00,287,$40.50
2025-02-05,09:22:00,21480.25,SELL,3,0.02h,Stop Loss,$39.00,$79.50,$133979.00,287,$79.50
2025-02-05,10:08:00,21461.75,BUY,3,0.02h,Stop Loss,$10.50,$90.00,$133989.50,287,$90.00
2025-02-05,10:47:00,21463.0,SELL,3,0.02h,Stop Loss,$-9.00,$81.00,$133980.50,287,$81.00
2025-02-05,10:57:00,21475.75,BUY,3,0.02h,Stop Loss,$4.50,$85.50,$133985.00,287,$85.50
2025-02-05,11:36:00,21481.5,SELL,3,0.02h,Stop Loss,$-9.00,$76.50,$133976.00,287,$76.50
2025-02-05,11:47:00,21487.25,BUY,3,0.02h,Stop Loss,$-9.00,$67.50,$133967.00,287,$67.50
2025-02-05,12:10:00,21483.25,SELL,3,0.02h,Stop Loss,$13.50,$81.00,$133980.50,287,$81.00
2025-02-05,12:20:00,21494.25,BUY,3,0.02h,Stop Loss,$-9.00,$72.00,$133971.50,287,$72.00
2025-02-05,13:17:00,21497.5,SELL,3,0.02h,Break Even,$-1.50,$70.50,$133970.00,287,$70.50
2025-02-05,13:21:00,21511.5,BUY,3,0.02h,Stop Loss,$43.50,$114.00,$134013.50,287,$114.00
2025-02-05,13:57:00,21518.75,SELL,3,0.02h,Stop Loss,$-9.00,$105.00,$134004.50,287,$105.00
2025-02-05,13:59:00,21531.5,BUY,3,0.02h,Stop Loss,$-9.00,$96.00,$133995.50,287,$96.00
2025-02-05,14:03:00,21513.5,SELL,3,0.02h,Break Even,$-1.50,$94.50,$133994.00,287,$94.50
2025-02-05,14:07:00,21531.5,BUY,3,0.02h,Stop Loss,$-9.00,$85.50,$133985.00,287,$85.50
2025-02-05,14:56:00,21554.75,SELL,3,0.02h,Break Even,$-1.50,$84.00,$133983.50,287,$84.00
2025-02-05,15:01:00,21589.25,BUY,3,0.02h,Stop Loss,$4.50,$88.50,$133988.00,287,$88.50
2025-02-05,15:04:00,21520.0,SELL,3,0.02h,Stop Loss,$93.00,$181.50,$134081.00,287,$181.50
2025-02-05,15:26:00,21554.75,BUY,3,0.02h,Stop Loss,$69.00,$250.50,$134150.00,287,$250.50
2025-02-05,16:18:00,21571.75,SELL,3,0.02h,Break Even,$-1.50,$249.00,$134148.50,287,$249.00
2025-02-05,16:29:00,21605.0,BUY,3,0.02h,Stop Loss,$84.00,$333.00,$134232.50,287,$333.00
2025-02-05,17:22:00,21708.0,SELL,3,0.02h,Break Even,$-1.50,$331.50,$134231.00,287,$331.50
2025-02-05,17:49:00,21710.25,BUY,3,0.02h,Break Even,$-1.50,$330.00,$134229.50,287,$330.00
2025-02-05,17:52:00,21689.25,SELL,3,0.02h,Stop Loss,$-9.00,$321.00,$134220.50,287,$321.00
2025-02-05,18:02:00,21713.0,BUY,3,0.02h,Break Even,$-1.50,$319.50,$134219.00,287,$319.50
2025-02-05,18:09:00,21699.75,SELL,3,0.02h,Stop Loss,$4.50,$324.00,$134223.50,287,$324.00
2025-02-05,18:22:00,21705.75,BUY,3,0.02h,Stop Loss,$-9.00,$315.00,$134214.50,287,$315.00
2025-02-05,18:23:00,21701.0,SELL,3,0.02h,Stop Loss,$7.50,$322.50,$134222.00,287,$322.50
2025-02-05,18:37:00,21704.5,BUY,3,0.02h,Stop Loss,$10.50,$333.00,$134232.50,287,$333.00
2025-02-05,18:53:00,21695.0,SELL,3,0.02h,Stop Loss,$33.00,$366.00,$134265.50,287,$366.00
2025-02-05,18:59:00,21709.75,BUY,3,0.02h,Break Even,$-1.50,$364.50,$134264.00,287,$364.50
2025-02-05,19:29:00,21718.75,SELL,3,0.02h,Break Even,$-1.50,$363.00,$134262.50,287,$363.00
2025-02-05,20:02:00,21720.25,BUY,3,0.02h,Stop Loss,$4.50,$367.50,$134267.00,287,$367.50
2025-02-05,20:38:00,21729.25,SELL,3,0.02h,Stop Loss,$19.50,$387.00,$134286.50,287,$387.00
2025-02-05,20:56:00,21743.0,BUY,3,0.02h,Stop Loss,$43.50,$430.50,$134330.00,287,$430.50
2025-02-05,21:31:00,21764.75,SELL,3,0.02h,Stop Loss,$6.00,$436.50,$134336.00,287,$436.50
2025-02-05,21:56:00,21770.25,BUY,3,0.02h,Stop Loss,$-9.00,$427.50,$134327.00,287,$427.50
2025-02-05,23:04:00,21758.0,SELL,3,0.02h,Stop Loss,$9.00,$436.50,$134336.00,287,$436.50
2025-02-05,23:23:00,21766.0,BUY,3,0.02h,Stop Loss,$-9.00,$427.50,$134327.00,287,$427.50
2025-02-05,23:34:00,21753.5,SELL,3,0.02h,Break Even,$-1.50,$426.00,$134325.50,287,$426.00
2025-02-05,23:47:00,21760.75,BUY,3,0.02h,Stop Loss,$40.50,$466.50,$134366.00,287,$466.50
,,,,,,,,,,,
2025-02-06,00:37:00,21778.25,SELL,3,0.02h,Break Even,$-1.50,$-1.50,$134364.50,288,$-1.50
2025-02-06,01:02:00,21780.25,BUY,3,0.02h,Stop Loss,$-9.00,$-10.50,$134355.50,288,$-10.50
2025-02-06,01:04:00,21773.25,SELL,3,0.02h,Break Even,$-1.50,$-12.00,$134354.00,288,$-12.00
2025-02-06,01:14:00,21776.75,BUY,3,0.02h,Stop Loss,$22.50,$10.50,$134376.50,288,$10.50
2025-02-06,01:29:00,21777.0,SELL,3,0.02h,Stop Loss,$-9.00,$1.50,$134367.50,288,$1.50
2025-02-06,01:36:00,21777.75,BUY,3,0.02h,Stop Loss,$-9.00,$-7.50,$134358.50,288,$-7.50
2025-02-06,01:37:00,21773.5,SELL,3,0.02h,Stop Loss,$-9.00,$-16.50,$134349.50,288,$-16.50
2025-02-06,02:12:00,21773.0,BUY,3,0.02h,Stop Loss,$-9.00,$-25.50,$134340.50,288,$-25.50
2025-02-06,03:10:00,21777.25,SELL,3,0.02h,Break Even,$-1.50,$-27.00,$134339.00,288,$-27.00
2025-02-06,03:52:00,21776.25,BUY,3,0.03h,Break Even,$-1.50,$-28.50,$134337.50,288,$-28.50
2025-02-06,06:06:00,21824.5,SELL,3,0.02h,Break Even,$-1.50,$-30.00,$134336.00,288,$-30.00
2025-02-06,06:30:00,21824.5,BUY,3,0.02h,Stop Loss,$-9.00,$-39.00,$134327.00,288,$-39.00
2025-02-06,06:31:00,21820.5,SELL,3,0.02h,Break Even,$-1.50,$-40.50,$134325.50,288,$-40.50
2025-02-06,07:03:00,21829.25,BUY,3,0.02h,Break Even,$-1.50,$-42.00,$134324.00,288,$-42.00
2025-02-06,07:16:00,21812.0,SELL,3,0.02h,Stop Loss,$21.00,$-21.00,$134345.00,288,$-21.00
2025-02-06,08:26:00,21788.5,BUY,3,0.02h,Break Even,$-1.50,$-22.50,$134343.50,288,$-22.50
2025-02-06,09:01:00,21798.0,SELL,3,0.02h,Stop Loss,$-9.00,$-31.50,$134334.50,288,$-31.50
2025-02-06,09:04:00,21809.5,BUY,3,0.02h,Stop Loss,$10.50,$-21.00,$134345.00,288,$-21.00
2025-02-06,09:23:00,21810.25,SELL,3,0.02h,Stop Loss,$-9.00,$-30.00,$134336.00,288,$-30.00
2025-02-06,10:07:00,21807.25,BUY,3,0.02h,Break Even,$-1.50,$-31.50,$134334.50,288,$-31.50
2025-02-06,10:18:00,21797.5,SELL,3,0.02h,Break Even,$-1.50,$-33.00,$134333.00,288,$-33.00
2025-02-06,12:20:00,21728.25,BUY,3,0.02h,Stop Loss,$-9.00,$-42.00,$134324.00,288,$-42.00
2025-02-06,13:32:00,21761.0,SELL,3,0.02h,Stop Loss,$3.00,$-39.00,$134327.00,288,$-39.00
2025-02-06,13:56:00,21771.25,BUY,3,0.02h,Stop Loss,$16.50,$-22.50,$134343.50,288,$-22.50
2025-02-06,14:16:00,21766.0,SELL,3,0.02h,Break Even,$-1.50,$-24.00,$134342.00,288,$-24.00
2025-02-06,14:19:00,21772.5,BUY,3,0.02h,Stop Loss,$3.00,$-21.00,$134345.00,288,$-21.00
2025-02-06,14:32:00,21742.25,SELL,3,0.02h,Stop Loss,$4.50,$-16.50,$134349.50,288,$-16.50
2025-02-06,14:45:00,21788.75,BUY,3,0.02h,Stop Loss,$96.00,$79.50,$134445.50,288,$79.50
2025-02-06,15:03:00,21779.5,SELL,3,0.02h,Break Even,$-1.50,$78.00,$134444.00,288,$78.00
2025-02-06,15:09:00,21800.75,BUY,3,0.02h,Stop Loss,$102.00,$180.00,$134546.00,288,$180.00
2025-02-06,15:27:00,21791.25,SELL,3,0.02h,Stop Loss,$15.00,$195.00,$134561.00,288,$195.00
2025-02-06,15:39:00,21832.0,BUY,3,0.02h,Break Even,$-1.50,$193.50,$134559.50,288,$193.50
2025-02-06,15:40:00,21763.25,SELL,3,0.02h,Stop Loss,$4.50,$198.00,$134564.00,288,$198.00
2025-02-06,16:04:00,21785.0,BUY,3,0.02h,Break Even,$-1.50,$196.50,$134562.50,288,$196.50
2025-02-06,16:06:00,21775.0,SELL,3,0.02h,Stop Loss,$-9.00,$187.50,$134553.50,288,$187.50
2025-02-06,16:07:00,21777.0,BUY,3,0.02h,Stop Loss,$19.50,$207.00,$134573.00,288,$207.00
2025-02-06,16:08:00,21772.75,SELL,3,0.02h,Stop Loss,$3.00,$210.00,$134576.00,288,$210.00
2025-02-06,16:09:00,21782.0,BUY,3,0.02h,Stop Loss,$30.00,$240.00,$134606.00,288,$240.00
2025-02-06,16:33:00,21793.75,SELL,3,0.02h,Stop Loss,$27.00,$267.00,$134633.00,288,$267.00
2025-02-06,17:10:00,21776.0,BUY,3,0.02h,Stop Loss,$-9.00,$258.00,$134624.00,288,$258.00
2025-02-06,17:11:00,21772.25,SELL,3,0.02h,Stop Loss,$15.00,$273.00,$134639.00,288,$273.00
2025-02-06,17:18:00,21786.0,BUY,3,0.02h,Stop Loss,$7.50,$280.50,$134646.50,288,$280.50
2025-02-06,17:34:00,21784.75,SELL,3,0.02h,Break Even,$-1.50,$279.00,$134645.00,288,$279.00
2025-02-06,17:36:00,21788.75,BUY,3,0.02h,Break Even,$-1.50,$277.50,$134643.50,288,$277.50
2025-02-06,18:17:00,21813.75,SELL,3,0.02h,Stop Loss,$48.00,$325.50,$134691.50,288,$325.50
2025-02-06,18:19:00,21822.5,BUY,3,0.02h,Break Even,$-1.50,$324.00,$134690.00,288,$324.00
2025-02-06,18:39:00,21817.25,SELL,3,0.02h,Break Even,$-1.50,$322.50,$134688.50,288,$322.50
2025-02-06,18:50:00,21828.75,BUY,3,0.02h,Break Even,$-1.50,$321.00,$134687.00,288,$321.00
2025-02-06,18:51:00,21822.5,SELL,3,0.02h,Stop Loss,$3.00,$324.00,$134690.00,288,$324.00
2025-02-06,19:10:00,21823.5,BUY,3,0.02h,Stop Loss,$13.50,$337.50,$134703.50,288,$337.50
2025-02-06,19:23:00,21816.75,SELL,3,0.02h,Stop Loss,$-9.00,$328.50,$134694.50,288,$328.50
2025-02-06,19:54:00,21768.5,BUY,3,0.02h,Break Even,$-1.50,$327.00,$134693.00,288,$327.00
2025-02-06,19:59:00,21750.5,SELL,3,0.02h,Stop Loss,$43.50,$370.50,$134736.50,288,$370.50
2025-02-06,20:14:00,21759.75,BUY,3,0.02h,Break Even,$-1.50,$369.00,$134735.00,288,$369.00
2025-02-06,21:06:00,21819.75,SELL,3,0.02h,Stop Loss,$64.50,$433.50,$134799.50,288,$433.50
2025-02-06,21:20:00,21844.0,BUY,3,0.02h,Stop Loss,$15.00,$448.50,$134814.50,288,$448.50
2025-02-06,21:47:00,21840.25,SELL,3,0.02h,Stop Loss,$15.00,$463.50,$134829.50,288,$463.50
2025-02-06,23:10:00,21842.0,BUY,3,0.02h,Stop Loss,$9.00,$472.50,$134838.50,288,$472.50
,,,,,,,,,,,
2025-02-07,00:18:00,21850.25,SELL,3,0.02h,Stop Loss,$-9.00,$-9.00,$134829.50,289,$-9.00
2025-02-07,00:46:00,21852.25,BUY,3,0.02h,Stop Loss,$-9.00,$-18.00,$134820.50,289,$-18.00
2025-02-07,02:09:00,21887.25,SELL,3,0.02h,Stop Loss,$-9.00,$-27.00,$134811.50,289,$-27.00
2025-02-07,02:43:00,21889.75,BUY,3,0.02h,Break Even,$-1.50,$-28.50,$134810.00,289,$-28.50
2025-02-07,02:48:00,21886.25,SELL,3,0.02h,Stop Loss,$-9.00,$-37.50,$134801.00,289,$-37.50
2025-02-07,02:50:00,21886.75,BUY,3,0.02h,Break Even,$-1.50,$-39.00,$134799.50,289,$-39.00
2025-02-07,03:12:00,21884.75,SELL,3,0.02h,Break Even,$-1.50,$-40.50,$134798.00,289,$-40.50
2025-02-07,05:16:00,21859.75,BUY,3,0.02h,Stop Loss,$-9.00,$-49.50,$134789.00,289,$-49.50
2025-02-07,05:17:00,21857.25,SELL,3,0.02h,Stop Loss,$-9.00,$-58.50,$134780.00,289,$-58.50
2025-02-07,06:01:00,21854.25,BUY,3,0.02h,Stop Loss,$-9.00,$-67.50,$134771.00,289,$-67.50
2025-02-07,06:04:00,21846.75,SELL,3,0.02h,Break Even,$-1.50,$-69.00,$134769.50,289,$-69.00
2025-02-07,06:41:00,21845.5,BUY,3,0.02h,Break Even,$-1.50,$-70.50,$134768.00,289,$-70.50
2025-02-07,07:54:00,21867.25,SELL,3,0.02h,Stop Loss,$-9.00,$-79.50,$134759.00,289,$-79.50
2025-02-07,08:07:00,21873.0,BUY,3,0.02h,Stop Loss,$4.50,$-75.00,$134763.50,289,$-75.00
2025-02-07,08:18:00,21865.5,SELL,3,0.02h,Stop Loss,$6.00,$-69.00,$134769.50,289,$-69.00
2025-02-07,08:42:00,21856.0,BUY,3,0.02h,Stop Loss,$-9.00,$-78.00,$134760.50,289,$-78.00
2025-02-07,08:51:00,21848.75,SELL,3,0.02h,Break Even,$-1.50,$-79.50,$134759.00,289,$-79.50
2025-02-07,09:05:00,21853.5,BUY,3,0.02h,Stop Loss,$13.50,$-66.00,$134772.50,289,$-66.00
2025-02-07,09:15:00,21848.25,SELL,3,0.02h,Stop Loss,$10.50,$-55.50,$134783.00,289,$-55.50
2025-02-07,09:36:00,21849.0,BUY,3,0.02h,Break Even,$-1.50,$-57.00,$134781.50,289,$-57.00
2025-02-07,10:02:00,21851.75,SELL,3,0.02h,Break Even,$-1.50,$-58.50,$134780.00,289,$-58.50
2025-02-07,10:07:00,21856.0,BUY,3,0.02h,Break Even,$-1.50,$-60.00,$134778.50,289,$-60.00
2025-02-07,10:15:00,21853.5,SELL,3,0.02h,Stop Loss,$-9.00,$-69.00,$134769.50,289,$-69.00
2025-02-07,10:16:00,21856.5,BUY,3,0.02h,Stop Loss,$-9.00,$-78.00,$134760.50,289,$-78.00
2025-02-07,10:17:00,21852.75,SELL,3,0.02h,Stop Loss,$-9.00,$-87.00,$134751.50,289,$-87.00
2025-02-07,10:21:00,21861.25,BUY,3,0.02h,Break Even,$-1.50,$-88.50,$134750.00,289,$-88.50
2025-02-07,10:37:00,21854.25,SELL,3,0.02h,Stop Loss,$-9.00,$-97.50,$134741.00,289,$-97.50
2025-02-07,11:02:00,21859.0,BUY,3,0.02h,Break Even,$-1.50,$-99.00,$134739.50,289,$-99.00
2025-02-07,11:14:00,21851.0,SELL,3,0.02h,Break Even,$-1.50,$-100.50,$134738.00,289,$-100.50
2025-02-07,11:34:00,21857.75,BUY,3,0.02h,Stop Loss,$-9.00,$-109.50,$134729.00,289,$-109.50
2025-02-07,12:27:00,21869.75,SELL,3,0.02h,Break Even,$-1.50,$-111.00,$134727.50,289,$-111.00
2025-02-07,12:46:00,21870.5,BUY,3,0.02h,Stop Loss,$-9.00,$-120.00,$134718.50,289,$-120.00
2025-02-07,12:59:00,21865.5,SELL,3,0.02h,Break Even,$-1.50,$-121.50,$134717.00,289,$-121.50
2025-02-07,13:18:00,21869.5,BUY,3,0.02h,Stop Loss,$-9.00,$-130.50,$134708.00,289,$-130.50
2025-02-07,13:21:00,21853.25,SELL,3,0.02h,Break Even,$-1.50,$-132.00,$134706.50,289,$-132.00
2025-02-07,13:41:00,21878.25,BUY,3,0.02h,Stop Loss,$39.00,$-93.00,$134745.50,289,$-93.00
2025-02-07,14:58:00,21905.25,SELL,3,0.02h,Stop Loss,$33.00,$-60.00,$134778.50,289,$-60.00
2025-02-07,15:38:00,21792.0,BUY,3,0.02h,Stop Loss,$16.50,$-43.50,$134795.00,289,$-43.50
2025-02-07,15:45:00,21751.0,SELL,3,0.02h,Stop Loss,$45.00,$1.50,$134840.00,289,$1.50
2025-02-07,15:48:00,21775.5,BUY,3,0.02h,Stop Loss,$7.50,$9.00,$134847.50,289,$9.00
2025-02-07,15:54:00,21654.5,SELL,3,0.02h,Stop Loss,$213.00,$222.00,$135060.50,289,$222.00
2025-02-07,16:21:00,21730.5,BUY,3,0.02h,Stop Loss,$24.00,$246.00,$135084.50,289,$246.00
2025-02-07,16:27:00,21679.25,SELL,3,0.02h,Stop Loss,$84.00,$330.00,$135168.50,289,$330.00
2025-02-07,17:10:00,21658.25,BUY,3,0.02h,Break Even,$-1.50,$328.50,$135167.00,289,$328.50
2025-02-07,17:19:00,21613.5,SELL,3,0.02h,Stop Loss,$96.00,$424.50,$135263.00,289,$424.50
2025-02-07,17:38:00,21644.75,BUY,3,0.02h,Stop Loss,$82.50,$507.00,$135345.50,289,$507.00
2025-02-07,18:42:00,21688.75,SELL,3,0.02h,Stop Loss,$40.50,$547.50,$135386.00,289,$547.50
2025-02-07,19:41:00,21604.5,BUY,3,0.02h,Stop Loss,$-9.00,$538.50,$135377.00,289,$538.50
2025-02-07,20:02:00,21583.5,SELL,3,0.02h,Stop Loss,$12.00,$550.50,$135389.00,289,$550.50
2025-02-07,20:35:00,21596.0,BUY,3,0.02h,Break Even,$-1.50,$549.00,$135387.50,289,$549.00
2025-02-07,21:06:00,21588.25,SELL,3,0.02h,Stop Loss,$-9.00,$540.00,$135378.50,289,$540.00
,,,,,,,,,,,
2025-02-10,00:00:00,21646.5,BUY,3,0.02h,Stop Loss,$153.00,$153.00,$135531.50,290,$153.00
2025-02-10,01:16:00,21682.75,SELL,3,0.02h,Stop Loss,$13.50,$166.50,$135545.00,290,$166.50
2025-02-10,01:19:00,21690.25,BUY,3,0.02h,Break Even,$-1.50,$165.00,$135543.50,290,$165.00
2025-02-10,01:21:00,21676.5,SELL,3,0.02h,Stop Loss,$-9.00,$156.00,$135534.50,290,$156.00
2025-02-10,02:24:00,21670.75,BUY,3,0.02h,Stop Loss,$9.00,$165.00,$135543.50,290,$165.00
2025-02-10,02:27:00,21664.75,SELL,3,0.02h,Break Even,$-1.50,$163.50,$135542.00,290,$163.50
2025-02-10,02:32:00,21671.5,BUY,3,0.02h,Stop Loss,$-9.00,$154.50,$135533.00,290,$154.50
2025-02-10,02:58:00,21673.75,SELL,3,0.02h,Stop Loss,$-9.00,$145.50,$135524.00,290,$145.50
2025-02-10,02:59:00,21676.0,BUY,3,0.02h,Stop Loss,$-9.00,$136.50,$135515.00,290,$136.50
2025-02-10,03:04:00,21675.25,SELL,3,0.02h,Break Even,$-1.50,$135.00,$135513.50,290,$135.00
2025-02-10,03:08:00,21675.75,BUY,3,0.02h,Stop Loss,$-9.00,$126.00,$135504.50,290,$126.00
2025-02-10,03:09:00,21674.5,SELL,3,0.02h,Break Even,$-1.50,$124.50,$135503.00,290,$124.50
2025-02-10,03:30:00,21674.5,BUY,3,0.02h,Break Even,$-1.50,$123.00,$135501.50,290,$123.00
2025-02-10,04:42:00,21693.25,SELL,3,0.02h,Stop Loss,$-9.00,$114.00,$135492.50,290,$114.00
2025-02-10,05:06:00,21696.75,BUY,3,0.02h,Stop Loss,$-9.00,$105.00,$135483.50,290,$105.00
2025-02-10,05:54:00,21713.0,SELL,3,0.02h,Stop Loss,$-9.00,$96.00,$135474.50,290,$96.00
2025-02-10,07:00:00,21694.5,BUY,3,0.02h,Stop Loss,$7.50,$103.50,$135482.00,290,$103.50
2025-02-10,07:21:00,21686.5,SELL,3,0.02h,Break Even,$-1.50,$102.00,$135480.50,290,$102.00
2025-02-10,07:27:00,21699.0,BUY,3,0.02h,Stop Loss,$-9.00,$93.00,$135471.50,290,$93.00
2025-02-10,07:28:00,21693.25,SELL,3,0.02h,Stop Loss,$-9.00,$84.00,$135462.50,290,$84.00
2025-02-10,07:29:00,21696.0,BUY,3,0.02h,Break Even,$-1.50,$82.50,$135461.00,290,$82.50
2025-02-10,07:34:00,21689.25,SELL,3,0.02h,Stop Loss,$-9.00,$73.50,$135452.00,290,$73.50
2025-02-10,07:46:00,21695.5,BUY,3,0.02h,Stop Loss,$3.00,$76.50,$135455.00,290,$76.50
2025-02-10,08:18:00,21696.25,SELL,3,0.02h,Break Even,$-1.50,$75.00,$135453.50,290,$75.00
2025-02-10,08:22:00,21704.75,BUY,3,0.02h,Stop Loss,$21.00,$96.00,$135474.50,290,$96.00
2025-02-10,08:34:00,21695.75,SELL,3,0.02h,Break Even,$-1.50,$94.50,$135473.00,290,$94.50
2025-02-10,08:43:00,21704.75,BUY,3,0.02h,Break Even,$-1.50,$93.00,$135471.50,290,$93.00
2025-02-10,08:50:00,21696.0,SELL,3,0.02h,Break Even,$-1.50,$91.50,$135470.00,290,$91.50
2025-02-10,09:11:00,21702.75,BUY,3,0.02h,Break Even,$-1.50,$90.00,$135468.50,290,$90.00
2025-02-10,09:40:00,21707.5,SELL,3,0.02h,Stop Loss,$6.00,$96.00,$135474.50,290,$96.00
2025-02-10,09:58:00,21706.0,BUY,3,0.02h,Stop Loss,$-9.00,$87.00,$135465.50,290,$87.00
2025-02-10,11:01:00,21711.75,SELL,3,0.02h,Stop Loss,$9.00,$96.00,$135474.50,290,$96.00
2025-02-10,11:11:00,21732.25,BUY,3,0.02h,Break Even,$-1.50,$94.50,$135473.00,290,$94.50
2025-02-10,11:49:00,21740.0,SELL,3,0.02h,Stop Loss,$-9.00,$85.50,$135464.00,290,$85.50
2025-02-10,12:25:00,21738.0,BUY,3,0.02h,Stop Loss,$-9.00,$76.50,$135455.00,290,$76.50
2025-02-10,12:29:00,21736.5,SELL,3,0.02h,Stop Loss,$-9.00,$67.50,$135446.00,290,$67.50
2025-02-10,12:30:00,21737.0,BUY,3,0.02h,Stop Loss,$-9.00,$58.50,$135437.00,290,$58.50
2025-02-10,12:31:00,21729.0,SELL,3,0.02h,Break Even,$-1.50,$57.00,$135435.50,290,$57.00
2025-02-10,12:50:00,21734.25,BUY,3,0.02h,Stop Loss,$-9.00,$48.00,$135426.50,290,$48.00
2025-02-10,12:56:00,21728.75,SELL,3,0.02h,Stop Loss,$-9.00,$39.00,$135417.50,290,$39.00
2025-02-10,12:58:00,21735.0,BUY,3,0.02h,Break Even,$-1.50,$37.50,$135416.00,290,$37.50
2025-02-10,14:12:00,21773.0,SELL,3,0.02h,Stop Loss,$6.00,$43.50,$135422.00,290,$43.50
2025-02-10,14:39:00,21777.5,BUY,3,0.02h,Stop Loss,$36.00,$79.50,$135458.00,290,$79.50
2025-02-10,15:58:00,21866.75,SELL,3,0.02h,Stop Loss,$-9.00,$70.50,$135449.00,290,$70.50
2025-02-10,16:01:00,21879.0,BUY,3,0.02h,Stop Loss,$22.50,$93.00,$135471.50,290,$93.00
2025-02-10,16:08:00,21866.0,SELL,3,0.02h,Stop Loss,$36.00,$129.00,$135507.50,290,$129.00
2025-02-10,16:55:00,21855.5,BUY,3,0.02h,Stop Loss,$39.00,$168.00,$135546.50,290,$168.00
2025-02-10,17:06:00,21846.75,SELL,3,0.02h,Break Even,$-1.50,$166.50,$135545.00,290,$166.50
2025-02-10,17:35:00,21841.25,BUY,3,0.02h,Stop Loss,$16.50,$183.00,$135561.50,290,$183.00
2025-02-10,18:36:00,21867.0,SELL,3,0.02h,Break Even,$-1.50,$181.50,$135560.00,290,$181.50
2025-02-10,18:37:00,21869.75,BUY,3,0.02h,Break Even,$-1.50,$180.00,$135558.50,290,$180.00
2025-02-10,18:41:00,21863.5,SELL,3,0.02h,Stop Loss,$3.00,$183.00,$135561.50,290,$183.00
2025-02-10,18:50:00,21870.75,BUY,3,0.02h,Stop Loss,$7.50,$190.50,$135569.00,290,$190.50
2025-02-10,19:03:00,21865.5,SELL,3,0.02h,Stop Loss,$-9.00,$181.50,$135560.00,290,$181.50
2025-02-10,19:13:00,21874.5,BUY,3,0.02h,Stop Loss,$12.00,$193.50,$135572.00,290,$193.50
2025-02-10,19:28:00,21866.0,SELL,3,0.02h,Stop Loss,$9.00,$202.50,$135581.00,290,$202.50
2025-02-10,20:07:00,21864.75,BUY,3,0.02h,Stop Loss,$21.00,$223.50,$135602.00,290,$223.50
2025-02-10,20:25:00,21860.5,SELL,3,0.02h,Stop Loss,$-9.00,$214.50,$135593.00,290,$214.50
2025-02-10,21:32:00,21835.25,BUY,3,0.03h,Break Even,$-1.50,$213.00,$135591.50,290,$213.00
2025-02-10,21:57:00,21834.75,SELL,3,0.02h,Stop Loss,$-9.00,$204.00,$135582.50,290,$204.00
2025-02-10,21:59:00,21837.0,BUY,3,1.03h,Stop Loss,$-9.00,$195.00,$135573.50,290,$195.00
2025-02-10,23:01:00,21821.25,SELL,3,0.02h,Stop Loss,$34.50,$229.50,$135608.00,290,$229.50
2025-02-10,23:43:00,21794.0,BUY,3,0.02h,Stop Loss,$-9.00,$220.50,$135599.00,290,$220.50
2025-02-10,23:44:00,21790.0,SELL,3,0.02h,Break Even,$-1.50,$219.00,$135597.50,290,$219.00
2025-02-10,23:55:00,21793.25,BUY,3,0.02h,Break Even,$-1.50,$217.50,$135596.00,290,$217.50
,,,,,,,,,,,
2025-02-11,00:05:00,21789.5,SELL,3,0.02h,Stop Loss,$-9.00,$-9.00,$135587.00,291,$-9.00
2025-02-11,00:28:00,21796.25,BUY,3,0.02h,Break Even,$-1.50,$-10.50,$135585.50,291,$-10.50
2025-02-11,01:05:00,21806.25,SELL,3,0.02h,Stop Loss,$-9.00,$-19.50,$135576.50,291,$-19.50
2025-02-11,01:38:00,21807.25,BUY,3,0.02h,Break Even,$-1.50,$-21.00,$135575.00,291,$-21.00
2025-02-11,01:50:00,21799.0,SELL,3,0.02h,Break Even,$-1.50,$-22.50,$135573.50,291,$-22.50
2025-02-11,02:55:00,21766.25,BUY,3,0.02h,Stop Loss,$-9.00,$-31.50,$135564.50,291,$-31.50
2025-02-11,03:02:00,21761.0,SELL,3,0.02h,Break Even,$-1.50,$-33.00,$135563.00,291,$-33.00
2025-02-11,03:10:00,21763.75,BUY,3,0.02h,Stop Loss,$-9.00,$-42.00,$135554.00,291,$-42.00
2025-02-11,03:11:00,21758.75,SELL,3,0.02h,Stop Loss,$16.50,$-25.50,$135570.50,291,$-25.50
2025-02-11,03:23:00,21764.0,BUY,3,0.02h,Stop Loss,$31.50,$6.00,$135602.00,291,$6.00
2025-02-11,04:40:00,21781.5,SELL,3,0.02h,Stop Loss,$-9.00,$-3.00,$135593.00,291,$-3.00
2025-02-11,04:59:00,21783.5,BUY,3,0.02h,Stop Loss,$-9.00,$-12.00,$135584.00,291,$-12.00
2025-02-11,05:41:00,21790.75,SELL,3,0.03h,Stop Loss,$-9.00,$-21.00,$135575.00,291,$-21.00
2025-02-11,06:33:00,21779.75,BUY,3,0.02h,Break Even,$-1.50,$-22.50,$135573.50,291,$-22.50
2025-02-11,06:38:00,21777.25,SELL,3,0.02h,Break Even,$-1.50,$-24.00,$135572.00,291,$-24.00
2025-02-11,07:17:00,21774.0,BUY,3,0.02h,Stop Loss,$-9.00,$-33.00,$135563.00,291,$-33.00
2025-02-11,07:22:00,21764.0,SELL,3,0.02h,Stop Loss,$-9.00,$-42.00,$135554.00,291,$-42.00
2025-02-11,07:57:00,21762.75,BUY,3,0.02h,Stop Loss,$-9.00,$-51.00,$135545.00,291,$-51.00
2025-02-11,07:58:00,21758.0,SELL,3,0.02h,Stop Loss,$115.50,$64.50,$135660.50,291,$64.50
2025-02-11,08:17:00,21750.25,BUY,3,0.02h,Stop Loss,$64.50,$129.00,$135725.00,291,$129.00
2025-02-11,09:00:00,21763.0,SELL,3,0.02h,Break Even,$-1.50,$127.50,$135723.50,291,$127.50
2025-02-11,09:01:00,21772.5,BUY,3,0.02h,Break Even,$-1.50,$126.00,$135722.00,291,$126.00
2025-02-11,09:21:00,21765.75,SELL,3,0.02h,Stop Loss,$-9.00,$117.00,$135713.00,291,$117.00
2025-02-11,09:50:00,21759.75,BUY,3,0.02h,Stop Loss,$-9.00,$108.00,$135704.00,291,$108.00
2025-02-11,09:51:00,21753.0,SELL,3,0.02h,Break Even,$-1.50,$106.50,$135702.50,291,$106.50
2025-02-11,10:16:00,21758.0,BUY,3,0.02h,Stop Loss,$-9.00,$97.50,$135693.50,291,$97.50
2025-02-11,10:27:00,21752.5,SELL,3,0.02h,Stop Loss,$9.00,$106.50,$135702.50,291,$106.50
2025-02-11,11:07:00,21745.25,BUY,3,0.02h,Stop Loss,$-9.00,$97.50,$135693.50,291,$97.50
2025-02-11,12:03:00,21744.5,SELL,3,0.02h,Break Even,$-1.50,$96.00,$135692.00,291,$96.00
2025-02-11,12:26:00,21752.25,BUY,3,0.02h,Stop Loss,$-9.00,$87.00,$135683.00,291,$87.00
2025-02-11,12:29:00,21738.75,SELL,3,0.02h,Stop Loss,$3.00,$90.00,$135686.00,291,$90.00
2025-02-11,12:43:00,21748.0,BUY,3,0.02h,Break Even,$-1.50,$88.50,$135684.50,291,$88.50
2025-02-11,12:56:00,21743.25,SELL,3,0.02h,Break Even,$-1.50,$87.00,$135683.00,291,$87.00
2025-02-11,13:01:00,21752.0,BUY,3,0.02h,Stop Loss,$-9.00,$78.00,$135674.00,291,$78.00
2025-02-11,13:09:00,21743.75,SELL,3,0.02h,Stop Loss,$-9.00,$69.00,$135665.00,291,$69.00
2025-02-11,14:17:00,21702.25,BUY,3,0.02h,Stop Loss,$-9.00,$60.00,$135656.00,291,$60.00
2025-02-11,14:18:00,21694.75,SELL,3,0.02h,Break Even,$-1.50,$58.50,$135654.50,291,$58.50
2025-02-11,14:19:00,21700.75,BUY,3,0.02h,Break Even,$-1.50,$57.00,$135653.00,291,$57.00
2025-02-11,14:24:00,21695.75,SELL,3,0.02h,Stop Loss,$10.50,$67.50,$135663.50,291,$67.50
2025-02-11,14:28:00,21706.5,BUY,3,0.02h,Break Even,$-1.50,$66.00,$135662.00,291,$66.00
2025-02-11,16:03:00,21837.0,SELL,3,0.02h,Stop Loss,$-9.00,$57.00,$135653.00,291,$57.00
2025-02-11,16:40:00,21836.75,BUY,3,0.02h,Break Even,$-1.50,$55.50,$135651.50,291,$55.50
2025-02-11,16:49:00,21827.75,SELL,3,0.02h,Break Even,$-1.50,$54.00,$135650.00,291,$54.00
2025-02-11,17:24:00,21783.5,BUY,3,0.02h,Stop Loss,$13.50,$67.50,$135663.50,291,$67.50
2025-02-11,17:45:00,21768.25,SELL,3,0.02h,Break Even,$-1.50,$66.00,$135662.00,291,$66.00
2025-02-11,18:19:00,21772.5,BUY,3,0.02h,Break Even,$-1.50,$64.50,$135660.50,291,$64.50
2025-02-11,18:57:00,21802.25,SELL,3,0.02h,Break Even,$-1.50,$63.00,$135659.00,291,$63.00
2025-02-11,19:05:00,21814.25,BUY,3,0.02h,Break Even,$-1.50,$61.50,$135657.50,291,$61.50
2025-02-11,19:12:00,21797.75,SELL,3,0.02h,Stop Loss,$7.50,$69.00,$135665.00,291,$69.00
2025-02-11,19:39:00,21805.0,BUY,3,0.02h,Stop Loss,$24.00,$93.00,$135689.00,291,$93.00
2025-02-11,20:11:00,21823.0,SELL,3,0.02h,Stop Loss,$4.50,$97.50,$135693.50,291,$97.50
2025-02-11,21:05:00,21793.25,BUY,3,0.02h,Stop Loss,$-9.00,$88.50,$135684.50,291,$88.50
2025-02-11,21:07:00,21784.5,SELL,3,0.02h,Break Even,$-1.50,$87.00,$135683.00,291,$87.00
2025-02-11,21:09:00,21788.0,BUY,3,0.02h,Break Even,$-1.50,$85.50,$135681.50,291,$85.50
2025-02-11,21:37:00,21790.5,SELL,3,0.02h,Stop Loss,$-9.00,$76.50,$135672.50,291,$76.50
2025-02-11,21:39:00,21794.75,BUY,3,0.02h,Stop Loss,$-9.00,$67.50,$135663.50,291,$67.50
2025-02-11,21:44:00,21789.5,SELL,3,0.02h,Stop Loss,$-9.00,$58.50,$135654.50,291,$58.50
2025-02-11,21:52:00,21793.25,BUY,3,0.02h,Stop Loss,$-9.00,$49.50,$135645.50,291,$49.50
2025-02-11,23:11:00,21791.75,SELL,3,0.02h,Stop Loss,$40.50,$90.00,$135686.00,291,$90.00
2025-02-11,23:29:00,21799.75,BUY,3,0.02h,Break Even,$-1.50,$88.50,$135684.50,291,$88.50
,,,,,,,,,,,
2025-02-12,00:01:00,21807.25,SELL,3,0.02h,Stop Loss,$-9.00,$-9.00,$135675.50,292,$-9.00
2025-02-12,00:02:00,21814.5,BUY,3,0.02h,Break Even,$-1.50,$-10.50,$135674.00,292,$-10.50
2025-02-12,00:13:00,21808.0,SELL,3,0.02h,Stop Loss,$-9.00,$-19.50,$135665.00,292,$-19.50
2025-02-12,00:24:00,21812.75,BUY,3,0.02h,Break Even,$-1.50,$-21.00,$135663.50,292,$-21.00
2025-02-12,00:57:00,21816.5,SELL,3,0.02h,Stop Loss,$10.50,$-10.50,$135674.00,292,$-10.50
2025-02-12,01:17:00,21816.75,BUY,3,0.02h,Break Even,$-1.50,$-12.00,$135672.50,292,$-12.00
2025-02-12,01:20:00,21811.5,SELL,3,0.02h,Break Even,$-1.50,$-13.50,$135671.00,292,$-13.50
2025-02-12,01:40:00,21812.75,BUY,3,0.02h,Stop Loss,$-9.00,$-22.50,$135662.00,292,$-22.50
2025-02-12,02:17:00,21818.25,SELL,3,0.02h,Stop Loss,$-9.00,$-31.50,$135653.00,292,$-31.50
2025-02-12,02:40:00,21823.0,BUY,3,0.02h,Stop Loss,$-9.00,$-40.50,$135644.00,292,$-40.50
2025-02-12,02:44:00,21818.25,SELL,3,0.02h,Stop Loss,$-9.00,$-49.50,$135635.00,292,$-49.50
2025-02-12,04:17:00,21791.0,BUY,3,0.02h,Break Even,$-1.50,$-51.00,$135633.50,292,$-51.00
2025-02-12,04:33:00,21781.25,SELL,3,0.02h,Stop Loss,$-9.00,$-60.00,$135624.50,292,$-60.00
2025-02-12,05:04:00,21783.0,BUY,3,0.02h,Stop Loss,$-9.00,$-69.00,$135615.50,292,$-69.00
2025-02-12,05:14:00,21779.25,SELL,3,0.03h,Stop Loss,$15.00,$-54.00,$135630.50,292,$-54.00
2025-02-12,05:42:00,21775.0,BUY,3,0.05h,Stop Loss,$-9.00,$-63.00,$135621.50,292,$-63.00
2025-02-12,06:12:00,21774.25,SELL,3,0.02h,Stop Loss,$-9.00,$-72.00,$135612.50,292,$-72.00
2025-02-12,06:15:00,21779.5,BUY,3,0.02h,Stop Loss,$-9.00,$-81.00,$135603.50,292,$-81.00
2025-02-12,06:53:00,21785.75,SELL,3,0.02h,Stop Loss,$-9.00,$-90.00,$135594.50,292,$-90.00
2025-02-12,06:54:00,21788.25,BUY,3,0.02h,Stop Loss,$-9.00,$-99.00,$135585.50,292,$-99.00
2025-02-12,06:55:00,21787.0,SELL,3,0.02h,Break Even,$-1.50,$-100.50,$135584.00,292,$-100.50
2025-02-12,07:30:00,21783.5,BUY,3,0.02h,Stop Loss,$-9.00,$-109.50,$135575.00,292,$-109.50
2025-02-12,07:37:00,21780.5,SELL,3,0.02h,Break Even,$-1.50,$-111.00,$135573.50,292,$-111.00
2025-02-12,07:38:00,21782.25,BUY,3,0.02h,Stop Loss,$-9.00,$-120.00,$135564.50,292,$-120.00
2025-02-12,07:39:00,21780.25,SELL,3,0.02h,Stop Loss,$-9.00,$-129.00,$135555.50,292,$-129.00
2025-02-12,07:41:00,21783.0,BUY,3,0.02h,Stop Loss,$7.50,$-121.50,$135563.00,292,$-121.50
2025-02-12,08:17:00,21798.75,SELL,3,0.02h,Stop Loss,$-9.00,$-130.50,$135554.00,292,$-130.50
2025-02-12,08:34:00,21802.5,BUY,3,0.02h,Stop Loss,$19.50,$-111.00,$135573.50,292,$-111.00
2025-02-12,08:48:00,21799.0,SELL,3,0.02h,Stop Loss,$-9.00,$-120.00,$135564.50,292,$-120.00
2025-02-12,09:37:00,21766.25,BUY,3,0.02h,Break Even,$-1.50,$-121.50,$135563.00,292,$-121.50
2025-02-12,10:02:00,21762.25,SELL,3,0.02h,Stop Loss,$-9.00,$-130.50,$135554.00,292,$-130.50
2025-02-12,10:21:00,21770.0,BUY,3,0.02h,Stop Loss,$7.50,$-123.00,$135561.50,292,$-123.00
2025-02-12,11:09:00,21776.25,SELL,3,0.02h,Stop Loss,$-9.00,$-132.00,$135552.50,292,$-132.00
2025-02-12,11:16:00,21788.25,BUY,3,0.02h,Stop Loss,$-9.00,$-141.00,$135543.50,292,$-141.00
2025-02-12,11:35:00,21781.0,SELL,3,0.02h,Stop Loss,$-9.00,$-150.00,$135534.50,292,$-150.00
2025-02-12,11:38:00,21787.0,BUY,3,0.02h,Stop Loss,$18.00,$-132.00,$135552.50,292,$-132.00
2025-02-12,13:22:00,21818.75,SELL,3,0.02h,Stop Loss,$12.00,$-120.00,$135564.50,292,$-120.00
2025-02-12,14:23:00,21557.5,BUY,3,0.02h,Break Even,$-1.50,$-121.50,$135563.00,292,$-121.50
2025-02-12,15:05:00,21615.0,SELL,3,0.02h,Stop Loss,$21.00,$-100.50,$135584.00,292,$-100.50
2025-02-12,15:19:00,21663.5,BUY,3,0.02h,Stop Loss,$45.00,$-55.50,$135629.00,292,$-55.50
2025-02-12,15:51:00,21700.5,SELL,3,0.02h,Break Even,$-1.50,$-57.00,$135627.50,292,$-57.00
2025-02-12,15:53:00,21716.0,BUY,3,0.02h,Break Even,$-1.50,$-58.50,$135626.00,292,$-58.50
2025-02-12,16:08:00,21697.25,SELL,3,0.02h,Stop Loss,$40.50,$-18.00,$135666.50,292,$-18.00
2025-02-12,16:37:00,21695.5,BUY,3,0.02h,Stop Loss,$48.00,$30.00,$135714.50,292,$30.00
2025-02-12,17:34:00,21773.75,SELL,3,0.02h,Stop Loss,$-9.00,$21.00,$135705.50,292,$21.00
2025-02-12,17:49:00,21791.75,BUY,3,0.02h,Break Even,$-1.50,$19.50,$135704.00,292,$19.50
2025-02-12,18:22:00,21799.25,SELL,3,0.02h,Break Even,$-1.50,$18.00,$135702.50,292,$18.00
2025-02-12,18:34:00,21809.0,BUY,3,0.02h,Break Even,$-1.50,$16.50,$135701.00,292,$16.50
2025-02-12,18:40:00,21798.5,SELL,3,0.02h,Break Even,$-1.50,$15.00,$135699.50,292,$15.00
2025-02-12,18:56:00,21800.0,BUY,3,0.02h,Stop Loss,$9.00,$24.00,$135708.50,292,$24.00
2025-02-12,19:01:00,21790.25,SELL,3,0.02h,Break Even,$-1.50,$22.50,$135707.00,292,$22.50
2025-02-12,19:25:00,21785.5,BUY,3,0.02h,Stop Loss,$-9.00,$13.50,$135698.00,292,$13.50
2025-02-12,20:11:00,21821.5,SELL,3,0.02h,Stop Loss,$-9.00,$4.50,$135689.00,292,$4.50
2025-02-12,20:12:00,21825.75,BUY,3,0.02h,Stop Loss,$12.00,$16.50,$135701.00,292,$16.50
2025-02-12,20:15:00,21819.75,SELL,3,0.02h,Stop Loss,$18.00,$34.50,$135719.00,292,$34.50
2025-02-12,20:22:00,21823.75,BUY,3,0.02h,Break Even,$-1.50,$33.00,$135717.50,292,$33.00
2025-02-12,20:30:00,21815.5,SELL,3,0.02h,Stop Loss,$9.00,$42.00,$135726.50,292,$42.00
2025-02-12,21:01:00,21810.5,BUY,3,0.02h,Break Even,$-1.50,$40.50,$135725.00,292,$40.50
2025-02-12,21:03:00,21792.25,SELL,3,0.02h,Break Even,$-1.50,$39.00,$135723.50,292,$39.00
2025-02-12,21:06:00,21813.75,BUY,3,0.02h,Stop Loss,$21.00,$60.00,$135744.50,292,$60.00
2025-02-12,23:17:00,21850.5,SELL,3,0.02h,Break Even,$-1.50,$58.50,$135743.00,292,$58.50
2025-02-12,23:18:00,21854.25,BUY,3,0.02h,Stop Loss,$-9.00,$49.50,$135734.00,292,$49.50
2025-02-12,23:20:00,21851.5,SELL,3,0.02h,Break Even,$-1.50,$48.00,$135732.50,292,$48.00
2025-02-12,23:36:00,21854.75,BUY,3,0.02h,Stop Loss,$-9.00,$39.00,$135723.50,292,$39.00
,,,,,,,,,,,
2025-02-13,00:12:00,21879.25,SELL,3,0.02h,Stop Loss,$4.50,$4.50,$135728.00,293,$4.50
2025-02-13,00:28:00,21883.5,BUY,3,0.02h,Break Even,$-1.50,$3.00,$135726.50,293,$3.00
2025-02-13,00:37:00,21877.75,SELL,3,0.02h,Stop Loss,$-9.00,$-6.00,$135717.50,293,$-6.00
2025-02-13,00:39:00,21883.0,BUY,3,0.02h,Stop Loss,$3.00,$-3.00,$135720.50,293,$-3.00
2025-02-13,01:04:00,21890.0,SELL,3,0.02h,Break Even,$-1.50,$-4.50,$135719.00,293,$-4.50
2025-02-13,01:12:00,21894.75,BUY,3,0.02h,Break Even,$-1.50,$-6.00,$135717.50,293,$-6.00
2025-02-13,01:20:00,21891.75,SELL,3,0.02h,Stop Loss,$-9.00,$-15.00,$135708.50,293,$-15.00
2025-02-13,01:35:00,21904.0,BUY,3,0.02h,Stop Loss,$-9.00,$-24.00,$135699.50,293,$-24.00
2025-02-13,01:51:00,21896.25,SELL,3,0.02h,Stop Loss,$-9.00,$-33.00,$135690.50,293,$-33.00
2025-02-13,02:27:00,21886.5,BUY,3,0.02h,Break Even,$-1.50,$-34.50,$135689.00,293,$-34.50
2025-02-13,02:54:00,21886.75,SELL,3,0.02h,Stop Loss,$-9.00,$-43.50,$135680.00,293,$-43.50
2025-02-13,03:08:00,21891.0,BUY,3,0.02h,Stop Loss,$27.00,$-16.50,$135707.00,293,$-16.50
2025-02-13,04:49:00,21915.25,SELL,3,0.02h,Break Even,$-1.50,$-18.00,$135705.50,293,$-18.00
2025-02-13,06:09:00,21906.0,BUY,3,0.02h,Stop Loss,$16.50,$-1.50,$135722.00,293,$-1.50
2025-02-13,06:27:00,21907.25,SELL,3,0.02h,Stop Loss,$-9.00,$-10.50,$135713.00,293,$-10.50
2025-02-13,06:28:00,21909.0,BUY,3,0.02h,Stop Loss,$-9.00,$-19.50,$135704.00,293,$-19.50
2025-02-13,06:44:00,21906.5,SELL,3,0.02h,Stop Loss,$-9.00,$-28.50,$135695.00,293,$-28.50
2025-02-13,07:24:00,21889.0,BUY,3,0.02h,Stop Loss,$-9.00,$-37.50,$135686.00,293,$-37.50
2025-02-13,07:25:00,21886.25,SELL,3,0.02h,Break Even,$-1.50,$-39.00,$135684.50,293,$-39.00
2025-02-13,07:26:00,21889.0,BUY,3,0.02h,Stop Loss,$-9.00,$-48.00,$135675.50,293,$-48.00
2025-02-13,07:28:00,21882.75,SELL,3,0.02h,Stop Loss,$13.50,$-34.50,$135689.00,293,$-34.50
2025-02-13,09:10:00,21784.5,BUY,3,0.02h,Break Even,$-1.50,$-36.00,$135687.50,293,$-36.00
2025-02-13,10:06:00,21826.25,SELL,3,0.02h,Stop Loss,$76.50,$40.50,$135764.00,293,$40.50
2025-02-13,10:15:00,21830.25,BUY,3,0.02h,Break Even,$-1.50,$39.00,$135762.50,293,$39.00
2025-02-13,10:24:00,21821.5,SELL,3,0.02h,Stop Loss,$-9.00,$30.00,$135753.50,293,$30.00
2025-02-13,10:36:00,21838.75,BUY,3,0.02h,Break Even,$-1.50,$28.50,$135752.00,293,$28.50
2025-02-13,11:00:00,21834.5,SELL,3,0.02h,Stop Loss,$15.00,$43.50,$135767.00,293,$43.50
2025-02-13,11:11:00,21840.5,BUY,3,0.02h,Stop Loss,$-9.00,$34.50,$135758.00,293,$34.50
2025-02-13,11:45:00,21848.5,SELL,3,0.02h,Stop Loss,$-9.00,$25.50,$135749.00,293,$25.50
2025-02-13,11:46:00,21851.5,BUY,3,0.02h,Break Even,$-1.50,$24.00,$135747.50,293,$24.00
2025-02-13,11:47:00,21831.5,SELL,3,0.02h,Stop Loss,$142.50,$166.50,$135890.00,293,$166.50
2025-02-13,12:26:00,21819.75,BUY,3,0.02h,Break Even,$-1.50,$165.00,$135888.50,293,$165.00
2025-02-13,12:49:00,21810.75,SELL,3,0.02h,Stop Loss,$-9.00,$156.00,$135879.50,293,$156.00
2025-02-13,12:56:00,21820.0,BUY,3,0.02h,Stop Loss,$-9.00,$147.00,$135870.50,293,$147.00
2025-02-13,13:06:00,21813.0,SELL,3,0.02h,Stop Loss,$12.00,$159.00,$135882.50,293,$159.00
2025-02-13,13:22:00,21820.5,BUY,3,0.02h,Break Even,$-1.50,$157.50,$135881.00,293,$157.50
2025-02-13,14:16:00,21866.0,SELL,3,0.02h,Stop Loss,$16.50,$174.00,$135897.50,293,$174.00
2025-02-13,14:24:00,21872.5,BUY,3,0.02h,Stop Loss,$27.00,$201.00,$135924.50,293,$201.00
2025-02-13,14:41:00,21863.5,SELL,3,0.02h,Stop Loss,$78.00,$279.00,$136002.50,293,$279.00
2025-02-13,14:54:00,21889.75,BUY,3,0.02h,Stop Loss,$9.00,$288.00,$136011.50,293,$288.00
2025-02-13,16:21:00,22033.0,SELL,3,0.02h,Stop Loss,$46.50,$334.50,$136058.00,293,$334.50
2025-02-13,17:09:00,21992.25,BUY,3,0.02h,Break Even,$-1.50,$333.00,$136056.50,293,$333.00
2025-02-13,17:13:00,21972.25,SELL,3,0.02h,Stop Loss,$22.50,$355.50,$136079.00,293,$355.50
2025-02-13,17:42:00,21975.5,BUY,3,0.02h,Stop Loss,$7.50,$363.00,$136086.50,293,$363.00
2025-02-13,17:58:00,21961.5,SELL,3,0.02h,Stop Loss,$57.00,$420.00,$136143.50,293,$420.00
2025-02-13,18:36:00,21955.75,BUY,3,0.02h,Stop Loss,$30.00,$450.00,$136173.50,293,$450.00
2025-02-13,18:44:00,21937.5,SELL,3,0.02h,Stop Loss,$30.00,$480.00,$136203.50,293,$480.00
2025-02-13,18:46:00,21956.75,BUY,3,0.02h,Stop Loss,$52.50,$532.50,$136256.00,293,$532.50
2025-02-13,20:32:00,22072.75,SELL,3,0.02h,Stop Loss,$-9.00,$523.50,$136247.00,293,$523.50
2025-02-13,20:47:00,22076.75,BUY,3,0.02h,Stop Loss,$3.00,$526.50,$136250.00,293,$526.50
2025-02-13,21:07:00,22078.5,SELL,3,0.02h,Break Even,$-1.50,$525.00,$136248.50,293,$525.00
2025-02-13,21:42:00,22083.5,BUY,3,0.03h,Stop Loss,$3.00,$528.00,$136251.50,293,$528.00
2025-02-13,21:57:00,22081.0,SELL,3,0.02h,Stop Loss,$-9.00,$519.00,$136242.50,293,$519.00
2025-02-13,23:14:00,22088.75,BUY,3,0.02h,Break Even,$-1.50,$517.50,$136241.00,293,$517.50
2025-02-13,23:35:00,22083.0,SELL,3,0.02h,Break Even,$-1.50,$516.00,$136239.50,293,$516.00
,,,,,,,,,,,
2025-02-14,00:01:00,22091.25,BUY,3,0.02h,Stop Loss,$6.00,$6.00,$136245.50,294,$6.00
2025-02-14,00:08:00,22078.0,SELL,3,0.02h,Stop Loss,$-9.00,$-3.00,$136236.50,294,$-3.00
2025-02-14,00:17:00,22091.75,BUY,3,0.02h,Stop Loss,$10.50,$7.50,$136247.00,294,$7.50
2025-02-14,00:49:00,22094.0,SELL,3,0.02h,Stop Loss,$-9.00,$-1.50,$136238.00,294,$-1.50
2025-02-14,00:54:00,22099.75,BUY,3,0.02h,Stop Loss,$-9.00,$-10.50,$136229.00,294,$-10.50
2025-02-14,00:57:00,22095.0,SELL,3,0.02h,Stop Loss,$-9.00,$-19.50,$136220.00,294,$-19.50
2025-02-14,01:02:00,22098.25,BUY,3,0.02h,Stop Loss,$-9.00,$-28.50,$136211.00,294,$-28.50
2025-02-14,02:17:00,22133.5,SELL,3,0.02h,Stop Loss,$-9.00,$-37.50,$136202.00,294,$-37.50
2025-02-14,02:40:00,22142.5,BUY,3,0.02h,Stop Loss,$19.50,$-18.00,$136221.50,294,$-18.00
2025-02-14,02:49:00,22135.25,SELL,3,0.02h,Break Even,$-1.50,$-19.50,$136220.00,294,$-19.50
2025-02-14,03:40:00,22133.25,BUY,3,0.02h,Break Even,$-1.50,$-21.00,$136218.50,294,$-21.00
2025-02-14,04:10:00,22136.5,SELL,3,0.02h,Stop Loss,$-9.00,$-30.00,$136209.50,294,$-30.00
2025-02-14,04:23:00,22140.75,BUY,3,0.02h,Stop Loss,$-9.00,$-39.00,$136200.50,294,$-39.00
2025-02-14,04:35:00,22138.5,SELL,3,0.02h,Stop Loss,$-9.00,$-48.00,$136191.50,294,$-48.00
2025-02-14,04:38:00,22140.25,BUY,3,0.02h,Break Even,$-1.50,$-49.50,$136190.00,294,$-49.50
2025-02-14,05:07:00,22139.5,SELL,3,0.02h,Break Even,$-1.50,$-51.00,$136188.50,294,$-51.00
2025-02-14,05:24:00,22141.75,BUY,3,0.02h,Stop Loss,$-9.00,$-60.00,$136179.50,294,$-60.00
2025-02-14,05:27:00,22139.0,SELL,3,0.02h,Break Even,$-1.50,$-61.50,$136178.00,294,$-61.50
2025-02-14,06:05:00,22127.0,BUY,3,0.02h,Stop Loss,$-9.00,$-70.50,$136169.00,294,$-70.50
2025-02-14,06:33:00,22126.0,SELL,3,0.03h,Break Even,$-1.50,$-72.00,$136167.50,294,$-72.00
2025-02-14,06:42:00,22128.5,BUY,3,0.05h,Stop Loss,$3.00,$-69.00,$136170.50,294,$-69.00
2025-02-14,07:36:00,22150.0,SELL,3,0.02h,Break Even,$-1.50,$-70.50,$136169.00,294,$-70.50
2025-02-14,07:53:00,22151.25,BUY,3,0.02h,Stop Loss,$-9.00,$-79.50,$136160.00,294,$-79.50
2025-02-14,08:01:00,22136.25,SELL,3,0.02h,Break Even,$-1.50,$-81.00,$136158.50,294,$-81.00
2025-02-14,09:03:00,22126.25,BUY,3,0.02h,Stop Loss,$10.50,$-70.50,$136169.00,294,$-70.50
2025-02-14,09:44:00,22130.5,SELL,3,0.02h,Break Even,$-1.50,$-72.00,$136167.50,294,$-72.00
2025-02-14,09:45:00,22137.0,BUY,3,0.02h,Stop Loss,$-9.00,$-81.00,$136158.50,294,$-81.00
2025-02-14,09:46:00,22133.5,SELL,3,0.02h,Stop Loss,$-9.00,$-90.00,$136149.50,294,$-90.00
2025-02-14,12:02:00,22071.25,BUY,3,0.02h,Stop Loss,$-9.00,$-99.00,$136140.50,294,$-99.00
2025-02-14,12:44:00,22073.25,SELL,3,0.02h,Break Even,$-1.50,$-100.50,$136139.00,294,$-100.50
2025-02-14,12:58:00,22078.5,BUY,3,0.02h,Stop Loss,$7.50,$-93.00,$136146.50,294,$-93.00
2025-02-14,13:30:00,22081.75,SELL,3,0.02h,Stop Loss,$9.00,$-84.00,$136155.50,294,$-84.00
2025-02-14,13:32:00,22097.5,BUY,3,0.02h,Stop Loss,$46.50,$-37.50,$136202.00,294,$-37.50
2025-02-14,14:12:00,22100.5,SELL,3,0.02h,Stop Loss,$16.50,$-21.00,$136218.50,294,$-21.00
2025-02-14,14:21:00,22106.75,BUY,3,0.02h,Stop Loss,$15.00,$-6.00,$136233.50,294,$-6.00
2025-02-14,14:36:00,22100.5,SELL,3,0.02h,Stop Loss,$34.50,$28.50,$136268.00,294,$28.50
2025-02-14,14:48:00,22122.25,BUY,3,0.02h,Stop Loss,$30.00,$58.50,$136298.00,294,$58.50
2025-02-14,15:32:00,22133.5,SELL,3,0.02h,Stop Loss,$34.50,$93.00,$136332.50,294,$93.00
2025-02-14,15:51:00,22134.0,BUY,3,0.02h,Stop Loss,$12.00,$105.00,$136344.50,294,$105.00
2025-02-14,16:18:00,22145.0,SELL,3,0.02h,Stop Loss,$43.50,$148.50,$136388.00,294,$148.50
2025-02-14,16:46:00,22138.0,BUY,3,0.02h,Break Even,$-1.50,$147.00,$136386.50,294,$147.00
2025-02-14,16:48:00,22123.75,SELL,3,0.02h,Stop Loss,$16.50,$163.50,$136403.00,294,$163.50
2025-02-14,16:58:00,22134.25,BUY,3,0.02h,Stop Loss,$28.50,$192.00,$136431.50,294,$192.00
2025-02-14,17:08:00,22126.0,SELL,3,0.02h,Stop Loss,$31.50,$223.50,$136463.00,294,$223.50
2025-02-14,17:48:00,22121.5,BUY,3,0.02h,Stop Loss,$28.50,$252.00,$136491.50,294,$252.00
2025-02-14,18:25:00,22155.0,SELL,3,0.02h,Stop Loss,$19.50,$271.50,$136511.00,294,$271.50
2025-02-14,18:32:00,22164.75,BUY,3,0.02h,Stop Loss,$24.00,$295.50,$136535.00,294,$295.50
2025-02-14,19:05:00,22184.5,SELL,3,0.02h,Stop Loss,$-9.00,$286.50,$136526.00,294,$286.50
2025-02-14,19:08:00,22192.5,BUY,3,0.02h,Stop Loss,$-9.00,$277.50,$136517.00,294,$277.50
2025-02-14,19:22:00,22187.5,SELL,3,0.02h,Break Even,$-1.50,$276.00,$136515.50,294,$276.00
2025-02-14,20:00:00,22179.0,BUY,3,0.02h,Stop Loss,$-9.00,$267.00,$136506.50,294,$267.00
2025-02-14,20:01:00,22166.5,SELL,3,0.02h,Break Even,$-1.50,$265.50,$136505.00,294,$265.50
2025-02-14,20:14:00,22176.5,BUY,3,0.02h,Break Even,$-1.50,$264.00,$136503.50,294,$264.00
2025-02-14,21:02:00,22191.25,SELL,3,0.02h,Stop Loss,$-9.00,$255.00,$136494.50,294,$255.00
2025-02-14,21:07:00,22207.5,BUY,3,0.02h,Break Even,$-1.50,$253.50,$136493.00,294,$253.50
2025-02-14,21:34:00,22200.25,SELL,3,0.02h,Break Even,$-1.50,$252.00,$136491.50,294,$252.00
2025-02-14,21:59:00,22206.75,BUY,3,50.03h,Stop Loss,$16.50,$268.50,$136508.00,294,$268.50
,,,,,,,,,,,
2025-02-17,00:25:00,22211.5,SELL,3,0.02h,Stop Loss,$-9.00,$-9.00,$136499.00,295,$-9.00
2025-02-17,00:48:00,22215.25,BUY,3,0.02h,Break Even,$-1.50,$-10.50,$136497.50,295,$-10.50
2025-02-17,02:07:00,22244.0,SELL,3,0.03h,Break Even,$-1.50,$-12.00,$136496.00,295,$-12.00
2025-02-17,02:14:00,22254.5,BUY,3,0.02h,Stop Loss,$4.50,$-7.50,$136500.50,295,$-7.50
2025-02-17,03:13:00,22264.5,SELL,3,0.02h,Stop Loss,$-9.00,$-16.50,$136491.50,295,$-16.50
2025-02-17,03:14:00,22267.75,BUY,3,0.05h,Break Even,$-1.50,$-18.00,$136490.00,295,$-18.00
2025-02-17,03:32:00,22265.75,SELL,3,0.02h,Break Even,$-1.50,$-19.50,$136488.50,295,$-19.50
2025-02-17,03:59:00,22263.5,BUY,3,0.02h,Stop Loss,$-9.00,$-28.50,$136479.50,295,$-28.50
2025-02-17,04:01:00,22259.5,SELL,3,0.02h,Break Even,$-1.50,$-30.00,$136478.00,295,$-30.00
2025-02-17,04:31:00,22260.25,BUY,3,0.02h,Break Even,$-1.50,$-31.50,$136476.50,295,$-31.50
2025-02-17,05:08:00,22269.0,SELL,3,0.05h,Stop Loss,$-9.00,$-40.50,$136467.50,295,$-40.50
2025-02-17,05:13:00,22272.75,BUY,3,0.02h,Stop Loss,$-9.00,$-49.50,$136458.50,295,$-49.50
2025-02-17,05:33:00,22271.5,SELL,3,0.02h,Break Even,$-1.50,$-51.00,$136457.00,295,$-51.00
2025-02-17,05:43:00,22276.0,BUY,3,0.02h,Stop Loss,$-9.00,$-60.00,$136448.00,295,$-60.00
2025-02-17,05:50:00,22269.75,SELL,3,0.02h,Break Even,$-1.50,$-61.50,$136446.50,295,$-61.50
2025-02-17,06:07:00,22273.75,BUY,3,0.02h,Stop Loss,$-9.00,$-70.50,$136437.50,295,$-70.50
2025-02-17,06:08:00,22270.5,SELL,3,0.02h,Stop Loss,$16.50,$-54.00,$136454.00,295,$-54.00
2025-02-17,06:30:00,22269.5,BUY,3,0.02h,Break Even,$-1.50,$-55.50,$136452.50,295,$-55.50
2025-02-17,06:32:00,22266.0,SELL,3,0.02h,Stop Loss,$-9.00,$-64.50,$136443.50,295,$-64.50
2025-02-17,06:43:00,22269.75,BUY,3,0.02h,Stop Loss,$-9.00,$-73.50,$136434.50,295,$-73.50
2025-02-17,07:06:00,22269.0,SELL,3,0.02h,Stop Loss,$-9.00,$-82.50,$136425.50,295,$-82.50
2025-02-17,08:09:00,22249.5,BUY,3,0.02h,Stop Loss,$-9.00,$-91.50,$136416.50,295,$-91.50
2025-02-17,08:26:00,22246.0,SELL,3,0.02h,Break Even,$-1.50,$-93.00,$136415.00,295,$-93.00
2025-02-17,09:11:00,22237.75,BUY,3,0.02h,Break Even,$-1.50,$-94.50,$136413.50,295,$-94.50
2025-02-17,09:30:00,22238.25,SELL,3,0.02h,Break Even,$-1.50,$-96.00,$136412.00,295,$-96.00
2025-02-17,09:41:00,22244.5,BUY,3,0.02h,Break Even,$-1.50,$-97.50,$136410.50,295,$-97.50
2025-02-17,09:43:00,22229.25,SELL,3,0.02h,Stop Loss,$-9.00,$-106.50,$136401.50,295,$-106.50
2025-02-17,09:54:00,22240.5,BUY,3,0.02h,Break Even,$-1.50,$-108.00,$136400.00,295,$-108.00
2025-02-17,10:23:00,22245.0,SELL,3,0.02h,Stop Loss,$-9.00,$-117.00,$136391.00,295,$-117.00
2025-02-17,10:38:00,22248.75,BUY,3,0.02h,Break Even,$-1.50,$-118.50,$136389.50,295,$-118.50
2025-02-17,11:26:00,22255.25,SELL,3,0.02h,Stop Loss,$10.50,$-108.00,$136400.00,295,$-108.00
2025-02-17,12:07:00,22245.75,BUY,3,0.03h,Break Even,$-1.50,$-109.50,$136398.50,295,$-109.50
2025-02-17,12:37:00,22250.0,SELL,3,0.02h,Stop Loss,$-9.00,$-118.50,$136389.50,295,$-118.50
2025-02-17,12:38:00,22256.0,BUY,3,0.02h,Break Even,$-1.50,$-120.00,$136388.00,295,$-120.00
2025-02-17,12:54:00,22251.25,SELL,3,0.02h,Stop Loss,$3.00,$-117.00,$136391.00,295,$-117.00
2025-02-17,13:11:00,22251.75,BUY,3,0.02h,Stop Loss,$-9.00,$-126.00,$136382.00,295,$-126.00
2025-02-17,13:31:00,22250.25,SELL,3,0.02h,Stop Loss,$4.50,$-121.50,$136386.50,295,$-121.50
2025-02-17,13:50:00,22249.5,BUY,3,0.02h,Break Even,$-1.50,$-123.00,$136385.00,295,$-123.00
2025-02-17,14:16:00,22250.25,SELL,3,0.02h,Stop Loss,$-9.00,$-132.00,$136376.00,295,$-132.00
2025-02-17,15:05:00,22216.0,BUY,3,0.02h,Break Even,$-1.50,$-133.50,$136374.50,295,$-133.50
2025-02-17,16:35:00,22239.5,SELL,3,0.02h,Stop Loss,$-9.00,$-142.50,$136365.50,295,$-142.50
2025-02-17,16:51:00,22243.0,BUY,3,0.02h,Stop Loss,$-9.00,$-151.50,$136356.50,295,$-151.50
2025-02-17,16:55:00,22239.25,SELL,3,0.02h,Stop Loss,$4.50,$-147.00,$136361.00,295,$-147.00
2025-02-17,17:30:00,22231.0,BUY,3,0.02h,Break Even,$-1.50,$-148.50,$136359.50,295,$-148.50
2025-02-17,17:48:00,22231.75,SELL,3,0.02h,Stop Loss,$-9.00,$-157.50,$136350.50,295,$-157.50
2025-02-17,17:49:00,22235.75,BUY,3,0.02h,Stop Loss,$3.00,$-154.50,$136353.50,295,$-154.50
2025-02-17,17:59:00,22233.25,SELL,3,0.02h,Break Even,$-1.50,$-156.00,$136352.00,295,$-156.00
2025-02-17,23:48:00,22217.0,BUY,3,0.02h,Break Even,$-1.50,$-157.50,$136350.50,295,$-157.50
,,,,,,,,,,,
2025-02-18,00:22:00,22214.75,SELL,3,0.02h,Break Even,$-1.50,$-1.50,$136349.00,296,$-1.50
2025-02-18,00:35:00,22225.75,BUY,3,0.02h,Break Even,$-1.50,$-3.00,$136347.50,296,$-3.00
2025-02-18,00:54:00,22219.5,SELL,3,0.02h,Break Even,$-1.50,$-4.50,$136346.00,296,$-4.50
2025-02-18,00:59:00,22232.0,BUY,3,0.02h,Break Even,$-1.50,$-6.00,$136344.50,296,$-6.00
2025-02-18,02:06:00,22239.75,SELL,3,0.02h,Break Even,$-1.50,$-7.50,$136343.00,296,$-7.50
2025-02-18,02:22:00,22241.25,BUY,3,0.02h,Stop Loss,$-9.00,$-16.50,$136334.00,296,$-16.50
2025-02-18,02:24:00,22239.25,SELL,3,0.02h,Stop Loss,$-9.00,$-25.50,$136325.00,296,$-25.50
2025-02-18,02:25:00,22240.75,BUY,3,0.02h,Break Even,$-1.50,$-27.00,$136323.50,296,$-27.00
2025-02-18,02:32:00,22239.0,SELL,3,0.02h,Stop Loss,$-9.00,$-36.00,$136314.50,296,$-36.00
2025-02-18,02:33:00,22241.5,BUY,3,0.02h,Stop Loss,$-9.00,$-45.00,$136305.50,296,$-45.00
2025-02-18,04:12:00,22262.5,SELL,3,0.02h,Break Even,$-1.50,$-46.50,$136304.00,296,$-46.50
2025-02-18,04:18:00,22264.25,BUY,3,0.03h,Stop Loss,$-9.00,$-55.50,$136295.00,296,$-55.50
2025-02-18,04:21:00,22262.0,SELL,3,0.03h,Stop Loss,$-9.00,$-64.50,$136286.00,296,$-64.50
2025-02-18,04:37:00,22262.0,BUY,3,0.02h,Stop Loss,$-9.00,$-73.50,$136277.00,296,$-73.50
2025-02-18,05:09:00,22261.75,SELL,3,0.03h,Stop Loss,$-9.00,$-82.50,$136268.00,296,$-82.50
2025-02-18,06:08:00,22255.5,BUY,3,0.02h,Stop Loss,$-9.00,$-91.50,$136259.00,296,$-91.50
2025-02-18,07:27:00,22303.5,SELL,3,0.02h,Break Even,$-1.50,$-93.00,$136257.50,296,$-93.00
2025-02-18,07:41:00,22308.25,BUY,3,0.02h,Stop Loss,$-9.00,$-102.00,$136248.50,296,$-102.00
2025-02-18,07:51:00,22298.25,SELL,3,0.02h,Break Even,$-1.50,$-103.50,$136247.00,296,$-103.50
2025-02-18,07:57:00,22308.75,BUY,3,0.03h,Stop Loss,$27.00,$-76.50,$136274.00,296,$-76.50
2025-02-18,08:03:00,22295.5,SELL,3,0.02h,Break Even,$-1.50,$-78.00,$136272.50,296,$-78.00
2025-02-18,08:25:00,22295.0,BUY,3,0.02h,Stop Loss,$-9.00,$-87.00,$136263.50,296,$-87.00
2025-02-18,08:36:00,22281.0,SELL,3,0.02h,Stop Loss,$-9.00,$-96.00,$136254.50,296,$-96.00
2025-02-18,08:56:00,22289.75,BUY,3,0.02h,Break Even,$-1.50,$-97.50,$136253.00,296,$-97.50
2025-02-18,09:07:00,22287.25,SELL,3,0.02h,Stop Loss,$6.00,$-91.50,$136259.00,296,$-91.50
2025-02-18,09:14:00,22295.25,BUY,3,0.02h,Stop Loss,$3.00,$-88.50,$136262.00,296,$-88.50
2025-02-18,09:29:00,22286.0,SELL,3,0.02h,Stop Loss,$-9.00,$-97.50,$136253.00,296,$-97.50
2025-02-18,10:25:00,22278.75,BUY,3,0.02h,Stop Loss,$-9.00,$-106.50,$136244.00,296,$-106.50
2025-02-18,11:12:00,22278.0,SELL,3,0.02h,Stop Loss,$-9.00,$-115.50,$136235.00,296,$-115.50
2025-02-18,11:20:00,22283.75,BUY,3,0.02h,Break Even,$-1.50,$-117.00,$136233.50,296,$-117.00
2025-02-18,11:36:00,22279.25,SELL,3,0.02h,Stop Loss,$-9.00,$-126.00,$136224.50,296,$-126.00
2025-02-18,12:07:00,22282.75,BUY,3,0.02h,Break Even,$-1.50,$-127.50,$136223.00,296,$-127.50
2025-02-18,12:49:00,22289.25,SELL,3,0.02h,Break Even,$-1.50,$-129.00,$136221.50,296,$-129.00
2025-02-18,13:19:00,22288.0,BUY,3,0.02h,Stop Loss,$15.00,$-114.00,$136236.50,296,$-114.00
2025-02-18,14:22:00,22305.5,SELL,3,0.02h,Stop Loss,$-9.00,$-123.00,$136227.50,296,$-123.00
2025-02-18,15:44:00,22170.25,BUY,3,0.02h,Break Even,$-1.50,$-124.50,$136226.00,296,$-124.50
2025-02-18,15:46:00,22154.25,SELL,3,0.02h,Stop Loss,$100.50,$-24.00,$136326.50,296,$-24.00
2025-02-18,15:53:00,22173.25,BUY,3,0.02h,Stop Loss,$6.00,$-18.00,$136332.50,296,$-18.00
2025-02-18,16:23:00,22168.75,SELL,3,0.02h,Stop Loss,$3.00,$-15.00,$136335.50,296,$-15.00
2025-02-18,16:29:00,22199.25,BUY,3,0.02h,Stop Loss,$16.50,$1.50,$136352.00,296,$1.50
2025-02-18,16:34:00,22181.0,SELL,3,0.02h,Break Even,$-1.50,$0.00,$136350.50,296,$0.00
2025-02-18,16:48:00,22203.5,BUY,3,0.02h,Stop Loss,$15.00,$15.00,$136365.50,296,$15.00
2025-02-18,17:01:00,22181.5,SELL,3,0.02h,Break Even,$-1.50,$13.50,$136364.00,296,$13.50
2025-02-18,17:33:00,22183.75,BUY,3,0.02h,Stop Loss,$-9.00,$4.50,$136355.00,296,$4.50
2025-02-18,18:10:00,22182.5,SELL,3,0.02h,Stop Loss,$9.00,$13.50,$136364.00,296,$13.50
2025-02-18,18:52:00,22162.0,BUY,3,0.02h,Stop Loss,$18.00,$31.50,$136382.00,296,$31.50
2025-02-18,19:08:00,22124.0,SELL,3,0.02h,Stop Loss,$105.00,$136.50,$136487.00,296,$136.50
2025-02-18,19:26:00,22151.0,BUY,3,0.02h,Stop Loss,$3.00,$139.50,$136490.00,296,$139.50
2025-02-18,20:17:00,22168.75,SELL,3,0.02h,Stop Loss,$-9.00,$130.50,$136481.00,296,$130.50
2025-02-18,20:26:00,22178.75,BUY,3,0.02h,Break Even,$-1.50,$129.00,$136479.50,296,$129.00
2025-02-18,20:30:00,22170.0,SELL,3,0.02h,Stop Loss,$4.50,$133.50,$136484.00,296,$133.50
2025-02-18,20:33:00,22177.0,BUY,3,0.02h,Stop Loss,$-9.00,$124.50,$136475.00,296,$124.50
2025-02-18,20:35:00,22170.0,SELL,3,0.02h,Stop Loss,$18.00,$142.50,$136493.00,296,$142.50
2025-02-18,20:43:00,22174.75,BUY,3,0.02h,Break Even,$-1.50,$141.00,$136491.50,296,$141.00
2025-02-18,20:44:00,22164.75,SELL,3,0.02h,Break Even,$-1.50,$139.50,$136490.00,296,$139.50
2025-02-18,20:53:00,22176.5,BUY,3,0.02h,Break Even,$-1.50,$138.00,$136488.50,296,$138.00
2025-02-18,21:34:00,22221.5,SELL,3,0.02h,Break Even,$-1.50,$136.50,$136487.00,296,$136.50
2025-02-18,23:01:00,22242.5,BUY,3,0.02h,Stop Loss,$24.00,$160.50,$136511.00,296,$160.50
2025-02-18,23:30:00,22236.0,SELL,3,0.02h,Break Even,$-1.50,$159.00,$136509.50,296,$159.00
2025-02-18,23:37:00,22245.75,BUY,3,0.03h,Stop Loss,$-9.00,$150.00,$136500.50,296,$150.00
,,,,,,,,,,,
2025-02-19,01:25:00,22273.5,SELL,3,0.02h,Stop Loss,$-9.00,$-9.00,$136491.50,297,$-9.00
2025-02-19,01:26:00,22278.5,BUY,3,0.02h,Break Even,$-1.50,$-10.50,$136490.00,297,$-10.50
2025-02-19,01:35:00,22274.5,SELL,3,0.02h,Stop Loss,$-9.00,$-19.50,$136481.00,297,$-19.50
2025-02-19,02:21:00,22272.75,BUY,3,0.02h,Stop Loss,$-9.00,$-28.50,$136472.00,297,$-28.50
2025-02-19,03:11:00,22284.5,SELL,3,0.03h,Break Even,$-1.50,$-30.00,$136470.50,297,$-30.00
2025-02-19,03:24:00,22285.75,BUY,3,0.05h,Stop Loss,$-9.00,$-39.00,$136461.50,297,$-39.00
2025-02-19,03:28:00,22283.25,SELL,3,0.02h,Break Even,$-1.50,$-40.50,$136460.00,297,$-40.50
2025-02-19,03:43:00,22287.0,BUY,3,0.02h,Break Even,$-1.50,$-42.00,$136458.50,297,$-42.00
2025-02-19,04:02:00,22283.75,SELL,3,0.02h,Break Even,$-1.50,$-43.50,$136457.00,297,$-43.50
2025-02-19,05:32:00,22266.25,BUY,3,0.02h,Stop Loss,$-9.00,$-52.50,$136448.00,297,$-52.50
2025-02-19,05:41:00,22256.5,SELL,3,0.02h,Break Even,$-1.50,$-54.00,$136446.50,297,$-54.00
2025-02-19,05:55:00,22263.5,BUY,3,0.02h,Stop Loss,$-9.00,$-63.00,$136437.50,297,$-63.00
2025-02-19,06:19:00,22262.75,SELL,3,0.03h,Stop Loss,$-9.00,$-72.00,$136428.50,297,$-72.00
2025-02-19,06:28:00,22264.25,BUY,3,0.02h,Break Even,$-1.50,$-73.50,$136427.00,297,$-73.50
2025-02-19,06:47:00,22266.0,SELL,3,0.05h,Break Even,$-1.50,$-75.00,$136425.50,297,$-75.00
2025-02-19,07:32:00,22256.25,BUY,3,0.02h,Break Even,$-1.50,$-76.50,$136424.00,297,$-76.50
2025-02-19,07:46:00,22254.25,SELL,3,0.02h,Stop Loss,$-9.00,$-85.50,$136415.00,297,$-85.50
2025-02-19,07:48:00,22257.25,BUY,3,0.02h,Break Even,$-1.50,$-87.00,$136413.50,297,$-87.00
2025-02-19,07:55:00,22251.5,SELL,3,0.02h,Break Even,$-1.50,$-88.50,$136412.00,297,$-88.50
2025-02-19,08:02:00,22260.25,BUY,3,0.02h,Stop Loss,$9.00,$-79.50,$136421.00,297,$-79.50
2025-02-19,08:12:00,22255.25,SELL,3,0.02h,Break Even,$-1.50,$-81.00,$136419.50,297,$-81.00
2025-02-19,08:18:00,22259.25,BUY,3,0.02h,Break Even,$-1.50,$-82.50,$136418.00,297,$-82.50
2025-02-19,08:25:00,22255.0,SELL,3,0.02h,Stop Loss,$31.50,$-51.00,$136449.50,297,$-51.00
2025-02-19,08:32:00,22262.75,BUY,3,0.02h,Stop Loss,$9.00,$-42.00,$136458.50,297,$-42.00
2025-02-19,08:51:00,22256.0,SELL,3,0.02h,Break Even,$-1.50,$-43.50,$136457.00,297,$-43.50
2025-02-19,09:02:00,22265.0,BUY,3,0.02h,Break Even,$-1.50,$-45.00,$136455.50,297,$-45.00
2025-02-19,09:07:00,22259.25,SELL,3,0.02h,Break Even,$-1.50,$-46.50,$136454.00,297,$-46.50
2025-02-19,09:08:00,22261.75,BUY,3,0.02h,Break Even,$-1.50,$-48.00,$136452.50,297,$-48.00
2025-02-19,09:11:00,22257.0,SELL,3,0.02h,Stop Loss,$12.00,$-36.00,$136464.50,297,$-36.00
2025-02-19,09:19:00,22262.0,BUY,3,0.02h,Stop Loss,$3.00,$-33.00,$136467.50,297,$-33.00
2025-02-19,09:35:00,22258.0,SELL,3,0.02h,Stop Loss,$-9.00,$-42.00,$136458.50,297,$-42.00
2025-02-19,10:56:00,22222.75,BUY,3,0.02h,Stop Loss,$-9.00,$-51.00,$136449.50,297,$-51.00
2025-02-19,11:03:00,22212.25,SELL,3,0.02h,Break Even,$-1.50,$-52.50,$136448.00,297,$-52.50
2025-02-19,11:05:00,22219.0,BUY,3,0.02h,Break Even,$-1.50,$-54.00,$136446.50,297,$-54.00
2025-02-19,11:25:00,22217.5,SELL,3,0.02h,Stop Loss,$7.50,$-46.50,$136454.00,297,$-46.50
2025-02-19,11:58:00,22212.25,BUY,3,0.02h,Break Even,$-1.50,$-48.00,$136452.50,297,$-48.00
2025-02-19,12:39:00,22237.75,SELL,3,0.02h,Stop Loss,$-9.00,$-57.00,$136443.50,297,$-57.00
2025-02-19,12:44:00,22243.0,BUY,3,0.02h,Stop Loss,$-9.00,$-66.00,$136434.50,297,$-66.00
2025-02-19,13:00:00,22228.5,SELL,3,0.02h,Stop Loss,$48.00,$-18.00,$136482.50,297,$-18.00
2025-02-19,13:50:00,22206.5,BUY,3,0.02h,Stop Loss,$-9.00,$-27.00,$136473.50,297,$-27.00
2025-02-19,14:02:00,22198.5,SELL,3,0.02h,Stop Loss,$-9.00,$-36.00,$136464.50,297,$-36.00
2025-02-19,14:03:00,22208.0,BUY,3,0.02h,Break Even,$-1.50,$-37.50,$136463.00,297,$-37.50
2025-02-19,14:18:00,22196.25,SELL,3,0.02h,Break Even,$-1.50,$-39.00,$136461.50,297,$-39.00
2025-02-19,14:37:00,22215.75,BUY,3,0.02h,Stop Loss,$13.50,$-25.50,$136475.00,297,$-25.50
2025-02-19,14:42:00,22187.0,SELL,3,0.02h,Stop Loss,$31.50,$6.00,$136506.50,297,$6.00
2025-02-19,15:31:00,22162.0,BUY,3,0.02h,Stop Loss,$141.00,$147.00,$136647.50,297,$147.00
2025-02-19,15:57:00,22157.0,SELL,3,0.02h,Stop Loss,$42.00,$189.00,$136689.50,297,$189.00
2025-02-19,16:03:00,22193.25,BUY,3,0.02h,Stop Loss,$18.00,$207.00,$136707.50,297,$207.00
2025-02-19,17:17:00,22235.25,SELL,3,0.02h,Break Even,$-1.50,$205.50,$136706.00,297,$205.50
2025-02-19,17:44:00,22234.25,BUY,3,0.02h,Stop Loss,$-9.00,$196.50,$136697.00,297,$196.50
2025-02-19,18:06:00,22222.25,SELL,3,0.02h,Stop Loss,$4.50,$201.00,$136701.50,297,$201.00
2025-02-19,18:20:00,22238.75,BUY,3,0.02h,Break Even,$-1.50,$199.50,$136700.00,297,$199.50
2025-02-19,18:50:00,22244.5,SELL,3,0.02h,Stop Loss,$12.00,$211.50,$136712.00,297,$211.50
2025-02-19,19:14:00,22250.25,BUY,3,0.02h,Stop Loss,$100.50,$312.00,$136812.50,297,$312.00
2025-02-19,20:05:00,22277.5,SELL,3,0.02h,Stop Loss,$10.50,$322.50,$136823.00,297,$322.50
2025-02-19,20:56:00,22250.25,BUY,3,0.02h,Stop Loss,$3.00,$325.50,$136826.00,297,$325.50
2025-02-19,21:03:00,22227.5,SELL,3,0.02h,Stop Loss,$40.50,$366.00,$136866.50,297,$366.00
2025-02-19,21:38:00,22226.25,BUY,3,0.02h,Stop Loss,$-9.00,$357.00,$136857.50,297,$357.00
2025-02-19,21:39:00,22221.0,SELL,3,0.02h,Stop Loss,$-9.00,$348.00,$136848.50,297,$348.00
2025-02-19,21:59:00,22223.25,BUY,3,1.03h,Stop Loss,$27.00,$375.00,$136875.50,297,$375.00
2025-02-19,23:26:00,22224.25,SELL,3,0.02h,Break Even,$-1.50,$373.50,$136874.00,297,$373.50
,,,,,,,,,,,
2025-02-20,00:10:00,22219.25,BUY,3,0.02h,Stop Loss,$-9.00,$-9.00,$136865.00,298,$-9.00
2025-02-20,00:15:00,22216.75,SELL,3,0.02h,Break Even,$-1.50,$-10.50,$136863.50,298,$-10.50
2025-02-20,00:40:00,22214.75,BUY,3,0.02h,Break Even,$-1.50,$-12.00,$136862.00,298,$-12.00
2025-02-20,01:10:00,22214.5,SELL,3,0.02h,Break Even,$-1.50,$-13.50,$136860.50,298,$-13.50
2025-02-20,02:11:00,22177.75,BUY,3,0.03h,Stop Loss,$21.00,$7.50,$136881.50,298,$7.50
2025-02-20,02:30:00,22176.75,SELL,3,0.02h,Break Even,$-1.50,$6.00,$136880.00,298,$6.00
2025-02-20,02:40:00,22184.25,BUY,3,0.02h,Stop Loss,$-9.00,$-3.00,$136871.00,298,$-3.00
2025-02-20,02:47:00,22175.25,SELL,3,0.02h,Stop Loss,$-9.00,$-12.00,$136862.00,298,$-12.00
2025-02-20,02:49:00,22181.0,BUY,3,0.02h,Break Even,$-1.50,$-13.50,$136860.50,298,$-13.50
2025-02-20,03:17:00,22180.75,SELL,3,0.02h,Stop Loss,$-9.00,$-22.50,$136851.50,298,$-22.50
2025-02-20,03:32:00,22183.75,BUY,3,0.02h,Break Even,$-1.50,$-24.00,$136850.00,298,$-24.00
2025-02-20,03:55:00,22184.5,SELL,3,0.02h,Stop Loss,$-9.00,$-33.00,$136841.00,298,$-33.00
2025-02-20,04:22:00,22179.25,BUY,3,0.02h,Stop Loss,$-9.00,$-42.00,$136832.00,298,$-42.00
2025-02-20,04:40:00,22176.5,SELL,3,0.02h,Break Even,$-1.50,$-43.50,$136830.50,298,$-43.50
2025-02-20,05:10:00,22175.25,BUY,3,0.02h,Break Even,$-1.50,$-45.00,$136829.00,298,$-45.00
2025-02-20,05:35:00,22175.75,SELL,3,0.02h,Break Even,$-1.50,$-46.50,$136827.50,298,$-46.50
2025-02-20,06:43:00,22157.75,BUY,3,0.02h,Break Even,$-1.50,$-48.00,$136826.00,298,$-48.00
2025-02-20,06:49:00,22153.75,SELL,3,0.02h,Stop Loss,$-9.00,$-57.00,$136817.00,298,$-57.00
2025-02-20,06:55:00,22158.0,BUY,3,0.02h,Break Even,$-1.50,$-58.50,$136815.50,298,$-58.50
2025-02-20,07:03:00,22152.75,SELL,3,0.02h,Break Even,$-1.50,$-60.00,$136814.00,298,$-60.00
2025-02-20,07:16:00,22161.25,BUY,3,0.02h,Break Even,$-1.50,$-61.50,$136812.50,298,$-61.50
2025-02-20,07:47:00,22158.5,SELL,3,0.02h,Stop Loss,$40.50,$-21.00,$136853.00,298,$-21.00
2025-02-20,08:04:00,22158.75,BUY,3,0.02h,Stop Loss,$-9.00,$-30.00,$136844.00,298,$-30.00
2025-02-20,09:26:00,22184.5,SELL,3,0.02h,Break Even,$-1.50,$-31.50,$136842.50,298,$-31.50
2025-02-20,09:27:00,22187.75,BUY,3,0.02h,Break Even,$-1.50,$-33.00,$136841.00,298,$-33.00
2025-02-20,09:34:00,22183.5,SELL,3,0.02h,Break Even,$-1.50,$-34.50,$136839.50,298,$-34.50
2025-02-20,09:46:00,22190.0,BUY,3,0.02h,Stop Loss,$-9.00,$-43.50,$136830.50,298,$-43.50
2025-02-20,10:38:00,22210.0,SELL,3,0.02h,Stop Loss,$-9.00,$-52.50,$136821.50,298,$-52.50
2025-02-20,10:45:00,22212.75,BUY,3,0.03h,Break Even,$-1.50,$-54.00,$136820.00,298,$-54.00
2025-02-20,10:55:00,22208.0,SELL,3,0.02h,Stop Loss,$-9.00,$-63.00,$136811.00,298,$-63.00
2025-02-20,11:51:00,22192.75,BUY,3,0.02h,Stop Loss,$3.00,$-60.00,$136814.00,298,$-60.00
2025-02-20,12:08:00,22188.25,SELL,3,0.02h,Break Even,$-1.50,$-61.50,$136812.50,298,$-61.50
2025-02-20,12:33:00,22192.25,BUY,3,0.02h,Stop Loss,$13.50,$-48.00,$136826.00,298,$-48.00
2025-02-20,13:07:00,22199.0,SELL,3,0.02h,Break Even,$-1.50,$-49.50,$136824.50,298,$-49.50
2025-02-20,13:44:00,22201.75,BUY,3,0.02h,Stop Loss,$4.50,$-45.00,$136829.00,298,$-45.00
2025-02-20,13:53:00,22193.0,SELL,3,0.02h,Break Even,$-1.50,$-46.50,$136827.50,298,$-46.50
2025-02-20,13:59:00,22201.25,BUY,3,0.02h,Break Even,$-1.50,$-48.00,$136826.00,298,$-48.00
2025-02-20,14:27:00,22209.75,SELL,3,0.02h,Stop Loss,$18.00,$-30.00,$136844.00,298,$-30.00
2025-02-20,15:19:00,22081.25,BUY,3,0.02h,Stop Loss,$16.50,$-13.50,$136860.50,298,$-13.50
2025-02-20,15:43:00,22073.25,SELL,3,0.02h,Stop Loss,$40.50,$27.00,$136901.00,298,$27.00
2025-02-20,16:10:00,22053.5,BUY,3,0.02h,Stop Loss,$40.50,$67.50,$136941.50,298,$67.50
2025-02-20,16:20:00,22029.0,SELL,3,0.02h,Stop Loss,$-9.00,$58.50,$136932.50,298,$58.50
2025-02-20,16:22:00,22050.0,BUY,3,0.02h,Stop Loss,$-9.00,$49.50,$136923.50,298,$49.50
2025-02-20,16:37:00,22033.5,SELL,3,0.02h,Stop Loss,$73.50,$123.00,$136997.00,298,$123.00
2025-02-20,16:45:00,22055.5,BUY,3,0.02h,Break Even,$-1.50,$121.50,$136995.50,298,$121.50
2025-02-20,16:48:00,22033.0,SELL,3,0.02h,Stop Loss,$6.00,$127.50,$137001.50,298,$127.50
2025-02-20,16:53:00,22055.0,BUY,3,0.02h,Stop Loss,$-9.00,$118.50,$136992.50,298,$118.50
2025-02-20,16:54:00,22038.25,SELL,3,0.02h,Break Even,$-1.50,$117.00,$136991.00,298,$117.00
2025-02-20,17:04:00,22061.25,BUY,3,0.02h,Stop Loss,$22.50,$139.50,$137013.50,298,$139.50
2025-02-20,17:50:00,22068.25,SELL,3,0.02h,Stop Loss,$6.00,$145.50,$137019.50,298,$145.50
2025-02-20,18:14:00,22065.75,BUY,3,0.02h,Break Even,$-1.50,$144.00,$137018.00,298,$144.00
2025-02-20,18:19:00,22052.25,SELL,3,0.02h,Stop Loss,$9.00,$153.00,$137027.00,298,$153.00
2025-02-20,18:34:00,22059.0,BUY,3,0.02h,Stop Loss,$-9.00,$144.00,$137018.00,298,$144.00
2025-02-20,18:52:00,22052.0,SELL,3,0.02h,Stop Loss,$7.50,$151.50,$137025.50,298,$151.50
2025-02-20,18:58:00,22063.5,BUY,3,0.02h,Stop Loss,$48.00,$199.50,$137073.50,298,$199.50
2025-02-20,19:33:00,22083.5,SELL,3,0.02h,Stop Loss,$12.00,$211.50,$137085.50,298,$211.50
2025-02-20,19:48:00,22102.0,BUY,3,0.02h,Stop Loss,$40.50,$252.00,$137126.00,298,$252.00
2025-02-20,20:13:00,22103.25,SELL,3,0.02h,Break Even,$-1.50,$250.50,$137124.50,298,$250.50
2025-02-20,20:23:00,22118.5,BUY,3,0.02h,Stop Loss,$-9.00,$241.50,$137115.50,298,$241.50
2025-02-20,20:28:00,22095.0,SELL,3,0.02h,Stop Loss,$-9.00,$232.50,$137106.50,298,$232.50
2025-02-20,20:44:00,22111.75,BUY,3,0.02h,Stop Loss,$25.50,$258.00,$137132.00,298,$258.00
2025-02-20,21:16:00,22127.5,SELL,3,0.02h,Stop Loss,$-9.00,$249.00,$137123.00,298,$249.00
2025-02-20,21:25:00,22135.0,BUY,3,0.02h,Stop Loss,$-9.00,$240.00,$137114.00,298,$240.00
2025-02-20,21:52:00,22134.0,SELL,3,0.02h,Break Even,$-1.50,$238.50,$137112.50,298,$238.50
2025-02-20,23:02:00,22142.25,BUY,3,0.02h,Stop Loss,$16.50,$255.00,$137129.00,298,$255.00
2025-02-20,23:26:00,22142.5,SELL,3,0.02h,Stop Loss,$-9.00,$246.00,$137120.00,298,$246.00
2025-02-20,23:31:00,22152.0,BUY,3,0.02h,Break Even,$-1.50,$244.50,$137118.50,298,$244.50
2025-02-20,23:59:00,22161.0,SELL,3,0.02h,Stop Loss,$-9.00,$235.50,$137109.50,298,$235.50
,,,,,,,,,,,
2025-02-21,00:08:00,22165.75,BUY,3,0.02h,Break Even,$-1.50,$-1.50,$137108.00,299,$-1.50
2025-02-21,00:11:00,22161.75,SELL,3,0.02h,Stop Loss,$-9.00,$-10.50,$137099.00,299,$-10.50
2025-02-21,00:14:00,22167.0,BUY,3,0.02h,Stop Loss,$-9.00,$-19.50,$137090.00,299,$-19.50
2025-02-21,00:21:00,22160.75,SELL,3,0.02h,Stop Loss,$46.50,$27.00,$137136.50,299,$27.00
2025-02-21,00:54:00,22155.5,BUY,3,0.02h,Stop Loss,$-9.00,$18.00,$137127.50,299,$18.00
2025-02-21,01:08:00,22146.25,SELL,3,0.02h,Break Even,$-1.50,$16.50,$137126.00,299,$16.50
2025-02-21,01:40:00,22151.0,BUY,3,0.02h,Break Even,$-1.50,$15.00,$137124.50,299,$15.00
2025-02-21,02:00:00,22140.25,SELL,3,0.02h,Stop Loss,$-9.00,$6.00,$137115.50,299,$6.00
2025-02-21,02:11:00,22145.5,BUY,3,0.02h,Stop Loss,$-9.00,$-3.00,$137106.50,299,$-3.00
2025-02-21,02:31:00,22143.75,SELL,3,0.02h,Stop Loss,$-9.00,$-12.00,$137097.50,299,$-12.00
2025-02-21,02:48:00,22150.5,BUY,3,0.02h,Stop Loss,$15.00,$3.00,$137112.50,299,$3.00
2025-02-21,03:06:00,22148.5,SELL,3,0.03h,Stop Loss,$-9.00,$-6.00,$137103.50,299,$-6.00
2025-02-21,03:24:00,22153.25,BUY,3,0.03h,Stop Loss,$-9.00,$-15.00,$137094.50,299,$-15.00
2025-02-21,03:31:00,22145.25,SELL,3,0.02h,Stop Loss,$-9.00,$-24.00,$137085.50,299,$-24.00
2025-02-21,04:14:00,22141.75,BUY,3,0.02h,Stop Loss,$-9.00,$-33.00,$137076.50,299,$-33.00
2025-02-21,04:17:00,22138.0,SELL,3,0.02h,Break Even,$-1.50,$-34.50,$137075.00,299,$-34.50
2025-02-21,05:18:00,22128.5,BUY,3,0.02h,Break Even,$-1.50,$-36.00,$137073.50,299,$-36.00
2025-02-21,05:49:00,22125.0,SELL,3,0.02h,Break Even,$-1.50,$-37.50,$137072.00,299,$-37.50
2025-02-21,06:04:00,22127.75,BUY,3,0.07h,Stop Loss,$37.50,$0.00,$137109.50,299,$0.00
2025-02-21,07:19:00,22149.0,SELL,3,0.02h,Break Even,$-1.50,$-1.50,$137108.00,299,$-1.50
2025-02-21,07:21:00,22153.25,BUY,3,0.02h,Stop Loss,$-9.00,$-10.50,$137099.00,299,$-10.50
2025-02-21,07:22:00,22148.0,SELL,3,0.02h,Break Even,$-1.50,$-12.00,$137097.50,299,$-12.00
2025-02-21,07:25:00,22153.5,BUY,3,0.02h,Stop Loss,$15.00,$3.00,$137112.50,299,$3.00
2025-02-21,07:36:00,22149.5,SELL,3,0.03h,Break Even,$-1.50,$1.50,$137111.00,299,$1.50
2025-02-21,08:31:00,22144.25,BUY,3,0.02h,Break Even,$-1.50,$0.00,$137109.50,299,$0.00
2025-02-21,09:10:00,22144.5,SELL,3,0.02h,Stop Loss,$-9.00,$-9.00,$137100.50,299,$-9.00
2025-02-21,09:12:00,22148.5,BUY,3,0.02h,Stop Loss,$-9.00,$-18.00,$137091.50,299,$-18.00
2025-02-21,09:13:00,22145.75,SELL,3,0.02h,Stop Loss,$-9.00,$-27.00,$137082.50,299,$-27.00
2025-02-21,09:14:00,22149.0,BUY,3,0.02h,Stop Loss,$-9.00,$-36.00,$137073.50,299,$-36.00
2025-02-21,10:03:00,22158.75,SELL,3,0.02h,Stop Loss,$-9.00,$-45.00,$137064.50,299,$-45.00
2025-02-21,10:15:00,22167.25,BUY,3,0.02h,Break Even,$-1.50,$-46.50,$137063.00,299,$-46.50
2025-02-21,10:33:00,22167.0,SELL,3,0.02h,Stop Loss,$-9.00,$-55.50,$137054.00,299,$-55.50
2025-02-21,10:55:00,22167.75,BUY,3,0.02h,Stop Loss,$-9.00,$-64.50,$137045.00,299,$-64.50
2025-02-21,11:20:00,22166.0,SELL,3,0.02h,Stop Loss,$-9.00,$-73.50,$137036.00,299,$-73.50
2025-02-21,11:55:00,22164.75,BUY,3,0.02h,Stop Loss,$-9.00,$-82.50,$137027.00,299,$-82.50
2025-02-21,13:07:00,22208.25,SELL,3,0.02h,Stop Loss,$-9.00,$-91.50,$137018.00,299,$-91.50
2025-02-21,13:12:00,22217.5,BUY,3,0.02h,Stop Loss,$-9.00,$-100.50,$137009.00,299,$-100.50
2025-02-21,13:58:00,22225.75,SELL,3,0.02h,Break Even,$-1.50,$-102.00,$137007.50,299,$-102.00
2025-02-21,14:19:00,22229.0,BUY,3,0.02h,Stop Loss,$-9.00,$-111.00,$136998.50,299,$-111.00
2025-02-21,14:21:00,22224.75,SELL,3,0.02h,Stop Loss,$-9.00,$-120.00,$136989.50,299,$-120.00
2025-02-21,14:22:00,22226.25,BUY,3,0.02h,Stop Loss,$-9.00,$-129.00,$136980.50,299,$-129.00
2025-02-21,14:23:00,22223.5,SELL,3,0.02h,Stop Loss,$22.50,$-106.50,$137003.00,299,$-106.50
2025-02-21,16:01:00,22015.25,BUY,3,0.02h,Stop Loss,$15.00,$-91.50,$137018.00,299,$-91.50
2025-02-21,16:07:00,21980.75,SELL,3,0.02h,Stop Loss,$31.50,$-60.00,$137049.50,299,$-60.00
2025-02-21,16:15:00,22015.25,BUY,3,0.02h,Stop Loss,$9.00,$-51.00,$137058.50,299,$-51.00
2025-02-21,16:30:00,21992.75,SELL,3,0.02h,Stop Loss,$58.50,$7.50,$137117.00,299,$7.50
2025-02-21,16:34:00,22015.0,BUY,3,0.02h,Stop Loss,$25.50,$33.00,$137142.50,299,$33.00
2025-02-21,16:44:00,21990.5,SELL,3,0.02h,Stop Loss,$10.50,$43.50,$137153.00,299,$43.50
2025-02-21,17:06:00,21991.5,BUY,3,0.02h,Break Even,$-1.50,$42.00,$137151.50,299,$42.00
2025-02-21,17:09:00,21978.25,SELL,3,0.02h,Stop Loss,$63.00,$105.00,$137214.50,299,$105.00
2025-02-21,18:39:00,21832.25,BUY,3,0.02h,Stop Loss,$-9.00,$96.00,$137205.50,299,$96.00
2025-02-21,18:42:00,21794.25,SELL,3,0.02h,Stop Loss,$-9.00,$87.00,$137196.50,299,$87.00
2025-02-21,19:54:00,21706.5,BUY,3,0.02h,Stop Loss,$-9.00,$78.00,$137187.50,299,$78.00
2025-02-21,19:55:00,21690.25,SELL,3,0.02h,Stop Loss,$-9.00,$69.00,$137178.50,299,$69.00
2025-02-21,19:56:00,21706.25,BUY,3,0.02h,Break Even,$-1.50,$67.50,$137177.00,299,$67.50
2025-02-21,19:59:00,21692.0,SELL,3,0.02h,Stop Loss,$37.50,$105.00,$137214.50,299,$105.00
2025-02-21,20:16:00,21699.0,BUY,3,0.02h,Break Even,$-1.50,$103.50,$137213.00,299,$103.50
2025-02-21,20:19:00,21691.0,SELL,3,0.02h,Stop Loss,$-9.00,$94.50,$137204.00,299,$94.50
2025-02-21,20:20:00,21699.25,BUY,3,0.02h,Break Even,$-1.50,$93.00,$137202.50,299,$93.00
2025-02-21,20:40:00,21696.5,SELL,3,0.02h,Stop Loss,$4.50,$97.50,$137207.00,299,$97.50
2025-02-21,20:56:00,21695.0,BUY,3,0.02h,Stop Loss,$-9.00,$88.50,$137198.00,299,$88.50
2025-02-21,20:57:00,21682.5,SELL,3,0.02h,Stop Loss,$24.00,$112.50,$137222.00,299,$112.50
2025-02-21,21:02:00,21688.5,BUY,3,0.02h,Stop Loss,$4.50,$117.00,$137226.50,299,$117.00
2025-02-21,21:05:00,21683.75,SELL,3,0.02h,Stop Loss,$9.00,$126.00,$137235.50,299,$126.00
2025-02-21,21:08:00,21690.75,BUY,3,0.02h,Break Even,$-1.50,$124.50,$137234.00,299,$124.50
2025-02-21,21:12:00,21683.0,SELL,3,0.02h,Stop Loss,$10.50,$135.00,$137244.50,299,$135.00
,,,,,,,,,,,
2025-02-24,00:00:00,21758.0,BUY,3,0.02h,Stop Loss,$27.00,$27.00,$137271.50,300,$27.00
2025-02-24,00:41:00,21766.0,SELL,3,0.02h,Stop Loss,$-9.00,$18.00,$137262.50,300,$18.00
2025-02-24,00:49:00,21777.25,BUY,3,0.02h,Stop Loss,$3.00,$21.00,$137265.50,300,$21.00
2025-02-24,00:51:00,21771.5,SELL,3,0.02h,Break Even,$-1.50,$19.50,$137264.00,300,$19.50
2025-02-24,01:06:00,21772.75,BUY,3,0.02h,Break Even,$-1.50,$18.00,$137262.50,300,$18.00
2025-02-24,01:20:00,21766.75,SELL,3,0.02h,Break Even,$-1.50,$16.50,$137261.00,300,$16.50
2025-02-24,01:46:00,21758.75,BUY,3,0.02h,Stop Loss,$12.00,$28.50,$137273.00,300,$28.50
2025-02-24,01:55:00,21744.25,SELL,3,0.02h,Stop Loss,$46.50,$75.00,$137319.50,300,$75.00
2025-02-24,02:07:00,21756.0,BUY,3,0.02h,Break Even,$-1.50,$73.50,$137318.00,300,$73.50
2025-02-24,02:46:00,21771.0,SELL,3,0.02h,Stop Loss,$-9.00,$64.50,$137309.00,300,$64.50
2025-02-24,02:47:00,21777.75,BUY,3,0.02h,Stop Loss,$13.50,$78.00,$137322.50,300,$78.00
2025-02-24,03:15:00,21774.25,SELL,3,0.02h,Break Even,$-1.50,$76.50,$137321.00,300,$76.50
2025-02-24,03:41:00,21775.25,BUY,3,0.02h,Stop Loss,$12.00,$88.50,$137333.00,300,$88.50
2025-02-24,04:14:00,21784.25,SELL,3,0.02h,Break Even,$-1.50,$87.00,$137331.50,300,$87.00
2025-02-24,04:26:00,21788.0,BUY,3,0.03h,Break Even,$-1.50,$85.50,$137330.00,300,$85.50
2025-02-24,04:34:00,21782.75,SELL,3,0.02h,Stop Loss,$-9.00,$76.50,$137321.00,300,$76.50
2025-02-24,04:52:00,21786.0,BUY,3,0.02h,Stop Loss,$-9.00,$67.50,$137312.00,300,$67.50
2025-02-24,04:56:00,21778.75,SELL,3,0.02h,Stop Loss,$19.50,$87.00,$137331.50,300,$87.00
2025-02-24,05:19:00,21779.75,BUY,3,0.02h,Stop Loss,$-9.00,$78.00,$137322.50,300,$78.00
2025-02-24,05:53:00,21790.5,SELL,3,0.02h,Break Even,$-1.50,$76.50,$137321.00,300,$76.50
2025-02-24,06:08:00,21796.0,BUY,3,0.02h,Stop Loss,$-9.00,$67.50,$137312.00,300,$67.50
2025-02-24,06:34:00,21789.5,SELL,3,0.02h,Stop Loss,$-9.00,$58.50,$137303.00,300,$58.50
2025-02-24,07:02:00,21789.75,BUY,3,0.02h,Stop Loss,$-9.00,$49.50,$137294.00,300,$49.50
2025-02-24,07:03:00,21782.0,SELL,3,0.02h,Stop Loss,$67.50,$117.00,$137361.50,300,$117.00
2025-02-24,07:58:00,21758.25,BUY,3,0.02h,Stop Loss,$-9.00,$108.00,$137352.50,300,$108.00
2025-02-24,08:04:00,21751.5,SELL,3,0.02h,Stop Loss,$-9.00,$99.00,$137343.50,300,$99.00
2025-02-24,08:05:00,21757.25,BUY,3,0.02h,Stop Loss,$-9.00,$90.00,$137334.50,300,$90.00
2025-02-24,08:06:00,21751.25,SELL,3,0.02h,Stop Loss,$18.00,$108.00,$137352.50,300,$108.00
2025-02-24,08:28:00,21739.25,BUY,3,0.02h,Stop Loss,$-9.00,$99.00,$137343.50,300,$99.00
2025-02-24,08:39:00,21724.5,SELL,3,0.02h,Stop Loss,$-9.00,$90.00,$137334.50,300,$90.00
2025-02-24,08:42:00,21737.75,BUY,3,0.02h,Stop Loss,$22.50,$112.50,$137357.00,300,$112.50
2025-02-24,09:39:00,21796.5,SELL,3,0.02h,Stop Loss,$12.00,$124.50,$137369.00,300,$124.50
2025-02-24,11:09:00,21773.75,BUY,3,0.02h,Stop Loss,$-9.00,$115.50,$137360.00,300,$115.50
2025-02-24,11:46:00,21771.5,SELL,3,0.02h,Stop Loss,$-9.00,$106.50,$137351.00,300,$106.50
2025-02-24,12:22:00,21764.0,BUY,3,0.02h,Break Even,$-1.50,$105.00,$137349.50,300,$105.00
2025-02-24,12:25:00,21753.75,SELL,3,0.02h,Break Even,$-1.50,$103.50,$137348.00,300,$103.50
2025-02-24,12:32:00,21767.75,BUY,3,0.02h,Break Even,$-1.50,$102.00,$137346.50,300,$102.00
2025-02-24,12:46:00,21759.75,SELL,3,0.02h,Stop Loss,$33.00,$135.00,$137379.50,300,$135.00
2025-02-24,13:01:00,21763.75,BUY,3,0.02h,Stop Loss,$7.50,$142.50,$137387.00,300,$142.50
2025-02-24,14:07:00,21774.5,SELL,3,0.02h,Stop Loss,$12.00,$154.50,$137399.00,300,$154.50
2025-02-24,16:03:00,21495.75,BUY,3,0.02h,Stop Loss,$72.00,$226.50,$137471.00,300,$226.50
2025-02-24,16:59:00,21572.25,SELL,3,0.02h,Break Even,$-1.50,$225.00,$137469.50,300,$225.00
2025-02-24,17:04:00,21606.25,BUY,3,0.02h,Stop Loss,$6.00,$231.00,$137475.50,300,$231.00
2025-02-24,17:55:00,21614.75,SELL,3,0.02h,Break Even,$-1.50,$229.50,$137474.00,300,$229.50
2025-02-24,18:15:00,21628.25,BUY,3,0.02h,Stop Loss,$18.00,$247.50,$137492.00,300,$247.50
2025-02-24,18:48:00,21630.5,SELL,3,0.02h,Stop Loss,$27.00,$274.50,$137519.00,300,$274.50
2025-02-24,20:16:00,21561.25,BUY,3,0.02h,Stop Loss,$10.50,$285.00,$137529.50,300,$285.00
2025-02-24,20:24:00,21542.25,SELL,3,0.02h,Stop Loss,$52.50,$337.50,$137582.00,300,$337.50
2025-02-24,20:38:00,21551.5,BUY,3,0.02h,Stop Loss,$-9.00,$328.50,$137573.00,300,$328.50
2025-02-24,20:39:00,21538.5,SELL,3,0.02h,Stop Loss,$39.00,$367.50,$137612.00,300,$367.50
2025-02-24,21:59:00,21428.25,BUY,3,1.03h,Stop Loss,$129.00,$496.50,$137741.00,300,$496.50
2025-02-24,23:16:00,21424.75,SELL,3,0.02h,Break Even,$-1.50,$495.00,$137739.50,300,$495.00
2025-02-24,23:30:00,21433.5,BUY,3,0.02h,Break Even,$-1.50,$493.50,$137738.00,300,$493.50
2025-02-24,23:33:00,21422.5,SELL,3,0.02h,Stop Loss,$24.00,$517.50,$137762.00,300,$517.50
,,,,,,,,,,,
2025-02-25,00:04:00,21408.25,BUY,3,0.02h,Stop Loss,$-9.00,$-9.00,$137753.00,301,$-9.00
2025-02-25,00:59:00,21434.5,SELL,3,0.02h,Break Even,$-1.50,$-10.50,$137751.50,301,$-10.50
2025-02-25,01:05:00,21446.25,BUY,3,0.02h,Break Even,$-1.50,$-12.00,$137750.00,301,$-12.00
2025-02-25,01:12:00,21430.25,SELL,3,0.02h,Break Even,$-1.50,$-13.50,$137748.50,301,$-13.50
2025-02-25,01:32:00,21445.5,BUY,3,0.02h,Stop Loss,$15.00,$1.50,$137763.50,301,$1.50
2025-02-25,01:49:00,21431.5,SELL,3,0.02h,Break Even,$-1.50,$0.00,$137762.00,301,$0.00
2025-02-25,01:56:00,21443.0,BUY,3,0.02h,Break Even,$-1.50,$-1.50,$137760.50,301,$-1.50
2025-02-25,02:22:00,21436.75,SELL,3,0.02h,Stop Loss,$7.50,$6.00,$137768.00,301,$6.00
2025-02-25,02:43:00,21437.5,BUY,3,0.02h,Stop Loss,$-9.00,$-3.00,$137759.00,301,$-3.00
2025-02-25,02:53:00,21428.5,SELL,3,0.02h,Stop Loss,$-9.00,$-12.00,$137750.00,301,$-12.00
2025-02-25,02:58:00,21435.75,BUY,3,0.02h,Stop Loss,$-9.00,$-21.00,$137741.00,301,$-21.00
2025-02-25,03:20:00,21434.25,SELL,3,0.02h,Stop Loss,$-9.00,$-30.00,$137732.00,301,$-30.00
2025-02-25,03:27:00,21438.0,BUY,3,0.02h,Stop Loss,$-9.00,$-39.00,$137723.00,301,$-39.00
2025-02-25,03:29:00,21435.5,SELL,3,0.02h,Break Even,$-1.50,$-40.50,$137721.50,301,$-40.50
2025-02-25,03:48:00,21435.0,BUY,3,0.02h,Stop Loss,$-9.00,$-49.50,$137712.50,301,$-49.50
2025-02-25,03:54:00,21428.25,SELL,3,0.02h,Stop Loss,$-9.00,$-58.50,$137703.50,301,$-58.50
2025-02-25,03:59:00,21432.75,BUY,3,0.02h,Stop Loss,$-9.00,$-67.50,$137694.50,301,$-67.50
2025-02-25,04:00:00,21430.0,SELL,3,0.02h,Stop Loss,$-9.00,$-76.50,$137685.50,301,$-76.50
2025-02-25,04:18:00,21434.75,BUY,3,0.02h,Stop Loss,$-9.00,$-85.50,$137676.50,301,$-85.50
2025-02-25,04:41:00,21431.0,SELL,3,0.03h,Stop Loss,$-9.00,$-94.50,$137667.50,301,$-94.50
2025-02-25,05:06:00,21431.5,BUY,3,0.02h,Stop Loss,$-9.00,$-103.50,$137658.50,301,$-103.50
2025-02-25,05:44:00,21430.75,SELL,3,0.02h,Stop Loss,$-9.00,$-112.50,$137649.50,301,$-112.50
2025-02-25,05:47:00,21434.25,BUY,3,0.02h,Break Even,$-1.50,$-114.00,$137648.00,301,$-114.00
2025-02-25,06:02:00,21431.5,SELL,3,0.02h,Stop Loss,$-9.00,$-123.00,$137639.00,301,$-123.00
2025-02-25,06:10:00,21441.25,BUY,3,0.02h,Break Even,$-1.50,$-124.50,$137637.50,301,$-124.50
2025-02-25,06:24:00,21435.25,SELL,3,0.02h,Break Even,$-1.50,$-126.00,$137636.00,301,$-126.00
2025-02-25,07:00:00,21422.5,BUY,3,0.02h,Break Even,$-1.50,$-127.50,$137634.50,301,$-127.50
2025-02-25,07:01:00,21419.25,SELL,3,0.02h,Stop Loss,$60.00,$-67.50,$137694.50,301,$-67.50
2025-02-25,08:07:00,21356.0,BUY,3,0.02h,Break Even,$-1.50,$-69.00,$137693.00,301,$-69.00
2025-02-25,08:29:00,21370.0,SELL,3,0.02h,Break Even,$-1.50,$-70.50,$137691.50,301,$-70.50
2025-02-25,08:38:00,21391.75,BUY,3,0.02h,Stop Loss,$3.00,$-67.50,$137694.50,301,$-67.50
2025-02-25,08:44:00,21369.75,SELL,3,0.02h,Break Even,$-1.50,$-69.00,$137693.00,301,$-69.00
2025-02-25,08:47:00,21379.5,BUY,3,0.02h,Break Even,$-1.50,$-70.50,$137691.50,301,$-70.50
2025-02-25,08:50:00,21360.25,SELL,3,0.02h,Stop Loss,$39.00,$-31.50,$137730.50,301,$-31.50
2025-02-25,09:08:00,21363.75,BUY,3,0.02h,Break Even,$-1.50,$-33.00,$137729.00,301,$-33.00
2025-02-25,09:30:00,21357.75,SELL,3,0.02h,Stop Loss,$13.50,$-19.50,$137742.50,301,$-19.50
2025-02-25,09:36:00,21367.25,BUY,3,0.02h,Break Even,$-1.50,$-21.00,$137741.00,301,$-21.00
2025-02-25,09:37:00,21360.75,SELL,3,0.02h,Stop Loss,$10.50,$-10.50,$137751.50,301,$-10.50
2025-02-25,10:08:00,21337.75,BUY,3,0.02h,Break Even,$-1.50,$-12.00,$137750.00,301,$-12.00
2025-02-25,10:38:00,21332.5,SELL,3,0.02h,Stop Loss,$24.00,$12.00,$137774.00,301,$12.00
2025-02-25,11:12:00,21315.0,BUY,3,0.02h,Stop Loss,$13.50,$25.50,$137787.50,301,$25.50
2025-02-25,12:38:00,21380.75,SELL,3,0.02h,Break Even,$-1.50,$24.00,$137786.00,301,$24.00
2025-02-25,12:39:00,21388.5,BUY,3,0.02h,Stop Loss,$-9.00,$15.00,$137777.00,301,$15.00
2025-02-25,12:45:00,21375.0,SELL,3,0.02h,Stop Loss,$25.50,$40.50,$137802.50,301,$40.50
2025-02-25,12:53:00,21390.25,BUY,3,0.02h,Stop Loss,$6.00,$46.50,$137808.50,301,$46.50
2025-02-25,13:38:00,21414.75,SELL,3,0.02h,Stop Loss,$13.50,$60.00,$137822.00,301,$60.00
2025-02-25,15:44:00,21115.75,BUY,3,0.02h,Break Even,$-1.50,$58.50,$137820.50,301,$58.50
2025-02-25,15:48:00,21088.5,SELL,3,0.02h,Stop Loss,$10.50,$69.00,$137831.00,301,$69.00
2025-02-25,15:50:00,21112.0,BUY,3,0.02h,Stop Loss,$45.00,$114.00,$137876.00,301,$114.00
2025-02-25,16:02:00,21084.0,SELL,3,0.02h,Stop Loss,$106.50,$220.50,$137982.50,301,$220.50
2025-02-25,16:43:00,21057.75,BUY,3,0.02h,Stop Loss,$-9.00,$211.50,$137973.50,301,$211.50
2025-02-25,17:22:00,21120.0,SELL,3,0.02h,Stop Loss,$39.00,$250.50,$138012.50,301,$250.50
2025-02-25,17:27:00,21154.0,BUY,3,0.02h,Stop Loss,$55.50,$306.00,$138068.00,301,$306.00
2025-02-25,18:18:00,21226.0,SELL,3,0.02h,Stop Loss,$81.00,$387.00,$138149.00,301,$387.00
2025-02-25,18:40:00,21243.0,BUY,3,0.02h,Stop Loss,$7.50,$394.50,$138156.50,301,$394.50
2025-02-25,18:56:00,21204.25,SELL,3,0.02h,Break Even,$-1.50,$393.00,$138155.00,301,$393.00
2025-02-25,19:38:00,21173.25,BUY,3,0.02h,Stop Loss,$88.50,$481.50,$138243.50,301,$481.50
2025-02-25,20:13:00,21198.75,SELL,3,0.02h,Stop Loss,$18.00,$499.50,$138261.50,301,$499.50
2025-02-25,20:15:00,21203.5,BUY,3,0.02h,Stop Loss,$21.00,$520.50,$138282.50,301,$520.50
2025-02-25,20:18:00,21196.0,SELL,3,0.02h,Break Even,$-1.50,$519.00,$138281.00,301,$519.00
2025-02-25,20:19:00,21208.75,BUY,3,0.02h,Stop Loss,$108.00,$627.00,$138389.00,301,$627.00
2025-02-25,20:36:00,21211.25,SELL,3,0.02h,Stop Loss,$136.50,$763.50,$138525.50,301,$763.50
2025-02-25,21:05:00,21187.75,BUY,3,0.02h,Stop Loss,$72.00,$835.50,$138597.50,301,$835.50
2025-02-25,21:39:00,21189.0,SELL,3,0.02h,Break Even,$-1.50,$834.00,$138596.00,301,$834.00
2025-02-25,21:46:00,21205.0,BUY,3,0.02h,Break Even,$-1.50,$832.50,$138594.50,301,$832.50
2025-02-25,21:58:00,21191.0,SELL,3,0.02h,Break Even,$-1.50,$831.00,$138593.00,301,$831.00
2025-02-25,23:01:00,21236.0,BUY,3,0.02h,Stop Loss,$13.50,$844.50,$138606.50,301,$844.50
2025-02-25,23:41:00,21219.5,SELL,3,0.02h,Stop Loss,$-9.00,$835.50,$138597.50,301,$835.50
2025-02-25,23:42:00,21223.25,BUY,3,0.02h,Break Even,$-1.50,$834.00,$138596.00,301,$834.00
2025-02-25,23:47:00,21214.25,SELL,3,0.02h,Break Even,$-1.50,$832.50,$138594.50,301,$832.50
,,,,,,,,,,,
2025-02-26,00:00:00,21225.5,BUY,3,0.02h,Stop Loss,$6.00,$6.00,$138600.50,302,$6.00
2025-02-26,00:11:00,21215.75,SELL,3,0.02h,Break Even,$-1.50,$4.50,$138599.00,302,$4.50
2025-02-26,00:21:00,21223.75,BUY,3,0.02h,Stop Loss,$19.50,$24.00,$138618.50,302,$24.00
2025-02-26,00:41:00,21227.25,SELL,3,0.03h,Break Even,$-1.50,$22.50,$138617.00,302,$22.50
2025-02-26,00:49:00,21237.75,BUY,3,0.02h,Stop Loss,$7.50,$30.00,$138624.50,302,$30.00
2025-02-26,01:09:00,21236.0,SELL,3,0.02h,Stop Loss,$-9.00,$21.00,$138615.50,302,$21.00
2025-02-26,02:19:00,21223.75,BUY,3,0.02h,Stop Loss,$49.50,$70.50,$138665.00,302,$70.50
2025-02-26,03:28:00,21249.5,SELL,3,0.02h,Stop Loss,$-9.00,$61.50,$138656.00,302,$61.50
2025-02-26,03:29:00,21252.75,BUY,3,0.02h,Stop Loss,$-9.00,$52.50,$138647.00,302,$52.50
2025-02-26,03:39:00,21249.0,SELL,3,0.03h,Break Even,$-1.50,$51.00,$138645.50,302,$51.00
2025-02-26,04:21:00,21238.0,BUY,3,0.02h,Break Even,$-1.50,$49.50,$138644.00,302,$49.50
2025-02-26,06:11:00,21271.75,SELL,3,0.03h,Break Even,$-1.50,$48.00,$138642.50,302,$48.00
2025-02-26,06:47:00,21274.0,BUY,3,0.02h,Break Even,$-1.50,$46.50,$138641.00,302,$46.50
2025-02-26,07:03:00,21264.25,SELL,3,0.02h,Break Even,$-1.50,$45.00,$138639.50,302,$45.00
2025-02-26,07:11:00,21281.0,BUY,3,0.02h,Stop Loss,$-9.00,$36.00,$138630.50,302,$36.00
2025-02-26,07:40:00,21285.0,SELL,3,0.02h,Break Even,$-1.50,$34.50,$138629.00,302,$34.50
2025-02-26,07:46:00,21291.75,BUY,3,0.02h,Stop Loss,$6.00,$40.50,$138635.00,302,$40.50
2025-02-26,08:05:00,21288.25,SELL,3,0.02h,Stop Loss,$24.00,$64.50,$138659.00,302,$64.50
2025-02-26,08:37:00,21282.25,BUY,3,0.02h,Stop Loss,$-9.00,$55.50,$138650.00,302,$55.50
2025-02-26,08:46:00,21275.25,SELL,3,0.02h,Break Even,$-1.50,$54.00,$138648.50,302,$54.00
2025-02-26,08:54:00,21282.5,BUY,3,0.02h,Stop Loss,$18.00,$72.00,$138666.50,302,$72.00
2025-02-26,09:40:00,21311.75,SELL,3,0.02h,Break Even,$-1.50,$70.50,$138665.00,302,$70.50
2025-02-26,10:05:00,21316.5,BUY,3,0.02h,Stop Loss,$34.50,$105.00,$138699.50,302,$105.00
2025-02-26,10:22:00,21312.5,SELL,3,0.02h,Break Even,$-1.50,$103.50,$138698.00,302,$103.50
2025-02-26,10:25:00,21317.75,BUY,3,0.02h,Stop Loss,$-9.00,$94.50,$138689.00,302,$94.50
2025-02-26,10:32:00,21311.25,SELL,3,0.02h,Break Even,$-1.50,$93.00,$138687.50,302,$93.00
2025-02-26,10:40:00,21319.0,BUY,3,0.02h,Break Even,$-1.50,$91.50,$138686.00,302,$91.50
2025-02-26,11:23:00,21315.75,SELL,3,0.02h,Break Even,$-1.50,$90.00,$138684.50,302,$90.00
2025-02-26,11:41:00,21322.5,BUY,3,0.02h,Break Even,$-1.50,$88.50,$138683.00,302,$88.50
2025-02-26,11:49:00,21314.5,SELL,3,0.02h,Break Even,$-1.50,$87.00,$138681.50,302,$87.00
2025-02-26,12:16:00,21300.25,BUY,3,0.02h,Stop Loss,$4.50,$91.50,$138686.00,302,$91.50
2025-02-26,12:42:00,21293.0,SELL,3,0.02h,Stop Loss,$-9.00,$82.50,$138677.00,302,$82.50
2025-02-26,13:14:00,21292.0,BUY,3,0.02h,Stop Loss,$21.00,$103.50,$138698.00,302,$103.50
2025-02-26,13:44:00,21306.75,SELL,3,0.02h,Break Even,$-1.50,$102.00,$138696.50,302,$102.00
2025-02-26,14:40:00,21265.0,BUY,3,0.02h,Stop Loss,$9.00,$111.00,$138705.50,302,$111.00
2025-02-26,14:43:00,21212.5,SELL,3,0.02h,Stop Loss,$79.50,$190.50,$138785.00,302,$190.50
2025-02-26,14:48:00,21256.75,BUY,3,0.02h,Stop Loss,$70.50,$261.00,$138855.50,302,$261.00
2025-02-26,15:30:00,21282.75,SELL,3,0.02h,Stop Loss,$-9.00,$252.00,$138846.50,302,$252.00
2025-02-26,15:38:00,21345.25,BUY,3,0.02h,Stop Loss,$10.50,$262.50,$138857.00,302,$262.50
2025-02-26,16:28:00,21362.0,SELL,3,0.02h,Break Even,$-1.50,$261.00,$138855.50,302,$261.00
2025-02-26,16:38:00,21389.75,BUY,3,0.02h,Stop Loss,$34.50,$295.50,$138890.00,302,$295.50
2025-02-26,16:59:00,21357.75,SELL,3,0.02h,Stop Loss,$91.50,$387.00,$138981.50,302,$387.00
2025-02-26,17:08:00,21391.25,BUY,3,0.02h,Stop Loss,$37.50,$424.50,$139019.00,302,$424.50
2025-02-26,17:23:00,21366.25,SELL,3,0.02h,Stop Loss,$3.00,$427.50,$139022.00,302,$427.50
2025-02-26,19:21:00,21130.0,BUY,3,0.02h,Break Even,$-1.50,$426.00,$139020.50,302,$426.00
2025-02-26,19:56:00,21139.0,SELL,3,0.02h,Stop Loss,$30.00,$456.00,$139050.50,302,$456.00
2025-02-26,20:14:00,21130.0,BUY,3,0.02h,Stop Loss,$-9.00,$447.00,$139041.50,302,$447.00
2025-02-26,20:15:00,21115.75,SELL,3,0.02h,Stop Loss,$27.00,$474.00,$139068.50,302,$474.00
2025-02-26,20:20:00,21131.75,BUY,3,0.02h,Break Even,$-1.50,$472.50,$139067.00,302,$472.50
2025-02-26,21:30:00,21205.0,SELL,3,0.02h,Stop Loss,$48.00,$520.50,$139115.00,302,$520.50
2025-02-26,21:42:00,21224.25,BUY,3,0.02h,Stop Loss,$-9.00,$511.50,$139106.00,302,$511.50
2025-02-26,23:13:00,21236.5,SELL,3,0.02h,Stop Loss,$108.00,$619.50,$139214.00,302,$619.50
2025-02-26,23:49:00,21215.25,BUY,3,0.02h,Stop Loss,$-9.00,$610.50,$139205.00,302,$610.50
,,,,,,,,,,,
2025-02-27,00:10:00,21199.5,SELL,3,0.02h,Stop Loss,$-9.00,$-9.00,$139196.00,303,$-9.00
2025-02-27,00:52:00,21160.0,BUY,3,0.02h,Stop Loss,$-9.00,$-18.00,$139187.00,303,$-18.00
2025-02-27,00:53:00,21152.5,SELL,3,0.02h,Stop Loss,$4.50,$-13.50,$139191.50,303,$-13.50
2025-02-27,01:15:00,21154.5,BUY,3,0.02h,Stop Loss,$10.50,$-3.00,$139202.00,303,$-3.00
2025-02-27,01:52:00,21172.5,SELL,3,0.02h,Stop Loss,$-9.00,$-12.00,$139193.00,303,$-12.00
2025-02-27,02:13:00,21176.75,BUY,3,0.02h,Break Even,$-1.50,$-13.50,$139191.50,303,$-13.50
2025-02-27,02:47:00,21193.0,SELL,3,0.02h,Stop Loss,$9.00,$-4.50,$139200.50,303,$-4.50
2025-02-27,03:12:00,21194.25,BUY,3,0.02h,Stop Loss,$-9.00,$-13.50,$139191.50,303,$-13.50
2025-02-27,03:21:00,21186.0,SELL,3,0.02h,Stop Loss,$-9.00,$-22.50,$139182.50,303,$-22.50
2025-02-27,03:33:00,21195.75,BUY,3,0.02h,Break Even,$-1.50,$-24.00,$139181.00,303,$-24.00
2025-02-27,03:48:00,21190.0,SELL,3,0.02h,Stop Loss,$-9.00,$-33.00,$139172.00,303,$-33.00
2025-02-27,04:38:00,21160.5,BUY,3,0.02h,Stop Loss,$9.00,$-24.00,$139181.00,303,$-24.00
2025-02-27,06:54:00,21277.0,SELL,3,0.02h,Break Even,$-1.50,$-25.50,$139179.50,303,$-25.50
2025-02-27,06:59:00,21282.25,BUY,3,0.02h,Break Even,$-1.50,$-27.00,$139178.00,303,$-27.00
2025-02-27,07:14:00,21278.75,SELL,3,0.02h,Break Even,$-1.50,$-28.50,$139176.50,303,$-28.50
2025-02-27,07:16:00,21289.25,BUY,3,0.02h,Stop Loss,$76.50,$48.00,$139253.00,303,$48.00
2025-02-27,07:50:00,21298.25,SELL,3,0.02h,Stop Loss,$-9.00,$39.00,$139244.00,303,$39.00
2025-02-27,08:24:00,21290.25,BUY,3,0.02h,Stop Loss,$4.50,$43.50,$139248.50,303,$43.50
2025-02-27,09:10:00,21301.5,SELL,3,0.02h,Stop Loss,$-9.00,$34.50,$139239.50,303,$34.50
2025-02-27,09:13:00,21315.0,BUY,3,0.02h,Stop Loss,$-9.00,$25.50,$139230.50,303,$25.50
2025-02-27,09:14:00,21302.0,SELL,3,0.02h,Break Even,$-1.50,$24.00,$139229.00,303,$24.00
2025-02-27,09:24:00,21315.75,BUY,3,0.02h,Break Even,$-1.50,$22.50,$139227.50,303,$22.50
2025-02-27,09:58:00,21317.0,SELL,3,0.02h,Break Even,$-1.50,$21.00,$139226.00,303,$21.00
2025-02-27,10:00:00,21324.5,BUY,3,0.02h,Stop Loss,$19.50,$40.50,$139245.50,303,$40.50
2025-02-27,10:02:00,21321.25,SELL,3,0.02h,Stop Loss,$18.00,$58.50,$139263.50,303,$58.50
2025-02-27,10:14:00,21321.75,BUY,3,0.02h,Stop Loss,$-9.00,$49.50,$139254.50,303,$49.50
2025-02-27,10:15:00,21318.25,SELL,3,0.02h,Stop Loss,$-9.00,$40.50,$139245.50,303,$40.50
2025-02-27,10:16:00,21321.25,BUY,3,0.02h,Break Even,$-1.50,$39.00,$139244.00,303,$39.00
2025-02-27,10:32:00,21318.0,SELL,3,0.02h,Stop Loss,$30.00,$69.00,$139274.00,303,$69.00
2025-02-27,10:54:00,21322.5,BUY,3,0.02h,Break Even,$-1.50,$67.50,$139272.50,303,$67.50
2025-02-27,11:20:00,21325.0,SELL,3,0.02h,Stop Loss,$-9.00,$58.50,$139263.50,303,$58.50
2025-02-27,11:47:00,21336.25,BUY,3,0.02h,Stop Loss,$-9.00,$49.50,$139254.50,303,$49.50
2025-02-27,12:53:00,21356.75,SELL,3,0.02h,Stop Loss,$3.00,$52.50,$139257.50,303,$52.50
2025-02-27,13:18:00,21365.0,BUY,3,0.02h,Stop Loss,$4.50,$57.00,$139262.00,303,$57.00
2025-02-27,13:26:00,21352.0,SELL,3,0.02h,Stop Loss,$4.50,$61.50,$139266.50,303,$61.50
2025-02-27,13:42:00,21363.25,BUY,3,0.02h,Stop Loss,$3.00,$64.50,$139269.50,303,$64.50
2025-02-27,13:47:00,21316.0,SELL,3,0.02h,Stop Loss,$166.50,$231.00,$139436.00,303,$231.00
2025-02-27,14:04:00,21344.75,BUY,3,0.02h,Break Even,$-1.50,$229.50,$139434.50,303,$229.50
2025-02-27,14:30:00,21340.5,SELL,3,0.02h,Stop Loss,$79.50,$309.00,$139514.00,303,$309.00
2025-02-27,14:31:00,21352.25,BUY,3,0.02h,Break Even,$-1.50,$307.50,$139512.50,303,$307.50
2025-02-27,14:32:00,21329.75,SELL,3,0.02h,Stop Loss,$-9.00,$298.50,$139503.50,303,$298.50
2025-02-27,14:34:00,21354.0,BUY,3,0.02h,Stop Loss,$18.00,$316.50,$139521.50,303,$316.50
2025-02-27,14:40:00,21308.25,SELL,3,0.02h,Stop Loss,$196.50,$513.00,$139718.00,303,$513.00
2025-02-27,15:18:00,21069.75,BUY,3,0.02h,Stop Loss,$165.00,$678.00,$139883.00,303,$678.00
2025-02-27,15:35:00,21067.5,SELL,3,0.02h,Stop Loss,$109.50,$787.50,$139992.50,303,$787.50
2025-02-27,15:40:00,21113.5,BUY,3,0.02h,Stop Loss,$7.50,$795.00,$140000.00,303,$795.00
2025-02-27,15:53:00,21058.0,SELL,3,0.02h,Stop Loss,$60.00,$855.00,$140060.00,303,$855.00
2025-02-27,16:12:00,21082.5,BUY,3,0.02h,Stop Loss,$66.00,$921.00,$140126.00,303,$921.00
2025-02-27,16:30:00,21065.0,SELL,3,0.02h,Stop Loss,$30.00,$951.00,$140156.00,303,$951.00
2025-02-27,17:28:00,21039.25,BUY,3,0.02h,Stop Loss,$31.50,$982.50,$140187.50,303,$982.50
2025-02-27,17:44:00,21001.25,SELL,3,0.02h,Stop Loss,$13.50,$996.00,$140201.00,303,$996.00
2025-02-27,18:00:00,21038.25,BUY,3,0.02h,Stop Loss,$103.50,$1099.50,$140304.50,303,$1099.50
2025-02-27,18:44:00,21075.75,SELL,3,0.02h,Break Even,$-1.50,$1098.00,$140303.00,303,$1098.00
2025-02-27,21:20:00,20634.5,BUY,3,0.02h,Break Even,$-1.50,$1096.50,$140301.50,303,$1096.50
2025-02-27,21:54:00,20633.75,SELL,3,0.02h,Stop Loss,$19.50,$1116.00,$140321.00,303,$1116.00
2025-02-27,23:02:00,20659.25,BUY,3,0.02h,Stop Loss,$60.00,$1176.00,$140381.00,303,$1176.00
2025-02-27,23:16:00,20641.75,SELL,3,0.02h,Stop Loss,$-9.00,$1167.00,$140372.00,303,$1167.00
2025-02-27,23:27:00,20655.25,BUY,3,0.02h,Stop Loss,$-9.00,$1158.00,$140363.00,303,$1158.00
2025-02-27,23:28:00,20651.5,SELL,3,0.02h,Stop Loss,$-9.00,$1149.00,$140354.00,303,$1149.00
2025-02-27,23:30:00,20657.75,BUY,3,0.02h,Stop Loss,$52.50,$1201.50,$140406.50,303,$1201.50
2025-02-27,23:53:00,20663.0,SELL,3,0.02h,Stop Loss,$3.00,$1204.50,$140409.50,303,$1204.50
2025-02-27,23:56:00,20666.75,BUY,3,0.02h,Stop Loss,$10.50,$1215.00,$140420.00,303,$1215.00
,,,,,,,,,,,
2025-02-28,00:19:00,20670.25,SELL,3,0.02h,Stop Loss,$-9.00,$-9.00,$140411.00,304,$-9.00
2025-02-28,01:10:00,20645.75,BUY,3,0.02h,Break Even,$-1.50,$-10.50,$140409.50,304,$-10.50
2025-02-28,01:29:00,20633.0,SELL,3,0.02h,Stop Loss,$12.00,$1.50,$140421.50,304,$1.50
2025-02-28,01:45:00,20639.75,BUY,3,0.02h,Stop Loss,$6.00,$7.50,$140427.50,304,$7.50
2025-02-28,02:02:00,20623.25,SELL,3,0.02h,Stop Loss,$6.00,$13.50,$140433.50,304,$13.50
2025-02-28,02:07:00,20641.75,BUY,3,0.02h,Break Even,$-1.50,$12.00,$140432.00,304,$12.00
2025-02-28,02:11:00,20630.75,SELL,3,0.02h,Stop Loss,$21.00,$33.00,$140453.00,304,$33.00
2025-02-28,02:29:00,20633.0,BUY,3,0.02h,Stop Loss,$3.00,$36.00,$140456.00,304,$36.00
2025-02-28,02:39:00,20616.0,SELL,3,0.02h,Stop Loss,$70.50,$106.50,$140526.50,304,$106.50
2025-02-28,03:55:00,20559.5,BUY,3,0.02h,Break Even,$-1.50,$105.00,$140525.00,304,$105.00
2025-02-28,05:26:00,20623.75,SELL,3,0.02h,Stop Loss,$15.00,$120.00,$140540.00,304,$120.00
2025-02-28,05:43:00,20628.25,BUY,3,0.02h,Stop Loss,$25.50,$145.50,$140565.50,304,$145.50
2025-02-28,05:58:00,20623.75,SELL,3,0.02h,Break Even,$-1.50,$144.00,$140564.00,304,$144.00
2025-02-28,06:17:00,20640.25,BUY,3,0.02h,Break Even,$-1.50,$142.50,$140562.50,304,$142.50
2025-02-28,06:33:00,20626.5,SELL,3,0.02h,Break Even,$-1.50,$141.00,$140561.00,304,$141.00
2025-02-28,07:42:00,20603.75,BUY,3,0.02h,Stop Loss,$36.00,$177.00,$140597.00,304,$177.00
2025-02-28,08:49:00,20656.25,SELL,3,0.02h,Stop Loss,$24.00,$201.00,$140621.00,304,$201.00
2025-02-28,08:54:00,20663.75,BUY,3,0.02h,Break Even,$-1.50,$199.50,$140619.50,304,$199.50
2025-02-28,08:57:00,20656.75,SELL,3,0.02h,Stop Loss,$-9.00,$190.50,$140610.50,304,$190.50
2025-02-28,08:58:00,20661.0,BUY,3,0.02h,Stop Loss,$4.50,$195.00,$140615.00,304,$195.00
2025-02-28,09:01:00,20655.5,SELL,3,0.02h,Stop Loss,$16.50,$211.50,$140631.50,304,$211.50
2025-02-28,09:09:00,20671.25,BUY,3,0.02h,Break Even,$-1.50,$210.00,$140630.00,304,$210.00
2025-02-28,09:36:00,20670.75,SELL,3,0.02h,Stop Loss,$-9.00,$201.00,$140621.00,304,$201.00
2025-02-28,09:37:00,20674.0,BUY,3,0.02h,Stop Loss,$-9.00,$192.00,$140612.00,304,$192.00
2025-02-28,09:38:00,20667.75,SELL,3,0.02h,Stop Loss,$24.00,$216.00,$140636.00,304,$216.00
2025-02-28,10:09:00,20662.25,BUY,3,0.02h,Stop Loss,$-9.00,$207.00,$140627.00,304,$207.00
2025-02-28,10:10:00,20656.75,SELL,3,0.02h,Stop Loss,$33.00,$240.00,$140660.00,304,$240.00
2025-02-28,10:22:00,20660.0,BUY,3,0.02h,Break Even,$-1.50,$238.50,$140658.50,304,$238.50
2025-02-28,10:27:00,20648.5,SELL,3,0.02h,Break Even,$-1.50,$237.00,$140657.00,304,$237.00
2025-02-28,10:36:00,20661.75,BUY,3,0.02h,Stop Loss,$19.50,$256.50,$140676.50,304,$256.50
2025-02-28,10:58:00,20660.0,SELL,3,0.02h,Break Even,$-1.50,$255.00,$140675.00,304,$255.00
2025-02-28,11:09:00,20669.0,BUY,3,0.02h,Break Even,$-1.50,$253.50,$140673.50,304,$253.50
2025-02-28,11:16:00,20664.75,SELL,3,0.02h,Break Even,$-1.50,$252.00,$140672.00,304,$252.00
2025-02-28,11:23:00,20668.25,BUY,3,0.02h,Break Even,$-1.50,$250.50,$140670.50,304,$250.50
2025-02-28,11:33:00,20654.75,SELL,3,0.02h,Stop Loss,$3.00,$253.50,$140673.50,304,$253.50
2025-02-28,11:42:00,20674.0,BUY,3,0.02h,Stop Loss,$-9.00,$244.50,$140664.50,304,$244.50
2025-02-28,11:51:00,20661.0,SELL,3,0.02h,Stop Loss,$-9.00,$235.50,$140655.50,304,$235.50
2025-02-28,12:24:00,20635.25,BUY,3,0.02h,Stop Loss,$13.50,$249.00,$140669.00,304,$249.00
2025-02-28,12:31:00,20618.25,SELL,3,0.02h,Stop Loss,$78.00,$327.00,$140747.00,304,$327.00
2025-02-28,12:51:00,20622.0,BUY,3,0.02h,Break Even,$-1.50,$325.50,$140745.50,304,$325.50
2025-02-28,13:11:00,20611.25,SELL,3,0.02h,Stop Loss,$57.00,$382.50,$140802.50,304,$382.50
2025-02-28,13:32:00,20659.75,BUY,3,0.02h,Break Even,$-1.50,$381.00,$140801.00,304,$381.00
2025-02-28,13:53:00,20609.5,SELL,3,0.02h,Stop Loss,$12.00,$393.00,$140813.00,304,$393.00
2025-02-28,14:10:00,20620.5,BUY,3,0.02h,Break Even,$-1.50,$391.50,$140811.50,304,$391.50
2025-02-28,14:12:00,20604.0,SELL,3,0.02h,Stop Loss,$12.00,$403.50,$140823.50,304,$403.50
2025-02-28,14:17:00,20615.0,BUY,3,0.02h,Stop Loss,$-9.00,$394.50,$140814.50,304,$394.50
2025-02-28,14:18:00,20611.5,SELL,3,0.02h,Stop Loss,$-9.00,$385.50,$140805.50,304,$385.50
2025-02-28,14:19:00,20620.25,BUY,3,0.02h,Stop Loss,$30.00,$415.50,$140835.50,304,$415.50
2025-02-28,14:22:00,20603.5,SELL,3,0.02h,Stop Loss,$24.00,$439.50,$140859.50,304,$439.50
2025-02-28,14:44:00,20628.25,BUY,3,0.02h,Break Even,$-1.50,$438.00,$140858.00,304,$438.00
2025-02-28,14:57:00,20550.25,SELL,3,0.02h,Stop Loss,$33.00,$471.00,$140891.00,304,$471.00
2025-02-28,15:01:00,20623.0,BUY,3,0.02h,Stop Loss,$46.50,$517.50,$140937.50,304,$517.50
2025-02-28,15:44:00,20680.25,SELL,3,0.02h,Break Even,$-1.50,$516.00,$140936.00,304,$516.00
2025-02-28,15:47:00,20735.75,BUY,3,0.02h,Stop Loss,$-9.00,$507.00,$140927.00,304,$507.00
2025-02-28,15:49:00,20693.25,SELL,3,0.02h,Stop Loss,$43.50,$550.50,$140970.50,304,$550.50
2025-02-28,15:52:00,20730.75,BUY,3,0.02h,Stop Loss,$36.00,$586.50,$141006.50,304,$586.50
2025-02-28,16:13:00,20702.0,SELL,3,0.02h,Stop Loss,$37.50,$624.00,$141044.00,304,$624.00
2025-02-28,16:38:00,20705.5,BUY,3,0.02h,Stop Loss,$57.00,$681.00,$141101.00,304,$681.00
2025-02-28,16:59:00,20708.5,SELL,3,0.02h,Stop Loss,$96.00,$777.00,$141197.00,304,$777.00
2025-02-28,17:15:00,20712.75,BUY,3,0.02h,Stop Loss,$-9.00,$768.00,$141188.00,304,$768.00
2025-02-28,17:26:00,20695.0,SELL,3,0.02h,Stop Loss,$-9.00,$759.00,$141179.00,304,$759.00
2025-02-28,18:30:00,20593.0,BUY,3,0.02h,Stop Loss,$163.50,$922.50,$141342.50,304,$922.50
2025-02-28,18:57:00,20574.5,SELL,3,0.02h,Stop Loss,$42.00,$964.50,$141384.50,304,$964.50
2025-02-28,19:20:00,20613.25,BUY,3,0.02h,Break Even,$-1.50,$963.00,$141383.00,304,$963.00
2025-02-28,20:22:00,20705.25,SELL,3,0.02h,Stop Loss,$79.50,$1042.50,$141462.50,304,$1042.50
2025-02-28,20:28:00,20749.5,BUY,3,0.02h,Stop Loss,$84.00,$1126.50,$141546.50,304,$1126.50
2025-02-28,20:36:00,20689.75,SELL,3,0.02h,Stop Loss,$-9.00,$1117.50,$141537.50,304,$1117.50
2025-02-28,20:41:00,20756.5,BUY,3,0.02h,Stop Loss,$16.50,$1134.00,$141554.00,304,$1134.00
,,,,,,,,,,,
2025-03-03,00:15:00,20897.75,SELL,3,0.02h,Stop Loss,$78.00,$78.00,$141632.00,305,$78.00
2025-03-03,00:45:00,20887.5,BUY,3,0.02h,Stop Loss,$66.00,$144.00,$141698.00,305,$144.00
2025-03-03,00:58:00,20885.5,SELL,3,0.02h,Stop Loss,$33.00,$177.00,$141731.00,305,$177.00
2025-03-03,01:03:00,20902.0,BUY,3,0.02h,Stop Loss,$39.00,$216.00,$141770.00,305,$216.00
2025-03-03,01:17:00,20885.0,SELL,3,0.02h,Break Even,$-1.50,$214.50,$141768.50,305,$214.50
2025-03-03,01:25:00,20903.5,BUY,3,0.02h,Stop Loss,$-9.00,$205.50,$141759.50,305,$205.50
2025-03-03,01:41:00,20899.5,SELL,3,0.02h,Stop Loss,$15.00,$220.50,$141774.50,305,$220.50
2025-03-03,01:47:00,20913.75,BUY,3,0.02h,Stop Loss,$42.00,$262.50,$141816.50,305,$262.50
2025-03-03,02:24:00,20931.25,SELL,3,0.02h,Stop Loss,$-9.00,$253.50,$141807.50,305,$253.50
2025-03-03,02:39:00,20948.0,BUY,3,0.02h,Stop Loss,$-9.00,$244.50,$141798.50,305,$244.50
2025-03-03,02:47:00,20933.5,SELL,3,0.02h,Stop Loss,$-9.00,$235.50,$141789.50,305,$235.50
2025-03-03,02:51:00,20942.5,BUY,3,0.02h,Break Even,$-1.50,$234.00,$141788.00,305,$234.00
2025-03-03,02:59:00,20927.0,SELL,3,0.02h,Break Even,$-1.50,$232.50,$141786.50,305,$232.50
2025-03-03,03:39:00,20910.0,BUY,3,0.02h,Break Even,$-1.50,$231.00,$141785.00,305,$231.00
2025-03-03,06:02:00,20982.5,SELL,3,0.02h,Stop Loss,$24.00,$255.00,$141809.00,305,$255.00
2025-03-03,06:38:00,20972.75,BUY,3,0.02h,Stop Loss,$22.50,$277.50,$141831.50,305,$277.50
2025-03-03,07:06:00,20983.5,SELL,3,0.02h,Stop Loss,$4.50,$282.00,$141836.00,305,$282.00
2025-03-03,07:40:00,20971.75,BUY,3,0.02h,Stop Loss,$-9.00,$273.00,$141827.00,305,$273.00
2025-03-03,07:58:00,20958.0,SELL,3,0.02h,Stop Loss,$12.00,$285.00,$141839.00,305,$285.00
2025-03-03,08:04:00,20974.0,BUY,3,0.02h,Stop Loss,$12.00,$297.00,$141851.00,305,$297.00
2025-03-03,08:17:00,20959.5,SELL,3,0.02h,Stop Loss,$42.00,$339.00,$141893.00,305,$339.00
2025-03-03,08:42:00,20941.75,BUY,3,0.02h,Stop Loss,$22.50,$361.50,$141915.50,305,$361.50
2025-03-03,09:09:00,20935.75,SELL,3,0.02h,Stop Loss,$24.00,$385.50,$141939.50,305,$385.50
2025-03-03,09:12:00,20946.5,BUY,3,0.02h,Stop Loss,$7.50,$393.00,$141947.00,305,$393.00
2025-03-03,10:10:00,20994.75,SELL,3,0.02h,Stop Loss,$-9.00,$384.00,$141938.00,305,$384.00
2025-03-03,10:33:00,21003.0,BUY,3,0.02h,Break Even,$-1.50,$382.50,$141936.50,305,$382.50
2025-03-03,10:58:00,20999.5,SELL,3,0.02h,Stop Loss,$-9.00,$373.50,$141927.50,305,$373.50
2025-03-03,11:02:00,21005.5,BUY,3,0.02h,Break Even,$-1.50,$372.00,$141926.00,305,$372.00
2025-03-03,11:39:00,21018.75,SELL,3,0.02h,Stop Loss,$31.50,$403.50,$141957.50,305,$403.50
2025-03-03,11:44:00,21024.0,BUY,3,0.02h,Break Even,$-1.50,$402.00,$141956.00,305,$402.00
2025-03-03,12:33:00,21068.75,SELL,3,0.02h,Break Even,$-1.50,$400.50,$141954.50,305,$400.50
2025-03-03,12:50:00,21074.75,BUY,3,0.02h,Stop Loss,$7.50,$408.00,$141962.00,305,$408.00
2025-03-03,12:54:00,21068.75,SELL,3,0.02h,Stop Loss,$-9.00,$399.00,$141953.00,305,$399.00
2025-03-03,13:25:00,21074.0,BUY,3,0.02h,Stop Loss,$7.50,$406.50,$141960.50,305,$406.50
2025-03-03,13:36:00,21052.75,SELL,3,0.02h,Break Even,$-1.50,$405.00,$141959.00,305,$405.00
2025-03-03,13:54:00,21061.75,BUY,3,0.02h,Stop Loss,$13.50,$418.50,$141972.50,305,$418.50
2025-03-03,14:26:00,21061.75,SELL,3,0.02h,Break Even,$-1.50,$417.00,$141971.00,305,$417.00
2025-03-03,14:35:00,21088.0,BUY,3,0.02h,Stop Loss,$60.00,$477.00,$142031.00,305,$477.00
2025-03-03,14:38:00,21037.75,SELL,3,0.02h,Stop Loss,$301.50,$778.50,$142332.50,305,$778.50
2025-03-03,15:24:00,20909.5,BUY,3,0.02h,Stop Loss,$45.00,$823.50,$142377.50,305,$823.50
2025-03-03,15:51:00,20906.25,SELL,3,0.02h,Break Even,$-1.50,$822.00,$142376.00,305,$822.00
2025-03-03,15:54:00,20938.75,BUY,3,0.02h,Stop Loss,$6.00,$828.00,$142382.00,305,$828.00
2025-03-03,15:56:00,20910.0,SELL,3,0.02h,Stop Loss,$85.50,$913.50,$142467.50,305,$913.50
2025-03-03,16:15:00,20913.0,BUY,3,0.02h,Stop Loss,$25.50,$939.00,$142493.00,305,$939.00
2025-03-03,16:16:00,20892.75,SELL,3,0.02h,Break Even,$-1.50,$937.50,$142491.50,305,$937.50
2025-03-03,16:17:00,20916.0,BUY,3,0.02h,Stop Loss,$111.00,$1048.50,$142602.50,305,$1048.50
2025-03-03,16:30:00,20886.5,SELL,3,0.02h,Stop Loss,$24.00,$1072.50,$142626.50,305,$1072.50
2025-03-03,16:51:00,20928.75,BUY,3,0.02h,Break Even,$-1.50,$1071.00,$142625.00,305,$1071.00
2025-03-03,17:37:00,20919.5,SELL,3,0.02h,Stop Loss,$58.50,$1129.50,$142683.50,305,$1129.50
2025-03-03,17:42:00,20944.25,BUY,3,0.02h,Stop Loss,$105.00,$1234.50,$142788.50,305,$1234.50
2025-03-03,17:47:00,20905.75,SELL,3,0.02h,Stop Loss,$123.00,$1357.50,$142911.50,305,$1357.50
2025-03-03,18:51:00,20734.5,BUY,3,0.02h,Stop Loss,$25.50,$1383.00,$142937.00,305,$1383.00
2025-03-03,19:18:00,20724.0,SELL,3,0.02h,Stop Loss,$109.50,$1492.50,$143046.50,305,$1492.50
2025-03-03,19:33:00,20757.75,BUY,3,0.02h,Stop Loss,$94.50,$1587.00,$143141.00,305,$1587.00
2025-03-03,19:50:00,20721.75,SELL,3,0.02h,Break Even,$-1.50,$1585.50,$143139.50,305,$1585.50
2025-03-03,20:53:00,20418.75,BUY,3,0.02h,Stop Loss,$15.00,$1600.50,$143154.50,305,$1600.50
2025-03-03,21:55:00,20520.25,SELL,3,0.02h,Break Even,$-1.50,$1599.00,$143153.00,305,$1599.00
2025-03-03,21:59:00,20527.0,BUY,3,1.03h,Stop Loss,$-9.00,$1590.00,$143144.00,305,$1590.00
2025-03-03,23:01:00,20498.0,SELL,3,0.02h,Break Even,$-1.50,$1588.50,$143142.50,305,$1588.50
2025-03-03,23:17:00,20525.25,BUY,3,0.02h,Stop Loss,$13.50,$1602.00,$143156.00,305,$1602.00
2025-03-03,23:43:00,20527.75,SELL,3,0.02h,Stop Loss,$36.00,$1638.00,$143192.00,305,$1638.00
,,,,,,,,,,,
2025-03-04,00:19:00,20526.0,BUY,3,0.02h,Break Even,$-1.50,$-1.50,$143190.50,306,$-1.50
2025-03-04,00:42:00,20514.0,SELL,3,0.02h,Break Even,$-1.50,$-3.00,$143189.00,306,$-3.00
2025-03-04,00:54:00,20526.5,BUY,3,0.02h,Stop Loss,$91.50,$88.50,$143280.50,306,$88.50
2025-03-04,01:14:00,20514.0,SELL,3,0.02h,Stop Loss,$10.50,$99.00,$143291.00,306,$99.00
2025-03-04,01:48:00,20510.5,BUY,3,0.02h,Stop Loss,$42.00,$141.00,$143333.00,306,$141.00
2025-03-04,01:59:00,20495.0,SELL,3,0.02h,Stop Loss,$145.50,$286.50,$143478.50,306,$286.50
2025-03-04,02:14:00,20507.25,BUY,3,0.02h,Stop Loss,$3.00,$289.50,$143481.50,306,$289.50
2025-03-04,03:04:00,20516.25,SELL,3,0.02h,Break Even,$-1.50,$288.00,$143480.00,306,$288.00
2025-03-04,03:08:00,20528.75,BUY,3,0.02h,Stop Loss,$-9.00,$279.00,$143471.00,306,$279.00
2025-03-04,03:09:00,20524.5,SELL,3,0.02h,Stop Loss,$24.00,$303.00,$143495.00,306,$303.00
2025-03-04,03:20:00,20547.75,BUY,3,0.02h,Stop Loss,$-9.00,$294.00,$143486.00,306,$294.00
2025-03-04,03:40:00,20528.75,SELL,3,0.02h,Stop Loss,$49.50,$343.50,$143535.50,306,$343.50
2025-03-04,03:49:00,20534.5,BUY,3,0.02h,Stop Loss,$-9.00,$334.50,$143526.50,306,$334.50
2025-03-04,04:05:00,20531.5,SELL,3,0.02h,Stop Loss,$-9.00,$325.50,$143517.50,306,$325.50
2025-03-04,04:06:00,20536.5,BUY,3,0.02h,Break Even,$-1.50,$324.00,$143516.00,306,$324.00
2025-03-04,04:07:00,20534.0,SELL,3,0.02h,Stop Loss,$4.50,$328.50,$143520.50,306,$328.50
2025-03-04,04:10:00,20537.75,BUY,3,0.02h,Break Even,$-1.50,$327.00,$143519.00,306,$327.00
2025-03-04,04:39:00,20532.75,SELL,3,0.02h,Stop Loss,$31.50,$358.50,$143550.50,306,$358.50
2025-03-04,05:02:00,20548.25,BUY,3,0.02h,Break Even,$-1.50,$357.00,$143549.00,306,$357.00
2025-03-04,05:45:00,20561.25,SELL,3,0.02h,Stop Loss,$-9.00,$348.00,$143540.00,306,$348.00
2025-03-04,05:52:00,20574.75,BUY,3,0.02h,Stop Loss,$-9.00,$339.00,$143531.00,306,$339.00
2025-03-04,06:01:00,20558.75,SELL,3,0.02h,Break Even,$-1.50,$337.50,$143529.50,306,$337.50
2025-03-04,06:24:00,20569.0,BUY,3,0.02h,Stop Loss,$4.50,$342.00,$143534.00,306,$342.00
2025-03-04,06:36:00,20536.75,SELL,3,0.02h,Stop Loss,$16.50,$358.50,$143550.50,306,$358.50
2025-03-04,06:49:00,20559.5,BUY,3,0.02h,Stop Loss,$46.50,$405.00,$143597.00,306,$405.00
2025-03-04,07:05:00,20554.0,SELL,3,0.02h,Stop Loss,$37.50,$442.50,$143634.50,306,$442.50
2025-03-04,07:46:00,20516.5,BUY,3,0.02h,Stop Loss,$-9.00,$433.50,$143625.50,306,$433.50
2025-03-04,07:55:00,20495.25,SELL,3,0.02h,Stop Loss,$33.00,$466.50,$143658.50,306,$466.50
2025-03-04,08:13:00,20505.0,BUY,3,0.02h,Stop Loss,$37.50,$504.00,$143696.00,306,$504.00
2025-03-04,08:50:00,20515.5,SELL,3,0.02h,Stop Loss,$75.00,$579.00,$143771.00,306,$579.00
2025-03-04,09:04:00,20543.75,BUY,3,0.02h,Stop Loss,$37.50,$616.50,$143808.50,306,$616.50
2025-03-04,09:17:00,20518.25,SELL,3,0.02h,Stop Loss,$31.50,$648.00,$143840.00,306,$648.00
2025-03-04,09:47:00,20534.75,BUY,3,0.02h,Stop Loss,$-9.00,$639.00,$143831.00,306,$639.00
2025-03-04,09:52:00,20508.75,SELL,3,0.02h,Stop Loss,$37.50,$676.50,$143868.50,306,$676.50
2025-03-04,10:15:00,20503.0,BUY,3,0.02h,Stop Loss,$13.50,$690.00,$143882.00,306,$690.00
2025-03-04,10:22:00,20495.0,SELL,3,0.02h,Break Even,$-1.50,$688.50,$143880.50,306,$688.50
2025-03-04,10:54:00,20475.75,BUY,3,0.02h,Break Even,$-1.50,$687.00,$143879.00,306,$687.00
2025-03-04,10:57:00,20460.5,SELL,3,0.02h,Stop Loss,$-9.00,$678.00,$143870.00,306,$678.00
2025-03-04,11:02:00,20472.75,BUY,3,0.02h,Stop Loss,$-9.00,$669.00,$143861.00,306,$669.00
2025-03-04,11:03:00,20461.0,SELL,3,0.02h,Stop Loss,$-9.00,$660.00,$143852.00,306,$660.00
2025-03-04,11:08:00,20473.75,BUY,3,0.02h,Stop Loss,$52.50,$712.50,$143904.50,306,$712.50
2025-03-04,11:18:00,20463.75,SELL,3,0.02h,Stop Loss,$21.00,$733.50,$143925.50,306,$733.50
2025-03-04,11:26:00,20475.25,BUY,3,0.02h,Stop Loss,$6.00,$739.50,$143931.50,306,$739.50
2025-03-04,11:37:00,20457.75,SELL,3,0.02h,Stop Loss,$4.50,$744.00,$143936.00,306,$744.00
2025-03-04,11:46:00,20475.5,BUY,3,0.02h,Stop Loss,$46.50,$790.50,$143982.50,306,$790.50
2025-03-04,12:01:00,20460.75,SELL,3,0.02h,Stop Loss,$54.00,$844.50,$144036.50,306,$844.50
2025-03-04,13:36:00,20327.25,BUY,3,0.02h,Stop Loss,$60.00,$904.50,$144096.50,306,$904.50
2025-03-04,14:00:00,20325.0,SELL,3,0.02h,Stop Loss,$6.00,$910.50,$144102.50,306,$910.50
2025-03-04,14:01:00,20337.0,BUY,3,0.02h,Stop Loss,$33.00,$943.50,$144135.50,306,$943.50
2025-03-04,14:21:00,20343.0,SELL,3,0.02h,Stop Loss,$34.50,$978.00,$144170.00,306,$978.00
2025-03-04,14:38:00,20399.5,BUY,3,0.02h,Stop Loss,$162.00,$1140.00,$144332.00,306,$1140.00
2025-03-04,14:43:00,20278.25,SELL,3,0.02h,Stop Loss,$79.50,$1219.50,$144411.50,306,$1219.50
2025-03-04,14:48:00,20370.5,BUY,3,0.02h,Stop Loss,$231.00,$1450.50,$144642.50,306,$1450.50
2025-03-04,14:51:00,20305.25,SELL,3,0.02h,Stop Loss,$181.50,$1632.00,$144824.00,306,$1632.00
2025-03-04,15:33:00,20211.25,BUY,3,0.02h,Stop Loss,$171.00,$1803.00,$144995.00,306,$1803.00
2025-03-04,15:55:00,20175.0,SELL,3,0.02h,Stop Loss,$87.00,$1890.00,$145082.00,306,$1890.00
2025-03-04,16:16:00,20220.75,BUY,3,0.02h,Stop Loss,$37.50,$1927.50,$145119.50,306,$1927.50
2025-03-04,16:22:00,20176.0,SELL,3,0.02h,Stop Loss,$51.00,$1978.50,$145170.50,306,$1978.50
2025-03-04,16:23:00,20186.0,BUY,3,0.02h,Stop Loss,$-9.00,$1969.50,$145161.50,306,$1969.50
2025-03-04,16:24:00,20148.25,SELL,3,0.02h,Stop Loss,$-9.00,$1960.50,$145152.50,306,$1960.50
2025-03-04,16:34:00,20186.0,BUY,3,0.02h,Stop Loss,$45.00,$2005.50,$145197.50,306,$2005.50
2025-03-04,17:53:00,20322.0,SELL,3,0.02h,Stop Loss,$3.00,$2008.50,$145200.50,306,$2008.50
2025-03-04,18:09:00,20407.25,BUY,3,0.02h,Stop Loss,$100.50,$2109.00,$145301.00,306,$2109.00
2025-03-04,18:27:00,20390.5,SELL,3,0.02h,Stop Loss,$31.50,$2140.50,$145332.50,306,$2140.50
2025-03-04,18:38:00,20420.0,BUY,3,0.02h,Stop Loss,$25.50,$2166.00,$145358.00,306,$2166.00
2025-03-04,19:35:00,20549.5,SELL,3,0.02h,Stop Loss,$3.00,$2169.00,$145361.00,306,$2169.00
2025-03-04,19:38:00,20583.0,BUY,3,0.02h,Stop Loss,$13.50,$2182.50,$145374.50,306,$2182.50
2025-03-04,20:32:00,20610.5,SELL,3,0.02h,Stop Loss,$159.00,$2341.50,$145533.50,306,$2341.50
2025-03-04,21:11:00,20453.0,BUY,3,0.02h,Stop Loss,$168.00,$2509.50,$145701.50,306,$2509.50
2025-03-04,21:41:00,20494.5,SELL,3,0.02h,Stop Loss,$19.50,$2529.00,$145721.00,306,$2529.00
2025-03-04,21:48:00,20535.0,BUY,3,0.02h,Break Even,$-1.50,$2527.50,$145719.50,306,$2527.50
2025-03-04,23:48:00,20565.75,SELL,3,0.02h,Stop Loss,$13.50,$2541.00,$145733.00,306,$2541.00
,,,,,,,,,,,
2025-03-05,00:02:00,20576.75,BUY,3,0.02h,Break Even,$-1.50,$-1.50,$145731.50,307,$-1.50
2025-03-05,00:15:00,20566.25,SELL,3,0.02h,Stop Loss,$39.00,$37.50,$145770.50,307,$37.50
2025-03-05,00:57:00,20534.25,BUY,3,0.02h,Stop Loss,$-9.00,$28.50,$145761.50,307,$28.50
2025-03-05,01:05:00,20510.25,SELL,3,0.02h,Stop Loss,$18.00,$46.50,$145779.50,307,$46.50
2025-03-05,01:27:00,20526.5,BUY,3,0.02h,Stop Loss,$7.50,$54.00,$145787.00,307,$54.00
2025-03-05,01:31:00,20490.25,SELL,3,0.02h,Stop Loss,$213.00,$267.00,$146000.00,307,$267.00
2025-03-05,01:39:00,20526.75,BUY,3,0.02h,Stop Loss,$18.00,$285.00,$146018.00,307,$285.00
2025-03-05,01:57:00,20511.5,SELL,3,0.02h,Stop Loss,$25.50,$310.50,$146043.50,307,$310.50
2025-03-05,02:43:00,20485.0,BUY,3,0.02h,Stop Loss,$39.00,$349.50,$146082.50,307,$349.50
2025-03-05,03:01:00,20474.5,SELL,3,0.02h,Stop Loss,$45.00,$394.50,$146127.50,307,$394.50
2025-03-05,03:07:00,20502.5,BUY,3,0.02h,Stop Loss,$94.50,$489.00,$146222.00,307,$489.00
2025-03-05,03:38:00,20516.0,SELL,3,0.02h,Stop Loss,$46.50,$535.50,$146268.50,307,$535.50
2025-03-05,03:49:00,20539.5,BUY,3,0.02h,Stop Loss,$12.00,$547.50,$146280.50,307,$547.50
2025-03-05,04:25:00,20543.0,SELL,3,0.02h,Stop Loss,$-9.00,$538.50,$146271.50,307,$538.50
2025-03-05,05:03:00,20545.5,BUY,3,0.02h,Stop Loss,$6.00,$544.50,$146277.50,307,$544.50
2025-03-05,05:16:00,20531.25,SELL,3,0.02h,Stop Loss,$-9.00,$535.50,$146268.50,307,$535.50
2025-03-05,05:39:00,20534.5,BUY,3,0.02h,Stop Loss,$-9.00,$526.50,$146259.50,307,$526.50
2025-03-05,06:22:00,20545.0,SELL,3,0.02h,Break Even,$-1.50,$525.00,$146258.00,307,$525.00
2025-03-05,06:43:00,20547.25,BUY,3,0.02h,Break Even,$-1.50,$523.50,$146256.50,307,$523.50
2025-03-05,07:15:00,20545.75,SELL,3,0.02h,Stop Loss,$16.50,$540.00,$146273.00,307,$540.00
2025-03-05,07:28:00,20552.75,BUY,3,0.02h,Stop Loss,$-9.00,$531.00,$146264.00,307,$531.00
2025-03-05,07:29:00,20549.0,SELL,3,0.02h,Stop Loss,$-9.00,$522.00,$146255.00,307,$522.00
2025-03-05,07:30:00,20552.75,BUY,3,0.02h,Stop Loss,$-9.00,$513.00,$146246.00,307,$513.00
2025-03-05,07:31:00,20546.75,SELL,3,0.02h,Break Even,$-1.50,$511.50,$146244.50,307,$511.50
2025-03-05,07:35:00,20551.0,BUY,3,0.02h,Break Even,$-1.50,$510.00,$146243.00,307,$510.00
2025-03-05,07:42:00,20542.5,SELL,3,0.02h,Stop Loss,$9.00,$519.00,$146252.00,307,$519.00
2025-03-05,07:49:00,20554.0,BUY,3,0.02h,Stop Loss,$-9.00,$510.00,$146243.00,307,$510.00
2025-03-05,07:52:00,20540.75,SELL,3,0.02h,Stop Loss,$10.50,$520.50,$146253.50,307,$520.50
2025-03-05,07:58:00,20553.25,BUY,3,0.02h,Stop Loss,$10.50,$531.00,$146264.00,307,$531.00
2025-03-05,08:01:00,20539.25,SELL,3,0.02h,Stop Loss,$21.00,$552.00,$146285.00,307,$552.00
2025-03-05,08:17:00,20547.25,BUY,3,0.02h,Stop Loss,$24.00,$576.00,$146309.00,307,$576.00
2025-03-05,08:41:00,20562.25,SELL,3,0.02h,Stop Loss,$3.00,$579.00,$146312.00,307,$579.00
2025-03-05,09:11:00,20558.75,BUY,3,0.02h,Stop Loss,$-9.00,$570.00,$146303.00,307,$570.00
2025-03-05,10:03:00,20598.75,SELL,3,0.02h,Stop Loss,$-9.00,$561.00,$146294.00,307,$561.00
2025-03-05,10:09:00,20617.25,BUY,3,0.02h,Stop Loss,$-9.00,$552.00,$146285.00,307,$552.00
2025-03-05,10:10:00,20602.25,SELL,3,0.02h,Stop Loss,$49.50,$601.50,$146334.50,307,$601.50
2025-03-05,10:39:00,20570.25,BUY,3,0.02h,Stop Loss,$24.00,$625.50,$146358.50,307,$625.50
2025-03-05,10:52:00,20564.75,SELL,3,0.02h,Stop Loss,$25.50,$651.00,$146384.00,307,$651.00
2025-03-05,11:41:00,20546.25,BUY,3,0.02h,Break Even,$-1.50,$649.50,$146382.50,307,$649.50
2025-03-05,11:42:00,20540.0,SELL,3,0.02h,Stop Loss,$9.00,$658.50,$146391.50,307,$658.50
2025-03-05,11:44:00,20551.75,BUY,3,0.02h,Break Even,$-1.50,$657.00,$146390.00,307,$657.00
2025-03-05,11:52:00,20528.75,SELL,3,0.02h,Break Even,$-1.50,$655.50,$146388.50,307,$655.50
2025-03-05,12:32:00,20500.5,BUY,3,0.02h,Stop Loss,$6.00,$661.50,$146394.50,307,$661.50
2025-03-05,12:49:00,20490.75,SELL,3,0.02h,Stop Loss,$-9.00,$652.50,$146385.50,307,$652.50
2025-03-05,13:12:00,20507.75,BUY,3,0.02h,Break Even,$-1.50,$651.00,$146384.00,307,$651.00
2025-03-05,13:15:00,20485.5,SELL,3,0.02h,Stop Loss,$306.00,$957.00,$146690.00,307,$957.00
2025-03-05,14:15:00,20440.5,BUY,3,0.02h,Stop Loss,$129.00,$1086.00,$146819.00,307,$1086.00
2025-03-05,14:32:00,20418.0,SELL,3,0.02h,Stop Loss,$154.50,$1240.50,$146973.50,307,$1240.50
2025-03-05,14:44:00,20443.5,BUY,3,0.02h,Break Even,$-1.50,$1239.00,$146972.00,307,$1239.00
2025-03-05,14:48:00,20376.25,SELL,3,0.02h,Stop Loss,$106.50,$1345.50,$147078.50,307,$1345.50
2025-03-05,15:03:00,20421.0,BUY,3,0.02h,Stop Loss,$126.00,$1471.50,$147204.50,307,$1471.50
2025-03-05,15:19:00,20384.0,SELL,3,0.02h,Stop Loss,$112.50,$1584.00,$147317.00,307,$1584.00
2025-03-05,15:38:00,20388.5,BUY,3,0.02h,Stop Loss,$175.50,$1759.50,$147492.50,307,$1759.50
2025-03-05,15:52:00,20359.5,SELL,3,0.02h,Stop Loss,$46.50,$1806.00,$147539.00,307,$1806.00
2025-03-05,15:54:00,20401.5,BUY,3,0.02h,Stop Loss,$90.00,$1896.00,$147629.00,307,$1896.00
2025-03-05,16:02:00,20354.75,SELL,3,0.02h,Stop Loss,$42.00,$1938.00,$147671.00,307,$1938.00
2025-03-05,16:57:00,20274.5,BUY,3,0.02h,Stop Loss,$336.00,$2274.00,$148007.00,307,$2274.00
2025-03-05,18:10:00,20469.25,SELL,3,0.02h,Stop Loss,$24.00,$2298.00,$148031.00,307,$2298.00
2025-03-05,18:48:00,20522.0,BUY,3,0.02h,Stop Loss,$157.50,$2455.50,$148188.50,307,$2455.50
2025-03-05,19:37:00,20649.75,SELL,3,0.02h,Stop Loss,$183.00,$2638.50,$148371.50,307,$2638.50
2025-03-05,19:50:00,20668.5,BUY,3,0.02h,Stop Loss,$66.00,$2704.50,$148437.50,307,$2704.50
2025-03-05,20:18:00,20623.5,SELL,3,0.02h,Break Even,$-1.50,$2703.00,$148436.00,307,$2703.00
2025-03-05,20:30:00,20690.0,BUY,3,0.02h,Break Even,$-1.50,$2701.50,$148434.50,307,$2701.50
2025-03-05,20:31:00,20660.0,SELL,3,0.02h,Stop Loss,$25.50,$2727.00,$148460.00,307,$2727.00
2025-03-05,20:42:00,20683.25,BUY,3,0.02h,Stop Loss,$31.50,$2758.50,$148491.50,307,$2758.50
2025-03-05,20:48:00,20662.75,SELL,3,0.02h,Stop Loss,$39.00,$2797.50,$148530.50,307,$2797.50
2025-03-05,20:55:00,20690.0,BUY,3,0.02h,Stop Loss,$-9.00,$2788.50,$148521.50,307,$2788.50
2025-03-05,21:00:00,20659.5,SELL,3,0.02h,Stop Loss,$49.50,$2838.00,$148571.00,307,$2838.00
2025-03-05,21:59:00,20616.75,BUY,3,1.03h,Break Even,$-1.50,$2836.50,$148569.50,307,$2836.50
2025-03-05,23:25:00,20619.5,SELL,3,0.02h,Break Even,$-1.50,$2835.00,$148568.00,307,$2835.00
2025-03-05,23:52:00,20612.75,BUY,3,0.02h,Break Even,$-1.50,$2833.50,$148566.50,307,$2833.50
2025-03-05,23:54:00,20609.25,SELL,3,0.02h,Break Even,$-1.50,$2832.00,$148565.00,307,$2832.00
,,,,,,,,,,,
2025-03-06,00:04:00,20612.25,BUY,3,0.02h,Break Even,$-1.50,$-1.50,$148563.50,308,$-1.50
2025-03-06,00:40:00,20624.25,SELL,3,0.02h,Break Even,$-1.50,$-3.00,$148562.00,308,$-3.00
2025-03-06,01:14:00,20611.25,BUY,3,0.02h,Stop Loss,$-9.00,$-12.00,$148553.00,308,$-12.00
2025-03-06,01:23:00,20600.25,SELL,3,0.02h,Stop Loss,$-9.00,$-21.00,$148544.00,308,$-21.00
2025-03-06,01:28:00,20609.75,BUY,3,0.02h,Stop Loss,$3.00,$-18.00,$148547.00,308,$-18.00
2025-03-06,01:33:00,20595.5,SELL,3,0.02h,Stop Loss,$-9.00,$-27.00,$148538.00,308,$-27.00
2025-03-06,01:53:00,20608.0,BUY,3,0.02h,Break Even,$-1.50,$-28.50,$148536.50,308,$-28.50
2025-03-06,02:18:00,20608.5,SELL,3,0.02h,Break Even,$-1.50,$-30.00,$148535.00,308,$-30.00
2025-03-06,02:35:00,20621.0,BUY,3,0.02h,Stop Loss,$-9.00,$-39.00,$148526.00,308,$-39.00
2025-03-06,02:43:00,20603.25,SELL,3,0.02h,Break Even,$-1.50,$-40.50,$148524.50,308,$-40.50
2025-03-06,02:55:00,20608.5,BUY,3,0.02h,Stop Loss,$-9.00,$-49.50,$148515.50,308,$-49.50
2025-03-06,02:56:00,20604.75,SELL,3,0.02h,Stop Loss,$-9.00,$-58.50,$148506.50,308,$-58.50
2025-03-06,02:57:00,20607.0,BUY,3,0.02h,Break Even,$-1.50,$-60.00,$148505.00,308,$-60.00
2025-03-06,03:01:00,20600.5,SELL,3,0.02h,Stop Loss,$10.50,$-49.50,$148515.50,308,$-49.50
2025-03-06,03:28:00,20602.75,BUY,3,0.02h,Stop Loss,$-9.00,$-58.50,$148506.50,308,$-58.50
2025-03-06,05:09:00,20636.75,SELL,3,0.02h,Stop Loss,$-9.00,$-67.50,$148497.50,308,$-67.50
2025-03-06,05:10:00,20639.25,BUY,3,0.02h,Break Even,$-1.50,$-69.00,$148496.00,308,$-69.00
2025-03-06,05:27:00,20636.25,SELL,3,0.02h,Stop Loss,$-9.00,$-78.00,$148487.00,308,$-78.00
2025-03-06,06:15:00,20620.5,BUY,3,0.02h,Break Even,$-1.50,$-79.50,$148485.50,308,$-79.50
2025-03-06,06:56:00,20630.5,SELL,3,0.02h,Stop Loss,$-9.00,$-88.50,$148476.50,308,$-88.50
2025-03-06,06:57:00,20634.5,BUY,3,0.02h,Stop Loss,$-9.00,$-97.50,$148467.50,308,$-97.50
2025-03-06,07:14:00,20628.25,SELL,3,0.02h,Break Even,$-1.50,$-99.00,$148466.00,308,$-99.00
2025-03-06,09:10:00,20473.75,BUY,3,0.02h,Stop Loss,$-9.00,$-108.00,$148457.00,308,$-108.00
2025-03-06,09:11:00,20466.25,SELL,3,0.02h,Stop Loss,$51.00,$-57.00,$148508.00,308,$-57.00
2025-03-06,09:45:00,20436.75,BUY,3,0.02h,Stop Loss,$25.50,$-31.50,$148533.50,308,$-31.50
2025-03-06,09:49:00,20420.0,SELL,3,0.02h,Stop Loss,$49.50,$18.00,$148583.00,308,$18.00
2025-03-06,10:13:00,20409.5,BUY,3,0.02h,Stop Loss,$37.50,$55.50,$148620.50,308,$55.50
2025-03-06,10:15:00,20403.75,SELL,3,0.02h,Stop Loss,$24.00,$79.50,$148644.50,308,$79.50
2025-03-06,10:16:00,20411.0,BUY,3,0.02h,Stop Loss,$25.50,$105.00,$148670.00,308,$105.00
2025-03-06,10:37:00,20402.5,SELL,3,0.02h,Break Even,$-1.50,$103.50,$148668.50,308,$103.50
2025-03-06,11:19:00,20389.5,BUY,3,0.02h,Break Even,$-1.50,$102.00,$148667.00,308,$102.00
2025-03-06,12:06:00,20410.0,SELL,3,0.02h,Stop Loss,$63.00,$165.00,$148730.00,308,$165.00
2025-03-06,12:29:00,20405.5,BUY,3,0.02h,Break Even,$-1.50,$163.50,$148728.50,308,$163.50
2025-03-06,12:33:00,20377.0,SELL,3,0.02h,Stop Loss,$7.50,$171.00,$148736.00,308,$171.00
2025-03-06,12:56:00,20389.5,BUY,3,0.02h,Stop Loss,$-9.00,$162.00,$148727.00,308,$162.00
2025-03-06,13:01:00,20371.0,SELL,3,0.02h,Stop Loss,$13.50,$175.50,$148740.50,308,$175.50
2025-03-06,13:34:00,20356.0,BUY,3,0.02h,Stop Loss,$28.50,$204.00,$148769.00,308,$204.00
2025-03-06,13:48:00,20334.75,SELL,3,0.02h,Stop Loss,$3.00,$207.00,$148772.00,308,$207.00
2025-03-06,14:07:00,20351.25,BUY,3,0.02h,Stop Loss,$-9.00,$198.00,$148763.00,308,$198.00
2025-03-06,14:23:00,20331.75,SELL,3,0.02h,Stop Loss,$33.00,$231.00,$148796.00,308,$231.00
2025-03-06,14:52:00,20324.5,BUY,3,0.02h,Stop Loss,$36.00,$267.00,$148832.00,308,$267.00
2025-03-06,14:59:00,20281.0,SELL,3,0.02h,Stop Loss,$6.00,$273.00,$148838.00,308,$273.00
2025-03-06,15:02:00,20304.0,BUY,3,0.02h,Stop Loss,$61.50,$334.50,$148899.50,308,$334.50
2025-03-06,15:53:00,20442.25,SELL,3,0.02h,Stop Loss,$7.50,$342.00,$148907.00,308,$342.00
2025-03-06,16:04:00,20472.5,BUY,3,0.02h,Stop Loss,$6.00,$348.00,$148913.00,308,$348.00
2025-03-06,16:08:00,20434.0,SELL,3,0.02h,Break Even,$-1.50,$346.50,$148911.50,308,$346.50
2025-03-06,16:09:00,20462.0,BUY,3,0.02h,Stop Loss,$150.00,$496.50,$149061.50,308,$496.50
2025-03-06,16:21:00,20425.0,SELL,3,0.02h,Stop Loss,$154.50,$651.00,$149216.00,308,$651.00
2025-03-06,17:59:00,20187.0,BUY,3,0.02h,Stop Loss,$18.00,$669.00,$149234.00,308,$669.00
2025-03-06,18:11:00,20127.0,SELL,3,0.02h,Break Even,$-1.50,$667.50,$149232.50,308,$667.50
2025-03-06,18:13:00,20163.5,BUY,3,0.02h,Break Even,$-1.50,$666.00,$149231.00,308,$666.00
2025-03-06,18:30:00,20135.75,SELL,3,0.02h,Stop Loss,$76.50,$742.50,$149307.50,308,$742.50
2025-03-06,18:54:00,20135.25,BUY,3,0.02h,Break Even,$-1.50,$741.00,$149306.00,308,$741.00
2025-03-06,19:02:00,20088.0,SELL,3,0.02h,Stop Loss,$127.50,$868.50,$149433.50,308,$868.50
2025-03-06,19:43:00,20077.5,BUY,3,0.02h,Stop Loss,$-9.00,$859.50,$149424.50,308,$859.50
2025-03-06,20:01:00,20065.0,SELL,3,0.02h,Stop Loss,$33.00,$892.50,$149457.50,308,$892.50
2025-03-06,20:11:00,20118.25,BUY,3,0.02h,Stop Loss,$63.00,$955.50,$149520.50,308,$955.50
2025-03-06,20:23:00,20081.0,SELL,3,0.02h,Stop Loss,$138.00,$1093.50,$149658.50,308,$1093.50
2025-03-06,20:32:00,20119.5,BUY,3,0.02h,Stop Loss,$81.00,$1174.50,$149739.50,308,$1174.50
2025-03-06,20:41:00,20090.0,SELL,3,0.02h,Stop Loss,$136.50,$1311.00,$149876.00,308,$1311.00
2025-03-06,20:54:00,20092.5,BUY,3,0.02h,Stop Loss,$117.00,$1428.00,$149993.00,308,$1428.00
2025-03-06,21:41:00,20163.75,SELL,3,0.02h,Stop Loss,$-9.00,$1419.00,$149984.00,308,$1419.00
2025-03-06,21:47:00,20185.25,BUY,3,0.02h,Stop Loss,$12.00,$1431.00,$149996.00,308,$1431.00
2025-03-06,23:22:00,20194.5,SELL,3,0.02h,Stop Loss,$46.50,$1477.50,$150042.50,308,$1477.50
,,,,,,,,,,,
2025-03-07,00:06:00,20193.0,BUY,3,0.02h,Stop Loss,$3.00,$3.00,$150045.50,309,$3.00
2025-03-07,00:25:00,20174.0,SELL,3,0.02h,Stop Loss,$52.50,$55.50,$150098.00,309,$55.50
2025-03-07,00:43:00,20193.75,BUY,3,0.02h,Break Even,$-1.50,$54.00,$150096.50,309,$54.00
2025-03-07,01:00:00,20175.25,SELL,3,0.02h,Stop Loss,$39.00,$93.00,$150135.50,309,$93.00
2025-03-07,01:08:00,20188.25,BUY,3,0.02h,Stop Loss,$25.50,$118.50,$150161.00,309,$118.50
2025-03-07,01:30:00,20193.5,SELL,3,0.02h,Stop Loss,$12.00,$130.50,$150173.00,309,$130.50
2025-03-07,01:48:00,20199.0,BUY,3,0.02h,Stop Loss,$-9.00,$121.50,$150164.00,309,$121.50
2025-03-07,01:54:00,20187.0,SELL,3,0.02h,Stop Loss,$-9.00,$112.50,$150155.00,309,$112.50
2025-03-07,01:56:00,20195.5,BUY,3,0.02h,Stop Loss,$15.00,$127.50,$150170.00,309,$127.50
2025-03-07,02:02:00,20190.5,SELL,3,0.02h,Stop Loss,$-9.00,$118.50,$150161.00,309,$118.50
2025-03-07,02:14:00,20197.0,BUY,3,0.02h,Break Even,$-1.50,$117.00,$150159.50,309,$117.00
2025-03-07,02:27:00,20192.25,SELL,3,0.02h,Break Even,$-1.50,$115.50,$150158.00,309,$115.50
2025-03-07,02:41:00,20200.0,BUY,3,0.02h,Stop Loss,$-9.00,$106.50,$150149.00,309,$106.50
2025-03-07,02:58:00,20192.25,SELL,3,0.02h,Stop Loss,$-9.00,$97.50,$150140.00,309,$97.50
2025-03-07,04:04:00,20177.75,BUY,3,0.02h,Stop Loss,$39.00,$136.50,$150179.00,309,$136.50
2025-03-07,04:17:00,20173.25,SELL,3,0.02h,Stop Loss,$-9.00,$127.50,$150170.00,309,$127.50
2025-03-07,04:39:00,20179.25,BUY,3,0.02h,Stop Loss,$-9.00,$118.50,$150161.00,309,$118.50
2025-03-07,05:05:00,20172.5,SELL,3,0.02h,Stop Loss,$-9.00,$109.50,$150152.00,309,$109.50
2025-03-07,05:20:00,20183.0,BUY,3,0.02h,Break Even,$-1.50,$108.00,$150150.50,309,$108.00
2025-03-07,05:25:00,20170.0,SELL,3,0.02h,Stop Loss,$-9.00,$99.00,$150141.50,309,$99.00
2025-03-07,05:29:00,20178.75,BUY,3,0.02h,Stop Loss,$-9.00,$90.00,$150132.50,309,$90.00
2025-03-07,05:45:00,20172.5,SELL,3,0.02h,Break Even,$-1.50,$88.50,$150131.00,309,$88.50
2025-03-07,07:01:00,20140.5,BUY,3,0.02h,Stop Loss,$51.00,$139.50,$150182.00,309,$139.50
2025-03-07,07:38:00,20148.25,SELL,3,0.02h,Stop Loss,$31.50,$171.00,$150213.50,309,$171.00
2025-03-07,07:50:00,20169.75,BUY,3,0.02h,Stop Loss,$3.00,$174.00,$150216.50,309,$174.00
2025-03-07,08:28:00,20163.75,SELL,3,0.02h,Stop Loss,$7.50,$181.50,$150224.00,309,$181.50
2025-03-07,08:31:00,20182.0,BUY,3,0.02h,Stop Loss,$24.00,$205.50,$150248.00,309,$205.50
2025-03-07,08:37:00,20167.75,SELL,3,0.02h,Stop Loss,$52.50,$258.00,$150300.50,309,$258.00
2025-03-07,08:48:00,20178.0,BUY,3,0.02h,Stop Loss,$-9.00,$249.00,$150291.50,309,$249.00
2025-03-07,08:53:00,20157.0,SELL,3,0.02h,Stop Loss,$-9.00,$240.00,$150282.50,309,$240.00
2025-03-07,08:58:00,20175.5,BUY,3,0.02h,Break Even,$-1.50,$238.50,$150281.00,309,$238.50
2025-03-07,09:39:00,20196.5,SELL,3,0.02h,Break Even,$-1.50,$237.00,$150279.50,309,$237.00
2025-03-07,09:50:00,20208.75,BUY,3,0.02h,Break Even,$-1.50,$235.50,$150278.00,309,$235.50
2025-03-07,10:01:00,20197.5,SELL,3,0.02h,Stop Loss,$16.50,$252.00,$150294.50,309,$252.00
2025-03-07,10:24:00,20186.75,BUY,3,0.02h,Stop Loss,$-9.00,$243.00,$150285.50,309,$243.00
2025-03-07,10:30:00,20182.25,SELL,3,0.02h,Stop Loss,$3.00,$246.00,$150288.50,309,$246.00
2025-03-07,10:36:00,20190.5,BUY,3,0.02h,Break Even,$-1.50,$244.50,$150287.00,309,$244.50
2025-03-07,10:46:00,20179.5,SELL,3,0.02h,Break Even,$-1.50,$243.00,$150285.50,309,$243.00
2025-03-07,11:19:00,20180.0,BUY,3,0.02h,Break Even,$-1.50,$241.50,$150284.00,309,$241.50
2025-03-07,11:46:00,20181.75,SELL,3,0.02h,Stop Loss,$6.00,$247.50,$150290.00,309,$247.50
2025-03-07,12:59:00,20130.0,BUY,3,0.02h,Stop Loss,$-9.00,$238.50,$150281.00,309,$238.50
2025-03-07,13:05:00,20116.5,SELL,3,0.02h,Stop Loss,$27.00,$265.50,$150308.00,309,$265.50
2025-03-07,13:06:00,20123.5,BUY,3,0.02h,Stop Loss,$31.50,$297.00,$150339.50,309,$297.00
2025-03-07,13:13:00,20106.0,SELL,3,0.02h,Stop Loss,$24.00,$321.00,$150363.50,309,$321.00
2025-03-07,13:31:00,20217.5,BUY,3,0.02h,Stop Loss,$298.50,$619.50,$150662.00,309,$619.50
2025-03-07,13:49:00,20152.75,SELL,3,0.02h,Stop Loss,$132.00,$751.50,$150794.00,309,$751.50
2025-03-07,14:35:00,20101.25,BUY,3,0.02h,Stop Loss,$130.50,$882.00,$150924.50,309,$882.00
2025-03-07,14:38:00,20048.75,SELL,3,0.02h,Stop Loss,$12.00,$894.00,$150936.50,309,$894.00
2025-03-07,14:39:00,20098.25,BUY,3,0.02h,Stop Loss,$55.50,$949.50,$150992.00,309,$949.50
2025-03-07,15:02:00,20129.25,SELL,3,0.02h,Stop Loss,$30.00,$979.50,$151022.00,309,$979.50
2025-03-07,15:07:00,20159.5,BUY,3,0.02h,Stop Loss,$124.50,$1104.00,$151146.50,309,$1104.00
2025-03-07,15:14:00,20118.5,SELL,3,0.02h,Stop Loss,$42.00,$1146.00,$151188.50,309,$1146.00
2025-03-07,15:52:00,19993.0,BUY,3,0.02h,Stop Loss,$175.50,$1321.50,$151364.00,309,$1321.50
2025-03-07,16:05:00,19986.0,SELL,3,0.02h,Stop Loss,$34.50,$1356.00,$151398.50,309,$1356.00
2025-03-07,16:08:00,20010.25,BUY,3,0.02h,Break Even,$-1.50,$1354.50,$151397.00,309,$1354.50
2025-03-07,16:11:00,19980.75,SELL,3,0.02h,Stop Loss,$48.00,$1402.50,$151445.00,309,$1402.50
2025-03-07,17:02:00,19845.0,BUY,3,0.02h,Stop Loss,$102.00,$1504.50,$151547.00,309,$1504.50
2025-03-07,17:09:00,19808.75,SELL,3,0.02h,Stop Loss,$85.50,$1590.00,$151632.50,309,$1590.00
2025-03-07,17:25:00,19849.25,BUY,3,0.02h,Stop Loss,$76.50,$1666.50,$151709.00,309,$1666.50
2025-03-07,18:30:00,20053.75,SELL,3,0.02h,Stop Loss,$55.50,$1722.00,$151764.50,309,$1722.00
2025-03-07,18:33:00,20077.75,BUY,3,0.02h,Stop Loss,$52.50,$1774.50,$151817.00,309,$1774.50
2025-03-07,19:10:00,20122.5,SELL,3,0.02h,Stop Loss,$-9.00,$1765.50,$151808.00,309,$1765.50
2025-03-07,19:15:00,20168.5,BUY,3,0.02h,Stop Loss,$12.00,$1777.50,$151820.00,309,$1777.50
2025-03-07,19:45:00,20206.5,SELL,3,0.02h,Stop Loss,$208.50,$1986.00,$152028.50,309,$1986.00
2025-03-07,20:09:00,20235.75,BUY,3,0.02h,Stop Loss,$30.00,$2016.00,$152058.50,309,$2016.00
2025-03-07,20:24:00,20205.75,SELL,3,0.02h,Stop Loss,$54.00,$2070.00,$152112.50,309,$2070.00
2025-03-07,20:28:00,20224.25,BUY,3,0.02h,Break Even,$-1.50,$2068.50,$152111.00,309,$2068.50
2025-03-07,20:33:00,20195.5,SELL,3,0.02h,Stop Loss,$-9.00,$2059.50,$152102.00,309,$2059.50
2025-03-07,20:35:00,20230.0,BUY,3,0.02h,Break Even,$-1.50,$2058.00,$152100.50,309,$2058.00
2025-03-07,20:37:00,20194.25,SELL,3,0.02h,Stop Loss,$225.00,$2283.00,$152325.50,309,$2283.00
2025-03-07,20:50:00,20219.25,BUY,3,0.02h,Stop Loss,$-9.00,$2274.00,$152316.50,309,$2274.00
2025-03-07,21:04:00,20159.25,SELL,3,0.02h,Break Even,$-1.50,$2272.50,$152315.00,309,$2272.50
2025-03-07,21:15:00,20208.75,BUY,3,0.02h,Break Even,$-1.50,$2271.00,$152313.50,309,$2271.00
2025-03-07,21:43:00,20201.75,SELL,3,0.02h,Stop Loss,$-9.00,$2262.00,$152304.50,309,$2262.00
2025-03-07,21:50:00,20209.75,BUY,3,0.02h,Break Even,$-1.50,$2260.50,$152303.00,309,$2260.50
,,,,,,,,,,,
2025-03-10,00:00:00,20034.0,SELL,3,0.02h,Stop Loss,$87.00,$87.00,$152390.00,310,$87.00
2025-03-10,00:43:00,20043.5,BUY,3,0.02h,Break Even,$-1.50,$85.50,$152388.50,310,$85.50
2025-03-10,02:29:00,20121.0,SELL,3,0.02h,Stop Loss,$-9.00,$76.50,$152379.50,310,$76.50
2025-03-10,02:35:00,20138.75,BUY,3,0.02h,Stop Loss,$16.50,$93.00,$152396.00,310,$93.00
2025-03-10,03:01:00,20138.5,SELL,3,0.02h,Break Even,$-1.50,$91.50,$152394.50,310,$91.50
2025-03-10,03:02:00,20141.0,BUY,3,0.02h,Stop Loss,$7.50,$99.00,$152402.00,310,$99.00
2025-03-10,03:13:00,20123.75,SELL,3,0.02h,Stop Loss,$22.50,$121.50,$152424.50,310,$121.50
2025-03-10,03:40:00,20126.5,BUY,3,0.02h,Break Even,$-1.50,$120.00,$152423.00,310,$120.00
2025-03-10,04:02:00,20128.0,SELL,3,0.02h,Break Even,$-1.50,$118.50,$152421.50,310,$118.50
2025-03-10,04:10:00,20137.25,BUY,3,0.02h,Stop Loss,$-9.00,$109.50,$152412.50,310,$109.50
2025-03-10,04:34:00,20136.5,SELL,3,0.02h,Stop Loss,$-9.00,$100.50,$152403.50,310,$100.50
2025-03-10,05:12:00,20115.5,BUY,3,0.02h,Stop Loss,$9.00,$109.50,$152412.50,310,$109.50
2025-03-10,05:34:00,20112.75,SELL,3,0.02h,Break Even,$-1.50,$108.00,$152411.00,310,$108.00
2025-03-10,06:04:00,20103.75,BUY,3,0.02h,Stop Loss,$28.50,$136.50,$152439.50,310,$136.50
2025-03-10,06:32:00,20107.25,SELL,3,0.02h,Break Even,$-1.50,$135.00,$152438.00,310,$135.00
2025-03-10,06:35:00,20116.25,BUY,3,0.02h,Stop Loss,$13.50,$148.50,$152451.50,310,$148.50
2025-03-10,06:42:00,20108.25,SELL,3,0.02h,Break Even,$-1.50,$147.00,$152450.00,310,$147.00
2025-03-10,06:46:00,20115.0,BUY,3,0.02h,Stop Loss,$3.00,$150.00,$152453.00,310,$150.00
2025-03-10,06:51:00,20109.5,SELL,3,0.02h,Break Even,$-1.50,$148.50,$152451.50,310,$148.50
2025-03-10,06:52:00,20119.5,BUY,3,0.02h,Break Even,$-1.50,$147.00,$152450.00,310,$147.00
2025-03-10,06:58:00,20108.5,SELL,3,0.02h,Stop Loss,$-9.00,$138.00,$152441.00,310,$138.00
2025-03-10,07:02:00,20121.75,BUY,3,0.02h,Stop Loss,$15.00,$153.00,$152456.00,310,$153.00
2025-03-10,07:16:00,20112.25,SELL,3,0.02h,Stop Loss,$4.50,$157.50,$152460.50,310,$157.50
2025-03-10,07:37:00,20117.75,BUY,3,0.02h,Stop Loss,$10.50,$168.00,$152471.00,310,$168.00
2025-03-10,07:51:00,20100.5,SELL,3,0.02h,Break Even,$-1.50,$166.50,$152469.50,310,$166.50
2025-03-10,09:19:00,20000.5,BUY,3,0.02h,Break Even,$-1.50,$165.00,$152468.00,310,$165.00
2025-03-10,09:55:00,19993.75,SELL,3,0.02h,Stop Loss,$-9.00,$156.00,$152459.00,310,$156.00
2025-03-10,10:57:00,19976.25,BUY,3,0.02h,Break Even,$-1.50,$154.50,$152457.50,310,$154.50
2025-03-10,10:58:00,19969.0,SELL,3,0.02h,Stop Loss,$6.00,$160.50,$152463.50,310,$160.50
2025-03-10,11:01:00,19993.0,BUY,3,0.02h,Stop Loss,$-9.00,$151.50,$152454.50,310,$151.50
2025-03-10,11:06:00,19961.5,SELL,3,0.02h,Stop Loss,$-9.00,$142.50,$152445.50,310,$142.50
2025-03-10,11:07:00,19982.25,BUY,3,0.02h,Stop Loss,$15.00,$157.50,$152460.50,310,$157.50
2025-03-10,11:36:00,19983.75,SELL,3,0.02h,Break Even,$-1.50,$156.00,$152459.00,310,$156.00
2025-03-10,12:47:00,19896.0,BUY,3,0.02h,Stop Loss,$-9.00,$147.00,$152450.00,310,$147.00
2025-03-10,12:50:00,19886.0,SELL,3,0.02h,Break Even,$-1.50,$145.50,$152448.50,310,$145.50
2025-03-10,12:52:00,19902.5,BUY,3,0.02h,Stop Loss,$34.50,$180.00,$152483.00,310,$180.00
2025-03-10,13:06:00,19888.5,SELL,3,0.02h,Stop Loss,$66.00,$246.00,$152549.00,310,$246.00
2025-03-10,13:11:00,19917.5,BUY,3,0.02h,Break Even,$-1.50,$244.50,$152547.50,310,$244.50
2025-03-10,13:22:00,19893.75,SELL,3,0.02h,Break Even,$-1.50,$243.00,$152546.00,310,$243.00
2025-03-10,13:46:00,19880.75,BUY,3,0.02h,Stop Loss,$87.00,$330.00,$152633.00,310,$330.00
2025-03-10,13:48:00,19850.5,SELL,3,0.02h,Stop Loss,$186.00,$516.00,$152819.00,310,$516.00
2025-03-10,15:11:00,19602.0,BUY,3,0.02h,Stop Loss,$6.00,$522.00,$152825.00,310,$522.00
2025-03-10,15:20:00,19569.5,SELL,3,0.02h,Stop Loss,$33.00,$555.00,$152858.00,310,$555.00
2025-03-10,15:24:00,19612.25,BUY,3,0.02h,Stop Loss,$112.50,$667.50,$152970.50,310,$667.50
2025-03-10,15:45:00,19604.25,SELL,3,0.02h,Break Even,$-1.50,$666.00,$152969.00,310,$666.00
2025-03-10,15:50:00,19650.75,BUY,3,0.02h,Stop Loss,$4.50,$670.50,$152973.50,310,$670.50
2025-03-10,15:51:00,19622.25,SELL,3,0.02h,Stop Loss,$-9.00,$661.50,$152964.50,310,$661.50
2025-03-10,16:32:00,19605.5,BUY,3,0.02h,Stop Loss,$34.50,$696.00,$152999.00,310,$696.00
2025-03-10,16:40:00,19538.25,SELL,3,0.02h,Break Even,$-1.50,$694.50,$152997.50,310,$694.50
2025-03-10,17:23:00,19547.5,BUY,3,0.02h,Stop Loss,$9.00,$703.50,$153006.50,310,$703.50
2025-03-10,17:31:00,19503.0,SELL,3,0.02h,Stop Loss,$111.00,$814.50,$153117.50,310,$814.50
2025-03-10,18:15:00,19452.5,BUY,3,0.02h,Stop Loss,$139.50,$954.00,$153257.00,310,$954.00
2025-03-10,18:26:00,19437.25,SELL,3,0.02h,Stop Loss,$129.00,$1083.00,$153386.00,310,$1083.00
2025-03-10,18:32:00,19467.0,BUY,3,0.02h,Break Even,$-1.50,$1081.50,$153384.50,310,$1081.50
2025-03-10,18:35:00,19442.0,SELL,3,0.02h,Stop Loss,$52.50,$1134.00,$153437.00,310,$1134.00
2025-03-10,19:18:00,19364.0,BUY,3,0.02h,Stop Loss,$48.00,$1182.00,$153485.00,310,$1182.00
2025-03-10,19:45:00,19393.75,SELL,3,0.02h,Stop Loss,$-9.00,$1173.00,$153476.00,310,$1173.00
2025-03-10,19:52:00,19458.5,BUY,3,0.02h,Stop Loss,$118.50,$1291.50,$153594.50,310,$1291.50
2025-03-10,19:54:00,19427.75,SELL,3,0.02h,Stop Loss,$159.00,$1450.50,$153753.50,310,$1450.50
2025-03-10,19:56:00,19470.25,BUY,3,0.02h,Stop Loss,$28.50,$1479.00,$153782.00,310,$1479.00
2025-03-10,20:38:00,19466.75,SELL,3,0.02h,Break Even,$-1.50,$1477.50,$153780.50,310,$1477.50
2025-03-10,20:46:00,19474.75,BUY,3,0.02h,Stop Loss,$10.50,$1488.00,$153791.00,310,$1488.00
2025-03-10,23:00:00,19377.5,SELL,3,0.02h,Stop Loss,$-9.00,$1479.00,$153782.00,310,$1479.00
2025-03-10,23:48:00,19309.0,BUY,3,0.02h,Stop Loss,$21.00,$1500.00,$153803.00,310,$1500.00
,,,,,,,,,,,
2025-03-11,00:09:00,19299.5,SELL,3,0.02h,Stop Loss,$13.50,$13.50,$153816.50,311,$13.50
2025-03-11,00:22:00,19315.5,BUY,3,0.02h,Stop Loss,$19.50,$33.00,$153836.00,311,$33.00
2025-03-11,00:24:00,19290.5,SELL,3,0.02h,Stop Loss,$3.00,$36.00,$153839.00,311,$36.00
2025-03-11,00:30:00,19314.75,BUY,3,0.02h,Stop Loss,$12.00,$48.00,$153851.00,311,$48.00
2025-03-11,00:31:00,19296.0,SELL,3,0.02h,Stop Loss,$6.00,$54.00,$153857.00,311,$54.00
2025-03-11,00:32:00,19306.0,BUY,3,0.02h,Stop Loss,$-9.00,$45.00,$153848.00,311,$45.00
2025-03-11,00:36:00,19295.75,SELL,3,0.02h,Break Even,$-1.50,$43.50,$153846.50,311,$43.50
2025-03-11,01:23:00,19209.75,BUY,3,0.02h,Stop Loss,$33.00,$76.50,$153879.50,311,$76.50
2025-03-11,01:57:00,19236.25,SELL,3,0.02h,Stop Loss,$-9.00,$67.50,$153870.50,311,$67.50
2025-03-11,01:59:00,19254.25,BUY,3,0.02h,Stop Loss,$10.50,$78.00,$153881.00,311,$78.00
2025-03-11,02:49:00,19353.75,SELL,3,0.02h,Stop Loss,$40.50,$118.50,$153921.50,311,$118.50
2025-03-11,02:55:00,19388.0,BUY,3,0.02h,Stop Loss,$42.00,$160.50,$153963.50,311,$160.50
2025-03-11,03:29:00,19446.25,SELL,3,0.02h,Break Even,$-1.50,$159.00,$153962.00,311,$159.00
2025-03-11,03:36:00,19464.75,BUY,3,0.02h,Stop Loss,$9.00,$168.00,$153971.00,311,$168.00
2025-03-11,03:41:00,19435.25,SELL,3,0.02h,Stop Loss,$-9.00,$159.00,$153962.00,311,$159.00
2025-03-11,04:12:00,19446.0,BUY,3,0.02h,Stop Loss,$12.00,$171.00,$153974.00,311,$171.00
2025-03-11,04:44:00,19463.75,SELL,3,0.02h,Stop Loss,$-9.00,$162.00,$153965.00,311,$162.00
2025-03-11,05:16:00,19476.0,BUY,3,0.02h,Break Even,$-1.50,$160.50,$153963.50,311,$160.50
2025-03-11,05:41:00,19455.5,SELL,3,0.02h,Break Even,$-1.50,$159.00,$153962.00,311,$159.00
2025-03-11,05:58:00,19469.25,BUY,3,0.02h,Break Even,$-1.50,$157.50,$153960.50,311,$157.50
2025-03-11,06:38:00,19480.25,SELL,3,0.02h,Stop Loss,$-9.00,$148.50,$153951.50,311,$148.50
2025-03-11,06:45:00,19497.25,BUY,3,0.02h,Stop Loss,$-9.00,$139.50,$153942.50,311,$139.50
2025-03-11,06:48:00,19483.25,SELL,3,0.02h,Stop Loss,$12.00,$151.50,$153954.50,311,$151.50
2025-03-11,07:25:00,19471.75,BUY,3,0.02h,Break Even,$-1.50,$150.00,$153953.00,311,$150.00
2025-03-11,07:27:00,19466.0,SELL,3,0.02h,Stop Loss,$16.50,$166.50,$153969.50,311,$166.50
2025-03-11,07:28:00,19470.0,BUY,3,0.02h,Stop Loss,$25.50,$192.00,$153995.00,311,$192.00
2025-03-11,07:30:00,19465.0,SELL,3,0.02h,Stop Loss,$61.50,$253.50,$154056.50,311,$253.50
2025-03-11,07:55:00,19448.25,BUY,3,0.02h,Stop Loss,$87.00,$340.50,$154143.50,311,$340.50
2025-03-11,08:44:00,19533.75,SELL,3,0.02h,Stop Loss,$-9.00,$331.50,$154134.50,311,$331.50
2025-03-11,08:55:00,19552.0,BUY,3,0.02h,Stop Loss,$15.00,$346.50,$154149.50,311,$346.50
2025-03-11,09:13:00,19548.5,SELL,3,0.02h,Stop Loss,$30.00,$376.50,$154179.50,311,$376.50
2025-03-11,09:15:00,19556.75,BUY,3,0.02h,Stop Loss,$30.00,$406.50,$154209.50,311,$406.50
2025-03-11,09:20:00,19552.5,SELL,3,0.02h,Stop Loss,$-9.00,$397.50,$154200.50,311,$397.50
2025-03-11,09:21:00,19563.5,BUY,3,0.02h,Stop Loss,$-9.00,$388.50,$154191.50,311,$388.50
2025-03-11,09:23:00,19537.5,SELL,3,0.02h,Stop Loss,$15.00,$403.50,$154206.50,311,$403.50
2025-03-11,09:29:00,19565.75,BUY,3,0.02h,Stop Loss,$-9.00,$394.50,$154197.50,311,$394.50
2025-03-11,09:32:00,19543.75,SELL,3,0.02h,Stop Loss,$4.50,$399.00,$154202.00,311,$399.00
2025-03-11,09:37:00,19560.5,BUY,3,0.02h,Break Even,$-1.50,$397.50,$154200.50,311,$397.50
2025-03-11,09:42:00,19539.75,SELL,3,0.02h,Break Even,$-1.50,$396.00,$154199.00,311,$396.00
2025-03-11,10:14:00,19541.25,BUY,3,0.02h,Break Even,$-1.50,$394.50,$154197.50,311,$394.50
2025-03-11,10:38:00,19534.0,SELL,3,0.02h,Break Even,$-1.50,$393.00,$154196.00,311,$393.00
2025-03-11,11:18:00,19523.25,BUY,3,0.02h,Stop Loss,$-9.00,$384.00,$154187.00,311,$384.00
2025-03-11,12:07:00,19554.25,SELL,3,0.02h,Stop Loss,$36.00,$420.00,$154223.00,311,$420.00
2025-03-11,13:22:00,19461.5,BUY,3,0.02h,Break Even,$-1.50,$418.50,$154221.50,311,$418.50
2025-03-11,13:24:00,19450.5,SELL,3,0.02h,Stop Loss,$30.00,$448.50,$154251.50,311,$448.50
2025-03-11,13:38:00,19528.25,BUY,3,0.02h,Stop Loss,$4.50,$453.00,$154256.00,311,$453.00
2025-03-11,14:04:00,19423.5,SELL,3,0.02h,Stop Loss,$399.00,$852.00,$154655.00,311,$852.00
2025-03-11,14:54:00,19388.5,BUY,3,0.02h,Stop Loss,$159.00,$1011.00,$154814.00,311,$1011.00
2025-03-11,15:01:00,19316.25,SELL,3,0.02h,Stop Loss,$28.50,$1039.50,$154842.50,311,$1039.50
2025-03-11,15:07:00,19392.75,BUY,3,0.02h,Stop Loss,$334.50,$1374.00,$155177.00,311,$1374.00
2025-03-11,15:59:00,19440.5,SELL,3,0.02h,Stop Loss,$144.00,$1518.00,$155321.00,311,$1518.00
2025-03-11,16:28:00,19403.5,BUY,3,0.02h,Stop Loss,$34.50,$1552.50,$155355.50,311,$1552.50
2025-03-11,16:30:00,19385.75,SELL,3,0.02h,Stop Loss,$-9.00,$1543.50,$155346.50,311,$1543.50
2025-03-11,16:31:00,19401.25,BUY,3,0.02h,Stop Loss,$9.00,$1552.50,$155355.50,311,$1552.50
2025-03-11,16:40:00,19375.5,SELL,3,0.02h,Stop Loss,$138.00,$1690.50,$155493.50,311,$1690.50
2025-03-11,17:43:00,19276.75,BUY,3,0.02h,Break Even,$-1.50,$1689.00,$155492.00,311,$1689.00
2025-03-11,19:15:00,19577.75,SELL,3,0.02h,Stop Loss,$139.50,$1828.50,$155631.50,311,$1828.50
2025-03-11,20:49:00,19409.75,BUY,3,0.02h,Break Even,$-1.50,$1827.00,$155630.00,311,$1827.00
2025-03-11,20:52:00,19394.0,SELL,3,0.02h,Stop Loss,$39.00,$1866.00,$155669.00,311,$1866.00
2025-03-11,23:00:00,19468.5,BUY,3,0.02h,Stop Loss,$25.50,$1891.50,$155694.50,311,$1891.50
2025-03-11,23:27:00,19438.0,SELL,3,0.02h,Break Even,$-1.50,$1890.00,$155693.00,311,$1890.00
2025-03-11,23:44:00,19447.75,BUY,3,0.02h,Stop Loss,$-9.00,$1881.00,$155684.00,311,$1881.00
,,,,,,,,,,,
2025-03-12,00:37:00,19467.5,SELL,3,0.02h,Break Even,$-1.50,$-1.50,$155682.50,312,$-1.50
2025-03-12,01:00:00,19466.0,BUY,3,0.02h,Stop Loss,$54.00,$52.50,$155736.50,312,$52.50
2025-03-12,01:11:00,19455.75,SELL,3,0.02h,Stop Loss,$-9.00,$43.50,$155727.50,312,$43.50
2025-03-12,01:25:00,19465.75,BUY,3,0.02h,Stop Loss,$6.00,$49.50,$155733.50,312,$49.50
2025-03-12,01:28:00,19450.5,SELL,3,0.02h,Break Even,$-1.50,$48.00,$155732.00,312,$48.00
2025-03-12,01:38:00,19472.5,BUY,3,0.02h,Break Even,$-1.50,$46.50,$155730.50,312,$46.50
2025-03-12,02:10:00,19470.5,SELL,3,0.02h,Stop Loss,$-9.00,$37.50,$155721.50,312,$37.50
2025-03-12,02:11:00,19475.75,BUY,3,0.02h,Stop Loss,$30.00,$67.50,$155751.50,312,$67.50
2025-03-12,02:33:00,19477.25,SELL,3,0.02h,Stop Loss,$4.50,$72.00,$155756.00,312,$72.00
2025-03-12,03:08:00,19464.0,BUY,3,0.02h,Stop Loss,$3.00,$75.00,$155759.00,312,$75.00
2025-03-12,03:13:00,19459.0,SELL,3,0.02h,Stop Loss,$-9.00,$66.00,$155750.00,312,$66.00
2025-03-12,03:40:00,19457.5,BUY,3,0.02h,Break Even,$-1.50,$64.50,$155748.50,312,$64.50
2025-03-12,04:00:00,19450.75,SELL,3,0.02h,Stop Loss,$13.50,$78.00,$155762.00,312,$78.00
2025-03-12,04:16:00,19456.5,BUY,3,0.02h,Break Even,$-1.50,$76.50,$155760.50,312,$76.50
2025-03-12,04:43:00,19460.0,SELL,3,0.02h,Break Even,$-1.50,$75.00,$155759.00,312,$75.00
2025-03-12,05:26:00,19457.25,BUY,3,0.02h,Break Even,$-1.50,$73.50,$155757.50,312,$73.50
2025-03-12,06:06:00,19466.25,SELL,3,0.02h,Stop Loss,$-9.00,$64.50,$155748.50,312,$64.50
2025-03-12,06:40:00,19460.5,BUY,3,0.02h,Break Even,$-1.50,$63.00,$155747.00,312,$63.00
2025-03-12,06:45:00,19456.5,SELL,3,0.02h,Break Even,$-1.50,$61.50,$155745.50,312,$61.50
2025-03-12,07:27:00,19420.25,BUY,3,0.02h,Stop Loss,$12.00,$73.50,$155757.50,312,$73.50
2025-03-12,08:14:00,19456.5,SELL,3,0.02h,Stop Loss,$10.50,$84.00,$155768.00,312,$84.00
2025-03-12,08:33:00,19471.75,BUY,3,0.02h,Break Even,$-1.50,$82.50,$155766.50,312,$82.50
2025-03-12,09:16:00,19529.25,SELL,3,0.02h,Stop Loss,$-9.00,$73.50,$155757.50,312,$73.50
2025-03-12,09:22:00,19542.25,BUY,3,0.02h,Stop Loss,$-9.00,$64.50,$155748.50,312,$64.50
2025-03-12,09:44:00,19530.25,SELL,3,0.02h,Break Even,$-1.50,$63.00,$155747.00,312,$63.00
2025-03-12,09:52:00,19553.0,BUY,3,0.02h,Break Even,$-1.50,$61.50,$155745.50,312,$61.50
2025-03-12,10:08:00,19537.5,SELL,3,0.02h,Stop Loss,$12.00,$73.50,$155757.50,312,$73.50
2025-03-12,10:39:00,19544.5,BUY,3,0.02h,Stop Loss,$37.50,$111.00,$155795.00,312,$111.00
2025-03-12,11:46:00,19577.25,SELL,3,0.02h,Stop Loss,$-9.00,$102.00,$155786.00,312,$102.00
2025-03-12,12:17:00,19595.5,BUY,3,0.02h,Stop Loss,$39.00,$141.00,$155825.00,312,$141.00
2025-03-12,13:13:00,19687.5,SELL,3,0.02h,Stop Loss,$37.50,$178.50,$155862.50,312,$178.50
2025-03-12,13:31:00,19694.25,BUY,3,0.02h,Stop Loss,$223.50,$402.00,$156086.00,312,$402.00
2025-03-12,13:48:00,19689.75,SELL,3,0.02h,Stop Loss,$300.00,$702.00,$156386.00,312,$702.00
2025-03-12,14:08:00,19693.0,BUY,3,0.02h,Stop Loss,$73.50,$775.50,$156459.50,312,$775.50
2025-03-12,14:15:00,19641.75,SELL,3,0.02h,Stop Loss,$145.50,$921.00,$156605.00,312,$921.00
2025-03-12,15:24:00,19493.5,BUY,3,0.02h,Stop Loss,$147.00,$1068.00,$156752.00,312,$1068.00
2025-03-12,16:42:00,19638.0,SELL,3,0.02h,Stop Loss,$127.50,$1195.50,$156879.50,312,$1195.50
2025-03-12,16:51:00,19709.0,BUY,3,0.02h,Break Even,$-1.50,$1194.00,$156878.00,312,$1194.00
2025-03-12,16:58:00,19658.25,SELL,3,0.02h,Stop Loss,$82.50,$1276.50,$156960.50,312,$1276.50
2025-03-12,17:15:00,19672.75,BUY,3,0.02h,Stop Loss,$-9.00,$1267.50,$156951.50,312,$1267.50
2025-03-12,17:43:00,19680.75,SELL,3,0.02h,Break Even,$-1.50,$1266.00,$156950.00,312,$1266.00
2025-03-12,18:18:00,19603.5,BUY,3,0.02h,Stop Loss,$69.00,$1335.00,$157019.00,312,$1335.00
2025-03-12,19:02:00,19630.5,SELL,3,0.02h,Break Even,$-1.50,$1333.50,$157017.50,312,$1333.50
2025-03-12,19:56:00,19630.0,BUY,3,0.02h,Stop Loss,$6.00,$1339.50,$157023.50,312,$1339.50
2025-03-12,20:04:00,19595.25,SELL,3,0.02h,Stop Loss,$9.00,$1348.50,$157032.50,312,$1348.50
2025-03-12,20:31:00,19592.75,BUY,3,0.02h,Stop Loss,$-9.00,$1339.50,$157023.50,312,$1339.50
2025-03-12,20:39:00,19580.5,SELL,3,0.02h,Break Even,$-1.50,$1338.00,$157022.00,312,$1338.00
2025-03-12,23:00:00,19627.5,BUY,3,0.02h,Stop Loss,$10.50,$1348.50,$157032.50,312,$1348.50
,,,,,,,,,,,
2025-03-13,00:19:00,19676.5,SELL,3,0.02h,Stop Loss,$-9.00,$-9.00,$157023.50,313,$-9.00
2025-03-13,01:21:00,19654.25,BUY,3,0.02h,Break Even,$-1.50,$-10.50,$157022.00,313,$-10.50
2025-03-13,01:31:00,19622.25,SELL,3,0.02h,Break Even,$-1.50,$-12.00,$157020.50,313,$-12.00
2025-03-13,01:55:00,19631.25,BUY,3,0.02h,Break Even,$-1.50,$-13.50,$157019.00,313,$-13.50
2025-03-13,02:20:00,19623.0,SELL,3,0.02h,Break Even,$-1.50,$-15.00,$157017.50,313,$-15.00
2025-03-13,03:01:00,19797.75,BUY,3,0.02h,Stop Loss,$-9.00,$-24.00,$157008.50,313,$-24.00
2025-03-13,03:12:00,19573.75,SELL,3,0.02h,Stop Loss,$-9.00,$-33.00,$156999.50,313,$-33.00
2025-03-13,03:13:00,19788.75,BUY,3,0.02h,Stop Loss,$-9.00,$-42.00,$156990.50,313,$-42.00
2025-03-13,03:15:00,19576.5,SELL,3,0.02h,Stop Loss,$-9.00,$-51.00,$156981.50,313,$-51.00
2025-03-13,03:16:00,19786.75,BUY,3,0.02h,Break Even,$-1.50,$-52.50,$156980.00,313,$-52.50
2025-03-13,03:24:00,19580.25,SELL,3,0.02h,Stop Loss,$28.50,$-24.00,$157008.50,313,$-24.00
2025-03-13,03:26:00,19783.75,BUY,3,0.02h,Stop Loss,$-9.00,$-33.00,$156999.50,313,$-33.00
2025-03-13,03:31:00,19554.75,SELL,3,0.02h,Stop Loss,$55.50,$22.50,$157055.00,313,$22.50
2025-03-13,03:44:00,19744.0,BUY,3,0.02h,Stop Loss,$-9.00,$13.50,$157046.00,313,$13.50
2025-03-13,03:52:00,19527.25,SELL,3,0.02h,Stop Loss,$-9.00,$4.50,$157037.00,313,$4.50
2025-03-13,03:53:00,19733.25,BUY,3,0.02h,Break Even,$-1.50,$3.00,$157035.50,313,$3.00
2025-03-13,04:00:00,19519.25,SELL,3,0.02h,Stop Loss,$4.50,$7.50,$157040.00,313,$7.50
2025-03-13,04:08:00,19748.0,BUY,3,0.02h,Break Even,$-1.50,$6.00,$157038.50,313,$6.00
2025-03-13,04:23:00,19535.5,SELL,3,0.02h,Stop Loss,$7.50,$13.50,$157046.00,313,$13.50
2025-03-13,04:26:00,19736.5,BUY,3,0.02h,Stop Loss,$-9.00,$4.50,$157037.00,313,$4.50
2025-03-13,04:29:00,19516.5,SELL,3,0.02h,Stop Loss,$-9.00,$-4.50,$157028.00,313,$-4.50
2025-03-13,04:46:00,19699.0,BUY,3,0.02h,Stop Loss,$4.50,$0.00,$157032.50,313,$0.00
2025-03-13,04:51:00,19491.5,SELL,3,0.02h,Stop Loss,$-9.00,$-9.00,$157023.50,313,$-9.00
2025-03-13,04:52:00,19699.25,BUY,3,0.02h,Stop Loss,$-9.00,$-18.00,$157014.50,313,$-18.00
2025-03-13,04:53:00,19487.0,SELL,3,0.02h,Stop Loss,$-9.00,$-27.00,$157005.50,313,$-27.00
2025-03-13,04:54:00,19699.25,BUY,3,0.02h,Stop Loss,$-9.00,$-36.00,$156996.50,313,$-36.00
2025-03-13,04:55:00,19490.75,SELL,3,0.02h,Stop Loss,$145.50,$109.50,$157142.00,313,$109.50
2025-03-13,05:02:00,19691.0,BUY,3,0.02h,Break Even,$-1.50,$108.00,$157140.50,313,$108.00
2025-03-13,05:04:00,19483.75,SELL,3,0.02h,Stop Loss,$3.00,$111.00,$157143.50,313,$111.00
2025-03-13,05:09:00,19679.75,BUY,3,0.02h,Stop Loss,$-9.00,$102.00,$157134.50,313,$102.00
2025-03-13,05:10:00,19472.75,SELL,3,0.02h,Stop Loss,$-9.00,$93.00,$157125.50,313,$93.00
2025-03-13,05:11:00,19683.5,BUY,3,0.02h,Stop Loss,$3.00,$96.00,$157128.50,313,$96.00
2025-03-13,05:13:00,19475.75,SELL,3,0.02h,Break Even,$-1.50,$94.50,$157127.00,313,$94.50
2025-03-13,05:17:00,19672.5,BUY,3,0.02h,Stop Loss,$28.50,$123.00,$157155.50,313,$123.00
2025-03-13,05:21:00,19484.0,SELL,3,0.02h,Stop Loss,$-9.00,$114.00,$157146.50,313,$114.00
2025-03-13,05:22:00,19689.75,BUY,3,0.02h,Break Even,$-1.50,$112.50,$157145.00,313,$112.50
2025-03-13,05:28:00,19498.25,SELL,3,0.02h,Stop Loss,$-9.00,$103.50,$157136.00,313,$103.50
2025-03-13,05:29:00,19705.5,BUY,3,0.02h,Stop Loss,$-9.00,$94.50,$157127.00,313,$94.50
2025-03-13,05:30:00,19494.75,SELL,3,0.02h,Stop Loss,$-9.00,$85.50,$157118.00,313,$85.50
2025-03-13,05:31:00,19694.5,BUY,3,0.02h,Stop Loss,$-9.00,$76.50,$157109.00,313,$76.50
2025-03-13,05:33:00,19463.25,SELL,3,0.02h,Break Even,$-1.50,$75.00,$157107.50,313,$75.00
2025-03-13,05:36:00,19660.0,BUY,3,0.02h,Break Even,$-1.50,$73.50,$157106.00,313,$73.50
2025-03-13,05:41:00,19445.5,SELL,3,0.02h,Stop Loss,$-9.00,$64.50,$157097.00,313,$64.50
2025-03-13,05:42:00,19658.0,BUY,3,0.02h,Stop Loss,$-9.00,$55.50,$157088.00,313,$55.50
2025-03-13,05:43:00,19455.0,SELL,3,0.02h,Stop Loss,$-9.00,$46.50,$157079.00,313,$46.50
2025-03-13,05:48:00,19658.75,BUY,3,0.02h,Stop Loss,$69.00,$115.50,$157148.00,313,$115.50
2025-03-13,05:52:00,19459.25,SELL,3,0.02h,Stop Loss,$-9.00,$106.50,$157139.00,313,$106.50
2025-03-13,05:53:00,19666.0,BUY,3,0.02h,Stop Loss,$-9.00,$97.50,$157130.00,313,$97.50
2025-03-13,05:54:00,19454.5,SELL,3,0.02h,Break Even,$-1.50,$96.00,$157128.50,313,$96.00
2025-03-13,06:03:00,19673.25,BUY,3,0.02h,Stop Loss,$-9.00,$87.00,$157119.50,313,$87.00
2025-03-13,06:04:00,19455.0,SELL,3,0.02h,Stop Loss,$9.00,$96.00,$157128.50,313,$96.00
2025-03-13,06:24:00,19615.25,BUY,3,0.02h,Stop Loss,$-9.00,$87.00,$157119.50,313,$87.00
2025-03-13,06:27:00,19434.0,SELL,3,0.02h,Stop Loss,$-9.00,$78.00,$157110.50,313,$78.00
2025-03-13,06:28:00,19638.0,BUY,3,0.02h,Stop Loss,$-9.00,$69.00,$157101.50,313,$69.00
2025-03-13,06:30:00,19442.5,SELL,3,0.02h,Stop Loss,$57.00,$126.00,$157158.50,313,$126.00
2025-03-13,06:35:00,19656.0,BUY,3,0.03h,Break Even,$-1.50,$124.50,$157157.00,313,$124.50
2025-03-13,07:00:00,19483.25,SELL,3,0.02h,Stop Loss,$18.00,$142.50,$157175.00,313,$142.50
2025-03-13,07:10:00,19659.0,BUY,3,0.02h,Break Even,$-1.50,$141.00,$157173.50,313,$141.00
2025-03-13,07:26:00,19491.25,SELL,3,0.02h,Stop Loss,$-9.00,$132.00,$157164.50,313,$132.00
2025-03-13,07:27:00,19700.75,BUY,3,0.02h,Stop Loss,$34.50,$166.50,$157199.00,313,$166.50
2025-03-13,07:35:00,19488.25,SELL,3,0.02h,Stop Loss,$46.50,$213.00,$157245.50,313,$213.00
2025-03-13,07:40:00,19658.75,BUY,3,0.02h,Stop Loss,$46.50,$259.50,$157292.00,313,$259.50
2025-03-13,07:43:00,19460.0,SELL,3,0.02h,Stop Loss,$49.50,$309.00,$157341.50,313,$309.00
2025-03-13,07:48:00,19659.75,BUY,3,0.02h,Stop Loss,$-9.00,$300.00,$157332.50,313,$300.00
2025-03-13,07:49:00,19454.5,SELL,3,0.02h,Stop Loss,$-9.00,$291.00,$157323.50,313,$291.00
2025-03-13,07:53:00,19644.5,BUY,3,0.02h,Break Even,$-1.50,$289.50,$157322.00,313,$289.50
2025-03-13,07:58:00,19424.0,SELL,3,0.02h,Break Even,$-1.50,$288.00,$157320.50,313,$288.00
2025-03-13,08:02:00,19650.0,BUY,3,0.02h,Stop Loss,$49.50,$337.50,$157370.00,313,$337.50
2025-03-13,08:05:00,19461.75,SELL,3,0.02h,Stop Loss,$-9.00,$328.50,$157361.00,313,$328.50
2025-03-13,08:06:00,19655.75,BUY,3,0.02h,Stop Loss,$-9.00,$319.50,$157352.00,313,$319.50
2025-03-13,08:08:00,19431.5,SELL,3,0.02h,Break Even,$-1.50,$318.00,$157350.50,313,$318.00
2025-03-13,08:19:00,19636.75,BUY,3,0.02h,Stop Loss,$-9.00,$309.00,$157341.50,313,$309.00
2025-03-13,08:20:00,19419.75,SELL,3,0.02h,Stop Loss,$6.00,$315.00,$157347.50,313,$315.00
2025-03-13,08:33:00,19671.25,BUY,3,0.02h,Stop Loss,$-9.00,$306.00,$157338.50,313,$306.00
2025-03-13,08:34:00,19454.25,SELL,3,0.02h,Stop Loss,$-9.00,$297.00,$157329.50,313,$297.00
2025-03-13,08:35:00,19670.0,BUY,3,0.02h,Break Even,$-1.50,$295.50,$157328.00,313,$295.50
2025-03-13,08:41:00,19445.0,SELL,3,0.02h,Break Even,$-1.50,$294.00,$157326.50,313,$294.00
2025-03-13,08:43:00,19662.0,BUY,3,0.02h,Stop Loss,$19.50,$313.50,$157346.00,313,$313.50
2025-03-13,08:49:00,19474.25,SELL,3,0.02h,Stop Loss,$-9.00,$304.50,$157337.00,313,$304.50
2025-03-13,08:50:00,19689.5,BUY,3,0.02h,Break Even,$-1.50,$303.00,$157335.50,313,$303.00
2025-03-13,08:58:00,19484.0,SELL,3,0.02h,Stop Loss,$-9.00,$294.00,$157326.50,313,$294.00
2025-03-13,08:59:00,19700.0,BUY,3,0.02h,Stop Loss,$-9.00,$285.00,$157317.50,313,$285.00
2025-03-13,09:00:00,19492.5,SELL,3,0.02h,Stop Loss,$9.00,$294.00,$157326.50,313,$294.00
2025-03-13,09:02:00,19690.0,BUY,3,0.02h,Stop Loss,$-9.00,$285.00,$157317.50,313,$285.00
2025-03-13,09:03:00,19482.25,SELL,3,0.02h,Stop Loss,$-9.00,$276.00,$157308.50,313,$276.00
2025-03-13,09:04:00,19686.0,BUY,3,0.02h,Stop Loss,$-9.00,$267.00,$157299.50,313,$267.00
2025-03-13,09:05:00,19472.0,SELL,3,0.02h,Break Even,$-1.50,$265.50,$157298.00,313,$265.50
2025-03-13,09:08:00,19674.0,BUY,3,0.02h,Break Even,$-1.50,$264.00,$157296.50,313,$264.00
2025-03-13,09:34:00,19545.75,SELL,3,0.02h,Stop Loss,$-9.00,$255.00,$157287.50,313,$255.00
2025-03-13,09:35:00,19756.25,BUY,3,0.02h,Stop Loss,$-9.00,$246.00,$157278.50,313,$246.00
2025-03-13,09:36:00,19556.5,SELL,3,0.02h,Stop Loss,$-9.00,$237.00,$157269.50,313,$237.00
2025-03-13,09:37:00,19768.0,BUY,3,0.02h,Stop Loss,$-9.00,$228.00,$157260.50,313,$228.00
2025-03-13,09:38:00,19562.5,SELL,3,0.02h,Stop Loss,$-9.00,$219.00,$157251.50,313,$219.00
2025-03-13,09:39:00,19774.5,BUY,3,0.02h,Stop Loss,$24.00,$243.00,$157275.50,313,$243.00
2025-03-13,09:48:00,19592.0,SELL,3,0.02h,Stop Loss,$-9.00,$234.00,$157266.50,313,$234.00
2025-03-13,09:49:00,19798.5,BUY,3,0.02h,Stop Loss,$-9.00,$225.00,$157257.50,313,$225.00
2025-03-13,09:50:00,19584.25,SELL,3,0.02h,Stop Loss,$-9.00,$216.00,$157248.50,313,$216.00
2025-03-13,09:51:00,19798.0,BUY,3,0.02h,Stop Loss,$-9.00,$207.00,$157239.50,313,$207.00
2025-03-13,09:52:00,19589.0,SELL,3,0.02h,Stop Loss,$-9.00,$198.00,$157230.50,313,$198.00
2025-03-13,09:53:00,19793.75,BUY,3,0.02h,Stop Loss,$-9.00,$189.00,$157221.50,313,$189.00
2025-03-13,09:54:00,19584.25,SELL,3,0.02h,Stop Loss,$-9.00,$180.00,$157212.50,313,$180.00
2025-03-13,09:55:00,19792.25,BUY,3,0.02h,Stop Loss,$-9.00,$171.00,$157203.50,313,$171.00
2025-03-13,09:56:00,19587.75,SELL,3,0.02h,Break Even,$-1.50,$169.50,$157202.00,313,$169.50
2025-03-13,10:03:00,19818.0,BUY,3,0.02h,Stop Loss,$-9.00,$160.50,$157193.00,313,$160.50
2025-03-13,10:04:00,19600.0,SELL,3,0.02h,Stop Loss,$-9.00,$151.50,$157184.00,313,$151.50
2025-03-13,10:05:00,19810.0,BUY,3,0.02h,Stop Loss,$-9.00,$142.50,$157175.00,313,$142.50
2025-03-13,10:06:00,19601.5,SELL,3,0.02h,Stop Loss,$-9.00,$133.50,$157166.00,313,$133.50
2025-03-13,10:07:00,19804.5,BUY,3,0.02h,Break Even,$-1.50,$132.00,$157164.50,313,$132.00
2025-03-13,10:15:00,19613.25,SELL,3,0.02h,Stop Loss,$37.50,$169.50,$157202.00,313,$169.50
2025-03-13,10:19:00,19818.75,BUY,3,0.02h,Stop Loss,$-9.00,$160.50,$157193.00,313,$160.50
2025-03-13,10:39:00,19605.25,SELL,3,0.02h,Stop Loss,$-9.00,$151.50,$157184.00,313,$151.50
2025-03-13,10:40:00,19814.0,BUY,3,0.02h,Stop Loss,$-9.00,$142.50,$157175.00,313,$142.50
2025-03-13,10:41:00,19611.0,SELL,3,0.02h,Stop Loss,$-9.00,$133.50,$157166.00,313,$133.50
2025-03-13,10:43:00,19818.25,BUY,3,0.02h,Stop Loss,$-9.00,$124.50,$157157.00,313,$124.50
2025-03-13,10:44:00,19612.0,SELL,3,0.02h,Stop Loss,$-9.00,$115.50,$157148.00,313,$115.50
2025-03-13,10:46:00,19823.5,BUY,3,0.03h,Break Even,$-1.50,$114.00,$157146.50,313,$114.00
2025-03-13,10:48:00,19615.75,SELL,3,0.02h,Stop Loss,$15.00,$129.00,$157161.50,313,$129.00
2025-03-13,11:00:00,19784.0,BUY,3,0.02h,Stop Loss,$3.00,$132.00,$157164.50,313,$132.00
2025-03-13,11:04:00,19567.25,SELL,3,0.02h,Stop Loss,$10.50,$142.50,$157175.00,313,$142.50
2025-03-13,11:09:00,19761.75,BUY,3,0.02h,Break Even,$-1.50,$141.00,$157173.50,313,$141.00
2025-03-13,11:14:00,19561.75,SELL,3,0.02h,Break Even,$-1.50,$139.50,$157172.00,313,$139.50
2025-03-13,11:29:00,19736.0,BUY,3,0.02h,Stop Loss,$-9.00,$130.50,$157163.00,313,$130.50
2025-03-13,11:30:00,19541.0,SELL,3,0.02h,Stop Loss,$-9.00,$121.50,$157154.00,313,$121.50
2025-03-13,11:31:00,19760.5,BUY,3,0.02h,Stop Loss,$-9.00,$112.50,$157145.00,313,$112.50
2025-03-13,11:32:00,19551.25,SELL,3,0.02h,Stop Loss,$12.00,$124.50,$157157.00,313,$124.50
2025-03-13,11:35:00,19757.5,BUY,3,0.02h,Stop Loss,$-9.00,$115.50,$157148.00,313,$115.50
2025-03-13,11:36:00,19536.5,SELL,3,0.02h,Stop Loss,$63.00,$178.50,$157211.00,313,$178.50
2025-03-13,11:39:00,19726.75,BUY,3,0.02h,Stop Loss,$-9.00,$169.50,$157202.00,313,$169.50
2025-03-13,11:40:00,19516.5,SELL,3,0.02h,Stop Loss,$-9.00,$160.50,$157193.00,313,$160.50
2025-03-13,11:48:00,19705.25,BUY,3,0.02h,Stop Loss,$-9.00,$151.50,$157184.00,313,$151.50
2025-03-13,11:49:00,19505.25,SELL,3,0.02h,Stop Loss,$-9.00,$142.50,$157175.00,313,$142.50
2025-03-13,11:50:00,19723.25,BUY,3,0.02h,Stop Loss,$7.50,$150.00,$157182.50,313,$150.00
2025-03-13,11:52:00,19525.0,SELL,3,0.02h,Stop Loss,$-9.00,$141.00,$157173.50,313,$141.00
2025-03-13,11:53:00,19737.0,BUY,3,0.02h,Stop Loss,$-9.00,$132.00,$157164.50,313,$132.00
2025-03-13,11:54:00,19537.75,SELL,3,0.02h,Stop Loss,$7.50,$139.50,$157172.00,313,$139.50
2025-03-13,12:01:00,19741.5,BUY,3,0.02h,Stop Loss,$-9.00,$130.50,$157163.00,313,$130.50
2025-03-13,12:04:00,19510.25,SELL,3,0.02h,Stop Loss,$66.00,$196.50,$157229.00,313,$196.50
2025-03-13,12:10:00,19699.0,BUY,3,0.02h,Stop Loss,$21.00,$217.50,$157250.00,313,$217.50
2025-03-13,12:20:00,19492.25,SELL,3,0.02h,Stop Loss,$52.50,$270.00,$157302.50,313,$270.00
2025-03-13,12:28:00,19714.0,BUY,3,0.02h,Stop Loss,$-9.00,$261.00,$157293.50,313,$261.00
2025-03-13,12:29:00,19504.0,SELL,3,0.02h,Stop Loss,$-9.00,$252.00,$157284.50,313,$252.00
2025-03-13,12:33:00,19752.25,BUY,3,0.02h,Stop Loss,$-9.00,$243.00,$157275.50,313,$243.00
2025-03-13,12:34:00,19575.75,SELL,3,0.02h,Stop Loss,$-9.00,$234.00,$157266.50,313,$234.00
2025-03-13,12:35:00,19770.0,BUY,3,0.02h,Stop Loss,$-9.00,$225.00,$157257.50,313,$225.00
2025-03-13,12:50:00,19519.0,SELL,3,0.02h,Break Even,$-1.50,$223.50,$157256.00,313,$223.50
2025-03-13,12:53:00,19750.75,BUY,3,0.02h,Stop Loss,$30.00,$253.50,$157286.00,313,$253.50
2025-03-13,12:57:00,19535.25,SELL,3,0.02h,Stop Loss,$-9.00,$244.50,$157277.00,313,$244.50
2025-03-13,12:58:00,19755.75,BUY,3,0.02h,Stop Loss,$-9.00,$235.50,$157268.00,313,$235.50
2025-03-13,12:59:00,19546.0,SELL,3,0.02h,Stop Loss,$-9.00,$226.50,$157259.00,313,$226.50
2025-03-13,13:00:00,19762.5,BUY,3,0.02h,Stop Loss,$99.00,$325.50,$157358.00,313,$325.50
2025-03-13,13:03:00,19573.5,SELL,3,0.02h,Break Even,$-1.50,$324.00,$157356.50,313,$324.00
2025-03-13,13:08:00,19792.25,BUY,3,0.02h,Stop Loss,$-9.00,$315.00,$157347.50,313,$315.00
2025-03-13,13:10:00,19577.25,SELL,3,0.02h,Stop Loss,$-9.00,$306.00,$157338.50,313,$306.00
2025-03-13,13:11:00,19773.5,BUY,3,0.02h,Break Even,$-1.50,$304.50,$157337.00,313,$304.50
2025-03-13,13:17:00,19559.75,SELL,3,0.02h,Stop Loss,$33.00,$337.50,$157370.00,313,$337.50
2025-03-13,13:20:00,19777.0,BUY,3,0.02h,Stop Loss,$-9.00,$328.50,$157361.00,313,$328.50
2025-03-13,13:21:00,19555.5,SELL,3,0.02h,Break Even,$-1.50,$327.00,$157359.50,313,$327.00
2025-03-13,13:23:00,19781.5,BUY,3,0.02h,Stop Loss,$-9.00,$318.00,$157350.50,313,$318.00
2025-03-13,13:24:00,19577.5,SELL,3,0.02h,Stop Loss,$-9.00,$309.00,$157341.50,313,$309.00
2025-03-13,13:26:00,19794.0,BUY,3,0.02h,Break Even,$-1.50,$307.50,$157340.00,313,$307.50
2025-03-13,13:32:00,19553.75,SELL,3,0.02h,Stop Loss,$-9.00,$298.50,$157331.00,313,$298.50
2025-03-13,13:33:00,19760.0,BUY,3,0.02h,Stop Loss,$-9.00,$289.50,$157322.00,313,$289.50
2025-03-13,13:34:00,19520.0,SELL,3,0.02h,Stop Loss,$-9.00,$280.50,$157313.00,313,$280.50
2025-03-13,13:36:00,19754.5,BUY,3,0.02h,Stop Loss,$76.50,$357.00,$157389.50,313,$357.00
2025-03-13,13:40:00,19541.5,SELL,3,0.02h,Stop Loss,$-9.00,$348.00,$157380.50,313,$348.00
2025-03-13,13:41:00,19727.5,BUY,3,0.02h,Stop Loss,$-9.00,$339.00,$157371.50,313,$339.00
2025-03-13,13:42:00,19529.5,SELL,3,0.02h,Stop Loss,$-9.00,$330.00,$157362.50,313,$330.00
2025-03-13,14:20:00,19728.5,BUY,3,0.02h,Stop Loss,$-9.00,$321.00,$157353.50,313,$321.00
2025-03-13,14:37:00,19440.25,SELL,3,0.02h,Stop Loss,$-9.00,$312.00,$157344.50,313,$312.00
2025-03-13,14:41:00,19644.25,BUY,3,0.02h,Stop Loss,$-9.00,$303.00,$157335.50,313,$303.00
2025-03-13,14:42:00,19430.0,SELL,3,0.02h,Stop Loss,$-9.00,$294.00,$157326.50,313,$294.00
2025-03-13,14:54:00,19693.75,BUY,3,0.02h,Stop Loss,$-9.00,$285.00,$157317.50,313,$285.00
2025-03-13,14:56:00,19462.0,SELL,3,0.02h,Stop Loss,$180.00,$465.00,$157497.50,313,$465.00
2025-03-13,15:07:00,19644.25,BUY,3,0.02h,Stop Loss,$-9.00,$456.00,$157488.50,313,$456.00
2025-03-13,15:09:00,19393.25,SELL,3,0.02h,Stop Loss,$70.50,$526.50,$157559.00,313,$526.50
2025-03-13,15:16:00,19570.5,BUY,3,0.02h,Stop Loss,$-9.00,$517.50,$157550.00,313,$517.50
2025-03-13,15:17:00,19381.5,SELL,3,0.02h,Stop Loss,$-9.00,$508.50,$157541.00,313,$508.50
2025-03-13,15:18:00,19589.75,BUY,3,0.02h,Stop Loss,$3.00,$511.50,$157544.00,313,$511.50
2025-03-13,15:20:00,19392.75,SELL,3,0.02h,Stop Loss,$73.50,$585.00,$157617.50,313,$585.00
2025-03-13,15:23:00,19575.25,BUY,3,0.02h,Stop Loss,$66.00,$651.00,$157683.50,313,$651.00
2025-03-13,15:29:00,19365.75,SELL,3,0.02h,Stop Loss,$90.00,$741.00,$157773.50,313,$741.00
2025-03-13,15:47:00,19541.25,BUY,3,0.02h,Stop Loss,$102.00,$843.00,$157875.50,313,$843.00
2025-03-13,15:52:00,19326.0,SELL,3,0.02h,Stop Loss,$79.50,$922.50,$157955.00,313,$922.50
2025-03-13,15:56:00,19515.0,BUY,3,0.02h,Stop Loss,$-9.00,$913.50,$157946.00,313,$913.50
2025-03-13,15:57:00,19296.25,SELL,3,0.02h,Stop Loss,$-9.00,$904.50,$157937.00,313,$904.50
2025-03-13,15:58:00,19511.25,BUY,3,0.02h,Stop Loss,$16.50,$921.00,$157953.50,313,$921.00
2025-03-13,16:01:00,19298.25,SELL,3,0.02h,Stop Loss,$57.00,$978.00,$158010.50,313,$978.00
2025-03-13,16:10:00,19549.0,BUY,3,0.02h,Stop Loss,$-9.00,$969.00,$158001.50,313,$969.00
2025-03-13,16:13:00,19327.75,SELL,3,0.02h,Stop Loss,$58.50,$1027.50,$158060.00,313,$1027.50
2025-03-13,16:15:00,19512.75,BUY,3,0.02h,Stop Loss,$-9.00,$1018.50,$158051.00,313,$1018.50
2025-03-13,16:26:00,19297.75,SELL,3,0.02h,Stop Loss,$49.50,$1068.00,$158100.50,313,$1068.00
2025-03-13,16:31:00,19527.25,BUY,3,0.02h,Stop Loss,$100.50,$1168.50,$158201.00,313,$1168.50
2025-03-13,16:46:00,19305.75,SELL,3,0.02h,Stop Loss,$-9.00,$1159.50,$158192.00,313,$1159.50
2025-03-13,17:02:00,19469.5,BUY,3,0.02h,Stop Loss,$4.50,$1164.00,$158196.50,313,$1164.00
2025-03-13,17:04:00,19263.25,SELL,3,0.02h,Stop Loss,$-9.00,$1155.00,$158187.50,313,$1155.00
2025-03-13,17:10:00,19464.25,BUY,3,0.02h,Break Even,$-1.50,$1153.50,$158186.00,313,$1153.50
2025-03-13,17:13:00,19229.25,SELL,3,0.02h,Stop Loss,$12.00,$1165.50,$158198.00,313,$1165.50
2025-03-13,17:38:00,19400.0,BUY,3,0.02h,Stop Loss,$-9.00,$1156.50,$158189.00,313,$1156.50
2025-03-13,17:39:00,19195.25,SELL,3,0.02h,Stop Loss,$46.50,$1203.00,$158235.50,313,$1203.00
2025-03-13,17:41:00,19409.0,BUY,3,0.02h,Stop Loss,$-9.00,$1194.00,$158226.50,313,$1194.00
2025-03-13,17:42:00,19192.0,SELL,3,0.02h,Stop Loss,$7.50,$1201.50,$158234.00,313,$1201.50
2025-03-13,17:44:00,19397.0,BUY,3,0.02h,Stop Loss,$-9.00,$1192.50,$158225.00,313,$1192.50
2025-03-13,17:46:00,19180.25,SELL,3,0.02h,Stop Loss,$43.50,$1236.00,$158268.50,313,$1236.00
2025-03-13,17:50:00,19386.0,BUY,3,0.02h,Stop Loss,$-9.00,$1227.00,$158259.50,313,$1227.00
2025-03-13,17:51:00,19202.0,SELL,3,0.02h,Stop Loss,$-9.00,$1218.00,$158250.50,313,$1218.00
2025-03-13,17:52:00,19404.75,BUY,3,0.02h,Stop Loss,$126.00,$1344.00,$158376.50,313,$1344.00
2025-03-13,18:04:00,19252.0,SELL,3,0.02h,Stop Loss,$-9.00,$1335.00,$158367.50,313,$1335.00
2025-03-13,18:05:00,19456.0,BUY,3,0.02h,Stop Loss,$-9.00,$1326.00,$158358.50,313,$1326.00
2025-03-13,18:07:00,19246.0,SELL,3,0.02h,Break Even,$-1.50,$1324.50,$158357.00,313,$1324.50
2025-03-13,18:10:00,19466.75,BUY,3,0.02h,Stop Loss,$78.00,$1402.50,$158435.00,313,$1402.50
2025-03-13,18:19:00,19276.25,SELL,3,0.02h,Stop Loss,$-9.00,$1393.50,$158426.00,313,$1393.50
2025-03-13,18:20:00,19485.75,BUY,3,0.02h,Stop Loss,$-9.00,$1384.50,$158417.00,313,$1384.50
2025-03-13,18:22:00,19293.5,SELL,3,0.02h,Break Even,$-1.50,$1383.00,$158415.50,313,$1383.00
2025-03-13,18:25:00,19509.0,BUY,3,0.02h,Stop Loss,$-9.00,$1374.00,$158406.50,313,$1374.00
2025-03-13,18:44:00,19360.0,SELL,3,0.02h,Break Even,$-1.50,$1372.50,$158405.00,313,$1372.50
2025-03-13,18:46:00,19560.25,BUY,3,0.02h,Stop Loss,$37.50,$1410.00,$158442.50,313,$1410.00
2025-03-13,18:49:00,19375.0,SELL,3,0.02h,Stop Loss,$-9.00,$1401.00,$158433.50,313,$1401.00
2025-03-13,18:50:00,19573.0,BUY,3,0.02h,Stop Loss,$-9.00,$1392.00,$158424.50,313,$1392.00
2025-03-13,18:54:00,19317.25,SELL,3,0.02h,Stop Loss,$4.50,$1396.50,$158429.00,313,$1396.50
2025-03-13,19:06:00,19546.25,BUY,3,0.02h,Stop Loss,$-9.00,$1387.50,$158420.00,313,$1387.50
2025-03-13,19:07:00,19332.5,SELL,3,0.02h,Stop Loss,$81.00,$1468.50,$158501.00,313,$1468.50
2025-03-13,19:14:00,19519.5,BUY,3,0.02h,Stop Loss,$-9.00,$1459.50,$158492.00,313,$1459.50
2025-03-13,19:15:00,19317.0,SELL,3,0.02h,Stop Loss,$-9.00,$1450.50,$158483.00,313,$1450.50
2025-03-13,19:16:00,19523.5,BUY,3,0.02h,Stop Loss,$-9.00,$1441.50,$158474.00,313,$1441.50
2025-03-13,19:18:00,19322.75,SELL,3,0.02h,Stop Loss,$-9.00,$1432.50,$158465.00,313,$1432.50
2025-03-13,19:19:00,19516.5,BUY,3,0.02h,Stop Loss,$96.00,$1528.50,$158561.00,313,$1528.50
2025-03-13,19:22:00,19307.5,SELL,3,0.02h,Break Even,$-1.50,$1527.00,$158559.50,313,$1527.00
2025-03-13,19:24:00,19511.0,BUY,3,0.02h,Stop Loss,$-9.00,$1518.00,$158550.50,313,$1518.00
2025-03-13,19:25:00,19306.5,SELL,3,0.02h,Stop Loss,$145.50,$1663.50,$158696.00,313,$1663.50
2025-03-13,19:42:00,19428.5,BUY,3,0.02h,Stop Loss,$-9.00,$1654.50,$158687.00,313,$1654.50
2025-03-13,19:43:00,19212.0,SELL,3,0.02h,Stop Loss,$40.50,$1695.00,$158727.50,313,$1695.00
2025-03-13,19:48:00,19434.0,BUY,3,0.02h,Stop Loss,$-9.00,$1686.00,$158718.50,313,$1686.00
2025-03-13,19:49:00,19229.25,SELL,3,0.02h,Break Even,$-1.50,$1684.50,$158717.00,313,$1684.50
2025-03-13,19:51:00,19409.5,BUY,3,0.02h,Break Even,$-1.50,$1683.00,$158715.50,313,$1683.00
2025-03-13,20:25:00,19314.75,SELL,3,0.02h,Stop Loss,$-9.00,$1674.00,$158706.50,313,$1674.00
2025-03-13,20:30:00,19515.0,BUY,3,0.02h,Break Even,$-1.50,$1672.50,$158705.00,313,$1672.50
2025-03-13,20:34:00,19309.0,SELL,3,0.02h,Break Even,$-1.50,$1671.00,$158703.50,313,$1671.00
2025-03-13,20:55:00,19507.25,BUY,3,0.02h,Stop Loss,$-9.00,$1662.00,$158694.50,313,$1662.00
2025-03-13,20:58:00,19296.25,SELL,3,0.02h,Stop Loss,$-9.00,$1653.00,$158685.50,313,$1653.00
2025-03-13,20:59:00,19499.25,BUY,3,0.02h,Stop Loss,$-9.00,$1644.00,$158676.50,313,$1644.00
2025-03-13,23:26:00,19370.0,SELL,3,0.02h,Break Even,$-1.50,$1642.50,$158675.00,313,$1642.50
2025-03-13,23:31:00,19570.5,BUY,3,0.02h,Stop Loss,$10.50,$1653.00,$158685.50,313,$1653.00
2025-03-13,23:34:00,19373.5,SELL,3,0.02h,Stop Loss,$-9.00,$1644.00,$158676.50,313,$1644.00
2025-03-13,23:35:00,19577.5,BUY,3,0.02h,Stop Loss,$-9.00,$1635.00,$158667.50,313,$1635.00
2025-03-13,23:38:00,19360.75,SELL,3,0.02h,Stop Loss,$-9.00,$1626.00,$158658.50,313,$1626.00
2025-03-13,23:39:00,19558.5,BUY,3,0.02h,Stop Loss,$-9.00,$1617.00,$158649.50,313,$1617.00
2025-03-13,23:42:00,19359.25,SELL,3,0.02h,Stop Loss,$-9.00,$1608.00,$158640.50,313,$1608.00
2025-03-13,23:57:00,19576.75,BUY,3,0.02h,Stop Loss,$-9.00,$1599.00,$158631.50,313,$1599.00
,,,,,,,,,,,
2025-03-14,00:11:00,19366.75,SELL,3,0.02h,Stop Loss,$-9.00,$-9.00,$158622.50,314,$-9.00
2025-03-14,00:18:00,19581.25,BUY,3,0.02h,Stop Loss,$-9.00,$-18.00,$158613.50,314,$-18.00
2025-03-14,00:19:00,19374.75,SELL,3,0.02h,Stop Loss,$-9.00,$-27.00,$158604.50,314,$-27.00
2025-03-14,00:23:00,19594.25,BUY,3,0.02h,Stop Loss,$-9.00,$-36.00,$158595.50,314,$-36.00
2025-03-14,00:24:00,19386.0,SELL,3,0.02h,Break Even,$-1.50,$-37.50,$158594.00,314,$-37.50
2025-03-14,00:31:00,19588.5,BUY,3,0.02h,Stop Loss,$-9.00,$-46.50,$158585.00,314,$-46.50
2025-03-14,00:52:00,19417.25,SELL,3,0.02h,Break Even,$-1.50,$-48.00,$158583.50,314,$-48.00
2025-03-14,01:10:00,19605.0,BUY,3,0.02h,Stop Loss,$57.00,$9.00,$158640.50,314,$9.00
2025-03-14,01:21:00,19402.5,SELL,3,0.02h,Stop Loss,$-9.00,$0.00,$158631.50,314,$0.00
2025-03-14,01:23:00,19615.75,BUY,3,0.03h,Stop Loss,$9.00,$9.00,$158640.50,314,$9.00
2025-03-14,01:44:00,19424.5,SELL,3,0.02h,Stop Loss,$-9.00,$0.00,$158631.50,314,$0.00
2025-03-14,01:45:00,19628.0,BUY,3,0.02h,Break Even,$-1.50,$-1.50,$158630.00,314,$-1.50
2025-03-14,01:48:00,19417.75,SELL,3,0.02h,Stop Loss,$-9.00,$-10.50,$158621.00,314,$-10.50
2025-03-14,01:56:00,19623.5,BUY,3,0.02h,Stop Loss,$-9.00,$-19.50,$158612.00,314,$-19.50
2025-03-14,01:57:00,19412.0,SELL,3,0.02h,Stop Loss,$-9.00,$-28.50,$158603.00,314,$-28.50
2025-03-14,01:58:00,19611.75,BUY,3,0.02h,Stop Loss,$-9.00,$-37.50,$158594.00,314,$-37.50
2025-03-14,01:59:00,19405.25,SELL,3,0.02h,Stop Loss,$-9.00,$-46.50,$158585.00,314,$-46.50
2025-03-14,02:01:00,19616.5,BUY,3,0.02h,Stop Loss,$-9.00,$-55.50,$158576.00,314,$-55.50
2025-03-14,02:08:00,19407.0,SELL,3,0.02h,Stop Loss,$15.00,$-40.50,$158591.00,314,$-40.50
2025-03-14,02:16:00,19627.0,BUY,3,0.02h,Stop Loss,$-9.00,$-49.50,$158582.00,314,$-49.50
2025-03-14,02:18:00,19417.5,SELL,3,0.02h,Stop Loss,$-9.00,$-58.50,$158573.00,314,$-58.50
2025-03-14,02:19:00,19626.0,BUY,3,0.02h,Stop Loss,$-9.00,$-67.50,$158564.00,314,$-67.50
2025-03-14,02:20:00,19419.25,SELL,3,0.02h,Stop Loss,$-9.00,$-76.50,$158555.00,314,$-76.50
2025-03-14,02:22:00,19629.25,BUY,3,0.05h,Stop Loss,$7.50,$-69.00,$158562.50,314,$-69.00
2025-03-14,02:28:00,19423.5,SELL,3,0.02h,Stop Loss,$-9.00,$-78.00,$158553.50,314,$-78.00
2025-03-14,02:31:00,19633.0,BUY,3,0.02h,Stop Loss,$-9.00,$-87.00,$158544.50,314,$-87.00
2025-03-14,02:34:00,19422.75,SELL,3,0.02h,Stop Loss,$-9.00,$-96.00,$158535.50,314,$-96.00
2025-03-14,02:41:00,19623.25,BUY,3,0.02h,Break Even,$-1.50,$-97.50,$158534.00,314,$-97.50
2025-03-14,02:44:00,19419.25,SELL,3,0.02h,Stop Loss,$-9.00,$-106.50,$158525.00,314,$-106.50
2025-03-14,02:45:00,19622.0,BUY,3,0.02h,Stop Loss,$13.50,$-93.00,$158538.50,314,$-93.00
2025-03-14,02:47:00,19414.5,SELL,3,0.02h,Break Even,$-1.50,$-94.50,$158537.00,314,$-94.50
2025-03-14,02:52:00,19631.0,BUY,3,0.02h,Stop Loss,$-9.00,$-103.50,$158528.00,314,$-103.50
2025-03-14,02:53:00,19432.75,SELL,3,0.02h,Stop Loss,$-9.00,$-112.50,$158519.00,314,$-112.50
2025-03-14,02:54:00,19641.25,BUY,3,0.02h,Stop Loss,$-9.00,$-121.50,$158510.00,314,$-121.50
2025-03-14,02:56:00,19430.0,SELL,3,0.02h,Break Even,$-1.50,$-123.00,$158508.50,314,$-123.00
2025-03-14,02:58:00,19641.0,BUY,3,0.02h,Stop Loss,$-9.00,$-132.00,$158499.50,314,$-132.00
2025-03-14,02:59:00,19433.5,SELL,3,0.02h,Stop Loss,$-9.00,$-141.00,$158490.50,314,$-141.00
2025-03-14,03:00:00,19638.75,BUY,3,0.02h,Stop Loss,$-9.00,$-150.00,$158481.50,314,$-150.00
2025-03-14,03:01:00,19435.5,SELL,3,0.02h,Break Even,$-1.50,$-151.50,$158480.00,314,$-151.50
2025-03-14,03:04:00,19651.5,BUY,3,0.02h,Stop Loss,$-9.00,$-160.50,$158471.00,314,$-160.50
2025-03-14,03:05:00,19442.5,SELL,3,0.02h,Stop Loss,$-9.00,$-169.50,$158462.00,314,$-169.50
2025-03-14,03:08:00,19652.0,BUY,3,0.02h,Stop Loss,$-9.00,$-178.50,$158453.00,314,$-178.50
2025-03-14,03:09:00,19440.5,SELL,3,0.02h,Break Even,$-1.50,$-180.00,$158451.50,314,$-180.00
2025-03-14,03:11:00,19652.0,BUY,3,0.02h,Stop Loss,$-9.00,$-189.00,$158442.50,314,$-189.00
2025-03-14,03:14:00,19437.5,SELL,3,0.02h,Stop Loss,$-9.00,$-198.00,$158433.50,314,$-198.00
2025-03-14,03:15:00,19651.5,BUY,3,0.02h,Stop Loss,$-9.00,$-207.00,$158424.50,314,$-207.00
2025-03-14,03:19:00,19457.5,SELL,3,0.02h,Break Even,$-1.50,$-208.50,$158423.00,314,$-208.50
2025-03-14,03:21:00,19662.5,BUY,3,0.02h,Stop Loss,$-9.00,$-217.50,$158414.00,314,$-217.50
2025-03-14,03:25:00,19452.0,SELL,3,0.02h,Break Even,$-1.50,$-219.00,$158412.50,314,$-219.00
2025-03-14,03:29:00,19659.25,BUY,3,0.02h,Stop Loss,$-9.00,$-228.00,$158403.50,314,$-228.00
2025-03-14,03:32:00,19452.5,SELL,3,0.02h,Stop Loss,$-9.00,$-237.00,$158394.50,314,$-237.00
2025-03-14,03:34:00,19658.0,BUY,3,0.02h,Break Even,$-1.50,$-238.50,$158393.00,314,$-238.50
2025-03-14,03:51:00,19452.0,SELL,3,0.02h,Break Even,$-1.50,$-240.00,$158391.50,314,$-240.00
2025-03-14,04:09:00,19656.0,BUY,3,0.03h,Break Even,$-1.50,$-241.50,$158390.00,314,$-241.50
2025-03-14,04:12:00,19455.0,SELL,3,0.02h,Break Even,$-1.50,$-243.00,$158388.50,314,$-243.00
2025-03-14,04:14:00,19661.75,BUY,3,0.02h,Stop Loss,$-9.00,$-252.00,$158379.50,314,$-252.00
2025-03-14,04:15:00,19454.75,SELL,3,0.02h,Stop Loss,$-9.00,$-261.00,$158370.50,314,$-261.00
2025-03-14,04:16:00,19662.75,BUY,3,0.02h,Stop Loss,$-9.00,$-270.00,$158361.50,314,$-270.00
2025-03-14,04:18:00,19455.0,SELL,3,0.02h,Break Even,$-1.50,$-271.50,$158360.00,314,$-271.50
2025-03-14,04:23:00,19661.0,BUY,3,0.03h,Break Even,$-1.50,$-273.00,$158358.50,314,$-273.00
2025-03-14,04:26:00,19451.25,SELL,3,0.02h,Stop Loss,$28.50,$-244.50,$158387.00,314,$-244.50
2025-03-14,04:28:00,19650.0,BUY,3,0.02h,Stop Loss,$-9.00,$-253.50,$158378.00,314,$-253.50
2025-03-14,04:29:00,19440.75,SELL,3,0.02h,Break Even,$-1.50,$-255.00,$158376.50,314,$-255.00
2025-03-14,04:32:00,19651.25,BUY,3,0.02h,Stop Loss,$-9.00,$-264.00,$158367.50,314,$-264.00
2025-03-14,04:41:00,19439.75,SELL,3,0.02h,Stop Loss,$-9.00,$-273.00,$158358.50,314,$-273.00
2025-03-14,04:42:00,19649.5,BUY,3,0.02h,Stop Loss,$-9.00,$-282.00,$158349.50,314,$-282.00
2025-03-14,04:43:00,19444.25,SELL,3,0.02h,Stop Loss,$13.50,$-268.50,$158363.00,314,$-268.50
2025-03-14,04:49:00,19642.5,BUY,3,0.03h,Stop Loss,$-9.00,$-277.50,$158354.00,314,$-277.50
2025-03-14,04:51:00,19436.75,SELL,3,0.02h,Stop Loss,$-9.00,$-286.50,$158345.00,314,$-286.50
2025-03-14,04:52:00,19642.25,BUY,3,0.07h,Stop Loss,$13.50,$-273.00,$158358.50,314,$-273.00
2025-03-14,04:57:00,19437.25,SELL,3,0.02h,Stop Loss,$-9.00,$-282.00,$158349.50,314,$-282.00
2025-03-14,04:58:00,19646.75,BUY,3,0.02h,Stop Loss,$-9.00,$-291.00,$158340.50,314,$-291.00
2025-03-14,04:59:00,19440.5,SELL,3,0.02h,Stop Loss,$-9.00,$-300.00,$158331.50,314,$-300.00
2025-03-14,05:00:00,19648.75,BUY,3,0.02h,Stop Loss,$7.50,$-292.50,$158339.00,314,$-292.50
2025-03-14,05:05:00,19443.0,SELL,3,0.02h,Break Even,$-1.50,$-294.00,$158337.50,314,$-294.00
2025-03-14,05:16:00,19661.75,BUY,3,0.02h,Stop Loss,$-9.00,$-303.00,$158328.50,314,$-303.00
2025-03-14,05:22:00,19434.25,SELL,3,0.02h,Stop Loss,$24.00,$-279.00,$158352.50,314,$-279.00
2025-03-14,05:29:00,19640.75,BUY,3,0.02h,Stop Loss,$-9.00,$-288.00,$158343.50,314,$-288.00
2025-03-14,05:30:00,19426.5,SELL,3,0.02h,Stop Loss,$-9.00,$-297.00,$158334.50,314,$-297.00
2025-03-14,05:31:00,19630.0,BUY,3,0.02h,Stop Loss,$-9.00,$-306.00,$158325.50,314,$-306.00
2025-03-14,05:32:00,19421.25,SELL,3,0.02h,Break Even,$-1.50,$-307.50,$158324.00,314,$-307.50
2025-03-14,05:37:00,19624.5,BUY,3,0.02h,Stop Loss,$-9.00,$-316.50,$158315.00,314,$-316.50
2025-03-14,05:38:00,19417.25,SELL,3,0.02h,Stop Loss,$-9.00,$-325.50,$158306.00,314,$-325.50
2025-03-14,05:46:00,19623.5,BUY,3,0.02h,Stop Loss,$-9.00,$-334.50,$158297.00,314,$-334.50
2025-03-14,05:47:00,19415.75,SELL,3,0.02h,Break Even,$-1.50,$-336.00,$158295.50,314,$-336.00
2025-03-14,05:49:00,19627.25,BUY,3,0.02h,Stop Loss,$-9.00,$-345.00,$158286.50,314,$-345.00
2025-03-14,05:50:00,19418.75,SELL,3,0.02h,Stop Loss,$-9.00,$-354.00,$158277.50,314,$-354.00
2025-03-14,05:51:00,19625.5,BUY,3,0.02h,Stop Loss,$-9.00,$-363.00,$158268.50,314,$-363.00
2025-03-14,06:06:00,19402.5,SELL,3,0.02h,Stop Loss,$-9.00,$-372.00,$158259.50,314,$-372.00
2025-03-14,06:20:00,19611.0,BUY,3,0.02h,Stop Loss,$-9.00,$-381.00,$158250.50,314,$-381.00
2025-03-14,06:21:00,19405.75,SELL,3,0.02h,Break Even,$-1.50,$-382.50,$158249.00,314,$-382.50
2025-03-14,06:25:00,19609.5,BUY,3,0.02h,Stop Loss,$-9.00,$-391.50,$158240.00,314,$-391.50
2025-03-14,06:26:00,19404.5,SELL,3,0.02h,Stop Loss,$-9.00,$-400.50,$158231.00,314,$-400.50
2025-03-14,06:33:00,19598.0,BUY,3,0.02h,Break Even,$-1.50,$-402.00,$158229.50,314,$-402.00
2025-03-14,06:37:00,19395.5,SELL,3,0.02h,Stop Loss,$-9.00,$-411.00,$158220.50,314,$-411.00
2025-03-14,06:39:00,19611.75,BUY,3,0.02h,Stop Loss,$-9.00,$-420.00,$158211.50,314,$-420.00
2025-03-14,06:40:00,19408.75,SELL,3,0.02h,Stop Loss,$-9.00,$-429.00,$158202.50,314,$-429.00
2025-03-14,06:50:00,19614.75,BUY,3,0.02h,Stop Loss,$-9.00,$-438.00,$158193.50,314,$-438.00
2025-03-14,06:52:00,19405.25,SELL,3,0.02h,Stop Loss,$-9.00,$-447.00,$158184.50,314,$-447.00
2025-03-14,06:53:00,19615.25,BUY,3,0.03h,Break Even,$-1.50,$-448.50,$158183.00,314,$-448.50
2025-03-14,07:07:00,19389.75,SELL,3,0.02h,Stop Loss,$-9.00,$-457.50,$158174.00,314,$-457.50
2025-03-14,07:08:00,19585.0,BUY,3,0.02h,Stop Loss,$25.50,$-432.00,$158199.50,314,$-432.00
2025-03-14,07:13:00,19378.25,SELL,3,0.02h,Stop Loss,$-9.00,$-441.00,$158190.50,314,$-441.00
2025-03-14,07:16:00,19593.5,BUY,3,0.03h,Break Even,$-1.50,$-442.50,$158189.00,314,$-442.50
2025-03-14,07:20:00,19388.0,SELL,3,0.02h,Break Even,$-1.50,$-444.00,$158187.50,314,$-444.00
2025-03-14,07:25:00,19596.5,BUY,3,0.02h,Stop Loss,$25.50,$-418.50,$158213.00,314,$-418.50
2025-03-14,07:27:00,19397.5,SELL,3,0.02h,Stop Loss,$-9.00,$-427.50,$158204.00,314,$-427.50
2025-03-14,07:28:00,19600.0,BUY,3,0.02h,Stop Loss,$-9.00,$-436.50,$158195.00,314,$-436.50
2025-03-14,07:29:00,19390.25,SELL,3,0.02h,Stop Loss,$-9.00,$-445.50,$158186.00,314,$-445.50
2025-03-14,07:34:00,19579.0,BUY,3,0.02h,Break Even,$-1.50,$-447.00,$158184.50,314,$-447.00
2025-03-14,07:36:00,19381.75,SELL,3,0.02h,Break Even,$-1.50,$-448.50,$158183.00,314,$-448.50
2025-03-14,07:39:00,19590.25,BUY,3,0.02h,Stop Loss,$12.00,$-436.50,$158195.00,314,$-436.50
2025-03-14,07:41:00,19390.5,SELL,3,0.02h,Stop Loss,$4.50,$-432.00,$158199.50,314,$-432.00
2025-03-14,07:45:00,19617.0,BUY,3,0.02h,Stop Loss,$-9.00,$-441.00,$158190.50,314,$-441.00
2025-03-14,07:46:00,19412.5,SELL,3,0.02h,Stop Loss,$-9.00,$-450.00,$158181.50,314,$-450.00
2025-03-14,07:47:00,19626.5,BUY,3,0.03h,Break Even,$-1.50,$-451.50,$158180.00,314,$-451.50
2025-03-14,07:51:00,19402.5,SELL,3,0.02h,Stop Loss,$18.00,$-433.50,$158198.00,314,$-433.50
2025-03-14,07:54:00,19617.5,BUY,3,0.02h,Stop Loss,$-9.00,$-442.50,$158189.00,314,$-442.50
2025-03-14,07:55:00,19411.25,SELL,3,0.02h,Stop Loss,$37.50,$-405.00,$158226.50,314,$-405.00
2025-03-14,07:57:00,19611.75,BUY,3,0.02h,Stop Loss,$-9.00,$-414.00,$158217.50,314,$-414.00
2025-03-14,07:58:00,19401.5,SELL,3,0.02h,Stop Loss,$34.50,$-379.50,$158252.00,314,$-379.50
2025-03-14,08:02:00,19588.0,BUY,3,0.02h,Stop Loss,$51.00,$-328.50,$158303.00,314,$-328.50
2025-03-14,08:10:00,19400.75,SELL,3,0.02h,Break Even,$-1.50,$-330.00,$158301.50,314,$-330.00
2025-03-14,08:17:00,19629.0,BUY,3,0.02h,Stop Loss,$-9.00,$-339.00,$158292.50,314,$-339.00
2025-03-14,08:18:00,19424.25,SELL,3,0.02h,Stop Loss,$15.00,$-324.00,$158307.50,314,$-324.00
2025-03-14,08:22:00,19628.75,BUY,3,0.02h,Stop Loss,$39.00,$-285.00,$158346.50,314,$-285.00
2025-03-14,08:35:00,19425.75,SELL,3,0.02h,Stop Loss,$-9.00,$-294.00,$158337.50,314,$-294.00
2025-03-14,08:36:00,19630.5,BUY,3,0.02h,Stop Loss,$-9.00,$-303.00,$158328.50,314,$-303.00
2025-03-14,08:46:00,19433.5,SELL,3,0.02h,Stop Loss,$-9.00,$-312.00,$158319.50,314,$-312.00
2025-03-14,09:09:00,19651.5,BUY,3,0.02h,Break Even,$-1.50,$-313.50,$158318.00,314,$-313.50
2025-03-14,09:23:00,19452.5,SELL,3,0.02h,Stop Loss,$6.00,$-307.50,$158324.00,314,$-307.50
2025-03-14,09:25:00,19661.75,BUY,3,0.02h,Stop Loss,$-9.00,$-316.50,$158315.00,314,$-316.50
2025-03-14,09:26:00,19454.0,SELL,3,0.02h,Stop Loss,$-9.00,$-325.50,$158306.00,314,$-325.50
2025-03-14,09:27:00,19662.0,BUY,3,0.02h,Break Even,$-1.50,$-327.00,$158304.50,314,$-327.00
2025-03-14,09:42:00,19440.0,SELL,3,0.02h,Stop Loss,$16.50,$-310.50,$158321.00,314,$-310.50
2025-03-14,09:46:00,19644.0,BUY,3,0.02h,Stop Loss,$-9.00,$-319.50,$158312.00,314,$-319.50
2025-03-14,09:53:00,19448.25,SELL,3,0.02h,Stop Loss,$-9.00,$-328.50,$158303.00,314,$-328.50
2025-03-14,09:55:00,19649.0,BUY,3,0.02h,Stop Loss,$-9.00,$-337.50,$158294.00,314,$-337.50
2025-03-14,09:59:00,19439.0,SELL,3,0.02h,Stop Loss,$-9.00,$-346.50,$158285.00,314,$-346.50
2025-03-14,10:01:00,19648.5,BUY,3,0.02h,Stop Loss,$-9.00,$-355.50,$158276.00,314,$-355.50
2025-03-14,10:02:00,19437.25,SELL,3,0.02h,Stop Loss,$-9.00,$-364.50,$158267.00,314,$-364.50
2025-03-14,10:15:00,19631.5,BUY,3,0.02h,Break Even,$-1.50,$-366.00,$158265.50,314,$-366.00
2025-03-14,10:17:00,19423.25,SELL,3,0.02h,Stop Loss,$-9.00,$-375.00,$158256.50,314,$-375.00
2025-03-14,10:19:00,19637.75,BUY,3,0.02h,Stop Loss,$-9.00,$-384.00,$158247.50,314,$-384.00
2025-03-14,10:20:00,19428.75,SELL,3,0.02h,Stop Loss,$-9.00,$-393.00,$158238.50,314,$-393.00
2025-03-14,10:22:00,19633.5,BUY,3,0.02h,Stop Loss,$-9.00,$-402.00,$158229.50,314,$-402.00
2025-03-14,10:25:00,19421.0,SELL,3,0.02h,Stop Loss,$-9.00,$-411.00,$158220.50,314,$-411.00
2025-03-14,10:34:00,19615.5,BUY,3,0.02h,Break Even,$-1.50,$-412.50,$158219.00,314,$-412.50
2025-03-14,10:38:00,19407.75,SELL,3,0.02h,Stop Loss,$-9.00,$-421.50,$158210.00,314,$-421.50
2025-03-14,10:39:00,19611.75,BUY,3,0.02h,Stop Loss,$-9.00,$-430.50,$158201.00,314,$-430.50
2025-03-14,10:40:00,19419.75,SELL,3,0.02h,Stop Loss,$-9.00,$-439.50,$158192.00,314,$-439.50
2025-03-14,10:42:00,19627.5,BUY,3,0.02h,Break Even,$-1.50,$-441.00,$158190.50,314,$-441.00
2025-03-14,10:44:00,19414.75,SELL,3,0.02h,Stop Loss,$-9.00,$-450.00,$158181.50,314,$-450.00
2025-03-14,10:45:00,19627.5,BUY,3,0.02h,Stop Loss,$-9.00,$-459.00,$158172.50,314,$-459.00
2025-03-14,10:46:00,19431.75,SELL,3,0.02h,Stop Loss,$-9.00,$-468.00,$158163.50,314,$-468.00
2025-03-14,10:47:00,19646.25,BUY,3,0.02h,Break Even,$-1.50,$-469.50,$158162.00,314,$-469.50
2025-03-14,10:49:00,19440.5,SELL,3,0.02h,Break Even,$-1.50,$-471.00,$158160.50,314,$-471.00
2025-03-14,10:51:00,19665.25,BUY,3,0.02h,Stop Loss,$70.50,$-400.50,$158231.00,314,$-400.50
2025-03-14,10:56:00,19462.75,SELL,3,0.02h,Break Even,$-1.50,$-402.00,$158229.50,314,$-402.00
2025-03-14,11:01:00,19659.0,BUY,3,0.02h,Stop Loss,$-9.00,$-411.00,$158220.50,314,$-411.00
2025-03-14,11:08:00,19458.25,SELL,3,0.02h,Stop Loss,$-9.00,$-420.00,$158211.50,314,$-420.00
2025-03-14,11:09:00,19655.25,BUY,3,0.02h,Stop Loss,$-9.00,$-429.00,$158202.50,314,$-429.00
2025-03-14,11:10:00,19450.5,SELL,3,0.02h,Stop Loss,$4.50,$-424.50,$158207.00,314,$-424.50
2025-03-14,11:16:00,19648.5,BUY,3,0.02h,Stop Loss,$-9.00,$-433.50,$158198.00,314,$-433.50
2025-03-14,11:17:00,19437.0,SELL,3,0.02h,Stop Loss,$18.00,$-415.50,$158216.00,314,$-415.50
2025-03-14,11:21:00,19635.0,BUY,3,0.02h,Stop Loss,$-9.00,$-424.50,$158207.00,314,$-424.50
2025-03-14,11:22:00,19431.25,SELL,3,0.02h,Stop Loss,$-9.00,$-433.50,$158198.00,314,$-433.50
2025-03-14,11:23:00,19639.5,BUY,3,0.03h,Stop Loss,$19.50,$-414.00,$158217.50,314,$-414.00
2025-03-14,11:27:00,19436.25,SELL,3,0.02h,Stop Loss,$-9.00,$-423.00,$158208.50,314,$-423.00
2025-03-14,11:28:00,19645.0,BUY,3,0.02h,Stop Loss,$18.00,$-405.00,$158226.50,314,$-405.00
2025-03-14,11:35:00,19456.25,SELL,3,0.02h,Break Even,$-1.50,$-406.50,$158225.00,314,$-406.50
2025-03-14,11:37:00,19665.0,BUY,3,0.02h,Stop Loss,$-9.00,$-415.50,$158216.00,314,$-415.50
2025-03-14,11:39:00,19460.5,SELL,3,0.02h,Stop Loss,$-9.00,$-424.50,$158207.00,314,$-424.50
2025-03-14,11:41:00,19678.75,BUY,3,0.02h,Stop Loss,$-9.00,$-433.50,$158198.00,314,$-433.50
2025-03-14,11:51:00,19483.0,SELL,3,0.02h,Stop Loss,$37.50,$-396.00,$158235.50,314,$-396.00
2025-03-14,11:55:00,19676.25,BUY,3,0.03h,Break Even,$-1.50,$-397.50,$158234.00,314,$-397.50
2025-03-14,11:57:00,19474.25,SELL,3,0.02h,Break Even,$-1.50,$-399.00,$158232.50,314,$-399.00
2025-03-14,11:59:00,19686.0,BUY,3,0.02h,Stop Loss,$-9.00,$-408.00,$158223.50,314,$-408.00
2025-03-14,12:00:00,19472.25,SELL,3,0.02h,Stop Loss,$9.00,$-399.00,$158232.50,314,$-399.00
2025-03-14,12:05:00,19682.5,BUY,3,0.02h,Stop Loss,$-9.00,$-408.00,$158223.50,314,$-408.00
2025-03-14,12:06:00,19483.5,SELL,3,0.02h,Stop Loss,$-9.00,$-417.00,$158214.50,314,$-417.00
2025-03-14,12:08:00,19691.25,BUY,3,0.02h,Break Even,$-1.50,$-418.50,$158213.00,314,$-418.50
2025-03-14,12:17:00,19479.25,SELL,3,0.02h,Break Even,$-1.50,$-420.00,$158211.50,314,$-420.00
2025-03-14,12:19:00,19689.0,BUY,3,0.02h,Break Even,$-1.50,$-421.50,$158210.00,314,$-421.50
2025-03-14,12:21:00,19501.5,SELL,3,0.02h,Stop Loss,$-9.00,$-430.50,$158201.00,314,$-430.50
2025-03-14,12:22:00,19703.25,BUY,3,0.02h,Stop Loss,$-9.00,$-439.50,$158192.00,314,$-439.50
2025-03-14,12:23:00,19506.0,SELL,3,0.02h,Stop Loss,$-9.00,$-448.50,$158183.00,314,$-448.50
2025-03-14,12:24:00,19709.0,BUY,3,0.02h,Stop Loss,$10.50,$-438.00,$158193.50,314,$-438.00
2025-03-14,12:29:00,19514.75,SELL,3,0.02h,Break Even,$-1.50,$-439.50,$158192.00,314,$-439.50
2025-03-14,12:39:00,19717.5,BUY,3,0.02h,Stop Loss,$-9.00,$-448.50,$158183.00,314,$-448.50
2025-03-14,12:40:00,19502.75,SELL,3,0.02h,Stop Loss,$-9.00,$-457.50,$158174.00,314,$-457.50
2025-03-14,12:41:00,19707.0,BUY,3,0.02h,Stop Loss,$-9.00,$-466.50,$158165.00,314,$-466.50
2025-03-14,12:42:00,19503.5,SELL,3,0.02h,Stop Loss,$-9.00,$-475.50,$158156.00,314,$-475.50
2025-03-14,12:44:00,19699.75,BUY,3,0.02h,Stop Loss,$-9.00,$-484.50,$158147.00,314,$-484.50
2025-03-14,12:52:00,19502.5,SELL,3,0.02h,Break Even,$-1.50,$-486.00,$158145.50,314,$-486.00
2025-03-14,12:56:00,19704.75,BUY,3,0.02h,Stop Loss,$-9.00,$-495.00,$158136.50,314,$-495.00
2025-03-14,12:57:00,19499.0,SELL,3,0.02h,Stop Loss,$-9.00,$-504.00,$158127.50,314,$-504.00
2025-03-14,12:58:00,19694.75,BUY,3,0.02h,Stop Loss,$-9.00,$-513.00,$158118.50,314,$-513.00
2025-03-14,12:59:00,19494.0,SELL,3,0.02h,Break Even,$-1.50,$-514.50,$158117.00,314,$-514.50
2025-03-14,13:03:00,19692.0,BUY,3,0.02h,Stop Loss,$-9.00,$-523.50,$158108.00,314,$-523.50
2025-03-14,13:04:00,19497.25,SELL,3,0.02h,Stop Loss,$-9.00,$-532.50,$158099.00,314,$-532.50
2025-03-14,13:05:00,19710.0,BUY,3,0.02h,Stop Loss,$-9.00,$-541.50,$158090.00,314,$-541.50
2025-03-14,13:06:00,19504.75,SELL,3,0.02h,Stop Loss,$10.50,$-531.00,$158100.50,314,$-531.00
2025-03-14,13:08:00,19703.5,BUY,3,0.02h,Stop Loss,$4.50,$-526.50,$158105.00,314,$-526.50
2025-03-14,13:11:00,19490.5,SELL,3,0.02h,Stop Loss,$31.50,$-495.00,$158136.50,314,$-495.00
2025-03-14,13:16:00,19683.75,BUY,3,0.02h,Stop Loss,$-9.00,$-504.00,$158127.50,314,$-504.00
2025-03-14,13:32:00,19497.0,SELL,3,0.02h,Stop Loss,$-9.00,$-513.00,$158118.50,314,$-513.00
2025-03-14,13:33:00,19699.25,BUY,3,0.02h,Stop Loss,$277.50,$-235.50,$158396.00,314,$-235.50
2025-03-14,13:35:00,19537.5,SELL,3,0.02h,Stop Loss,$-9.00,$-244.50,$158387.00,314,$-244.50
2025-03-14,13:36:00,19772.5,BUY,3,0.02h,Stop Loss,$48.00,$-196.50,$158435.00,314,$-196.50
2025-03-14,13:43:00,19558.0,SELL,3,0.02h,Stop Loss,$-9.00,$-205.50,$158426.00,314,$-205.50
2025-03-14,13:44:00,19779.75,BUY,3,0.02h,Stop Loss,$22.50,$-183.00,$158448.50,314,$-183.00
2025-03-14,13:57:00,19584.5,SELL,3,0.02h,Stop Loss,$163.50,$-19.50,$158612.00,314,$-19.50
2025-03-14,14:22:00,19690.5,BUY,3,0.02h,Stop Loss,$-9.00,$-28.50,$158603.00,314,$-28.50
2025-03-14,14:23:00,19486.0,SELL,3,0.02h,Stop Loss,$-9.00,$-37.50,$158594.00,314,$-37.50
2025-03-14,14:24:00,19715.75,BUY,3,0.02h,Stop Loss,$55.50,$18.00,$158649.50,314,$18.00
2025-03-14,14:32:00,19501.25,SELL,3,0.02h,Stop Loss,$39.00,$57.00,$158688.50,314,$57.00
2025-03-14,14:39:00,19735.5,BUY,3,0.02h,Stop Loss,$-9.00,$48.00,$158679.50,314,$48.00
2025-03-14,15:02:00,19628.0,SELL,3,0.02h,Stop Loss,$21.00,$69.00,$158700.50,314,$69.00
2025-03-14,15:08:00,19835.25,BUY,3,0.02h,Stop Loss,$37.50,$106.50,$158738.00,314,$106.50
2025-03-14,15:14:00,19602.75,SELL,3,0.02h,Stop Loss,$-9.00,$97.50,$158729.00,314,$97.50
2025-03-14,15:15:00,19819.75,BUY,3,0.02h,Stop Loss,$-9.00,$88.50,$158720.00,314,$88.50
2025-03-14,15:34:00,19669.75,SELL,3,0.02h,Stop Loss,$33.00,$121.50,$158753.00,314,$121.50
2025-03-14,15:37:00,19870.0,BUY,3,0.02h,Stop Loss,$-9.00,$112.50,$158744.00,314,$112.50
2025-03-14,15:38:00,19671.25,SELL,3,0.02h,Stop Loss,$-9.00,$103.50,$158735.00,314,$103.50
2025-03-14,15:39:00,19875.75,BUY,3,0.02h,Stop Loss,$54.00,$157.50,$158789.00,314,$157.50
2025-03-14,15:46:00,19672.5,SELL,3,0.02h,Stop Loss,$21.00,$178.50,$158810.00,314,$178.50
2025-03-14,15:55:00,19879.5,BUY,3,0.02h,Stop Loss,$-9.00,$169.50,$158801.00,314,$169.50
2025-03-14,15:56:00,19672.25,SELL,3,0.02h,Stop Loss,$-9.00,$160.50,$158792.00,314,$160.50
2025-03-14,15:57:00,19873.75,BUY,3,0.02h,Stop Loss,$106.50,$267.00,$158898.50,314,$267.00
2025-03-14,16:00:00,19680.25,SELL,3,0.02h,Stop Loss,$21.00,$288.00,$158919.50,314,$288.00
2025-03-14,16:23:00,19840.0,BUY,3,0.02h,Stop Loss,$-9.00,$279.00,$158910.50,314,$279.00
2025-03-14,16:24:00,19652.5,SELL,3,0.02h,Stop Loss,$16.50,$295.50,$158927.00,314,$295.50
2025-03-14,16:26:00,19853.25,BUY,3,0.02h,Stop Loss,$-9.00,$286.50,$158918.00,314,$286.50
2025-03-14,16:28:00,19622.25,SELL,3,0.02h,Stop Loss,$-9.00,$277.50,$158909.00,314,$277.50
2025-03-14,16:29:00,19812.0,BUY,3,0.02h,Stop Loss,$-9.00,$268.50,$158900.00,314,$268.50
2025-03-14,16:30:00,19614.75,SELL,3,0.02h,Break Even,$-1.50,$267.00,$158898.50,314,$267.00
2025-03-14,16:33:00,19823.25,BUY,3,0.02h,Stop Loss,$42.00,$309.00,$158940.50,314,$309.00
2025-03-14,17:00:00,19687.25,SELL,3,0.02h,Stop Loss,$61.50,$370.50,$159002.00,314,$370.50
2025-03-14,17:11:00,19889.0,BUY,3,0.02h,Stop Loss,$-9.00,$361.50,$158993.00,314,$361.50
2025-03-14,17:13:00,19673.0,SELL,3,0.02h,Stop Loss,$-9.00,$352.50,$158984.00,314,$352.50
2025-03-14,17:14:00,19888.25,BUY,3,0.02h,Stop Loss,$-9.00,$343.50,$158975.00,314,$343.50
2025-03-14,17:18:00,19689.75,SELL,3,0.02h,Stop Loss,$40.50,$384.00,$159015.50,314,$384.00
2025-03-14,17:22:00,19891.75,BUY,3,0.02h,Stop Loss,$10.50,$394.50,$159026.00,314,$394.50
2025-03-14,17:26:00,19671.0,SELL,3,0.02h,Stop Loss,$90.00,$484.50,$159116.00,314,$484.50
2025-03-14,17:30:00,19858.75,BUY,3,0.02h,Stop Loss,$18.00,$502.50,$159134.00,314,$502.50
2025-03-14,17:32:00,19664.25,SELL,3,0.02h,Stop Loss,$51.00,$553.50,$159185.00,314,$553.50
2025-03-14,17:36:00,19862.25,BUY,3,0.02h,Break Even,$-1.50,$552.00,$159183.50,314,$552.00
2025-03-14,17:44:00,19637.5,SELL,3,0.02h,Stop Loss,$39.00,$591.00,$159222.50,314,$591.00
2025-03-14,17:52:00,19851.5,BUY,3,0.02h,Break Even,$-1.50,$589.50,$159221.00,314,$589.50
2025-03-14,17:54:00,19647.5,SELL,3,0.02h,Stop Loss,$-9.00,$580.50,$159212.00,314,$580.50
2025-03-14,17:55:00,19867.25,BUY,3,0.02h,Stop Loss,$-9.00,$571.50,$159203.00,314,$571.50
2025-03-14,17:56:00,19652.75,SELL,3,0.02h,Stop Loss,$-9.00,$562.50,$159194.00,314,$562.50
2025-03-14,17:57:00,19847.75,BUY,3,0.02h,Stop Loss,$-9.00,$553.50,$159185.00,314,$553.50
2025-03-14,17:58:00,19647.5,SELL,3,0.02h,Stop Loss,$-9.00,$544.50,$159176.00,314,$544.50
2025-03-14,17:59:00,19845.0,BUY,3,0.02h,Stop Loss,$-9.00,$535.50,$159167.00,314,$535.50
2025-03-14,18:00:00,19630.0,SELL,3,0.02h,Stop Loss,$-9.00,$526.50,$159158.00,314,$526.50
2025-03-14,18:07:00,19875.75,BUY,3,0.02h,Stop Loss,$-9.00,$517.50,$159149.00,314,$517.50
2025-03-14,18:08:00,19654.5,SELL,3,0.02h,Break Even,$-1.50,$516.00,$159147.50,314,$516.00
2025-03-14,18:17:00,19834.25,BUY,3,0.02h,Stop Loss,$72.00,$588.00,$159219.50,314,$588.00
2025-03-14,18:26:00,19624.0,SELL,3,0.02h,Stop Loss,$-9.00,$579.00,$159210.50,314,$579.00
2025-03-14,18:29:00,19845.0,BUY,3,0.02h,Stop Loss,$-9.00,$570.00,$159201.50,314,$570.00
2025-03-14,18:30:00,19632.0,SELL,3,0.02h,Stop Loss,$-9.00,$561.00,$159192.50,314,$561.00
2025-03-14,18:35:00,19870.75,BUY,3,0.02h,Stop Loss,$-9.00,$552.00,$159183.50,314,$552.00
2025-03-14,18:36:00,19658.5,SELL,3,0.02h,Stop Loss,$9.00,$561.00,$159192.50,314,$561.00
2025-03-14,18:38:00,19875.0,BUY,3,0.02h,Stop Loss,$-9.00,$552.00,$159183.50,314,$552.00
2025-03-14,18:39:00,19681.25,SELL,3,0.02h,Break Even,$-1.50,$550.50,$159182.00,314,$550.50
2025-03-14,18:42:00,19886.0,BUY,3,0.02h,Stop Loss,$-9.00,$541.50,$159173.00,314,$541.50
2025-03-14,18:48:00,19701.0,SELL,3,0.02h,Stop Loss,$39.00,$580.50,$159212.00,314,$580.50
2025-03-14,18:51:00,19898.25,BUY,3,0.02h,Stop Loss,$-9.00,$571.50,$159203.00,314,$571.50
2025-03-14,18:52:00,19678.0,SELL,3,0.02h,Stop Loss,$18.00,$589.50,$159221.00,314,$589.50
2025-03-14,18:55:00,19883.0,BUY,3,0.02h,Stop Loss,$-9.00,$580.50,$159212.00,314,$580.50
2025-03-14,19:02:00,19670.75,SELL,3,0.02h,Break Even,$-1.50,$579.00,$159210.50,314,$579.00
2025-03-14,19:06:00,19897.5,BUY,3,0.02h,Stop Loss,$43.50,$622.50,$159254.00,314,$622.50
2025-03-14,19:16:00,19699.0,SELL,3,0.02h,Stop Loss,$-9.00,$613.50,$159245.00,314,$613.50
2025-03-14,19:17:00,19912.0,BUY,3,0.02h,Break Even,$-1.50,$612.00,$159243.50,314,$612.00
2025-03-14,19:24:00,19679.5,SELL,3,0.02h,Stop Loss,$-9.00,$603.00,$159234.50,314,$603.00
2025-03-14,19:34:00,19885.25,BUY,3,0.02h,Break Even,$-1.50,$601.50,$159233.00,314,$601.50
2025-03-14,19:36:00,19674.25,SELL,3,0.02h,Stop Loss,$58.50,$660.00,$159291.50,314,$660.00
2025-03-14,19:41:00,19875.25,BUY,3,0.02h,Stop Loss,$-9.00,$651.00,$159282.50,314,$651.00
2025-03-14,19:42:00,19655.5,SELL,3,0.02h,Stop Loss,$-9.00,$642.00,$159273.50,314,$642.00
2025-03-14,19:43:00,19871.75,BUY,3,0.02h,Stop Loss,$22.50,$664.50,$159296.00,314,$664.50
2025-03-14,19:55:00,19731.0,SELL,3,0.02h,Stop Loss,$52.50,$717.00,$159348.50,314,$717.00
2025-03-14,19:57:00,19945.75,BUY,3,0.02h,Stop Loss,$-9.00,$708.00,$159339.50,314,$708.00
2025-03-14,19:58:00,19730.5,SELL,3,0.02h,Stop Loss,$-9.00,$699.00,$159330.50,314,$699.00
2025-03-14,19:59:00,19938.25,BUY,3,0.02h,Stop Loss,$-9.00,$690.00,$159321.50,314,$690.00
2025-03-14,20:01:00,19678.75,SELL,3,0.02h,Stop Loss,$15.00,$705.00,$159336.50,314,$705.00
2025-03-14,20:14:00,19869.0,BUY,3,0.02h,Break Even,$-1.50,$703.50,$159335.00,314,$703.50
2025-03-14,20:22:00,19647.75,SELL,3,0.02h,Stop Loss,$4.50,$708.00,$159339.50,314,$708.00
2025-03-14,20:26:00,19860.5,BUY,3,0.02h,Stop Loss,$4.50,$712.50,$159344.00,314,$712.50
2025-03-14,20:33:00,19660.25,SELL,3,0.02h,Stop Loss,$-9.00,$703.50,$159335.00,314,$703.50
2025-03-14,20:43:00,19870.75,BUY,3,0.05h,Stop Loss,$4.50,$708.00,$159339.50,314,$708.00
2025-03-14,20:48:00,19661.0,SELL,3,0.02h,Stop Loss,$-9.00,$699.00,$159330.50,314,$699.00
2025-03-14,20:49:00,19869.75,BUY,3,0.02h,Stop Loss,$18.00,$717.00,$159348.50,314,$717.00
2025-03-14,20:53:00,19663.5,SELL,3,0.02h,Stop Loss,$-9.00,$708.00,$159339.50,314,$708.00
2025-03-14,20:54:00,19874.0,BUY,3,0.02h,Stop Loss,$-9.00,$699.00,$159330.50,314,$699.00
,,,,,,,,,,,
2025-03-17,00:02:00,19790.75,SELL,3,0.02h,Stop Loss,$-9.00,$-9.00,$159321.50,315,$-9.00
2025-03-17,00:31:00,19795.0,BUY,3,0.02h,Stop Loss,$3.00,$-6.00,$159324.50,315,$-6.00
2025-03-17,01:06:00,19810.0,SELL,3,0.02h,Stop Loss,$-9.00,$-15.00,$159315.50,315,$-15.00
2025-03-17,01:10:00,19819.75,BUY,3,0.02h,Break Even,$-1.50,$-16.50,$159314.00,315,$-16.50
2025-03-17,01:13:00,19814.0,SELL,3,0.02h,Break Even,$-1.50,$-18.00,$159312.50,315,$-18.00
2025-03-17,01:20:00,19823.5,BUY,3,0.02h,Stop Loss,$57.00,$39.00,$159369.50,315,$39.00
2025-03-17,01:58:00,19821.25,SELL,3,0.02h,Stop Loss,$33.00,$72.00,$159402.50,315,$72.00
2025-03-17,02:21:00,19815.5,BUY,3,0.02h,Stop Loss,$-9.00,$63.00,$159393.50,315,$63.00
2025-03-17,02:46:00,19811.75,SELL,3,0.02h,Stop Loss,$-9.00,$54.00,$159384.50,315,$54.00
2025-03-17,02:57:00,19817.25,BUY,3,0.02h,Break Even,$-1.50,$52.50,$159383.00,315,$52.50
2025-03-17,03:01:00,19812.5,SELL,3,0.02h,Break Even,$-1.50,$51.00,$159381.50,315,$51.00
2025-03-17,03:16:00,19815.25,BUY,3,0.02h,Stop Loss,$-9.00,$42.00,$159372.50,315,$42.00
2025-03-17,03:22:00,19804.5,SELL,3,0.02h,Stop Loss,$-9.00,$33.00,$159363.50,315,$33.00
2025-03-17,03:47:00,19809.5,BUY,3,0.02h,Break Even,$-1.50,$31.50,$159362.00,315,$31.50
2025-03-17,03:55:00,19799.0,SELL,3,0.02h,Stop Loss,$-9.00,$22.50,$159353.00,315,$22.50
2025-03-17,04:08:00,19807.5,BUY,3,0.02h,Break Even,$-1.50,$21.00,$159351.50,315,$21.00
2025-03-17,04:29:00,19804.5,SELL,3,0.02h,Stop Loss,$3.00,$24.00,$159354.50,315,$24.00
2025-03-17,04:38:00,19813.5,BUY,3,0.02h,Stop Loss,$-9.00,$15.00,$159345.50,315,$15.00
2025-03-17,04:57:00,19802.75,SELL,3,0.02h,Stop Loss,$-9.00,$6.00,$159336.50,315,$6.00
2025-03-17,05:19:00,19805.25,BUY,3,0.02h,Break Even,$-1.50,$4.50,$159335.00,315,$4.50
2025-03-17,05:42:00,19802.25,SELL,3,0.02h,Break Even,$-1.50,$3.00,$159333.50,315,$3.00
2025-03-17,05:58:00,19804.5,BUY,3,0.02h,Stop Loss,$-9.00,$-6.00,$159324.50,315,$-6.00
2025-03-17,06:08:00,19800.5,SELL,3,0.02h,Round Number,$0.00,$-6.00,$159324.50,315,$-6.00
2025-03-17,06:46:00,19785.25,BUY,3,0.02h,Stop Loss,$-9.00,$-15.00,$159315.50,315,$-15.00
2025-03-17,07:02:00,19778.75,SELL,3,0.02h,Stop Loss,$-9.00,$-24.00,$159306.50,315,$-24.00
2025-03-17,07:27:00,19788.0,BUY,3,0.02h,Break Even,$-1.50,$-25.50,$159305.00,315,$-25.50
2025-03-17,07:37:00,19771.25,SELL,3,0.02h,Stop Loss,$4.50,$-21.00,$159309.50,315,$-21.00
2025-03-17,07:48:00,19783.75,BUY,3,0.02h,Stop Loss,$6.00,$-15.00,$159315.50,315,$-15.00
2025-03-17,09:11:00,19820.0,SELL,3,0.02h,Break Even,$-1.50,$-16.50,$159314.00,315,$-16.50
2025-03-17,09:28:00,19830.5,BUY,3,0.02h,Break Even,$-1.50,$-18.00,$159312.50,315,$-18.00
2025-03-17,10:04:00,19833.5,SELL,3,0.02h,Stop Loss,$-9.00,$-27.00,$159303.50,315,$-27.00
2025-03-17,10:05:00,19839.75,BUY,3,0.02h,Stop Loss,$13.50,$-13.50,$159317.00,315,$-13.50
2025-03-17,11:33:00,19898.75,SELL,3,0.02h,Break Even,$-1.50,$-15.00,$159315.50,315,$-15.00
2025-03-17,11:41:00,19917.5,BUY,3,0.02h,Stop Loss,$22.50,$7.50,$159338.00,315,$7.50
2025-03-17,11:46:00,19901.75,SELL,3,0.02h,Stop Loss,$-9.00,$-1.50,$159329.00,315,$-1.50
2025-03-17,12:24:00,19895.75,BUY,3,0.02h,Stop Loss,$-9.00,$-10.50,$159320.00,315,$-10.50
2025-03-17,12:28:00,19881.75,SELL,3,0.02h,Stop Loss,$-9.00,$-19.50,$159311.00,315,$-19.50
2025-03-17,12:31:00,19894.0,BUY,3,0.02h,Stop Loss,$61.50,$42.00,$159372.50,315,$42.00
2025-03-17,13:02:00,19939.0,SELL,3,0.02h,Break Even,$-1.50,$40.50,$159371.00,315,$40.50
2025-03-17,13:34:00,19962.25,BUY,3,0.02h,Stop Loss,$15.00,$55.50,$159386.00,315,$55.50
2025-03-17,14:02:00,19956.25,SELL,3,0.02h,Stop Loss,$49.50,$105.00,$159435.50,315,$105.00
2025-03-17,14:14:00,20010.5,BUY,3,0.02h,Stop Loss,$61.50,$166.50,$159497.00,315,$166.50
2025-03-17,14:27:00,19966.75,SELL,3,0.02h,Stop Loss,$85.50,$252.00,$159582.50,315,$252.00
2025-03-17,14:49:00,19955.0,BUY,3,0.02h,Stop Loss,$19.50,$271.50,$159602.00,315,$271.50
2025-03-17,14:52:00,19932.5,SELL,3,0.02h,Stop Loss,$37.50,$309.00,$159639.50,315,$309.00
2025-03-17,15:18:00,19923.75,BUY,3,0.02h,Stop Loss,$24.00,$333.00,$159663.50,315,$333.00
2025-03-17,15:30:00,19885.75,SELL,3,0.02h,Stop Loss,$24.00,$357.00,$159687.50,315,$357.00
2025-03-17,15:52:00,19894.25,BUY,3,0.02h,Stop Loss,$9.00,$366.00,$159696.50,315,$366.00
2025-03-17,16:02:00,19867.0,SELL,3,0.02h,Stop Loss,$16.50,$382.50,$159713.00,315,$382.50
2025-03-17,16:05:00,19896.75,BUY,3,0.02h,Stop Loss,$30.00,$412.50,$159743.00,315,$412.50
2025-03-17,16:23:00,19894.0,SELL,3,0.02h,Stop Loss,$81.00,$493.50,$159824.00,315,$493.50
2025-03-17,16:39:00,19905.75,BUY,3,0.02h,Break Even,$-1.50,$492.00,$159822.50,315,$492.00
2025-03-17,16:42:00,19871.25,SELL,3,0.02h,Stop Loss,$31.50,$523.50,$159854.00,315,$523.50
2025-03-17,16:52:00,19906.25,BUY,3,0.02h,Stop Loss,$33.00,$556.50,$159887.00,315,$556.50
2025-03-17,17:04:00,19883.75,SELL,3,0.02h,Break Even,$-1.50,$555.00,$159885.50,315,$555.00
2025-03-17,17:07:00,19910.0,BUY,3,0.02h,Stop Loss,$61.50,$616.50,$159947.00,315,$616.50
2025-03-17,19:03:00,20131.75,SELL,3,0.02h,Stop Loss,$15.00,$631.50,$159962.00,315,$631.50
2025-03-17,20:29:00,20036.0,BUY,3,0.02h,Stop Loss,$12.00,$643.50,$159974.00,315,$643.50
2025-03-17,20:49:00,20032.75,SELL,3,0.02h,Stop Loss,$-9.00,$634.50,$159965.00,315,$634.50
2025-03-17,20:52:00,20037.5,BUY,3,0.03h,Break Even,$-1.50,$633.00,$159963.50,315,$633.00
2025-03-17,23:15:00,20029.25,SELL,3,0.02h,Stop Loss,$-9.00,$624.00,$159954.50,315,$624.00
2025-03-17,23:47:00,20039.0,BUY,3,0.02h,Break Even,$-1.50,$622.50,$159953.00,315,$622.50
2025-03-17,23:51:00,20030.75,SELL,3,0.02h,Stop Loss,$-9.00,$613.50,$159944.00,315,$613.50
,,,,,,,,,,,
2025-03-18,00:51:00,20006.25,BUY,3,0.02h,Stop Loss,$-9.00,$-9.00,$159935.00,316,$-9.00
2025-03-18,00:52:00,20002.0,SELL,3,0.02h,Break Even,$-1.50,$-10.50,$159933.50,316,$-10.50
2025-03-18,00:57:00,20005.75,BUY,3,0.02h,Stop Loss,$-9.00,$-19.50,$159924.50,316,$-19.50
2025-03-18,00:58:00,20003.75,SELL,3,0.02h,Stop Loss,$18.00,$-1.50,$159942.50,316,$-1.50
2025-03-18,01:08:00,20006.75,BUY,3,0.02h,Stop Loss,$19.50,$18.00,$159962.00,316,$18.00
2025-03-18,01:17:00,19989.0,SELL,3,0.02h,Break Even,$-1.50,$16.50,$159960.50,316,$16.50
2025-03-18,02:08:00,19969.75,BUY,3,0.02h,Break Even,$-1.50,$15.00,$159959.00,316,$15.00
2025-03-18,02:12:00,19961.75,SELL,3,0.02h,Break Even,$-1.50,$13.50,$159957.50,316,$13.50
2025-03-18,02:15:00,19968.0,BUY,3,0.02h,Break Even,$-1.50,$12.00,$159956.00,316,$12.00
2025-03-18,02:23:00,19964.5,SELL,3,0.02h,Stop Loss,$-9.00,$3.00,$159947.00,316,$3.00
2025-03-18,02:24:00,19972.5,BUY,3,0.02h,Stop Loss,$-9.00,$-6.00,$159938.00,316,$-6.00
2025-03-18,02:32:00,19965.25,SELL,3,0.03h,Stop Loss,$-9.00,$-15.00,$159929.00,316,$-15.00
2025-03-18,02:34:00,19970.25,BUY,3,0.02h,Break Even,$-1.50,$-16.50,$159927.50,316,$-16.50
2025-03-18,03:00:00,19970.75,SELL,3,0.02h,Break Even,$-1.50,$-18.00,$159926.00,316,$-18.00
2025-03-18,03:03:00,19972.75,BUY,3,0.02h,Stop Loss,$-9.00,$-27.00,$159917.00,316,$-27.00
2025-03-18,03:04:00,19969.0,SELL,3,0.02h,Stop Loss,$-9.00,$-36.00,$159908.00,316,$-36.00
2025-03-18,04:08:00,19949.25,BUY,3,0.02h,Stop Loss,$-9.00,$-45.00,$159899.00,316,$-45.00
2025-03-18,04:27:00,19945.5,SELL,3,0.02h,Stop Loss,$-9.00,$-54.00,$159890.00,316,$-54.00
2025-03-18,05:04:00,19938.5,BUY,3,0.02h,Stop Loss,$-9.00,$-63.00,$159881.00,316,$-63.00
2025-03-18,05:24:00,19935.75,SELL,3,0.03h,Stop Loss,$-9.00,$-72.00,$159872.00,316,$-72.00
2025-03-18,05:46:00,19944.0,BUY,3,0.02h,Break Even,$-1.50,$-73.50,$159870.50,316,$-73.50
2025-03-18,07:04:00,19968.75,SELL,3,0.02h,Break Even,$-1.50,$-75.00,$159869.00,316,$-75.00
2025-03-18,07:08:00,19975.5,BUY,3,0.02h,Break Even,$-1.50,$-76.50,$159867.50,316,$-76.50
2025-03-18,07:14:00,19965.25,SELL,3,0.02h,Break Even,$-1.50,$-78.00,$159866.00,316,$-78.00
2025-03-18,07:27:00,19982.5,BUY,3,0.02h,Stop Loss,$4.50,$-73.50,$159870.50,316,$-73.50
2025-03-18,07:49:00,19975.5,SELL,3,0.02h,Stop Loss,$-9.00,$-82.50,$159861.50,316,$-82.50
2025-03-18,07:58:00,19984.25,BUY,3,0.02h,Stop Loss,$-9.00,$-91.50,$159852.50,316,$-91.50
2025-03-18,08:02:00,19975.5,SELL,3,0.02h,Break Even,$-1.50,$-93.00,$159851.00,316,$-93.00
2025-03-18,08:07:00,19984.75,BUY,3,0.02h,Stop Loss,$21.00,$-72.00,$159872.00,316,$-72.00
2025-03-18,08:47:00,20011.75,SELL,3,0.02h,Stop Loss,$7.50,$-64.50,$159879.50,316,$-64.50
2025-03-18,09:01:00,20028.0,BUY,3,0.02h,Break Even,$-1.50,$-66.00,$159878.00,316,$-66.00
2025-03-18,09:27:00,20021.75,SELL,3,0.02h,Break Even,$-1.50,$-67.50,$159876.50,316,$-67.50
2025-03-18,10:28:00,19971.5,BUY,3,0.02h,Break Even,$-1.50,$-69.00,$159875.00,316,$-69.00
2025-03-18,10:32:00,19949.25,SELL,3,0.02h,Stop Loss,$15.00,$-54.00,$159890.00,316,$-54.00
2025-03-18,10:41:00,19967.0,BUY,3,0.02h,Break Even,$-1.50,$-55.50,$159888.50,316,$-55.50
2025-03-18,11:26:00,19972.0,SELL,3,0.02h,Stop Loss,$18.00,$-37.50,$159906.50,316,$-37.50
2025-03-18,11:50:00,19963.25,BUY,3,0.02h,Stop Loss,$6.00,$-31.50,$159912.50,316,$-31.50
2025-03-18,12:04:00,19949.0,SELL,3,0.02h,Break Even,$-1.50,$-33.00,$159911.00,316,$-33.00
2025-03-18,12:27:00,19956.0,BUY,3,0.02h,Stop Loss,$6.00,$-27.00,$159917.00,316,$-27.00
2025-03-18,12:40:00,19944.75,SELL,3,0.02h,Stop Loss,$6.00,$-21.00,$159923.00,316,$-21.00
2025-03-18,14:26:00,19697.25,BUY,3,0.02h,Break Even,$-1.50,$-22.50,$159921.50,316,$-22.50
2025-03-18,14:47:00,19671.75,SELL,3,0.02h,Stop Loss,$-9.00,$-31.50,$159912.50,316,$-31.50
2025-03-18,15:19:00,19669.25,BUY,3,0.02h,Stop Loss,$16.50,$-15.00,$159929.00,316,$-15.00
2025-03-18,15:48:00,19667.75,SELL,3,0.02h,Stop Loss,$16.50,$1.50,$159945.50,316,$1.50
2025-03-18,16:04:00,19685.25,BUY,3,0.02h,Stop Loss,$24.00,$25.50,$159969.50,316,$25.50
2025-03-18,16:44:00,19701.75,SELL,3,0.02h,Stop Loss,$82.50,$108.00,$160052.00,316,$108.00
2025-03-18,17:00:00,19732.25,BUY,3,0.02h,Break Even,$-1.50,$106.50,$160050.50,316,$106.50
2025-03-18,17:21:00,19690.75,SELL,3,0.02h,Stop Loss,$4.50,$111.00,$160055.00,316,$111.00
2025-03-18,17:39:00,19726.75,BUY,3,0.02h,Stop Loss,$34.50,$145.50,$160089.50,316,$145.50
2025-03-18,17:58:00,19697.0,SELL,3,0.02h,Break Even,$-1.50,$144.00,$160088.00,316,$144.00
2025-03-18,18:23:00,19708.25,BUY,3,0.02h,Stop Loss,$85.50,$229.50,$160173.50,316,$229.50
2025-03-18,19:07:00,19719.0,SELL,3,0.02h,Stop Loss,$28.50,$258.00,$160202.00,316,$258.00
2025-03-18,19:21:00,19746.0,BUY,3,0.02h,Break Even,$-1.50,$256.50,$160200.50,316,$256.50
2025-03-18,19:25:00,19726.25,SELL,3,0.02h,Stop Loss,$138.00,$394.50,$160338.50,316,$394.50
2025-03-18,20:00:00,19704.25,BUY,3,0.02h,Stop Loss,$172.50,$567.00,$160511.00,316,$567.00
2025-03-18,20:22:00,19706.0,SELL,3,0.02h,Stop Loss,$-9.00,$558.00,$160502.00,316,$558.00
2025-03-18,20:37:00,19715.5,BUY,3,0.02h,Break Even,$-1.50,$556.50,$160500.50,316,$556.50
2025-03-18,20:41:00,19712.25,SELL,3,0.02h,Break Even,$-1.50,$555.00,$160499.00,316,$555.00
2025-03-18,20:48:00,19714.5,BUY,3,0.02h,Stop Loss,$-9.00,$546.00,$160490.00,316,$546.00
2025-03-18,20:49:00,19712.25,SELL,3,0.02h,Stop Loss,$-9.00,$537.00,$160481.00,316,$537.00
2025-03-18,23:03:00,19716.75,BUY,3,0.02h,Break Even,$-1.50,$535.50,$160479.50,316,$535.50
2025-03-18,23:16:00,19698.75,SELL,3,0.02h,Stop Loss,$16.50,$552.00,$160496.00,316,$552.00
2025-03-18,23:35:00,19708.25,BUY,3,0.02h,Break Even,$-1.50,$550.50,$160494.50,316,$550.50
,,,,,,,,,,,
2025-03-19,01:05:00,19775.75,SELL,3,0.02h,Break Even,$-1.50,$-1.50,$160493.00,317,$-1.50
2025-03-19,01:12:00,19778.5,BUY,3,0.02h,Break Even,$-1.50,$-3.00,$160491.50,317,$-3.00
2025-03-19,01:17:00,19770.5,SELL,3,0.02h,Stop Loss,$9.00,$6.00,$160500.50,317,$6.00
2025-03-19,01:29:00,19776.5,BUY,3,0.02h,Break Even,$-1.50,$4.50,$160499.00,317,$4.50
2025-03-19,01:30:00,19773.0,SELL,3,0.02h,Break Even,$-1.50,$3.00,$160497.50,317,$3.00
2025-03-19,01:41:00,19774.5,BUY,3,0.02h,Stop Loss,$12.00,$15.00,$160509.50,317,$15.00
2025-03-19,01:49:00,19765.25,SELL,3,0.02h,Break Even,$-1.50,$13.50,$160508.00,317,$13.50
2025-03-19,02:11:00,19774.0,BUY,3,0.02h,Break Even,$-1.50,$12.00,$160506.50,317,$12.00
2025-03-19,02:32:00,19769.5,SELL,3,0.02h,Stop Loss,$-9.00,$3.00,$160497.50,317,$3.00
2025-03-19,02:35:00,19777.75,BUY,3,0.02h,Break Even,$-1.50,$1.50,$160496.00,317,$1.50
2025-03-19,02:46:00,19769.75,SELL,3,0.02h,Stop Loss,$-9.00,$-7.50,$160487.00,317,$-7.50
2025-03-19,03:09:00,19769.5,BUY,3,0.02h,Break Even,$-1.50,$-9.00,$160485.50,317,$-9.00
2025-03-19,03:24:00,19765.0,SELL,3,0.02h,Stop Loss,$-9.00,$-18.00,$160476.50,317,$-18.00
2025-03-19,03:56:00,19764.25,BUY,3,0.02h,Stop Loss,$-9.00,$-27.00,$160467.50,317,$-27.00
2025-03-19,03:57:00,19757.5,SELL,3,0.02h,Stop Loss,$-9.00,$-36.00,$160458.50,317,$-36.00
2025-03-19,04:00:00,19763.0,BUY,3,0.02h,Break Even,$-1.50,$-37.50,$160457.00,317,$-37.50
2025-03-19,04:03:00,19758.25,SELL,3,0.02h,Stop Loss,$-9.00,$-46.50,$160448.00,317,$-46.50
2025-03-19,05:25:00,19738.5,BUY,3,0.02h,Break Even,$-1.50,$-48.00,$160446.50,317,$-48.00
2025-03-19,05:50:00,19738.5,SELL,3,0.02h,Stop Loss,$-9.00,$-57.00,$160437.50,317,$-57.00
2025-03-19,06:36:00,19742.0,BUY,3,0.02h,Break Even,$-1.50,$-58.50,$160436.00,317,$-58.50
2025-03-19,06:52:00,19730.0,SELL,3,0.02h,Break Even,$-1.50,$-60.00,$160434.50,317,$-60.00
2025-03-19,06:55:00,19737.0,BUY,3,0.02h,Break Even,$-1.50,$-61.50,$160433.00,317,$-61.50
2025-03-19,07:02:00,19722.5,SELL,3,0.02h,Stop Loss,$24.00,$-37.50,$160457.00,317,$-37.50
2025-03-19,07:26:00,19722.5,BUY,3,0.02h,Stop Loss,$3.00,$-34.50,$160460.00,317,$-34.50
2025-03-19,07:36:00,19711.5,SELL,3,0.02h,Stop Loss,$51.00,$16.50,$160511.00,317,$16.50
2025-03-19,08:03:00,19696.0,BUY,3,0.02h,Stop Loss,$3.00,$19.50,$160514.00,317,$19.50
2025-03-19,08:57:00,19721.75,SELL,3,0.02h,Stop Loss,$-9.00,$10.50,$160505.00,317,$10.50
2025-03-19,09:10:00,19732.25,BUY,3,0.02h,Stop Loss,$-9.00,$1.50,$160496.00,317,$1.50
2025-03-19,09:13:00,19715.5,SELL,3,0.02h,Stop Loss,$15.00,$16.50,$160511.00,317,$16.50
2025-03-19,09:25:00,19729.75,BUY,3,0.02h,Stop Loss,$24.00,$40.50,$160535.00,317,$40.50
2025-03-19,10:25:00,19765.25,SELL,3,0.02h,Stop Loss,$30.00,$70.50,$160565.00,317,$70.50
2025-03-19,10:30:00,19771.75,BUY,3,0.02h,Break Even,$-1.50,$69.00,$160563.50,317,$69.00
2025-03-19,10:41:00,19762.5,SELL,3,0.02h,Stop Loss,$9.00,$78.00,$160572.50,317,$78.00
2025-03-19,11:07:00,19763.5,BUY,3,0.02h,Stop Loss,$-9.00,$69.00,$160563.50,317,$69.00
2025-03-19,11:57:00,19756.0,SELL,3,0.02h,Stop Loss,$25.50,$94.50,$160589.00,317,$94.50
2025-03-19,12:17:00,19781.0,BUY,3,0.02h,Stop Loss,$-9.00,$85.50,$160580.00,317,$85.50
2025-03-19,12:20:00,19764.25,SELL,3,0.02h,Stop Loss,$16.50,$102.00,$160596.50,317,$102.00
2025-03-19,12:47:00,19768.25,BUY,3,0.02h,Break Even,$-1.50,$100.50,$160595.00,317,$100.50
2025-03-19,12:58:00,19751.5,SELL,3,0.02h,Stop Loss,$-9.00,$91.50,$160586.00,317,$91.50
2025-03-19,13:01:00,19763.5,BUY,3,0.02h,Stop Loss,$-9.00,$82.50,$160577.00,317,$82.50
2025-03-19,13:05:00,19756.5,SELL,3,0.02h,Break Even,$-1.50,$81.00,$160575.50,317,$81.00
2025-03-19,13:07:00,19768.5,BUY,3,0.02h,Stop Loss,$-9.00,$72.00,$160566.50,317,$72.00
2025-03-19,13:12:00,19748.5,SELL,3,0.02h,Break Even,$-1.50,$70.50,$160565.00,317,$70.50
2025-03-19,13:28:00,19774.25,BUY,3,0.02h,Stop Loss,$84.00,$154.50,$160649.00,317,$154.50
2025-03-19,13:42:00,19747.0,SELL,3,0.02h,Stop Loss,$175.50,$330.00,$160824.50,317,$330.00
2025-03-19,13:49:00,19777.75,BUY,3,0.02h,Stop Loss,$27.00,$357.00,$160851.50,317,$357.00
2025-03-19,14:30:00,19848.0,SELL,3,0.02h,Stop Loss,$49.50,$406.50,$160901.00,317,$406.50
2025-03-19,15:08:00,19845.75,BUY,3,0.02h,Stop Loss,$12.00,$418.50,$160913.00,317,$418.50
2025-03-19,16:13:00,19900.0,SELL,3,0.02h,Stop Loss,$22.50,$441.00,$160935.50,317,$441.00
2025-03-19,17:40:00,19839.0,BUY,3,0.02h,Stop Loss,$3.00,$444.00,$160938.50,317,$444.00
2025-03-19,17:47:00,19805.25,SELL,3,0.02h,Stop Loss,$31.50,$475.50,$160970.00,317,$475.50
2025-03-19,18:01:00,19886.5,BUY,3,0.02h,Stop Loss,$48.00,$523.50,$161018.00,317,$523.50
2025-03-19,19:23:00,20023.0,SELL,3,0.02h,Stop Loss,$130.50,$654.00,$161148.50,317,$654.00
2025-03-19,19:42:00,20037.25,BUY,3,0.02h,Stop Loss,$3.00,$657.00,$161151.50,317,$657.00
2025-03-19,19:51:00,19972.75,SELL,3,0.02h,Stop Loss,$67.50,$724.50,$161219.00,317,$724.50
2025-03-19,23:00:00,20011.5,BUY,3,0.02h,Break Even,$-1.50,$723.00,$161217.50,317,$723.00
,,,,,,,,,,,
2025-03-20,00:13:00,20022.75,SELL,3,0.02h,Break Even,$-1.50,$-1.50,$161216.00,318,$-1.50
2025-03-20,00:22:00,20028.25,BUY,3,0.02h,Stop Loss,$10.50,$9.00,$161226.50,318,$9.00
2025-03-20,01:03:00,20044.5,SELL,3,0.03h,Stop Loss,$-9.00,$0.00,$161217.50,318,$0.00
2025-03-20,01:13:00,20055.75,BUY,3,0.02h,Stop Loss,$-9.00,$-9.00,$161208.50,318,$-9.00
2025-03-20,01:30:00,20047.5,SELL,3,0.02h,Stop Loss,$10.50,$1.50,$161219.00,318,$1.50
2025-03-20,02:05:00,20038.25,BUY,3,0.02h,Break Even,$-1.50,$0.00,$161217.50,318,$0.00
2025-03-20,03:31:00,20081.0,SELL,3,0.02h,Break Even,$-1.50,$-1.50,$161216.00,318,$-1.50
2025-03-20,03:41:00,20084.75,BUY,3,0.02h,Break Even,$-1.50,$-3.00,$161214.50,318,$-3.00
2025-03-20,03:49:00,20079.25,SELL,3,0.02h,Stop Loss,$-9.00,$-12.00,$161205.50,318,$-12.00
2025-03-20,04:20:00,20082.75,BUY,3,0.02h,Stop Loss,$-9.00,$-21.00,$161196.50,318,$-21.00
2025-03-20,04:38:00,20075.5,SELL,3,0.02h,Break Even,$-1.50,$-22.50,$161195.00,318,$-22.50
2025-03-20,04:59:00,20080.5,BUY,3,0.02h,Stop Loss,$-9.00,$-31.50,$161186.00,318,$-31.50
2025-03-20,05:07:00,20072.5,SELL,3,0.02h,Break Even,$-1.50,$-33.00,$161184.50,318,$-33.00
2025-03-20,05:31:00,20075.0,BUY,3,0.02h,Stop Loss,$-9.00,$-42.00,$161175.50,318,$-42.00
2025-03-20,05:42:00,20071.75,SELL,3,0.02h,Stop Loss,$-9.00,$-51.00,$161166.50,318,$-51.00
2025-03-20,05:50:00,20080.0,BUY,3,0.02h,Break Even,$-1.50,$-52.50,$161165.00,318,$-52.50
2025-03-20,06:12:00,20078.75,SELL,3,0.02h,Stop Loss,$-9.00,$-61.50,$161156.00,318,$-61.50
2025-03-20,06:48:00,20064.75,BUY,3,0.02h,Break Even,$-1.50,$-63.00,$161154.50,318,$-63.00
2025-03-20,06:54:00,20057.0,SELL,3,0.02h,Break Even,$-1.50,$-64.50,$161153.00,318,$-64.50
2025-03-20,07:05:00,20062.0,BUY,3,0.02h,Stop Loss,$-9.00,$-73.50,$161144.00,318,$-73.50
2025-03-20,07:06:00,20057.25,SELL,3,0.02h,Break Even,$-1.50,$-75.00,$161142.50,318,$-75.00
2025-03-20,07:08:00,20059.5,BUY,3,0.02h,Stop Loss,$-9.00,$-84.00,$161133.50,318,$-84.00
2025-03-20,07:20:00,20056.25,SELL,3,0.02h,Stop Loss,$19.50,$-64.50,$161153.00,318,$-64.50
2025-03-20,07:29:00,20063.75,BUY,3,0.02h,Stop Loss,$-9.00,$-73.50,$161144.00,318,$-73.50
2025-03-20,07:32:00,20055.5,SELL,3,0.02h,Stop Loss,$-9.00,$-82.50,$161135.00,318,$-82.50
2025-03-20,08:03:00,20054.75,BUY,3,0.02h,Stop Loss,$4.50,$-78.00,$161139.50,318,$-78.00
2025-03-20,08:45:00,20059.0,SELL,3,0.02h,Stop Loss,$24.00,$-54.00,$161163.50,318,$-54.00
2025-03-20,10:53:00,19807.0,BUY,3,0.02h,Stop Loss,$-9.00,$-63.00,$161154.50,318,$-63.00
2025-03-20,11:29:00,19813.25,SELL,3,0.02h,Stop Loss,$-9.00,$-72.00,$161145.50,318,$-72.00
2025-03-20,11:38:00,19835.75,BUY,3,0.02h,Stop Loss,$40.50,$-31.50,$161186.00,318,$-31.50
2025-03-20,12:13:00,19843.0,SELL,3,0.02h,Stop Loss,$-9.00,$-40.50,$161177.00,318,$-40.50
2025-03-20,12:33:00,19857.5,BUY,3,0.02h,Stop Loss,$6.00,$-34.50,$161183.00,318,$-34.50
2025-03-20,12:48:00,19837.75,SELL,3,0.02h,Stop Loss,$61.50,$27.00,$161244.50,318,$27.00
2025-03-20,13:34:00,19864.5,BUY,3,0.02h,Stop Loss,$21.00,$48.00,$161265.50,318,$48.00
2025-03-20,14:57:00,20064.25,SELL,3,0.02h,Stop Loss,$31.50,$79.50,$161297.00,318,$79.50
2025-03-20,15:47:00,20038.25,BUY,3,0.02h,Stop Loss,$63.00,$142.50,$161360.00,318,$142.50
2025-03-20,15:59:00,19994.75,SELL,3,0.02h,Stop Loss,$66.00,$208.50,$161426.00,318,$208.50
2025-03-20,17:05:00,19902.0,BUY,3,0.02h,Stop Loss,$76.50,$285.00,$161502.50,318,$285.00
2025-03-20,17:22:00,19892.5,SELL,3,0.02h,Stop Loss,$40.50,$325.50,$161543.00,318,$325.50
2025-03-20,17:45:00,19880.25,BUY,3,0.02h,Stop Loss,$54.00,$379.50,$161597.00,318,$379.50
2025-03-20,17:54:00,19865.75,SELL,3,0.02h,Stop Loss,$85.50,$465.00,$161682.50,318,$465.00
2025-03-20,18:07:00,19870.5,BUY,3,0.02h,Break Even,$-1.50,$463.50,$161681.00,318,$463.50
2025-03-20,18:22:00,19845.75,SELL,3,0.02h,Stop Loss,$39.00,$502.50,$161720.00,318,$502.50
2025-03-20,18:51:00,19855.5,BUY,3,0.02h,Stop Loss,$-9.00,$493.50,$161711.00,318,$493.50
2025-03-20,19:29:00,19839.0,SELL,3,0.02h,Stop Loss,$48.00,$541.50,$161759.00,318,$541.50
2025-03-20,19:37:00,19881.5,BUY,3,0.02h,Break Even,$-1.50,$540.00,$161757.50,318,$540.00
2025-03-20,20:35:00,19901.25,SELL,3,0.02h,Stop Loss,$7.50,$547.50,$161765.00,318,$547.50
2025-03-20,20:53:00,19902.0,BUY,3,0.02h,Stop Loss,$-9.00,$538.50,$161756.00,318,$538.50
2025-03-20,20:59:00,19894.75,SELL,3,0.02h,Stop Loss,$-9.00,$529.50,$161747.00,318,$529.50
2025-03-20,23:37:00,19862.75,BUY,3,0.02h,Break Even,$-1.50,$528.00,$161745.50,318,$528.00
,,,,,,,,,,,
2025-03-21,00:41:00,19910.25,SELL,3,0.02h,Break Even,$-1.50,$-1.50,$161744.00,319,$-1.50
2025-03-21,00:54:00,19919.25,BUY,3,0.02h,Stop Loss,$-9.00,$-10.50,$161735.00,319,$-10.50
2025-03-21,01:05:00,19912.75,SELL,3,0.02h,Break Even,$-1.50,$-12.00,$161733.50,319,$-12.00
2025-03-21,01:24:00,19913.75,BUY,3,0.02h,Break Even,$-1.50,$-13.50,$161732.00,319,$-13.50
2025-03-21,02:05:00,19922.0,SELL,3,0.02h,Stop Loss,$-9.00,$-22.50,$161723.00,319,$-22.50
2025-03-21,02:46:00,19913.25,BUY,3,0.02h,Break Even,$-1.50,$-24.00,$161721.50,319,$-24.00
2025-03-21,03:00:00,19903.25,SELL,3,0.02h,Stop Loss,$31.50,$7.50,$161753.00,319,$7.50
2025-03-21,03:36:00,19886.5,BUY,3,0.02h,Stop Loss,$-9.00,$-1.50,$161744.00,319,$-1.50
2025-03-21,03:38:00,19883.5,SELL,3,0.02h,Break Even,$-1.50,$-3.00,$161742.50,319,$-3.00
2025-03-21,03:41:00,19887.0,BUY,3,0.02h,Break Even,$-1.50,$-4.50,$161741.00,319,$-4.50
2025-03-21,03:49:00,19883.25,SELL,3,0.02h,Stop Loss,$9.00,$4.50,$161750.00,319,$4.50
2025-03-21,04:08:00,19888.75,BUY,3,0.02h,Break Even,$-1.50,$3.00,$161748.50,319,$3.00
2025-03-21,04:27:00,19885.5,SELL,3,0.02h,Stop Loss,$-9.00,$-6.00,$161739.50,319,$-6.00
2025-03-21,04:29:00,19890.0,BUY,3,0.02h,Stop Loss,$-9.00,$-15.00,$161730.50,319,$-15.00
2025-03-21,04:31:00,19886.0,SELL,3,0.02h,Stop Loss,$-9.00,$-24.00,$161721.50,319,$-24.00
2025-03-21,04:33:00,19888.75,BUY,3,0.02h,Stop Loss,$-9.00,$-33.00,$161712.50,319,$-33.00
2025-03-21,04:34:00,19884.25,SELL,3,0.02h,Stop Loss,$-9.00,$-42.00,$161703.50,319,$-42.00
2025-03-21,05:20:00,19870.0,BUY,3,0.02h,Break Even,$-1.50,$-43.50,$161702.00,319,$-43.50
2025-03-21,05:38:00,19860.5,SELL,3,0.02h,Stop Loss,$57.00,$13.50,$161759.00,319,$13.50
2025-03-21,06:00:00,19850.5,BUY,3,0.02h,Break Even,$-1.50,$12.00,$161757.50,319,$12.00
2025-03-21,06:12:00,19843.75,SELL,3,0.02h,Stop Loss,$-9.00,$3.00,$161748.50,319,$3.00
2025-03-21,06:15:00,19853.5,BUY,3,0.02h,Stop Loss,$-9.00,$-6.00,$161739.50,319,$-6.00
2025-03-21,07:12:00,19873.5,SELL,3,0.02h,Break Even,$-1.50,$-7.50,$161738.00,319,$-7.50
2025-03-21,08:01:00,19848.0,BUY,3,0.02h,Stop Loss,$31.50,$24.00,$161769.50,319,$24.00
2025-03-21,08:17:00,19840.25,SELL,3,0.02h,Stop Loss,$-9.00,$15.00,$161760.50,319,$15.00
2025-03-21,08:59:00,19798.75,BUY,3,0.02h,Break Even,$-1.50,$13.50,$161759.00,319,$13.50
2025-03-21,09:03:00,19781.0,SELL,3,0.02h,Stop Loss,$33.00,$46.50,$161792.00,319,$46.50
2025-03-21,09:16:00,19791.25,BUY,3,0.02h,Stop Loss,$-9.00,$37.50,$161783.00,319,$37.50
2025-03-21,09:19:00,19777.25,SELL,3,0.02h,Break Even,$-1.50,$36.00,$161781.50,319,$36.00
2025-03-21,09:26:00,19789.5,BUY,3,0.02h,Stop Loss,$36.00,$72.00,$161817.50,319,$72.00
2025-03-21,09:53:00,19795.0,SELL,3,0.02h,Stop Loss,$-9.00,$63.00,$161808.50,319,$63.00
2025-03-21,10:02:00,19814.0,BUY,3,0.02h,Stop Loss,$-9.00,$54.00,$161799.50,319,$54.00
2025-03-21,10:27:00,19812.75,SELL,3,0.02h,Stop Loss,$-9.00,$45.00,$161790.50,319,$45.00
2025-03-21,10:52:00,19807.25,BUY,3,0.02h,Break Even,$-1.50,$43.50,$161789.00,319,$43.50
2025-03-21,11:12:00,19790.5,SELL,3,0.02h,Stop Loss,$-9.00,$34.50,$161780.00,319,$34.50
2025-03-21,11:16:00,19811.5,BUY,3,0.02h,Stop Loss,$-9.00,$25.50,$161771.00,319,$25.50
2025-03-21,11:50:00,19810.5,SELL,3,0.02h,Break Even,$-1.50,$24.00,$161769.50,319,$24.00
2025-03-21,12:05:00,19817.75,BUY,3,0.02h,Stop Loss,$-9.00,$15.00,$161760.50,319,$15.00
2025-03-21,12:21:00,19800.75,SELL,3,0.02h,Stop Loss,$-9.00,$6.00,$161751.50,319,$6.00
2025-03-21,13:42:00,19677.75,BUY,3,0.02h,Stop Loss,$102.00,$108.00,$161853.50,319,$108.00
2025-03-21,14:11:00,19690.0,SELL,3,0.02h,Stop Loss,$141.00,$249.00,$161994.50,319,$249.00
2025-03-21,14:17:00,19705.75,BUY,3,0.02h,Stop Loss,$19.50,$268.50,$162014.00,319,$268.50
2025-03-21,14:41:00,19728.75,SELL,3,0.02h,Stop Loss,$97.50,$366.00,$162111.50,319,$366.00
2025-03-21,14:47:00,19741.0,BUY,3,0.02h,Stop Loss,$10.50,$376.50,$162122.00,319,$376.50
2025-03-21,14:54:00,19730.75,SELL,3,0.02h,Stop Loss,$22.50,$399.00,$162144.50,319,$399.00
2025-03-21,14:55:00,19741.25,BUY,3,0.02h,Stop Loss,$30.00,$429.00,$162174.50,319,$429.00
2025-03-21,15:16:00,19733.75,SELL,3,0.02h,Stop Loss,$10.50,$439.50,$162185.00,319,$439.50
2025-03-21,15:57:00,19736.0,BUY,3,0.02h,Break Even,$-1.50,$438.00,$162183.50,319,$438.00
2025-03-21,16:03:00,19700.5,SELL,3,0.02h,Stop Loss,$-9.00,$429.00,$162174.50,319,$429.00
2025-03-21,16:05:00,19727.0,BUY,3,0.02h,Stop Loss,$30.00,$459.00,$162204.50,319,$459.00
2025-03-21,17:14:00,19851.75,SELL,3,0.02h,Stop Loss,$28.50,$487.50,$162233.00,319,$487.50
2025-03-21,17:40:00,19855.75,BUY,3,0.02h,Stop Loss,$9.00,$496.50,$162242.00,319,$496.50
2025-03-21,18:07:00,19849.75,SELL,3,0.02h,Stop Loss,$-9.00,$487.50,$162233.00,319,$487.50
2025-03-21,18:38:00,19871.5,BUY,3,0.02h,Break Even,$-1.50,$486.00,$162231.50,319,$486.00
2025-03-21,18:52:00,19851.5,SELL,3,0.02h,Stop Loss,$9.00,$495.00,$162240.50,319,$495.00
2025-03-21,18:57:00,19868.25,BUY,3,0.02h,Stop Loss,$21.00,$516.00,$162261.50,319,$516.00
2025-03-21,19:01:00,19849.25,SELL,3,0.02h,Stop Loss,$52.50,$568.50,$162314.00,319,$568.50
2025-03-21,19:30:00,19840.75,BUY,3,0.02h,Stop Loss,$16.50,$585.00,$162330.50,319,$585.00
2025-03-21,20:52:00,19958.25,SELL,3,0.02h,Break Even,$-1.50,$583.50,$162329.00,319,$583.50
2025-03-21,20:56:00,19966.0,BUY,3,0.02h,Stop Loss,$16.50,$600.00,$162345.50,319,$600.00
,,,,,,,,,,,
2025-03-24,00:40:00,20111.0,SELL,3,0.02h,Stop Loss,$-9.00,$-9.00,$162336.50,320,$-9.00
2025-03-24,00:48:00,20122.5,BUY,3,0.02h,Break Even,$-1.50,$-10.50,$162335.00,320,$-10.50
2025-03-24,01:03:00,20115.25,SELL,3,0.02h,Stop Loss,$-9.00,$-19.50,$162326.00,320,$-19.50
2025-03-24,01:18:00,20119.75,BUY,3,0.02h,Stop Loss,$-9.00,$-28.50,$162317.00,320,$-28.50
2025-03-24,01:27:00,20109.75,SELL,3,0.02h,Stop Loss,$-9.00,$-37.50,$162308.00,320,$-37.50
2025-03-24,01:39:00,20120.25,BUY,3,0.02h,Stop Loss,$-9.00,$-46.50,$162299.00,320,$-46.50
2025-03-24,01:44:00,20101.5,SELL,3,0.02h,Stop Loss,$-9.00,$-55.50,$162290.00,320,$-55.50
2025-03-24,02:07:00,20111.75,BUY,3,0.02h,Stop Loss,$-9.00,$-64.50,$162281.00,320,$-64.50
2025-03-24,02:15:00,20107.25,SELL,3,0.02h,Stop Loss,$-9.00,$-73.50,$162272.00,320,$-73.50
2025-03-24,02:42:00,20111.25,BUY,3,0.02h,Stop Loss,$-9.00,$-82.50,$162263.00,320,$-82.50
2025-03-24,03:22:00,20113.25,SELL,3,0.02h,Stop Loss,$-9.00,$-91.50,$162254.00,320,$-91.50
2025-03-24,03:24:00,20116.25,BUY,3,0.02h,Stop Loss,$-9.00,$-100.50,$162245.00,320,$-100.50
2025-03-24,03:25:00,20115.0,SELL,3,0.02h,Break Even,$-1.50,$-102.00,$162243.50,320,$-102.00
2025-03-24,04:20:00,20104.25,BUY,3,0.02h,Stop Loss,$-9.00,$-111.00,$162234.50,320,$-111.00
2025-03-24,05:32:00,20115.75,SELL,3,0.02h,Stop Loss,$-9.00,$-120.00,$162225.50,320,$-120.00
2025-03-24,05:38:00,20121.5,BUY,3,0.02h,Stop Loss,$-9.00,$-129.00,$162216.50,320,$-129.00
2025-03-24,05:39:00,20118.5,SELL,3,0.02h,Break Even,$-1.50,$-130.50,$162215.00,320,$-130.50
2025-03-24,06:19:00,20117.75,BUY,3,0.02h,Stop Loss,$-9.00,$-139.50,$162206.00,320,$-139.50
2025-03-24,06:36:00,20115.25,SELL,3,0.02h,Stop Loss,$-9.00,$-148.50,$162197.00,320,$-148.50
2025-03-24,06:37:00,20120.5,BUY,3,0.02h,Break Even,$-1.50,$-150.00,$162195.50,320,$-150.00
2025-03-24,07:43:00,20160.75,SELL,3,0.02h,Break Even,$-1.50,$-151.50,$162194.00,320,$-151.50
2025-03-24,07:47:00,20169.25,BUY,3,0.02h,Stop Loss,$-9.00,$-160.50,$162185.00,320,$-160.50
2025-03-24,08:48:00,20200.25,SELL,3,0.02h,Stop Loss,$-9.00,$-169.50,$162176.00,320,$-169.50
2025-03-24,08:51:00,20211.75,BUY,3,0.02h,Break Even,$-1.50,$-171.00,$162174.50,320,$-171.00
2025-03-24,09:03:00,20203.75,SELL,3,0.02h,Stop Loss,$13.50,$-157.50,$162188.00,320,$-157.50
2025-03-24,09:14:00,20213.25,BUY,3,0.02h,Stop Loss,$37.50,$-120.00,$162225.50,320,$-120.00
2025-03-24,09:24:00,20205.25,SELL,3,0.02h,Break Even,$-1.50,$-121.50,$162224.00,320,$-121.50
2025-03-24,09:49:00,20199.0,BUY,3,0.02h,Stop Loss,$9.00,$-112.50,$162233.00,320,$-112.50
2025-03-24,09:57:00,20188.5,SELL,3,0.02h,Stop Loss,$-9.00,$-121.50,$162224.00,320,$-121.50
2025-03-24,10:17:00,20196.0,BUY,3,0.02h,Break Even,$-1.50,$-123.00,$162222.50,320,$-123.00
2025-03-24,10:57:00,20214.5,SELL,3,0.02h,Stop Loss,$-9.00,$-132.00,$162213.50,320,$-132.00
2025-03-24,11:03:00,20222.5,BUY,3,0.02h,Break Even,$-1.50,$-133.50,$162212.00,320,$-133.50
2025-03-24,11:06:00,20213.5,SELL,3,0.02h,Break Even,$-1.50,$-135.00,$162210.50,320,$-135.00
2025-03-24,11:09:00,20219.25,BUY,3,0.02h,Stop Loss,$3.00,$-132.00,$162213.50,320,$-132.00
2025-03-24,11:34:00,20233.0,SELL,3,0.02h,Break Even,$-1.50,$-133.50,$162212.00,320,$-133.50
2025-03-24,11:39:00,20245.25,BUY,3,0.02h,Break Even,$-1.50,$-135.00,$162210.50,320,$-135.00
2025-03-24,12:15:00,20246.0,SELL,3,0.02h,Break Even,$-1.50,$-136.50,$162209.00,320,$-136.50
2025-03-24,12:25:00,20256.0,BUY,3,0.02h,Stop Loss,$4.50,$-132.00,$162213.50,320,$-132.00
2025-03-24,13:22:00,20271.0,SELL,3,0.02h,Stop Loss,$-9.00,$-141.00,$162204.50,320,$-141.00
2025-03-24,13:40:00,20282.25,BUY,3,0.02h,Stop Loss,$22.50,$-118.50,$162227.00,320,$-118.50
2025-03-24,13:45:00,20238.25,SELL,3,0.02h,Stop Loss,$-9.00,$-127.50,$162218.00,320,$-127.50
2025-03-24,13:46:00,20276.0,BUY,3,0.02h,Stop Loss,$111.00,$-16.50,$162329.00,320,$-16.50
2025-03-24,14:10:00,20281.5,SELL,3,0.02h,Stop Loss,$-9.00,$-25.50,$162320.00,320,$-25.50
2025-03-24,14:15:00,20319.0,BUY,3,0.02h,Stop Loss,$40.50,$15.00,$162360.50,320,$15.00
2025-03-24,14:41:00,20327.25,SELL,3,0.02h,Break Even,$-1.50,$13.50,$162359.00,320,$13.50
2025-03-24,14:42:00,20331.25,BUY,3,0.02h,Stop Loss,$16.50,$30.00,$162375.50,320,$30.00
2025-03-24,15:28:00,20351.75,SELL,3,0.02h,Stop Loss,$22.50,$52.50,$162398.00,320,$52.50
2025-03-24,15:55:00,20351.75,BUY,3,0.02h,Stop Loss,$10.50,$63.00,$162408.50,320,$63.00
2025-03-24,16:27:00,20343.0,SELL,3,0.02h,Stop Loss,$37.50,$100.50,$162446.00,320,$100.50
2025-03-24,16:49:00,20355.75,BUY,3,0.02h,Stop Loss,$-9.00,$91.50,$162437.00,320,$91.50
2025-03-24,16:57:00,20339.5,SELL,3,0.02h,Stop Loss,$6.00,$97.50,$162443.00,320,$97.50
2025-03-24,17:30:00,20337.5,BUY,3,0.02h,Stop Loss,$12.00,$109.50,$162455.00,320,$109.50
2025-03-24,17:56:00,20332.5,SELL,3,0.02h,Stop Loss,$10.50,$120.00,$162465.50,320,$120.00
2025-03-24,18:23:00,20329.25,BUY,3,0.02h,Break Even,$-1.50,$118.50,$162464.00,320,$118.50
2025-03-24,18:33:00,20320.75,SELL,3,0.02h,Break Even,$-1.50,$117.00,$162462.50,320,$117.00
2025-03-24,18:40:00,20346.5,BUY,3,0.02h,Stop Loss,$42.00,$159.00,$162504.50,320,$159.00
2025-03-24,19:27:00,20369.75,SELL,3,0.02h,Break Even,$-1.50,$157.50,$162503.00,320,$157.50
2025-03-24,19:47:00,20376.0,BUY,3,0.02h,Stop Loss,$60.00,$217.50,$162563.00,320,$217.50
2025-03-24,20:02:00,20368.75,SELL,3,0.02h,Stop Loss,$7.50,$225.00,$162570.50,320,$225.00
2025-03-24,20:18:00,20375.5,BUY,3,0.02h,Stop Loss,$-9.00,$216.00,$162561.50,320,$216.00
2025-03-24,20:28:00,20368.25,SELL,3,0.02h,Break Even,$-1.50,$214.50,$162560.00,320,$214.50
2025-03-24,23:31:00,20355.5,BUY,3,0.02h,Stop Loss,$-9.00,$205.50,$162551.00,320,$205.50
2025-03-24,23:59:00,20359.0,SELL,3,0.02h,Stop Loss,$9.00,$214.50,$162560.00,320,$214.50
,,,,,,,,,,,
2025-03-25,00:22:00,20358.5,BUY,3,0.02h,Stop Loss,$-9.00,$-9.00,$162551.00,321,$-9.00
2025-03-25,00:24:00,20351.25,SELL,3,0.02h,Break Even,$-1.50,$-10.50,$162549.50,321,$-10.50
2025-03-25,00:51:00,20357.5,BUY,3,0.02h,Stop Loss,$-9.00,$-19.50,$162540.50,321,$-19.50
2025-03-25,01:32:00,20363.75,SELL,3,0.02h,Break Even,$-1.50,$-21.00,$162539.00,321,$-21.00
2025-03-25,01:39:00,20367.5,BUY,3,0.02h,Break Even,$-1.50,$-22.50,$162537.50,321,$-22.50
2025-03-25,01:54:00,20365.0,SELL,3,0.02h,Stop Loss,$-9.00,$-31.50,$162528.50,321,$-31.50
2025-03-25,02:30:00,20353.75,BUY,3,0.02h,Stop Loss,$-9.00,$-40.50,$162519.50,321,$-40.50
2025-03-25,02:44:00,20347.0,SELL,3,0.02h,Stop Loss,$-9.00,$-49.50,$162510.50,321,$-49.50
2025-03-25,03:09:00,20345.5,BUY,3,0.02h,Stop Loss,$-9.00,$-58.50,$162501.50,321,$-58.50
2025-03-25,03:11:00,20344.0,SELL,3,0.02h,Stop Loss,$-9.00,$-67.50,$162492.50,321,$-67.50
2025-03-25,03:12:00,20345.75,BUY,3,0.02h,Break Even,$-1.50,$-69.00,$162491.00,321,$-69.00
2025-03-25,03:17:00,20342.0,SELL,3,0.02h,Break Even,$-1.50,$-70.50,$162489.50,321,$-70.50
2025-03-25,03:49:00,20337.75,BUY,3,0.02h,Stop Loss,$-9.00,$-79.50,$162480.50,321,$-79.50
2025-03-25,03:50:00,20336.25,SELL,3,0.02h,Stop Loss,$-9.00,$-88.50,$162471.50,321,$-88.50
2025-03-25,03:51:00,20337.5,BUY,3,0.02h,Stop Loss,$-9.00,$-97.50,$162462.50,321,$-97.50
2025-03-25,03:52:00,20336.25,SELL,3,0.02h,Break Even,$-1.50,$-99.00,$162461.00,321,$-99.00
2025-03-25,04:00:00,20338.5,BUY,3,0.02h,Break Even,$-1.50,$-100.50,$162459.50,321,$-100.50
2025-03-25,04:06:00,20336.5,SELL,3,0.05h,Stop Loss,$9.00,$-91.50,$162468.50,321,$-91.50
2025-03-25,04:38:00,20335.25,BUY,3,0.02h,Stop Loss,$-9.00,$-100.50,$162459.50,321,$-100.50
2025-03-25,05:03:00,20334.75,SELL,3,0.02h,Break Even,$-1.50,$-102.00,$162458.00,321,$-102.00
2025-03-25,05:09:00,20337.75,BUY,3,0.02h,Break Even,$-1.50,$-103.50,$162456.50,321,$-103.50
2025-03-25,05:28:00,20337.75,SELL,3,0.03h,Stop Loss,$-9.00,$-112.50,$162447.50,321,$-112.50
2025-03-25,05:31:00,20337.0,SELL,3,0.07h,Stop Loss,$-9.00,$-121.50,$162438.50,321,$-121.50
2025-03-25,05:46:00,20339.75,BUY,3,0.03h,Break Even,$-1.50,$-123.00,$162437.00,321,$-123.00
2025-03-25,06:12:00,20339.0,SELL,3,0.02h,Break Even,$-1.50,$-124.50,$162435.50,321,$-124.50
2025-03-25,06:15:00,20341.75,BUY,3,0.05h,Stop Loss,$-9.00,$-133.50,$162426.50,321,$-133.50
2025-03-25,06:19:00,20336.25,SELL,3,0.02h,Stop Loss,$-9.00,$-142.50,$162417.50,321,$-142.50
2025-03-25,06:35:00,20342.0,BUY,3,0.02h,Break Even,$-1.50,$-144.00,$162416.00,321,$-144.00
2025-03-25,06:50:00,20338.25,SELL,3,0.02h,Stop Loss,$-9.00,$-153.00,$162407.00,321,$-153.00
2025-03-25,06:51:00,20341.5,BUY,3,0.02h,Break Even,$-1.50,$-154.50,$162405.50,321,$-154.50
2025-03-25,07:29:00,20359.75,SELL,3,0.02h,Break Even,$-1.50,$-156.00,$162404.00,321,$-156.00
2025-03-25,08:49:00,20310.5,BUY,3,0.02h,Break Even,$-1.50,$-157.50,$162402.50,321,$-157.50
2025-03-25,09:00:00,20303.5,SELL,3,0.02h,Stop Loss,$13.50,$-144.00,$162416.00,321,$-144.00
2025-03-25,09:22:00,20313.5,BUY,3,0.02h,Stop Loss,$6.00,$-138.00,$162422.00,321,$-138.00
2025-03-25,10:09:00,20331.5,SELL,3,0.02h,Break Even,$-1.50,$-139.50,$162420.50,321,$-139.50
2025-03-25,10:17:00,20343.25,BUY,3,0.02h,Break Even,$-1.50,$-141.00,$162419.00,321,$-141.00
2025-03-25,11:16:00,20374.25,SELL,3,0.02h,Stop Loss,$-9.00,$-150.00,$162410.00,321,$-150.00
2025-03-25,11:17:00,20378.0,BUY,3,0.02h,Stop Loss,$3.00,$-147.00,$162413.00,321,$-147.00
2025-03-25,12:51:00,20421.75,SELL,3,0.02h,Stop Loss,$33.00,$-114.00,$162446.00,321,$-114.00
2025-03-25,13:09:00,20425.5,BUY,3,0.02h,Break Even,$-1.50,$-115.50,$162444.50,321,$-115.50
2025-03-25,13:28:00,20421.75,SELL,3,0.02h,Stop Loss,$115.50,$0.00,$162560.00,321,$0.00
2025-03-25,13:57:00,20410.5,BUY,3,0.02h,Stop Loss,$19.50,$19.50,$162579.50,321,$19.50
2025-03-25,14:03:00,20379.75,SELL,3,0.02h,Stop Loss,$31.50,$51.00,$162611.00,321,$51.00
2025-03-25,14:08:00,20413.0,BUY,3,0.02h,Stop Loss,$21.00,$72.00,$162632.00,321,$72.00
2025-03-25,15:17:00,20472.75,SELL,3,0.02h,Break Even,$-1.50,$70.50,$162630.50,321,$70.50
2025-03-25,15:26:00,20486.25,BUY,3,0.02h,Stop Loss,$-9.00,$61.50,$162621.50,321,$61.50
2025-03-25,15:31:00,20471.75,SELL,3,0.02h,Stop Loss,$15.00,$76.50,$162636.50,321,$76.50
2025-03-25,16:44:00,20438.25,BUY,3,0.02h,Stop Loss,$18.00,$94.50,$162654.50,321,$94.50
2025-03-25,17:18:00,20446.5,SELL,3,0.02h,Stop Loss,$18.00,$112.50,$162672.50,321,$112.50
2025-03-25,18:11:00,20434.25,BUY,3,0.02h,Break Even,$-1.50,$111.00,$162671.00,321,$111.00
2025-03-25,18:32:00,20428.5,SELL,3,0.02h,Stop Loss,$4.50,$115.50,$162675.50,321,$115.50
2025-03-25,18:59:00,20431.5,BUY,3,0.02h,Stop Loss,$-9.00,$106.50,$162666.50,321,$106.50
2025-03-25,19:17:00,20429.5,SELL,3,0.02h,Stop Loss,$-9.00,$97.50,$162657.50,321,$97.50
2025-03-25,19:20:00,20441.5,BUY,3,0.02h,Break Even,$-1.50,$96.00,$162656.00,321,$96.00
2025-03-25,20:54:00,20515.75,SELL,3,0.02h,Stop Loss,$-9.00,$87.00,$162647.00,321,$87.00
2025-03-25,23:17:00,20516.25,BUY,3,0.02h,Stop Loss,$-9.00,$78.00,$162638.00,321,$78.00
2025-03-25,23:20:00,20513.25,SELL,3,0.03h,Break Even,$-1.50,$76.50,$162636.50,321,$76.50
2025-03-25,23:27:00,20516.0,BUY,3,0.02h,Stop Loss,$-9.00,$67.50,$162627.50,321,$67.50
,,,,,,,,,,,
2025-03-26,00:01:00,20515.75,SELL,3,0.02h,Break Even,$-1.50,$-1.50,$162626.00,322,$-1.50
2025-03-26,00:18:00,20522.75,BUY,3,0.02h,Stop Loss,$-9.00,$-10.50,$162617.00,322,$-10.50
2025-03-26,00:57:00,20527.5,SELL,3,0.02h,Break Even,$-1.50,$-12.00,$162615.50,322,$-12.00
2025-03-26,02:49:00,20488.0,BUY,3,0.02h,Break Even,$-1.50,$-13.50,$162614.00,322,$-13.50
2025-03-26,03:13:00,20485.25,SELL,3,0.02h,Stop Loss,$-9.00,$-22.50,$162605.00,322,$-22.50
2025-03-26,04:01:00,20480.0,BUY,3,0.05h,Stop Loss,$-9.00,$-31.50,$162596.00,322,$-31.50
2025-03-26,04:06:00,20476.5,SELL,3,0.03h,Stop Loss,$-9.00,$-40.50,$162587.00,322,$-40.50
2025-03-26,04:10:00,20480.0,BUY,3,0.02h,Stop Loss,$-9.00,$-49.50,$162578.00,322,$-49.50
2025-03-26,04:13:00,20477.25,SELL,3,0.03h,Break Even,$-1.50,$-51.00,$162576.50,322,$-51.00
2025-03-26,04:36:00,20479.75,BUY,3,0.02h,Stop Loss,$-9.00,$-60.00,$162567.50,322,$-60.00
2025-03-26,05:28:00,20482.25,SELL,3,0.02h,Stop Loss,$-9.00,$-69.00,$162558.50,322,$-69.00
2025-03-26,06:27:00,20464.25,BUY,3,0.02h,Stop Loss,$-9.00,$-78.00,$162549.50,322,$-78.00
2025-03-26,06:30:00,20453.75,SELL,3,0.02h,Stop Loss,$-9.00,$-87.00,$162540.50,322,$-87.00
2025-03-26,06:41:00,20464.25,BUY,3,0.02h,Break Even,$-1.50,$-88.50,$162539.00,322,$-88.50
2025-03-26,07:53:00,20486.0,SELL,3,0.02h,Stop Loss,$-9.00,$-97.50,$162530.00,322,$-97.50
2025-03-26,08:31:00,20469.0,BUY,3,0.02h,Stop Loss,$-9.00,$-106.50,$162521.00,322,$-106.50
2025-03-26,08:49:00,20454.75,SELL,3,0.02h,Break Even,$-1.50,$-108.00,$162519.50,322,$-108.00
2025-03-26,09:10:00,20460.5,BUY,3,0.02h,Stop Loss,$3.00,$-105.00,$162522.50,322,$-105.00
2025-03-26,09:20:00,20451.0,SELL,3,0.02h,Break Even,$-1.50,$-106.50,$162521.00,322,$-106.50
2025-03-26,09:33:00,20458.5,BUY,3,0.02h,Stop Loss,$3.00,$-103.50,$162524.00,322,$-103.50
2025-03-26,09:45:00,20454.25,SELL,3,0.02h,Break Even,$-1.50,$-105.00,$162522.50,322,$-105.00
2025-03-26,10:15:00,20444.75,BUY,3,0.02h,Break Even,$-1.50,$-106.50,$162521.00,322,$-106.50
2025-03-26,11:11:00,20460.5,SELL,3,0.02h,Break Even,$-1.50,$-108.00,$162519.50,322,$-108.00
2025-03-26,11:15:00,20468.75,BUY,3,0.02h,Break Even,$-1.50,$-109.50,$162518.00,322,$-109.50
2025-03-26,12:01:00,20476.25,SELL,3,0.02h,Break Even,$-1.50,$-111.00,$162516.50,322,$-111.00
2025-03-26,12:46:00,20467.0,BUY,3,0.02h,Break Even,$-1.50,$-112.50,$162515.00,322,$-112.50
2025-03-26,13:15:00,20473.5,SELL,3,0.02h,Break Even,$-1.50,$-114.00,$162513.50,322,$-114.00
2025-03-26,13:40:00,20458.25,BUY,3,0.02h,Stop Loss,$64.50,$-49.50,$162578.00,322,$-49.50
2025-03-26,13:43:00,20439.25,SELL,3,0.02h,Stop Loss,$63.00,$13.50,$162641.00,322,$13.50
2025-03-26,14:42:00,20291.75,BUY,3,0.02h,Stop Loss,$-9.00,$4.50,$162632.00,322,$4.50
2025-03-26,14:43:00,20280.75,SELL,3,0.02h,Break Even,$-1.50,$3.00,$162630.50,322,$3.00
2025-03-26,14:54:00,20310.5,BUY,3,0.02h,Stop Loss,$-9.00,$-6.00,$162621.50,322,$-6.00
2025-03-26,15:25:00,20288.25,SELL,3,0.02h,Stop Loss,$100.50,$94.50,$162722.00,322,$94.50
2025-03-26,16:30:00,20205.0,BUY,3,0.02h,Stop Loss,$55.50,$150.00,$162777.50,322,$150.00
2025-03-26,16:43:00,20189.5,SELL,3,0.02h,Stop Loss,$46.50,$196.50,$162824.00,322,$196.50
2025-03-26,18:11:00,20109.5,BUY,3,0.02h,Stop Loss,$34.50,$231.00,$162858.50,322,$231.00
2025-03-26,18:37:00,20115.0,SELL,3,0.02h,Stop Loss,$3.00,$234.00,$162861.50,322,$234.00
2025-03-26,19:19:00,20079.0,BUY,3,0.02h,Stop Loss,$60.00,$294.00,$162921.50,322,$294.00
2025-03-26,19:32:00,20065.25,SELL,3,0.02h,Stop Loss,$-9.00,$285.00,$162912.50,322,$285.00
2025-03-26,19:36:00,20079.75,BUY,3,0.02h,Break Even,$-1.50,$283.50,$162911.00,322,$283.50
2025-03-26,20:18:00,20105.75,SELL,3,0.02h,Stop Loss,$-9.00,$274.50,$162902.00,322,$274.50
2025-03-26,20:50:00,20099.5,BUY,3,0.02h,Stop Loss,$-9.00,$265.50,$162893.00,322,$265.50
2025-03-26,20:53:00,20093.75,SELL,3,0.02h,Stop Loss,$18.00,$283.50,$162911.00,322,$283.50
2025-03-26,23:31:00,20040.25,BUY,3,0.02h,Break Even,$-1.50,$282.00,$162909.50,322,$282.00
,,,,,,,,,,,
2025-03-27,00:20:00,20054.5,SELL,3,0.02h,Break Even,$-1.50,$-1.50,$162908.00,323,$-1.50
2025-03-27,00:25:00,20061.25,BUY,3,0.02h,Stop Loss,$10.50,$9.00,$162918.50,323,$9.00
2025-03-27,00:55:00,20075.0,SELL,3,0.02h,Break Even,$-1.50,$7.50,$162917.00,323,$7.50
2025-03-27,01:12:00,20088.0,BUY,3,0.02h,Stop Loss,$-9.00,$-1.50,$162908.00,323,$-1.50
2025-03-27,01:33:00,20073.0,SELL,3,0.02h,Stop Loss,$-9.00,$-10.50,$162899.00,323,$-10.50
2025-03-27,01:43:00,20081.25,BUY,3,0.02h,Stop Loss,$3.00,$-7.50,$162902.00,323,$-7.50
2025-03-27,02:55:00,20115.25,SELL,3,0.02h,Break Even,$-1.50,$-9.00,$162900.50,323,$-9.00
2025-03-27,03:00:00,20118.25,BUY,3,0.02h,Stop Loss,$22.50,$13.50,$162923.00,323,$13.50
2025-03-27,03:14:00,20117.25,SELL,3,0.02h,Stop Loss,$-9.00,$4.50,$162914.00,323,$4.50
2025-03-27,03:15:00,20118.75,BUY,3,0.02h,Stop Loss,$-9.00,$-4.50,$162905.00,323,$-4.50
2025-03-27,03:17:00,20117.5,SELL,3,0.02h,Stop Loss,$-9.00,$-13.50,$162896.00,323,$-13.50
2025-03-27,03:18:00,20121.5,BUY,3,0.02h,Break Even,$-1.50,$-15.00,$162894.50,323,$-15.00
2025-03-27,04:14:00,20129.0,SELL,3,0.02h,Stop Loss,$-9.00,$-24.00,$162885.50,323,$-24.00
2025-03-27,04:37:00,20136.25,BUY,3,0.02h,Stop Loss,$-9.00,$-33.00,$162876.50,323,$-33.00
2025-03-27,04:40:00,20129.75,SELL,3,0.03h,Stop Loss,$-9.00,$-42.00,$162867.50,323,$-42.00
2025-03-27,04:43:00,20135.5,BUY,3,0.02h,Stop Loss,$-9.00,$-51.00,$162858.50,323,$-51.00
2025-03-27,04:47:00,20130.75,SELL,3,0.02h,Stop Loss,$-9.00,$-60.00,$162849.50,323,$-60.00
2025-03-27,04:49:00,20133.0,BUY,3,0.02h,Break Even,$-1.50,$-61.50,$162848.00,323,$-61.50
2025-03-27,04:54:00,20131.0,SELL,3,0.02h,Stop Loss,$-9.00,$-70.50,$162839.00,323,$-70.50
2025-03-27,04:56:00,20133.0,BUY,3,0.02h,Break Even,$-1.50,$-72.00,$162837.50,323,$-72.00
2025-03-27,05:05:00,20132.0,SELL,3,0.02h,Stop Loss,$-9.00,$-81.00,$162828.50,323,$-81.00
2025-03-27,05:25:00,20129.25,BUY,3,0.02h,Stop Loss,$-9.00,$-90.00,$162819.50,323,$-90.00
2025-03-27,05:51:00,20125.25,SELL,3,0.02h,Stop Loss,$4.50,$-85.50,$162824.00,323,$-85.50
2025-03-27,06:14:00,20127.0,BUY,3,0.02h,Stop Loss,$-9.00,$-94.50,$162815.00,323,$-94.50
2025-03-27,06:45:00,20126.75,SELL,3,0.02h,Stop Loss,$3.00,$-91.50,$162818.00,323,$-91.50
2025-03-27,07:14:00,20113.75,BUY,3,0.02h,Break Even,$-1.50,$-93.00,$162816.50,323,$-93.00
2025-03-27,07:20:00,20101.75,SELL,3,0.02h,Stop Loss,$-9.00,$-102.00,$162807.50,323,$-102.00
2025-03-27,08:22:00,20073.75,BUY,3,0.02h,Stop Loss,$-9.00,$-111.00,$162798.50,323,$-111.00
2025-03-27,08:53:00,20069.5,SELL,3,0.02h,Stop Loss,$-9.00,$-120.00,$162789.50,323,$-120.00
2025-03-27,08:54:00,20079.75,BUY,3,0.02h,Break Even,$-1.50,$-121.50,$162788.00,323,$-121.50
2025-03-27,09:40:00,20103.5,SELL,3,0.02h,Stop Loss,$18.00,$-103.50,$162806.00,323,$-103.50
2025-03-27,09:48:00,20113.75,BUY,3,0.02h,Break Even,$-1.50,$-105.00,$162804.50,323,$-105.00
2025-03-27,10:20:00,20116.25,SELL,3,0.02h,Break Even,$-1.50,$-106.50,$162803.00,323,$-106.50
2025-03-27,11:39:00,20070.25,BUY,3,0.02h,Break Even,$-1.50,$-108.00,$162801.50,323,$-108.00
2025-03-27,12:07:00,20058.0,SELL,3,0.02h,Break Even,$-1.50,$-109.50,$162800.00,323,$-109.50
2025-03-27,12:32:00,20091.0,BUY,3,0.02h,Stop Loss,$27.00,$-82.50,$162827.00,323,$-82.50
2025-03-27,12:48:00,20070.25,SELL,3,0.02h,Stop Loss,$18.00,$-64.50,$162845.00,323,$-64.50
2025-03-27,13:08:00,20080.75,BUY,3,0.02h,Stop Loss,$-9.00,$-73.50,$162836.00,323,$-73.50
2025-03-27,13:10:00,20068.0,SELL,3,0.02h,Break Even,$-1.50,$-75.00,$162834.50,323,$-75.00
2025-03-27,13:51:00,20028.25,BUY,3,0.02h,Stop Loss,$39.00,$-36.00,$162873.50,323,$-36.00
2025-03-27,14:24:00,20050.0,SELL,3,0.02h,Break Even,$-1.50,$-37.50,$162872.00,323,$-37.50
2025-03-27,14:26:00,20080.25,BUY,3,0.02h,Stop Loss,$9.00,$-28.50,$162881.00,323,$-28.50
2025-03-27,15:14:00,20157.75,SELL,3,0.02h,Stop Loss,$-9.00,$-37.50,$162872.00,323,$-37.50
2025-03-27,16:08:00,20085.75,BUY,3,0.02h,Break Even,$-1.50,$-39.00,$162870.50,323,$-39.00
2025-03-27,16:30:00,20079.5,SELL,3,0.02h,Break Even,$-1.50,$-40.50,$162869.00,323,$-40.50
2025-03-27,17:13:00,20049.75,BUY,3,0.02h,Stop Loss,$30.00,$-10.50,$162899.00,323,$-10.50
2025-03-27,17:26:00,20034.25,SELL,3,0.02h,Stop Loss,$13.50,$3.00,$162912.50,323,$3.00
2025-03-27,17:48:00,20050.75,BUY,3,0.02h,Stop Loss,$-9.00,$-6.00,$162903.50,323,$-6.00
2025-03-27,17:55:00,20011.0,SELL,3,0.02h,Break Even,$-1.50,$-7.50,$162902.00,323,$-7.50
2025-03-27,18:05:00,20042.5,BUY,3,0.02h,Stop Loss,$39.00,$31.50,$162941.00,323,$31.50
2025-03-27,18:34:00,20058.5,SELL,3,0.02h,Break Even,$-1.50,$30.00,$162939.50,323,$30.00
2025-03-27,18:35:00,20065.0,BUY,3,0.02h,Stop Loss,$24.00,$54.00,$162963.50,323,$54.00
2025-03-27,18:58:00,20061.0,SELL,3,0.02h,Stop Loss,$18.00,$72.00,$162981.50,323,$72.00
2025-03-27,19:15:00,20096.75,BUY,3,0.02h,Stop Loss,$39.00,$111.00,$163020.50,323,$111.00
2025-03-27,19:34:00,20073.25,SELL,3,0.02h,Stop Loss,$13.50,$124.50,$163034.00,323,$124.50
2025-03-27,20:35:00,20004.25,BUY,3,0.02h,Break Even,$-1.50,$123.00,$163032.50,323,$123.00
2025-03-27,20:57:00,20004.0,SELL,3,0.02h,Break Even,$-1.50,$121.50,$163031.00,323,$121.50
2025-03-27,23:50:00,19968.0,BUY,3,0.02h,Break Even,$-1.50,$120.00,$163029.50,323,$120.00
,,,,,,,,,,,
2025-03-28,00:02:00,19960.75,SELL,3,0.02h,Break Even,$-1.50,$-1.50,$163028.00,324,$-1.50
2025-03-28,00:22:00,19953.75,BUY,3,0.02h,Stop Loss,$12.00,$10.50,$163040.00,324,$10.50
2025-03-28,01:43:00,19982.0,SELL,3,0.02h,Stop Loss,$-9.00,$1.50,$163031.00,324,$1.50
2025-03-28,02:09:00,19984.0,BUY,3,0.02h,Stop Loss,$-9.00,$-7.50,$163022.00,324,$-7.50
2025-03-28,02:53:00,19985.25,SELL,3,0.02h,Stop Loss,$-9.00,$-16.50,$163013.00,324,$-16.50
2025-03-28,03:21:00,19985.0,BUY,3,0.02h,Stop Loss,$-9.00,$-25.50,$163004.00,324,$-25.50
2025-03-28,03:24:00,19982.75,SELL,3,0.02h,Stop Loss,$-9.00,$-34.50,$162995.00,324,$-34.50
2025-03-28,03:31:00,19987.75,BUY,3,0.02h,Stop Loss,$10.50,$-24.00,$163005.50,324,$-24.00
2025-03-28,03:37:00,19976.25,SELL,3,0.02h,Break Even,$-1.50,$-25.50,$163004.00,324,$-25.50
2025-03-28,03:55:00,19981.5,BUY,3,0.02h,Break Even,$-1.50,$-27.00,$163002.50,324,$-27.00
2025-03-28,04:07:00,19975.5,SELL,3,0.02h,Break Even,$-1.50,$-28.50,$163001.00,324,$-28.50
2025-03-28,04:33:00,19977.25,BUY,3,0.02h,Break Even,$-1.50,$-30.00,$162999.50,324,$-30.00
2025-03-28,04:56:00,19975.5,SELL,3,0.02h,Stop Loss,$-9.00,$-39.00,$162990.50,324,$-39.00
2025-03-28,04:58:00,19980.25,BUY,3,0.03h,Break Even,$-1.50,$-40.50,$162989.00,324,$-40.50
2025-03-28,05:20:00,19981.5,SELL,3,0.02h,Break Even,$-1.50,$-42.00,$162987.50,324,$-42.00
2025-03-28,05:59:00,19974.75,BUY,3,0.02h,Break Even,$-1.50,$-43.50,$162986.00,324,$-43.50
2025-03-28,06:34:00,19991.25,SELL,3,0.03h,Stop Loss,$-9.00,$-52.50,$162977.00,324,$-52.50
2025-03-28,07:24:00,19939.5,BUY,3,0.02h,Stop Loss,$13.50,$-39.00,$162990.50,324,$-39.00
2025-03-28,07:27:00,19929.75,SELL,3,0.02h,Stop Loss,$10.50,$-28.50,$163001.00,324,$-28.50
2025-03-28,08:07:00,19892.25,BUY,3,0.02h,Stop Loss,$-9.00,$-37.50,$162992.00,324,$-37.50
2025-03-28,08:14:00,19878.75,SELL,3,0.02h,Stop Loss,$6.00,$-31.50,$162998.00,324,$-31.50
2025-03-28,08:16:00,19886.5,BUY,3,0.02h,Break Even,$-1.50,$-33.00,$162996.50,324,$-33.00
2025-03-28,08:19:00,19876.5,SELL,3,0.02h,Stop Loss,$-9.00,$-42.00,$162987.50,324,$-42.00
2025-03-28,08:20:00,19888.25,BUY,3,0.02h,Break Even,$-1.50,$-43.50,$162986.00,324,$-43.50
2025-03-28,08:22:00,19877.0,SELL,3,0.02h,Break Even,$-1.50,$-45.00,$162984.50,324,$-45.00
2025-03-28,08:40:00,19880.75,BUY,3,0.02h,Stop Loss,$-9.00,$-54.00,$162975.50,324,$-54.00
2025-03-28,09:47:00,19911.0,SELL,3,0.02h,Stop Loss,$6.00,$-48.00,$162981.50,324,$-48.00
2025-03-28,10:04:00,19918.75,BUY,3,0.02h,Stop Loss,$-9.00,$-57.00,$162972.50,324,$-57.00
2025-03-28,10:54:00,19946.0,SELL,3,0.02h,Break Even,$-1.50,$-58.50,$162971.00,324,$-58.50
2025-03-28,11:22:00,19945.5,BUY,3,0.02h,Stop Loss,$7.50,$-51.00,$162978.50,324,$-51.00
2025-03-28,11:30:00,19931.25,SELL,3,0.02h,Stop Loss,$33.00,$-18.00,$163011.50,324,$-18.00
2025-03-28,11:44:00,19938.25,BUY,3,0.02h,Break Even,$-1.50,$-19.50,$163010.00,324,$-19.50
2025-03-28,12:12:00,19933.0,SELL,3,0.02h,Break Even,$-1.50,$-21.00,$163008.50,324,$-21.00
2025-03-28,12:22:00,19947.75,BUY,3,0.02h,Stop Loss,$-9.00,$-30.00,$162999.50,324,$-30.00
2025-03-28,12:28:00,19935.75,SELL,3,0.02h,Stop Loss,$3.00,$-27.00,$163002.50,324,$-27.00
2025-03-28,13:11:00,19893.75,BUY,3,0.02h,Stop Loss,$94.50,$67.50,$163097.00,324,$67.50
2025-03-28,13:31:00,19889.0,SELL,3,0.02h,Stop Loss,$165.00,$232.50,$163262.00,324,$232.50
2025-03-28,13:43:00,19934.5,BUY,3,0.02h,Stop Loss,$19.50,$252.00,$163281.50,324,$252.00
2025-03-28,13:45:00,19881.75,SELL,3,0.02h,Stop Loss,$25.50,$277.50,$163307.00,324,$277.50
2025-03-28,13:50:00,19909.0,BUY,3,0.02h,Stop Loss,$63.00,$340.50,$163370.00,324,$340.50
2025-03-28,13:52:00,19883.5,SELL,3,0.02h,Stop Loss,$129.00,$469.50,$163499.00,324,$469.50
2025-03-28,15:15:00,19608.5,BUY,3,0.02h,Stop Loss,$19.50,$489.00,$163518.50,324,$489.00
2025-03-28,15:20:00,19587.75,SELL,3,0.02h,Stop Loss,$12.00,$501.00,$163530.50,324,$501.00
2025-03-28,15:31:00,19594.5,BUY,3,0.02h,Stop Loss,$97.50,$598.50,$163628.00,324,$598.50
2025-03-28,15:46:00,19598.75,SELL,3,0.02h,Stop Loss,$12.00,$610.50,$163640.00,324,$610.50
2025-03-28,16:52:00,19525.75,BUY,3,0.02h,Stop Loss,$22.50,$633.00,$163662.50,324,$633.00
2025-03-28,16:57:00,19501.0,SELL,3,0.02h,Stop Loss,$12.00,$645.00,$163674.50,324,$645.00
2025-03-28,17:44:00,19472.75,BUY,3,0.02h,Stop Loss,$-9.00,$636.00,$163665.50,324,$636.00
2025-03-28,17:45:00,19456.5,SELL,3,0.02h,Stop Loss,$4.50,$640.50,$163670.00,324,$640.50
2025-03-28,17:47:00,19464.75,BUY,3,0.02h,Stop Loss,$48.00,$688.50,$163718.00,324,$688.50
2025-03-28,17:52:00,19449.5,SELL,3,0.02h,Stop Loss,$-9.00,$679.50,$163709.00,324,$679.50
2025-03-28,17:58:00,19478.0,BUY,3,0.02h,Stop Loss,$-9.00,$670.50,$163700.00,324,$670.50
2025-03-28,18:24:00,19473.5,SELL,3,0.02h,Stop Loss,$18.00,$688.50,$163718.00,324,$688.50
2025-03-28,18:35:00,19485.75,BUY,3,0.02h,Stop Loss,$7.50,$696.00,$163725.50,324,$696.00
2025-03-28,18:36:00,19477.75,SELL,3,0.02h,Stop Loss,$30.00,$726.00,$163755.50,324,$726.00
2025-03-28,18:58:00,19477.0,BUY,3,0.02h,Break Even,$-1.50,$724.50,$163754.00,324,$724.50
2025-03-28,19:17:00,19471.75,SELL,3,0.02h,Stop Loss,$39.00,$763.50,$163793.00,324,$763.50
2025-03-28,19:55:00,19470.5,BUY,3,0.02h,Stop Loss,$37.50,$801.00,$163830.50,324,$801.00
2025-03-28,20:06:00,19438.75,SELL,3,0.02h,Break Even,$-1.50,$799.50,$163829.00,324,$799.50
,,,,,,,,,,,
2025-03-31,00:47:00,19198.25,BUY,3,0.02h,Stop Loss,$7.50,$7.50,$163836.50,325,$7.50
2025-03-31,01:38:00,19233.75,SELL,3,0.02h,Stop Loss,$-9.00,$-1.50,$163827.50,325,$-1.50
2025-03-31,01:51:00,19247.5,BUY,3,0.02h,Break Even,$-1.50,$-3.00,$163826.00,325,$-3.00
2025-03-31,01:53:00,19243.75,SELL,3,0.02h,Stop Loss,$10.50,$7.50,$163836.50,325,$7.50
2025-03-31,02:17:00,19248.0,BUY,3,0.02h,Stop Loss,$4.50,$12.00,$163841.00,325,$12.00
2025-03-31,02:32:00,19233.5,SELL,3,0.02h,Stop Loss,$15.00,$27.00,$163856.00,325,$27.00
2025-03-31,03:30:00,19205.25,BUY,3,0.02h,Stop Loss,$-9.00,$18.00,$163847.00,325,$18.00
2025-03-31,03:31:00,19197.25,SELL,3,0.02h,Stop Loss,$12.00,$30.00,$163859.00,325,$30.00
2025-03-31,04:00:00,19200.5,BUY,3,0.02h,Break Even,$-1.50,$28.50,$163857.50,325,$28.50
2025-03-31,04:11:00,19191.75,SELL,3,0.02h,Stop Loss,$19.50,$48.00,$163877.00,325,$48.00
2025-03-31,04:29:00,19201.5,BUY,3,0.02h,Break Even,$-1.50,$46.50,$163875.50,325,$46.50
2025-03-31,05:34:00,19239.25,SELL,3,0.02h,Break Even,$-1.50,$45.00,$163874.00,325,$45.00
2025-03-31,05:53:00,19240.0,BUY,3,0.02h,Stop Loss,$-9.00,$36.00,$163865.00,325,$36.00
2025-03-31,06:02:00,19227.25,SELL,3,0.02h,Stop Loss,$9.00,$45.00,$163874.00,325,$45.00
2025-03-31,06:23:00,19227.5,BUY,3,0.02h,Stop Loss,$22.50,$67.50,$163896.50,325,$67.50
2025-03-31,06:29:00,19214.25,SELL,3,0.02h,Stop Loss,$3.00,$70.50,$163899.50,325,$70.50
2025-03-31,06:58:00,19216.25,BUY,3,0.02h,Stop Loss,$10.50,$81.00,$163910.00,325,$81.00
2025-03-31,07:10:00,19203.5,SELL,3,0.02h,Stop Loss,$3.00,$84.00,$163913.00,325,$84.00
2025-03-31,07:17:00,19218.5,BUY,3,0.02h,Stop Loss,$-9.00,$75.00,$163904.00,325,$75.00
2025-03-31,07:18:00,19210.25,SELL,3,0.02h,Break Even,$-1.50,$73.50,$163902.50,325,$73.50
2025-03-31,07:19:00,19216.25,BUY,3,0.02h,Break Even,$-1.50,$72.00,$163901.00,325,$72.00
2025-03-31,08:05:00,19235.0,SELL,3,0.02h,Stop Loss,$28.50,$100.50,$163929.50,325,$100.50
2025-03-31,08:14:00,19265.0,BUY,3,0.02h,Break Even,$-1.50,$99.00,$163928.00,325,$99.00
2025-03-31,08:22:00,19242.5,SELL,3,0.02h,Stop Loss,$24.00,$123.00,$163952.00,325,$123.00
2025-03-31,09:25:00,19203.25,BUY,3,0.02h,Stop Loss,$12.00,$135.00,$163964.00,325,$135.00
2025-03-31,09:44:00,19196.0,SELL,3,0.02h,Stop Loss,$15.00,$150.00,$163979.00,325,$150.00
2025-03-31,10:03:00,19207.25,BUY,3,0.02h,Stop Loss,$-9.00,$141.00,$163970.00,325,$141.00
2025-03-31,10:07:00,19194.25,SELL,3,0.02h,Break Even,$-1.50,$139.50,$163968.50,325,$139.50
2025-03-31,10:09:00,19198.75,BUY,3,0.02h,Stop Loss,$-9.00,$130.50,$163959.50,325,$130.50
2025-03-31,10:10:00,19190.0,SELL,3,0.02h,Break Even,$-1.50,$129.00,$163958.00,325,$129.00
2025-03-31,10:23:00,19200.5,BUY,3,0.02h,Stop Loss,$3.00,$132.00,$163961.00,325,$132.00
2025-03-31,10:24:00,19190.75,SELL,3,0.02h,Stop Loss,$7.50,$139.50,$163968.50,325,$139.50
2025-03-31,10:29:00,19207.5,BUY,3,0.02h,Stop Loss,$-9.00,$130.50,$163959.50,325,$130.50
2025-03-31,11:02:00,19204.0,SELL,3,0.02h,Stop Loss,$22.50,$153.00,$163982.00,325,$153.00
2025-03-31,11:50:00,19167.25,BUY,3,0.02h,Stop Loss,$19.50,$172.50,$164001.50,325,$172.50
2025-03-31,12:13:00,19160.75,SELL,3,0.02h,Break Even,$-1.50,$171.00,$164000.00,325,$171.00
2025-03-31,12:26:00,19180.25,BUY,3,0.02h,Stop Loss,$34.50,$205.50,$164034.50,325,$205.50
2025-03-31,13:16:00,19205.0,SELL,3,0.02h,Break Even,$-1.50,$204.00,$164033.00,325,$204.00
2025-03-31,13:57:00,19099.25,BUY,3,0.02h,Stop Loss,$148.50,$352.50,$164181.50,325,$352.50
2025-03-31,14:20:00,19095.75,SELL,3,0.02h,Stop Loss,$-9.00,$343.50,$164172.50,325,$343.50
2025-03-31,14:35:00,19157.25,BUY,3,0.02h,Stop Loss,$28.50,$372.00,$164201.00,325,$372.00
2025-03-31,15:15:00,19121.0,SELL,3,0.02h,Stop Loss,$22.50,$394.50,$164223.50,325,$394.50
2025-03-31,15:18:00,19150.25,BUY,3,0.02h,Stop Loss,$31.50,$426.00,$164255.00,325,$426.00
2025-03-31,16:07:00,19214.75,SELL,3,0.02h,Stop Loss,$45.00,$471.00,$164300.00,325,$471.00
2025-03-31,16:23:00,19229.75,BUY,3,0.02h,Break Even,$-1.50,$469.50,$164298.50,325,$469.50
2025-03-31,16:49:00,19246.0,SELL,3,0.02h,Break Even,$-1.50,$468.00,$164297.00,325,$468.00
2025-03-31,16:55:00,19264.5,BUY,3,0.02h,Stop Loss,$-9.00,$459.00,$164288.00,325,$459.00
2025-03-31,16:56:00,19249.25,SELL,3,0.02h,Stop Loss,$102.00,$561.00,$164390.00,325,$561.00
2025-03-31,17:07:00,19261.5,BUY,3,0.02h,Stop Loss,$64.50,$625.50,$164454.50,325,$625.50
2025-03-31,17:21:00,19241.0,SELL,3,0.02h,Stop Loss,$69.00,$694.50,$164523.50,325,$694.50
2025-03-31,17:39:00,19266.0,BUY,3,0.02h,Stop Loss,$10.50,$705.00,$164534.00,325,$705.00
2025-03-31,17:44:00,19225.75,SELL,3,0.02h,Stop Loss,$22.50,$727.50,$164556.50,325,$727.50
2025-03-31,17:54:00,19259.25,BUY,3,0.02h,Stop Loss,$31.50,$759.00,$164588.00,325,$759.00
2025-03-31,17:59:00,19227.0,SELL,3,0.02h,Stop Loss,$24.00,$783.00,$164612.00,325,$783.00
2025-03-31,18:02:00,19262.5,BUY,3,0.02h,Stop Loss,$54.00,$837.00,$164666.00,325,$837.00
2025-03-31,18:49:00,19361.25,SELL,3,0.02h,Stop Loss,$4.50,$841.50,$164670.50,325,$841.50
2025-03-31,18:51:00,19396.75,BUY,3,0.02h,Break Even,$-1.50,$840.00,$164669.00,325,$840.00
2025-03-31,19:00:00,19348.25,SELL,3,0.02h,Break Even,$-1.50,$838.50,$164667.50,325,$838.50
2025-03-31,19:06:00,19387.0,BUY,3,0.02h,Stop Loss,$85.50,$924.00,$164753.00,325,$924.00
2025-03-31,19:29:00,19371.0,SELL,3,0.02h,Stop Loss,$66.00,$990.00,$164819.00,325,$990.00
2025-03-31,19:36:00,19422.5,BUY,3,0.02h,Break Even,$-1.50,$988.50,$164817.50,325,$988.50
2025-03-31,20:03:00,19409.5,SELL,3,0.02h,Stop Loss,$7.50,$996.00,$164825.00,325,$996.00
2025-03-31,20:18:00,19429.5,BUY,3,0.02h,Stop Loss,$-9.00,$987.00,$164816.00,325,$987.00
2025-03-31,20:24:00,19421.0,SELL,3,0.02h,Break Even,$-1.50,$985.50,$164814.50,325,$985.50
2025-03-31,20:45:00,19424.0,BUY,3,0.02h,Stop Loss,$-9.00,$976.50,$164805.50,325,$976.50
2025-03-31,20:51:00,19413.75,SELL,3,0.03h,Stop Loss,$-9.00,$967.50,$164796.50,325,$967.50
,,,,,,,,,,,
2025-04-01,00:11:00,19358.75,BUY,3,0.02h,Break Even,$-1.50,$-1.50,$164795.00,326,$-1.50
2025-04-01,00:13:00,19341.75,SELL,3,0.02h,Break Even,$-1.50,$-3.00,$164793.50,326,$-3.00
2025-04-01,00:19:00,19357.5,BUY,3,0.02h,Break Even,$-1.50,$-4.50,$164792.00,326,$-4.50
2025-04-01,00:31:00,19344.25,SELL,3,0.02h,Stop Loss,$9.00,$4.50,$164801.00,326,$4.50
2025-04-01,01:17:00,19333.75,BUY,3,0.02h,Stop Loss,$-9.00,$-4.50,$164792.00,326,$-4.50
2025-04-01,01:36:00,19311.5,SELL,3,0.02h,Stop Loss,$18.00,$13.50,$164810.00,326,$13.50
2025-04-01,01:45:00,19333.75,BUY,3,0.02h,Stop Loss,$51.00,$64.50,$164861.00,326,$64.50
2025-04-01,03:18:00,19368.75,SELL,3,0.02h,Stop Loss,$-9.00,$55.50,$164852.00,326,$55.50
2025-04-01,03:53:00,19365.5,BUY,3,0.02h,Break Even,$-1.50,$54.00,$164850.50,326,$54.00
2025-04-01,04:00:00,19360.5,SELL,3,0.02h,Stop Loss,$88.50,$142.50,$164939.00,326,$142.50
2025-04-01,04:18:00,19356.75,BUY,3,0.02h,Break Even,$-1.50,$141.00,$164937.50,326,$141.00
2025-04-01,04:30:00,19351.75,SELL,3,0.02h,Stop Loss,$-9.00,$132.00,$164928.50,326,$132.00
2025-04-01,04:38:00,19358.25,BUY,3,0.02h,Stop Loss,$-9.00,$123.00,$164919.50,326,$123.00
2025-04-01,04:42:00,19350.5,SELL,3,0.02h,Break Even,$-1.50,$121.50,$164918.00,326,$121.50
2025-04-01,04:52:00,19358.5,BUY,3,0.02h,Stop Loss,$13.50,$135.00,$164931.50,326,$135.00
2025-04-01,05:35:00,19380.5,SELL,3,0.02h,Stop Loss,$12.00,$147.00,$164943.50,326,$147.00
2025-04-01,06:09:00,19373.0,BUY,3,0.02h,Stop Loss,$-9.00,$138.00,$164934.50,326,$138.00
2025-04-01,06:11:00,19365.25,SELL,3,0.02h,Stop Loss,$28.50,$166.50,$164963.00,326,$166.50
2025-04-01,06:17:00,19373.75,BUY,3,0.02h,Stop Loss,$16.50,$183.00,$164979.50,326,$183.00
2025-04-01,07:21:00,19434.0,SELL,3,0.02h,Stop Loss,$12.00,$195.00,$164991.50,326,$195.00
2025-04-01,08:08:00,19408.25,BUY,3,0.02h,Break Even,$-1.50,$193.50,$164990.00,326,$193.50
2025-04-01,09:58:00,19490.75,SELL,3,0.02h,Stop Loss,$6.00,$199.50,$164996.00,326,$199.50
2025-04-01,10:49:00,19406.75,BUY,3,0.02h,Stop Loss,$36.00,$235.50,$165032.00,326,$235.50
2025-04-01,11:02:00,19379.75,SELL,3,0.02h,Stop Loss,$6.00,$241.50,$165038.00,326,$241.50
2025-04-01,11:50:00,19352.5,BUY,3,0.02h,Break Even,$-1.50,$240.00,$165036.50,326,$240.00
2025-04-01,11:51:00,19344.5,SELL,3,0.02h,Stop Loss,$-9.00,$231.00,$165027.50,326,$231.00
2025-04-01,11:58:00,19356.0,BUY,3,0.02h,Stop Loss,$12.00,$243.00,$165039.50,326,$243.00
2025-04-01,12:23:00,19349.5,SELL,3,0.02h,Stop Loss,$33.00,$276.00,$165072.50,326,$276.00
2025-04-01,12:32:00,19374.0,BUY,3,0.02h,Stop Loss,$15.00,$291.00,$165087.50,326,$291.00
2025-04-01,13:29:00,19383.25,SELL,3,0.02h,Stop Loss,$49.50,$340.50,$165137.00,326,$340.50
2025-04-01,13:45:00,19400.75,BUY,3,0.02h,Stop Loss,$81.00,$421.50,$165218.00,326,$421.50
2025-04-01,14:00:00,19367.5,SELL,3,0.02h,Stop Loss,$-9.00,$412.50,$165209.00,326,$412.50
2025-04-01,14:31:00,19352.5,BUY,3,0.02h,Stop Loss,$78.00,$490.50,$165287.00,326,$490.50
2025-04-01,15:37:00,19558.0,SELL,3,0.02h,Stop Loss,$96.00,$586.50,$165383.00,326,$586.50
2025-04-01,15:46:00,19585.0,BUY,3,0.02h,Stop Loss,$55.50,$642.00,$165438.50,326,$642.00
2025-04-01,16:27:00,19570.75,SELL,3,0.02h,Stop Loss,$40.50,$682.50,$165479.00,326,$682.50
2025-04-01,16:53:00,19576.75,BUY,3,0.02h,Stop Loss,$84.00,$766.50,$165563.00,326,$766.50
2025-04-01,17:07:00,19535.0,SELL,3,0.02h,Stop Loss,$6.00,$772.50,$165569.00,326,$772.50
2025-04-01,17:41:00,19560.25,BUY,3,0.02h,Stop Loss,$45.00,$817.50,$165614.00,326,$817.50
2025-04-01,17:56:00,19517.75,SELL,3,0.02h,Break Even,$-1.50,$816.00,$165612.50,326,$816.00
2025-04-01,18:45:00,19432.5,BUY,3,0.02h,Stop Loss,$-9.00,$807.00,$165603.50,326,$807.00
2025-04-01,18:48:00,19408.75,SELL,3,0.02h,Stop Loss,$16.50,$823.50,$165620.00,326,$823.50
2025-04-01,18:56:00,19440.25,BUY,3,0.02h,Stop Loss,$31.50,$855.00,$165651.50,326,$855.00
2025-04-01,20:26:00,19594.0,SELL,3,0.02h,Stop Loss,$4.50,$859.50,$165656.00,326,$859.50
2025-04-01,20:47:00,19597.5,BUY,3,0.02h,Stop Loss,$172.50,$1032.00,$165828.50,326,$1032.00
2025-04-01,23:50:00,19649.25,SELL,3,0.02h,Stop Loss,$30.00,$1062.00,$165858.50,326,$1062.00
,,,,,,,,,,,
2025-04-02,00:46:00,19587.75,BUY,3,0.02h,Stop Loss,$10.50,$10.50,$165869.00,327,$10.50
2025-04-02,00:48:00,19581.75,SELL,3,0.02h,Break Even,$-1.50,$9.00,$165867.50,327,$9.00
2025-04-02,01:14:00,19578.5,BUY,3,0.02h,Stop Loss,$3.00,$12.00,$165870.50,327,$12.00
2025-04-02,01:31:00,19574.25,SELL,3,0.02h,Stop Loss,$-9.00,$3.00,$165861.50,327,$3.00
2025-04-02,01:36:00,19584.25,BUY,3,0.02h,Stop Loss,$3.00,$6.00,$165864.50,327,$6.00
2025-04-02,01:41:00,19574.25,SELL,3,0.02h,Stop Loss,$-9.00,$-3.00,$165855.50,327,$-3.00
2025-04-02,01:43:00,19582.25,BUY,3,0.02h,Break Even,$-1.50,$-4.50,$165854.00,327,$-4.50
2025-04-02,02:06:00,19582.75,SELL,3,0.02h,Stop Loss,$13.50,$9.00,$165867.50,327,$9.00
2025-04-02,02:27:00,19588.0,BUY,3,0.02h,Stop Loss,$13.50,$22.50,$165881.00,327,$22.50
2025-04-02,02:45:00,19578.0,SELL,3,0.02h,Break Even,$-1.50,$21.00,$165879.50,327,$21.00
2025-04-02,03:02:00,19584.5,BUY,3,0.02h,Stop Loss,$6.00,$27.00,$165885.50,327,$27.00
2025-04-02,03:08:00,19578.75,SELL,3,0.02h,Stop Loss,$-9.00,$18.00,$165876.50,327,$18.00
2025-04-02,04:19:00,19573.0,BUY,3,0.02h,Stop Loss,$-9.00,$9.00,$165867.50,327,$9.00
2025-04-02,05:07:00,19579.0,SELL,3,0.02h,Stop Loss,$12.00,$21.00,$165879.50,327,$21.00
2025-04-02,05:36:00,19579.0,BUY,3,0.02h,Stop Loss,$-9.00,$12.00,$165870.50,327,$12.00
2025-04-02,05:48:00,19574.25,SELL,3,0.02h,Break Even,$-1.50,$10.50,$165869.00,327,$10.50
2025-04-02,06:17:00,19571.5,BUY,3,0.02h,Stop Loss,$25.50,$36.00,$165894.50,327,$36.00
2025-04-02,06:35:00,19569.25,SELL,3,0.02h,Stop Loss,$10.50,$46.50,$165905.00,327,$46.50
2025-04-02,06:43:00,19576.75,BUY,3,0.02h,Break Even,$-1.50,$45.00,$165903.50,327,$45.00
2025-04-02,06:54:00,19573.25,SELL,3,0.02h,Stop Loss,$-9.00,$36.00,$165894.50,327,$36.00
2025-04-02,06:55:00,19577.75,BUY,3,0.02h,Stop Loss,$-9.00,$27.00,$165885.50,327,$27.00
2025-04-02,06:58:00,19564.5,SELL,3,0.02h,Break Even,$-1.50,$25.50,$165884.00,327,$25.50
2025-04-02,08:20:00,19526.0,BUY,3,0.02h,Break Even,$-1.50,$24.00,$165882.50,327,$24.00
2025-04-02,08:53:00,19531.75,SELL,3,0.02h,Break Even,$-1.50,$22.50,$165881.00,327,$22.50
2025-04-02,09:10:00,19545.75,BUY,3,0.02h,Stop Loss,$3.00,$25.50,$165884.00,327,$25.50
2025-04-02,09:19:00,19532.0,SELL,3,0.02h,Break Even,$-1.50,$24.00,$165882.50,327,$24.00
2025-04-02,09:38:00,19540.75,BUY,3,0.02h,Stop Loss,$-9.00,$15.00,$165873.50,327,$15.00
2025-04-02,09:50:00,19528.0,SELL,3,0.02h,Break Even,$-1.50,$13.50,$165872.00,327,$13.50
2025-04-02,10:51:00,19483.75,BUY,3,0.02h,Break Even,$-1.50,$12.00,$165870.50,327,$12.00
2025-04-02,10:57:00,19471.5,SELL,3,0.02h,Stop Loss,$-9.00,$3.00,$165861.50,327,$3.00
2025-04-02,11:12:00,19480.5,BUY,3,0.02h,Stop Loss,$-9.00,$-6.00,$165852.50,327,$-6.00
2025-04-02,11:16:00,19462.0,SELL,3,0.02h,Stop Loss,$10.50,$4.50,$165863.00,327,$4.50
2025-04-02,11:20:00,19477.25,BUY,3,0.02h,Stop Loss,$-9.00,$-4.50,$165854.00,327,$-4.50
2025-04-02,11:21:00,19465.5,SELL,3,0.02h,Break Even,$-1.50,$-6.00,$165852.50,327,$-6.00
2025-04-02,11:26:00,19474.5,BUY,3,0.02h,Stop Loss,$-9.00,$-15.00,$165843.50,327,$-15.00
2025-04-02,11:29:00,19466.75,SELL,3,0.02h,Stop Loss,$45.00,$30.00,$165888.50,327,$30.00
2025-04-02,12:48:00,19382.5,BUY,3,0.02h,Stop Loss,$45.00,$75.00,$165933.50,327,$75.00
2025-04-02,13:03:00,19367.25,SELL,3,0.02h,Stop Loss,$66.00,$141.00,$165999.50,327,$141.00
2025-04-02,13:34:00,19394.5,BUY,3,0.02h,Stop Loss,$127.50,$268.50,$166127.00,327,$268.50
2025-04-02,14:12:00,19517.75,SELL,3,0.02h,Stop Loss,$30.00,$298.50,$166157.00,327,$298.50
2025-04-02,14:19:00,19568.75,BUY,3,0.02h,Stop Loss,$-9.00,$289.50,$166148.00,327,$289.50
2025-04-02,15:15:00,19584.5,SELL,3,0.02h,Stop Loss,$6.00,$295.50,$166154.00,327,$295.50
2025-04-02,15:21:00,19650.25,BUY,3,0.02h,Stop Loss,$79.50,$375.00,$166233.50,327,$375.00
2025-04-02,15:47:00,19655.0,SELL,3,0.02h,Stop Loss,$94.50,$469.50,$166328.00,327,$469.50
2025-04-02,16:02:00,19673.25,BUY,3,0.02h,Stop Loss,$60.00,$529.50,$166388.00,327,$529.50
2025-04-02,17:30:00,19832.25,SELL,3,0.02h,Stop Loss,$49.50,$579.00,$166437.50,327,$579.00
2025-04-02,18:39:00,19693.0,BUY,3,0.02h,Stop Loss,$19.50,$598.50,$166457.00,327,$598.50
2025-04-02,18:55:00,19674.75,SELL,3,0.02h,Stop Loss,$51.00,$649.50,$166508.00,327,$649.50
2025-04-02,19:10:00,19665.5,BUY,3,0.02h,Break Even,$-1.50,$648.00,$166506.50,327,$648.00
2025-04-02,19:11:00,19661.5,SELL,3,0.02h,Stop Loss,$82.50,$730.50,$166589.00,327,$730.50
2025-04-02,19:27:00,19670.25,BUY,3,0.02h,Stop Loss,$60.00,$790.50,$166649.00,327,$790.50
2025-04-02,20:08:00,19740.25,SELL,3,0.02h,Stop Loss,$100.50,$891.00,$166749.50,327,$891.00
2025-04-02,20:14:00,19925.25,BUY,3,0.02h,Stop Loss,$324.00,$1215.00,$167073.50,327,$1215.00
2025-04-02,20:28:00,19606.0,SELL,3,0.02h,Stop Loss,$915.00,$2130.00,$167988.50,327,$2130.00
,,,,,,,,,,,
2025-04-03,00:02:00,18896.75,BUY,3,0.02h,Stop Loss,$49.50,$49.50,$168038.00,328,$49.50
2025-04-03,00:52:00,19015.0,SELL,3,0.02h,Stop Loss,$61.50,$111.00,$168099.50,328,$111.00
2025-04-03,01:07:00,19022.5,BUY,3,0.02h,Stop Loss,$120.00,$231.00,$168219.50,328,$231.00
2025-04-03,01:35:00,19033.5,SELL,3,0.02h,Stop Loss,$30.00,$261.00,$168249.50,328,$261.00
2025-04-03,01:42:00,19053.5,BUY,3,0.02h,Break Even,$-1.50,$259.50,$168248.00,328,$259.50
2025-04-03,02:13:00,19078.5,SELL,3,0.02h,Stop Loss,$-9.00,$250.50,$168239.00,328,$250.50
2025-04-03,02:16:00,19101.5,BUY,3,0.02h,Stop Loss,$39.00,$289.50,$168278.00,328,$289.50
2025-04-03,02:19:00,19071.25,SELL,3,0.02h,Stop Loss,$46.50,$336.00,$168324.50,328,$336.00
2025-04-03,02:25:00,19097.5,BUY,3,0.02h,Stop Loss,$18.00,$354.00,$168342.50,328,$354.00
2025-04-03,02:35:00,19084.25,SELL,3,0.02h,Break Even,$-1.50,$352.50,$168341.00,328,$352.50
2025-04-03,02:48:00,19105.25,BUY,3,0.02h,Stop Loss,$-9.00,$343.50,$168332.00,328,$343.50
2025-04-03,03:13:00,19099.0,SELL,3,0.02h,Stop Loss,$54.00,$397.50,$168386.00,328,$397.50
2025-04-03,03:33:00,19117.25,BUY,3,0.02h,Break Even,$-1.50,$396.00,$168384.50,328,$396.00
2025-04-03,03:39:00,19099.75,SELL,3,0.02h,Stop Loss,$12.00,$408.00,$168396.50,328,$408.00
2025-04-03,03:59:00,19098.25,BUY,3,0.02h,Stop Loss,$24.00,$432.00,$168420.50,328,$432.00
2025-04-03,04:28:00,19109.5,SELL,3,0.02h,Stop Loss,$12.00,$444.00,$168432.50,328,$444.00
2025-04-03,04:36:00,19129.75,BUY,3,0.02h,Stop Loss,$15.00,$459.00,$168447.50,328,$459.00
2025-04-03,04:48:00,19113.25,SELL,3,0.02h,Break Even,$-1.50,$457.50,$168446.00,328,$457.50
2025-04-03,04:53:00,19132.75,BUY,3,0.02h,Break Even,$-1.50,$456.00,$168444.50,328,$456.00
2025-04-03,04:57:00,19121.5,SELL,3,0.02h,Break Even,$-1.50,$454.50,$168443.00,328,$454.50
2025-04-03,05:03:00,19130.0,BUY,3,0.02h,Break Even,$-1.50,$453.00,$168441.50,328,$453.00
2025-04-03,05:17:00,19111.0,SELL,3,0.02h,Stop Loss,$18.00,$471.00,$168459.50,328,$471.00
2025-04-03,05:46:00,19100.25,BUY,3,0.02h,Stop Loss,$6.00,$477.00,$168465.50,328,$477.00
2025-04-03,05:49:00,19056.0,SELL,3,0.02h,Stop Loss,$57.00,$534.00,$168522.50,328,$534.00
2025-04-03,06:10:00,19067.0,BUY,3,0.02h,Stop Loss,$36.00,$570.00,$168558.50,328,$570.00
2025-04-03,06:17:00,19048.0,SELL,3,0.02h,Break Even,$-1.50,$568.50,$168557.00,328,$568.50
2025-04-03,06:20:00,19069.75,BUY,3,0.02h,Break Even,$-1.50,$567.00,$168555.50,328,$567.00
2025-04-03,06:57:00,19062.0,SELL,3,0.02h,Stop Loss,$55.50,$622.50,$168611.00,328,$622.50
2025-04-03,07:08:00,19090.5,BUY,3,0.02h,Stop Loss,$16.50,$639.00,$168627.50,328,$639.00
2025-04-03,07:15:00,19040.25,SELL,3,0.02h,Break Even,$-1.50,$637.50,$168626.00,328,$637.50
2025-04-03,07:24:00,19100.75,BUY,3,0.02h,Stop Loss,$-9.00,$628.50,$168617.00,328,$628.50
2025-04-03,07:39:00,19063.75,SELL,3,0.02h,Stop Loss,$37.50,$666.00,$168654.50,328,$666.00
2025-04-03,07:49:00,19083.25,BUY,3,0.02h,Break Even,$-1.50,$664.50,$168653.00,328,$664.50
2025-04-03,07:50:00,19071.5,SELL,3,0.02h,Stop Loss,$27.00,$691.50,$168680.00,328,$691.50
2025-04-03,07:58:00,19090.0,BUY,3,0.02h,Stop Loss,$31.50,$723.00,$168711.50,328,$723.00
2025-04-03,08:47:00,19125.25,SELL,3,0.02h,Break Even,$-1.50,$721.50,$168710.00,328,$721.50
2025-04-03,08:58:00,19158.25,BUY,3,0.02h,Stop Loss,$7.50,$729.00,$168717.50,328,$729.00
2025-04-03,09:09:00,19135.25,SELL,3,0.02h,Stop Loss,$34.50,$763.50,$168752.00,328,$763.50
2025-04-03,10:46:00,19018.25,BUY,3,0.02h,Stop Loss,$-9.00,$754.50,$168743.00,328,$754.50
2025-04-03,10:49:00,18988.75,SELL,3,0.02h,Stop Loss,$138.00,$892.50,$168881.00,328,$892.50
2025-04-03,11:09:00,19000.25,BUY,3,0.02h,Break Even,$-1.50,$891.00,$168879.50,328,$891.00
2025-04-03,11:24:00,18988.5,SELL,3,0.02h,Stop Loss,$-9.00,$882.00,$168870.50,328,$882.00
2025-04-03,11:44:00,18986.5,BUY,3,0.02h,Stop Loss,$54.00,$936.00,$168924.50,328,$936.00
2025-04-03,11:59:00,18974.5,SELL,3,0.02h,Stop Loss,$-9.00,$927.00,$168915.50,328,$927.00
2025-04-03,12:06:00,18998.75,BUY,3,0.02h,Stop Loss,$79.50,$1006.50,$168995.00,328,$1006.50
2025-04-03,12:24:00,18999.75,SELL,3,0.02h,Stop Loss,$34.50,$1041.00,$169029.50,328,$1041.00
2025-04-03,13:15:00,18882.0,BUY,3,0.02h,Stop Loss,$31.50,$1072.50,$169061.00,328,$1072.50
2025-04-03,13:22:00,18864.75,SELL,3,0.02h,Stop Loss,$-9.00,$1063.50,$169052.00,328,$1063.50
2025-04-03,13:26:00,18905.5,BUY,3,0.02h,Stop Loss,$43.50,$1107.00,$169095.50,328,$1107.00
2025-04-03,14:02:00,18978.25,SELL,3,0.02h,Stop Loss,$75.00,$1182.00,$169170.50,328,$1182.00
2025-04-03,14:31:00,18929.25,BUY,3,0.02h,Stop Loss,$10.50,$1192.50,$169181.00,328,$1192.50
2025-04-03,14:35:00,18893.0,SELL,3,0.02h,Stop Loss,$48.00,$1240.50,$169229.00,328,$1240.50
2025-04-03,15:15:00,18797.75,BUY,3,0.02h,Stop Loss,$189.00,$1429.50,$169418.00,328,$1429.50
2025-04-03,15:53:00,18844.0,SELL,3,0.02h,Stop Loss,$13.50,$1443.00,$169431.50,328,$1443.00
2025-04-03,15:55:00,18893.25,BUY,3,0.02h,Stop Loss,$51.00,$1494.00,$169482.50,328,$1494.00
2025-04-03,16:35:00,18902.25,SELL,3,0.02h,Stop Loss,$10.50,$1504.50,$169493.00,328,$1504.50
2025-04-03,16:44:00,18958.5,BUY,3,0.02h,Stop Loss,$10.50,$1515.00,$169503.50,328,$1515.00
2025-04-03,16:45:00,18916.0,SELL,3,0.02h,Stop Loss,$33.00,$1548.00,$169536.50,328,$1548.00
2025-04-03,17:38:00,18876.5,BUY,3,0.02h,Stop Loss,$96.00,$1644.00,$169632.50,328,$1644.00
2025-04-03,17:52:00,18846.5,SELL,3,0.02h,Break Even,$-1.50,$1642.50,$169631.00,328,$1642.50
2025-04-03,18:38:00,18803.25,BUY,3,0.02h,Stop Loss,$39.00,$1681.50,$169670.00,328,$1681.50
2025-04-03,19:12:00,18817.0,SELL,3,0.02h,Break Even,$-1.50,$1680.00,$169668.50,328,$1680.00
2025-04-03,20:56:00,18650.0,BUY,3,0.02h,Break Even,$-1.50,$1678.50,$169667.00,328,$1678.50
2025-04-03,23:03:00,18633.25,SELL,3,0.02h,Stop Loss,$24.00,$1702.50,$169691.00,328,$1702.50
2025-04-03,23:26:00,18650.0,BUY,3,0.02h,Stop Loss,$-9.00,$1693.50,$169682.00,328,$1693.50
2025-04-03,23:58:00,18660.25,SELL,3,0.02h,Stop Loss,$36.00,$1729.50,$169718.00,328,$1729.50
,,,,,,,,,,,
2025-04-04,00:02:00,18680.75,BUY,3,0.02h,Stop Loss,$27.00,$27.00,$169745.00,329,$27.00
2025-04-04,00:27:00,18683.25,SELL,3,0.02h,Break Even,$-1.50,$25.50,$169743.50,329,$25.50
2025-04-04,00:28:00,18690.25,BUY,3,0.02h,Stop Loss,$48.00,$73.50,$169791.50,329,$73.50
2025-04-04,00:36:00,18670.0,SELL,3,0.02h,Stop Loss,$-9.00,$64.50,$169782.50,329,$64.50
2025-04-04,01:02:00,18680.75,BUY,3,0.02h,Break Even,$-1.50,$63.00,$169781.00,329,$63.00
2025-04-04,01:13:00,18669.5,SELL,3,0.02h,Break Even,$-1.50,$61.50,$169779.50,329,$61.50
2025-04-04,01:21:00,18690.0,BUY,3,0.02h,Stop Loss,$28.50,$90.00,$169808.00,329,$90.00
2025-04-04,01:32:00,18668.5,SELL,3,0.02h,Stop Loss,$45.00,$135.00,$169853.00,329,$135.00
2025-04-04,02:09:00,18662.5,BUY,3,0.02h,Stop Loss,$21.00,$156.00,$169874.00,329,$156.00
2025-04-04,02:27:00,18660.0,SELL,3,0.02h,Break Even,$-1.50,$154.50,$169872.50,329,$154.50
2025-04-04,02:37:00,18670.0,BUY,3,0.02h,Stop Loss,$10.50,$165.00,$169883.00,329,$165.00
2025-04-04,02:44:00,18658.0,SELL,3,0.02h,Stop Loss,$-9.00,$156.00,$169874.00,329,$156.00
2025-04-04,04:00:00,18561.0,BUY,3,0.02h,Break Even,$-1.50,$154.50,$169872.50,329,$154.50
2025-04-04,04:08:00,18552.75,SELL,3,0.02h,Stop Loss,$6.00,$160.50,$169878.50,329,$160.50
2025-04-04,04:10:00,18564.75,BUY,3,0.02h,Break Even,$-1.50,$159.00,$169877.00,329,$159.00
2025-04-04,04:19:00,18552.25,SELL,3,0.02h,Break Even,$-1.50,$157.50,$169875.50,329,$157.50
2025-04-04,05:11:00,18512.25,BUY,3,0.02h,Stop Loss,$-9.00,$148.50,$169866.50,329,$148.50
2025-04-04,06:18:00,18632.0,SELL,3,0.02h,Stop Loss,$13.50,$162.00,$169880.00,329,$162.00
2025-04-04,06:28:00,18655.25,BUY,3,0.02h,Stop Loss,$39.00,$201.00,$169919.00,329,$201.00
2025-04-04,06:35:00,18636.5,SELL,3,0.02h,Stop Loss,$57.00,$258.00,$169976.00,329,$258.00
2025-04-04,07:14:00,18632.25,BUY,3,0.02h,Stop Loss,$70.50,$328.50,$170046.50,329,$328.50
2025-04-04,07:33:00,18609.0,SELL,3,0.02h,Stop Loss,$7.50,$336.00,$170054.00,329,$336.00
2025-04-04,08:20:00,18614.25,BUY,3,0.02h,Stop Loss,$166.50,$502.50,$170220.50,329,$502.50
2025-04-04,08:35:00,18591.75,SELL,3,0.02h,Stop Loss,$39.00,$541.50,$170259.50,329,$541.50
2025-04-04,08:52:00,18611.0,BUY,3,0.02h,Break Even,$-1.50,$540.00,$170258.00,329,$540.00
2025-04-04,08:56:00,18586.0,SELL,3,0.02h,Stop Loss,$69.00,$609.00,$170327.00,329,$609.00
2025-04-04,09:21:00,18585.0,BUY,3,0.02h,Stop Loss,$-9.00,$600.00,$170318.00,329,$600.00
2025-04-04,09:25:00,18577.25,SELL,3,0.02h,Stop Loss,$10.50,$610.50,$170328.50,329,$610.50
2025-04-04,09:39:00,18584.0,BUY,3,0.02h,Break Even,$-1.50,$609.00,$170327.00,329,$609.00
2025-04-04,09:55:00,18566.5,SELL,3,0.02h,Stop Loss,$24.00,$633.00,$170351.00,329,$633.00
2025-04-04,10:02:00,18582.5,BUY,3,0.02h,Stop Loss,$76.50,$709.50,$170427.50,329,$709.50
2025-04-04,10:07:00,18517.5,SELL,3,0.02h,Break Even,$-1.50,$708.00,$170426.00,329,$708.00
2025-04-04,11:52:00,18004.0,BUY,3,0.02h,Stop Loss,$36.00,$744.00,$170462.00,329,$744.00
2025-04-04,12:40:00,18084.0,SELL,3,0.02h,Stop Loss,$79.50,$823.50,$170541.50,329,$823.50
2025-04-04,12:44:00,18140.0,BUY,3,0.02h,Stop Loss,$339.00,$1162.50,$170880.50,329,$1162.50
2025-04-04,13:16:00,18189.75,SELL,3,0.02h,Stop Loss,$213.00,$1375.50,$171093.50,329,$1375.50
2025-04-04,13:53:00,18144.5,BUY,3,0.02h,Stop Loss,$288.00,$1663.50,$171381.50,329,$1663.50
2025-04-04,13:56:00,18080.0,SELL,3,0.02h,Stop Loss,$57.00,$1720.50,$171438.50,329,$1720.50
2025-04-04,13:57:00,18143.5,BUY,3,0.02h,Stop Loss,$312.00,$2032.50,$171750.50,329,$2032.50
2025-04-04,14:08:00,18099.0,SELL,3,0.02h,Stop Loss,$178.50,$2211.00,$171929.00,329,$2211.00
2025-04-04,15:01:00,17876.25,BUY,3,0.02h,Stop Loss,$690.00,$2901.00,$172619.00,329,$2901.00
2025-04-04,15:29:00,17994.0,SELL,3,0.02h,Stop Loss,$351.00,$3252.00,$172970.00,329,$3252.00
2025-04-04,15:50:00,18001.0,BUY,3,0.02h,Break Even,$-1.50,$3250.50,$172968.50,329,$3250.50
2025-04-04,15:59:00,17889.75,SELL,3,0.02h,Stop Loss,$73.50,$3324.00,$173042.00,329,$3324.00
2025-04-04,16:42:00,17823.25,BUY,3,0.02h,Stop Loss,$64.50,$3388.50,$173106.50,329,$3388.50
2025-04-04,16:45:00,17755.75,SELL,3,0.02h,Stop Loss,$79.50,$3468.00,$173186.00,329,$3468.00
2025-04-04,17:03:00,17803.25,BUY,3,0.02h,Stop Loss,$15.00,$3483.00,$173201.00,329,$3483.00
2025-04-04,17:07:00,17732.75,SELL,3,0.02h,Break Even,$-1.50,$3481.50,$173199.50,329,$3481.50
2025-04-04,17:27:00,17735.25,BUY,3,0.02h,Stop Loss,$54.00,$3535.50,$173253.50,329,$3535.50
2025-04-04,17:32:00,17675.25,SELL,3,0.02h,Stop Loss,$22.50,$3558.00,$173276.00,329,$3558.00
2025-04-04,17:34:00,17725.75,BUY,3,0.02h,Stop Loss,$189.00,$3747.00,$173465.00,329,$3747.00
2025-04-04,18:11:00,17797.25,SELL,3,0.02h,Stop Loss,$135.00,$3882.00,$173600.00,329,$3882.00
2025-04-04,18:53:00,17665.0,BUY,3,0.02h,Stop Loss,$61.50,$3943.50,$173661.50,329,$3943.50
2025-04-04,19:01:00,17617.75,SELL,3,0.02h,Stop Loss,$187.50,$4131.00,$173849.00,329,$4131.00
2025-04-04,19:12:00,17661.75,BUY,3,0.02h,Stop Loss,$190.50,$4321.50,$174039.50,329,$4321.50
2025-04-04,19:49:00,17720.75,SELL,3,0.02h,Stop Loss,$88.50,$4410.00,$174128.00,329,$4410.00
2025-04-04,20:40:00,17484.0,BUY,3,0.02h,Stop Loss,$24.00,$4434.00,$174152.00,329,$4434.00
,,,,,,,,,,,
2025-04-07,00:00:00,16720.75,SELL,3,0.02h,Break Even,$-1.50,$-1.50,$174150.50,330,$-1.50
2025-04-07,00:39:00,16757.25,BUY,3,0.02h,Stop Loss,$90.00,$88.50,$174240.50,330,$88.50
2025-04-07,00:46:00,16701.0,SELL,3,0.02h,Stop Loss,$72.00,$160.50,$174312.50,330,$160.50
2025-04-07,00:55:00,16735.75,BUY,3,0.02h,Stop Loss,$54.00,$214.50,$174366.50,330,$214.50
2025-04-07,01:42:00,16861.0,SELL,3,0.02h,Stop Loss,$285.00,$499.50,$174651.50,330,$499.50
2025-04-07,01:48:00,16915.25,BUY,3,0.02h,Stop Loss,$25.50,$525.00,$174677.00,330,$525.00
2025-04-07,02:25:00,16924.5,SELL,3,0.02h,Stop Loss,$60.00,$585.00,$174737.00,330,$585.00
2025-04-07,02:52:00,16930.5,BUY,3,0.02h,Stop Loss,$16.50,$601.50,$174753.50,330,$601.50
2025-04-07,02:54:00,16900.5,SELL,3,0.02h,Stop Loss,$79.50,$681.00,$174833.00,330,$681.00
2025-04-07,03:53:00,16823.25,BUY,3,0.02h,Stop Loss,$52.50,$733.50,$174885.50,330,$733.50
2025-04-07,04:13:00,16796.0,SELL,3,0.02h,Stop Loss,$66.00,$799.50,$174951.50,330,$799.50
2025-04-07,04:51:00,16748.5,BUY,3,0.02h,Stop Loss,$22.50,$822.00,$174974.00,330,$822.00
2025-04-07,05:31:00,16785.5,SELL,3,0.02h,Stop Loss,$51.00,$873.00,$175025.00,330,$873.00
2025-04-07,06:02:00,16759.75,BUY,3,0.02h,Stop Loss,$91.50,$964.50,$175116.50,330,$964.50
2025-04-07,06:12:00,16726.75,SELL,3,0.02h,Stop Loss,$34.50,$999.00,$175151.00,330,$999.00
2025-04-07,07:14:00,16575.75,BUY,3,0.02h,Stop Loss,$199.50,$1198.50,$175350.50,330,$1198.50
2025-04-07,07:30:00,16581.25,SELL,3,0.02h,Stop Loss,$190.50,$1389.00,$175541.00,330,$1389.00
2025-04-07,07:40:00,16628.25,BUY,3,0.02h,Stop Loss,$106.50,$1495.50,$175647.50,330,$1495.50
2025-04-07,08:56:00,16887.25,SELL,3,0.02h,Stop Loss,$180.00,$1675.50,$175827.50,330,$1675.50
2025-04-07,09:33:00,16827.25,BUY,3,0.02h,Stop Loss,$76.50,$1752.00,$175904.00,330,$1752.00
2025-04-07,10:02:00,16857.25,SELL,3,0.02h,Stop Loss,$-9.00,$1743.00,$175895.00,330,$1743.00
2025-04-07,10:03:00,16999.75,BUY,3,0.02h,Stop Loss,$64.50,$1807.50,$175959.50,330,$1807.50
2025-04-07,10:56:00,17093.5,SELL,3,0.02h,Break Even,$-1.50,$1806.00,$175958.00,330,$1806.00
2025-04-07,11:08:00,17166.75,BUY,3,0.02h,Stop Loss,$157.50,$1963.50,$176115.50,330,$1963.50
2025-04-07,11:18:00,17136.0,SELL,3,0.02h,Break Even,$-1.50,$1962.00,$176114.00,330,$1962.00
2025-04-07,12:01:00,17127.75,BUY,3,0.02h,Stop Loss,$82.50,$2044.50,$176196.50,330,$2044.50
2025-04-07,12:07:00,17028.75,SELL,3,0.02h,Stop Loss,$-9.00,$2035.50,$176187.50,330,$2035.50
2025-04-07,12:28:00,17037.75,BUY,3,0.02h,Stop Loss,$675.00,$2710.50,$176862.50,330,$2710.50
2025-04-07,12:46:00,17013.75,SELL,3,0.02h,Stop Loss,$10.50,$2721.00,$176873.00,330,$2721.00
2025-04-07,12:52:00,17124.5,BUY,3,0.02h,Stop Loss,$280.50,$3001.50,$177153.50,330,$3001.50
2025-04-07,13:06:00,17114.25,SELL,3,0.02h,Stop Loss,$348.00,$3349.50,$177501.50,330,$3349.50
2025-04-07,13:51:00,16978.25,BUY,3,0.02h,Stop Loss,$280.50,$3630.00,$177782.00,330,$3630.00
2025-04-07,14:29:00,17392.5,SELL,3,0.02h,Stop Loss,$294.00,$3924.00,$178076.00,330,$3924.00
2025-04-07,14:51:00,17598.75,BUY,3,0.02h,Stop Loss,$43.50,$3967.50,$178119.50,330,$3967.50
2025-04-07,15:11:00,17551.25,SELL,3,0.02h,Stop Loss,$147.00,$4114.50,$178266.50,330,$4114.50
2025-04-07,15:39:00,17426.5,BUY,3,0.02h,Stop Loss,$9.00,$4123.50,$178275.50,330,$4123.50
2025-04-07,16:00:00,17390.75,SELL,3,0.02h,Stop Loss,$360.00,$4483.50,$178635.50,330,$4483.50
2025-04-07,16:27:00,17427.5,BUY,3,0.02h,Stop Loss,$15.00,$4498.50,$178650.50,330,$4498.50
2025-04-07,16:44:00,17327.75,SELL,3,0.02h,Stop Loss,$112.50,$4611.00,$178763.00,330,$4611.00
2025-04-07,17:02:00,17453.5,BUY,3,0.02h,Stop Loss,$3.00,$4614.00,$178766.00,330,$4614.00
2025-04-07,17:07:00,17297.25,SELL,3,0.02h,Stop Loss,$286.50,$4900.50,$179052.50,330,$4900.50
2025-04-07,17:13:00,17386.0,BUY,3,0.02h,Stop Loss,$180.00,$5080.50,$179232.50,330,$5080.50
2025-04-07,18:12:00,17680.0,SELL,3,0.02h,Stop Loss,$379.50,$5460.00,$179612.00,330,$5460.00
2025-04-07,18:19:00,17795.25,BUY,3,0.02h,Stop Loss,$40.50,$5500.50,$179652.50,330,$5500.50
2025-04-07,18:28:00,17652.5,SELL,3,0.02h,Stop Loss,$277.50,$5778.00,$179930.00,330,$5778.00
2025-04-07,18:40:00,17713.25,BUY,3,0.02h,Stop Loss,$172.50,$5950.50,$180102.50,330,$5950.50
2025-04-07,18:46:00,17653.5,SELL,3,0.02h,Stop Loss,$33.00,$5983.50,$180135.50,330,$5983.50
2025-04-07,19:34:00,17608.5,BUY,3,0.02h,Stop Loss,$169.50,$6153.00,$180305.00,330,$6153.00
2025-04-07,19:45:00,17461.5,SELL,3,0.02h,Stop Loss,$24.00,$6177.00,$180329.00,330,$6177.00
2025-04-07,19:58:00,17539.5,BUY,3,0.02h,Stop Loss,$139.50,$6316.50,$180468.50,330,$6316.50
2025-04-07,20:28:00,17652.25,SELL,3,0.02h,Stop Loss,$-9.00,$6307.50,$180459.50,330,$6307.50
2025-04-07,23:00:00,17748.0,BUY,3,0.02h,Stop Loss,$4.50,$6312.00,$180464.00,330,$6312.00
2025-04-07,23:36:00,17740.75,SELL,3,0.02h,Break Even,$-1.50,$6310.50,$180462.50,330,$6310.50
2025-04-07,23:51:00,17767.25,BUY,3,0.02h,Stop Loss,$-9.00,$6301.50,$180453.50,330,$6301.50
2025-04-07,23:57:00,17744.5,SELL,3,0.02h,Stop Loss,$-9.00,$6292.50,$180444.50,330,$6292.50
2025-04-07,23:58:00,17767.75,BUY,3,0.02h,Stop Loss,$27.00,$6319.50,$180471.50,330,$6319.50
,,,,,,,,,,,
2025-04-08,00:02:00,17728.25,SELL,3,0.02h,Stop Loss,$43.50,$43.50,$180515.00,331,$43.50
2025-04-08,00:10:00,17767.75,BUY,3,0.02h,Stop Loss,$100.50,$144.00,$180615.50,331,$144.00
2025-04-08,00:46:00,17795.5,SELL,3,0.02h,Stop Loss,$51.00,$195.00,$180666.50,331,$195.00
2025-04-08,01:27:00,17739.75,BUY,3,0.02h,Stop Loss,$34.50,$229.50,$180701.00,331,$229.50
2025-04-08,02:08:00,17823.0,SELL,3,0.02h,Break Even,$-1.50,$228.00,$180699.50,331,$228.00
2025-04-08,02:12:00,17852.0,BUY,3,0.02h,Stop Loss,$-9.00,$219.00,$180690.50,331,$219.00
2025-04-08,02:22:00,17836.75,SELL,3,0.02h,Stop Loss,$-9.00,$210.00,$180681.50,331,$210.00
2025-04-08,02:23:00,17846.0,BUY,3,0.02h,Stop Loss,$-9.00,$201.00,$180672.50,331,$201.00
2025-04-08,02:24:00,17844.0,SELL,3,0.02h,Stop Loss,$4.50,$205.50,$180677.00,331,$205.50
2025-04-08,02:25:00,17850.75,BUY,3,0.02h,Stop Loss,$10.50,$216.00,$180687.50,331,$216.00
2025-04-08,02:31:00,17834.0,SELL,3,0.02h,Stop Loss,$9.00,$225.00,$180696.50,331,$225.00
2025-04-08,02:34:00,17853.75,BUY,3,0.02h,Break Even,$-1.50,$223.50,$180695.00,331,$223.50
2025-04-08,02:38:00,17841.0,SELL,3,0.02h,Stop Loss,$4.50,$228.00,$180699.50,331,$228.00
2025-04-08,03:10:00,17830.5,BUY,3,0.02h,Stop Loss,$21.00,$249.00,$180720.50,331,$249.00
2025-04-08,03:13:00,17814.0,SELL,3,0.02h,Stop Loss,$31.50,$280.50,$180752.00,331,$280.50
2025-04-08,04:03:00,17774.25,BUY,3,0.02h,Break Even,$-1.50,$279.00,$180750.50,331,$279.00
2025-04-08,04:04:00,17763.25,SELL,3,0.02h,Stop Loss,$24.00,$303.00,$180774.50,331,$303.00
2025-04-08,04:12:00,17774.75,BUY,3,0.02h,Stop Loss,$61.50,$364.50,$180836.00,331,$364.50
2025-04-08,04:29:00,17775.75,SELL,3,0.02h,Break Even,$-1.50,$363.00,$180834.50,331,$363.00
2025-04-08,04:58:00,17775.75,BUY,3,0.02h,Break Even,$-1.50,$361.50,$180833.00,331,$361.50
2025-04-08,05:06:00,17727.25,SELL,3,0.02h,Stop Loss,$30.00,$391.50,$180863.00,331,$391.50
2025-04-08,05:33:00,17717.25,BUY,3,0.02h,Stop Loss,$31.50,$423.00,$180894.50,331,$423.00
2025-04-08,05:52:00,17714.0,SELL,3,0.02h,Stop Loss,$-9.00,$414.00,$180885.50,331,$414.00
2025-04-08,05:55:00,17746.5,BUY,3,0.02h,Break Even,$-1.50,$412.50,$180884.00,331,$412.50
2025-04-08,06:16:00,17735.0,SELL,3,0.02h,Stop Loss,$28.50,$441.00,$180912.50,331,$441.00
2025-04-08,06:38:00,17742.75,BUY,3,0.02h,Break Even,$-1.50,$439.50,$180911.00,331,$439.50
2025-04-08,07:49:00,17818.0,SELL,3,0.02h,Stop Loss,$-9.00,$430.50,$180902.00,331,$430.50
2025-04-08,07:55:00,17855.25,BUY,3,0.02h,Stop Loss,$33.00,$463.50,$180935.00,331,$463.50
2025-04-08,08:09:00,17838.0,SELL,3,0.02h,Stop Loss,$103.50,$567.00,$181038.50,331,$567.00
2025-04-08,08:40:00,17807.75,BUY,3,0.02h,Stop Loss,$45.00,$612.00,$181083.50,331,$612.00
2025-04-08,09:20:00,17795.25,SELL,3,0.02h,Stop Loss,$67.50,$679.50,$181151.00,331,$679.50
2025-04-08,09:43:00,17804.25,BUY,3,0.02h,Break Even,$-1.50,$678.00,$181149.50,331,$678.00
2025-04-08,09:48:00,17768.5,SELL,3,0.02h,Stop Loss,$3.00,$681.00,$181152.50,331,$681.00
2025-04-08,10:29:00,17748.25,BUY,3,0.02h,Break Even,$-1.50,$679.50,$181151.00,331,$679.50
2025-04-08,11:15:00,17775.75,SELL,3,0.02h,Stop Loss,$84.00,$763.50,$181235.00,331,$763.50
2025-04-08,11:18:00,17828.5,BUY,3,0.02h,Stop Loss,$138.00,$901.50,$181373.00,331,$901.50
2025-04-08,12:24:00,17991.0,SELL,3,0.02h,Stop Loss,$7.50,$909.00,$181380.50,331,$909.00
2025-04-08,12:59:00,17989.75,BUY,3,0.02h,Stop Loss,$18.00,$927.00,$181398.50,331,$927.00
2025-04-08,13:40:00,18103.25,SELL,3,0.02h,Stop Loss,$159.00,$1086.00,$181557.50,331,$1086.00
2025-04-08,13:44:00,18145.75,BUY,3,0.02h,Stop Loss,$57.00,$1143.00,$181614.50,331,$1143.00
2025-04-08,14:33:00,18287.25,SELL,3,0.02h,Stop Loss,$112.50,$1255.50,$181727.00,331,$1255.50
2025-04-08,14:35:00,18310.75,BUY,3,0.02h,Stop Loss,$67.50,$1323.00,$181794.50,331,$1323.00
2025-04-08,14:43:00,18274.75,SELL,3,0.02h,Stop Loss,$208.50,$1531.50,$182003.00,331,$1531.50
2025-04-08,15:39:00,18091.0,BUY,3,0.02h,Stop Loss,$66.00,$1597.50,$182069.00,331,$1597.50
2025-04-08,15:51:00,17998.25,SELL,3,0.02h,Stop Loss,$67.50,$1665.00,$182136.50,331,$1665.00
2025-04-08,16:13:00,18052.75,BUY,3,0.02h,Stop Loss,$69.00,$1734.00,$182205.50,331,$1734.00
2025-04-08,16:15:00,17999.75,SELL,3,0.02h,Stop Loss,$97.50,$1831.50,$182303.00,331,$1831.50
2025-04-08,17:41:00,17651.25,BUY,3,0.02h,Stop Loss,$166.50,$1998.00,$182469.50,331,$1998.00
2025-04-08,18:07:00,17595.5,SELL,3,0.02h,Stop Loss,$207.00,$2205.00,$182676.50,331,$2205.00
2025-04-08,18:21:00,17626.0,BUY,3,0.02h,Break Even,$-1.50,$2203.50,$182675.00,331,$2203.50
2025-04-08,18:22:00,17592.25,SELL,3,0.02h,Stop Loss,$94.50,$2298.00,$182769.50,331,$2298.00
2025-04-08,19:55:00,17227.5,BUY,3,0.02h,Stop Loss,$-9.00,$2289.00,$182760.50,331,$2289.00
2025-04-08,20:22:00,17214.75,SELL,3,0.02h,Stop Loss,$123.00,$2412.00,$182883.50,331,$2412.00
2025-04-08,20:47:00,17205.5,BUY,3,0.02h,Stop Loss,$63.00,$2475.00,$182946.50,331,$2475.00
2025-04-08,23:00:00,17067.25,SELL,3,0.02h,Stop Loss,$114.00,$2589.00,$183060.50,331,$2589.00
2025-04-08,23:49:00,16972.5,BUY,3,0.02h,Stop Loss,$10.50,$2599.50,$183071.00,331,$2599.50
,,,,,,,,,,,
2025-04-09,00:06:00,16938.0,SELL,3,0.02h,Stop Loss,$73.50,$73.50,$183144.50,332,$73.50
2025-04-09,00:45:00,16916.0,BUY,3,0.02h,Break Even,$-1.50,$72.00,$183143.00,332,$72.00
2025-04-09,01:24:00,16893.25,SELL,3,0.02h,Stop Loss,$6.00,$78.00,$183149.00,332,$78.00
2025-04-09,01:35:00,16943.5,BUY,3,0.02h,Stop Loss,$84.00,$162.00,$183233.00,332,$162.00
2025-04-09,02:42:00,17140.75,SELL,3,0.02h,Stop Loss,$33.00,$195.00,$183266.00,332,$195.00
2025-04-09,04:47:00,16884.0,BUY,3,0.02h,Stop Loss,$31.50,$226.50,$183297.50,332,$226.50
2025-04-09,04:59:00,16818.75,SELL,3,0.02h,Break Even,$-1.50,$225.00,$183296.00,332,$225.00
2025-04-09,05:14:00,16837.5,BUY,3,0.02h,Stop Loss,$57.00,$282.00,$183353.00,332,$282.00
2025-04-09,05:34:00,16832.0,SELL,3,0.02h,Stop Loss,$57.00,$339.00,$183410.00,332,$339.00
2025-04-09,05:52:00,16845.0,BUY,3,0.02h,Stop Loss,$24.00,$363.00,$183434.00,332,$363.00
2025-04-09,06:31:00,16938.75,SELL,3,0.02h,Stop Loss,$19.50,$382.50,$183453.50,332,$382.50
2025-04-09,06:45:00,17004.0,BUY,3,0.02h,Stop Loss,$123.00,$505.50,$183576.50,332,$505.50
2025-04-09,08:06:00,17298.75,SELL,3,0.02h,Stop Loss,$199.50,$705.00,$183776.00,332,$705.00
2025-04-09,08:26:00,17342.5,BUY,3,0.02h,Stop Loss,$6.00,$711.00,$183782.00,332,$711.00
2025-04-09,08:29:00,17266.25,SELL,3,0.02h,Stop Loss,$130.50,$841.50,$183912.50,332,$841.50
2025-04-09,08:45:00,17278.5,BUY,3,0.02h,Stop Loss,$48.00,$889.50,$183960.50,332,$889.50
2025-04-09,09:25:00,17317.75,SELL,3,0.02h,Stop Loss,$178.50,$1068.00,$184139.00,332,$1068.00
2025-04-09,10:42:00,17238.0,BUY,3,0.02h,Stop Loss,$-9.00,$1059.00,$184130.00,332,$1059.00
2025-04-09,11:01:00,17019.0,SELL,3,0.02h,Stop Loss,$-9.00,$1050.00,$184121.00,332,$1050.00
2025-04-09,12:05:00,16999.75,BUY,3,0.02h,Stop Loss,$24.00,$1074.00,$184145.00,332,$1074.00
2025-04-09,12:06:00,16949.75,SELL,3,0.02h,Stop Loss,$130.50,$1204.50,$184275.50,332,$1204.50
2025-04-09,12:12:00,17000.0,BUY,3,0.02h,Break Even,$-1.50,$1203.00,$184274.00,332,$1203.00
2025-04-09,12:21:00,16954.75,SELL,3,0.02h,Break Even,$-1.50,$1201.50,$184272.50,332,$1201.50
2025-04-09,12:43:00,16997.75,BUY,3,0.02h,Stop Loss,$159.00,$1360.50,$184431.50,332,$1360.50
2025-04-09,13:28:00,17191.5,SELL,3,0.02h,Stop Loss,$18.00,$1378.50,$184449.50,332,$1378.50
2025-04-09,13:31:00,17245.25,BUY,3,0.02h,Stop Loss,$481.50,$1860.00,$184931.00,332,$1860.00
2025-04-09,14:10:00,17399.5,SELL,3,0.02h,Stop Loss,$66.00,$1926.00,$184997.00,332,$1926.00
2025-04-09,14:25:00,17446.5,BUY,3,0.02h,Stop Loss,$120.00,$2046.00,$185117.00,332,$2046.00
2025-04-09,14:28:00,17404.75,SELL,3,0.02h,Stop Loss,$189.00,$2235.00,$185306.00,332,$2235.00
2025-04-09,14:31:00,17460.25,BUY,3,0.02h,Stop Loss,$313.50,$2548.50,$185619.50,332,$2548.50
2025-04-09,14:42:00,17431.75,SELL,3,0.02h,Stop Loss,$36.00,$2584.50,$185655.50,332,$2584.50
2025-04-09,15:10:00,17374.0,BUY,3,0.02h,Stop Loss,$63.00,$2647.50,$185718.50,332,$2647.50
2025-04-09,15:35:00,17353.75,SELL,3,0.02h,Stop Loss,$145.50,$2793.00,$185864.00,332,$2793.00
2025-04-09,15:51:00,17395.75,BUY,3,0.02h,Stop Loss,$28.50,$2821.50,$185892.50,332,$2821.50
2025-04-09,15:56:00,17324.75,SELL,3,0.02h,Stop Loss,$169.50,$2991.00,$186062.00,332,$2991.00
2025-04-09,16:09:00,17362.75,BUY,3,0.02h,Stop Loss,$151.50,$3142.50,$186213.50,332,$3142.50
2025-04-09,18:44:00,18914.75,SELL,3,0.02h,Stop Loss,$423.00,$3565.50,$186636.50,332,$3565.50
2025-04-09,19:11:00,18949.0,BUY,3,0.02h,Stop Loss,$156.00,$3721.50,$186792.50,332,$3721.50
2025-04-09,20:15:00,19244.5,SELL,3,0.02h,Break Even,$-1.50,$3720.00,$186791.00,332,$3720.00
2025-04-09,20:19:00,19298.0,BUY,3,0.02h,Break Even,$-1.50,$3718.50,$186789.50,332,$3718.50
2025-04-09,20:34:00,19285.75,SELL,3,0.02h,Stop Loss,$73.50,$3792.00,$186863.00,332,$3792.00
2025-04-09,20:35:00,19300.5,BUY,3,0.02h,Break Even,$-1.50,$3790.50,$186861.50,332,$3790.50
2025-04-09,20:36:00,19287.75,SELL,3,0.02h,Stop Loss,$-9.00,$3781.50,$186852.50,332,$3781.50
2025-04-09,20:37:00,19296.5,BUY,3,0.02h,Break Even,$-1.50,$3780.00,$186851.00,332,$3780.00
2025-04-09,23:13:00,19327.0,SELL,3,0.02h,Stop Loss,$67.50,$3847.50,$186918.50,332,$3847.50
2025-04-09,23:34:00,19332.5,BUY,3,0.02h,Stop Loss,$-9.00,$3838.50,$186909.50,332,$3838.50
2025-04-09,23:44:00,19323.75,SELL,3,0.02h,Stop Loss,$-9.00,$3829.50,$186900.50,332,$3829.50
,,,,,,,,,,,
2025-04-10,00:04:00,19328.5,BUY,3,0.02h,Break Even,$-1.50,$-1.50,$186899.00,333,$-1.50
2025-04-10,00:06:00,19307.0,SELL,3,0.02h,Stop Loss,$52.50,$51.00,$186951.50,333,$51.00
2025-04-10,00:57:00,19227.75,BUY,3,0.02h,Stop Loss,$12.00,$63.00,$186963.50,333,$63.00
2025-04-10,01:12:00,19208.75,SELL,3,0.02h,Stop Loss,$-9.00,$54.00,$186954.50,333,$54.00
2025-04-10,01:53:00,19154.5,BUY,3,0.02h,Break Even,$-1.50,$52.50,$186953.00,333,$52.50
2025-04-10,02:01:00,19144.5,SELL,3,0.02h,Stop Loss,$84.00,$136.50,$187037.00,333,$136.50
2025-04-10,02:15:00,19153.25,BUY,3,0.02h,Break Even,$-1.50,$135.00,$187035.50,333,$135.00
2025-04-10,02:31:00,19139.5,SELL,3,0.02h,Stop Loss,$31.50,$166.50,$187067.00,333,$166.50
2025-04-10,04:17:00,19011.0,BUY,3,0.02h,Stop Loss,$10.50,$177.00,$187077.50,333,$177.00
2025-04-10,05:03:00,19044.0,SELL,3,0.02h,Stop Loss,$-9.00,$168.00,$187068.50,333,$168.00
2025-04-10,05:05:00,19054.0,BUY,3,0.02h,Stop Loss,$42.00,$210.00,$187110.50,333,$210.00
2025-04-10,05:09:00,19040.0,SELL,3,0.02h,Stop Loss,$106.50,$316.50,$187217.00,333,$316.50
2025-04-10,05:22:00,19055.75,BUY,3,0.02h,Stop Loss,$6.00,$322.50,$187223.00,333,$322.50
2025-04-10,06:14:00,19104.75,SELL,3,0.02h,Stop Loss,$12.00,$334.50,$187235.00,333,$334.50
2025-04-10,06:32:00,19117.5,BUY,3,0.02h,Stop Loss,$78.00,$412.50,$187313.00,333,$412.50
2025-04-10,06:45:00,19107.5,SELL,3,0.02h,Stop Loss,$31.50,$444.00,$187344.50,333,$444.00
2025-04-10,06:58:00,19113.25,BUY,3,0.02h,Stop Loss,$54.00,$498.00,$187398.50,333,$498.00
2025-04-10,07:19:00,19108.0,SELL,3,0.02h,Stop Loss,$58.50,$556.50,$187457.00,333,$556.50
2025-04-10,08:49:00,18875.5,BUY,3,0.02h,Break Even,$-1.50,$555.00,$187455.50,333,$555.00
2025-04-10,08:52:00,18827.0,SELL,3,0.02h,Stop Loss,$91.50,$646.50,$187547.00,333,$646.50
2025-04-10,09:15:00,18824.25,BUY,3,0.02h,Stop Loss,$63.00,$709.50,$187610.00,333,$709.50
2025-04-10,09:46:00,18839.75,SELL,3,0.02h,Stop Loss,$73.50,$783.00,$187683.50,333,$783.00
2025-04-10,09:52:00,18859.5,BUY,3,0.02h,Stop Loss,$60.00,$843.00,$187743.50,333,$843.00
2025-04-10,10:48:00,18934.75,SELL,3,0.02h,Stop Loss,$6.00,$849.00,$187749.50,333,$849.00
2025-04-10,11:23:00,18924.0,BUY,3,0.02h,Stop Loss,$79.50,$928.50,$187829.00,333,$928.50
2025-04-10,11:32:00,18895.5,SELL,3,0.02h,Break Even,$-1.50,$927.00,$187827.50,333,$927.00
2025-04-10,11:33:00,18919.25,BUY,3,0.02h,Stop Loss,$43.50,$970.50,$187871.00,333,$970.50
2025-04-10,11:48:00,18918.5,SELL,3,0.02h,Break Even,$-1.50,$969.00,$187869.50,333,$969.00
2025-04-10,11:49:00,18926.5,BUY,3,0.02h,Stop Loss,$24.00,$993.00,$187893.50,333,$993.00
2025-04-10,11:53:00,18911.0,SELL,3,0.02h,Stop Loss,$-9.00,$984.00,$187884.50,333,$984.00
2025-04-10,11:56:00,18930.5,BUY,3,0.02h,Stop Loss,$12.00,$996.00,$187896.50,333,$996.00
2025-04-10,12:01:00,18906.0,SELL,3,0.02h,Stop Loss,$12.00,$1008.00,$187908.50,333,$1008.00
2025-04-10,12:32:00,18972.25,BUY,3,0.02h,Stop Loss,$61.50,$1069.50,$187970.00,333,$1069.50
2025-04-10,12:40:00,18842.5,SELL,3,0.02h,Stop Loss,$342.00,$1411.50,$188312.00,333,$1411.50
2025-04-10,13:01:00,18829.75,BUY,3,0.02h,Stop Loss,$6.00,$1417.50,$188318.00,333,$1417.50
2025-04-10,13:29:00,18785.5,SELL,3,0.02h,Break Even,$-1.50,$1416.00,$188316.50,333,$1416.00
2025-04-10,13:51:00,18844.25,BUY,3,0.02h,Stop Loss,$15.00,$1431.00,$188331.50,333,$1431.00
2025-04-10,13:52:00,18767.0,SELL,3,0.02h,Stop Loss,$141.00,$1572.00,$188472.50,333,$1572.00
2025-04-10,14:25:00,18705.25,BUY,3,0.02h,Stop Loss,$118.50,$1690.50,$188591.00,333,$1690.50
2025-04-10,14:49:00,18665.5,SELL,3,0.02h,Stop Loss,$138.00,$1828.50,$188729.00,333,$1828.50
2025-04-10,16:36:00,18137.5,BUY,3,0.02h,Stop Loss,$256.50,$2085.00,$188985.50,333,$2085.00
2025-04-10,17:11:00,18168.5,SELL,3,0.02h,Stop Loss,$193.50,$2278.50,$189179.00,333,$2278.50
2025-04-10,17:28:00,18256.5,BUY,3,0.02h,Stop Loss,$148.50,$2427.00,$189327.50,333,$2427.00
2025-04-10,18:12:00,18373.0,SELL,3,0.02h,Stop Loss,$73.50,$2500.50,$189401.00,333,$2500.50
2025-04-10,18:23:00,18544.0,BUY,3,0.02h,Stop Loss,$84.00,$2584.50,$189485.00,333,$2584.50
2025-04-10,18:52:00,18552.25,SELL,3,0.02h,Stop Loss,$330.00,$2914.50,$189815.00,333,$2914.50
2025-04-10,19:02:00,18616.75,BUY,3,0.02h,Stop Loss,$220.50,$3135.00,$190035.50,333,$3135.00
2025-04-10,19:09:00,18489.25,SELL,3,0.02h,Stop Loss,$180.00,$3315.00,$190215.50,333,$3315.00
2025-04-10,19:22:00,18595.5,BUY,3,0.02h,Stop Loss,$39.00,$3354.00,$190254.50,333,$3354.00
2025-04-10,19:26:00,18507.5,SELL,3,0.02h,Stop Loss,$169.50,$3523.50,$190424.00,333,$3523.50
2025-04-10,19:54:00,18468.5,BUY,3,0.02h,Stop Loss,$346.50,$3870.00,$190770.50,333,$3870.00
2025-04-10,20:23:00,18489.75,SELL,3,0.02h,Break Even,$-1.50,$3868.50,$190769.00,333,$3868.50
2025-04-10,20:53:00,18488.5,BUY,3,0.02h,Stop Loss,$-9.00,$3859.50,$190760.00,333,$3859.50
2025-04-10,23:13:00,18467.5,SELL,3,0.02h,Stop Loss,$40.50,$3900.00,$190800.50,333,$3900.00
,,,,,,,,,,,
2025-04-11,01:05:00,18205.75,BUY,3,0.02h,Stop Loss,$-9.00,$-9.00,$190791.50,334,$-9.00
2025-04-11,02:06:00,18300.75,SELL,3,0.02h,Stop Loss,$99.00,$90.00,$190890.50,334,$90.00
2025-04-11,02:22:00,18343.75,BUY,3,0.02h,Stop Loss,$9.00,$99.00,$190899.50,334,$99.00
2025-04-11,02:57:00,18377.0,SELL,3,0.02h,Stop Loss,$133.50,$232.50,$191033.00,334,$232.50
2025-04-11,03:07:00,18397.5,BUY,3,0.02h,Break Even,$-1.50,$231.00,$191031.50,334,$231.00
2025-04-11,03:11:00,18364.75,SELL,3,0.02h,Stop Loss,$-9.00,$222.00,$191022.50,334,$222.00
2025-04-11,03:12:00,18403.25,BUY,3,0.02h,Stop Loss,$40.50,$262.50,$191063.00,334,$262.50
2025-04-11,04:29:00,18500.75,SELL,3,0.02h,Stop Loss,$31.50,$294.00,$191094.50,334,$294.00
2025-04-11,05:14:00,18515.25,BUY,3,0.02h,Stop Loss,$19.50,$313.50,$191114.00,334,$313.50
2025-04-11,06:32:00,18721.5,SELL,3,0.02h,Stop Loss,$49.50,$363.00,$191163.50,334,$363.00
2025-04-11,07:37:00,18648.75,BUY,3,0.02h,Stop Loss,$195.00,$558.00,$191358.50,334,$558.00
2025-04-11,07:53:00,18630.25,SELL,3,0.02h,Stop Loss,$63.00,$621.00,$191421.50,334,$621.00
2025-04-11,09:01:00,18405.0,BUY,3,0.02h,Stop Loss,$106.50,$727.50,$191528.00,334,$727.50
2025-04-11,10:46:00,18625.75,SELL,3,0.02h,Break Even,$-1.50,$726.00,$191526.50,334,$726.00
2025-04-11,11:10:00,18644.25,BUY,3,0.02h,Stop Loss,$42.00,$768.00,$191568.50,334,$768.00
2025-04-11,11:14:00,18605.75,SELL,3,0.02h,Stop Loss,$81.00,$849.00,$191649.50,334,$849.00
2025-04-11,11:58:00,18585.0,BUY,3,0.02h,Stop Loss,$15.00,$864.00,$191664.50,334,$864.00
2025-04-11,12:23:00,18530.25,SELL,3,0.02h,Stop Loss,$9.00,$873.00,$191673.50,334,$873.00
2025-04-11,12:30:00,18568.75,BUY,3,0.02h,Stop Loss,$318.00,$1191.00,$191991.50,334,$1191.00
2025-04-11,12:47:00,18572.25,SELL,3,0.02h,Stop Loss,$213.00,$1404.00,$192204.50,334,$1404.00
2025-04-11,13:40:00,18506.5,BUY,3,0.02h,Stop Loss,$37.50,$1441.50,$192242.00,334,$1441.50
2025-04-11,14:03:00,18484.5,SELL,3,0.02h,Stop Loss,$292.50,$1734.00,$192534.50,334,$1734.00
2025-04-11,14:09:00,18568.0,BUY,3,0.02h,Stop Loss,$166.50,$1900.50,$192701.00,334,$1900.50
2025-04-11,14:13:00,18482.75,SELL,3,0.02h,Stop Loss,$42.00,$1942.50,$192743.00,334,$1942.50
2025-04-11,14:16:00,18573.0,BUY,3,0.02h,Stop Loss,$57.00,$1999.50,$192800.00,334,$1999.50
2025-04-11,14:18:00,18475.0,SELL,3,0.02h,Stop Loss,$129.00,$2128.50,$192929.00,334,$2128.50
2025-04-11,14:39:00,18442.0,BUY,3,0.02h,Stop Loss,$178.50,$2307.00,$193107.50,334,$2307.00
2025-04-11,15:00:00,18413.5,SELL,3,0.02h,Stop Loss,$79.50,$2386.50,$193187.00,334,$2386.50
2025-04-11,15:30:00,18414.25,BUY,3,0.02h,Stop Loss,$108.00,$2494.50,$193295.00,334,$2494.50
2025-04-11,16:27:00,18551.75,SELL,3,0.02h,Stop Loss,$12.00,$2506.50,$193307.00,334,$2506.50
2025-04-11,16:32:00,18632.0,BUY,3,0.02h,Stop Loss,$105.00,$2611.50,$193412.00,334,$2611.50
2025-04-11,17:11:00,18715.0,SELL,3,0.02h,Stop Loss,$132.00,$2743.50,$193544.00,334,$2743.50
2025-04-11,17:40:00,18737.5,BUY,3,0.02h,Stop Loss,$312.00,$3055.50,$193856.00,334,$3055.50
2025-04-11,18:10:00,18780.0,SELL,3,0.02h,Stop Loss,$150.00,$3205.50,$194006.00,334,$3205.50
2025-04-11,18:14:00,18804.75,BUY,3,0.02h,Stop Loss,$18.00,$3223.50,$194024.00,334,$3223.50
2025-04-11,18:15:00,18793.0,SELL,3,0.02h,Stop Loss,$6.00,$3229.50,$194030.00,334,$3229.50
2025-04-11,18:16:00,18809.75,BUY,3,0.02h,Stop Loss,$9.00,$3238.50,$194039.00,334,$3238.50
2025-04-11,18:17:00,18791.0,SELL,3,0.02h,Stop Loss,$181.50,$3420.00,$194220.50,334,$3420.00
2025-04-11,18:37:00,18794.75,BUY,3,0.02h,Stop Loss,$63.00,$3483.00,$194283.50,334,$3483.00
2025-04-11,18:54:00,18780.75,SELL,3,0.02h,Break Even,$-1.50,$3481.50,$194282.00,334,$3481.50
2025-04-11,18:55:00,18787.0,BUY,3,0.02h,Stop Loss,$61.50,$3543.00,$194343.50,334,$3543.00
2025-04-11,18:56:00,18773.0,SELL,3,0.02h,Stop Loss,$123.00,$3666.00,$194466.50,334,$3666.00
2025-04-11,19:04:00,18802.5,BUY,3,0.02h,Stop Loss,$60.00,$3726.00,$194526.50,334,$3726.00
2025-04-11,19:36:00,18810.0,SELL,3,0.02h,Break Even,$-1.50,$3724.50,$194525.00,334,$3724.50
2025-04-11,19:45:00,18841.0,BUY,3,0.02h,Stop Loss,$12.00,$3736.50,$194537.00,334,$3736.50
2025-04-11,19:46:00,18815.0,SELL,3,0.02h,Stop Loss,$13.50,$3750.00,$194550.50,334,$3750.00
2025-04-11,19:48:00,18831.25,BUY,3,0.02h,Break Even,$-1.50,$3748.50,$194549.00,334,$3748.50
2025-04-11,19:49:00,18812.0,SELL,3,0.02h,Stop Loss,$46.50,$3795.00,$194595.50,334,$3795.00
2025-04-11,19:56:00,18833.25,BUY,3,0.02h,Stop Loss,$67.50,$3862.50,$194663.00,334,$3862.50
2025-04-11,20:00:00,18808.75,SELL,3,0.02h,Stop Loss,$72.00,$3934.50,$194735.00,334,$3934.50
2025-04-11,20:18:00,18826.25,BUY,3,0.02h,Break Even,$-1.50,$3933.00,$194733.50,334,$3933.00
2025-04-11,20:58:00,18810.75,SELL,3,0.02h,Stop Loss,$-9.00,$3924.00,$194724.50,334,$3924.00
,,,,,,,,,,,
2025-04-14,00:00:00,19013.0,BUY,3,0.02h,Stop Loss,$138.00,$138.00,$194862.50,335,$138.00
2025-04-14,00:46:00,19037.75,SELL,3,0.02h,Stop Loss,$9.00,$147.00,$194871.50,335,$147.00
2025-04-14,01:12:00,19026.25,BUY,3,0.02h,Stop Loss,$-9.00,$138.00,$194862.50,335,$138.00
2025-04-14,01:16:00,19011.0,SELL,3,0.02h,Stop Loss,$31.50,$169.50,$194894.00,335,$169.50
2025-04-14,01:34:00,19010.0,BUY,3,0.02h,Stop Loss,$7.50,$177.00,$194901.50,335,$177.00
2025-04-14,01:40:00,18996.25,SELL,3,0.02h,Stop Loss,$48.00,$225.00,$194949.50,335,$225.00
2025-04-14,01:57:00,18995.0,BUY,3,0.02h,Stop Loss,$13.50,$238.50,$194963.00,335,$238.50
2025-04-14,03:05:00,19034.5,SELL,3,0.02h,Stop Loss,$-9.00,$229.50,$194954.00,335,$229.50
2025-04-14,03:18:00,19051.25,BUY,3,0.02h,Break Even,$-1.50,$228.00,$194952.50,335,$228.00
2025-04-14,03:52:00,19057.25,SELL,3,0.02h,Stop Loss,$-9.00,$219.00,$194943.50,335,$219.00
2025-04-14,04:06:00,19061.0,BUY,3,0.02h,Break Even,$-1.50,$217.50,$194942.00,335,$217.50
2025-04-14,05:19:00,19107.0,SELL,3,0.02h,Stop Loss,$9.00,$226.50,$194951.00,335,$226.50
2025-04-14,05:54:00,19095.25,BUY,3,0.02h,Stop Loss,$40.50,$267.00,$194991.50,335,$267.00
2025-04-14,06:01:00,19079.75,SELL,3,0.02h,Break Even,$-1.50,$265.50,$194990.00,335,$265.50
2025-04-14,06:11:00,19101.25,BUY,3,0.02h,Stop Loss,$43.50,$309.00,$195033.50,335,$309.00
2025-04-14,06:21:00,19085.5,SELL,3,0.02h,Stop Loss,$-9.00,$300.00,$195024.50,335,$300.00
2025-04-14,06:32:00,19098.25,BUY,3,0.02h,Stop Loss,$12.00,$312.00,$195036.50,335,$312.00
2025-04-14,07:01:00,19105.25,SELL,3,0.02h,Stop Loss,$46.50,$358.50,$195083.00,335,$358.50
2025-04-14,07:24:00,19117.75,BUY,3,0.02h,Break Even,$-1.50,$357.00,$195081.50,335,$357.00
2025-04-14,07:35:00,19090.5,SELL,3,0.02h,Stop Loss,$37.50,$394.50,$195119.00,335,$394.50
2025-04-14,07:39:00,19117.0,BUY,3,0.02h,Stop Loss,$27.00,$421.50,$195146.00,335,$421.50
2025-04-14,08:13:00,19135.5,SELL,3,0.02h,Break Even,$-1.50,$420.00,$195144.50,335,$420.00
2025-04-14,08:19:00,19150.0,BUY,3,0.02h,Stop Loss,$-9.00,$411.00,$195135.50,335,$411.00
2025-04-14,08:21:00,19146.5,SELL,3,0.02h,Stop Loss,$3.00,$414.00,$195138.50,335,$414.00
2025-04-14,08:22:00,19149.5,BUY,3,0.02h,Stop Loss,$22.50,$436.50,$195161.00,335,$436.50
2025-04-14,08:28:00,19141.75,SELL,3,0.02h,Break Even,$-1.50,$435.00,$195159.50,335,$435.00
2025-04-14,09:07:00,19143.75,BUY,3,0.02h,Stop Loss,$-9.00,$426.00,$195150.50,335,$426.00
2025-04-14,09:11:00,19127.75,SELL,3,0.02h,Break Even,$-1.50,$424.50,$195149.00,335,$424.50
2025-04-14,09:57:00,19067.75,BUY,3,0.02h,Stop Loss,$-9.00,$415.50,$195140.00,335,$415.50
2025-04-14,10:21:00,19053.5,SELL,3,0.02h,Stop Loss,$42.00,$457.50,$195182.00,335,$457.50
2025-04-14,10:29:00,19076.0,BUY,3,0.02h,Break Even,$-1.50,$456.00,$195180.50,335,$456.00
2025-04-14,11:38:00,19141.75,SELL,3,0.02h,Stop Loss,$-9.00,$447.00,$195171.50,335,$447.00
2025-04-14,12:10:00,19118.25,BUY,3,0.02h,Stop Loss,$7.50,$454.50,$195179.00,335,$454.50
2025-04-14,13:34:00,19183.5,SELL,3,0.02h,Stop Loss,$48.00,$502.50,$195227.00,335,$502.50
2025-04-14,14:04:00,19135.0,BUY,3,0.02h,Stop Loss,$129.00,$631.50,$195356.00,335,$631.50
2025-04-14,14:16:00,19068.25,SELL,3,0.02h,Stop Loss,$105.00,$736.50,$195461.00,335,$736.50
2025-04-14,14:26:00,19105.75,BUY,3,0.02h,Stop Loss,$112.50,$849.00,$195573.50,335,$849.00
2025-04-14,14:59:00,19125.75,SELL,3,0.02h,Break Even,$-1.50,$847.50,$195572.00,335,$847.50
2025-04-14,16:21:00,18858.0,BUY,3,0.02h,Stop Loss,$231.00,$1078.50,$195803.00,335,$1078.50
2025-04-14,16:28:00,18793.0,SELL,3,0.02h,Break Even,$-1.50,$1077.00,$195801.50,335,$1077.00
2025-04-14,16:34:00,18869.75,BUY,3,0.02h,Stop Loss,$61.50,$1138.50,$195863.00,335,$1138.50
2025-04-14,16:52:00,18826.25,SELL,3,0.02h,Stop Loss,$54.00,$1192.50,$195917.00,335,$1192.50
2025-04-14,17:14:00,18852.5,BUY,3,0.02h,Stop Loss,$-9.00,$1183.50,$195908.00,335,$1183.50
2025-04-14,17:17:00,18815.25,SELL,3,0.02h,Break Even,$-1.50,$1182.00,$195906.50,335,$1182.00
2025-04-14,17:19:00,18869.75,BUY,3,0.02h,Stop Loss,$16.50,$1198.50,$195923.00,335,$1198.50
2025-04-14,17:41:00,18856.5,SELL,3,0.02h,Stop Loss,$9.00,$1207.50,$195932.00,335,$1207.50
2025-04-14,17:43:00,18893.25,BUY,3,0.02h,Stop Loss,$16.50,$1224.00,$195948.50,335,$1224.00
2025-04-14,17:47:00,18857.75,SELL,3,0.02h,Stop Loss,$91.50,$1315.50,$196040.00,335,$1315.50
2025-04-14,17:51:00,18880.5,BUY,3,0.02h,Stop Loss,$96.00,$1411.50,$196136.00,335,$1411.50
2025-04-14,19:27:00,19034.75,SELL,3,0.02h,Stop Loss,$3.00,$1414.50,$196139.00,335,$1414.50
2025-04-14,19:41:00,19066.5,BUY,3,0.02h,Break Even,$-1.50,$1413.00,$196137.50,335,$1413.00
2025-04-14,19:49:00,19022.5,SELL,3,0.02h,Stop Loss,$82.50,$1495.50,$196220.00,335,$1495.50
2025-04-14,20:39:00,18887.75,BUY,3,0.02h,Stop Loss,$54.00,$1549.50,$196274.00,335,$1549.50
2025-04-14,23:00:00,18817.0,SELL,3,0.02h,Break Even,$-1.50,$1548.00,$196272.50,335,$1548.00
2025-04-14,23:21:00,18865.5,BUY,3,0.02h,Stop Loss,$-9.00,$1539.00,$196263.50,335,$1539.00
2025-04-14,23:40:00,18852.5,SELL,3,0.02h,Stop Loss,$78.00,$1617.00,$196341.50,335,$1617.00
,,,,,,,,,,,
2025-04-15,00:01:00,18866.75,BUY,3,0.02h,Stop Loss,$-9.00,$-9.00,$196332.50,336,$-9.00
2025-04-15,01:28:00,18919.0,SELL,3,0.02h,Stop Loss,$-9.00,$-18.00,$196323.50,336,$-18.00
2025-04-15,01:32:00,18929.75,BUY,3,0.02h,Break Even,$-1.50,$-19.50,$196322.00,336,$-19.50
2025-04-15,01:36:00,18917.5,SELL,3,0.02h,Stop Loss,$30.00,$10.50,$196352.00,336,$10.50
2025-04-15,02:09:00,18916.75,BUY,3,0.02h,Break Even,$-1.50,$9.00,$196350.50,336,$9.00
2025-04-15,02:22:00,18902.75,SELL,3,0.02h,Stop Loss,$63.00,$72.00,$196413.50,336,$72.00
2025-04-15,03:18:00,18879.5,BUY,3,0.02h,Stop Loss,$58.50,$130.50,$196472.00,336,$130.50
2025-04-15,04:06:00,18909.5,SELL,3,0.02h,Stop Loss,$-9.00,$121.50,$196463.00,336,$121.50
2025-04-15,04:07:00,18915.25,BUY,3,0.02h,Stop Loss,$-9.00,$112.50,$196454.00,336,$112.50
2025-04-15,04:40:00,18909.75,SELL,3,0.02h,Stop Loss,$72.00,$184.50,$196526.00,336,$184.50
2025-04-15,05:02:00,18919.75,BUY,3,0.02h,Stop Loss,$-9.00,$175.50,$196517.00,336,$175.50
2025-04-15,05:06:00,18900.25,SELL,3,0.02h,Break Even,$-1.50,$174.00,$196515.50,336,$174.00
2025-04-15,05:20:00,18913.75,BUY,3,0.02h,Break Even,$-1.50,$172.50,$196514.00,336,$172.50
2025-04-15,05:28:00,18888.0,SELL,3,0.02h,Stop Loss,$33.00,$205.50,$196547.00,336,$205.50
2025-04-15,06:08:00,18898.75,BUY,3,0.02h,Stop Loss,$-9.00,$196.50,$196538.00,336,$196.50
2025-04-15,06:57:00,18911.25,SELL,3,0.02h,Stop Loss,$-9.00,$187.50,$196529.00,336,$187.50
2025-04-15,06:59:00,18916.5,BUY,3,0.02h,Stop Loss,$12.00,$199.50,$196541.00,336,$199.50
2025-04-15,07:52:00,19003.25,SELL,3,0.02h,Break Even,$-1.50,$198.00,$196539.50,336,$198.00
2025-04-15,08:17:00,19006.5,BUY,3,0.02h,Stop Loss,$30.00,$228.00,$196569.50,336,$228.00
2025-04-15,08:27:00,19002.5,SELL,3,0.02h,Break Even,$-1.50,$226.50,$196568.00,336,$226.50
2025-04-15,08:47:00,18997.25,BUY,3,0.02h,Stop Loss,$-9.00,$217.50,$196559.00,336,$217.50
2025-04-15,08:52:00,18988.5,SELL,3,0.02h,Break Even,$-1.50,$216.00,$196557.50,336,$216.00
2025-04-15,08:53:00,18994.25,BUY,3,0.02h,Break Even,$-1.50,$214.50,$196556.00,336,$214.50
2025-04-15,08:54:00,18986.5,SELL,3,0.02h,Stop Loss,$24.00,$238.50,$196580.00,336,$238.50
2025-04-15,08:57:00,18995.5,BUY,3,0.02h,Break Even,$-1.50,$237.00,$196578.50,336,$237.00
2025-04-15,09:12:00,18982.5,SELL,3,0.02h,Stop Loss,$-9.00,$228.00,$196569.50,336,$228.00
2025-04-15,09:25:00,19001.0,BUY,3,0.02h,Stop Loss,$21.00,$249.00,$196590.50,336,$249.00
2025-04-15,09:41:00,18987.0,SELL,3,0.02h,Stop Loss,$49.50,$298.50,$196640.00,336,$298.50
2025-04-15,10:02:00,18993.0,BUY,3,0.02h,Stop Loss,$3.00,$301.50,$196643.00,336,$301.50
2025-04-15,10:35:00,18991.75,SELL,3,0.02h,Stop Loss,$-9.00,$292.50,$196634.00,336,$292.50
2025-04-15,11:01:00,18985.25,BUY,3,0.02h,Break Even,$-1.50,$291.00,$196632.50,336,$291.00
2025-04-15,11:08:00,18972.25,SELL,3,0.02h,Break Even,$-1.50,$289.50,$196631.00,336,$289.50
2025-04-15,11:10:00,18979.5,BUY,3,0.02h,Stop Loss,$-9.00,$280.50,$196622.00,336,$280.50
2025-04-15,11:11:00,18973.5,SELL,3,0.02h,Stop Loss,$19.50,$300.00,$196641.50,336,$300.00
2025-04-15,11:28:00,18976.0,BUY,3,0.02h,Stop Loss,$10.50,$310.50,$196652.00,336,$310.50
2025-04-15,11:36:00,18947.75,SELL,3,0.02h,Stop Loss,$73.50,$384.00,$196725.50,336,$384.00
2025-04-15,12:09:00,18923.75,BUY,3,0.02h,Break Even,$-1.50,$382.50,$196724.00,336,$382.50
2025-04-15,12:18:00,18900.25,SELL,3,0.02h,Stop Loss,$21.00,$403.50,$196745.00,336,$403.50
2025-04-15,12:39:00,18890.5,BUY,3,0.02h,Stop Loss,$49.50,$453.00,$196794.50,336,$453.00
2025-04-15,14:18:00,19049.75,SELL,3,0.02h,Stop Loss,$214.50,$667.50,$197009.00,336,$667.50
2025-04-15,14:44:00,19070.0,BUY,3,0.02h,Stop Loss,$25.50,$693.00,$197034.50,336,$693.00
2025-04-15,14:52:00,19023.25,SELL,3,0.02h,Stop Loss,$60.00,$753.00,$197094.50,336,$753.00
2025-04-15,14:55:00,19034.75,BUY,3,0.02h,Stop Loss,$63.00,$816.00,$197157.50,336,$816.00
2025-04-15,15:10:00,19030.75,SELL,3,0.02h,Stop Loss,$94.50,$910.50,$197252.00,336,$910.50
2025-04-15,15:11:00,19042.25,BUY,3,0.02h,Stop Loss,$31.50,$942.00,$197283.50,336,$942.00
2025-04-15,15:12:00,19016.5,SELL,3,0.02h,Break Even,$-1.50,$940.50,$197282.00,336,$940.50
2025-04-15,15:13:00,19054.5,BUY,3,0.02h,Break Even,$-1.50,$939.00,$197280.50,336,$939.00
2025-04-15,15:28:00,19029.75,SELL,3,0.02h,Stop Loss,$58.50,$997.50,$197339.00,336,$997.50
2025-04-15,15:55:00,19048.5,BUY,3,0.02h,Stop Loss,$-9.00,$988.50,$197330.00,336,$988.50
2025-04-15,16:38:00,19053.0,SELL,3,0.02h,Stop Loss,$43.50,$1032.00,$197373.50,336,$1032.00
2025-04-15,16:48:00,19069.0,BUY,3,0.02h,Stop Loss,$-9.00,$1023.00,$197364.50,336,$1023.00
2025-04-15,16:49:00,19052.25,SELL,3,0.02h,Stop Loss,$31.50,$1054.50,$197396.00,336,$1054.50
2025-04-15,17:40:00,18968.0,BUY,3,0.02h,Stop Loss,$97.50,$1152.00,$197493.50,336,$1152.00
2025-04-15,17:54:00,18920.25,SELL,3,0.02h,Stop Loss,$9.00,$1161.00,$197502.50,336,$1161.00
2025-04-15,18:32:00,18934.0,BUY,3,0.02h,Stop Loss,$51.00,$1212.00,$197553.50,336,$1212.00
2025-04-15,19:26:00,18955.0,SELL,3,0.02h,Stop Loss,$31.50,$1243.50,$197585.00,336,$1243.50
2025-04-15,19:53:00,18979.25,BUY,3,0.02h,Break Even,$-1.50,$1242.00,$197583.50,336,$1242.00
2025-04-15,20:15:00,18960.25,SELL,3,0.02h,Stop Loss,$9.00,$1251.00,$197592.50,336,$1251.00
2025-04-15,23:59:00,18730.5,BUY,3,0.02h,Break Even,$-1.50,$1249.50,$197591.00,336,$1249.50
,,,,,,,,,,,
2025-04-16,00:07:00,18707.0,SELL,3,0.02h,Stop Loss,$12.00,$12.00,$197603.00,337,$12.00
2025-04-16,00:53:00,18678.75,BUY,3,0.02h,Stop Loss,$-9.00,$3.00,$197594.00,337,$3.00
2025-04-16,01:53:00,18707.25,SELL,3,0.02h,Stop Loss,$-9.00,$-6.00,$197585.00,337,$-6.00
2025-04-16,02:04:00,18720.25,BUY,3,0.02h,Break Even,$-1.50,$-7.50,$197583.50,337,$-7.50
2025-04-16,02:10:00,18709.0,SELL,3,0.02h,Stop Loss,$31.50,$24.00,$197615.00,337,$24.00
2025-04-16,02:51:00,18697.0,BUY,3,0.02h,Stop Loss,$-9.00,$15.00,$197606.00,337,$15.00
2025-04-16,02:53:00,18692.25,SELL,3,0.02h,Stop Loss,$79.50,$94.50,$197685.50,337,$94.50
2025-04-16,03:06:00,18695.25,BUY,3,0.02h,Stop Loss,$7.50,$102.00,$197693.00,337,$102.00
2025-04-16,03:30:00,18683.0,SELL,3,0.02h,Stop Loss,$-9.00,$93.00,$197684.00,337,$93.00
2025-04-16,04:28:00,18673.5,BUY,3,0.02h,Break Even,$-1.50,$91.50,$197682.50,337,$91.50
2025-04-16,04:50:00,18670.25,SELL,3,0.02h,Break Even,$-1.50,$90.00,$197681.00,337,$90.00
2025-04-16,06:12:00,18536.5,BUY,3,0.02h,Stop Loss,$34.50,$124.50,$197715.50,337,$124.50
2025-04-16,07:06:00,18582.5,SELL,3,0.02h,Stop Loss,$3.00,$127.50,$197718.50,337,$127.50
2025-04-16,07:07:00,18592.0,BUY,3,0.02h,Stop Loss,$60.00,$187.50,$197778.50,337,$187.50
2025-04-16,07:18:00,18575.75,SELL,3,0.02h,Stop Loss,$-9.00,$178.50,$197769.50,337,$178.50
2025-04-16,08:22:00,18540.75,BUY,3,0.02h,Stop Loss,$52.50,$231.00,$197822.00,337,$231.00
2025-04-16,09:00:00,18711.25,SELL,3,0.02h,Stop Loss,$-9.00,$222.00,$197813.00,337,$222.00
2025-04-16,09:18:00,18742.75,BUY,3,0.02h,Break Even,$-1.50,$220.50,$197811.50,337,$220.50
2025-04-16,09:34:00,18722.75,SELL,3,0.02h,Stop Loss,$7.50,$228.00,$197819.00,337,$228.00
2025-04-16,09:41:00,18737.75,BUY,3,0.02h,Break Even,$-1.50,$226.50,$197817.50,337,$226.50
2025-04-16,09:43:00,18726.25,SELL,3,0.02h,Break Even,$-1.50,$225.00,$197816.00,337,$225.00
2025-04-16,10:08:00,18717.5,BUY,3,0.02h,Stop Loss,$22.50,$247.50,$197838.50,337,$247.50
2025-04-16,10:13:00,18704.0,SELL,3,0.02h,Stop Loss,$3.00,$250.50,$197841.50,337,$250.50
2025-04-16,10:23:00,18723.0,BUY,3,0.02h,Stop Loss,$10.50,$261.00,$197852.00,337,$261.00
2025-04-16,10:26:00,18709.5,SELL,3,0.02h,Stop Loss,$6.00,$267.00,$197858.00,337,$267.00
2025-04-16,11:24:00,18685.75,BUY,3,0.02h,Break Even,$-1.50,$265.50,$197856.50,337,$265.50
2025-04-16,11:25:00,18676.5,SELL,3,0.02h,Break Even,$-1.50,$264.00,$197855.00,337,$264.00
2025-04-16,11:27:00,18685.25,BUY,3,0.02h,Stop Loss,$72.00,$336.00,$197927.00,337,$336.00
2025-04-16,11:55:00,18692.5,SELL,3,0.02h,Break Even,$-1.50,$334.50,$197925.50,337,$334.50
2025-04-16,12:08:00,18704.0,BUY,3,0.02h,Stop Loss,$-9.00,$325.50,$197916.50,337,$325.50
2025-04-16,12:12:00,18688.75,SELL,3,0.02h,Stop Loss,$9.00,$334.50,$197925.50,337,$334.50
2025-04-16,12:27:00,18700.25,BUY,3,0.02h,Stop Loss,$22.50,$357.00,$197948.00,337,$357.00
2025-04-16,12:35:00,18689.75,SELL,3,0.02h,Break Even,$-1.50,$355.50,$197946.50,337,$355.50
2025-04-16,12:36:00,18699.0,BUY,3,0.02h,Break Even,$-1.50,$354.00,$197945.00,337,$354.00
2025-04-16,12:38:00,18690.5,SELL,3,0.02h,Stop Loss,$129.00,$483.00,$198074.00,337,$483.00
2025-04-16,13:33:00,18644.5,BUY,3,0.02h,Stop Loss,$72.00,$555.00,$198146.00,337,$555.00
2025-04-16,13:47:00,18599.25,SELL,3,0.02h,Stop Loss,$31.50,$586.50,$198177.50,337,$586.50
2025-04-16,14:11:00,18596.75,BUY,3,0.02h,Stop Loss,$3.00,$589.50,$198180.50,337,$589.50
2025-04-16,14:15:00,18552.0,SELL,3,0.02h,Stop Loss,$13.50,$603.00,$198194.00,337,$603.00
2025-04-16,14:23:00,18592.0,BUY,3,0.02h,Stop Loss,$3.00,$606.00,$198197.00,337,$606.00
2025-04-16,14:57:00,18601.25,SELL,3,0.02h,Stop Loss,$-9.00,$597.00,$198188.00,337,$597.00
2025-04-16,15:01:00,18639.75,BUY,3,0.02h,Stop Loss,$7.50,$604.50,$198195.50,337,$604.50
2025-04-16,15:03:00,18614.25,SELL,3,0.02h,Stop Loss,$27.00,$631.50,$198222.50,337,$631.50
2025-04-16,15:11:00,18626.25,BUY,3,0.02h,Stop Loss,$46.50,$678.00,$198269.00,337,$678.00
2025-04-16,15:17:00,18613.5,SELL,3,0.02h,Break Even,$-1.50,$676.50,$198267.50,337,$676.50
2025-04-16,15:23:00,18663.75,BUY,3,0.02h,Stop Loss,$49.50,$726.00,$198317.00,337,$726.00
2025-04-16,15:43:00,18654.75,SELL,3,0.02h,Stop Loss,$49.50,$775.50,$198366.50,337,$775.50
2025-04-16,16:27:00,18602.5,BUY,3,0.02h,Break Even,$-1.50,$774.00,$198365.00,337,$774.00
2025-04-16,16:38:00,18573.5,SELL,3,0.02h,Stop Loss,$27.00,$801.00,$198392.00,337,$801.00
2025-04-16,17:19:00,18576.75,BUY,3,0.02h,Stop Loss,$39.00,$840.00,$198431.00,337,$840.00
2025-04-16,17:32:00,18485.5,SELL,3,0.02h,Stop Loss,$84.00,$924.00,$198515.00,337,$924.00
2025-04-16,18:25:00,18363.5,BUY,3,0.02h,Stop Loss,$4.50,$928.50,$198519.50,337,$928.50
2025-04-16,18:33:00,18339.25,SELL,3,0.02h,Stop Loss,$57.00,$985.50,$198576.50,337,$985.50
2025-04-16,19:35:00,18192.5,BUY,3,0.02h,Stop Loss,$63.00,$1048.50,$198639.50,337,$1048.50
2025-04-16,20:43:00,18401.75,SELL,3,0.02h,Stop Loss,$16.50,$1065.00,$198656.00,337,$1065.00
2025-04-16,23:03:00,18402.25,BUY,3,0.02h,Stop Loss,$18.00,$1083.00,$198674.00,337,$1083.00
2025-04-16,23:07:00,18362.75,SELL,3,0.02h,Stop Loss,$-9.00,$1074.00,$198665.00,337,$1074.00
2025-04-16,23:17:00,18416.5,BUY,3,0.02h,Stop Loss,$15.00,$1089.00,$198680.00,337,$1089.00
2025-04-16,23:37:00,18388.75,SELL,3,0.02h,Stop Loss,$-9.00,$1080.00,$198671.00,337,$1080.00
2025-04-16,23:47:00,18412.5,BUY,3,0.02h,Stop Loss,$-9.00,$1071.00,$198662.00,337,$1071.00
2025-04-16,23:57:00,18388.75,SELL,3,0.02h,Stop Loss,$15.00,$1086.00,$198677.00,337,$1086.00
2025-04-16,23:59:00,18405.5,BUY,3,0.02h,Break Even,$-1.50,$1084.50,$198675.50,337,$1084.50
,,,,,,,,,,,
2025-04-17,00:33:00,18428.75,SELL,3,0.02h,Break Even,$-1.50,$-1.50,$198674.00,338,$-1.50
2025-04-17,00:37:00,18442.0,BUY,3,0.02h,Break Even,$-1.50,$-3.00,$198672.50,338,$-3.00
2025-04-17,01:25:00,18466.5,SELL,3,0.02h,Stop Loss,$-9.00,$-12.00,$198663.50,338,$-12.00
2025-04-17,01:34:00,18480.25,BUY,3,0.02h,Break Even,$-1.50,$-13.50,$198662.00,338,$-13.50
2025-04-17,01:42:00,18465.0,SELL,3,0.02h,Stop Loss,$-9.00,$-22.50,$198653.00,338,$-22.50
2025-04-17,01:47:00,18474.25,BUY,3,0.02h,Stop Loss,$-9.00,$-31.50,$198644.00,338,$-31.50
2025-04-17,01:48:00,18470.5,SELL,3,0.02h,Stop Loss,$19.50,$-12.00,$198663.50,338,$-12.00
2025-04-17,01:56:00,18477.0,BUY,3,0.02h,Stop Loss,$21.00,$9.00,$198684.50,338,$9.00
2025-04-17,02:03:00,18469.25,SELL,3,0.02h,Break Even,$-1.50,$7.50,$198683.00,338,$7.50
2025-04-17,02:05:00,18475.5,BUY,3,0.02h,Break Even,$-1.50,$6.00,$198681.50,338,$6.00
2025-04-17,02:33:00,18486.0,SELL,3,0.02h,Stop Loss,$9.00,$15.00,$198690.50,338,$15.00
2025-04-17,02:49:00,18493.0,BUY,3,0.02h,Stop Loss,$-9.00,$6.00,$198681.50,338,$6.00
2025-04-17,03:35:00,18505.5,SELL,3,0.02h,Stop Loss,$19.50,$25.50,$198701.00,338,$25.50
2025-04-17,03:49:00,18514.25,BUY,3,0.02h,Stop Loss,$-9.00,$16.50,$198692.00,338,$16.50
2025-04-17,05:00:00,18535.25,SELL,3,0.02h,Break Even,$-1.50,$15.00,$198690.50,338,$15.00
2025-04-17,05:05:00,18539.0,BUY,3,0.02h,Stop Loss,$-9.00,$6.00,$198681.50,338,$6.00
2025-04-17,05:06:00,18534.5,SELL,3,0.02h,Stop Loss,$4.50,$10.50,$198686.00,338,$10.50
2025-04-17,05:36:00,18544.0,BUY,3,0.02h,Stop Loss,$3.00,$13.50,$198689.00,338,$13.50
2025-04-17,05:57:00,18541.75,SELL,3,0.02h,Stop Loss,$7.50,$21.00,$198696.50,338,$21.00
2025-04-17,06:07:00,18567.5,BUY,3,0.02h,Stop Loss,$31.50,$52.50,$198728.00,338,$52.50
2025-04-17,06:45:00,18569.25,SELL,3,0.02h,Stop Loss,$168.00,$220.50,$198896.00,338,$220.50
2025-04-17,07:06:00,18571.0,BUY,3,0.02h,Break Even,$-1.50,$219.00,$198894.50,338,$219.00
2025-04-17,07:07:00,18565.25,SELL,3,0.02h,Break Even,$-1.50,$217.50,$198893.00,338,$217.50
2025-04-17,07:11:00,18571.5,BUY,3,0.02h,Stop Loss,$78.00,$295.50,$198971.00,338,$295.50
2025-04-17,07:42:00,18606.0,SELL,3,0.02h,Break Even,$-1.50,$294.00,$198969.50,338,$294.00
2025-04-17,07:49:00,18618.5,BUY,3,0.02h,Stop Loss,$-9.00,$285.00,$198960.50,338,$285.00
2025-04-17,08:04:00,18606.75,SELL,3,0.02h,Stop Loss,$54.00,$339.00,$199014.50,338,$339.00
2025-04-17,09:19:00,18559.75,BUY,3,0.02h,Stop Loss,$18.00,$357.00,$199032.50,338,$357.00
2025-04-17,09:42:00,18565.25,SELL,3,0.02h,Stop Loss,$19.50,$376.50,$199052.00,338,$376.50
2025-04-17,09:58:00,18578.5,BUY,3,0.02h,Stop Loss,$-9.00,$367.50,$199043.00,338,$367.50
2025-04-17,10:10:00,18560.0,SELL,3,0.02h,Stop Loss,$-9.00,$358.50,$199034.00,338,$358.50
2025-04-17,10:12:00,18579.5,BUY,3,0.02h,Break Even,$-1.50,$357.00,$199032.50,338,$357.00
2025-04-17,10:13:00,18553.75,SELL,3,0.02h,Stop Loss,$18.00,$375.00,$199050.50,338,$375.00
2025-04-17,11:29:00,18515.25,BUY,3,0.02h,Break Even,$-1.50,$373.50,$199049.00,338,$373.50
2025-04-17,12:28:00,18530.0,SELL,3,0.02h,Stop Loss,$6.00,$379.50,$199055.00,338,$379.50
2025-04-17,12:34:00,18575.5,BUY,3,0.02h,Stop Loss,$36.00,$415.50,$199091.00,338,$415.50
2025-04-17,12:47:00,18537.75,SELL,3,0.02h,Stop Loss,$18.00,$433.50,$199109.00,338,$433.50
2025-04-17,12:51:00,18555.75,BUY,3,0.02h,Stop Loss,$10.50,$444.00,$199119.50,338,$444.00
2025-04-17,12:57:00,18535.25,SELL,3,0.02h,Stop Loss,$34.50,$478.50,$199154.00,338,$478.50
2025-04-17,13:22:00,18528.25,BUY,3,0.02h,Stop Loss,$61.50,$540.00,$199215.50,338,$540.00
2025-04-17,13:28:00,18486.25,SELL,3,0.02h,Stop Loss,$-9.00,$531.00,$199206.50,338,$531.00
2025-04-17,13:53:00,18485.75,BUY,3,0.02h,Stop Loss,$39.00,$570.00,$199245.50,338,$570.00
2025-04-17,14:07:00,18424.5,SELL,3,0.02h,Stop Loss,$225.00,$795.00,$199470.50,338,$795.00
2025-04-17,14:47:00,18355.0,BUY,3,0.02h,Stop Loss,$22.50,$817.50,$199493.00,338,$817.50
2025-04-17,14:53:00,18315.0,SELL,3,0.02h,Stop Loss,$6.00,$823.50,$199499.00,338,$823.50
2025-04-17,15:07:00,18389.0,BUY,3,0.02h,Stop Loss,$159.00,$982.50,$199658.00,338,$982.50
2025-04-17,15:29:00,18341.75,SELL,3,0.02h,Stop Loss,$60.00,$1042.50,$199718.00,338,$1042.50
2025-04-17,15:38:00,18416.75,BUY,3,0.02h,Stop Loss,$10.50,$1053.00,$199728.50,338,$1053.00
2025-04-17,15:44:00,18371.0,SELL,3,0.02h,Stop Loss,$78.00,$1131.00,$199806.50,338,$1131.00
2025-04-17,16:08:00,18398.75,BUY,3,0.02h,Stop Loss,$175.50,$1306.50,$199982.00,338,$1306.50
2025-04-17,16:43:00,18412.75,SELL,3,0.02h,Stop Loss,$171.00,$1477.50,$200153.00,338,$1477.50
2025-04-17,16:53:00,18452.25,BUY,3,0.02h,Stop Loss,$25.50,$1503.00,$200178.50,338,$1503.00
2025-04-17,17:12:00,18427.0,SELL,3,0.02h,Stop Loss,$25.50,$1528.50,$200204.00,338,$1528.50
2025-04-17,17:37:00,18421.25,BUY,3,0.02h,Break Even,$-1.50,$1527.00,$200202.50,338,$1527.00
2025-04-17,17:44:00,18398.5,SELL,3,0.02h,Break Even,$-1.50,$1525.50,$200201.00,338,$1525.50
2025-04-17,17:45:00,18410.25,BUY,3,0.02h,Stop Loss,$70.50,$1596.00,$200271.50,338,$1596.00
2025-04-17,18:43:00,18484.75,SELL,3,0.02h,Break Even,$-1.50,$1594.50,$200270.00,338,$1594.50
2025-04-17,19:36:00,18398.5,BUY,3,0.02h,Stop Loss,$57.00,$1651.50,$200327.00,338,$1651.50
2025-04-17,19:47:00,18380.0,SELL,3,0.02h,Stop Loss,$67.50,$1719.00,$200394.50,338,$1719.00
2025-04-17,20:02:00,18408.25,BUY,3,0.02h,Break Even,$-1.50,$1717.50,$200393.00,338,$1717.50
2025-04-17,20:32:00,18404.5,SELL,3,0.02h,Stop Loss,$10.50,$1728.00,$200403.50,338,$1728.00
2025-04-17,20:37:00,18410.5,BUY,3,0.02h,Stop Loss,$10.50,$1738.50,$200414.00,338,$1738.50
,,,,,,,,,,,
2025-04-21,00:00:00,18314.25,SELL,3,0.02h,Break Even,$-1.50,$-1.50,$200412.50,339,$-1.50
2025-04-21,00:25:00,18357.5,BUY,3,0.02h,Break Even,$-1.50,$-3.00,$200411.00,339,$-3.00
2025-04-21,00:39:00,18345.75,SELL,3,0.02h,Stop Loss,$-9.00,$-12.00,$200402.00,339,$-12.00
2025-04-21,00:42:00,18363.0,BUY,3,0.02h,Stop Loss,$45.00,$33.00,$200447.00,339,$33.00
2025-04-21,00:47:00,18345.75,SELL,3,0.02h,Stop Loss,$18.00,$51.00,$200465.00,339,$51.00
2025-04-21,01:32:00,18297.0,BUY,3,0.02h,Stop Loss,$31.50,$82.50,$200496.50,339,$82.50
2025-04-21,01:53:00,18287.0,SELL,3,0.02h,Stop Loss,$36.00,$118.50,$200532.50,339,$118.50
2025-04-21,02:09:00,18298.25,BUY,3,0.02h,Stop Loss,$7.50,$126.00,$200540.00,339,$126.00
2025-04-21,02:20:00,18284.5,SELL,3,0.02h,Stop Loss,$13.50,$139.50,$200553.50,339,$139.50
2025-04-21,03:16:00,18231.0,BUY,3,0.02h,Stop Loss,$3.00,$142.50,$200556.50,339,$142.50
2025-04-21,03:34:00,18216.0,SELL,3,0.02h,Stop Loss,$-9.00,$133.50,$200547.50,339,$133.50
2025-04-21,04:02:00,18223.25,BUY,3,0.02h,Break Even,$-1.50,$132.00,$200546.00,339,$132.00
2025-04-21,04:43:00,18223.25,SELL,3,0.02h,Stop Loss,$-9.00,$123.00,$200537.00,339,$123.00
2025-04-21,05:04:00,18231.0,BUY,3,0.02h,Break Even,$-1.50,$121.50,$200535.50,339,$121.50
2025-04-21,05:13:00,18222.0,SELL,3,0.02h,Stop Loss,$-9.00,$112.50,$200526.50,339,$112.50
2025-04-21,05:16:00,18241.0,BUY,3,0.02h,Stop Loss,$-9.00,$103.50,$200517.50,339,$103.50
2025-04-21,05:29:00,18226.5,SELL,3,0.02h,Stop Loss,$-9.00,$94.50,$200508.50,339,$94.50
2025-04-21,05:31:00,18232.0,BUY,3,0.02h,Break Even,$-1.50,$93.00,$200507.00,339,$93.00
2025-04-21,05:33:00,18227.5,SELL,3,0.02h,Break Even,$-1.50,$91.50,$200505.50,339,$91.50
2025-04-21,05:43:00,18235.75,BUY,3,0.02h,Stop Loss,$34.50,$126.00,$200540.00,339,$126.00
2025-04-21,06:20:00,18237.25,SELL,3,0.02h,Break Even,$-1.50,$124.50,$200538.50,339,$124.50
2025-04-21,06:58:00,18221.0,BUY,3,0.02h,Stop Loss,$9.00,$133.50,$200547.50,339,$133.50
2025-04-21,07:03:00,18210.75,SELL,3,0.02h,Stop Loss,$25.50,$159.00,$200573.00,339,$159.00
2025-04-21,07:48:00,18186.0,BUY,3,0.02h,Stop Loss,$6.00,$165.00,$200579.00,339,$165.00
2025-04-21,07:53:00,18172.0,SELL,3,0.02h,Break Even,$-1.50,$163.50,$200577.50,339,$163.50
2025-04-21,08:05:00,18189.0,BUY,3,0.02h,Stop Loss,$-9.00,$154.50,$200568.50,339,$154.50
2025-04-21,08:16:00,18169.5,SELL,3,0.02h,Stop Loss,$13.50,$168.00,$200582.00,339,$168.00
2025-04-21,08:29:00,18179.0,BUY,3,0.02h,Break Even,$-1.50,$166.50,$200580.50,339,$166.50
2025-04-21,08:48:00,18174.25,SELL,3,0.02h,Stop Loss,$12.00,$178.50,$200592.50,339,$178.50
2025-04-21,09:29:00,18165.5,BUY,3,0.02h,Stop Loss,$16.50,$195.00,$200609.00,339,$195.00
2025-04-21,09:43:00,18150.0,SELL,3,0.02h,Stop Loss,$7.50,$202.50,$200616.50,339,$202.50
2025-04-21,09:48:00,18161.0,BUY,3,0.02h,Stop Loss,$3.00,$205.50,$200619.50,339,$205.50
2025-04-21,10:19:00,18168.0,SELL,3,0.02h,Stop Loss,$7.50,$213.00,$200627.00,339,$213.00
2025-04-21,10:44:00,18167.75,BUY,3,0.02h,Break Even,$-1.50,$211.50,$200625.50,339,$211.50
2025-04-21,11:14:00,18171.5,SELL,3,0.02h,Stop Loss,$10.50,$222.00,$200636.00,339,$222.00
2025-04-21,12:01:00,18109.0,BUY,3,0.02h,Stop Loss,$18.00,$240.00,$200654.00,339,$240.00
2025-04-21,12:54:00,18121.5,SELL,3,0.02h,Stop Loss,$-9.00,$231.00,$200645.00,339,$231.00
2025-04-21,13:29:00,18118.75,BUY,3,0.02h,Stop Loss,$43.50,$274.50,$200688.50,339,$274.50
2025-04-21,13:39:00,18090.0,SELL,3,0.02h,Stop Loss,$42.00,$316.50,$200730.50,339,$316.50
2025-04-21,14:38:00,17963.5,BUY,3,0.02h,Break Even,$-1.50,$315.00,$200729.00,339,$315.00
2025-04-21,14:48:00,17925.25,SELL,3,0.02h,Stop Loss,$36.00,$351.00,$200765.00,339,$351.00
2025-04-21,16:07:00,17826.0,BUY,3,0.02h,Stop Loss,$-9.00,$342.00,$200756.00,339,$342.00
2025-04-21,16:28:00,17812.5,SELL,3,0.02h,Stop Loss,$30.00,$372.00,$200786.00,339,$372.00
2025-04-21,16:32:00,17836.25,BUY,3,0.02h,Stop Loss,$63.00,$435.00,$200849.00,339,$435.00
2025-04-21,16:51:00,17829.0,SELL,3,0.02h,Stop Loss,$33.00,$468.00,$200882.00,339,$468.00
2025-04-21,18:14:00,17725.0,BUY,3,0.02h,Stop Loss,$33.00,$501.00,$200915.00,339,$501.00
2025-04-21,18:43:00,17733.5,SELL,3,0.02h,Stop Loss,$12.00,$513.00,$200927.00,339,$513.00
2025-04-21,19:03:00,17745.25,BUY,3,0.02h,Stop Loss,$6.00,$519.00,$200933.00,339,$519.00
2025-04-21,23:00:00,17893.25,SELL,3,0.02h,Stop Loss,$-9.00,$510.00,$200924.00,339,$510.00
2025-04-21,23:20:00,17908.75,BUY,3,0.02h,Break Even,$-1.50,$508.50,$200922.50,339,$508.50
2025-04-21,23:22:00,17901.25,SELL,3,0.02h,Stop Loss,$10.50,$519.00,$200933.00,339,$519.00
2025-04-21,23:28:00,17908.0,BUY,3,0.02h,Break Even,$-1.50,$517.50,$200931.50,339,$517.50
,,,,,,,,,,,
2025-04-22,00:38:00,17986.5,SELL,3,0.02h,Break Even,$-1.50,$-1.50,$200930.00,340,$-1.50
2025-04-22,00:59:00,17992.0,BUY,3,0.02h,Stop Loss,$9.00,$7.50,$200939.00,340,$7.50
2025-04-22,01:53:00,18039.75,SELL,3,0.02h,Stop Loss,$15.00,$22.50,$200954.00,340,$22.50
2025-04-22,02:14:00,18042.75,BUY,3,0.02h,Stop Loss,$-9.00,$13.50,$200945.00,340,$13.50
2025-04-22,02:26:00,18032.0,SELL,3,0.02h,Stop Loss,$42.00,$55.50,$200987.00,340,$55.50
2025-04-22,02:42:00,18034.25,BUY,3,0.02h,Stop Loss,$-9.00,$46.50,$200978.00,340,$46.50
2025-04-22,02:45:00,18023.5,SELL,3,0.02h,Stop Loss,$-9.00,$37.50,$200969.00,340,$37.50
2025-04-22,02:46:00,18028.5,BUY,3,0.02h,Break Even,$-1.50,$36.00,$200967.50,340,$36.00
2025-04-22,02:51:00,18024.75,SELL,3,0.02h,Break Even,$-1.50,$34.50,$200966.00,340,$34.50
2025-04-22,02:52:00,18030.5,BUY,3,0.02h,Break Even,$-1.50,$33.00,$200964.50,340,$33.00
2025-04-22,02:56:00,18026.75,SELL,3,0.02h,Break Even,$-1.50,$31.50,$200963.00,340,$31.50
2025-04-22,02:57:00,18029.25,BUY,3,0.02h,Stop Loss,$-9.00,$22.50,$200954.00,340,$22.50
2025-04-22,03:04:00,18020.0,SELL,3,0.02h,Stop Loss,$-9.00,$13.50,$200945.00,340,$13.50
2025-04-22,03:37:00,18016.25,BUY,3,0.02h,Break Even,$-1.50,$12.00,$200943.50,340,$12.00
2025-04-22,03:52:00,17990.25,SELL,3,0.02h,Break Even,$-1.50,$10.50,$200942.00,340,$10.50
2025-04-22,04:26:00,17987.0,BUY,3,0.02h,Stop Loss,$-9.00,$1.50,$200933.00,340,$1.50
2025-04-22,04:35:00,17978.25,SELL,3,0.02h,Break Even,$-1.50,$0.00,$200931.50,340,$0.00
2025-04-22,04:42:00,17988.5,BUY,3,0.02h,Stop Loss,$-9.00,$-9.00,$200922.50,340,$-9.00
2025-04-22,04:55:00,17978.75,SELL,3,0.02h,Break Even,$-1.50,$-10.50,$200921.00,340,$-10.50
2025-04-22,05:03:00,17992.0,BUY,3,0.02h,Stop Loss,$19.50,$9.00,$200940.50,340,$9.00
2025-04-22,05:22:00,17983.0,SELL,3,0.02h,Break Even,$-1.50,$7.50,$200939.00,340,$7.50
2025-04-22,05:38:00,17994.75,BUY,3,0.02h,Break Even,$-1.50,$6.00,$200937.50,340,$6.00
2025-04-22,05:57:00,17989.25,SELL,3,0.02h,Stop Loss,$-9.00,$-3.00,$200928.50,340,$-3.00
2025-04-22,05:58:00,17997.25,BUY,3,0.02h,Break Even,$-1.50,$-4.50,$200927.00,340,$-4.50
2025-04-22,07:15:00,18094.25,SELL,3,0.02h,Stop Loss,$34.50,$30.00,$200961.50,340,$30.00
2025-04-22,07:32:00,18109.25,BUY,3,0.02h,Stop Loss,$-9.00,$21.00,$200952.50,340,$21.00
2025-04-22,07:33:00,18097.0,SELL,3,0.02h,Stop Loss,$12.00,$33.00,$200964.50,340,$33.00
2025-04-22,08:27:00,18084.25,BUY,3,0.02h,Stop Loss,$9.00,$42.00,$200973.50,340,$42.00
2025-04-22,09:14:00,18102.25,SELL,3,0.02h,Stop Loss,$7.50,$49.50,$200981.00,340,$49.50
2025-04-22,09:29:00,18115.75,BUY,3,0.02h,Stop Loss,$-9.00,$40.50,$200972.00,340,$40.50
2025-04-22,09:44:00,18100.25,SELL,3,0.02h,Break Even,$-1.50,$39.00,$200970.50,340,$39.00
2025-04-22,10:15:00,18102.5,BUY,3,0.02h,Break Even,$-1.50,$37.50,$200969.00,340,$37.50
2025-04-22,10:26:00,18090.25,SELL,3,0.02h,Stop Loss,$12.00,$49.50,$200981.00,340,$49.50
2025-04-22,10:43:00,18095.0,BUY,3,0.02h,Stop Loss,$-9.00,$40.50,$200972.00,340,$40.50
2025-04-22,10:56:00,18089.25,SELL,3,0.02h,Break Even,$-1.50,$39.00,$200970.50,340,$39.00
2025-04-22,11:01:00,18093.75,BUY,3,0.02h,Stop Loss,$18.00,$57.00,$200988.50,340,$57.00
2025-04-22,11:08:00,18067.25,SELL,3,0.02h,Stop Loss,$19.50,$76.50,$201008.00,340,$76.50
2025-04-22,11:26:00,18084.25,BUY,3,0.02h,Break Even,$-1.50,$75.00,$201006.50,340,$75.00
2025-04-22,11:37:00,18069.5,SELL,3,0.02h,Stop Loss,$48.00,$123.00,$201054.50,340,$123.00
2025-04-22,11:49:00,18077.75,BUY,3,0.02h,Stop Loss,$-9.00,$114.00,$201045.50,340,$114.00
2025-04-22,11:53:00,18065.5,SELL,3,0.02h,Stop Loss,$39.00,$153.00,$201084.50,340,$153.00
2025-04-22,12:12:00,18066.75,BUY,3,0.02h,Break Even,$-1.50,$151.50,$201083.00,340,$151.50
2025-04-22,13:35:00,18111.25,SELL,3,0.02h,Stop Loss,$45.00,$196.50,$201128.00,340,$196.50
2025-04-22,13:40:00,18153.0,BUY,3,0.02h,Stop Loss,$69.00,$265.50,$201197.00,340,$265.50
2025-04-22,15:30:00,18352.0,SELL,3,0.02h,Stop Loss,$61.50,$327.00,$201258.50,340,$327.00
2025-04-22,16:00:00,18379.0,BUY,3,0.02h,Stop Loss,$325.50,$652.50,$201584.00,340,$652.50
2025-04-22,16:42:00,18451.25,SELL,3,0.02h,Break Even,$-1.50,$651.00,$201582.50,340,$651.00
2025-04-22,17:09:00,18480.75,BUY,3,0.02h,Stop Loss,$52.50,$703.50,$201635.00,340,$703.50
2025-04-22,17:11:00,18415.0,SELL,3,0.02h,Stop Loss,$192.00,$895.50,$201827.00,340,$895.50
2025-04-22,18:06:00,18295.25,BUY,3,0.02h,Stop Loss,$51.00,$946.50,$201878.00,340,$946.50
2025-04-22,19:09:00,18365.0,SELL,3,0.02h,Stop Loss,$15.00,$961.50,$201893.00,340,$961.50
2025-04-22,19:45:00,18324.25,BUY,3,0.02h,Stop Loss,$120.00,$1081.50,$202013.00,340,$1081.50
2025-04-22,20:19:00,18359.25,SELL,3,0.02h,Stop Loss,$30.00,$1111.50,$202043.00,340,$1111.50
2025-04-22,20:28:00,18367.25,BUY,3,0.02h,Break Even,$-1.50,$1110.00,$202041.50,340,$1110.00
2025-04-22,20:47:00,18361.75,SELL,3,0.02h,Break Even,$-1.50,$1108.50,$202040.00,340,$1108.50
2025-04-22,23:00:00,18765.5,BUY,3,0.02h,Stop Loss,$96.00,$1204.50,$202136.00,340,$1204.50
,,,,,,,,,,,
2025-04-23,00:11:00,18738.25,SELL,3,0.02h,Stop Loss,$7.50,$7.50,$202143.50,341,$7.50
2025-04-23,00:57:00,18703.5,BUY,3,0.02h,Stop Loss,$-9.00,$-1.50,$202134.50,341,$-1.50
2025-04-23,01:26:00,18705.25,SELL,3,0.02h,Stop Loss,$4.50,$3.00,$202139.00,341,$3.00
2025-04-23,02:10:00,18657.75,BUY,3,0.02h,Break Even,$-1.50,$1.50,$202137.50,341,$1.50
2025-04-23,03:02:00,18672.5,SELL,3,0.02h,Stop Loss,$49.50,$51.00,$202187.00,341,$51.00
2025-04-23,03:25:00,18689.0,BUY,3,0.02h,Stop Loss,$-9.00,$42.00,$202178.00,341,$42.00
2025-04-23,04:25:00,18709.75,SELL,3,0.02h,Break Even,$-1.50,$40.50,$202176.50,341,$40.50
2025-04-23,04:31:00,18720.5,BUY,3,0.02h,Stop Loss,$18.00,$58.50,$202194.50,341,$58.50
2025-04-23,05:03:00,18714.0,SELL,3,0.02h,Stop Loss,$6.00,$64.50,$202200.50,341,$64.50
2025-04-23,05:30:00,18713.75,BUY,3,0.02h,Stop Loss,$-9.00,$55.50,$202191.50,341,$55.50
2025-04-23,06:10:00,18735.75,SELL,3,0.02h,Break Even,$-1.50,$54.00,$202190.00,341,$54.00
2025-04-23,06:11:00,18743.25,BUY,3,0.02h,Stop Loss,$-9.00,$45.00,$202181.00,341,$45.00
2025-04-23,06:39:00,18741.5,SELL,3,0.02h,Stop Loss,$34.50,$79.50,$202215.50,341,$79.50
2025-04-23,07:03:00,18762.75,BUY,3,0.02h,Break Even,$-1.50,$78.00,$202214.00,341,$78.00
2025-04-23,07:07:00,18736.25,SELL,3,0.02h,Stop Loss,$40.50,$118.50,$202254.50,341,$118.50
2025-04-23,07:18:00,18742.0,BUY,3,0.02h,Stop Loss,$31.50,$150.00,$202286.00,341,$150.00
2025-04-23,07:25:00,18734.75,SELL,3,0.02h,Stop Loss,$21.00,$171.00,$202307.00,341,$171.00
2025-04-23,07:30:00,18745.25,BUY,3,0.02h,Stop Loss,$33.00,$204.00,$202340.00,341,$204.00
2025-04-23,08:57:00,18830.5,SELL,3,0.02h,Break Even,$-1.50,$202.50,$202338.50,341,$202.50
2025-04-23,09:08:00,18845.25,BUY,3,0.02h,Break Even,$-1.50,$201.00,$202337.00,341,$201.00
2025-04-23,09:28:00,18834.75,SELL,3,0.02h,Stop Loss,$-9.00,$192.00,$202328.00,341,$192.00
2025-04-23,09:57:00,18841.25,BUY,3,0.02h,Stop Loss,$28.50,$220.50,$202356.50,341,$220.50
2025-04-23,11:24:00,18908.75,SELL,3,0.02h,Stop Loss,$31.50,$252.00,$202388.00,341,$252.00
2025-04-23,12:12:00,18893.0,BUY,3,0.02h,Break Even,$-1.50,$250.50,$202386.50,341,$250.50
2025-04-23,13:07:00,18926.5,SELL,3,0.02h,Stop Loss,$6.00,$256.50,$202392.50,341,$256.50
2025-04-23,13:22:00,18945.0,BUY,3,0.02h,Stop Loss,$13.50,$270.00,$202406.00,341,$270.00
2025-04-23,14:18:00,18996.0,SELL,3,0.02h,Stop Loss,$82.50,$352.50,$202488.50,341,$352.50
2025-04-23,14:26:00,19076.25,BUY,3,0.02h,Stop Loss,$160.50,$513.00,$202649.00,341,$513.00
2025-04-23,14:51:00,19076.5,SELL,3,0.02h,Stop Loss,$7.50,$520.50,$202656.50,341,$520.50
2025-04-23,16:32:00,18842.0,BUY,3,0.02h,Stop Loss,$-9.00,$511.50,$202647.50,341,$511.50
2025-04-23,17:33:00,18925.25,SELL,3,0.02h,Stop Loss,$105.00,$616.50,$202752.50,341,$616.50
2025-04-23,17:55:00,18925.5,BUY,3,0.02h,Stop Loss,$36.00,$652.50,$202788.50,341,$652.50
2025-04-23,18:26:00,18893.75,SELL,3,0.02h,Stop Loss,$63.00,$715.50,$202851.50,341,$715.50
2025-04-23,18:59:00,18896.75,BUY,3,0.02h,Break Even,$-1.50,$714.00,$202850.00,341,$714.00
2025-04-23,19:00:00,18869.75,SELL,3,0.02h,Stop Loss,$37.50,$751.50,$202887.50,341,$751.50
2025-04-23,19:51:00,18824.25,BUY,3,0.02h,Break Even,$-1.50,$750.00,$202886.00,341,$750.00
2025-04-23,20:04:00,18779.0,SELL,3,0.02h,Stop Loss,$-9.00,$741.00,$202877.00,341,$741.00
2025-04-23,20:11:00,18812.0,BUY,3,0.02h,Stop Loss,$22.50,$763.50,$202899.50,341,$763.50
2025-04-23,20:45:00,18850.75,SELL,3,0.02h,Break Even,$-1.50,$762.00,$202898.00,341,$762.00
2025-04-23,23:24:00,18848.25,BUY,3,0.02h,Break Even,$-1.50,$760.50,$202896.50,341,$760.50
2025-04-23,23:31:00,18818.75,SELL,3,0.02h,Stop Loss,$6.00,$766.50,$202902.50,341,$766.50
2025-04-23,23:49:00,18829.25,BUY,3,0.02h,Break Even,$-1.50,$765.00,$202901.00,341,$765.00
,,,,,,,,,,,
2025-04-24,00:26:00,18846.25,SELL,3,0.02h,Stop Loss,$9.00,$9.00,$202910.00,342,$9.00
2025-04-24,00:42:00,18855.75,BUY,3,0.02h,Break Even,$-1.50,$7.50,$202908.50,342,$7.50
2025-04-24,00:49:00,18843.25,SELL,3,0.02h,Break Even,$-1.50,$6.00,$202907.00,342,$6.00
2025-04-24,01:39:00,18828.75,BUY,3,0.02h,Break Even,$-1.50,$4.50,$202905.50,342,$4.50
2025-04-24,01:43:00,18810.75,SELL,3,0.02h,Break Even,$-1.50,$3.00,$202904.00,342,$3.00
2025-04-24,02:18:00,18791.0,BUY,3,0.02h,Stop Loss,$-9.00,$-6.00,$202895.00,342,$-6.00
2025-04-24,02:19:00,18776.25,SELL,3,0.02h,Break Even,$-1.50,$-7.50,$202893.50,342,$-7.50
2025-04-24,02:22:00,18793.0,BUY,3,0.02h,Stop Loss,$4.50,$-3.00,$202898.00,342,$-3.00
2025-04-24,02:33:00,18779.0,SELL,3,0.02h,Stop Loss,$31.50,$28.50,$202929.50,342,$28.50
2025-04-24,03:38:00,18755.0,BUY,3,0.02h,Break Even,$-1.50,$27.00,$202928.00,342,$27.00
2025-04-24,04:08:00,18747.25,SELL,3,0.02h,Stop Loss,$-9.00,$18.00,$202919.00,342,$18.00
2025-04-24,04:40:00,18743.5,BUY,3,0.02h,Stop Loss,$-9.00,$9.00,$202910.00,342,$9.00
2025-04-24,05:20:00,18758.75,SELL,3,0.02h,Stop Loss,$12.00,$21.00,$202922.00,342,$21.00
2025-04-24,05:38:00,18764.75,BUY,3,0.02h,Break Even,$-1.50,$19.50,$202920.50,342,$19.50
2025-04-24,05:52:00,18746.5,SELL,3,0.02h,Break Even,$-1.50,$18.00,$202919.00,342,$18.00
2025-04-24,06:19:00,18734.25,BUY,3,0.02h,Stop Loss,$6.00,$24.00,$202925.00,342,$24.00
2025-04-24,06:40:00,18742.75,SELL,3,0.02h,Stop Loss,$16.50,$40.50,$202941.50,342,$40.50
2025-04-24,07:15:00,18745.75,BUY,3,0.02h,Stop Loss,$15.00,$55.50,$202956.50,342,$55.50
2025-04-24,07:24:00,18723.25,SELL,3,0.02h,Stop Loss,$78.00,$133.50,$203034.50,342,$133.50
2025-04-24,08:03:00,18692.75,BUY,3,0.02h,Stop Loss,$6.00,$139.50,$203040.50,342,$139.50
2025-04-24,08:08:00,18657.25,SELL,3,0.02h,Stop Loss,$33.00,$172.50,$203073.50,342,$172.50
2025-04-24,09:00:00,18629.5,BUY,3,0.02h,Stop Loss,$34.50,$207.00,$203108.00,342,$207.00
2025-04-24,11:09:00,18778.75,SELL,3,0.02h,Break Even,$-1.50,$205.50,$203106.50,342,$205.50
2025-04-24,11:51:00,18754.0,BUY,3,0.02h,Stop Loss,$15.00,$220.50,$203121.50,342,$220.50
2025-04-24,13:08:00,18830.0,SELL,3,0.02h,Stop Loss,$13.50,$234.00,$203135.00,342,$234.00
2025-04-24,13:20:00,18840.0,BUY,3,0.02h,Stop Loss,$-9.00,$225.00,$203126.00,342,$225.00
2025-04-24,14:48:00,19097.5,SELL,3,0.02h,Stop Loss,$39.00,$264.00,$203165.00,342,$264.00
2025-04-24,14:57:00,19143.25,BUY,3,0.02h,Stop Loss,$9.00,$273.00,$203174.00,342,$273.00
2025-04-24,15:26:00,19154.0,SELL,3,0.02h,Stop Loss,$-9.00,$264.00,$203165.00,342,$264.00
2025-04-24,15:39:00,19176.0,BUY,3,0.02h,Break Even,$-1.50,$262.50,$203163.50,342,$262.50
2025-04-24,15:45:00,19153.0,SELL,3,0.02h,Stop Loss,$31.50,$294.00,$203195.00,342,$294.00
2025-04-24,15:50:00,19173.75,BUY,3,0.02h,Break Even,$-1.50,$292.50,$203193.50,342,$292.50
2025-04-24,16:02:00,19158.75,SELL,3,0.02h,Stop Loss,$51.00,$343.50,$203244.50,342,$343.50
2025-04-24,16:14:00,19185.25,BUY,3,0.02h,Stop Loss,$25.50,$369.00,$203270.00,342,$369.00
2025-04-24,17:17:00,19226.75,SELL,3,0.02h,Stop Loss,$61.50,$430.50,$203331.50,342,$430.50
2025-04-24,17:27:00,19255.0,BUY,3,0.02h,Stop Loss,$21.00,$451.50,$203352.50,342,$451.50
2025-04-24,17:38:00,19242.0,SELL,3,0.02h,Stop Loss,$-9.00,$442.50,$203343.50,342,$442.50
2025-04-24,17:39:00,19249.25,BUY,3,0.02h,Stop Loss,$-9.00,$433.50,$203334.50,342,$433.50
2025-04-24,17:41:00,19237.25,SELL,3,0.02h,Stop Loss,$66.00,$499.50,$203400.50,342,$499.50
2025-04-24,17:51:00,19247.25,BUY,3,0.02h,Stop Loss,$6.00,$505.50,$203406.50,342,$505.50
2025-04-24,19:00:00,19292.5,SELL,3,0.02h,Stop Loss,$55.50,$561.00,$203462.00,342,$561.00
2025-04-24,19:38:00,19274.25,BUY,3,0.02h,Stop Loss,$22.50,$583.50,$203484.50,342,$583.50
2025-04-24,20:20:00,19333.25,SELL,3,0.02h,Stop Loss,$10.50,$594.00,$203495.00,342,$594.00
2025-04-24,20:27:00,19344.75,BUY,3,0.02h,Stop Loss,$21.00,$615.00,$203516.00,342,$615.00
2025-04-24,20:31:00,19327.0,SELL,3,0.02h,Stop Loss,$-9.00,$606.00,$203507.00,342,$606.00
2025-04-24,20:36:00,19346.0,BUY,3,0.02h,Stop Loss,$3.00,$609.00,$203510.00,342,$609.00
2025-04-24,20:58:00,19349.0,SELL,3,0.02h,Break Even,$-1.50,$607.50,$203508.50,342,$607.50
2025-04-24,23:00:00,19405.5,BUY,3,0.02h,Stop Loss,$4.50,$612.00,$203513.00,342,$612.00
2025-04-24,23:54:00,19410.5,SELL,3,0.02h,Stop Loss,$21.00,$633.00,$203534.00,342,$633.00
,,,,,,,,,,,
2025-04-25,00:08:00,19420.0,BUY,3,0.02h,Break Even,$-1.50,$-1.50,$203532.50,343,$-1.50
2025-04-25,00:10:00,19408.5,SELL,3,0.02h,Stop Loss,$37.50,$36.00,$203570.00,343,$36.00
2025-04-25,00:23:00,19415.25,BUY,3,0.02h,Stop Loss,$24.00,$60.00,$203594.00,343,$60.00
2025-04-25,01:19:00,19442.75,SELL,3,0.02h,Stop Loss,$42.00,$102.00,$203636.00,343,$102.00
2025-04-25,01:42:00,19445.25,BUY,3,0.02h,Break Even,$-1.50,$100.50,$203634.50,343,$100.50
2025-04-25,01:51:00,19416.25,SELL,3,0.02h,Stop Loss,$18.00,$118.50,$203652.50,343,$118.50
2025-04-25,02:59:00,19384.0,BUY,3,0.02h,Break Even,$-1.50,$117.00,$203651.00,343,$117.00
2025-04-25,03:08:00,19373.75,SELL,3,0.02h,Stop Loss,$-9.00,$108.00,$203642.00,343,$108.00
2025-04-25,03:17:00,19387.75,BUY,3,0.02h,Break Even,$-1.50,$106.50,$203640.50,343,$106.50
2025-04-25,04:25:00,19452.0,SELL,3,0.02h,Stop Loss,$58.50,$165.00,$203699.00,343,$165.00
2025-04-25,05:10:00,19423.5,BUY,3,0.02h,Stop Loss,$4.50,$169.50,$203703.50,343,$169.50
2025-04-25,05:26:00,19415.75,SELL,3,0.02h,Stop Loss,$42.00,$211.50,$203745.50,343,$211.50
2025-04-25,05:40:00,19424.5,BUY,3,0.02h,Stop Loss,$-9.00,$202.50,$203736.50,343,$202.50
2025-04-25,05:41:00,19415.25,SELL,3,0.02h,Break Even,$-1.50,$201.00,$203735.00,343,$201.00
2025-04-25,05:42:00,19417.5,BUY,3,0.02h,Stop Loss,$-9.00,$192.00,$203726.00,343,$192.00
2025-04-25,05:43:00,19414.5,SELL,3,0.02h,Break Even,$-1.50,$190.50,$203724.50,343,$190.50
2025-04-25,05:45:00,19423.5,BUY,3,0.02h,Stop Loss,$7.50,$198.00,$203732.00,343,$198.00
2025-04-25,05:52:00,19406.5,SELL,3,0.02h,Stop Loss,$13.50,$211.50,$203745.50,343,$211.50
2025-04-25,06:06:00,19429.5,BUY,3,0.02h,Break Even,$-1.50,$210.00,$203744.00,343,$210.00
2025-04-25,06:21:00,19418.75,SELL,3,0.02h,Stop Loss,$46.50,$256.50,$203790.50,343,$256.50
2025-04-25,06:31:00,19434.0,BUY,3,0.02h,Stop Loss,$-9.00,$247.50,$203781.50,343,$247.50
2025-04-25,07:11:00,19444.5,SELL,3,0.02h,Stop Loss,$15.00,$262.50,$203796.50,343,$262.50
2025-04-25,07:47:00,19412.75,BUY,3,0.02h,Stop Loss,$21.00,$283.50,$203817.50,343,$283.50
2025-04-25,08:13:00,19402.75,SELL,3,0.02h,Break Even,$-1.50,$282.00,$203816.00,343,$282.00
2025-04-25,08:19:00,19418.25,BUY,3,0.02h,Stop Loss,$9.00,$291.00,$203825.00,343,$291.00
2025-04-25,08:22:00,19415.25,SELL,3,0.02h,Break Even,$-1.50,$289.50,$203823.50,343,$289.50
2025-04-25,08:23:00,19418.75,BUY,3,0.02h,Stop Loss,$9.00,$298.50,$203832.50,343,$298.50
2025-04-25,08:34:00,19415.25,SELL,3,0.02h,Stop Loss,$76.50,$375.00,$203909.00,343,$375.00
2025-04-25,08:52:00,19416.0,BUY,3,0.02h,Stop Loss,$45.00,$420.00,$203954.00,343,$420.00
2025-04-25,08:59:00,19399.75,SELL,3,0.02h,Break Even,$-1.50,$418.50,$203952.50,343,$418.50
2025-04-25,09:26:00,19390.5,BUY,3,0.02h,Break Even,$-1.50,$417.00,$203951.00,343,$417.00
2025-04-25,09:42:00,19379.75,SELL,3,0.02h,Stop Loss,$49.50,$466.50,$204000.50,343,$466.50
2025-04-25,09:53:00,19395.25,BUY,3,0.02h,Break Even,$-1.50,$465.00,$203999.00,343,$465.00
2025-04-25,10:03:00,19374.5,SELL,3,0.02h,Break Even,$-1.50,$463.50,$203997.50,343,$463.50
2025-04-25,11:07:00,19267.25,BUY,3,0.02h,Stop Loss,$69.00,$532.50,$204066.50,343,$532.50
2025-04-25,11:37:00,19285.75,SELL,3,0.02h,Stop Loss,$42.00,$574.50,$204108.50,343,$574.50
2025-04-25,12:14:00,19262.25,BUY,3,0.02h,Stop Loss,$16.50,$591.00,$204125.00,343,$591.00
2025-04-25,12:29:00,19255.0,SELL,3,0.02h,Break Even,$-1.50,$589.50,$204123.50,343,$589.50
2025-04-25,12:33:00,19286.75,BUY,3,0.02h,Stop Loss,$-9.00,$580.50,$204114.50,343,$580.50
2025-04-25,12:48:00,19252.25,SELL,3,0.02h,Stop Loss,$21.00,$601.50,$204135.50,343,$601.50
2025-04-25,13:09:00,19261.25,BUY,3,0.02h,Break Even,$-1.50,$600.00,$204134.00,343,$600.00
2025-04-25,13:48:00,19275.5,SELL,3,0.02h,Stop Loss,$4.50,$604.50,$204138.50,343,$604.50
2025-04-25,14:02:00,19321.25,BUY,3,0.02h,Stop Loss,$108.00,$712.50,$204246.50,343,$712.50
2025-04-25,14:23:00,19271.5,SELL,3,0.02h,Stop Loss,$91.50,$804.00,$204338.00,343,$804.00
2025-04-25,14:40:00,19331.5,BUY,3,0.02h,Stop Loss,$132.00,$936.00,$204470.00,343,$936.00
2025-04-25,14:59:00,19308.5,SELL,3,0.02h,Break Even,$-1.50,$934.50,$204468.50,343,$934.50
2025-04-25,15:05:00,19347.0,BUY,3,0.02h,Stop Loss,$43.50,$978.00,$204512.00,343,$978.00
2025-04-25,15:33:00,19356.5,SELL,3,0.02h,Stop Loss,$21.00,$999.00,$204533.00,343,$999.00
2025-04-25,15:53:00,19360.0,BUY,3,0.02h,Stop Loss,$-9.00,$990.00,$204524.00,343,$990.00
2025-04-25,17:39:00,19472.0,SELL,3,0.02h,Stop Loss,$154.50,$1144.50,$204678.50,343,$1144.50
2025-04-25,18:07:00,19458.5,BUY,3,0.02h,Stop Loss,$4.50,$1149.00,$204683.00,343,$1149.00
2025-04-25,19:00:00,19499.75,SELL,3,0.02h,Stop Loss,$18.00,$1167.00,$204701.00,343,$1167.00
2025-04-25,19:03:00,19512.5,BUY,3,0.02h,Stop Loss,$42.00,$1209.00,$204743.00,343,$1209.00
2025-04-25,19:12:00,19493.25,SELL,3,0.02h,Break Even,$-1.50,$1207.50,$204741.50,343,$1207.50
2025-04-25,19:24:00,19509.25,BUY,3,0.02h,Stop Loss,$10.50,$1218.00,$204752.00,343,$1218.00
2025-04-25,19:29:00,19488.75,SELL,3,0.02h,Stop Loss,$16.50,$1234.50,$204768.50,343,$1234.50
2025-04-25,19:51:00,19511.75,BUY,3,0.02h,Stop Loss,$-9.00,$1225.50,$204759.50,343,$1225.50
2025-04-25,20:45:00,19542.75,SELL,3,0.02h,Break Even,$-1.50,$1224.00,$204758.00,343,$1224.00
2025-04-25,21:00:00,19554.75,BUY,3,51.00h,Stop Loss,$-9.00,$1215.00,$204749.00,343,$1215.00
,,,,,,,,,,,
2025-04-28,00:00:00,19454.25,SELL,3,0.02h,Break Even,$-1.50,$-1.50,$204747.50,344,$-1.50
2025-04-28,01:14:00,19426.25,BUY,3,0.02h,Stop Loss,$13.50,$12.00,$204761.00,344,$12.00
2025-04-28,01:24:00,19415.5,SELL,3,0.02h,Stop Loss,$30.00,$42.00,$204791.00,344,$42.00
2025-04-28,01:42:00,19416.0,BUY,3,0.02h,Stop Loss,$-9.00,$33.00,$204782.00,344,$33.00
2025-04-28,02:48:00,19438.25,SELL,3,0.02h,Break Even,$-1.50,$31.50,$204780.50,344,$31.50
2025-04-28,04:03:00,19405.5,BUY,3,0.02h,Stop Loss,$3.00,$34.50,$204783.50,344,$34.50
2025-04-28,04:55:00,19415.0,SELL,3,0.02h,Break Even,$-1.50,$33.00,$204782.00,344,$33.00
2025-04-28,05:12:00,19419.75,BUY,3,0.02h,Break Even,$-1.50,$31.50,$204780.50,344,$31.50
2025-04-28,05:31:00,19411.25,SELL,3,0.02h,Stop Loss,$6.00,$37.50,$204786.50,344,$37.50
2025-04-28,05:41:00,19420.0,BUY,3,0.02h,Break Even,$-1.50,$36.00,$204785.00,344,$36.00
2025-04-28,05:43:00,19413.25,SELL,3,0.02h,Stop Loss,$34.50,$70.50,$204819.50,344,$70.50
2025-04-28,05:57:00,19415.75,BUY,3,0.02h,Break Even,$-1.50,$69.00,$204818.00,344,$69.00
2025-04-28,07:14:00,19487.25,SELL,3,0.02h,Break Even,$-1.50,$67.50,$204816.50,344,$67.50
2025-04-28,07:23:00,19507.5,BUY,3,0.02h,Break Even,$-1.50,$66.00,$204815.00,344,$66.00
2025-04-28,07:35:00,19490.75,SELL,3,0.02h,Break Even,$-1.50,$64.50,$204813.50,344,$64.50
2025-04-28,08:20:00,19473.25,BUY,3,0.02h,Stop Loss,$-9.00,$55.50,$204804.50,344,$55.50
2025-04-28,08:22:00,19459.5,SELL,3,0.02h,Stop Loss,$15.00,$70.50,$204819.50,344,$70.50
2025-04-28,08:36:00,19469.0,BUY,3,0.02h,Stop Loss,$12.00,$82.50,$204831.50,344,$82.50
2025-04-28,09:12:00,19483.75,SELL,3,0.02h,Stop Loss,$-9.00,$73.50,$204822.50,344,$73.50
2025-04-28,09:16:00,19502.5,BUY,3,0.02h,Stop Loss,$-9.00,$64.50,$204813.50,344,$64.50
2025-04-28,09:58:00,19518.25,SELL,3,0.02h,Stop Loss,$-9.00,$55.50,$204804.50,344,$55.50
2025-04-28,10:34:00,19508.25,BUY,3,0.02h,Break Even,$-1.50,$54.00,$204803.00,344,$54.00
2025-04-28,10:43:00,19488.75,SELL,3,0.02h,Stop Loss,$25.50,$79.50,$204828.50,344,$79.50
2025-04-28,11:09:00,19492.0,BUY,3,0.02h,Stop Loss,$13.50,$93.00,$204842.00,344,$93.00
2025-04-28,11:17:00,19482.0,SELL,3,0.02h,Break Even,$-1.50,$91.50,$204840.50,344,$91.50
2025-04-28,11:18:00,19498.75,BUY,3,0.02h,Break Even,$-1.50,$90.00,$204839.00,344,$90.00
2025-04-28,11:22:00,19481.5,SELL,3,0.02h,Stop Loss,$-9.00,$81.00,$204830.00,344,$81.00
2025-04-28,11:24:00,19493.5,BUY,3,0.02h,Break Even,$-1.50,$79.50,$204828.50,344,$79.50
2025-04-28,11:56:00,19511.5,SELL,3,0.02h,Stop Loss,$-9.00,$70.50,$204819.50,344,$70.50
2025-04-28,12:24:00,19507.75,BUY,3,0.02h,Stop Loss,$6.00,$76.50,$204825.50,344,$76.50
2025-04-28,13:32:00,19541.25,SELL,3,0.02h,Stop Loss,$6.00,$82.50,$204831.50,344,$82.50
2025-04-28,13:44:00,19580.5,BUY,3,0.02h,Stop Loss,$90.00,$172.50,$204921.50,344,$172.50
2025-04-28,13:56:00,19518.5,SELL,3,0.02h,Stop Loss,$48.00,$220.50,$204969.50,344,$220.50
2025-04-28,14:25:00,19536.0,BUY,3,0.02h,Break Even,$-1.50,$219.00,$204968.00,344,$219.00
2025-04-28,14:28:00,19503.75,SELL,3,0.02h,Stop Loss,$58.50,$277.50,$205026.50,344,$277.50
2025-04-28,14:39:00,19521.75,BUY,3,0.02h,Stop Loss,$4.50,$282.00,$205031.00,344,$282.00
2025-04-28,14:54:00,19485.5,SELL,3,0.02h,Break Even,$-1.50,$280.50,$205029.50,344,$280.50
2025-04-28,15:43:00,19384.75,BUY,3,0.02h,Break Even,$-1.50,$279.00,$205028.00,344,$279.00
2025-04-28,15:45:00,19352.25,SELL,3,0.02h,Stop Loss,$19.50,$298.50,$205047.50,344,$298.50
2025-04-28,16:36:00,19321.5,BUY,3,0.02h,Stop Loss,$27.00,$325.50,$205074.50,344,$325.50
2025-04-28,16:56:00,19303.25,SELL,3,0.02h,Stop Loss,$45.00,$370.50,$205119.50,344,$370.50
2025-04-28,17:02:00,19331.25,BUY,3,0.02h,Stop Loss,$-9.00,$361.50,$205110.50,344,$361.50
2025-04-28,17:03:00,19313.5,SELL,3,0.02h,Break Even,$-1.50,$360.00,$205109.00,344,$360.00
2025-04-28,17:04:00,19325.5,BUY,3,0.02h,Stop Loss,$25.50,$385.50,$205134.50,344,$385.50
2025-04-28,17:05:00,19316.0,SELL,3,0.02h,Stop Loss,$30.00,$415.50,$205164.50,344,$415.50
2025-04-28,17:40:00,19305.25,BUY,3,0.02h,Stop Loss,$40.50,$456.00,$205205.00,344,$456.00
2025-04-28,20:02:00,19501.75,SELL,3,0.02h,Stop Loss,$13.50,$469.50,$205218.50,344,$469.50
2025-04-28,23:00:00,19485.5,BUY,3,0.02h,Break Even,$-1.50,$468.00,$205217.00,344,$468.00
,,,,,,,,,,,
2025-04-29,00:05:00,19514.25,SELL,3,0.02h,Stop Loss,$15.00,$15.00,$205232.00,345,$15.00
2025-04-29,00:34:00,19511.75,BUY,3,0.02h,Break Even,$-1.50,$13.50,$205230.50,345,$13.50
2025-04-29,01:18:00,19547.75,SELL,3,0.02h,Stop Loss,$-9.00,$4.50,$205221.50,345,$4.50
2025-04-29,01:29:00,19554.0,BUY,3,0.02h,Stop Loss,$3.00,$7.50,$205224.50,345,$7.50
2025-04-29,02:42:00,19602.75,SELL,3,0.02h,Stop Loss,$40.50,$48.00,$205265.00,345,$48.00
2025-04-29,03:11:00,19588.0,BUY,3,0.02h,Stop Loss,$-9.00,$39.00,$205256.00,345,$39.00
2025-04-29,03:17:00,19570.25,SELL,3,0.02h,Break Even,$-1.50,$37.50,$205254.50,345,$37.50
2025-04-29,03:24:00,19580.75,BUY,3,0.02h,Break Even,$-1.50,$36.00,$205253.00,345,$36.00
2025-04-29,03:34:00,19574.0,SELL,3,0.02h,Stop Loss,$3.00,$39.00,$205256.00,345,$39.00
2025-04-29,03:57:00,19572.5,BUY,3,0.02h,Stop Loss,$-9.00,$30.00,$205247.00,345,$30.00
2025-04-29,04:02:00,19567.75,SELL,3,0.02h,Stop Loss,$-9.00,$21.00,$205238.00,345,$21.00
2025-04-29,04:23:00,19570.75,BUY,3,0.02h,Break Even,$-1.50,$19.50,$205236.50,345,$19.50
2025-04-29,04:43:00,19573.25,SELL,3,0.02h,Break Even,$-1.50,$18.00,$205235.00,345,$18.00
2025-04-29,05:09:00,19567.5,BUY,3,0.02h,Break Even,$-1.50,$16.50,$205233.50,345,$16.50
2025-04-29,05:20:00,19556.75,SELL,3,0.02h,Stop Loss,$51.00,$67.50,$205284.50,345,$67.50
2025-04-29,05:53:00,19549.25,BUY,3,0.02h,Stop Loss,$-9.00,$58.50,$205275.50,345,$58.50
2025-04-29,05:54:00,19545.25,SELL,3,0.02h,Stop Loss,$13.50,$72.00,$205289.00,345,$72.00
2025-04-29,06:16:00,19549.0,BUY,3,0.02h,Break Even,$-1.50,$70.50,$205287.50,345,$70.50
2025-04-29,06:25:00,19537.5,SELL,3,0.02h,Stop Loss,$-9.00,$61.50,$205278.50,345,$61.50
2025-04-29,06:26:00,19546.25,BUY,3,0.02h,Break Even,$-1.50,$60.00,$205277.00,345,$60.00
2025-04-29,06:55:00,19548.5,SELL,3,0.02h,Stop Loss,$6.00,$66.00,$205283.00,345,$66.00
2025-04-29,07:08:00,19560.0,BUY,3,0.02h,Stop Loss,$33.00,$99.00,$205316.00,345,$99.00
2025-04-29,08:03:00,19580.5,SELL,3,0.02h,Stop Loss,$22.50,$121.50,$205338.50,345,$121.50
2025-04-29,08:30:00,19573.75,BUY,3,0.02h,Break Even,$-1.50,$120.00,$205337.00,345,$120.00
2025-04-29,09:01:00,19575.75,SELL,3,0.02h,Stop Loss,$4.50,$124.50,$205341.50,345,$124.50
2025-04-29,09:06:00,19587.75,BUY,3,0.02h,Break Even,$-1.50,$123.00,$205340.00,345,$123.00
2025-04-29,09:07:00,19581.0,SELL,3,0.02h,Stop Loss,$13.50,$136.50,$205353.50,345,$136.50
2025-04-29,09:37:00,19568.5,BUY,3,0.02h,Break Even,$-1.50,$135.00,$205352.00,345,$135.00
2025-04-29,09:55:00,19565.0,SELL,3,0.02h,Stop Loss,$-9.00,$126.00,$205343.00,345,$126.00
2025-04-29,10:17:00,19571.75,BUY,3,0.02h,Stop Loss,$-9.00,$117.00,$205334.00,345,$117.00
2025-04-29,10:19:00,19555.0,SELL,3,0.02h,Stop Loss,$-9.00,$108.00,$205325.00,345,$108.00
2025-04-29,10:25:00,19564.5,BUY,3,0.02h,Stop Loss,$3.00,$111.00,$205328.00,345,$111.00
2025-04-29,10:34:00,19533.75,SELL,3,0.02h,Stop Loss,$79.50,$190.50,$205407.50,345,$190.50
2025-04-29,11:10:00,19506.75,BUY,3,0.02h,Break Even,$-1.50,$189.00,$205406.00,345,$189.00
2025-04-29,11:39:00,19502.0,SELL,3,0.02h,Break Even,$-1.50,$187.50,$205404.50,345,$187.50
2025-04-29,12:07:00,19508.75,BUY,3,0.02h,Stop Loss,$12.00,$199.50,$205416.50,345,$199.50
2025-04-29,12:11:00,19497.75,SELL,3,0.02h,Stop Loss,$3.00,$202.50,$205419.50,345,$202.50
2025-04-29,12:34:00,19495.0,BUY,3,0.02h,Stop Loss,$12.00,$214.50,$205431.50,345,$214.50
2025-04-29,12:55:00,19497.5,SELL,3,0.02h,Stop Loss,$43.50,$258.00,$205475.00,345,$258.00
2025-04-29,13:30:00,19427.25,BUY,3,0.02h,Stop Loss,$76.50,$334.50,$205551.50,345,$334.50
2025-04-29,14:22:00,19500.5,SELL,3,0.02h,Stop Loss,$21.00,$355.50,$205572.50,345,$355.50
2025-04-29,14:36:00,19556.0,BUY,3,0.02h,Stop Loss,$48.00,$403.50,$205620.50,345,$403.50
2025-04-29,15:13:00,19565.0,SELL,3,0.02h,Stop Loss,$96.00,$499.50,$205716.50,345,$499.50
2025-04-29,15:42:00,19555.0,BUY,3,0.02h,Stop Loss,$81.00,$580.50,$205797.50,345,$580.50
2025-04-29,15:58:00,19539.25,SELL,3,0.02h,Break Even,$-1.50,$579.00,$205796.00,345,$579.00
2025-04-29,16:04:00,19579.5,BUY,3,0.02h,Break Even,$-1.50,$577.50,$205794.50,345,$577.50
2025-04-29,16:20:00,19556.5,SELL,3,0.02h,Stop Loss,$34.50,$612.00,$205829.00,345,$612.00
2025-04-29,16:37:00,19581.25,BUY,3,0.02h,Stop Loss,$-9.00,$603.00,$205820.00,345,$603.00
2025-04-29,16:39:00,19550.0,SELL,3,0.02h,Stop Loss,$9.00,$612.00,$205829.00,345,$612.00
2025-04-29,16:43:00,19577.0,BUY,3,0.02h,Stop Loss,$12.00,$624.00,$205841.00,345,$624.00
2025-04-29,16:47:00,19547.5,SELL,3,0.02h,Stop Loss,$84.00,$708.00,$205925.00,345,$708.00
2025-04-29,17:18:00,19542.25,BUY,3,0.02h,Stop Loss,$40.50,$748.50,$205965.50,345,$748.50
2025-04-29,18:23:00,19644.0,SELL,3,0.02h,Stop Loss,$-9.00,$739.50,$205956.50,345,$739.50
2025-04-29,18:26:00,19663.5,BUY,3,0.02h,Stop Loss,$4.50,$744.00,$205961.00,345,$744.00
2025-04-29,18:27:00,19656.0,SELL,3,0.02h,Stop Loss,$-9.00,$735.00,$205952.00,345,$735.00
2025-04-29,18:28:00,19670.25,BUY,3,0.02h,Stop Loss,$79.50,$814.50,$206031.50,345,$814.50
2025-04-29,18:49:00,19665.25,SELL,3,0.02h,Stop Loss,$7.50,$822.00,$206039.00,345,$822.00
2025-04-29,19:12:00,19671.0,BUY,3,0.02h,Stop Loss,$-9.00,$813.00,$206030.00,345,$813.00
2025-04-29,19:16:00,19643.25,SELL,3,0.02h,Break Even,$-1.50,$811.50,$206028.50,345,$811.50
2025-04-29,19:34:00,19657.25,BUY,3,0.02h,Break Even,$-1.50,$810.00,$206027.00,345,$810.00
2025-04-29,19:37:00,19641.75,SELL,3,0.02h,Stop Loss,$24.00,$834.00,$206051.00,345,$834.00
2025-04-29,19:50:00,19663.0,BUY,3,0.02h,Stop Loss,$93.00,$927.00,$206144.00,345,$927.00
2025-04-29,20:04:00,19645.0,SELL,3,0.02h,Stop Loss,$19.50,$946.50,$206163.50,345,$946.50
2025-04-29,20:27:00,19639.25,BUY,3,0.02h,Stop Loss,$-9.00,$937.50,$206154.50,345,$937.50
2025-04-29,20:29:00,19620.0,SELL,3,0.02h,Stop Loss,$28.50,$966.00,$206183.00,345,$966.00
2025-04-29,20:57:00,19617.25,BUY,3,0.02h,Stop Loss,$19.50,$985.50,$206202.50,345,$985.50
2025-04-29,23:01:00,19563.5,SELL,3,0.02h,Stop Loss,$-9.00,$976.50,$206193.50,345,$976.50
2025-04-29,23:35:00,19565.25,BUY,3,0.02h,Stop Loss,$13.50,$990.00,$206207.00,345,$990.00
2025-04-29,23:52:00,19565.5,SELL,3,0.02h,Break Even,$-1.50,$988.50,$206205.50,345,$988.50
,,,,,,,,,,,
2025-04-30,00:09:00,19578.5,BUY,3,0.02h,Stop Loss,$16.50,$16.50,$206222.00,346,$16.50
2025-04-30,00:19:00,19555.25,SELL,3,0.02h,Break Even,$-1.50,$15.00,$206220.50,346,$15.00
2025-04-30,00:38:00,19563.25,BUY,3,0.02h,Break Even,$-1.50,$13.50,$206219.00,346,$13.50
2025-04-30,00:41:00,19556.25,SELL,3,0.02h,Stop Loss,$-9.00,$4.50,$206210.00,346,$4.50
2025-04-30,01:12:00,19536.5,BUY,3,0.02h,Stop Loss,$-9.00,$-4.50,$206201.00,346,$-4.50
2025-04-30,01:28:00,19535.25,SELL,3,0.02h,Stop Loss,$-9.00,$-13.50,$206192.00,346,$-13.50
2025-04-30,01:30:00,19542.0,BUY,3,0.02h,Break Even,$-1.50,$-15.00,$206190.50,346,$-15.00
2025-04-30,01:33:00,19526.5,SELL,3,0.02h,Stop Loss,$-9.00,$-24.00,$206181.50,346,$-24.00
2025-04-30,01:37:00,19543.5,BUY,3,0.02h,Stop Loss,$-9.00,$-33.00,$206172.50,346,$-33.00
2025-04-30,01:40:00,19533.0,SELL,3,0.02h,Stop Loss,$30.00,$-3.00,$206202.50,346,$-3.00
2025-04-30,02:11:00,19522.0,BUY,3,0.02h,Stop Loss,$19.50,$16.50,$206222.00,346,$16.50
2025-04-30,02:22:00,19511.5,SELL,3,0.02h,Break Even,$-1.50,$15.00,$206220.50,346,$15.00
2025-04-30,02:38:00,19517.25,BUY,3,0.02h,Stop Loss,$-9.00,$6.00,$206211.50,346,$6.00
2025-04-30,02:57:00,19511.75,SELL,3,0.02h,Break Even,$-1.50,$4.50,$206210.00,346,$4.50
2025-04-30,03:24:00,19506.0,BUY,3,0.02h,Break Even,$-1.50,$3.00,$206208.50,346,$3.00
2025-04-30,04:07:00,19512.5,SELL,3,0.02h,Stop Loss,$-9.00,$-6.00,$206199.50,346,$-6.00
2025-04-30,04:17:00,19524.5,BUY,3,0.02h,Break Even,$-1.50,$-7.50,$206198.00,346,$-7.50
2025-04-30,04:35:00,19520.75,SELL,3,0.02h,Stop Loss,$6.00,$-1.50,$206204.00,346,$-1.50
2025-04-30,05:04:00,19522.0,BUY,3,0.02h,Stop Loss,$6.00,$4.50,$206210.00,346,$4.50
2025-04-30,05:16:00,19514.0,SELL,3,0.02h,Stop Loss,$27.00,$31.50,$206237.00,346,$31.50
2025-04-30,05:34:00,19521.5,BUY,3,0.02h,Stop Loss,$81.00,$112.50,$206318.00,346,$112.50
2025-04-30,06:43:00,19556.25,SELL,3,0.02h,Break Even,$-1.50,$111.00,$206316.50,346,$111.00
2025-04-30,06:57:00,19562.0,BUY,3,0.02h,Stop Loss,$22.50,$133.50,$206339.00,346,$133.50
2025-04-30,07:38:00,19574.75,SELL,3,0.02h,Stop Loss,$-9.00,$124.50,$206330.00,346,$124.50
2025-04-30,07:56:00,19589.0,BUY,3,0.02h,Break Even,$-1.50,$123.00,$206328.50,346,$123.00
2025-04-30,08:03:00,19563.5,SELL,3,0.02h,Stop Loss,$22.50,$145.50,$206351.00,346,$145.50
2025-04-30,08:10:00,19592.5,BUY,3,0.02h,Stop Loss,$30.00,$175.50,$206381.00,346,$175.50
2025-04-30,08:27:00,19581.75,SELL,3,0.02h,Stop Loss,$15.00,$190.50,$206396.00,346,$190.50
2025-04-30,08:48:00,19582.25,BUY,3,0.02h,Break Even,$-1.50,$189.00,$206394.50,346,$189.00
2025-04-30,09:01:00,19580.5,SELL,3,0.02h,Break Even,$-1.50,$187.50,$206393.00,346,$187.50
2025-04-30,09:05:00,19587.0,BUY,3,0.02h,Break Even,$-1.50,$186.00,$206391.50,346,$186.00
2025-04-30,09:47:00,19599.5,SELL,3,0.02h,Stop Loss,$19.50,$205.50,$206411.00,346,$205.50
2025-04-30,10:59:00,19567.0,BUY,3,0.02h,Stop Loss,$9.00,$214.50,$206420.00,346,$214.50
2025-04-30,11:21:00,19564.25,SELL,3,0.02h,Stop Loss,$3.00,$217.50,$206423.00,346,$217.50
2025-04-30,13:24:00,19280.25,BUY,3,0.02h,Break Even,$-1.50,$216.00,$206421.50,346,$216.00
2025-04-30,13:32:00,19242.0,SELL,3,0.02h,Stop Loss,$16.50,$232.50,$206438.00,346,$232.50
2025-04-30,13:35:00,19295.5,BUY,3,0.02h,Stop Loss,$27.00,$259.50,$206465.00,346,$259.50
2025-04-30,13:37:00,19256.75,SELL,3,0.02h,Stop Loss,$232.50,$492.00,$206697.50,346,$492.00
2025-04-30,14:09:00,19200.0,BUY,3,0.02h,Stop Loss,$129.00,$621.00,$206826.50,346,$621.00
2025-04-30,16:14:00,19421.0,SELL,3,0.02h,Break Even,$-1.50,$619.50,$206825.00,346,$619.50
2025-04-30,16:40:00,19426.75,BUY,3,0.02h,Stop Loss,$40.50,$660.00,$206865.50,346,$660.00
2025-04-30,17:07:00,19403.25,SELL,3,0.02h,Stop Loss,$7.50,$667.50,$206873.00,346,$667.50
2025-04-30,17:25:00,19405.0,BUY,3,0.02h,Stop Loss,$64.50,$732.00,$206937.50,346,$732.00
2025-04-30,18:02:00,19465.75,SELL,3,0.02h,Stop Loss,$37.50,$769.50,$206975.00,346,$769.50
2025-04-30,18:08:00,19528.75,BUY,3,0.02h,Stop Loss,$25.50,$795.00,$207000.50,346,$795.00
2025-04-30,18:30:00,19494.75,SELL,3,0.02h,Stop Loss,$25.50,$820.50,$207026.00,346,$820.50
2025-04-30,18:50:00,19515.25,BUY,3,0.02h,Stop Loss,$58.50,$879.00,$207084.50,346,$879.00
2025-04-30,18:59:00,19482.5,SELL,3,0.02h,Stop Loss,$48.00,$927.00,$207132.50,346,$927.00
2025-04-30,19:04:00,19504.0,BUY,3,0.02h,Break Even,$-1.50,$925.50,$207131.00,346,$925.50
2025-04-30,19:26:00,19481.75,SELL,3,0.02h,Stop Loss,$30.00,$955.50,$207161.00,346,$955.50
2025-04-30,19:39:00,19513.75,BUY,3,0.02h,Break Even,$-1.50,$954.00,$207159.50,346,$954.00
,,,,,,,,,,,
2025-05-01,00:32:00,19919.75,SELL,3,0.02h,Break Even,$-1.50,$-1.50,$207158.00,347,$-1.50
2025-05-01,00:44:00,19934.0,BUY,3,0.02h,Stop Loss,$-9.00,$-10.50,$207149.00,347,$-10.50
2025-05-01,01:10:00,19914.5,SELL,3,0.02h,Break Even,$-1.50,$-12.00,$207147.50,347,$-12.00
2025-05-01,01:39:00,19928.5,BUY,3,0.02h,Stop Loss,$-9.00,$-21.00,$207138.50,347,$-21.00
2025-05-01,01:40:00,19921.75,SELL,3,0.02h,Stop Loss,$7.50,$-13.50,$207146.00,347,$-13.50
2025-05-01,01:46:00,19928.75,BUY,3,0.02h,Stop Loss,$-9.00,$-22.50,$207137.00,347,$-22.50
2025-05-01,01:52:00,19919.25,SELL,3,0.02h,Break Even,$-1.50,$-24.00,$207135.50,347,$-24.00
2025-05-01,01:59:00,19928.25,BUY,3,0.02h,Break Even,$-1.50,$-25.50,$207134.00,347,$-25.50
2025-05-01,02:49:00,19925.25,SELL,3,0.02h,Stop Loss,$15.00,$-10.50,$207149.00,347,$-10.50
2025-05-01,03:07:00,19931.0,BUY,3,0.02h,Stop Loss,$-9.00,$-19.50,$207140.00,347,$-19.50
2025-05-01,04:11:00,19953.5,SELL,3,0.02h,Break Even,$-1.50,$-21.00,$207138.50,347,$-21.00
2025-05-01,05:02:00,19946.5,BUY,3,0.02h,Break Even,$-1.50,$-22.50,$207137.00,347,$-22.50
2025-05-01,05:20:00,19937.5,SELL,3,0.02h,Stop Loss,$16.50,$-6.00,$207153.50,347,$-6.00
2025-05-01,05:29:00,19951.75,BUY,3,0.02h,Stop Loss,$4.50,$-1.50,$207158.00,347,$-1.50
2025-05-01,05:46:00,19947.25,SELL,3,0.02h,Break Even,$-1.50,$-3.00,$207156.50,347,$-3.00
2025-05-01,06:26:00,19932.75,BUY,3,0.02h,Stop Loss,$10.50,$7.50,$207167.00,347,$7.50
2025-05-01,06:46:00,19931.0,SELL,3,0.02h,Break Even,$-1.50,$6.00,$207165.50,347,$6.00
2025-05-01,07:09:00,19938.5,BUY,3,0.02h,Stop Loss,$-9.00,$-3.00,$207156.50,347,$-3.00
2025-05-01,08:01:00,19955.75,SELL,3,0.02h,Stop Loss,$9.00,$6.00,$207165.50,347,$6.00
2025-05-01,08:03:00,19968.25,BUY,3,0.02h,Break Even,$-1.50,$4.50,$207164.00,347,$4.50
2025-05-01,08:04:00,19948.0,SELL,3,0.02h,Stop Loss,$21.00,$25.50,$207185.00,347,$25.50
2025-05-01,08:21:00,19951.0,BUY,3,0.02h,Stop Loss,$15.00,$40.50,$207200.00,347,$40.50
2025-05-01,08:27:00,19946.5,SELL,3,0.02h,Break Even,$-1.50,$39.00,$207198.50,347,$39.00
2025-05-01,08:28:00,19954.25,BUY,3,0.02h,Break Even,$-1.50,$37.50,$207197.00,347,$37.50
2025-05-01,09:25:00,19978.25,SELL,3,0.02h,Stop Loss,$10.50,$48.00,$207207.50,347,$48.00
2025-05-01,09:30:00,19994.25,BUY,3,0.02h,Break Even,$-1.50,$46.50,$207206.00,347,$46.50
2025-05-01,10:06:00,20003.5,SELL,3,0.02h,Break Even,$-1.50,$45.00,$207204.50,347,$45.00
2025-05-01,10:11:00,20014.75,BUY,3,0.02h,Break Even,$-1.50,$43.50,$207203.00,347,$43.50
2025-05-01,10:14:00,20005.0,SELL,3,0.02h,Stop Loss,$-9.00,$34.50,$207194.00,347,$34.50
2025-05-01,10:16:00,20014.25,BUY,3,0.02h,Break Even,$-1.50,$33.00,$207192.50,347,$33.00
2025-05-01,10:26:00,20005.0,SELL,3,0.02h,Stop Loss,$6.00,$39.00,$207198.50,347,$39.00
2025-05-01,10:57:00,20002.25,BUY,3,0.02h,Break Even,$-1.50,$37.50,$207197.00,347,$37.50
2025-05-01,11:20:00,19996.75,SELL,3,0.02h,Stop Loss,$31.50,$69.00,$207228.50,347,$69.00
2025-05-01,11:36:00,20005.5,BUY,3,0.02h,Stop Loss,$15.00,$84.00,$207243.50,347,$84.00
2025-05-01,11:41:00,19992.75,SELL,3,0.02h,Stop Loss,$-9.00,$75.00,$207234.50,347,$75.00
2025-05-01,11:43:00,20004.75,BUY,3,0.02h,Break Even,$-1.50,$73.50,$207233.00,347,$73.50
2025-05-01,12:03:00,20003.5,SELL,3,0.02h,Stop Loss,$-9.00,$64.50,$207224.00,347,$64.50
2025-05-01,12:05:00,20013.5,BUY,3,0.02h,Stop Loss,$46.50,$111.00,$207270.50,347,$111.00
2025-05-01,12:24:00,20007.5,SELL,3,0.02h,Stop Loss,$37.50,$148.50,$207308.00,347,$148.50
2025-05-01,13:12:00,19981.0,BUY,3,0.02h,Break Even,$-1.50,$147.00,$207306.50,347,$147.00
2025-05-01,13:32:00,19921.75,SELL,3,0.02h,Stop Loss,$31.50,$178.50,$207338.00,347,$178.50
2025-05-01,13:49:00,19979.75,BUY,3,0.02h,Break Even,$-1.50,$177.00,$207336.50,347,$177.00
2025-05-01,13:57:00,19932.75,SELL,3,0.02h,Stop Loss,$96.00,$273.00,$207432.50,347,$273.00
2025-05-01,14:18:00,19956.0,BUY,3,0.02h,Break Even,$-1.50,$271.50,$207431.00,347,$271.50
2025-05-01,15:30:00,20077.5,SELL,3,0.02h,Stop Loss,$69.00,$340.50,$207500.00,347,$340.50
2025-05-01,16:32:00,19974.0,BUY,3,0.02h,Break Even,$-1.50,$339.00,$207498.50,347,$339.00
2025-05-01,16:44:00,19961.25,SELL,3,0.02h,Break Even,$-1.50,$337.50,$207497.00,347,$337.50
2025-05-01,17:03:00,19984.25,BUY,3,0.02h,Stop Loss,$28.50,$366.00,$207525.50,347,$366.00
2025-05-01,17:31:00,19999.25,SELL,3,0.02h,Stop Loss,$6.00,$372.00,$207531.50,347,$372.00
2025-05-01,17:37:00,20012.25,BUY,3,0.02h,Stop Loss,$-9.00,$363.00,$207522.50,347,$363.00
2025-05-01,17:39:00,19998.75,SELL,3,0.02h,Stop Loss,$36.00,$399.00,$207558.50,347,$399.00
2025-05-01,18:01:00,19982.75,BUY,3,0.02h,Stop Loss,$55.50,$454.50,$207614.00,347,$454.50
2025-05-01,18:27:00,19993.5,SELL,3,0.02h,Stop Loss,$10.50,$465.00,$207624.50,347,$465.00
2025-05-01,18:32:00,20028.75,BUY,3,0.02h,Stop Loss,$-9.00,$456.00,$207615.50,347,$456.00
2025-05-01,18:55:00,20012.25,SELL,3,0.02h,Stop Loss,$3.00,$459.00,$207618.50,347,$459.00
2025-05-01,19:20:00,20013.5,BUY,3,0.02h,Stop Loss,$30.00,$489.00,$207648.50,347,$489.00
2025-05-01,19:37:00,19997.0,SELL,3,0.02h,Stop Loss,$-9.00,$480.00,$207639.50,347,$480.00
2025-05-01,19:50:00,20008.75,BUY,3,0.02h,Stop Loss,$81.00,$561.00,$207720.50,347,$561.00
2025-05-01,19:51:00,19966.5,SELL,3,0.02h,Stop Loss,$129.00,$690.00,$207849.50,347,$690.00
2025-05-01,20:24:00,19852.25,BUY,3,0.02h,Break Even,$-1.50,$688.50,$207848.00,347,$688.50
2025-05-01,20:28:00,19834.25,SELL,3,0.02h,Stop Loss,$34.50,$723.00,$207882.50,347,$723.00
2025-05-01,23:17:00,19808.25,BUY,3,0.02h,Stop Loss,$10.50,$733.50,$207893.00,347,$733.50
2025-05-01,23:34:00,19799.75,SELL,3,0.02h,Stop Loss,$3.00,$736.50,$207896.00,347,$736.50
,,,,,,,,,,,
2025-05-02,00:17:00,19798.75,BUY,3,0.02h,Stop Loss,$73.50,$73.50,$207969.50,348,$73.50
2025-05-02,01:13:00,19922.75,SELL,3,0.02h,Break Even,$-1.50,$72.00,$207968.00,348,$72.00
2025-05-02,01:14:00,19941.0,BUY,3,0.02h,Stop Loss,$10.50,$82.50,$207978.50,348,$82.50
2025-05-02,01:43:00,19943.75,SELL,3,0.02h,Break Even,$-1.50,$81.00,$207977.00,348,$81.00
2025-05-02,02:07:00,19945.5,BUY,3,0.02h,Stop Loss,$-9.00,$72.00,$207968.00,348,$72.00
2025-05-02,02:11:00,19931.0,SELL,3,0.02h,Stop Loss,$3.00,$75.00,$207971.00,348,$75.00
2025-05-02,02:27:00,19942.0,BUY,3,0.02h,Stop Loss,$49.50,$124.50,$208020.50,348,$124.50
2025-05-02,03:06:00,19954.0,SELL,3,0.02h,Stop Loss,$-9.00,$115.50,$208011.50,348,$115.50
2025-05-02,03:15:00,19964.5,BUY,3,0.02h,Stop Loss,$-9.00,$106.50,$208002.50,348,$106.50
2025-05-02,04:23:00,19975.0,SELL,3,0.02h,Stop Loss,$-9.00,$97.50,$207993.50,348,$97.50
2025-05-02,04:39:00,19991.25,BUY,3,0.02h,Break Even,$-1.50,$96.00,$207992.00,348,$96.00
2025-05-02,05:03:00,19980.0,SELL,3,0.02h,Break Even,$-1.50,$94.50,$207990.50,348,$94.50
2025-05-02,06:45:00,19916.0,BUY,3,0.02h,Break Even,$-1.50,$93.00,$207989.00,348,$93.00
2025-05-02,07:33:00,19926.25,SELL,3,0.02h,Break Even,$-1.50,$91.50,$207987.50,348,$91.50
2025-05-02,07:52:00,19938.75,BUY,3,0.02h,Stop Loss,$7.50,$99.00,$207995.00,348,$99.00
2025-05-02,07:56:00,19923.25,SELL,3,0.02h,Stop Loss,$21.00,$120.00,$208016.00,348,$120.00
2025-05-02,08:15:00,19922.75,BUY,3,0.02h,Stop Loss,$21.00,$141.00,$208037.00,348,$141.00
2025-05-02,08:46:00,19926.25,SELL,3,0.02h,Stop Loss,$15.00,$156.00,$208052.00,348,$156.00
2025-05-02,09:14:00,19899.5,BUY,3,0.02h,Stop Loss,$22.50,$178.50,$208074.50,348,$178.50
2025-05-02,10:41:00,19932.5,SELL,3,0.02h,Break Even,$-1.50,$177.00,$208073.00,348,$177.00
2025-05-02,11:03:00,19941.75,BUY,3,0.02h,Break Even,$-1.50,$175.50,$208071.50,348,$175.50
2025-05-02,11:11:00,19928.5,SELL,3,0.02h,Break Even,$-1.50,$174.00,$208070.00,348,$174.00
2025-05-02,11:14:00,19943.0,BUY,3,0.02h,Stop Loss,$-9.00,$165.00,$208061.00,348,$165.00
2025-05-02,11:26:00,19935.25,SELL,3,0.02h,Break Even,$-1.50,$163.50,$208059.50,348,$163.50
2025-05-02,11:53:00,19928.25,BUY,3,0.02h,Stop Loss,$-9.00,$154.50,$208050.50,348,$154.50
2025-05-02,11:55:00,19916.25,SELL,3,0.02h,Stop Loss,$18.00,$172.50,$208068.50,348,$172.50
2025-05-02,12:03:00,19925.25,BUY,3,0.02h,Stop Loss,$-9.00,$163.50,$208059.50,348,$163.50
2025-05-02,13:26:00,20093.0,SELL,3,0.02h,Stop Loss,$25.50,$189.00,$208085.00,348,$189.00
2025-05-02,13:45:00,20100.25,BUY,3,0.02h,Stop Loss,$70.50,$259.50,$208155.50,348,$259.50
2025-05-02,13:48:00,20071.5,SELL,3,0.02h,Stop Loss,$130.50,$390.00,$208286.00,348,$390.00
2025-05-02,14:03:00,20104.0,BUY,3,0.02h,Stop Loss,$183.00,$573.00,$208469.00,348,$573.00
2025-05-02,14:44:00,20142.75,SELL,3,0.02h,Stop Loss,$10.50,$583.50,$208479.50,348,$583.50
2025-05-02,14:47:00,20159.25,BUY,3,0.02h,Stop Loss,$-9.00,$574.50,$208470.50,348,$574.50
2025-05-02,14:53:00,20141.5,SELL,3,0.02h,Stop Loss,$91.50,$666.00,$208562.00,348,$666.00
2025-05-02,14:57:00,20150.25,BUY,3,0.02h,Stop Loss,$-9.00,$657.00,$208553.00,348,$657.00
2025-05-02,14:58:00,20143.0,SELL,3,0.02h,Stop Loss,$3.00,$660.00,$208556.00,348,$660.00
2025-05-02,15:00:00,20166.0,BUY,3,0.02h,Stop Loss,$54.00,$714.00,$208610.00,348,$714.00
2025-05-02,15:25:00,20161.75,SELL,3,0.02h,Stop Loss,$55.50,$769.50,$208665.50,348,$769.50
2025-05-02,15:39:00,20173.25,BUY,3,0.02h,Break Even,$-1.50,$768.00,$208664.00,348,$768.00
2025-05-02,16:30:00,20224.0,SELL,3,0.02h,Break Even,$-1.50,$766.50,$208662.50,348,$766.50
2025-05-02,16:37:00,20246.0,BUY,3,0.02h,Stop Loss,$99.00,$865.50,$208761.50,348,$865.50
2025-05-02,16:58:00,20243.75,SELL,3,0.02h,Break Even,$-1.50,$864.00,$208760.00,348,$864.00
2025-05-02,17:40:00,20219.0,BUY,3,0.02h,Stop Loss,$-9.00,$855.00,$208751.00,348,$855.00
2025-05-02,17:41:00,20204.25,SELL,3,0.02h,Stop Loss,$-9.00,$846.00,$208742.00,348,$846.00
2025-05-02,17:43:00,20217.25,BUY,3,0.02h,Break Even,$-1.50,$844.50,$208740.50,348,$844.50
2025-05-02,17:52:00,20212.25,SELL,3,0.02h,Stop Loss,$-9.00,$835.50,$208731.50,348,$835.50
2025-05-02,17:54:00,20225.0,BUY,3,0.02h,Break Even,$-1.50,$834.00,$208730.00,348,$834.00
2025-05-02,18:48:00,20242.75,SELL,3,0.02h,Stop Loss,$72.00,$906.00,$208802.00,348,$906.00
2025-05-02,19:22:00,20229.25,BUY,3,0.02h,Stop Loss,$18.00,$924.00,$208820.00,348,$924.00
2025-05-02,19:35:00,20211.5,SELL,3,0.02h,Stop Loss,$99.00,$1023.00,$208919.00,348,$1023.00
2025-05-02,20:06:00,20211.25,BUY,3,0.02h,Stop Loss,$24.00,$1047.00,$208943.00,348,$1047.00
2025-05-02,20:18:00,20193.25,SELL,3,0.02h,Stop Loss,$-9.00,$1038.00,$208934.00,348,$1038.00
2025-05-02,20:56:00,20202.25,BUY,3,0.02h,Break Even,$-1.50,$1036.50,$208932.50,348,$1036.50
,,,,,,,,,,,
2025-05-05,00:00:00,20085.25,SELL,3,0.02h,Stop Loss,$12.00,$12.00,$208944.50,349,$12.00
2025-05-05,00:33:00,20100.0,BUY,3,0.02h,Stop Loss,$-9.00,$3.00,$208935.50,349,$3.00
2025-05-05,00:45:00,20090.0,SELL,3,0.02h,Break Even,$-1.50,$1.50,$208934.00,349,$1.50
2025-05-05,00:47:00,20106.5,BUY,3,0.02h,Stop Loss,$-9.00,$-7.50,$208925.00,349,$-7.50
2025-05-05,01:03:00,20092.5,SELL,3,0.02h,Stop Loss,$15.00,$7.50,$208940.00,349,$7.50
2025-05-05,02:15:00,20023.0,BUY,3,0.02h,Stop Loss,$16.50,$24.00,$208956.50,349,$24.00
2025-05-05,02:45:00,20031.75,SELL,3,0.02h,Break Even,$-1.50,$22.50,$208955.00,349,$22.50
2025-05-05,02:48:00,20049.75,BUY,3,0.02h,Stop Loss,$-9.00,$13.50,$208946.00,349,$13.50
2025-05-05,03:00:00,20035.5,SELL,3,0.02h,Break Even,$-1.50,$12.00,$208944.50,349,$12.00
2025-05-05,03:11:00,20045.5,BUY,3,0.02h,Stop Loss,$6.00,$18.00,$208950.50,349,$18.00
2025-05-05,03:16:00,20032.25,SELL,3,0.02h,Stop Loss,$-9.00,$9.00,$208941.50,349,$9.00
2025-05-05,03:22:00,20039.75,BUY,3,0.02h,Stop Loss,$-9.00,$0.00,$208932.50,349,$0.00
2025-05-05,03:24:00,20025.5,SELL,3,0.02h,Break Even,$-1.50,$-1.50,$208931.00,349,$-1.50
2025-05-05,03:37:00,20042.75,BUY,3,0.02h,Stop Loss,$-9.00,$-10.50,$208922.00,349,$-10.50
2025-05-05,04:07:00,20037.25,SELL,3,0.02h,Break Even,$-1.50,$-12.00,$208920.50,349,$-12.00
2025-05-05,04:25:00,20048.75,BUY,3,0.02h,Stop Loss,$-9.00,$-21.00,$208911.50,349,$-21.00
2025-05-05,04:28:00,20040.0,SELL,3,0.02h,Stop Loss,$3.00,$-18.00,$208914.50,349,$-18.00
2025-05-05,04:31:00,20045.75,BUY,3,0.02h,Stop Loss,$16.50,$-1.50,$208931.00,349,$-1.50
2025-05-05,04:49:00,20043.5,SELL,3,0.02h,Stop Loss,$-9.00,$-10.50,$208922.00,349,$-10.50
2025-05-05,05:02:00,20057.5,BUY,3,0.02h,Stop Loss,$-9.00,$-19.50,$208913.00,349,$-19.50
2025-05-05,05:40:00,20057.0,SELL,3,0.02h,Stop Loss,$-9.00,$-28.50,$208904.00,349,$-28.50
2025-05-05,05:43:00,20069.5,BUY,3,0.02h,Stop Loss,$-9.00,$-37.50,$208895.00,349,$-37.50
2025-05-05,05:45:00,20055.25,SELL,3,0.02h,Break Even,$-1.50,$-39.00,$208893.50,349,$-39.00
2025-05-05,05:58:00,20065.25,BUY,3,0.02h,Break Even,$-1.50,$-40.50,$208892.00,349,$-40.50
2025-05-05,06:49:00,20075.5,SELL,3,0.02h,Break Even,$-1.50,$-42.00,$208890.50,349,$-42.00
2025-05-05,07:32:00,20061.5,BUY,3,0.02h,Break Even,$-1.50,$-43.50,$208889.00,349,$-43.50
2025-05-05,07:38:00,20053.5,SELL,3,0.02h,Break Even,$-1.50,$-45.00,$208887.50,349,$-45.00
2025-05-05,07:47:00,20060.25,BUY,3,0.02h,Stop Loss,$-9.00,$-54.00,$208878.50,349,$-54.00
2025-05-05,07:48:00,20056.0,SELL,3,0.02h,Stop Loss,$-9.00,$-63.00,$208869.50,349,$-63.00
2025-05-05,07:56:00,20059.25,BUY,3,0.02h,Stop Loss,$-9.00,$-72.00,$208860.50,349,$-72.00
2025-05-05,07:57:00,20053.75,SELL,3,0.02h,Stop Loss,$-9.00,$-81.00,$208851.50,349,$-81.00
2025-05-05,07:58:00,20057.75,BUY,3,0.02h,Stop Loss,$7.50,$-73.50,$208859.00,349,$-73.50
2025-05-05,08:30:00,20048.0,SELL,3,0.02h,Stop Loss,$66.00,$-7.50,$208925.00,349,$-7.50
2025-05-05,09:21:00,20007.5,BUY,3,0.02h,Stop Loss,$37.50,$30.00,$208962.50,349,$30.00
2025-05-05,10:01:00,20011.0,SELL,3,0.02h,Stop Loss,$3.00,$33.00,$208965.50,349,$33.00
2025-05-05,10:03:00,20018.75,BUY,3,0.02h,Stop Loss,$-9.00,$24.00,$208956.50,349,$24.00
2025-05-05,10:04:00,20010.5,SELL,3,0.02h,Stop Loss,$39.00,$63.00,$208995.50,349,$63.00
2025-05-05,10:52:00,20003.75,BUY,3,0.02h,Stop Loss,$13.50,$76.50,$209009.00,349,$76.50
2025-05-05,11:21:00,20002.25,SELL,3,0.02h,Break Even,$-1.50,$75.00,$209007.50,349,$75.00
2025-05-05,12:09:00,19991.25,BUY,3,0.02h,Stop Loss,$24.00,$99.00,$209031.50,349,$99.00
2025-05-05,12:34:00,19990.25,SELL,3,0.02h,Break Even,$-1.50,$97.50,$209030.00,349,$97.50
2025-05-05,12:53:00,20000.0,BUY,3,0.02h,Break Even,$-1.50,$96.00,$209028.50,349,$96.00
2025-05-05,13:16:00,19995.25,SELL,3,0.02h,Stop Loss,$-9.00,$87.00,$209019.50,349,$87.00
2025-05-05,13:21:00,20004.25,BUY,3,0.02h,Break Even,$-1.50,$85.50,$209018.00,349,$85.50
2025-05-05,13:28:00,19999.0,SELL,3,0.02h,Stop Loss,$-9.00,$76.50,$209009.00,349,$76.50
2025-05-05,13:29:00,20015.75,BUY,3,0.02h,Stop Loss,$-9.00,$67.50,$209000.00,349,$67.50
2025-05-05,14:25:00,20050.5,SELL,3,0.02h,Break Even,$-1.50,$66.00,$208998.50,349,$66.00
2025-05-05,14:41:00,20073.0,BUY,3,0.02h,Stop Loss,$64.50,$130.50,$209063.00,349,$130.50
2025-05-05,15:16:00,20090.5,SELL,3,0.02h,Stop Loss,$30.00,$160.50,$209093.00,349,$160.50
2025-05-05,15:21:00,20103.0,BUY,3,0.02h,Stop Loss,$66.00,$226.50,$209159.00,349,$226.50
2025-05-05,15:29:00,20095.75,SELL,3,0.02h,Break Even,$-1.50,$225.00,$209157.50,349,$225.00
2025-05-05,15:31:00,20105.75,BUY,3,0.02h,Stop Loss,$-9.00,$216.00,$209148.50,349,$216.00
2025-05-05,15:32:00,20096.5,SELL,3,0.02h,Stop Loss,$60.00,$276.00,$209208.50,349,$276.00
2025-05-05,15:53:00,20100.5,BUY,3,0.02h,Stop Loss,$19.50,$295.50,$209228.00,349,$295.50
2025-05-05,17:01:00,20124.0,SELL,3,0.02h,Break Even,$-1.50,$294.00,$209226.50,349,$294.00
2025-05-05,17:28:00,20129.0,BUY,3,0.02h,Stop Loss,$6.00,$300.00,$209232.50,349,$300.00
2025-05-05,18:55:00,20169.5,SELL,3,0.02h,Stop Loss,$33.00,$333.00,$209265.50,349,$333.00
2025-05-05,19:39:00,20133.5,BUY,3,0.02h,Stop Loss,$-9.00,$324.00,$209256.50,349,$324.00
2025-05-05,19:44:00,20114.0,SELL,3,0.02h,Stop Loss,$70.50,$394.50,$209327.00,349,$394.50
2025-05-05,20:45:00,20028.0,BUY,3,0.02h,Stop Loss,$31.50,$426.00,$209358.50,349,$426.00
2025-05-05,23:01:00,20021.25,SELL,3,0.02h,Break Even,$-1.50,$424.50,$209357.00,349,$424.50
2025-05-05,23:17:00,20028.75,BUY,3,0.02h,Break Even,$-1.50,$423.00,$209355.50,349,$423.00
2025-05-05,23:30:00,20024.25,SELL,3,0.02h,Stop Loss,$48.00,$471.00,$209403.50,349,$471.00
2025-05-05,23:49:00,20027.0,BUY,3,0.02h,Stop Loss,$-9.00,$462.00,$209394.50,349,$462.00
2025-05-05,23:51:00,20019.5,SELL,3,0.02h,Stop Loss,$36.00,$498.00,$209430.50,349,$498.00
,,,,,,,,,,,
2025-05-06,00:08:00,20029.0,BUY,3,0.02h,Stop Loss,$-9.00,$-9.00,$209421.50,350,$-9.00
2025-05-06,00:17:00,20011.75,SELL,3,0.02h,Stop Loss,$30.00,$21.00,$209451.50,350,$21.00
2025-05-06,00:59:00,19992.0,BUY,3,0.02h,Break Even,$-1.50,$19.50,$209450.00,350,$19.50
2025-05-06,01:06:00,19984.25,SELL,3,0.02h,Stop Loss,$21.00,$40.50,$209471.00,350,$40.50
2025-05-06,01:14:00,19992.25,BUY,3,0.02h,Stop Loss,$6.00,$46.50,$209477.00,350,$46.50
2025-05-06,01:28:00,19987.75,SELL,3,0.02h,Stop Loss,$7.50,$54.00,$209484.50,350,$54.00
2025-05-06,02:05:00,19966.75,BUY,3,0.02h,Break Even,$-1.50,$52.50,$209483.00,350,$52.50
2025-05-06,02:06:00,19947.25,SELL,3,0.02h,Break Even,$-1.50,$51.00,$209481.50,350,$51.00
2025-05-06,02:38:00,19952.75,BUY,3,0.02h,Stop Loss,$25.50,$76.50,$209507.00,350,$76.50
2025-05-06,03:01:00,19950.5,SELL,3,0.02h,Break Even,$-1.50,$75.00,$209505.50,350,$75.00
2025-05-06,03:20:00,19951.75,BUY,3,0.02h,Stop Loss,$4.50,$79.50,$209510.00,350,$79.50
2025-05-06,04:12:00,19978.0,SELL,3,0.02h,Stop Loss,$-9.00,$70.50,$209501.00,350,$70.50
2025-05-06,04:54:00,19965.75,BUY,3,0.02h,Stop Loss,$-9.00,$61.50,$209492.00,350,$61.50
2025-05-06,04:55:00,19962.75,SELL,3,0.02h,Stop Loss,$-9.00,$52.50,$209483.00,350,$52.50
2025-05-06,04:56:00,19966.75,BUY,3,0.02h,Stop Loss,$-9.00,$43.50,$209474.00,350,$43.50
2025-05-06,05:06:00,19958.25,SELL,3,0.02h,Break Even,$-1.50,$42.00,$209472.50,350,$42.00
2025-05-06,05:11:00,19968.75,BUY,3,0.02h,Stop Loss,$27.00,$69.00,$209499.50,350,$69.00
2025-05-06,05:16:00,19961.75,SELL,3,0.02h,Stop Loss,$4.50,$73.50,$209504.00,350,$73.50
2025-05-06,06:10:00,19943.25,BUY,3,0.02h,Stop Loss,$-9.00,$64.50,$209495.00,350,$64.50
2025-05-06,06:46:00,19947.75,SELL,3,0.02h,Stop Loss,$-9.00,$55.50,$209486.00,350,$55.50
2025-05-06,06:49:00,19955.5,BUY,3,0.02h,Break Even,$-1.50,$54.00,$209484.50,350,$54.00
2025-05-06,07:12:00,19951.75,SELL,3,0.02h,Stop Loss,$43.50,$97.50,$209528.00,350,$97.50
2025-05-06,08:43:00,19873.0,BUY,3,0.02h,Break Even,$-1.50,$96.00,$209526.50,350,$96.00
2025-05-06,09:03:00,19857.25,SELL,3,0.02h,Break Even,$-1.50,$94.50,$209525.00,350,$94.50
2025-05-06,09:35:00,19852.25,BUY,3,0.02h,Break Even,$-1.50,$93.00,$209523.50,350,$93.00
2025-05-06,09:40:00,19833.5,SELL,3,0.02h,Stop Loss,$9.00,$102.00,$209532.50,350,$102.00
2025-05-06,09:55:00,19852.25,BUY,3,0.02h,Stop Loss,$33.00,$135.00,$209565.50,350,$135.00
2025-05-06,10:54:00,19873.25,SELL,3,0.02h,Stop Loss,$-9.00,$126.00,$209556.50,350,$126.00
2025-05-06,10:56:00,19880.0,BUY,3,0.02h,Break Even,$-1.50,$124.50,$209555.00,350,$124.50
2025-05-06,11:17:00,19881.25,SELL,3,0.02h,Stop Loss,$-9.00,$115.50,$209546.00,350,$115.50
2025-05-06,12:04:00,19849.5,BUY,3,0.02h,Break Even,$-1.50,$114.00,$209544.50,350,$114.00
2025-05-06,12:12:00,19836.0,SELL,3,0.02h,Stop Loss,$45.00,$159.00,$209589.50,350,$159.00
2025-05-06,12:16:00,19847.75,BUY,3,0.02h,Break Even,$-1.50,$157.50,$209588.00,350,$157.50
2025-05-06,12:17:00,19836.25,SELL,3,0.02h,Break Even,$-1.50,$156.00,$209586.50,350,$156.00
2025-05-06,12:51:00,19831.5,BUY,3,0.02h,Break Even,$-1.50,$154.50,$209585.00,350,$154.50
2025-05-06,13:07:00,19824.0,SELL,3,0.02h,Stop Loss,$36.00,$190.50,$209621.00,350,$190.50
2025-05-06,13:34:00,19828.75,BUY,3,0.02h,Stop Loss,$61.50,$252.00,$209682.50,350,$252.00
2025-05-06,13:50:00,19799.5,SELL,3,0.02h,Stop Loss,$70.50,$322.50,$209753.00,350,$322.50
2025-05-06,14:09:00,19813.5,BUY,3,0.02h,Stop Loss,$57.00,$379.50,$209810.00,350,$379.50
2025-05-06,15:11:00,19896.75,SELL,3,0.02h,Stop Loss,$-9.00,$370.50,$209801.00,350,$370.50
2025-05-06,15:16:00,19915.0,BUY,3,0.02h,Stop Loss,$-9.00,$361.50,$209792.00,350,$361.50
2025-05-06,15:17:00,19905.0,SELL,3,0.02h,Break Even,$-1.50,$360.00,$209790.50,350,$360.00
2025-05-06,15:18:00,19916.75,BUY,3,0.02h,Stop Loss,$31.50,$391.50,$209822.00,350,$391.50
2025-05-06,15:43:00,19911.25,SELL,3,0.02h,Stop Loss,$24.00,$415.50,$209846.00,350,$415.50
2025-05-06,16:13:00,19946.25,BUY,3,0.02h,Stop Loss,$283.50,$699.00,$210129.50,350,$699.00
2025-05-06,16:25:00,19903.25,SELL,3,0.02h,Stop Loss,$4.50,$703.50,$210134.00,350,$703.50
2025-05-06,16:41:00,19932.5,BUY,3,0.02h,Stop Loss,$6.00,$709.50,$210140.00,350,$709.50
2025-05-06,16:44:00,19915.5,SELL,3,0.02h,Stop Loss,$120.00,$829.50,$210260.00,350,$829.50
2025-05-06,17:09:00,19907.5,BUY,3,0.02h,Stop Loss,$52.50,$882.00,$210312.50,350,$882.00
2025-05-06,17:22:00,19876.5,SELL,3,0.02h,Stop Loss,$27.00,$909.00,$210339.50,350,$909.00
2025-05-06,17:34:00,19897.75,BUY,3,0.02h,Stop Loss,$19.50,$928.50,$210359.00,350,$928.50
2025-05-06,17:39:00,19881.0,SELL,3,0.02h,Stop Loss,$78.00,$1006.50,$210437.00,350,$1006.50
2025-05-06,18:03:00,19884.5,BUY,3,0.02h,Stop Loss,$4.50,$1011.00,$210441.50,350,$1011.00
2025-05-06,19:09:00,19925.75,SELL,3,0.02h,Break Even,$-1.50,$1009.50,$210440.00,350,$1009.50
2025-05-06,19:16:00,19940.75,BUY,3,0.02h,Stop Loss,$19.50,$1029.00,$210459.50,350,$1029.00
2025-05-06,19:21:00,19926.75,SELL,3,0.02h,Break Even,$-1.50,$1027.50,$210458.00,350,$1027.50
2025-05-06,19:27:00,19938.0,BUY,3,0.02h,Stop Loss,$19.50,$1047.00,$210477.50,350,$1047.00
2025-05-06,19:52:00,19922.75,SELL,3,0.02h,Stop Loss,$66.00,$1113.00,$210543.50,350,$1113.00
2025-05-06,20:53:00,19856.75,BUY,3,0.02h,Break Even,$-1.50,$1111.50,$210542.00,350,$1111.50
2025-05-06,21:00:00,19846.25,SELL,3,2.00h,Stop Loss,$-9.00,$1102.50,$210533.00,350,$1102.50
2025-05-06,23:00:00,20079.0,BUY,3,0.02h,Stop Loss,$30.00,$1132.50,$210563.00,350,$1132.50
,,,,,,,,,,,
2025-05-07,00:06:00,20045.5,SELL,3,0.02h,Stop Loss,$58.50,$58.50,$210621.50,351,$58.50
2025-05-07,00:25:00,20058.25,BUY,3,0.02h,Stop Loss,$31.50,$90.00,$210653.00,351,$90.00
2025-05-07,01:01:00,20085.5,SELL,3,0.02h,Break Even,$-1.50,$88.50,$210651.50,351,$88.50
2025-05-07,01:02:00,20092.0,BUY,3,0.02h,Stop Loss,$40.50,$129.00,$210692.00,351,$129.00
2025-05-07,01:10:00,20082.5,SELL,3,0.02h,Stop Loss,$61.50,$190.50,$210753.50,351,$190.50
2025-05-07,03:02:00,19996.5,BUY,3,0.02h,Stop Loss,$27.00,$217.50,$210780.50,351,$217.50
2025-05-07,03:22:00,19998.25,SELL,3,0.02h,Stop Loss,$6.00,$223.50,$210786.50,351,$223.50
2025-05-07,03:35:00,20007.0,BUY,3,0.02h,Stop Loss,$6.00,$229.50,$210792.50,351,$229.50
2025-05-07,03:59:00,20004.75,SELL,3,0.02h,Break Even,$-1.50,$228.00,$210791.00,351,$228.00
2025-05-07,04:03:00,20010.0,BUY,3,0.02h,Break Even,$-1.50,$226.50,$210789.50,351,$226.50
2025-05-07,04:32:00,20011.5,SELL,3,0.02h,Stop Loss,$13.50,$240.00,$210803.00,351,$240.00
2025-05-07,04:58:00,20013.25,BUY,3,0.02h,Stop Loss,$-9.00,$231.00,$210794.00,351,$231.00
2025-05-07,05:02:00,20004.25,SELL,3,0.02h,Break Even,$-1.50,$229.50,$210792.50,351,$229.50
2025-05-07,05:35:00,20008.75,BUY,3,0.02h,Stop Loss,$-9.00,$220.50,$210783.50,351,$220.50
2025-05-07,05:38:00,19993.25,SELL,3,0.02h,Stop Loss,$27.00,$247.50,$210810.50,351,$247.50
2025-05-07,06:05:00,19995.0,BUY,3,0.02h,Stop Loss,$-9.00,$238.50,$210801.50,351,$238.50
2025-05-07,06:19:00,19980.0,SELL,3,0.02h,Break Even,$-1.50,$237.00,$210800.00,351,$237.00
2025-05-07,06:45:00,19969.0,BUY,3,0.02h,Break Even,$-1.50,$235.50,$210798.50,351,$235.50
2025-05-07,07:43:00,19995.75,SELL,3,0.02h,Break Even,$-1.50,$234.00,$210797.00,351,$234.00
2025-05-07,07:47:00,20006.0,BUY,3,0.02h,Stop Loss,$-9.00,$225.00,$210788.00,351,$225.00
2025-05-07,08:07:00,19998.5,SELL,3,0.02h,Stop Loss,$15.00,$240.00,$210803.00,351,$240.00
2025-05-07,08:29:00,19999.0,BUY,3,0.02h,Stop Loss,$-9.00,$231.00,$210794.00,351,$231.00
2025-05-07,08:50:00,19991.5,SELL,3,0.02h,Stop Loss,$16.50,$247.50,$210810.50,351,$247.50
2025-05-07,08:57:00,20006.0,BUY,3,0.02h,Stop Loss,$6.00,$253.50,$210816.50,351,$253.50
2025-05-07,09:12:00,19998.5,SELL,3,0.02h,Stop Loss,$22.50,$276.00,$210839.00,351,$276.00
2025-05-07,09:44:00,19994.0,BUY,3,0.02h,Break Even,$-1.50,$274.50,$210837.50,351,$274.50
2025-05-07,10:01:00,19977.75,SELL,3,0.02h,Stop Loss,$24.00,$298.50,$210861.50,351,$298.50
2025-05-07,10:14:00,19998.0,BUY,3,0.02h,Break Even,$-1.50,$297.00,$210860.00,351,$297.00
2025-05-07,10:29:00,19983.25,SELL,3,0.02h,Stop Loss,$7.50,$304.50,$210867.50,351,$304.50
2025-05-07,10:44:00,19995.0,BUY,3,0.02h,Stop Loss,$21.00,$325.50,$210888.50,351,$325.50
2025-05-07,11:29:00,20003.0,SELL,3,0.02h,Break Even,$-1.50,$324.00,$210887.00,351,$324.00
2025-05-07,12:44:00,19943.5,BUY,3,0.02h,Break Even,$-1.50,$322.50,$210885.50,351,$322.50
2025-05-07,13:00:00,19933.0,SELL,3,0.02h,Stop Loss,$97.50,$420.00,$210983.00,351,$420.00
2025-05-07,13:42:00,19915.0,BUY,3,0.02h,Stop Loss,$34.50,$454.50,$211017.50,351,$454.50
2025-05-07,13:51:00,19877.25,SELL,3,0.02h,Stop Loss,$-9.00,$445.50,$211008.50,351,$445.50
2025-05-07,13:56:00,19921.75,BUY,3,0.02h,Stop Loss,$31.50,$477.00,$211040.00,351,$477.00
2025-05-07,14:47:00,19952.75,SELL,3,0.02h,Stop Loss,$67.50,$544.50,$211107.50,351,$544.50
2025-05-07,15:41:00,19830.5,BUY,3,0.02h,Stop Loss,$52.50,$597.00,$211160.00,351,$597.00
2025-05-07,15:50:00,19796.75,SELL,3,0.02h,Stop Loss,$51.00,$648.00,$211211.00,351,$648.00
2025-05-07,15:54:00,19840.75,BUY,3,0.02h,Stop Loss,$13.50,$661.50,$211224.50,351,$661.50
2025-05-07,16:22:00,19823.0,SELL,3,0.02h,Stop Loss,$52.50,$714.00,$211277.00,351,$714.00
2025-05-07,16:40:00,19841.25,BUY,3,0.02h,Stop Loss,$82.50,$796.50,$211359.50,351,$796.50
2025-05-07,17:22:00,19886.25,SELL,3,0.02h,Break Even,$-1.50,$795.00,$211358.00,351,$795.00
2025-05-07,17:25:00,19908.0,BUY,3,0.02h,Stop Loss,$9.00,$804.00,$211367.00,351,$804.00
2025-05-07,17:34:00,19889.0,SELL,3,0.02h,Break Even,$-1.50,$802.50,$211365.50,351,$802.50
2025-05-07,18:28:00,19781.75,BUY,3,0.02h,Stop Loss,$12.00,$814.50,$211377.50,351,$814.50
2025-05-07,18:50:00,19777.25,SELL,3,0.02h,Stop Loss,$75.00,$889.50,$211452.50,351,$889.50
2025-05-07,18:57:00,19860.25,BUY,3,0.02h,Stop Loss,$240.00,$1129.50,$211692.50,351,$1129.50
2025-05-07,19:25:00,19832.0,SELL,3,0.02h,Stop Loss,$151.50,$1281.00,$211844.00,351,$1281.00
2025-05-07,19:42:00,19911.0,BUY,3,0.02h,Stop Loss,$628.50,$1909.50,$212472.50,351,$1909.50
2025-05-07,20:29:00,19943.25,SELL,3,0.02h,Break Even,$-1.50,$1908.00,$212471.00,351,$1908.00
2025-05-07,20:40:00,19958.0,BUY,3,0.02h,Break Even,$-1.50,$1906.50,$212469.50,351,$1906.50
2025-05-07,23:00:00,19943.5,SELL,3,0.02h,Break Even,$-1.50,$1905.00,$212468.00,351,$1905.00
2025-05-07,23:06:00,19964.25,BUY,3,0.02h,Stop Loss,$-9.00,$1896.00,$212459.00,351,$1896.00
2025-05-07,23:24:00,19956.25,SELL,3,0.02h,Stop Loss,$-9.00,$1887.00,$212450.00,351,$1887.00
2025-05-07,23:26:00,19961.25,BUY,3,0.02h,Stop Loss,$31.50,$1918.50,$212481.50,351,$1918.50
2025-05-07,23:42:00,19958.75,SELL,3,0.02h,Stop Loss,$-9.00,$1909.50,$212472.50,351,$1909.50
,,,,,,,,,,,
2025-05-08,00:01:00,19969.5,BUY,3,0.02h,Stop Loss,$24.00,$24.00,$212496.50,352,$24.00
2025-05-08,00:19:00,19965.5,SELL,3,0.02h,Stop Loss,$3.00,$27.00,$212499.50,352,$27.00
2025-05-08,00:30:00,19974.25,BUY,3,0.02h,Break Even,$-1.50,$25.50,$212498.00,352,$25.50
2025-05-08,00:38:00,19951.25,SELL,3,0.02h,Break Even,$-1.50,$24.00,$212496.50,352,$24.00
2025-05-08,00:57:00,19979.5,BUY,3,0.02h,Stop Loss,$325.50,$349.50,$212822.00,352,$349.50
2025-05-08,01:42:00,20083.75,SELL,3,0.02h,Break Even,$-1.50,$348.00,$212820.50,352,$348.00
2025-05-08,02:17:00,20088.25,BUY,3,0.02h,Stop Loss,$-9.00,$339.00,$212811.50,352,$339.00
2025-05-08,02:56:00,20096.75,SELL,3,0.02h,Stop Loss,$-9.00,$330.00,$212802.50,352,$330.00
2025-05-08,03:01:00,20101.5,BUY,3,0.02h,Stop Loss,$3.00,$333.00,$212805.50,352,$333.00
2025-05-08,04:30:00,20173.75,SELL,3,0.02h,Stop Loss,$-9.00,$324.00,$212796.50,352,$324.00
2025-05-08,04:34:00,20182.0,BUY,3,0.02h,Break Even,$-1.50,$322.50,$212795.00,352,$322.50
2025-05-08,05:03:00,20183.5,SELL,3,0.02h,Stop Loss,$-9.00,$313.50,$212786.00,352,$313.50
2025-05-08,05:10:00,20192.75,BUY,3,0.02h,Stop Loss,$-9.00,$304.50,$212777.00,352,$304.50
2025-05-08,05:13:00,20183.0,SELL,3,0.02h,Stop Loss,$9.00,$313.50,$212786.00,352,$313.50
2025-05-08,06:31:00,20151.25,BUY,3,0.02h,Stop Loss,$-9.00,$304.50,$212777.00,352,$304.50
2025-05-08,06:32:00,20141.75,SELL,3,0.02h,Stop Loss,$9.00,$313.50,$212786.00,352,$313.50
2025-05-08,06:43:00,20154.75,BUY,3,0.02h,Break Even,$-1.50,$312.00,$212784.50,352,$312.00
2025-05-08,07:01:00,20137.25,SELL,3,0.02h,Stop Loss,$-9.00,$303.00,$212775.50,352,$303.00
2025-05-08,07:03:00,20159.75,BUY,3,0.02h,Break Even,$-1.50,$301.50,$212774.00,352,$301.50
2025-05-08,07:35:00,20168.5,SELL,3,0.02h,Stop Loss,$3.00,$304.50,$212777.00,352,$304.50
2025-05-08,07:42:00,20185.75,BUY,3,0.02h,Stop Loss,$12.00,$316.50,$212789.00,352,$316.50
2025-05-08,07:49:00,20167.5,SELL,3,0.02h,Break Even,$-1.50,$315.00,$212787.50,352,$315.00
2025-05-08,08:00:00,20177.5,BUY,3,0.02h,Stop Loss,$-9.00,$306.00,$212778.50,352,$306.00
2025-05-08,08:01:00,20165.0,SELL,3,0.02h,Stop Loss,$3.00,$309.00,$212781.50,352,$309.00
2025-05-08,08:14:00,20176.75,BUY,3,0.02h,Stop Loss,$9.00,$318.00,$212790.50,352,$318.00
2025-05-08,09:12:00,20216.5,SELL,3,0.02h,Stop Loss,$-9.00,$309.00,$212781.50,352,$309.00
2025-05-08,09:21:00,20229.75,BUY,3,0.02h,Stop Loss,$-9.00,$300.00,$212772.50,352,$300.00
2025-05-08,10:01:00,20242.0,SELL,3,0.02h,Break Even,$-1.50,$298.50,$212771.00,352,$298.50
2025-05-08,10:18:00,20250.75,BUY,3,0.02h,Break Even,$-1.50,$297.00,$212769.50,352,$297.00
2025-05-08,10:25:00,20244.0,SELL,3,0.02h,Break Even,$-1.50,$295.50,$212768.00,352,$295.50
2025-05-08,10:27:00,20250.0,BUY,3,0.02h,Break Even,$-1.50,$294.00,$212766.50,352,$294.00
2025-05-08,10:31:00,20243.75,SELL,3,0.02h,Stop Loss,$19.50,$313.50,$212786.00,352,$313.50
2025-05-08,10:51:00,20246.25,BUY,3,0.02h,Break Even,$-1.50,$312.00,$212784.50,352,$312.00
2025-05-08,11:07:00,20240.5,SELL,3,0.02h,Stop Loss,$30.00,$342.00,$212814.50,352,$342.00
2025-05-08,12:05:00,20214.0,BUY,3,0.02h,Break Even,$-1.50,$340.50,$212813.00,352,$340.50
2025-05-08,12:18:00,20207.0,SELL,3,0.02h,Stop Loss,$-9.00,$331.50,$212804.00,352,$331.50
2025-05-08,12:20:00,20211.0,BUY,3,0.02h,Stop Loss,$3.00,$334.50,$212807.00,352,$334.50
2025-05-08,12:29:00,20202.5,SELL,3,0.02h,Break Even,$-1.50,$333.00,$212805.50,352,$333.00
2025-05-08,12:31:00,20214.0,BUY,3,0.02h,Stop Loss,$54.00,$387.00,$212859.50,352,$387.00
2025-05-08,12:37:00,20175.0,SELL,3,0.02h,Stop Loss,$201.00,$588.00,$213060.50,352,$588.00
2025-05-08,12:52:00,20194.0,BUY,3,0.02h,Stop Loss,$-9.00,$579.00,$213051.50,352,$579.00
2025-05-08,12:57:00,20177.75,SELL,3,0.02h,Break Even,$-1.50,$577.50,$213050.00,352,$577.50
2025-05-08,13:22:00,20177.25,BUY,3,0.02h,Break Even,$-1.50,$576.00,$213048.50,352,$576.00
2025-05-08,13:25:00,20169.5,SELL,3,0.02h,Stop Loss,$-9.00,$567.00,$213039.50,352,$567.00
2025-05-08,14:28:00,20091.0,BUY,3,0.02h,Stop Loss,$9.00,$576.00,$213048.50,352,$576.00
2025-05-08,14:40:00,20062.0,SELL,3,0.02h,Stop Loss,$19.50,$595.50,$213068.00,352,$595.50
2025-05-08,15:10:00,20059.25,BUY,3,0.02h,Stop Loss,$55.50,$651.00,$213123.50,352,$651.00
2025-05-08,16:29:00,20288.5,SELL,3,0.02h,Stop Loss,$19.50,$670.50,$213143.00,352,$670.50
2025-05-08,16:39:00,20306.0,BUY,3,0.02h,Stop Loss,$6.00,$676.50,$213149.00,352,$676.50
2025-05-08,17:06:00,20313.0,SELL,3,0.02h,Stop Loss,$39.00,$715.50,$213188.00,352,$715.50
2025-05-08,18:16:00,20276.5,BUY,3,0.02h,Stop Loss,$21.00,$736.50,$213209.00,352,$736.50
2025-05-08,18:56:00,20293.75,SELL,3,0.02h,Stop Loss,$24.00,$760.50,$213233.00,352,$760.50
2025-05-08,19:21:00,20298.5,BUY,3,0.02h,Stop Loss,$165.00,$925.50,$213398.00,352,$925.50
2025-05-08,19:37:00,20280.0,SELL,3,0.02h,Break Even,$-1.50,$924.00,$213396.50,352,$924.00
2025-05-08,20:43:00,20163.0,BUY,3,0.02h,Break Even,$-1.50,$922.50,$213395.00,352,$922.50
2025-05-08,21:00:00,20155.75,SELL,3,2.00h,Stop Loss,$-9.00,$913.50,$213386.00,352,$913.50
2025-05-08,23:00:00,20161.75,BUY,3,0.02h,Stop Loss,$13.50,$927.00,$213399.50,352,$927.00
2025-05-08,23:02:00,20156.0,SELL,3,0.02h,Stop Loss,$28.50,$955.50,$213428.00,352,$955.50
2025-05-08,23:09:00,20162.0,BUY,3,0.02h,Stop Loss,$-9.00,$946.50,$213419.00,352,$946.50
2025-05-08,23:23:00,20154.75,SELL,3,0.02h,Stop Loss,$-9.00,$937.50,$213410.00,352,$937.50
,,,,,,,,,,,
2025-05-09,00:46:00,20119.75,BUY,3,0.02h,Stop Loss,$-9.00,$-9.00,$213401.00,353,$-9.00
2025-05-09,02:53:00,20174.25,SELL,3,0.02h,Stop Loss,$3.00,$-6.00,$213404.00,353,$-6.00
2025-05-09,03:14:00,20169.75,BUY,3,0.02h,Break Even,$-1.50,$-7.50,$213402.50,353,$-7.50
2025-05-09,03:25:00,20165.25,SELL,3,0.02h,Break Even,$-1.50,$-9.00,$213401.00,353,$-9.00
2025-05-09,03:46:00,20169.5,BUY,3,0.02h,Stop Loss,$18.00,$9.00,$213419.00,353,$9.00
2025-05-09,04:20:00,20177.0,SELL,3,0.02h,Stop Loss,$15.00,$24.00,$213434.00,353,$24.00
2025-05-09,04:36:00,20184.25,BUY,3,0.02h,Stop Loss,$-9.00,$15.00,$213425.00,353,$15.00
2025-05-09,05:00:00,20183.25,SELL,3,0.02h,Break Even,$-1.50,$13.50,$213423.50,353,$13.50
2025-05-09,05:19:00,20181.0,BUY,3,0.02h,Stop Loss,$-9.00,$4.50,$213414.50,353,$4.50
2025-05-09,05:20:00,20168.25,SELL,3,0.02h,Break Even,$-1.50,$3.00,$213413.00,353,$3.00
2025-05-09,05:33:00,20178.75,BUY,3,0.02h,Stop Loss,$12.00,$15.00,$213425.00,353,$15.00
2025-05-09,05:41:00,20166.25,SELL,3,0.02h,Break Even,$-1.50,$13.50,$213423.50,353,$13.50
2025-05-09,05:45:00,20178.75,BUY,3,0.02h,Break Even,$-1.50,$12.00,$213422.00,353,$12.00
2025-05-09,06:17:00,20188.25,SELL,3,0.02h,Stop Loss,$3.00,$15.00,$213425.00,353,$15.00
2025-05-09,06:21:00,20198.0,BUY,3,0.02h,Break Even,$-1.50,$13.50,$213423.50,353,$13.50
2025-05-09,06:24:00,20187.5,SELL,3,0.02h,Break Even,$-1.50,$12.00,$213422.00,353,$12.00
2025-05-09,06:46:00,20191.25,BUY,3,0.02h,Break Even,$-1.50,$10.50,$213420.50,353,$10.50
2025-05-09,07:02:00,20183.25,SELL,3,0.02h,Stop Loss,$19.50,$30.00,$213440.00,353,$30.00
2025-05-09,07:07:00,20198.5,BUY,3,0.02h,Stop Loss,$-9.00,$21.00,$213431.00,353,$21.00
2025-05-09,07:15:00,20171.25,SELL,3,0.02h,Stop Loss,$-9.00,$12.00,$213422.00,353,$12.00
2025-05-09,07:30:00,20197.0,BUY,3,0.02h,Stop Loss,$4.50,$16.50,$213426.50,353,$16.50
2025-05-09,07:58:00,20198.5,SELL,3,0.02h,Stop Loss,$19.50,$36.00,$213446.00,353,$36.00
2025-05-09,08:29:00,20197.0,BUY,3,0.02h,Break Even,$-1.50,$34.50,$213444.50,353,$34.50
2025-05-09,08:38:00,20177.0,SELL,3,0.02h,Break Even,$-1.50,$33.00,$213443.00,353,$33.00
2025-05-09,09:02:00,20182.5,BUY,3,0.02h,Break Even,$-1.50,$31.50,$213441.50,353,$31.50
2025-05-09,09:30:00,20180.5,SELL,3,0.02h,Stop Loss,$25.50,$57.00,$213467.00,353,$57.00
2025-05-09,09:39:00,20189.5,BUY,3,0.02h,Stop Loss,$-9.00,$48.00,$213458.00,353,$48.00
2025-05-09,11:03:00,20224.5,SELL,3,0.02h,Break Even,$-1.50,$46.50,$213456.50,353,$46.50
2025-05-09,11:09:00,20233.0,BUY,3,0.02h,Break Even,$-1.50,$45.00,$213455.00,353,$45.00
2025-05-09,11:27:00,20164.0,SELL,3,0.02h,Stop Loss,$121.50,$166.50,$213576.50,353,$166.50
2025-05-09,11:47:00,20219.75,BUY,3,0.02h,Stop Loss,$27.00,$193.50,$213603.50,353,$193.50
2025-05-09,12:15:00,20205.5,SELL,3,0.02h,Stop Loss,$10.50,$204.00,$213614.00,353,$204.00
2025-05-09,12:23:00,20216.5,BUY,3,0.02h,Stop Loss,$-9.00,$195.00,$213605.00,353,$195.00
2025-05-09,12:26:00,20205.25,SELL,3,0.02h,Stop Loss,$4.50,$199.50,$213609.50,353,$199.50
2025-05-09,12:33:00,20220.5,BUY,3,0.02h,Stop Loss,$15.00,$214.50,$213624.50,353,$214.50
2025-05-09,13:26:00,20237.75,SELL,3,0.02h,Stop Loss,$19.50,$234.00,$213644.00,353,$234.00
2025-05-09,13:35:00,20260.5,BUY,3,0.02h,Stop Loss,$28.50,$262.50,$213672.50,353,$262.50
2025-05-09,13:45:00,20227.0,SELL,3,0.02h,Stop Loss,$21.00,$283.50,$213693.50,353,$283.50
2025-05-09,14:00:00,20254.25,BUY,3,0.02h,Break Even,$-1.50,$282.00,$213692.00,353,$282.00
2025-05-09,14:16:00,20237.25,SELL,3,0.02h,Break Even,$-1.50,$280.50,$213690.50,353,$280.50
2025-05-09,14:58:00,20139.0,BUY,3,0.02h,Stop Loss,$25.50,$306.00,$213716.00,353,$306.00
2025-05-09,15:23:00,20133.5,SELL,3,0.02h,Stop Loss,$60.00,$366.00,$213776.00,353,$366.00
2025-05-09,15:46:00,20144.25,BUY,3,0.02h,Stop Loss,$7.50,$373.50,$213783.50,353,$373.50
2025-05-09,16:05:00,20108.25,SELL,3,0.02h,Break Even,$-1.50,$372.00,$213782.00,353,$372.00
2025-05-09,16:38:00,20131.25,BUY,3,0.02h,Stop Loss,$-9.00,$363.00,$213773.00,353,$363.00
2025-05-09,16:45:00,20107.25,SELL,3,0.02h,Stop Loss,$54.00,$417.00,$213827.00,353,$417.00
2025-05-09,17:11:00,20114.75,BUY,3,0.02h,Stop Loss,$-9.00,$408.00,$213818.00,353,$408.00
2025-05-09,17:32:00,20096.0,SELL,3,0.02h,Break Even,$-1.50,$406.50,$213816.50,353,$406.50
2025-05-09,17:37:00,20113.5,BUY,3,0.02h,Stop Loss,$-9.00,$397.50,$213807.50,353,$397.50
2025-05-09,18:13:00,20139.5,SELL,3,0.02h,Stop Loss,$7.50,$405.00,$213815.00,353,$405.00
2025-05-09,18:34:00,20138.5,BUY,3,0.02h,Break Even,$-1.50,$403.50,$213813.50,353,$403.50
2025-05-09,18:38:00,20130.75,SELL,3,0.02h,Stop Loss,$7.50,$411.00,$213821.00,353,$411.00
2025-05-09,18:41:00,20137.5,BUY,3,0.02h,Break Even,$-1.50,$409.50,$213819.50,353,$409.50
2025-05-09,18:42:00,20128.25,SELL,3,0.02h,Break Even,$-1.50,$408.00,$213818.00,353,$408.00
2025-05-09,18:48:00,20142.75,BUY,3,0.02h,Break Even,$-1.50,$406.50,$213816.50,353,$406.50
2025-05-09,19:24:00,20156.75,SELL,3,0.02h,Stop Loss,$6.00,$412.50,$213822.50,353,$412.50
2025-05-09,19:44:00,20162.75,BUY,3,0.02h,Stop Loss,$-9.00,$403.50,$213813.50,353,$403.50
2025-05-09,19:46:00,20139.5,SELL,3,0.02h,Stop Loss,$6.00,$409.50,$213819.50,353,$409.50
2025-05-09,19:55:00,20164.75,BUY,3,0.02h,Stop Loss,$-9.00,$400.50,$213810.50,353,$400.50
2025-05-09,19:56:00,20138.5,SELL,3,0.02h,Stop Loss,$25.50,$426.00,$213836.00,353,$426.00
2025-05-09,20:42:00,20133.5,BUY,3,0.02h,Stop Loss,$-9.00,$417.00,$213827.00,353,$417.00
,,,,,,,,,,,
2025-05-12,01:38:00,20527.0,SELL,3,0.02h,Stop Loss,$10.50,$10.50,$213837.50,354,$10.50
2025-05-12,02:07:00,20525.5,BUY,3,0.02h,Break Even,$-1.50,$9.00,$213836.00,354,$9.00
2025-05-12,02:14:00,20516.25,SELL,3,0.02h,Stop Loss,$31.50,$40.50,$213867.50,354,$40.50
2025-05-12,02:46:00,20518.0,BUY,3,0.02h,Stop Loss,$19.50,$60.00,$213887.00,354,$60.00
2025-05-12,03:28:00,20524.75,SELL,3,0.02h,Stop Loss,$7.50,$67.50,$213894.50,354,$67.50
2025-05-12,03:51:00,20521.75,BUY,3,0.02h,Stop Loss,$3.00,$70.50,$213897.50,354,$70.50
2025-05-12,04:08:00,20522.0,SELL,3,0.02h,Break Even,$-1.50,$69.00,$213896.00,354,$69.00
2025-05-12,04:10:00,20526.25,BUY,3,0.02h,Break Even,$-1.50,$67.50,$213894.50,354,$67.50
2025-05-12,04:12:00,20525.0,SELL,3,0.02h,Stop Loss,$-9.00,$58.50,$213885.50,354,$58.50
2025-05-12,04:21:00,20526.5,BUY,3,0.02h,Break Even,$-1.50,$57.00,$213884.00,354,$57.00
2025-05-12,05:01:00,20527.75,SELL,3,0.02h,Stop Loss,$-9.00,$48.00,$213875.00,354,$48.00
2025-05-12,05:04:00,20535.0,BUY,3,0.02h,Stop Loss,$-9.00,$39.00,$213866.00,354,$39.00
2025-05-12,05:21:00,20530.0,SELL,3,0.02h,Break Even,$-1.50,$37.50,$213864.50,354,$37.50
2025-05-12,05:31:00,20535.25,BUY,3,0.02h,Stop Loss,$-9.00,$28.50,$213855.50,354,$28.50
2025-05-12,05:36:00,20528.5,SELL,3,0.02h,Stop Loss,$-9.00,$19.50,$213846.50,354,$19.50
2025-05-12,05:39:00,20537.25,BUY,3,0.02h,Stop Loss,$-9.00,$10.50,$213837.50,354,$10.50
2025-05-12,06:19:00,20546.75,SELL,3,0.02h,Stop Loss,$6.00,$16.50,$213843.50,354,$16.50
2025-05-12,06:20:00,20557.25,BUY,3,0.02h,Stop Loss,$-9.00,$7.50,$213834.50,354,$7.50
2025-05-12,06:55:00,20570.0,SELL,3,0.02h,Stop Loss,$24.00,$31.50,$213858.50,354,$31.50
2025-05-12,07:01:00,20745.5,BUY,3,0.02h,Stop Loss,$318.00,$349.50,$214176.50,354,$349.50
2025-05-12,07:42:00,20845.25,SELL,3,0.02h,Stop Loss,$34.50,$384.00,$214211.00,354,$384.00
2025-05-12,08:16:00,20834.75,BUY,3,0.02h,Stop Loss,$31.50,$415.50,$214242.50,354,$415.50
2025-05-12,08:25:00,20813.0,SELL,3,0.02h,Stop Loss,$36.00,$451.50,$214278.50,354,$451.50
2025-05-12,08:29:00,20827.0,BUY,3,0.02h,Stop Loss,$21.00,$472.50,$214299.50,354,$472.50
2025-05-12,09:22:00,20878.75,SELL,3,0.02h,Stop Loss,$-9.00,$463.50,$214290.50,354,$463.50
2025-05-12,09:25:00,20894.5,BUY,3,0.02h,Stop Loss,$-9.00,$454.50,$214281.50,354,$454.50
2025-05-12,09:26:00,20888.0,SELL,3,0.02h,Break Even,$-1.50,$453.00,$214280.00,354,$453.00
2025-05-12,09:27:00,20895.75,BUY,3,0.02h,Break Even,$-1.50,$451.50,$214278.50,354,$451.50
2025-05-12,09:46:00,20893.0,SELL,3,0.02h,Stop Loss,$3.00,$454.50,$214281.50,354,$454.50
2025-05-12,09:50:00,20902.5,BUY,3,0.02h,Stop Loss,$10.50,$465.00,$214292.00,354,$465.00
2025-05-12,10:04:00,20885.5,SELL,3,0.02h,Break Even,$-1.50,$463.50,$214290.50,354,$463.50
2025-05-12,10:06:00,20914.75,BUY,3,0.02h,Stop Loss,$33.00,$496.50,$214323.50,354,$496.50
2025-05-12,10:21:00,20897.75,SELL,3,0.02h,Stop Loss,$16.50,$513.00,$214340.00,354,$513.00
2025-05-12,10:27:00,20909.0,BUY,3,0.02h,Stop Loss,$24.00,$537.00,$214364.00,354,$537.00
2025-05-12,10:48:00,20926.0,SELL,3,0.02h,Break Even,$-1.50,$535.50,$214362.50,354,$535.50
2025-05-12,10:51:00,20934.75,BUY,3,0.02h,Stop Loss,$3.00,$538.50,$214365.50,354,$538.50
2025-05-12,11:16:00,20938.5,SELL,3,0.02h,Break Even,$-1.50,$537.00,$214364.00,354,$537.00
2025-05-12,12:02:00,20929.75,BUY,3,0.02h,Break Even,$-1.50,$535.50,$214362.50,354,$535.50
2025-05-12,12:39:00,20923.0,SELL,3,0.02h,Stop Loss,$6.00,$541.50,$214368.50,354,$541.50
2025-05-12,13:21:00,20922.5,BUY,3,0.02h,Stop Loss,$42.00,$583.50,$214410.50,354,$583.50
2025-05-12,13:31:00,20865.5,SELL,3,0.02h,Stop Loss,$247.50,$831.00,$214658.00,354,$831.00
2025-05-12,14:08:00,20815.25,BUY,3,0.02h,Break Even,$-1.50,$829.50,$214656.50,354,$829.50
2025-05-12,14:26:00,20799.0,SELL,3,0.02h,Stop Loss,$172.50,$1002.00,$214829.00,354,$1002.00
2025-05-12,14:45:00,20794.75,BUY,3,0.02h,Stop Loss,$22.50,$1024.50,$214851.50,354,$1024.50
2025-05-12,15:08:00,20775.25,SELL,3,0.02h,Stop Loss,$9.00,$1033.50,$214860.50,354,$1033.50
2025-05-12,15:13:00,20790.25,BUY,3,0.02h,Stop Loss,$30.00,$1063.50,$214890.50,354,$1063.50
2025-05-12,15:23:00,20769.0,SELL,3,0.02h,Stop Loss,$66.00,$1129.50,$214956.50,354,$1129.50
2025-05-12,15:31:00,20785.0,BUY,3,0.02h,Stop Loss,$52.50,$1182.00,$215009.00,354,$1182.00
2025-05-12,15:42:00,20765.25,SELL,3,0.02h,Break Even,$-1.50,$1180.50,$215007.50,354,$1180.50
2025-05-12,15:49:00,20790.5,BUY,3,0.02h,Stop Loss,$-9.00,$1171.50,$214998.50,354,$1171.50
2025-05-12,15:51:00,20781.5,SELL,3,0.02h,Stop Loss,$118.50,$1290.00,$215117.00,354,$1290.00
2025-05-12,16:06:00,20785.5,BUY,3,0.02h,Stop Loss,$60.00,$1350.00,$215177.00,354,$1350.00
2025-05-12,17:25:00,20894.25,SELL,3,0.02h,Stop Loss,$10.50,$1360.50,$215187.50,354,$1360.50
2025-05-12,17:31:00,20906.75,BUY,3,0.02h,Stop Loss,$40.50,$1401.00,$215228.00,354,$1401.00
2025-05-12,18:11:00,20905.25,SELL,3,0.02h,Stop Loss,$45.00,$1446.00,$215273.00,354,$1446.00
2025-05-12,18:19:00,20924.25,BUY,3,0.02h,Stop Loss,$4.50,$1450.50,$215277.50,354,$1450.50
2025-05-12,18:49:00,20922.75,SELL,3,0.02h,Stop Loss,$22.50,$1473.00,$215300.00,354,$1473.00
2025-05-12,19:08:00,20921.75,BUY,3,0.02h,Break Even,$-1.50,$1471.50,$215298.50,354,$1471.50
2025-05-12,19:15:00,20902.75,SELL,3,0.02h,Stop Loss,$46.50,$1518.00,$215345.00,354,$1518.00
2025-05-12,19:51:00,20908.75,BUY,3,0.02h,Stop Loss,$-9.00,$1509.00,$215336.00,354,$1509.00
2025-05-12,23:00:00,20920.25,SELL,3,0.02h,Stop Loss,$-9.00,$1500.00,$215327.00,354,$1500.00
2025-05-12,23:18:00,20949.5,BUY,3,0.02h,Stop Loss,$-9.00,$1491.00,$215318.00,354,$1491.00
2025-05-12,23:35:00,20943.75,SELL,3,0.02h,Stop Loss,$64.50,$1555.50,$215382.50,354,$1555.50
,,,,,,,,,,,
2025-05-13,01:13:00,20884.75,BUY,3,0.02h,Stop Loss,$-9.00,$-9.00,$215373.50,355,$-9.00
2025-05-13,01:41:00,20877.75,SELL,3,0.02h,Break Even,$-1.50,$-10.50,$215372.00,355,$-10.50
2025-05-13,02:04:00,20892.5,BUY,3,0.02h,Break Even,$-1.50,$-12.00,$215370.50,355,$-12.00
2025-05-13,02:17:00,20880.25,SELL,3,0.02h,Stop Loss,$-9.00,$-21.00,$215361.50,355,$-21.00
2025-05-13,02:56:00,20868.0,BUY,3,0.02h,Break Even,$-1.50,$-22.50,$215360.00,355,$-22.50
2025-05-13,03:07:00,20855.75,SELL,3,0.02h,Stop Loss,$12.00,$-10.50,$215372.00,355,$-10.50
2025-05-13,04:14:00,20848.0,BUY,3,0.02h,Stop Loss,$-9.00,$-19.50,$215363.00,355,$-19.50
2025-05-13,04:16:00,20844.5,SELL,3,0.02h,Break Even,$-1.50,$-21.00,$215361.50,355,$-21.00
2025-05-13,04:21:00,20849.75,BUY,3,0.02h,Stop Loss,$3.00,$-18.00,$215364.50,355,$-18.00
2025-05-13,04:29:00,20843.0,SELL,3,0.02h,Break Even,$-1.50,$-19.50,$215363.00,355,$-19.50
2025-05-13,04:48:00,20847.25,BUY,3,0.02h,Stop Loss,$-9.00,$-28.50,$215354.00,355,$-28.50
2025-05-13,05:56:00,20858.5,SELL,3,0.02h,Break Even,$-1.50,$-30.00,$215352.50,355,$-30.00
2025-05-13,06:01:00,20859.75,BUY,3,0.02h,Stop Loss,$15.00,$-15.00,$215367.50,355,$-15.00
2025-05-13,06:24:00,20865.5,SELL,3,0.02h,Break Even,$-1.50,$-16.50,$215366.00,355,$-16.50
2025-05-13,06:38:00,20872.75,BUY,3,0.02h,Break Even,$-1.50,$-18.00,$215364.50,355,$-18.00
2025-05-13,06:51:00,20858.5,SELL,3,0.02h,Stop Loss,$10.50,$-7.50,$215375.00,355,$-7.50
2025-05-13,07:14:00,20860.25,BUY,3,0.02h,Stop Loss,$-9.00,$-16.50,$215366.00,355,$-16.50
2025-05-13,07:23:00,20846.5,SELL,3,0.02h,Stop Loss,$24.00,$7.50,$215390.00,355,$7.50
2025-05-13,07:31:00,20857.25,BUY,3,0.02h,Stop Loss,$15.00,$22.50,$215405.00,355,$22.50
2025-05-13,07:42:00,20851.25,SELL,3,0.02h,Break Even,$-1.50,$21.00,$215403.50,355,$21.00
2025-05-13,08:03:00,20852.75,BUY,3,0.02h,Break Even,$-1.50,$19.50,$215402.00,355,$19.50
2025-05-13,08:04:00,20849.75,SELL,3,0.02h,Stop Loss,$30.00,$49.50,$215432.00,355,$49.50
2025-05-13,08:18:00,20855.5,BUY,3,0.02h,Break Even,$-1.50,$48.00,$215430.50,355,$48.00
2025-05-13,08:44:00,20851.25,SELL,3,0.02h,Break Even,$-1.50,$46.50,$215429.00,355,$46.50
2025-05-13,09:09:00,20844.75,BUY,3,0.02h,Break Even,$-1.50,$45.00,$215427.50,355,$45.00
2025-05-13,10:09:00,20866.0,SELL,3,0.02h,Break Even,$-1.50,$43.50,$215426.00,355,$43.50
2025-05-13,10:11:00,20882.75,BUY,3,0.02h,Stop Loss,$-9.00,$34.50,$215417.00,355,$34.50
2025-05-13,10:34:00,20871.75,SELL,3,0.02h,Stop Loss,$-9.00,$25.50,$215408.00,355,$25.50
2025-05-13,10:37:00,20883.5,BUY,3,0.02h,Stop Loss,$12.00,$37.50,$215420.00,355,$37.50
2025-05-13,11:30:00,20913.75,SELL,3,0.02h,Stop Loss,$3.00,$40.50,$215423.00,355,$40.50
2025-05-13,11:38:00,20919.5,BUY,3,0.02h,Stop Loss,$19.50,$60.00,$215442.50,355,$60.00
2025-05-13,12:48:00,20991.75,SELL,3,0.02h,Break Even,$-1.50,$58.50,$215441.00,355,$58.50
2025-05-13,12:50:00,21006.0,BUY,3,0.02h,Break Even,$-1.50,$57.00,$215439.50,355,$57.00
2025-05-13,13:27:00,20996.75,SELL,3,0.02h,Stop Loss,$10.50,$67.50,$215450.00,355,$67.50
2025-05-13,13:34:00,21033.5,BUY,3,0.02h,Stop Loss,$15.00,$82.50,$215465.00,355,$82.50
2025-05-13,14:45:00,21191.75,SELL,3,0.02h,Stop Loss,$10.50,$93.00,$215475.50,355,$93.00
2025-05-13,14:51:00,21228.0,BUY,3,0.02h,Break Even,$-1.50,$91.50,$215474.00,355,$91.50
2025-05-13,15:54:00,21278.5,SELL,3,0.02h,Break Even,$-1.50,$90.00,$215472.50,355,$90.00
2025-05-13,15:57:00,21290.0,BUY,3,0.02h,Stop Loss,$13.50,$103.50,$215486.00,355,$103.50
2025-05-13,16:01:00,21271.25,SELL,3,0.02h,Stop Loss,$6.00,$109.50,$215492.00,355,$109.50
2025-05-13,16:15:00,21288.5,BUY,3,0.02h,Stop Loss,$-9.00,$100.50,$215483.00,355,$100.50
2025-05-13,17:04:00,21316.0,SELL,3,0.02h,Stop Loss,$-9.00,$91.50,$215474.00,355,$91.50
2025-05-13,17:19:00,21326.25,BUY,3,0.02h,Break Even,$-1.50,$90.00,$215472.50,355,$90.00
2025-05-13,17:22:00,21310.0,SELL,3,0.02h,Stop Loss,$-9.00,$81.00,$215463.50,355,$81.00
2025-05-13,17:28:00,21318.75,BUY,3,0.02h,Stop Loss,$-9.00,$72.00,$215454.50,355,$72.00
2025-05-13,17:29:00,21313.25,SELL,3,0.02h,Stop Loss,$-9.00,$63.00,$215445.50,355,$63.00
2025-05-13,17:31:00,21323.0,BUY,3,0.02h,Stop Loss,$40.50,$103.50,$215486.00,355,$103.50
2025-05-13,17:54:00,21319.5,SELL,3,0.02h,Stop Loss,$45.00,$148.50,$215531.00,355,$148.50
2025-05-13,18:21:00,21313.5,BUY,3,0.02h,Stop Loss,$-9.00,$139.50,$215522.00,355,$139.50
2025-05-13,18:32:00,21299.0,SELL,3,0.02h,Break Even,$-1.50,$138.00,$215520.50,355,$138.00
2025-05-13,18:57:00,21315.25,BUY,3,0.02h,Stop Loss,$46.50,$184.50,$215567.00,355,$184.50
2025-05-13,19:28:00,21323.5,SELL,3,0.02h,Stop Loss,$-9.00,$175.50,$215558.00,355,$175.50
2025-05-13,19:29:00,21328.0,BUY,3,0.02h,Break Even,$-1.50,$174.00,$215556.50,355,$174.00
2025-05-13,19:30:00,21321.0,SELL,3,0.02h,Stop Loss,$3.00,$177.00,$215559.50,355,$177.00
2025-05-13,19:31:00,21327.75,BUY,3,0.02h,Break Even,$-1.50,$175.50,$215558.00,355,$175.50
2025-05-13,19:36:00,21318.75,SELL,3,0.02h,Stop Loss,$-9.00,$166.50,$215549.00,355,$166.50
2025-05-13,19:38:00,21337.75,BUY,3,0.02h,Stop Loss,$10.50,$177.00,$215559.50,355,$177.00
2025-05-13,19:44:00,21323.0,SELL,3,0.02h,Break Even,$-1.50,$175.50,$215558.00,355,$175.50
2025-05-13,20:37:00,21260.5,BUY,3,0.02h,Break Even,$-1.50,$174.00,$215556.50,355,$174.00
2025-05-13,20:56:00,21259.25,SELL,3,0.02h,Break Even,$-1.50,$172.50,$215555.00,355,$172.50
2025-05-13,23:02:00,21265.0,BUY,3,0.02h,Stop Loss,$-9.00,$163.50,$215546.00,355,$163.50
2025-05-13,23:06:00,21253.5,SELL,3,0.02h,Stop Loss,$-9.00,$154.50,$215537.00,355,$154.50
2025-05-13,23:10:00,21274.0,BUY,3,0.02h,Stop Loss,$-9.00,$145.50,$215528.00,355,$145.50
,,,,,,,,,,,
2025-05-14,00:06:00,21283.0,SELL,3,0.02h,Stop Loss,$7.50,$7.50,$215535.50,356,$7.50
2025-05-14,00:12:00,21290.25,BUY,3,0.02h,Stop Loss,$-9.00,$-1.50,$215526.50,356,$-1.50
2025-05-14,00:13:00,21282.75,SELL,3,0.02h,Stop Loss,$33.00,$31.50,$215559.50,356,$31.50
2025-05-14,00:48:00,21272.5,BUY,3,0.02h,Stop Loss,$-9.00,$22.50,$215550.50,356,$22.50
2025-05-14,00:49:00,21270.5,SELL,3,0.02h,Break Even,$-1.50,$21.00,$215549.00,356,$21.00
2025-05-14,00:52:00,21273.75,BUY,3,0.02h,Stop Loss,$-9.00,$12.00,$215540.00,356,$12.00
2025-05-14,00:54:00,21262.75,SELL,3,0.02h,Break Even,$-1.50,$10.50,$215538.50,356,$10.50
2025-05-14,01:19:00,21270.5,BUY,3,0.02h,Break Even,$-1.50,$9.00,$215537.00,356,$9.00
2025-05-14,02:04:00,21268.25,SELL,3,0.02h,Stop Loss,$9.00,$18.00,$215546.00,356,$18.00
2025-05-14,02:17:00,21277.0,BUY,3,0.02h,Stop Loss,$12.00,$30.00,$215558.00,356,$30.00
2025-05-14,02:36:00,21273.25,SELL,3,0.02h,Break Even,$-1.50,$28.50,$215556.50,356,$28.50
2025-05-14,03:05:00,21275.0,BUY,3,0.02h,Stop Loss,$-9.00,$19.50,$215547.50,356,$19.50
2025-05-14,03:46:00,21288.0,SELL,3,0.02h,Break Even,$-1.50,$18.00,$215546.00,356,$18.00
2025-05-14,04:15:00,21289.5,BUY,3,0.02h,Break Even,$-1.50,$16.50,$215544.50,356,$16.50
2025-05-14,05:27:00,21306.75,SELL,3,0.02h,Break Even,$-1.50,$15.00,$215543.00,356,$15.00
2025-05-14,05:41:00,21311.25,BUY,3,0.02h,Break Even,$-1.50,$13.50,$215541.50,356,$13.50
2025-05-14,06:09:00,21310.0,SELL,3,0.02h,Stop Loss,$-9.00,$4.50,$215532.50,356,$4.50
2025-05-14,06:27:00,21319.25,BUY,3,0.02h,Break Even,$-1.50,$3.00,$215531.00,356,$3.00
2025-05-14,06:47:00,21313.75,SELL,3,0.02h,Stop Loss,$3.00,$6.00,$215534.00,356,$6.00
2025-05-14,06:54:00,21323.0,BUY,3,0.02h,Break Even,$-1.50,$4.50,$215532.50,356,$4.50
2025-05-14,07:22:00,21324.0,SELL,3,0.02h,Stop Loss,$48.00,$52.50,$215580.50,356,$52.50
2025-05-14,07:54:00,21311.5,BUY,3,0.02h,Break Even,$-1.50,$51.00,$215579.00,356,$51.00
2025-05-14,08:03:00,21292.0,SELL,3,0.02h,Stop Loss,$34.50,$85.50,$215613.50,356,$85.50
2025-05-14,08:46:00,21281.75,BUY,3,0.02h,Break Even,$-1.50,$84.00,$215612.00,356,$84.00
2025-05-14,08:47:00,21275.5,SELL,3,0.02h,Break Even,$-1.50,$82.50,$215610.50,356,$82.50
2025-05-14,08:48:00,21278.75,BUY,3,0.02h,Stop Loss,$-9.00,$73.50,$215601.50,356,$73.50
2025-05-14,09:00:00,21274.5,SELL,3,0.02h,Stop Loss,$16.50,$90.00,$215618.00,356,$90.00
2025-05-14,09:23:00,21268.75,BUY,3,0.02h,Break Even,$-1.50,$88.50,$215616.50,356,$88.50
2025-05-14,09:41:00,21265.0,SELL,3,0.02h,Break Even,$-1.50,$87.00,$215615.00,356,$87.00
2025-05-14,09:46:00,21276.75,BUY,3,0.02h,Stop Loss,$-9.00,$78.00,$215606.00,356,$78.00
2025-05-14,09:52:00,21265.5,SELL,3,0.02h,Break Even,$-1.50,$76.50,$215604.50,356,$76.50
2025-05-14,10:21:00,21272.25,BUY,3,0.02h,Stop Loss,$4.50,$81.00,$215609.00,356,$81.00
2025-05-14,10:54:00,21289.25,SELL,3,0.02h,Break Even,$-1.50,$79.50,$215607.50,356,$79.50
2025-05-14,11:00:00,21293.25,BUY,3,0.02h,Stop Loss,$48.00,$127.50,$215655.50,356,$127.50
2025-05-14,11:46:00,21348.25,SELL,3,0.02h,Break Even,$-1.50,$126.00,$215654.00,356,$126.00
2025-05-14,12:09:00,21354.25,BUY,3,0.02h,Stop Loss,$-9.00,$117.00,$215645.00,356,$117.00
2025-05-14,12:10:00,21344.0,SELL,3,0.02h,Break Even,$-1.50,$115.50,$215643.50,356,$115.50
2025-05-14,12:11:00,21350.5,BUY,3,0.02h,Break Even,$-1.50,$114.00,$215642.00,356,$114.00
2025-05-14,12:16:00,21346.25,SELL,3,0.02h,Break Even,$-1.50,$112.50,$215640.50,356,$112.50
2025-05-14,12:18:00,21350.25,BUY,3,0.02h,Stop Loss,$7.50,$120.00,$215648.00,356,$120.00
2025-05-14,12:37:00,21347.25,SELL,3,0.02h,Stop Loss,$34.50,$154.50,$215682.50,356,$154.50
2025-05-14,13:14:00,21335.25,BUY,3,0.02h,Stop Loss,$6.00,$160.50,$215688.50,356,$160.50
2025-05-14,13:29:00,21320.5,SELL,3,0.02h,Stop Loss,$36.00,$196.50,$215724.50,356,$196.50
2025-05-14,13:33:00,21361.25,BUY,3,0.02h,Stop Loss,$49.50,$246.00,$215774.00,356,$246.00
2025-05-14,13:47:00,21320.5,SELL,3,0.02h,Stop Loss,$87.00,$333.00,$215861.00,356,$333.00
2025-05-14,14:07:00,21340.25,BUY,3,0.02h,Break Even,$-1.50,$331.50,$215859.50,356,$331.50
2025-05-14,14:21:00,21317.0,SELL,3,0.02h,Stop Loss,$34.50,$366.00,$215894.00,356,$366.00
2025-05-14,14:24:00,21332.5,BUY,3,0.02h,Stop Loss,$19.50,$385.50,$215913.50,356,$385.50
2025-05-14,14:42:00,21323.5,SELL,3,0.02h,Stop Loss,$9.00,$394.50,$215922.50,356,$394.50
2025-05-14,14:50:00,21344.25,BUY,3,0.02h,Stop Loss,$60.00,$454.50,$215982.50,356,$454.50
2025-05-14,15:04:00,21327.0,SELL,3,0.02h,Stop Loss,$178.50,$633.00,$216161.00,356,$633.00
2025-05-14,15:16:00,21344.5,BUY,3,0.02h,Stop Loss,$16.50,$649.50,$216177.50,356,$649.50
2025-05-14,15:52:00,21368.75,SELL,3,0.02h,Stop Loss,$-9.00,$640.50,$216168.50,356,$640.50
2025-05-14,15:54:00,21380.0,BUY,3,0.02h,Break Even,$-1.50,$639.00,$216167.00,356,$639.00
2025-05-14,15:55:00,21368.5,SELL,3,0.02h,Stop Loss,$30.00,$669.00,$216197.00,356,$669.00
2025-05-14,15:57:00,21377.25,BUY,3,0.02h,Break Even,$-1.50,$667.50,$216195.50,356,$667.50
2025-05-14,16:20:00,21370.5,SELL,3,0.02h,Stop Loss,$-9.00,$658.50,$216186.50,356,$658.50
2025-05-14,16:30:00,21384.75,BUY,3,0.02h,Stop Loss,$7.50,$666.00,$216194.00,356,$666.00
2025-05-14,16:42:00,21370.25,SELL,3,0.02h,Stop Loss,$-9.00,$657.00,$216185.00,356,$657.00
2025-05-14,17:39:00,21333.25,BUY,3,0.02h,Stop Loss,$16.50,$673.50,$216201.50,356,$673.50
2025-05-14,18:28:00,21349.25,SELL,3,0.02h,Stop Loss,$63.00,$736.50,$216264.50,356,$736.50
2025-05-14,18:35:00,21390.75,BUY,3,0.02h,Stop Loss,$4.50,$741.00,$216269.00,356,$741.00
2025-05-14,19:01:00,21361.75,SELL,3,0.02h,Stop Loss,$25.50,$766.50,$216294.50,356,$766.50
2025-05-14,19:15:00,21369.0,BUY,3,0.02h,Stop Loss,$24.00,$790.50,$216318.50,356,$790.50
2025-05-14,19:23:00,21354.0,SELL,3,0.02h,Stop Loss,$78.00,$868.50,$216396.50,356,$868.50
2025-05-14,19:51:00,21377.75,BUY,3,0.02h,Stop Loss,$49.50,$918.00,$216446.00,356,$918.00
2025-05-14,20:54:00,21398.5,SELL,3,0.02h,Stop Loss,$-9.00,$909.00,$216437.00,356,$909.00
2025-05-14,23:47:00,21367.75,BUY,3,0.02h,Stop Loss,$10.50,$919.50,$216447.50,356,$919.50
,,,,,,,,,,,
2025-05-15,00:26:00,21369.0,SELL,3,0.02h,Break Even,$-1.50,$-1.50,$216446.00,357,$-1.50
2025-05-15,00:33:00,21381.25,BUY,3,0.02h,Stop Loss,$-9.00,$-10.50,$216437.00,357,$-10.50
2025-05-15,00:52:00,21378.75,SELL,3,0.02h,Stop Loss,$-9.00,$-19.50,$216428.00,357,$-19.50
2025-05-15,01:01:00,21385.5,BUY,3,0.02h,Stop Loss,$40.50,$21.00,$216468.50,357,$21.00
2025-05-15,01:16:00,21383.0,SELL,3,0.02h,Break Even,$-1.50,$19.50,$216467.00,357,$19.50
2025-05-15,01:51:00,21374.5,BUY,3,0.02h,Stop Loss,$4.50,$24.00,$216471.50,357,$24.00
2025-05-15,01:54:00,21371.75,SELL,3,0.02h,Break Even,$-1.50,$22.50,$216470.00,357,$22.50
2025-05-15,01:57:00,21374.75,BUY,3,0.02h,Stop Loss,$-9.00,$13.50,$216461.00,357,$13.50
2025-05-15,02:06:00,21369.0,SELL,3,0.02h,Break Even,$-1.50,$12.00,$216459.50,357,$12.00
2025-05-15,02:08:00,21376.0,BUY,3,0.02h,Break Even,$-1.50,$10.50,$216458.00,357,$10.50
2025-05-15,02:13:00,21368.75,SELL,3,0.02h,Break Even,$-1.50,$9.00,$216456.50,357,$9.00
2025-05-15,02:31:00,21374.25,BUY,3,0.02h,Break Even,$-1.50,$7.50,$216455.00,357,$7.50
2025-05-15,03:12:00,21393.75,SELL,3,0.02h,Stop Loss,$4.50,$12.00,$216459.50,357,$12.00
2025-05-15,04:22:00,21383.0,BUY,3,0.02h,Stop Loss,$-9.00,$3.00,$216450.50,357,$3.00
2025-05-15,04:27:00,21381.0,SELL,3,0.02h,Stop Loss,$-9.00,$-6.00,$216441.50,357,$-6.00
2025-05-15,04:28:00,21382.5,BUY,3,0.02h,Break Even,$-1.50,$-7.50,$216440.00,357,$-7.50
2025-05-15,04:39:00,21375.0,SELL,3,0.02h,Break Even,$-1.50,$-9.00,$216438.50,357,$-9.00
2025-05-15,04:53:00,21386.25,BUY,3,0.02h,Break Even,$-1.50,$-10.50,$216437.00,357,$-10.50
2025-05-15,05:09:00,21375.0,SELL,3,0.02h,Stop Loss,$3.00,$-7.50,$216440.00,357,$-7.50
2025-05-15,06:06:00,21333.0,BUY,3,0.02h,Stop Loss,$6.00,$-1.50,$216446.00,357,$-1.50
2025-05-15,06:41:00,21345.25,SELL,3,0.02h,Stop Loss,$16.50,$15.00,$216462.50,357,$15.00
2025-05-15,07:07:00,21356.0,BUY,3,0.02h,Break Even,$-1.50,$13.50,$216461.00,357,$13.50
2025-05-15,07:09:00,21337.25,SELL,3,0.02h,Stop Loss,$16.50,$30.00,$216477.50,357,$30.00
2025-05-15,08:26:00,21277.75,BUY,3,0.02h,Stop Loss,$4.50,$34.50,$216482.00,357,$34.50
2025-05-15,08:32:00,21262.25,SELL,3,0.02h,Stop Loss,$49.50,$84.00,$216531.50,357,$84.00
2025-05-15,09:24:00,21227.75,BUY,3,0.02h,Break Even,$-1.50,$82.50,$216530.00,357,$82.50
2025-05-15,10:06:00,21244.0,SELL,3,0.02h,Stop Loss,$-9.00,$73.50,$216521.00,357,$73.50
2025-05-15,10:25:00,21246.0,BUY,3,0.02h,Break Even,$-1.50,$72.00,$216519.50,357,$72.00
2025-05-15,10:47:00,21242.75,SELL,3,0.02h,Stop Loss,$-9.00,$63.00,$216510.50,357,$63.00
2025-05-15,10:59:00,21248.25,BUY,3,0.02h,Stop Loss,$33.00,$96.00,$216543.50,357,$96.00
2025-05-15,11:46:00,21275.75,SELL,3,0.02h,Stop Loss,$7.50,$103.50,$216551.00,357,$103.50
2025-05-15,12:04:00,21282.5,BUY,3,0.02h,Stop Loss,$-9.00,$94.50,$216542.00,357,$94.50
2025-05-15,12:05:00,21275.75,SELL,3,0.02h,Stop Loss,$9.00,$103.50,$216551.00,357,$103.50
2025-05-15,12:32:00,21291.0,BUY,3,0.02h,Stop Loss,$103.50,$207.00,$216654.50,357,$207.00
2025-05-15,12:51:00,21269.0,SELL,3,0.02h,Stop Loss,$-9.00,$198.00,$216645.50,357,$198.00
2025-05-15,13:04:00,21301.25,BUY,3,0.02h,Stop Loss,$-9.00,$189.00,$216636.50,357,$189.00
2025-05-15,13:22:00,21294.75,SELL,3,0.02h,Stop Loss,$4.50,$193.50,$216641.00,357,$193.50
2025-05-15,13:30:00,21303.5,BUY,3,0.02h,Stop Loss,$6.00,$199.50,$216647.00,357,$199.50
2025-05-15,13:31:00,21287.25,SELL,3,0.02h,Stop Loss,$7.50,$207.00,$216654.50,357,$207.00
2025-05-15,13:32:00,21313.75,BUY,3,0.02h,Stop Loss,$106.50,$313.50,$216761.00,357,$313.50
2025-05-15,13:42:00,21294.75,SELL,3,0.02h,Stop Loss,$12.00,$325.50,$216773.00,357,$325.50
2025-05-15,13:45:00,21316.75,BUY,3,0.02h,Stop Loss,$6.00,$331.50,$216779.00,357,$331.50
2025-05-15,13:47:00,21269.0,SELL,3,0.02h,Stop Loss,$46.50,$378.00,$216825.50,357,$378.00
2025-05-15,14:01:00,21314.0,BUY,3,0.02h,Stop Loss,$177.00,$555.00,$217002.50,357,$555.00
2025-05-15,14:13:00,21297.5,SELL,3,0.02h,Stop Loss,$28.50,$583.50,$217031.00,357,$583.50
2025-05-15,14:21:00,21324.0,BUY,3,0.02h,Stop Loss,$9.00,$592.50,$217040.00,357,$592.50
2025-05-15,14:30:00,21288.5,SELL,3,0.02h,Stop Loss,$15.00,$607.50,$217055.00,357,$607.50
2025-05-15,14:46:00,21301.5,BUY,3,0.02h,Stop Loss,$16.50,$624.00,$217071.50,357,$624.00
2025-05-15,16:26:00,21432.75,SELL,3,0.02h,Stop Loss,$-9.00,$615.00,$217062.50,357,$615.00
2025-05-15,16:31:00,21441.25,BUY,3,0.02h,Stop Loss,$7.50,$622.50,$217070.00,357,$622.50
2025-05-15,16:33:00,21428.75,SELL,3,0.02h,Stop Loss,$-9.00,$613.50,$217061.00,357,$613.50
2025-05-15,16:37:00,21455.25,BUY,3,0.02h,Stop Loss,$18.00,$631.50,$217079.00,357,$631.50
2025-05-15,17:35:00,21491.5,SELL,3,0.02h,Stop Loss,$40.50,$672.00,$217119.50,357,$672.00
2025-05-15,18:33:00,21435.0,BUY,3,0.02h,Stop Loss,$9.00,$681.00,$217128.50,357,$681.00
2025-05-15,18:48:00,21411.5,SELL,3,0.02h,Stop Loss,$31.50,$712.50,$217160.00,357,$712.50
2025-05-15,19:42:00,21375.5,BUY,3,0.02h,Stop Loss,$18.00,$730.50,$217178.00,357,$730.50
2025-05-15,20:28:00,21403.75,SELL,3,0.02h,Stop Loss,$-9.00,$721.50,$217169.00,357,$721.50
2025-05-15,23:28:00,21391.5,BUY,3,0.02h,Stop Loss,$3.00,$724.50,$217172.00,357,$724.50
,,,,,,,,,,,
2025-05-16,00:25:00,21416.5,SELL,3,0.02h,Stop Loss,$-9.00,$-9.00,$217163.00,358,$-9.00
2025-05-16,01:31:00,21367.5,BUY,3,0.02h,Stop Loss,$-9.00,$-18.00,$217154.00,358,$-18.00
2025-05-16,01:32:00,21361.5,SELL,3,0.02h,Stop Loss,$-9.00,$-27.00,$217145.00,358,$-27.00
2025-05-16,01:33:00,21364.25,BUY,3,0.02h,Stop Loss,$-9.00,$-36.00,$217136.00,358,$-36.00
2025-05-16,01:52:00,21366.0,SELL,3,0.02h,Break Even,$-1.50,$-37.50,$217134.50,358,$-37.50
2025-05-16,01:59:00,21371.75,BUY,3,0.02h,Stop Loss,$-9.00,$-46.50,$217125.50,358,$-46.50
2025-05-16,02:13:00,21362.5,SELL,3,0.02h,Break Even,$-1.50,$-48.00,$217124.00,358,$-48.00
2025-05-16,02:16:00,21373.5,BUY,3,0.02h,Break Even,$-1.50,$-49.50,$217122.50,358,$-49.50
2025-05-16,03:40:00,21401.25,SELL,3,0.02h,Break Even,$-1.50,$-51.00,$217121.00,358,$-51.00
2025-05-16,03:52:00,21410.25,BUY,3,0.02h,Break Even,$-1.50,$-52.50,$217119.50,358,$-52.50
2025-05-16,04:21:00,21406.0,SELL,3,0.02h,Break Even,$-1.50,$-54.00,$217118.00,358,$-54.00
2025-05-16,04:33:00,21413.5,BUY,3,0.02h,Stop Loss,$-9.00,$-63.00,$217109.00,358,$-63.00
2025-05-16,04:37:00,21409.0,SELL,3,0.02h,Stop Loss,$-9.00,$-72.00,$217100.00,358,$-72.00
2025-05-16,04:38:00,21412.25,BUY,3,0.02h,Stop Loss,$-9.00,$-81.00,$217091.00,358,$-81.00
2025-05-16,04:41:00,21409.75,SELL,3,0.02h,Stop Loss,$-9.00,$-90.00,$217082.00,358,$-90.00
2025-05-16,04:42:00,21410.5,BUY,3,0.02h,Break Even,$-1.50,$-91.50,$217080.50,358,$-91.50
2025-05-16,04:49:00,21410.0,SELL,3,0.02h,Stop Loss,$-9.00,$-100.50,$217071.50,358,$-100.50
2025-05-16,04:50:00,21413.25,BUY,3,0.02h,Stop Loss,$12.00,$-88.50,$217083.50,358,$-88.50
2025-05-16,04:53:00,21404.5,SELL,3,0.02h,Stop Loss,$12.00,$-76.50,$217095.50,358,$-76.50
2025-05-16,05:28:00,21401.75,BUY,3,0.02h,Stop Loss,$-9.00,$-85.50,$217086.50,358,$-85.50
2025-05-16,05:31:00,21392.75,SELL,3,0.02h,Break Even,$-1.50,$-87.00,$217085.00,358,$-87.00
2025-05-16,06:02:00,21397.75,BUY,3,0.02h,Break Even,$-1.50,$-88.50,$217083.50,358,$-88.50
2025-05-16,06:28:00,21390.0,SELL,3,0.02h,Stop Loss,$6.00,$-82.50,$217089.50,358,$-82.50
2025-05-16,07:06:00,21381.25,BUY,3,0.02h,Break Even,$-1.50,$-84.00,$217088.00,358,$-84.00
2025-05-16,08:41:00,21450.75,SELL,3,0.02h,Break Even,$-1.50,$-85.50,$217086.50,358,$-85.50
2025-05-16,08:54:00,21472.5,BUY,3,0.02h,Stop Loss,$-9.00,$-94.50,$217077.50,358,$-94.50
2025-05-16,09:04:00,21452.75,SELL,3,0.02h,Stop Loss,$-9.00,$-103.50,$217068.50,358,$-103.50
2025-05-16,09:23:00,21461.5,BUY,3,0.02h,Stop Loss,$-9.00,$-112.50,$217059.50,358,$-112.50
2025-05-16,09:33:00,21453.75,SELL,3,0.02h,Break Even,$-1.50,$-114.00,$217058.00,358,$-114.00
2025-05-16,10:18:00,21448.0,BUY,3,0.02h,Break Even,$-1.50,$-115.50,$217056.50,358,$-115.50
2025-05-16,10:56:00,21452.0,SELL,3,0.02h,Stop Loss,$-9.00,$-124.50,$217047.50,358,$-124.50
2025-05-16,11:03:00,21466.0,BUY,3,0.02h,Stop Loss,$-9.00,$-133.50,$217038.50,358,$-133.50
2025-05-16,11:08:00,21452.0,SELL,3,0.02h,Break Even,$-1.50,$-135.00,$217037.00,358,$-135.00
2025-05-16,11:17:00,21458.75,BUY,3,0.02h,Stop Loss,$16.50,$-118.50,$217053.50,358,$-118.50
2025-05-16,11:39:00,21466.75,SELL,3,0.02h,Stop Loss,$-9.00,$-127.50,$217044.50,358,$-127.50
2025-05-16,11:47:00,21475.75,BUY,3,0.02h,Break Even,$-1.50,$-129.00,$217043.00,358,$-129.00
2025-05-16,12:33:00,21478.25,SELL,3,0.02h,Stop Loss,$33.00,$-96.00,$217076.00,358,$-96.00
2025-05-16,13:09:00,21453.5,BUY,3,0.02h,Stop Loss,$16.50,$-79.50,$217092.50,358,$-79.50
2025-05-16,13:28:00,21446.5,SELL,3,0.02h,Stop Loss,$-9.00,$-88.50,$217083.50,358,$-88.50
2025-05-16,13:29:00,21479.5,BUY,3,0.02h,Stop Loss,$4.50,$-84.00,$217088.00,358,$-84.00
2025-05-16,13:31:00,21435.25,SELL,3,0.02h,Stop Loss,$82.50,$-1.50,$217170.50,358,$-1.50
2025-05-16,13:57:00,21443.75,BUY,3,0.02h,Stop Loss,$-9.00,$-10.50,$217161.50,358,$-10.50
2025-05-16,14:01:00,21408.5,SELL,3,0.02h,Stop Loss,$12.00,$1.50,$217173.50,358,$1.50
2025-05-16,14:18:00,21438.0,BUY,3,0.02h,Stop Loss,$81.00,$82.50,$217254.50,358,$82.50
2025-05-16,14:30:00,21412.75,SELL,3,0.02h,Stop Loss,$90.00,$172.50,$217344.50,358,$172.50
2025-05-16,14:56:00,21402.75,BUY,3,0.02h,Stop Loss,$-9.00,$163.50,$217335.50,358,$163.50
2025-05-16,15:22:00,21387.0,SELL,3,0.02h,Stop Loss,$40.50,$204.00,$217376.00,358,$204.00
2025-05-16,15:29:00,21398.25,BUY,3,0.02h,Break Even,$-1.50,$202.50,$217374.50,358,$202.50
2025-05-16,15:58:00,21415.75,SELL,3,0.02h,Stop Loss,$27.00,$229.50,$217401.50,358,$229.50
2025-05-16,16:02:00,21427.5,BUY,3,0.02h,Stop Loss,$16.50,$246.00,$217418.00,358,$246.00
2025-05-16,16:35:00,21425.25,SELL,3,0.02h,Stop Loss,$-9.00,$237.00,$217409.00,358,$237.00
2025-05-16,16:55:00,21438.0,BUY,3,0.02h,Stop Loss,$30.00,$267.00,$217439.00,358,$267.00
2025-05-16,17:01:00,21423.75,SELL,3,0.02h,Stop Loss,$-9.00,$258.00,$217430.00,358,$258.00
2025-05-16,17:05:00,21437.5,BUY,3,0.02h,Stop Loss,$-9.00,$249.00,$217421.00,358,$249.00
2025-05-16,17:46:00,21457.75,SELL,3,0.02h,Stop Loss,$21.00,$270.00,$217442.00,358,$270.00
2025-05-16,18:14:00,21457.5,BUY,3,0.02h,Break Even,$-1.50,$268.50,$217440.50,358,$268.50
2025-05-16,19:32:00,21488.75,SELL,3,0.02h,Break Even,$-1.50,$267.00,$217439.00,358,$267.00
2025-05-16,19:50:00,21493.5,BUY,3,0.02h,Stop Loss,$52.50,$319.50,$217491.50,358,$319.50
2025-05-16,20:17:00,21493.0,SELL,3,0.02h,Break Even,$-1.50,$318.00,$217490.00,358,$318.00
2025-05-16,20:22:00,21501.0,BUY,3,0.02h,Break Even,$-1.50,$316.50,$217488.50,358,$316.50
2025-05-16,20:43:00,21489.25,SELL,3,0.02h,Break Even,$-1.50,$315.00,$217487.00,358,$315.00
,,,,,,,,,,,
2025-05-19,00:54:00,21300.0,BUY,3,0.02h,Stop Loss,$6.00,$6.00,$217493.00,359,$6.00
2025-05-19,01:10:00,21289.0,SELL,3,0.02h,Stop Loss,$34.50,$40.50,$217527.50,359,$40.50
2025-05-19,01:24:00,21300.25,BUY,3,0.02h,Stop Loss,$16.50,$57.00,$217544.00,359,$57.00
2025-05-19,01:40:00,21286.25,SELL,3,0.02h,Stop Loss,$31.50,$88.50,$217575.50,359,$88.50
2025-05-19,02:22:00,21286.25,BUY,3,0.02h,Break Even,$-1.50,$87.00,$217574.00,359,$87.00
2025-05-19,02:45:00,21279.25,SELL,3,0.02h,Stop Loss,$3.00,$90.00,$217577.00,359,$90.00
2025-05-19,04:06:00,21218.5,BUY,3,0.02h,Stop Loss,$24.00,$114.00,$217601.00,359,$114.00
2025-05-19,04:22:00,21214.5,SELL,3,0.02h,Stop Loss,$-9.00,$105.00,$217592.00,359,$105.00
2025-05-19,04:33:00,21228.5,BUY,3,0.02h,Stop Loss,$-9.00,$96.00,$217583.00,359,$96.00
2025-05-19,04:54:00,21223.5,SELL,3,0.02h,Break Even,$-1.50,$94.50,$217581.50,359,$94.50
2025-05-19,05:11:00,21229.25,BUY,3,0.02h,Stop Loss,$-9.00,$85.50,$217572.50,359,$85.50
2025-05-19,05:24:00,21218.5,SELL,3,0.02h,Break Even,$-1.50,$84.00,$217571.00,359,$84.00
2025-05-19,05:27:00,21230.0,BUY,3,0.02h,Break Even,$-1.50,$82.50,$217569.50,359,$82.50
2025-05-19,05:32:00,21215.5,SELL,3,0.02h,Break Even,$-1.50,$81.00,$217568.00,359,$81.00
2025-05-19,05:41:00,21236.5,BUY,3,0.02h,Break Even,$-1.50,$79.50,$217566.50,359,$79.50
2025-05-19,06:24:00,21254.25,SELL,3,0.02h,Break Even,$-1.50,$78.00,$217565.00,359,$78.00
2025-05-19,07:22:00,21206.75,BUY,3,0.02h,Stop Loss,$4.50,$82.50,$217569.50,359,$82.50
2025-05-19,07:44:00,21196.75,SELL,3,0.02h,Break Even,$-1.50,$81.00,$217568.00,359,$81.00
2025-05-19,07:53:00,21223.0,BUY,3,0.02h,Stop Loss,$-9.00,$72.00,$217559.00,359,$72.00
2025-05-19,07:59:00,21201.0,SELL,3,0.02h,Stop Loss,$30.00,$102.00,$217589.00,359,$102.00
2025-05-19,08:52:00,21141.0,BUY,3,0.02h,Break Even,$-1.50,$100.50,$217587.50,359,$100.50
2025-05-19,09:01:00,21122.5,SELL,3,0.02h,Break Even,$-1.50,$99.00,$217586.00,359,$99.00
2025-05-19,09:13:00,21137.5,BUY,3,0.02h,Break Even,$-1.50,$97.50,$217584.50,359,$97.50
2025-05-19,09:50:00,21157.75,SELL,3,0.02h,Break Even,$-1.50,$96.00,$217583.00,359,$96.00
2025-05-19,10:23:00,21156.5,BUY,3,0.02h,Break Even,$-1.50,$94.50,$217581.50,359,$94.50
2025-05-19,11:15:00,21186.25,SELL,3,0.02h,Break Even,$-1.50,$93.00,$217580.00,359,$93.00
2025-05-19,11:22:00,21200.0,BUY,3,0.02h,Break Even,$-1.50,$91.50,$217578.50,359,$91.50
2025-05-19,11:29:00,21182.0,SELL,3,0.02h,Stop Loss,$-9.00,$82.50,$217569.50,359,$82.50
2025-05-19,11:48:00,21190.75,BUY,3,0.02h,Stop Loss,$7.50,$90.00,$217577.00,359,$90.00
2025-05-19,12:11:00,21190.25,SELL,3,0.02h,Stop Loss,$4.50,$94.50,$217581.50,359,$94.50
2025-05-19,12:40:00,21191.25,BUY,3,0.02h,Stop Loss,$15.00,$109.50,$217596.50,359,$109.50
2025-05-19,13:08:00,21196.25,SELL,3,0.02h,Break Even,$-1.50,$108.00,$217595.00,359,$108.00
2025-05-19,13:12:00,21207.5,BUY,3,0.02h,Stop Loss,$18.00,$126.00,$217613.00,359,$126.00
2025-05-19,13:14:00,21181.0,SELL,3,0.02h,Stop Loss,$129.00,$255.00,$217742.00,359,$255.00
2025-05-19,13:29:00,21196.25,BUY,3,0.02h,Stop Loss,$25.50,$280.50,$217767.50,359,$280.50
2025-05-19,14:29:00,21394.75,SELL,3,0.02h,Stop Loss,$-9.00,$271.50,$217758.50,359,$271.50
2025-05-19,14:41:00,21427.0,BUY,3,0.02h,Break Even,$-1.50,$270.00,$217757.00,359,$270.00
2025-05-19,14:49:00,21396.0,SELL,3,0.02h,Stop Loss,$58.50,$328.50,$217815.50,359,$328.50
2025-05-19,15:12:00,21422.0,BUY,3,0.02h,Stop Loss,$13.50,$342.00,$217829.00,359,$342.00
2025-05-19,15:27:00,21405.0,SELL,3,0.02h,Break Even,$-1.50,$340.50,$217827.50,359,$340.50
2025-05-19,15:33:00,21426.0,BUY,3,0.02h,Stop Loss,$-9.00,$331.50,$217818.50,359,$331.50
2025-05-19,15:52:00,21424.5,SELL,3,0.02h,Stop Loss,$-9.00,$322.50,$217809.50,359,$322.50
2025-05-19,16:04:00,21440.25,BUY,3,0.02h,Stop Loss,$25.50,$348.00,$217835.00,359,$348.00
2025-05-19,16:43:00,21450.5,SELL,3,0.02h,Break Even,$-1.50,$346.50,$217833.50,359,$346.50
2025-05-19,16:48:00,21461.75,BUY,3,0.02h,Stop Loss,$3.00,$349.50,$217836.50,359,$349.50
2025-05-19,17:33:00,21519.25,SELL,3,0.02h,Stop Loss,$6.00,$355.50,$217842.50,359,$355.50
2025-05-19,17:34:00,21530.75,BUY,3,0.02h,Stop Loss,$51.00,$406.50,$217893.50,359,$406.50
2025-05-19,17:41:00,21518.25,SELL,3,0.02h,Break Even,$-1.50,$405.00,$217892.00,359,$405.00
2025-05-19,18:36:00,21483.5,BUY,3,0.02h,Stop Loss,$21.00,$426.00,$217913.00,359,$426.00
2025-05-19,18:48:00,21472.5,SELL,3,0.02h,Stop Loss,$7.50,$433.50,$217920.50,359,$433.50
2025-05-19,18:51:00,21483.0,BUY,3,0.02h,Stop Loss,$19.50,$453.00,$217940.00,359,$453.00
2025-05-19,19:11:00,21474.25,SELL,3,0.02h,Stop Loss,$-9.00,$444.00,$217931.00,359,$444.00
2025-05-19,19:39:00,21475.25,BUY,3,0.02h,Stop Loss,$10.50,$454.50,$217941.50,359,$454.50
2025-05-19,19:45:00,21462.5,SELL,3,0.02h,Break Even,$-1.50,$453.00,$217940.00,359,$453.00
2025-05-19,19:46:00,21473.25,BUY,3,0.02h,Break Even,$-1.50,$451.50,$217938.50,359,$451.50
2025-05-19,20:09:00,21486.75,SELL,3,0.02h,Stop Loss,$-9.00,$442.50,$217929.50,359,$442.50
2025-05-19,20:25:00,21492.25,BUY,3,0.02h,Stop Loss,$4.50,$447.00,$217934.00,359,$447.00
2025-05-19,23:02:00,21499.5,SELL,3,0.02h,Break Even,$-1.50,$445.50,$217932.50,359,$445.50
2025-05-19,23:12:00,21518.75,BUY,3,0.02h,Stop Loss,$22.50,$468.00,$217955.00,359,$468.00
2025-05-19,23:55:00,21526.25,SELL,3,0.02h,Stop Loss,$-9.00,$459.00,$217946.00,359,$459.00
,,,,,,,,,,,
2025-05-20,00:03:00,21553.25,BUY,3,0.02h,Stop Loss,$-9.00,$-9.00,$217937.00,360,$-9.00
2025-05-20,00:20:00,21542.5,SELL,3,0.02h,Break Even,$-1.50,$-10.50,$217935.50,360,$-10.50
2025-05-20,00:39:00,21549.75,BUY,3,0.02h,Stop Loss,$9.00,$-1.50,$217944.50,360,$-1.50
2025-05-20,00:45:00,21540.75,SELL,3,0.02h,Break Even,$-1.50,$-3.00,$217943.00,360,$-3.00
2025-05-20,01:58:00,21460.75,BUY,3,0.02h,Stop Loss,$-9.00,$-12.00,$217934.00,360,$-12.00
2025-05-20,02:04:00,21456.0,SELL,3,0.02h,Stop Loss,$-9.00,$-21.00,$217925.00,360,$-21.00
2025-05-20,02:05:00,21459.0,BUY,3,0.02h,Stop Loss,$-9.00,$-30.00,$217916.00,360,$-30.00
2025-05-20,02:06:00,21451.75,SELL,3,0.02h,Stop Loss,$-9.00,$-39.00,$217907.00,360,$-39.00
2025-05-20,02:11:00,21465.75,BUY,3,0.02h,Stop Loss,$-9.00,$-48.00,$217898.00,360,$-48.00
2025-05-20,02:15:00,21456.5,SELL,3,0.02h,Stop Loss,$22.50,$-25.50,$217920.50,360,$-25.50
2025-05-20,02:26:00,21457.75,BUY,3,0.02h,Stop Loss,$-9.00,$-34.50,$217911.50,360,$-34.50
2025-05-20,02:28:00,21451.25,SELL,3,0.02h,Break Even,$-1.50,$-36.00,$217910.00,360,$-36.00
2025-05-20,02:42:00,21457.75,BUY,3,0.02h,Break Even,$-1.50,$-37.50,$217908.50,360,$-37.50
2025-05-20,03:01:00,21450.5,SELL,3,0.02h,Break Even,$-1.50,$-39.00,$217907.00,360,$-39.00
2025-05-20,03:30:00,21447.25,BUY,3,0.02h,Stop Loss,$-9.00,$-48.00,$217898.00,360,$-48.00
2025-05-20,03:34:00,21440.75,SELL,3,0.02h,Stop Loss,$4.50,$-43.50,$217902.50,360,$-43.50
2025-05-20,03:40:00,21453.5,BUY,3,0.02h,Break Even,$-1.50,$-45.00,$217901.00,360,$-45.00
2025-05-20,03:48:00,21442.5,SELL,3,0.02h,Stop Loss,$3.00,$-42.00,$217904.00,360,$-42.00
2025-05-20,04:32:00,21435.0,BUY,3,0.02h,Stop Loss,$-9.00,$-51.00,$217895.00,360,$-51.00
2025-05-20,04:39:00,21431.0,SELL,3,0.02h,Break Even,$-1.50,$-52.50,$217893.50,360,$-52.50
2025-05-20,04:43:00,21433.75,BUY,3,0.02h,Break Even,$-1.50,$-54.00,$217892.00,360,$-54.00
2025-05-20,04:50:00,21430.5,SELL,3,0.02h,Stop Loss,$-9.00,$-63.00,$217883.00,360,$-63.00
2025-05-20,04:51:00,21434.25,BUY,3,0.05h,Stop Loss,$63.00,$0.00,$217946.00,360,$0.00
2025-05-20,05:41:00,21468.75,SELL,3,0.02h,Break Even,$-1.50,$-1.50,$217944.50,360,$-1.50
2025-05-20,06:35:00,21415.0,BUY,3,0.02h,Stop Loss,$46.50,$45.00,$217991.00,360,$45.00
2025-05-20,07:02:00,21413.5,SELL,3,0.02h,Stop Loss,$-9.00,$36.00,$217982.00,360,$36.00
2025-05-20,07:11:00,21424.75,BUY,3,0.02h,Stop Loss,$15.00,$51.00,$217997.00,360,$51.00
2025-05-20,07:41:00,21442.5,SELL,3,0.02h,Stop Loss,$30.00,$81.00,$218027.00,360,$81.00
2025-05-20,07:58:00,21444.5,BUY,3,0.02h,Break Even,$-1.50,$79.50,$218025.50,360,$79.50
2025-05-20,08:10:00,21433.75,SELL,3,0.02h,Stop Loss,$16.50,$96.00,$218042.00,360,$96.00
2025-05-20,08:22:00,21446.75,BUY,3,0.02h,Break Even,$-1.50,$94.50,$218040.50,360,$94.50
2025-05-20,08:33:00,21435.25,SELL,3,0.02h,Stop Loss,$9.00,$103.50,$218049.50,360,$103.50
2025-05-20,08:42:00,21445.5,BUY,3,0.02h,Stop Loss,$9.00,$112.50,$218058.50,360,$112.50
2025-05-20,08:54:00,21436.25,SELL,3,0.02h,Stop Loss,$-9.00,$103.50,$218049.50,360,$103.50
2025-05-20,09:04:00,21449.75,BUY,3,0.02h,Break Even,$-1.50,$102.00,$218048.00,360,$102.00
2025-05-20,09:11:00,21431.25,SELL,3,0.02h,Break Even,$-1.50,$100.50,$218046.50,360,$100.50
2025-05-20,09:40:00,21432.25,BUY,3,0.02h,Stop Loss,$-9.00,$91.50,$218037.50,360,$91.50
2025-05-20,09:50:00,21422.5,SELL,3,0.02h,Break Even,$-1.50,$90.00,$218036.00,360,$90.00
2025-05-20,10:02:00,21432.75,BUY,3,0.02h,Stop Loss,$4.50,$94.50,$218040.50,360,$94.50
2025-05-20,10:36:00,21439.25,SELL,3,0.02h,Break Even,$-1.50,$93.00,$218039.00,360,$93.00
2025-05-20,10:46:00,21444.0,BUY,3,0.02h,Break Even,$-1.50,$91.50,$218037.50,360,$91.50
2025-05-20,11:37:00,21472.25,SELL,3,0.02h,Stop Loss,$-9.00,$82.50,$218028.50,360,$82.50
2025-05-20,11:39:00,21475.5,BUY,3,0.02h,Stop Loss,$13.50,$96.00,$218042.00,360,$96.00
2025-05-20,11:45:00,21471.0,SELL,3,0.02h,Stop Loss,$16.50,$112.50,$218058.50,360,$112.50
2025-05-20,12:19:00,21469.25,BUY,3,0.02h,Break Even,$-1.50,$111.00,$218057.00,360,$111.00
2025-05-20,12:21:00,21462.0,SELL,3,0.02h,Break Even,$-1.50,$109.50,$218055.50,360,$109.50
2025-05-20,13:02:00,21442.5,BUY,3,0.02h,Break Even,$-1.50,$108.00,$218054.00,360,$108.00
2025-05-20,13:25:00,21431.0,SELL,3,0.02h,Stop Loss,$9.00,$117.00,$218063.00,360,$117.00
2025-05-20,14:19:00,21407.25,BUY,3,0.02h,Stop Loss,$19.50,$136.50,$218082.50,360,$136.50
2025-05-20,14:33:00,21388.0,SELL,3,0.02h,Stop Loss,$18.00,$154.50,$218100.50,360,$154.50
2025-05-20,14:36:00,21407.5,BUY,3,0.02h,Break Even,$-1.50,$153.00,$218099.00,360,$153.00
2025-05-20,14:59:00,21410.25,SELL,3,0.02h,Stop Loss,$25.50,$178.50,$218124.50,360,$178.50
2025-05-20,15:18:00,21424.5,BUY,3,0.02h,Break Even,$-1.50,$177.00,$218123.00,360,$177.00
2025-05-20,15:25:00,21408.5,SELL,3,0.02h,Stop Loss,$9.00,$186.00,$218132.00,360,$186.00
2025-05-20,15:28:00,21423.25,BUY,3,0.02h,Break Even,$-1.50,$184.50,$218130.50,360,$184.50
2025-05-20,15:36:00,21414.5,SELL,3,0.02h,Stop Loss,$4.50,$189.00,$218135.00,360,$189.00
2025-05-20,15:51:00,21420.75,BUY,3,0.02h,Stop Loss,$-9.00,$180.00,$218126.00,360,$180.00
2025-05-20,16:11:00,21411.75,SELL,3,0.02h,Stop Loss,$31.50,$211.50,$218157.50,360,$211.50
2025-05-20,16:21:00,21430.25,BUY,3,0.02h,Break Even,$-1.50,$210.00,$218156.00,360,$210.00
2025-05-20,16:25:00,21413.5,SELL,3,0.02h,Stop Loss,$28.50,$238.50,$218184.50,360,$238.50
2025-05-20,16:28:00,21434.75,BUY,3,0.02h,Stop Loss,$9.00,$247.50,$218193.50,360,$247.50
2025-05-20,17:18:00,21460.25,SELL,3,0.02h,Stop Loss,$12.00,$259.50,$218205.50,360,$259.50
2025-05-20,18:05:00,21435.5,BUY,3,0.02h,Break Even,$-1.50,$258.00,$218204.00,360,$258.00
2025-05-20,18:17:00,21419.5,SELL,3,0.02h,Stop Loss,$18.00,$276.00,$218222.00,360,$276.00
2025-05-20,19:15:00,21354.5,BUY,3,0.02h,Stop Loss,$-9.00,$267.00,$218213.00,360,$267.00
2025-05-20,20:11:00,21407.0,SELL,3,0.02h,Stop Loss,$-9.00,$258.00,$218204.00,360,$258.00
2025-05-20,20:21:00,21423.75,BUY,3,0.02h,Break Even,$-1.50,$256.50,$218202.50,360,$256.50
2025-05-20,20:41:00,21424.25,SELL,3,0.02h,Break Even,$-1.50,$255.00,$218201.00,360,$255.00
2025-05-20,23:08:00,21419.25,BUY,3,0.02h,Stop Loss,$-9.00,$246.00,$218192.00,360,$246.00
2025-05-20,23:25:00,21415.75,SELL,3,0.02h,Break Even,$-1.50,$244.50,$218190.50,360,$244.50
2025-05-20,23:52:00,21418.75,BUY,3,0.02h,Stop Loss,$-9.00,$235.50,$218181.50,360,$235.50
,,,,,,,,,,,
2025-05-21,00:08:00,21407.5,SELL,3,0.02h,Stop Loss,$-9.00,$-9.00,$218172.50,361,$-9.00
2025-05-21,00:25:00,21432.25,BUY,3,0.02h,Break Even,$-1.50,$-10.50,$218171.00,361,$-10.50
2025-05-21,00:53:00,21425.75,SELL,3,0.02h,Break Even,$-1.50,$-12.00,$218169.50,361,$-12.00
2025-05-21,01:09:00,21431.75,BUY,3,0.02h,Stop Loss,$-9.00,$-21.00,$218160.50,361,$-21.00
2025-05-21,01:17:00,21420.75,SELL,3,0.02h,Break Even,$-1.50,$-22.50,$218159.00,361,$-22.50
2025-05-21,01:45:00,21410.25,BUY,3,0.02h,Break Even,$-1.50,$-24.00,$218157.50,361,$-24.00
2025-05-21,01:57:00,21399.75,SELL,3,0.02h,Break Even,$-1.50,$-25.50,$218156.00,361,$-25.50
2025-05-21,02:36:00,21398.0,BUY,3,0.02h,Stop Loss,$-9.00,$-34.50,$218147.00,361,$-34.50
2025-05-21,02:47:00,21382.0,SELL,3,0.02h,Break Even,$-1.50,$-36.00,$218145.50,361,$-36.00
2025-05-21,03:05:00,21387.25,BUY,3,0.02h,Stop Loss,$10.50,$-25.50,$218156.00,361,$-25.50
2025-05-21,03:19:00,21377.75,SELL,3,0.02h,Break Even,$-1.50,$-27.00,$218154.50,361,$-27.00
2025-05-21,03:46:00,21388.5,BUY,3,0.02h,Stop Loss,$-9.00,$-36.00,$218145.50,361,$-36.00
2025-05-21,03:59:00,21381.0,SELL,3,0.02h,Stop Loss,$7.50,$-28.50,$218153.00,361,$-28.50
2025-05-21,05:01:00,21366.0,BUY,3,0.02h,Break Even,$-1.50,$-30.00,$218151.50,361,$-30.00
2025-05-21,05:33:00,21365.75,SELL,3,0.02h,Break Even,$-1.50,$-31.50,$218150.00,361,$-31.50
2025-05-21,07:04:00,21312.75,BUY,3,0.02h,Stop Loss,$19.50,$-12.00,$218169.50,361,$-12.00
2025-05-21,07:33:00,21318.5,SELL,3,0.02h,Break Even,$-1.50,$-13.50,$218168.00,361,$-13.50
2025-05-21,07:45:00,21331.5,BUY,3,0.02h,Break Even,$-1.50,$-15.00,$218166.50,361,$-15.00
2025-05-21,08:10:00,21331.75,SELL,3,0.02h,Stop Loss,$-9.00,$-24.00,$218157.50,361,$-24.00
2025-05-21,08:54:00,21317.5,BUY,3,0.02h,Stop Loss,$-9.00,$-33.00,$218148.50,361,$-33.00
2025-05-21,09:12:00,21312.75,SELL,3,0.02h,Break Even,$-1.50,$-34.50,$218147.00,361,$-34.50
2025-05-21,09:17:00,21317.5,BUY,3,0.02h,Break Even,$-1.50,$-36.00,$218145.50,361,$-36.00
2025-05-21,09:25:00,21309.5,SELL,3,0.02h,Break Even,$-1.50,$-37.50,$218144.00,361,$-37.50
2025-05-21,10:34:00,21265.25,BUY,3,0.02h,Stop Loss,$-9.00,$-46.50,$218135.00,361,$-46.50
2025-05-21,12:03:00,21329.0,SELL,3,0.02h,Stop Loss,$24.00,$-22.50,$218159.00,361,$-22.50
2025-05-21,12:23:00,21328.75,BUY,3,0.02h,Break Even,$-1.50,$-24.00,$218157.50,361,$-24.00
2025-05-21,12:32:00,21301.25,SELL,3,0.02h,Break Even,$-1.50,$-25.50,$218156.00,361,$-25.50
2025-05-21,12:57:00,21308.75,BUY,3,0.02h,Stop Loss,$4.50,$-21.00,$218160.50,361,$-21.00
2025-05-21,13:07:00,21300.25,SELL,3,0.02h,Stop Loss,$27.00,$6.00,$218187.50,361,$6.00
2025-05-21,13:32:00,21324.25,BUY,3,0.02h,Stop Loss,$63.00,$69.00,$218250.50,361,$69.00
2025-05-21,14:30:00,21383.25,SELL,3,0.02h,Stop Loss,$-9.00,$60.00,$218241.50,361,$60.00
2025-05-21,14:31:00,21404.0,BUY,3,0.02h,Stop Loss,$19.50,$79.50,$218261.00,361,$79.50
2025-05-21,14:34:00,21381.25,SELL,3,0.02h,Stop Loss,$28.50,$108.00,$218289.50,361,$108.00
2025-05-21,14:40:00,21403.75,BUY,3,0.02h,Stop Loss,$60.00,$168.00,$218349.50,361,$168.00
2025-05-21,14:47:00,21390.5,SELL,3,0.02h,Stop Loss,$39.00,$207.00,$218388.50,361,$207.00
2025-05-21,14:50:00,21403.75,BUY,3,0.02h,Stop Loss,$51.00,$258.00,$218439.50,361,$258.00
2025-05-21,15:39:00,21505.25,SELL,3,0.02h,Break Even,$-1.50,$256.50,$218438.00,361,$256.50
2025-05-21,15:40:00,21512.0,BUY,3,0.02h,Stop Loss,$34.50,$291.00,$218472.50,361,$291.00
2025-05-21,16:22:00,21520.5,SELL,3,0.02h,Stop Loss,$13.50,$304.50,$218486.00,361,$304.50
2025-05-21,16:31:00,21538.25,BUY,3,0.02h,Break Even,$-1.50,$303.00,$218484.50,361,$303.00
2025-05-21,16:57:00,21521.0,SELL,3,0.02h,Stop Loss,$-9.00,$294.00,$218475.50,361,$294.00
2025-05-21,18:31:00,21244.25,BUY,3,0.02h,Stop Loss,$84.00,$378.00,$218559.50,361,$378.00
2025-05-21,18:49:00,21233.0,SELL,3,0.02h,Stop Loss,$139.50,$517.50,$218699.00,361,$517.50
2025-05-21,19:34:00,21155.25,BUY,3,0.02h,Break Even,$-1.50,$516.00,$218697.50,361,$516.00
2025-05-21,20:00:00,21150.25,SELL,3,0.02h,Stop Loss,$61.50,$577.50,$218759.00,361,$577.50
2025-05-21,20:34:00,21142.25,BUY,3,0.02h,Stop Loss,$10.50,$588.00,$218769.50,361,$588.00
2025-05-21,23:02:00,21136.5,SELL,3,0.02h,Break Even,$-1.50,$586.50,$218768.00,361,$586.50
2025-05-21,23:11:00,21148.5,BUY,3,0.02h,Stop Loss,$7.50,$594.00,$218775.50,361,$594.00
2025-05-21,23:35:00,21150.75,SELL,3,0.02h,Stop Loss,$21.00,$615.00,$218796.50,361,$615.00
,,,,,,,,,,,
2025-05-22,00:07:00,21162.25,BUY,3,0.02h,Stop Loss,$-9.00,$-9.00,$218787.50,362,$-9.00
2025-05-22,00:35:00,21165.0,SELL,3,0.02h,Stop Loss,$13.50,$4.50,$218801.00,362,$4.50
2025-05-22,00:48:00,21177.0,BUY,3,0.02h,Stop Loss,$6.00,$10.50,$218807.00,362,$10.50
2025-05-22,01:21:00,21183.75,SELL,3,0.02h,Break Even,$-1.50,$9.00,$218805.50,362,$9.00
2025-05-22,02:10:00,21181.5,BUY,3,0.02h,Stop Loss,$-9.00,$0.00,$218796.50,362,$0.00
2025-05-22,02:13:00,21163.0,SELL,3,0.02h,Stop Loss,$24.00,$24.00,$218820.50,362,$24.00
2025-05-22,02:39:00,21159.25,BUY,3,0.02h,Break Even,$-1.50,$22.50,$218819.00,362,$22.50
2025-05-22,02:51:00,21155.0,SELL,3,0.02h,Break Even,$-1.50,$21.00,$218817.50,362,$21.00
2025-05-22,02:52:00,21158.5,BUY,3,0.02h,Stop Loss,$-9.00,$12.00,$218808.50,362,$12.00
2025-05-22,02:53:00,21156.75,SELL,3,0.02h,Stop Loss,$-9.00,$3.00,$218799.50,362,$3.00
2025-05-22,02:54:00,21158.5,BUY,3,0.02h,Stop Loss,$-9.00,$-6.00,$218790.50,362,$-6.00
2025-05-22,02:55:00,21154.25,SELL,3,0.02h,Break Even,$-1.50,$-7.50,$218789.00,362,$-7.50
2025-05-22,03:01:00,21163.0,BUY,3,0.02h,Stop Loss,$-9.00,$-16.50,$218780.00,362,$-16.50
2025-05-22,03:30:00,21167.25,SELL,3,0.02h,Break Even,$-1.50,$-18.00,$218778.50,362,$-18.00
2025-05-22,03:44:00,21173.75,BUY,3,0.02h,Stop Loss,$-9.00,$-27.00,$218769.50,362,$-27.00
2025-05-22,03:57:00,21167.0,SELL,3,0.02h,Break Even,$-1.50,$-28.50,$218768.00,362,$-28.50
2025-05-22,04:24:00,21167.0,BUY,3,0.02h,Stop Loss,$-9.00,$-37.50,$218759.00,362,$-37.50
2025-05-22,04:30:00,21164.5,SELL,3,0.02h,Stop Loss,$-9.00,$-46.50,$218750.00,362,$-46.50
2025-05-22,04:32:00,21168.75,BUY,3,0.02h,Stop Loss,$7.50,$-39.00,$218757.50,362,$-39.00
2025-05-22,04:41:00,21166.0,SELL,3,0.02h,Break Even,$-1.50,$-40.50,$218756.00,362,$-40.50
2025-05-22,05:08:00,21168.75,BUY,3,0.02h,Break Even,$-1.50,$-42.00,$218754.50,362,$-42.00
2025-05-22,05:15:00,21164.0,SELL,3,0.02h,Stop Loss,$-9.00,$-51.00,$218745.50,362,$-51.00
2025-05-22,05:16:00,21166.0,BUY,3,0.02h,Break Even,$-1.50,$-52.50,$218744.00,362,$-52.50
2025-05-22,05:24:00,21164.0,SELL,3,0.02h,Stop Loss,$-9.00,$-61.50,$218735.00,362,$-61.50
2025-05-22,05:26:00,21175.25,BUY,3,0.02h,Stop Loss,$18.00,$-43.50,$218753.00,362,$-43.50
2025-05-22,06:03:00,21184.5,SELL,3,0.02h,Stop Loss,$-9.00,$-52.50,$218744.00,362,$-52.50
2025-05-22,06:25:00,21190.5,BUY,3,0.02h,Stop Loss,$-9.00,$-61.50,$218735.00,362,$-61.50
2025-05-22,06:28:00,21168.5,SELL,3,0.02h,Stop Loss,$6.00,$-55.50,$218741.00,362,$-55.50
2025-05-22,06:35:00,21185.0,BUY,3,0.02h,Break Even,$-1.50,$-57.00,$218739.50,362,$-57.00
2025-05-22,07:16:00,21192.5,SELL,3,0.02h,Break Even,$-1.50,$-58.50,$218738.00,362,$-58.50
2025-05-22,07:35:00,21204.0,BUY,3,0.02h,Stop Loss,$22.50,$-36.00,$218760.50,362,$-36.00
2025-05-22,07:43:00,21185.25,SELL,3,0.02h,Stop Loss,$46.50,$10.50,$218807.00,362,$10.50
2025-05-22,07:58:00,21191.5,BUY,3,0.02h,Stop Loss,$21.00,$31.50,$218828.00,362,$31.50
2025-05-22,08:14:00,21189.5,SELL,3,0.02h,Break Even,$-1.50,$30.00,$218826.50,362,$30.00
2025-05-22,08:16:00,21200.75,BUY,3,0.02h,Stop Loss,$-9.00,$21.00,$218817.50,362,$21.00
2025-05-22,08:35:00,21192.0,SELL,3,0.02h,Break Even,$-1.50,$19.50,$218816.00,362,$19.50
2025-05-22,08:44:00,21210.75,BUY,3,0.02h,Stop Loss,$13.50,$33.00,$218829.50,362,$33.00
2025-05-22,08:59:00,21202.25,SELL,3,0.02h,Stop Loss,$12.00,$45.00,$218841.50,362,$45.00
2025-05-22,09:27:00,21200.0,BUY,3,0.02h,Stop Loss,$-9.00,$36.00,$218832.50,362,$36.00
2025-05-22,09:45:00,21194.75,SELL,3,0.02h,Stop Loss,$-9.00,$27.00,$218823.50,362,$27.00
2025-05-22,09:59:00,21204.75,BUY,3,0.02h,Break Even,$-1.50,$25.50,$218822.00,362,$25.50
2025-05-22,10:03:00,21193.0,SELL,3,0.02h,Break Even,$-1.50,$24.00,$218820.50,362,$24.00
2025-05-22,10:16:00,21199.0,BUY,3,0.02h,Break Even,$-1.50,$22.50,$218819.00,362,$22.50
2025-05-22,10:42:00,21197.5,SELL,3,0.02h,Stop Loss,$-9.00,$13.50,$218810.00,362,$13.50
2025-05-22,10:43:00,21203.25,BUY,3,0.02h,Stop Loss,$-9.00,$4.50,$218801.00,362,$4.50
2025-05-22,10:45:00,21198.75,SELL,3,0.02h,Break Even,$-1.50,$3.00,$218799.50,362,$3.00
2025-05-22,10:51:00,21201.5,BUY,3,0.02h,Stop Loss,$-9.00,$-6.00,$218790.50,362,$-6.00
2025-05-22,10:53:00,21197.5,SELL,3,0.02h,Break Even,$-1.50,$-7.50,$218789.00,362,$-7.50
2025-05-22,11:03:00,21216.5,BUY,3,0.02h,Stop Loss,$19.50,$12.00,$218808.50,362,$12.00
2025-05-22,11:16:00,21197.25,SELL,3,0.02h,Stop Loss,$30.00,$42.00,$218838.50,362,$42.00
2025-05-22,11:23:00,21212.5,BUY,3,0.02h,Stop Loss,$-9.00,$33.00,$218829.50,362,$33.00
2025-05-22,11:25:00,21203.25,SELL,3,0.02h,Stop Loss,$13.50,$46.50,$218843.00,362,$46.50
2025-05-22,12:36:00,21092.5,BUY,3,0.02h,Stop Loss,$37.50,$84.00,$218880.50,362,$84.00
2025-05-22,13:20:00,21170.0,SELL,3,0.02h,Stop Loss,$6.00,$90.00,$218886.50,362,$90.00
2025-05-22,13:51:00,21199.75,BUY,3,0.02h,Stop Loss,$57.00,$147.00,$218943.50,362,$147.00
2025-05-22,14:20:00,21261.5,SELL,3,0.02h,Stop Loss,$58.50,$205.50,$219002.00,362,$205.50
2025-05-22,15:03:00,21240.5,BUY,3,0.02h,Stop Loss,$6.00,$211.50,$219008.00,362,$211.50
2025-05-22,15:17:00,21215.0,SELL,3,0.02h,Stop Loss,$24.00,$235.50,$219032.00,362,$235.50
2025-05-22,15:22:00,21256.25,BUY,3,0.02h,Break Even,$-1.50,$234.00,$219030.50,362,$234.00
2025-05-22,15:30:00,21207.0,SELL,3,0.02h,Stop Loss,$37.50,$271.50,$219068.00,362,$271.50
2025-05-22,15:36:00,21249.75,BUY,3,0.02h,Break Even,$-1.50,$270.00,$219066.50,362,$270.00
2025-05-22,15:37:00,21233.0,SELL,3,0.02h,Break Even,$-1.50,$268.50,$219065.00,362,$268.50
2025-05-22,15:38:00,21242.0,BUY,3,0.02h,Stop Loss,$75.00,$343.50,$219140.00,362,$343.50
2025-05-22,16:26:00,21278.5,SELL,3,0.02h,Stop Loss,$72.00,$415.50,$219212.00,362,$415.50
2025-05-22,17:19:00,21240.75,BUY,3,0.02h,Break Even,$-1.50,$414.00,$219210.50,362,$414.00
2025-05-22,18:31:00,21286.75,SELL,3,0.02h,Stop Loss,$-9.00,$405.00,$219201.50,362,$405.00
2025-05-22,18:34:00,21298.25,BUY,3,0.02h,Break Even,$-1.50,$403.50,$219200.00,362,$403.50
2025-05-22,18:39:00,21286.25,SELL,3,0.02h,Stop Loss,$21.00,$424.50,$219221.00,362,$424.50
2025-05-22,18:53:00,21305.5,BUY,3,0.02h,Stop Loss,$-9.00,$415.50,$219212.00,362,$415.50
2025-05-22,19:22:00,21307.25,SELL,3,0.02h,Break Even,$-1.50,$414.00,$219210.50,362,$414.00
2025-05-22,19:28:00,21326.0,BUY,3,0.02h,Break Even,$-1.50,$412.50,$219209.00,362,$412.50
2025-05-22,19:34:00,21296.25,SELL,3,0.02h,Break Even,$-1.50,$411.00,$219207.50,362,$411.00
2025-05-22,20:38:00,21191.0,BUY,3,0.02h,Break Even,$-1.50,$409.50,$219206.00,362,$409.50
2025-05-22,23:00:00,21146.5,SELL,3,0.02h,Break Even,$-1.50,$408.00,$219204.50,362,$408.00
2025-05-22,23:21:00,21170.5,BUY,3,0.02h,Stop Loss,$-9.00,$399.00,$219195.50,362,$399.00
2025-05-22,23:37:00,21159.25,SELL,3,0.02h,Stop Loss,$4.50,$403.50,$219200.00,362,$403.50
2025-05-22,23:49:00,21169.25,BUY,3,0.02h,Break Even,$-1.50,$402.00,$219198.50,362,$402.00
,,,,,,,,,,,
2025-05-23,00:25:00,21184.5,SELL,3,0.02h,Stop Loss,$-9.00,$-9.00,$219189.50,363,$-9.00
2025-05-23,00:38:00,21197.0,BUY,3,0.02h,Stop Loss,$-9.00,$-18.00,$219180.50,363,$-18.00
2025-05-23,00:40:00,21179.0,SELL,3,0.02h,Stop Loss,$-9.00,$-27.00,$219171.50,363,$-27.00
2025-05-23,00:48:00,21191.25,BUY,3,0.02h,Stop Loss,$6.00,$-21.00,$219177.50,363,$-21.00
2025-05-23,01:04:00,21184.0,SELL,3,0.02h,Stop Loss,$18.00,$-3.00,$219195.50,363,$-3.00
2025-05-23,01:32:00,21178.25,BUY,3,0.02h,Break Even,$-1.50,$-4.50,$219194.00,363,$-4.50
2025-05-23,01:37:00,21169.25,SELL,3,0.02h,Stop Loss,$4.50,$0.00,$219198.50,363,$0.00
2025-05-23,02:04:00,21171.5,BUY,3,0.02h,Break Even,$-1.50,$-1.50,$219197.00,363,$-1.50
2025-05-23,02:35:00,21178.0,SELL,3,0.02h,Stop Loss,$-9.00,$-10.50,$219188.00,363,$-10.50
2025-05-23,02:58:00,21187.0,BUY,3,0.02h,Stop Loss,$-9.00,$-19.50,$219179.00,363,$-19.50
2025-05-23,02:59:00,21179.0,SELL,3,0.02h,Stop Loss,$-9.00,$-28.50,$219170.00,363,$-28.50
2025-05-23,03:01:00,21189.25,BUY,3,0.02h,Stop Loss,$19.50,$-9.00,$219189.50,363,$-9.00
2025-05-23,03:08:00,21183.0,SELL,3,0.02h,Stop Loss,$-9.00,$-18.00,$219180.50,363,$-18.00
2025-05-23,03:11:00,21191.5,BUY,3,0.02h,Stop Loss,$-9.00,$-27.00,$219171.50,363,$-27.00
2025-05-23,03:17:00,21182.75,SELL,3,0.02h,Break Even,$-1.50,$-28.50,$219170.00,363,$-28.50
2025-05-23,03:19:00,21188.25,BUY,3,0.02h,Stop Loss,$25.50,$-3.00,$219195.50,363,$-3.00
2025-05-23,03:36:00,21184.5,SELL,3,0.02h,Stop Loss,$15.00,$12.00,$219210.50,363,$12.00
2025-05-23,03:52:00,21195.25,BUY,3,0.02h,Stop Loss,$-9.00,$3.00,$219201.50,363,$3.00
2025-05-23,04:03:00,21180.0,SELL,3,0.02h,Stop Loss,$-9.00,$-6.00,$219192.50,363,$-6.00
2025-05-23,05:04:00,21161.75,BUY,3,0.02h,Break Even,$-1.50,$-7.50,$219191.00,363,$-7.50
2025-05-23,05:35:00,21167.25,SELL,3,0.02h,Break Even,$-1.50,$-9.00,$219189.50,363,$-9.00
2025-05-23,06:31:00,21122.5,BUY,3,0.02h,Break Even,$-1.50,$-10.50,$219188.00,363,$-10.50
2025-05-23,08:17:00,21195.25,SELL,3,0.02h,Break Even,$-1.50,$-12.00,$219186.50,363,$-12.00
2025-05-23,08:28:00,21217.25,BUY,3,0.02h,Stop Loss,$9.00,$-3.00,$219195.50,363,$-3.00
2025-05-23,08:36:00,21199.25,SELL,3,0.02h,Stop Loss,$-9.00,$-12.00,$219186.50,363,$-12.00
2025-05-23,09:43:00,21162.5,BUY,3,0.02h,Stop Loss,$-9.00,$-21.00,$219177.50,363,$-21.00
2025-05-23,09:49:00,21155.5,SELL,3,0.02h,Stop Loss,$-9.00,$-30.00,$219168.50,363,$-30.00
2025-05-23,09:50:00,21161.75,BUY,3,0.02h,Break Even,$-1.50,$-31.50,$219167.00,363,$-31.50
2025-05-23,10:14:00,21164.25,SELL,3,0.02h,Stop Loss,$-9.00,$-40.50,$219158.00,363,$-40.50
2025-05-23,10:28:00,21174.25,BUY,3,0.02h,Break Even,$-1.50,$-42.00,$219156.50,363,$-42.00
2025-05-23,10:32:00,21167.25,SELL,3,0.02h,Break Even,$-1.50,$-43.50,$219155.00,363,$-43.50
2025-05-23,10:49:00,21174.0,BUY,3,0.02h,Stop Loss,$-9.00,$-52.50,$219146.00,363,$-52.50
2025-05-23,11:07:00,21160.0,SELL,3,0.02h,Stop Loss,$6.00,$-46.50,$219152.00,363,$-46.50
2025-05-23,11:16:00,21174.5,BUY,3,0.02h,Break Even,$-1.50,$-48.00,$219150.50,363,$-48.00
2025-05-23,11:20:00,21113.5,SELL,3,0.02h,Stop Loss,$244.50,$196.50,$219395.00,363,$196.50
2025-05-23,12:31:00,20820.0,BUY,3,0.02h,Stop Loss,$72.00,$268.50,$219467.00,363,$268.50
2025-05-23,12:54:00,20796.0,SELL,3,0.02h,Stop Loss,$72.00,$340.50,$219539.00,363,$340.50
2025-05-23,13:12:00,20805.25,BUY,3,0.02h,Stop Loss,$-9.00,$331.50,$219530.00,363,$331.50
2025-05-23,13:14:00,20779.5,SELL,3,0.02h,Break Even,$-1.50,$330.00,$219528.50,363,$330.00
2025-05-23,13:19:00,20794.0,BUY,3,0.02h,Stop Loss,$75.00,$405.00,$219603.50,363,$405.00
2025-05-23,13:22:00,20779.5,SELL,3,0.02h,Stop Loss,$3.00,$408.00,$219606.50,363,$408.00
2025-05-23,13:26:00,20816.75,BUY,3,0.02h,Stop Loss,$81.00,$489.00,$219687.50,363,$489.00
2025-05-23,13:54:00,20858.25,SELL,3,0.02h,Stop Loss,$40.50,$529.50,$219728.00,363,$529.50
2025-05-23,13:57:00,20881.0,BUY,3,0.02h,Stop Loss,$37.50,$567.00,$219765.50,363,$567.00
2025-05-23,14:52:00,20941.25,SELL,3,0.02h,Stop Loss,$52.50,$619.50,$219818.00,363,$619.50
2025-05-23,15:21:00,20942.75,BUY,3,0.02h,Stop Loss,$58.50,$678.00,$219876.50,363,$678.00
2025-05-23,15:53:00,20945.75,SELL,3,0.02h,Stop Loss,$15.00,$693.00,$219891.50,363,$693.00
2025-05-23,16:22:00,20962.0,BUY,3,0.02h,Stop Loss,$40.50,$733.50,$219932.00,363,$733.50
2025-05-23,16:34:00,20942.75,SELL,3,0.02h,Stop Loss,$16.50,$750.00,$219948.50,363,$750.00
2025-05-23,16:38:00,20978.75,BUY,3,0.02h,Stop Loss,$4.50,$754.50,$219953.00,363,$754.50
2025-05-23,17:41:00,21027.0,SELL,3,0.02h,Stop Loss,$-9.00,$745.50,$219944.00,363,$745.50
2025-05-23,17:52:00,21058.75,BUY,3,0.02h,Stop Loss,$63.00,$808.50,$220007.00,363,$808.50
2025-05-23,18:20:00,21041.75,SELL,3,0.02h,Stop Loss,$133.50,$942.00,$220140.50,363,$942.00
2025-05-23,18:36:00,21064.25,BUY,3,0.02h,Break Even,$-1.50,$940.50,$220139.00,363,$940.50
2025-05-23,18:46:00,21041.75,SELL,3,0.02h,Stop Loss,$63.00,$1003.50,$220202.00,363,$1003.50
2025-05-23,18:56:00,21052.75,BUY,3,0.02h,Break Even,$-1.50,$1002.00,$220200.50,363,$1002.00
2025-05-23,18:58:00,21042.0,SELL,3,0.02h,Stop Loss,$34.50,$1036.50,$220235.00,363,$1036.50
2025-05-23,19:11:00,21048.5,BUY,3,0.02h,Stop Loss,$91.50,$1128.00,$220326.50,363,$1128.00
2025-05-23,19:20:00,21028.75,SELL,3,0.02h,Stop Loss,$33.00,$1161.00,$220359.50,363,$1161.00
2025-05-23,19:38:00,21030.75,BUY,3,0.02h,Stop Loss,$58.50,$1219.50,$220418.00,363,$1219.50
2025-05-23,19:49:00,21013.75,SELL,3,0.02h,Stop Loss,$30.00,$1249.50,$220448.00,363,$1249.50
2025-05-23,20:58:00,20946.25,BUY,3,0.02h,Stop Loss,$49.50,$1299.00,$220497.50,363,$1299.00
,,,,,,,,,,,
2025-05-26,01:01:00,21170.0,SELL,3,0.02h,Break Even,$-1.50,$-1.50,$220496.00,364,$-1.50
2025-05-26,01:13:00,21193.75,BUY,3,0.02h,Stop Loss,$22.50,$21.00,$220518.50,364,$21.00
2025-05-26,01:27:00,21182.5,SELL,3,0.02h,Break Even,$-1.50,$19.50,$220517.00,364,$19.50
2025-05-26,01:41:00,21201.75,BUY,3,0.02h,Stop Loss,$-9.00,$10.50,$220508.00,364,$10.50
2025-05-26,02:36:00,21206.5,SELL,3,0.02h,Break Even,$-1.50,$9.00,$220506.50,364,$9.00
2025-05-26,03:05:00,21204.0,BUY,3,0.02h,Stop Loss,$7.50,$16.50,$220514.00,364,$16.50
2025-05-26,03:36:00,21208.0,SELL,3,0.02h,Break Even,$-1.50,$15.00,$220512.50,364,$15.00
2025-05-26,03:40:00,21215.25,BUY,3,0.02h,Stop Loss,$-9.00,$6.00,$220503.50,364,$6.00
2025-05-26,03:52:00,21212.25,SELL,3,0.02h,Stop Loss,$-9.00,$-3.00,$220494.50,364,$-3.00
2025-05-26,04:36:00,21214.75,BUY,3,0.02h,Break Even,$-1.50,$-4.50,$220493.00,364,$-4.50
2025-05-26,05:03:00,21214.0,SELL,3,0.02h,Break Even,$-1.50,$-6.00,$220491.50,364,$-6.00
2025-05-26,05:24:00,21214.0,BUY,3,0.02h,Stop Loss,$-9.00,$-15.00,$220482.50,364,$-15.00
2025-05-26,05:25:00,21210.0,SELL,3,0.02h,Break Even,$-1.50,$-16.50,$220481.00,364,$-16.50
2025-05-26,05:39:00,21211.0,BUY,3,0.02h,Break Even,$-1.50,$-18.00,$220479.50,364,$-18.00
2025-05-26,05:57:00,21207.5,SELL,3,0.02h,Break Even,$-1.50,$-19.50,$220478.00,364,$-19.50
2025-05-26,06:06:00,21213.75,BUY,3,0.02h,Stop Loss,$55.50,$36.00,$220533.50,364,$36.00
2025-05-26,06:16:00,21205.75,SELL,3,0.02h,Break Even,$-1.50,$34.50,$220532.00,364,$34.50
2025-05-26,06:23:00,21218.0,BUY,3,0.02h,Stop Loss,$-9.00,$25.50,$220523.00,364,$25.50
2025-05-26,07:15:00,21236.0,SELL,3,0.02h,Stop Loss,$7.50,$33.00,$220530.50,364,$33.00
2025-05-26,07:20:00,21256.75,BUY,3,0.02h,Break Even,$-1.50,$31.50,$220529.00,364,$31.50
2025-05-26,07:43:00,21246.25,SELL,3,0.02h,Break Even,$-1.50,$30.00,$220527.50,364,$30.00
2025-05-26,07:46:00,21256.5,BUY,3,0.02h,Stop Loss,$-9.00,$21.00,$220518.50,364,$21.00
2025-05-26,07:49:00,21251.5,SELL,3,0.02h,Break Even,$-1.50,$19.50,$220517.00,364,$19.50
2025-05-26,07:57:00,21256.25,BUY,3,0.02h,Stop Loss,$15.00,$34.50,$220532.00,364,$34.50
2025-05-26,08:25:00,21267.0,SELL,3,0.02h,Stop Loss,$-9.00,$25.50,$220523.00,364,$25.50
2025-05-26,08:41:00,21273.25,BUY,3,0.02h,Stop Loss,$-9.00,$16.50,$220514.00,364,$16.50
2025-05-26,08:42:00,21267.25,SELL,3,0.02h,Stop Loss,$-9.00,$7.50,$220505.00,364,$7.50
2025-05-26,08:43:00,21272.25,BUY,3,0.02h,Break Even,$-1.50,$6.00,$220503.50,364,$6.00
2025-05-26,08:51:00,21267.0,SELL,3,0.02h,Stop Loss,$31.50,$37.50,$220535.00,364,$37.50
2025-05-26,09:13:00,21260.0,BUY,3,0.02h,Break Even,$-1.50,$36.00,$220533.50,364,$36.00
2025-05-26,09:19:00,21251.75,SELL,3,0.02h,Break Even,$-1.50,$34.50,$220532.00,364,$34.50
2025-05-26,09:26:00,21260.0,BUY,3,0.02h,Stop Loss,$-9.00,$25.50,$220523.00,364,$25.50
2025-05-26,09:31:00,21253.25,SELL,3,0.02h,Break Even,$-1.50,$24.00,$220521.50,364,$24.00
2025-05-26,09:53:00,21252.5,BUY,3,0.02h,Stop Loss,$-9.00,$15.00,$220512.50,364,$15.00
2025-05-26,10:02:00,21246.5,SELL,3,0.02h,Stop Loss,$-9.00,$6.00,$220503.50,364,$6.00
2025-05-26,10:03:00,21255.75,BUY,3,0.02h,Break Even,$-1.50,$4.50,$220502.00,364,$4.50
2025-05-26,10:40:00,21264.5,SELL,3,0.02h,Break Even,$-1.50,$3.00,$220500.50,364,$3.00
2025-05-26,10:45:00,21269.75,BUY,3,0.02h,Stop Loss,$-9.00,$-6.00,$220491.50,364,$-6.00
2025-05-26,10:57:00,21259.75,SELL,3,0.02h,Stop Loss,$-9.00,$-15.00,$220482.50,364,$-15.00
2025-05-26,11:12:00,21267.75,BUY,3,0.02h,Break Even,$-1.50,$-16.50,$220481.00,364,$-16.50
2025-05-26,11:23:00,21264.5,SELL,3,0.02h,Stop Loss,$-9.00,$-25.50,$220472.00,364,$-25.50
2025-05-26,11:34:00,21270.0,BUY,3,0.02h,Stop Loss,$9.00,$-16.50,$220481.00,364,$-16.50
2025-05-26,12:29:00,21276.0,SELL,3,0.02h,Break Even,$-1.50,$-18.00,$220479.50,364,$-18.00
2025-05-26,12:32:00,21285.25,BUY,3,0.02h,Break Even,$-1.50,$-19.50,$220478.00,364,$-19.50
2025-05-26,12:39:00,21276.5,SELL,3,0.02h,Stop Loss,$18.00,$-1.50,$220496.00,364,$-1.50
2025-05-26,13:04:00,21276.5,BUY,3,0.02h,Stop Loss,$-9.00,$-10.50,$220487.00,364,$-10.50
2025-05-26,13:07:00,21268.5,SELL,3,0.02h,Stop Loss,$-9.00,$-19.50,$220478.00,364,$-19.50
2025-05-26,13:12:00,21278.0,BUY,3,0.02h,Break Even,$-1.50,$-21.00,$220476.50,364,$-21.00
2025-05-26,13:21:00,21264.5,SELL,3,0.02h,Break Even,$-1.50,$-22.50,$220475.00,364,$-22.50
2025-05-26,13:33:00,21288.25,BUY,3,0.02h,Stop Loss,$70.50,$48.00,$220545.50,364,$48.00
2025-05-26,13:56:00,21278.25,SELL,3,0.02h,Stop Loss,$3.00,$51.00,$220548.50,364,$51.00
2025-05-26,15:20:00,21236.75,BUY,3,0.02h,Stop Loss,$7.50,$58.50,$220556.00,364,$58.50
2025-05-26,16:26:00,21272.75,SELL,3,0.02h,Break Even,$-1.50,$57.00,$220554.50,364,$57.00
2025-05-26,16:40:00,21277.5,BUY,3,0.02h,Stop Loss,$-9.00,$48.00,$220545.50,364,$48.00
2025-05-26,23:00:00,21228.75,SELL,3,0.02h,Stop Loss,$-9.00,$39.00,$220536.50,364,$39.00
2025-05-26,23:55:00,21233.25,BUY,3,0.02h,Break Even,$-1.50,$37.50,$220535.00,364,$37.50
,,,,,,,,,,,
2025-05-27,00:05:00,21225.5,SELL,3,0.02h,Break Even,$-1.50,$-1.50,$220533.50,365,$-1.50
2025-05-27,00:20:00,21233.0,BUY,3,0.02h,Stop Loss,$-9.00,$-10.50,$220524.50,365,$-10.50
2025-05-27,00:22:00,21223.5,SELL,3,0.02h,Stop Loss,$105.00,$94.50,$220629.50,365,$94.50
2025-05-27,00:40:00,21220.25,BUY,3,0.02h,Stop Loss,$-9.00,$85.50,$220620.50,365,$85.50
2025-05-27,00:42:00,21215.25,SELL,3,0.02h,Break Even,$-1.50,$84.00,$220619.00,365,$84.00
2025-05-27,00:43:00,21217.25,BUY,3,0.02h,Stop Loss,$4.50,$88.50,$220623.50,365,$88.50
2025-05-27,01:05:00,21210.0,SELL,3,0.02h,Stop Loss,$-9.00,$79.50,$220614.50,365,$79.50
2025-05-27,02:28:00,21174.25,BUY,3,0.02h,Break Even,$-1.50,$78.00,$220613.00,365,$78.00
2025-05-27,02:46:00,21171.0,SELL,3,0.02h,Stop Loss,$-9.00,$69.00,$220604.00,365,$69.00
2025-05-27,02:51:00,21181.5,BUY,3,0.02h,Stop Loss,$-9.00,$60.00,$220595.00,365,$60.00
2025-05-27,03:14:00,21174.25,SELL,3,0.02h,Break Even,$-1.50,$58.50,$220593.50,365,$58.50
2025-05-27,04:09:00,21164.75,BUY,3,0.02h,Stop Loss,$10.50,$69.00,$220604.00,365,$69.00
2025-05-27,05:05:00,21167.5,SELL,3,0.02h,Break Even,$-1.50,$67.50,$220602.50,365,$67.50
2025-05-27,05:21:00,21180.25,BUY,3,0.02h,Break Even,$-1.50,$66.00,$220601.00,365,$66.00
2025-05-27,07:02:00,21238.0,SELL,3,0.02h,Stop Loss,$-9.00,$57.00,$220592.00,365,$57.00
2025-05-27,07:04:00,21254.25,BUY,3,0.02h,Stop Loss,$12.00,$69.00,$220604.00,365,$69.00
2025-05-27,08:04:00,21317.25,SELL,3,0.02h,Stop Loss,$3.00,$72.00,$220607.00,365,$72.00
2025-05-27,08:10:00,21337.0,BUY,3,0.02h,Stop Loss,$37.50,$109.50,$220644.50,365,$109.50
2025-05-27,08:21:00,21323.0,SELL,3,0.02h,Stop Loss,$-9.00,$100.50,$220635.50,365,$100.50
2025-05-27,08:45:00,21329.25,BUY,3,0.02h,Break Even,$-1.50,$99.00,$220634.00,365,$99.00
2025-05-27,08:47:00,21322.0,SELL,3,0.02h,Break Even,$-1.50,$97.50,$220632.50,365,$97.50
2025-05-27,09:04:00,21331.0,BUY,3,0.02h,Stop Loss,$6.00,$103.50,$220638.50,365,$103.50
2025-05-27,09:24:00,21328.25,SELL,3,0.02h,Stop Loss,$13.50,$117.00,$220652.00,365,$117.00
2025-05-27,09:36:00,21336.5,BUY,3,0.02h,Stop Loss,$9.00,$126.00,$220661.00,365,$126.00
2025-05-27,09:55:00,21334.0,SELL,3,0.02h,Stop Loss,$22.50,$148.50,$220683.50,365,$148.50
2025-05-27,10:17:00,21340.0,BUY,3,0.02h,Stop Loss,$6.00,$154.50,$220689.50,365,$154.50
2025-05-27,10:32:00,21320.25,SELL,3,0.02h,Stop Loss,$-9.00,$145.50,$220680.50,365,$145.50
2025-05-27,11:29:00,21296.75,BUY,3,0.02h,Stop Loss,$-9.00,$136.50,$220671.50,365,$136.50
2025-05-27,11:54:00,21299.25,SELL,3,0.02h,Stop Loss,$-9.00,$127.50,$220662.50,365,$127.50
2025-05-27,11:55:00,21304.0,BUY,3,0.02h,Break Even,$-1.50,$126.00,$220661.00,365,$126.00
2025-05-27,12:00:00,21297.0,SELL,3,0.02h,Stop Loss,$4.50,$130.50,$220665.50,365,$130.50
2025-05-27,12:33:00,21294.25,BUY,3,0.02h,Break Even,$-1.50,$129.00,$220664.00,365,$129.00
2025-05-27,12:39:00,21283.25,SELL,3,0.02h,Stop Loss,$3.00,$132.00,$220667.00,365,$132.00
2025-05-27,13:03:00,21281.75,BUY,3,0.02h,Break Even,$-1.50,$130.50,$220665.50,365,$130.50
2025-05-27,13:28:00,21266.0,SELL,3,0.02h,Stop Loss,$34.50,$165.00,$220700.00,365,$165.00
2025-05-27,13:50:00,21265.75,BUY,3,0.02h,Stop Loss,$75.00,$240.00,$220775.00,365,$240.00
2025-05-27,14:57:00,21363.5,SELL,3,0.02h,Break Even,$-1.50,$238.50,$220773.50,365,$238.50
2025-05-27,15:12:00,21373.75,BUY,3,0.02h,Break Even,$-1.50,$237.00,$220772.00,365,$237.00
2025-05-27,15:42:00,21375.5,SELL,3,0.02h,Stop Loss,$-9.00,$228.00,$220763.00,365,$228.00
2025-05-27,15:46:00,21385.5,BUY,3,0.02h,Break Even,$-1.50,$226.50,$220761.50,365,$226.50
2025-05-27,17:34:00,21448.5,SELL,3,0.02h,Break Even,$-1.50,$225.00,$220760.00,365,$225.00
2025-05-27,17:41:00,21456.5,BUY,3,0.02h,Stop Loss,$6.00,$231.00,$220766.00,365,$231.00
2025-05-27,18:19:00,21467.25,SELL,3,0.02h,Stop Loss,$-9.00,$222.00,$220757.00,365,$222.00
2025-05-27,19:25:00,21444.25,BUY,3,0.02h,Stop Loss,$-9.00,$213.00,$220748.00,365,$213.00
2025-05-27,19:28:00,21437.75,SELL,3,0.02h,Break Even,$-1.50,$211.50,$220746.50,365,$211.50
2025-05-27,19:43:00,21442.75,BUY,3,0.02h,Stop Loss,$-9.00,$202.50,$220737.50,365,$202.50
2025-05-27,19:50:00,21426.5,SELL,3,0.02h,Stop Loss,$45.00,$247.50,$220782.50,365,$247.50
2025-05-27,19:54:00,21436.0,BUY,3,0.02h,Stop Loss,$105.00,$352.50,$220887.50,365,$352.50
2025-05-27,20:34:00,21464.0,SELL,3,0.02h,Break Even,$-1.50,$351.00,$220886.00,365,$351.00
2025-05-27,20:36:00,21468.25,BUY,3,0.02h,Stop Loss,$-9.00,$342.00,$220877.00,365,$342.00
2025-05-27,23:04:00,21470.25,SELL,3,0.02h,Stop Loss,$-9.00,$333.00,$220868.00,365,$333.00
2025-05-27,23:11:00,21475.25,BUY,3,0.02h,Break Even,$-1.50,$331.50,$220866.50,365,$331.50
2025-05-27,23:26:00,21473.25,SELL,3,0.02h,Break Even,$-1.50,$330.00,$220865.00,365,$330.00
2025-05-27,23:37:00,21478.0,BUY,3,0.02h,Break Even,$-1.50,$328.50,$220863.50,365,$328.50
2025-05-27,23:49:00,21474.0,SELL,3,0.02h,Break Even,$-1.50,$327.00,$220862.00,365,$327.00
2025-05-27,23:58:00,21481.25,BUY,3,0.02h,Stop Loss,$-9.00,$318.00,$220853.00,365,$318.00
,,,,,,,,,,,
2025-05-28,00:00:00,21470.5,SELL,3,0.02h,Stop Loss,$34.50,$34.50,$220887.50,366,$34.50
2025-05-28,00:26:00,21466.75,BUY,3,0.02h,Stop Loss,$-9.00,$25.50,$220878.50,366,$25.50
2025-05-28,00:30:00,21462.25,SELL,3,0.02h,Break Even,$-1.50,$24.00,$220877.00,366,$24.00
2025-05-28,00:37:00,21467.0,BUY,3,0.02h,Stop Loss,$-9.00,$15.00,$220868.00,366,$15.00
2025-05-28,00:41:00,21462.75,SELL,3,0.02h,Stop Loss,$-9.00,$6.00,$220859.00,366,$6.00
2025-05-28,00:43:00,21466.25,BUY,3,0.02h,Break Even,$-1.50,$4.50,$220857.50,366,$4.50
2025-05-28,00:50:00,21460.0,SELL,3,0.02h,Stop Loss,$-9.00,$-4.50,$220848.50,366,$-4.50
2025-05-28,00:52:00,21467.5,BUY,3,0.02h,Break Even,$-1.50,$-6.00,$220847.00,366,$-6.00
2025-05-28,01:33:00,21468.0,SELL,3,0.02h,Break Even,$-1.50,$-7.50,$220845.50,366,$-7.50
2025-05-28,02:12:00,21466.25,BUY,3,0.02h,Break Even,$-1.50,$-9.00,$220844.00,366,$-9.00
2025-05-28,02:51:00,21466.75,SELL,3,0.02h,Break Even,$-1.50,$-10.50,$220842.50,366,$-10.50
2025-05-28,03:11:00,21470.25,BUY,3,0.02h,Stop Loss,$-9.00,$-19.50,$220833.50,366,$-19.50
2025-05-28,03:33:00,21468.75,SELL,3,0.02h,Stop Loss,$-9.00,$-28.50,$220824.50,366,$-28.50
2025-05-28,04:34:00,21445.0,BUY,3,0.02h,Stop Loss,$-9.00,$-37.50,$220815.50,366,$-37.50
2025-05-28,04:36:00,21443.0,SELL,3,0.02h,Stop Loss,$-9.00,$-46.50,$220806.50,366,$-46.50
2025-05-28,05:09:00,21441.25,BUY,3,0.03h,Break Even,$-1.50,$-48.00,$220805.00,366,$-48.00
2025-05-28,05:29:00,21442.75,SELL,3,0.02h,Break Even,$-1.50,$-49.50,$220803.50,366,$-49.50
2025-05-28,05:34:00,21454.5,BUY,3,0.02h,Stop Loss,$-9.00,$-58.50,$220794.50,366,$-58.50
2025-05-28,06:01:00,21445.5,SELL,3,0.02h,Stop Loss,$18.00,$-40.50,$220812.50,366,$-40.50
2025-05-28,06:12:00,21452.0,BUY,3,0.02h,Break Even,$-1.50,$-42.00,$220811.00,366,$-42.00
2025-05-28,06:32:00,21445.5,SELL,3,0.02h,Stop Loss,$-9.00,$-51.00,$220802.00,366,$-51.00
2025-05-28,06:36:00,21454.25,BUY,3,0.03h,Stop Loss,$-9.00,$-60.00,$220793.00,366,$-60.00
2025-05-28,06:39:00,21451.0,SELL,3,0.02h,Stop Loss,$7.50,$-52.50,$220800.50,366,$-52.50
2025-05-28,07:10:00,21450.5,BUY,3,0.02h,Stop Loss,$-9.00,$-61.50,$220791.50,366,$-61.50
2025-05-28,07:30:00,21436.25,SELL,3,0.02h,Stop Loss,$12.00,$-49.50,$220803.50,366,$-49.50
2025-05-28,07:43:00,21453.0,BUY,3,0.02h,Break Even,$-1.50,$-51.00,$220802.00,366,$-51.00
2025-05-28,07:49:00,21441.5,SELL,3,0.02h,Break Even,$-1.50,$-52.50,$220800.50,366,$-52.50
2025-05-28,08:27:00,21436.75,BUY,3,0.02h,Stop Loss,$-9.00,$-61.50,$220791.50,366,$-61.50
2025-05-28,08:31:00,21427.25,SELL,3,0.02h,Stop Loss,$4.50,$-57.00,$220796.00,366,$-57.00
2025-05-28,08:36:00,21434.75,BUY,3,0.02h,Break Even,$-1.50,$-58.50,$220794.50,366,$-58.50
2025-05-28,08:49:00,21428.5,SELL,3,0.02h,Break Even,$-1.50,$-60.00,$220793.00,366,$-60.00
2025-05-28,09:08:00,21430.75,BUY,3,0.02h,Stop Loss,$-9.00,$-69.00,$220784.00,366,$-69.00
2025-05-28,09:10:00,21423.0,SELL,3,0.02h,Break Even,$-1.50,$-70.50,$220782.50,366,$-70.50
2025-05-28,09:20:00,21428.25,BUY,3,0.02h,Break Even,$-1.50,$-72.00,$220781.00,366,$-72.00
2025-05-28,09:23:00,21419.25,SELL,3,0.02h,Stop Loss,$49.50,$-22.50,$220830.50,366,$-22.50
2025-05-28,09:41:00,21422.5,BUY,3,0.02h,Stop Loss,$-9.00,$-31.50,$220821.50,366,$-31.50
2025-05-28,09:42:00,21414.0,SELL,3,0.02h,Stop Loss,$-9.00,$-40.50,$220812.50,366,$-40.50
2025-05-28,09:50:00,21420.5,BUY,3,0.02h,Stop Loss,$-9.00,$-49.50,$220803.50,366,$-49.50
2025-05-28,11:09:00,21497.5,SELL,3,0.02h,Stop Loss,$-9.00,$-58.50,$220794.50,366,$-58.50
2025-05-28,11:32:00,21509.0,BUY,3,0.02h,Break Even,$-1.50,$-60.00,$220793.00,366,$-60.00
2025-05-28,11:44:00,21492.25,SELL,3,0.02h,Break Even,$-1.50,$-61.50,$220791.50,366,$-61.50
2025-05-28,11:55:00,21500.75,BUY,3,0.02h,Break Even,$-1.50,$-63.00,$220790.00,366,$-63.00
2025-05-28,12:32:00,21507.0,SELL,3,0.02h,Stop Loss,$-9.00,$-72.00,$220781.00,366,$-72.00
2025-05-28,12:38:00,21520.25,BUY,3,0.02h,Stop Loss,$7.50,$-64.50,$220788.50,366,$-64.50
2025-05-28,12:52:00,21507.75,SELL,3,0.02h,Break Even,$-1.50,$-66.00,$220787.00,366,$-66.00
2025-05-28,13:14:00,21516.25,BUY,3,0.02h,Break Even,$-1.50,$-67.50,$220785.50,366,$-67.50
2025-05-28,13:18:00,21503.0,SELL,3,0.02h,Stop Loss,$-9.00,$-76.50,$220776.50,366,$-76.50
2025-05-28,13:34:00,21511.75,BUY,3,0.02h,Stop Loss,$67.50,$-9.00,$220844.00,366,$-9.00
2025-05-28,13:49:00,21491.5,SELL,3,0.02h,Stop Loss,$55.50,$46.50,$220899.50,366,$46.50
2025-05-28,15:05:00,21467.0,BUY,3,0.02h,Break Even,$-1.50,$45.00,$220898.00,366,$45.00
2025-05-28,15:15:00,21438.25,SELL,3,0.02h,Stop Loss,$-9.00,$36.00,$220889.00,366,$36.00
2025-05-28,15:18:00,21454.0,BUY,3,0.02h,Stop Loss,$21.00,$57.00,$220910.00,366,$57.00
2025-05-28,15:35:00,21451.75,SELL,3,0.02h,Stop Loss,$6.00,$63.00,$220916.00,366,$63.00
2025-05-28,15:54:00,21461.75,BUY,3,0.02h,Break Even,$-1.50,$61.50,$220914.50,366,$61.50
2025-05-28,15:57:00,21447.0,SELL,3,0.02h,Break Even,$-1.50,$60.00,$220913.00,366,$60.00
2025-05-28,16:04:00,21462.25,BUY,3,0.02h,Break Even,$-1.50,$58.50,$220911.50,366,$58.50
2025-05-28,16:47:00,21467.75,SELL,3,0.02h,Stop Loss,$-9.00,$49.50,$220902.50,366,$49.50
2025-05-28,16:48:00,21474.0,BUY,3,0.02h,Stop Loss,$-9.00,$40.50,$220893.50,366,$40.50
2025-05-28,16:53:00,21458.0,SELL,3,0.02h,Stop Loss,$9.00,$49.50,$220902.50,366,$49.50
2025-05-28,17:04:00,21475.75,BUY,3,0.02h,Break Even,$-1.50,$48.00,$220901.00,366,$48.00
2025-05-28,17:27:00,21469.5,SELL,3,0.02h,Break Even,$-1.50,$46.50,$220899.50,366,$46.50
2025-05-28,17:56:00,21476.25,BUY,3,0.02h,Break Even,$-1.50,$45.00,$220898.00,366,$45.00
2025-05-28,18:21:00,21473.25,SELL,3,0.02h,Break Even,$-1.50,$43.50,$220896.50,366,$43.50
2025-05-28,18:34:00,21488.75,BUY,3,0.02h,Stop Loss,$-9.00,$34.50,$220887.50,366,$34.50
2025-05-28,18:50:00,21479.0,SELL,3,0.02h,Stop Loss,$3.00,$37.50,$220890.50,366,$37.50
2025-05-28,19:04:00,21480.75,BUY,3,0.02h,Stop Loss,$13.50,$51.00,$220904.00,366,$51.00
2025-05-28,19:18:00,21460.25,SELL,3,0.02h,Break Even,$-1.50,$49.50,$220902.50,366,$49.50
2025-05-28,20:17:00,21393.75,BUY,3,0.02h,Break Even,$-1.50,$48.00,$220901.00,366,$48.00
,,,,,,,,,,,
2025-05-29,00:07:00,21725.25,SELL,3,0.02h,Stop Loss,$25.50,$25.50,$220926.50,367,$25.50
2025-05-29,00:19:00,21754.75,BUY,3,0.02h,Stop Loss,$3.00,$28.50,$220929.50,367,$28.50
2025-05-29,01:10:00,21783.75,SELL,3,0.02h,Break Even,$-1.50,$27.00,$220928.00,367,$27.00
2025-05-29,01:45:00,21781.0,BUY,3,0.02h,Stop Loss,$-9.00,$18.00,$220919.00,367,$18.00
2025-05-29,01:49:00,21767.25,SELL,3,0.02h,Stop Loss,$-9.00,$9.00,$220910.00,367,$9.00
2025-05-29,01:51:00,21778.0,BUY,3,0.02h,Stop Loss,$60.00,$69.00,$220970.00,367,$69.00
2025-05-29,02:56:00,21799.0,SELL,3,0.02h,Stop Loss,$9.00,$78.00,$220979.00,367,$78.00
2025-05-29,03:14:00,21810.25,BUY,3,0.02h,Stop Loss,$-9.00,$69.00,$220970.00,367,$69.00
2025-05-29,03:26:00,21794.25,SELL,3,0.02h,Break Even,$-1.50,$67.50,$220968.50,367,$67.50
2025-05-29,03:39:00,21799.75,BUY,3,0.02h,Stop Loss,$-9.00,$58.50,$220959.50,367,$58.50
2025-05-29,03:40:00,21793.0,SELL,3,0.02h,Break Even,$-1.50,$57.00,$220958.00,367,$57.00
2025-05-29,04:05:00,21793.75,BUY,3,0.02h,Stop Loss,$-9.00,$48.00,$220949.00,367,$48.00
2025-05-29,04:20:00,21789.5,SELL,3,0.02h,Break Even,$-1.50,$46.50,$220947.50,367,$46.50
2025-05-29,04:43:00,21790.25,BUY,3,0.02h,Break Even,$-1.50,$45.00,$220946.00,367,$45.00
2025-05-29,05:07:00,21792.75,SELL,3,0.02h,Stop Loss,$-9.00,$36.00,$220937.00,367,$36.00
2025-05-29,05:09:00,21799.25,BUY,3,0.02h,Stop Loss,$-9.00,$27.00,$220928.00,367,$27.00
2025-05-29,05:13:00,21794.25,SELL,3,0.02h,Stop Loss,$-9.00,$18.00,$220919.00,367,$18.00
2025-05-29,05:16:00,21799.25,BUY,3,0.02h,Stop Loss,$-9.00,$9.00,$220910.00,367,$9.00
2025-05-29,05:59:00,21802.0,SELL,3,0.02h,Stop Loss,$-9.00,$0.00,$220901.00,367,$0.00
2025-05-29,07:25:00,21778.25,BUY,3,0.02h,Break Even,$-1.50,$-1.50,$220899.50,367,$-1.50
2025-05-29,08:15:00,21822.75,SELL,3,0.02h,Break Even,$-1.50,$-3.00,$220898.00,367,$-3.00
2025-05-29,09:06:00,21790.0,BUY,3,0.02h,Stop Loss,$9.00,$6.00,$220907.00,367,$6.00
2025-05-29,09:21:00,21791.0,SELL,3,0.02h,Stop Loss,$19.50,$25.50,$220926.50,367,$25.50
2025-05-29,09:25:00,21798.0,BUY,3,0.02h,Break Even,$-1.50,$24.00,$220925.00,367,$24.00
2025-05-29,09:27:00,21791.25,SELL,3,0.02h,Stop Loss,$-9.00,$15.00,$220916.00,367,$15.00
2025-05-29,09:31:00,21807.0,BUY,3,0.02h,Break Even,$-1.50,$13.50,$220914.50,367,$13.50
2025-05-29,09:59:00,21789.5,SELL,3,0.02h,Stop Loss,$16.50,$30.00,$220931.00,367,$30.00
2025-05-29,11:19:00,21732.5,BUY,3,0.02h,Stop Loss,$-9.00,$21.00,$220922.00,367,$21.00
2025-05-29,11:23:00,21714.0,SELL,3,0.02h,Break Even,$-1.50,$19.50,$220920.50,367,$19.50
2025-05-29,12:27:00,21659.75,BUY,3,0.02h,Stop Loss,$4.50,$24.00,$220925.00,367,$24.00
2025-05-29,12:41:00,21643.0,SELL,3,0.02h,Stop Loss,$36.00,$60.00,$220961.00,367,$60.00
2025-05-29,12:54:00,21660.75,BUY,3,0.02h,Stop Loss,$9.00,$69.00,$220970.00,367,$69.00
2025-05-29,12:58:00,21646.5,SELL,3,0.02h,Stop Loss,$16.50,$85.50,$220986.50,367,$85.50
2025-05-29,13:06:00,21655.5,BUY,3,0.02h,Stop Loss,$42.00,$127.50,$221028.50,367,$127.50
2025-05-29,13:31:00,21649.5,SELL,3,0.02h,Stop Loss,$204.00,$331.50,$221232.50,367,$331.50
2025-05-29,14:31:00,21457.0,BUY,3,0.02h,Stop Loss,$75.00,$406.50,$221307.50,367,$406.50
2025-05-29,15:14:00,21477.0,SELL,3,0.02h,Stop Loss,$87.00,$493.50,$221394.50,367,$493.50
2025-05-29,15:27:00,21497.0,BUY,3,0.02h,Break Even,$-1.50,$492.00,$221393.00,367,$492.00
2025-05-29,15:33:00,21447.25,SELL,3,0.02h,Stop Loss,$37.50,$529.50,$221430.50,367,$529.50
2025-05-29,16:16:00,21416.75,BUY,3,0.02h,Stop Loss,$34.50,$564.00,$221465.00,367,$564.00
2025-05-29,17:16:00,21440.75,SELL,3,0.02h,Stop Loss,$4.50,$568.50,$221469.50,367,$568.50
2025-05-29,18:14:00,21400.5,BUY,3,0.02h,Stop Loss,$4.50,$573.00,$221474.00,367,$573.00
2025-05-29,18:17:00,21380.25,SELL,3,0.02h,Stop Loss,$48.00,$621.00,$221522.00,367,$621.00
2025-05-29,18:37:00,21380.0,BUY,3,0.02h,Break Even,$-1.50,$619.50,$221520.50,367,$619.50
2025-05-29,19:00:00,21362.75,SELL,3,0.02h,Stop Loss,$15.00,$634.50,$221535.50,367,$634.50
2025-05-29,19:05:00,21382.0,BUY,3,0.02h,Break Even,$-1.50,$633.00,$221534.00,367,$633.00
2025-05-29,19:07:00,21356.0,SELL,3,0.02h,Stop Loss,$51.00,$684.00,$221585.00,367,$684.00
2025-05-29,19:21:00,21385.5,BUY,3,0.02h,Stop Loss,$33.00,$717.00,$221618.00,367,$717.00
2025-05-29,20:06:00,21376.5,SELL,3,0.02h,Stop Loss,$18.00,$735.00,$221636.00,367,$735.00
2025-05-29,20:20:00,21405.0,BUY,3,0.02h,Break Even,$-1.50,$733.50,$221634.50,367,$733.50
2025-05-29,20:44:00,21396.0,SELL,3,0.02h,Stop Loss,$-9.00,$724.50,$221625.50,367,$724.50
2025-05-29,23:27:00,21367.25,BUY,3,0.02h,Stop Loss,$-9.00,$715.50,$221616.50,367,$715.50
2025-05-29,23:28:00,21361.25,SELL,3,0.02h,Stop Loss,$3.00,$718.50,$221619.50,367,$718.50
,,,,,,,,,,,
2025-05-30,00:06:00,21339.0,BUY,3,0.02h,Stop Loss,$10.50,$10.50,$221630.00,368,$10.50
2025-05-30,00:33:00,21337.75,SELL,3,0.02h,Break Even,$-1.50,$9.00,$221628.50,368,$9.00
2025-05-30,00:44:00,21350.75,BUY,3,0.02h,Break Even,$-1.50,$7.50,$221627.00,368,$7.50
2025-05-30,00:50:00,21334.0,SELL,3,0.02h,Stop Loss,$-9.00,$-1.50,$221618.00,368,$-1.50
2025-05-30,01:02:00,21346.5,BUY,3,0.02h,Stop Loss,$-9.00,$-10.50,$221609.00,368,$-10.50
2025-05-30,01:05:00,21309.75,SELL,3,0.02h,Stop Loss,$228.00,$217.50,$221837.00,368,$217.50
2025-05-30,01:30:00,21325.5,BUY,3,0.02h,Stop Loss,$24.00,$241.50,$221861.00,368,$241.50
2025-05-30,02:32:00,21341.5,SELL,3,0.02h,Stop Loss,$-9.00,$232.50,$221852.00,368,$232.50
2025-05-30,02:33:00,21345.25,BUY,3,0.02h,Stop Loss,$3.00,$235.50,$221855.00,368,$235.50
2025-05-30,03:17:00,21344.5,SELL,3,0.02h,Stop Loss,$12.00,$247.50,$221867.00,368,$247.50
2025-05-30,03:52:00,21347.25,BUY,3,0.02h,Stop Loss,$-9.00,$238.50,$221858.00,368,$238.50
2025-05-30,03:58:00,21339.75,SELL,3,0.02h,Stop Loss,$-9.00,$229.50,$221849.00,368,$229.50
2025-05-30,04:00:00,21346.25,BUY,3,0.02h,Stop Loss,$6.00,$235.50,$221855.00,368,$235.50
2025-05-30,04:02:00,21339.75,SELL,3,0.02h,Stop Loss,$-9.00,$226.50,$221846.00,368,$226.50
2025-05-30,04:07:00,21349.0,BUY,3,0.02h,Break Even,$-1.50,$225.00,$221844.50,368,$225.00
2025-05-30,04:31:00,21347.5,SELL,3,0.02h,Break Even,$-1.50,$223.50,$221843.00,368,$223.50
2025-05-30,04:57:00,21344.5,BUY,3,0.02h,Stop Loss,$9.00,$232.50,$221852.00,368,$232.50
2025-05-30,05:55:00,21385.75,SELL,3,0.02h,Stop Loss,$-9.00,$223.50,$221843.00,368,$223.50
2025-05-30,07:06:00,21353.75,BUY,3,0.02h,Break Even,$-1.50,$222.00,$221841.50,368,$222.00
2025-05-30,07:09:00,21326.25,SELL,3,0.02h,Stop Loss,$21.00,$243.00,$221862.50,368,$243.00
2025-05-30,07:20:00,21345.0,BUY,3,0.02h,Stop Loss,$57.00,$300.00,$221919.50,368,$300.00
2025-05-30,07:53:00,21355.0,SELL,3,0.02h,Stop Loss,$13.50,$313.50,$221933.00,368,$313.50
2025-05-30,08:01:00,21371.75,BUY,3,0.02h,Stop Loss,$16.50,$330.00,$221949.50,368,$330.00
2025-05-30,08:29:00,21373.25,SELL,3,0.02h,Stop Loss,$15.00,$345.00,$221964.50,368,$345.00
2025-05-30,08:48:00,21381.5,BUY,3,0.02h,Break Even,$-1.50,$343.50,$221963.00,368,$343.50
2025-05-30,08:58:00,21361.75,SELL,3,0.02h,Break Even,$-1.50,$342.00,$221961.50,368,$342.00
2025-05-30,09:05:00,21376.0,BUY,3,0.02h,Stop Loss,$-9.00,$333.00,$221952.50,368,$333.00
2025-05-30,09:13:00,21369.0,SELL,3,0.02h,Stop Loss,$-9.00,$324.00,$221943.50,368,$324.00
2025-05-30,09:14:00,21372.75,BUY,3,0.02h,Stop Loss,$-9.00,$315.00,$221934.50,368,$315.00
2025-05-30,09:15:00,21368.75,SELL,3,0.02h,Break Even,$-1.50,$313.50,$221933.00,368,$313.50
2025-05-30,09:18:00,21375.0,BUY,3,0.02h,Stop Loss,$49.50,$363.00,$221982.50,368,$363.00
2025-05-30,09:42:00,21378.75,SELL,3,0.02h,Stop Loss,$9.00,$372.00,$221991.50,368,$372.00
2025-05-30,10:07:00,21380.5,BUY,3,0.02h,Stop Loss,$-9.00,$363.00,$221982.50,368,$363.00
2025-05-30,10:14:00,21354.75,SELL,3,0.02h,Break Even,$-1.50,$361.50,$221981.00,368,$361.50
2025-05-30,10:25:00,21374.0,BUY,3,0.02h,Stop Loss,$-9.00,$352.50,$221972.00,368,$352.50
2025-05-30,10:55:00,21373.5,SELL,3,0.02h,Break Even,$-1.50,$351.00,$221970.50,368,$351.00
2025-05-30,11:01:00,21384.25,BUY,3,0.02h,Break Even,$-1.50,$349.50,$221969.00,368,$349.50
2025-05-30,11:28:00,21397.5,SELL,3,0.02h,Break Even,$-1.50,$348.00,$221967.50,368,$348.00
2025-05-30,11:53:00,21397.25,BUY,3,0.02h,Stop Loss,$3.00,$351.00,$221970.50,368,$351.00
2025-05-30,11:58:00,21390.25,SELL,3,0.02h,Stop Loss,$3.00,$354.00,$221973.50,368,$354.00
2025-05-30,12:03:00,21404.25,BUY,3,0.02h,Stop Loss,$13.50,$367.50,$221987.00,368,$367.50
2025-05-30,12:11:00,21303.5,SELL,3,0.02h,Stop Loss,$444.00,$811.50,$222431.00,368,$811.50
2025-05-30,12:35:00,21351.0,BUY,3,0.02h,Stop Loss,$30.00,$841.50,$222461.00,368,$841.50
2025-05-30,12:59:00,21335.75,SELL,3,0.02h,Break Even,$-1.50,$840.00,$222459.50,368,$840.00
2025-05-30,13:17:00,21360.25,BUY,3,0.02h,Break Even,$-1.50,$838.50,$222458.00,368,$838.50
2025-05-30,13:34:00,21337.0,SELL,3,0.02h,Stop Loss,$33.00,$871.50,$222491.00,368,$871.50
2025-05-30,14:05:00,21322.75,BUY,3,0.02h,Stop Loss,$118.50,$990.00,$222609.50,368,$990.00
2025-05-30,14:52:00,21369.0,SELL,3,0.02h,Stop Loss,$70.50,$1060.50,$222680.00,368,$1060.50
2025-05-30,15:28:00,21368.0,BUY,3,0.02h,Break Even,$-1.50,$1059.00,$222678.50,368,$1059.00
2025-05-30,15:35:00,21326.25,SELL,3,0.02h,Stop Loss,$42.00,$1101.00,$222720.50,368,$1101.00
2025-05-30,15:56:00,21344.0,BUY,3,0.02h,Break Even,$-1.50,$1099.50,$222719.00,368,$1099.50
2025-05-30,16:02:00,21305.0,SELL,3,0.02h,Stop Loss,$30.00,$1129.50,$222749.00,368,$1129.50
2025-05-30,16:10:00,21334.25,BUY,3,0.02h,Break Even,$-1.50,$1128.00,$222747.50,368,$1128.00
2025-05-30,16:17:00,21293.75,SELL,3,0.02h,Stop Loss,$97.50,$1225.50,$222845.00,368,$1225.50
2025-05-30,17:06:00,21143.25,BUY,3,0.02h,Stop Loss,$82.50,$1308.00,$222927.50,368,$1308.00
2025-05-30,19:46:00,21358.5,SELL,3,0.02h,Stop Loss,$57.00,$1365.00,$222984.50,368,$1365.00
2025-05-30,19:49:00,21382.25,BUY,3,0.02h,Stop Loss,$13.50,$1378.50,$222998.00,368,$1378.50
2025-05-30,20:04:00,21344.25,SELL,3,0.02h,Stop Loss,$-9.00,$1369.50,$222989.00,368,$1369.50
2025-05-30,20:21:00,21377.75,BUY,3,0.02h,Stop Loss,$12.00,$1381.50,$223001.00,368,$1381.50
2025-05-30,20:26:00,21359.25,SELL,3,0.02h,Stop Loss,$13.50,$1395.00,$223014.50,368,$1395.00
2025-05-30,20:58:00,21363.75,BUY,3,0.02h,Stop Loss,$7.50,$1402.50,$223022.00,368,$1402.50
,,,,,,,,,,,
2025-06-02,00:00:00,21303.5,SELL,3,0.02h,Stop Loss,$7.50,$7.50,$223029.50,369,$7.50
2025-06-02,01:04:00,21299.75,BUY,3,0.02h,Stop Loss,$-9.00,$-1.50,$223020.50,369,$-1.50
2025-06-02,01:30:00,21296.75,SELL,3,0.02h,Stop Loss,$16.50,$15.00,$223037.00,369,$15.00
2025-06-02,02:29:00,21270.75,BUY,3,0.02h,Break Even,$-1.50,$13.50,$223035.50,369,$13.50
2025-06-02,02:30:00,21268.0,SELL,3,0.02h,Stop Loss,$-9.00,$4.50,$223026.50,369,$4.50
2025-06-02,02:36:00,21270.5,BUY,3,0.02h,Break Even,$-1.50,$3.00,$223025.00,369,$3.00
2025-06-02,02:53:00,21266.75,SELL,3,0.02h,Stop Loss,$-9.00,$-6.00,$223016.00,369,$-6.00
2025-06-02,04:12:00,21238.5,BUY,3,0.02h,Break Even,$-1.50,$-7.50,$223014.50,369,$-7.50
2025-06-02,04:39:00,21244.0,SELL,3,0.03h,Break Even,$-1.50,$-9.00,$223013.00,369,$-9.00
2025-06-02,05:10:00,21246.75,BUY,3,0.02h,Break Even,$-1.50,$-10.50,$223011.50,369,$-10.50
2025-06-02,05:21:00,21235.25,SELL,3,0.02h,Break Even,$-1.50,$-12.00,$223010.00,369,$-12.00
2025-06-02,05:45:00,21232.5,BUY,3,0.02h,Break Even,$-1.50,$-13.50,$223008.50,369,$-13.50
2025-06-02,05:58:00,21223.25,SELL,3,0.02h,Stop Loss,$-9.00,$-22.50,$222999.50,369,$-22.50
2025-06-02,06:22:00,21227.0,BUY,3,0.02h,Stop Loss,$-9.00,$-31.50,$222990.50,369,$-31.50
2025-06-02,06:26:00,21218.5,SELL,3,0.02h,Stop Loss,$-9.00,$-40.50,$222981.50,369,$-40.50
2025-06-02,06:27:00,21223.25,BUY,3,0.02h,Stop Loss,$6.00,$-34.50,$222987.50,369,$-34.50
2025-06-02,06:57:00,21229.25,SELL,3,0.02h,Break Even,$-1.50,$-36.00,$222986.00,369,$-36.00
2025-06-02,07:03:00,21244.75,BUY,3,0.02h,Stop Loss,$34.50,$-1.50,$223020.50,369,$-1.50
2025-06-02,07:24:00,21238.5,SELL,3,0.02h,Stop Loss,$18.00,$16.50,$223038.50,369,$16.50
2025-06-02,07:52:00,21229.0,BUY,3,0.02h,Break Even,$-1.50,$15.00,$223037.00,369,$15.00
2025-06-02,07:57:00,21212.5,SELL,3,0.02h,Stop Loss,$-9.00,$6.00,$223028.00,369,$6.00
2025-06-02,08:03:00,21229.5,BUY,3,0.02h,Stop Loss,$-9.00,$-3.00,$223019.00,369,$-3.00
2025-06-02,08:22:00,21231.5,SELL,3,0.02h,Stop Loss,$-9.00,$-12.00,$223010.00,369,$-12.00
2025-06-02,08:23:00,21240.5,BUY,3,0.02h,Stop Loss,$16.50,$4.50,$223026.50,369,$4.50
2025-06-02,08:43:00,21235.25,SELL,3,0.02h,Break Even,$-1.50,$3.00,$223025.00,369,$3.00
2025-06-02,09:26:00,21227.5,BUY,3,0.02h,Break Even,$-1.50,$1.50,$223023.50,369,$1.50
2025-06-02,09:29:00,21221.25,SELL,3,0.02h,Stop Loss,$-9.00,$-7.50,$223014.50,369,$-7.50
2025-06-02,09:30:00,21227.75,BUY,3,0.02h,Break Even,$-1.50,$-9.00,$223013.00,369,$-9.00
2025-06-02,09:44:00,21217.5,SELL,3,0.02h,Stop Loss,$36.00,$27.00,$223049.00,369,$27.00
2025-06-02,10:00:00,21225.25,BUY,3,0.02h,Break Even,$-1.50,$25.50,$223047.50,369,$25.50
2025-06-02,10:23:00,21222.25,SELL,3,0.02h,Stop Loss,$7.50,$33.00,$223055.00,369,$33.00
2025-06-02,10:40:00,21235.75,BUY,3,0.02h,Stop Loss,$24.00,$57.00,$223079.00,369,$57.00
2025-06-02,11:45:00,21267.5,SELL,3,0.02h,Stop Loss,$-9.00,$48.00,$223070.00,369,$48.00
2025-06-02,12:09:00,21276.0,BUY,3,0.02h,Break Even,$-1.50,$46.50,$223068.50,369,$46.50
2025-06-02,12:21:00,21251.25,SELL,3,0.02h,Break Even,$-1.50,$45.00,$223067.00,369,$45.00
2025-06-02,12:40:00,21260.25,BUY,3,0.02h,Stop Loss,$66.00,$111.00,$223133.00,369,$111.00
2025-06-02,12:56:00,21267.0,SELL,3,0.02h,Break Even,$-1.50,$109.50,$223131.50,369,$109.50
2025-06-02,12:58:00,21278.25,BUY,3,0.02h,Stop Loss,$10.50,$120.00,$223142.00,369,$120.00
2025-06-02,13:07:00,21266.75,SELL,3,0.02h,Stop Loss,$9.00,$129.00,$223151.00,369,$129.00
2025-06-02,13:27:00,21280.5,BUY,3,0.02h,Stop Loss,$18.00,$147.00,$223169.00,369,$147.00
2025-06-02,13:53:00,21325.0,SELL,3,0.02h,Stop Loss,$82.50,$229.50,$223251.50,369,$229.50
2025-06-02,14:19:00,21323.5,BUY,3,0.02h,Stop Loss,$76.50,$306.00,$223328.00,369,$306.00
2025-06-02,15:11:00,21369.75,SELL,3,0.02h,Stop Loss,$-9.00,$297.00,$223319.00,369,$297.00
2025-06-02,15:14:00,21404.5,BUY,3,0.02h,Stop Loss,$-9.00,$288.00,$223310.00,369,$288.00
2025-06-02,15:27:00,21368.5,SELL,3,0.02h,Stop Loss,$16.50,$304.50,$223326.50,369,$304.50
2025-06-02,15:42:00,21388.0,BUY,3,0.02h,Stop Loss,$10.50,$315.00,$223337.00,369,$315.00
2025-06-02,16:28:00,21415.25,SELL,3,0.02h,Stop Loss,$3.00,$318.00,$223340.00,369,$318.00
2025-06-02,16:35:00,21432.75,BUY,3,0.02h,Stop Loss,$18.00,$336.00,$223358.00,369,$336.00
2025-06-02,16:37:00,21420.0,SELL,3,0.02h,Break Even,$-1.50,$334.50,$223356.50,369,$334.50
2025-06-02,16:39:00,21435.75,BUY,3,0.02h,Stop Loss,$-9.00,$325.50,$223347.50,369,$325.50
2025-06-02,16:42:00,21425.25,SELL,3,0.02h,Stop Loss,$25.50,$351.00,$223373.00,369,$351.00
2025-06-02,16:54:00,21439.25,BUY,3,0.02h,Stop Loss,$70.50,$421.50,$223443.50,369,$421.50
2025-06-02,17:23:00,21442.0,SELL,3,0.02h,Stop Loss,$-9.00,$412.50,$223434.50,369,$412.50
2025-06-02,18:00:00,21445.5,BUY,3,0.02h,Break Even,$-1.50,$411.00,$223433.00,369,$411.00
2025-06-02,19:20:00,21512.0,SELL,3,0.02h,Stop Loss,$18.00,$429.00,$223451.00,369,$429.00
2025-06-02,19:22:00,21519.75,BUY,3,0.02h,Stop Loss,$15.00,$444.00,$223466.00,369,$444.00
2025-06-02,19:36:00,21515.25,SELL,3,0.02h,Break Even,$-1.50,$442.50,$223464.50,369,$442.50
2025-06-02,19:52:00,21524.75,BUY,3,0.02h,Stop Loss,$-9.00,$433.50,$223455.50,369,$433.50
2025-06-02,19:53:00,21511.25,SELL,3,0.02h,Stop Loss,$34.50,$468.00,$223490.00,369,$468.00
2025-06-02,19:59:00,21525.5,BUY,3,0.02h,Stop Loss,$66.00,$534.00,$223556.00,369,$534.00
2025-06-02,20:35:00,21555.75,SELL,3,0.02h,Break Even,$-1.50,$532.50,$223554.50,369,$532.50
2025-06-02,23:31:00,21525.0,BUY,3,0.02h,Stop Loss,$-9.00,$523.50,$223545.50,369,$523.50
2025-06-02,23:32:00,21520.75,SELL,3,0.02h,Break Even,$-1.50,$522.00,$223544.00,369,$522.00
,,,,,,,,,,,
2025-06-03,00:46:00,21488.75,BUY,3,0.02h,Break Even,$-1.50,$-1.50,$223542.50,370,$-1.50
2025-06-03,00:47:00,21487.0,SELL,3,0.02h,Stop Loss,$-9.00,$-10.50,$223533.50,370,$-10.50
2025-06-03,00:48:00,21489.0,BUY,3,0.02h,Stop Loss,$-9.00,$-19.50,$223524.50,370,$-19.50
2025-06-03,00:49:00,21487.0,SELL,3,0.02h,Break Even,$-1.50,$-21.00,$223523.00,370,$-21.00
2025-06-03,01:08:00,21486.75,BUY,3,0.02h,Stop Loss,$-9.00,$-30.00,$223514.00,370,$-30.00
2025-06-03,01:34:00,21486.5,SELL,3,0.02h,Break Even,$-1.50,$-31.50,$223512.50,370,$-31.50
2025-06-03,01:45:00,21496.25,BUY,3,0.02h,Stop Loss,$-9.00,$-40.50,$223503.50,370,$-40.50
2025-06-03,01:57:00,21488.25,SELL,3,0.02h,Break Even,$-1.50,$-42.00,$223502.00,370,$-42.00
2025-06-03,02:39:00,21469.75,BUY,3,0.02h,Stop Loss,$-9.00,$-51.00,$223493.00,370,$-51.00
2025-06-03,03:06:00,21463.0,SELL,3,0.02h,Break Even,$-1.50,$-52.50,$223491.50,370,$-52.50
2025-06-03,03:39:00,21454.5,BUY,3,0.02h,Break Even,$-1.50,$-54.00,$223490.00,370,$-54.00
2025-06-03,04:06:00,21456.5,SELL,3,0.02h,Stop Loss,$-9.00,$-63.00,$223481.00,370,$-63.00
2025-06-03,04:47:00,21456.0,BUY,3,0.02h,Break Even,$-1.50,$-64.50,$223479.50,370,$-64.50
2025-06-03,04:54:00,21446.75,SELL,3,0.02h,Stop Loss,$-9.00,$-73.50,$223470.50,370,$-73.50
2025-06-03,05:02:00,21458.0,BUY,3,0.02h,Stop Loss,$3.00,$-70.50,$223473.50,370,$-70.50
2025-06-03,05:28:00,21458.5,SELL,3,0.02h,Stop Loss,$-9.00,$-79.50,$223464.50,370,$-79.50
2025-06-03,05:31:00,21467.25,BUY,3,0.02h,Stop Loss,$12.00,$-67.50,$223476.50,370,$-67.50
2025-06-03,05:36:00,21456.5,SELL,3,0.02h,Stop Loss,$-9.00,$-76.50,$223467.50,370,$-76.50
2025-06-03,05:49:00,21463.5,BUY,3,0.02h,Stop Loss,$-9.00,$-85.50,$223458.50,370,$-85.50
2025-06-03,06:06:00,21457.75,SELL,3,0.02h,Stop Loss,$-9.00,$-94.50,$223449.50,370,$-94.50
2025-06-03,06:26:00,21459.0,BUY,3,0.02h,Stop Loss,$6.00,$-88.50,$223455.50,370,$-88.50
2025-06-03,06:31:00,21449.0,SELL,3,0.02h,Stop Loss,$-9.00,$-97.50,$223446.50,370,$-97.50
2025-06-03,06:32:00,21454.0,BUY,3,0.02h,Break Even,$-1.50,$-99.00,$223445.00,370,$-99.00
2025-06-03,07:13:00,21462.75,SELL,3,0.02h,Break Even,$-1.50,$-100.50,$223443.50,370,$-100.50
2025-06-03,07:37:00,21442.5,BUY,3,0.02h,Break Even,$-1.50,$-102.00,$223442.00,370,$-102.00
2025-06-03,07:45:00,21427.0,SELL,3,0.02h,Break Even,$-1.50,$-103.50,$223440.50,370,$-103.50
2025-06-03,08:00:00,21439.0,BUY,3,0.02h,Break Even,$-1.50,$-105.00,$223439.00,370,$-105.00
2025-06-03,08:07:00,21433.0,SELL,3,0.02h,Break Even,$-1.50,$-106.50,$223437.50,370,$-106.50
2025-06-03,08:35:00,21424.0,BUY,3,0.02h,Stop Loss,$28.50,$-78.00,$223466.00,370,$-78.00
2025-06-03,09:23:00,21435.75,SELL,3,0.02h,Stop Loss,$-9.00,$-87.00,$223457.00,370,$-87.00
2025-06-03,09:26:00,21451.75,BUY,3,0.02h,Break Even,$-1.50,$-88.50,$223455.50,370,$-88.50
2025-06-03,09:57:00,21448.0,SELL,3,0.02h,Stop Loss,$-9.00,$-97.50,$223446.50,370,$-97.50
2025-06-03,10:02:00,21460.75,BUY,3,0.02h,Break Even,$-1.50,$-99.00,$223445.00,370,$-99.00
2025-06-03,10:04:00,21449.25,SELL,3,0.02h,Break Even,$-1.50,$-100.50,$223443.50,370,$-100.50
2025-06-03,10:29:00,21455.75,BUY,3,0.02h,Break Even,$-1.50,$-102.00,$223442.00,370,$-102.00
2025-06-03,12:09:00,21519.5,SELL,3,0.02h,Stop Loss,$25.50,$-76.50,$223467.50,370,$-76.50
2025-06-03,12:13:00,21525.0,BUY,3,0.02h,Break Even,$-1.50,$-78.00,$223466.00,370,$-78.00
2025-06-03,12:19:00,21517.0,SELL,3,0.02h,Stop Loss,$-9.00,$-87.00,$223457.00,370,$-87.00
2025-06-03,12:25:00,21527.25,BUY,3,0.02h,Break Even,$-1.50,$-88.50,$223455.50,370,$-88.50
2025-06-03,12:38:00,21515.0,SELL,3,0.02h,Break Even,$-1.50,$-90.00,$223454.00,370,$-90.00
2025-06-03,12:57:00,21528.75,BUY,3,0.02h,Break Even,$-1.50,$-91.50,$223452.50,370,$-91.50
2025-06-03,13:37:00,21537.25,SELL,3,0.02h,Stop Loss,$28.50,$-63.00,$223481.00,370,$-63.00
2025-06-03,13:43:00,21569.75,BUY,3,0.02h,Break Even,$-1.50,$-64.50,$223479.50,370,$-64.50
2025-06-03,14:35:00,21597.0,SELL,3,0.02h,Stop Loss,$57.00,$-7.50,$223536.50,370,$-7.50
2025-06-03,14:41:00,21609.25,BUY,3,0.02h,Break Even,$-1.50,$-9.00,$223535.00,370,$-9.00
2025-06-03,15:39:00,21663.75,SELL,3,0.02h,Stop Loss,$-9.00,$-18.00,$223526.00,370,$-18.00
2025-06-03,15:40:00,21671.25,BUY,3,0.02h,Break Even,$-1.50,$-19.50,$223524.50,370,$-19.50
2025-06-03,15:51:00,21662.5,SELL,3,0.02h,Stop Loss,$12.00,$-7.50,$223536.50,370,$-7.50
2025-06-03,15:56:00,21674.75,BUY,3,0.02h,Stop Loss,$19.50,$12.00,$223556.00,370,$12.00
2025-06-03,17:32:00,21743.0,SELL,3,0.02h,Break Even,$-1.50,$10.50,$223554.50,370,$10.50
2025-06-03,18:27:00,21686.0,BUY,3,0.02h,Stop Loss,$60.00,$70.50,$223614.50,370,$70.50
2025-06-03,19:12:00,21696.5,SELL,3,0.02h,Stop Loss,$-9.00,$61.50,$223605.50,370,$61.50
2025-06-03,19:19:00,21710.0,BUY,3,0.02h,Break Even,$-1.50,$60.00,$223604.00,370,$60.00
2025-06-03,19:41:00,21700.25,SELL,3,0.02h,Stop Loss,$7.50,$67.50,$223611.50,370,$67.50
2025-06-03,19:57:00,21714.75,BUY,3,0.02h,Stop Loss,$46.50,$114.00,$223658.00,370,$114.00
2025-06-03,20:02:00,21684.5,SELL,3,0.02h,Stop Loss,$12.00,$126.00,$223670.00,370,$126.00
2025-06-03,20:38:00,21683.0,BUY,3,0.02h,Break Even,$-1.50,$124.50,$223668.50,370,$124.50
2025-06-03,23:34:00,21700.5,SELL,3,0.02h,Break Even,$-1.50,$123.00,$223667.00,370,$123.00
,,,,,,,,,,,
2025-06-04,00:03:00,21718.5,BUY,3,0.02h,Stop Loss,$30.00,$30.00,$223697.00,371,$30.00
2025-06-04,00:13:00,21697.75,SELL,3,0.02h,Break Even,$-1.50,$28.50,$223695.50,371,$28.50
2025-06-04,00:34:00,21708.25,BUY,3,0.02h,Stop Loss,$10.50,$39.00,$223706.00,371,$39.00
2025-06-04,00:58:00,21702.25,SELL,3,0.02h,Break Even,$-1.50,$37.50,$223704.50,371,$37.50
2025-06-04,01:17:00,21710.75,BUY,3,0.02h,Stop Loss,$-9.00,$28.50,$223695.50,371,$28.50
2025-06-04,01:19:00,21701.5,SELL,3,0.02h,Stop Loss,$-9.00,$19.50,$223686.50,371,$19.50
2025-06-04,01:29:00,21708.75,BUY,3,0.02h,Stop Loss,$-9.00,$10.50,$223677.50,371,$10.50
2025-06-04,01:31:00,21699.0,SELL,3,0.02h,Break Even,$-1.50,$9.00,$223676.00,371,$9.00
2025-06-04,02:31:00,21675.5,BUY,3,0.02h,Break Even,$-1.50,$7.50,$223674.50,371,$7.50
2025-06-04,02:55:00,21674.25,SELL,3,0.02h,Stop Loss,$-9.00,$-1.50,$223665.50,371,$-1.50
2025-06-04,03:08:00,21678.25,BUY,3,0.02h,Break Even,$-1.50,$-3.00,$223664.00,371,$-3.00
2025-06-04,03:12:00,21674.75,SELL,3,0.02h,Stop Loss,$-9.00,$-12.00,$223655.00,371,$-12.00
2025-06-04,03:13:00,21680.0,BUY,3,0.02h,Break Even,$-1.50,$-13.50,$223653.50,371,$-13.50
2025-06-04,03:24:00,21676.25,SELL,3,0.02h,Break Even,$-1.50,$-15.00,$223652.00,371,$-15.00
2025-06-04,03:41:00,21677.75,BUY,3,0.02h,Break Even,$-1.50,$-16.50,$223650.50,371,$-16.50
2025-06-04,04:06:00,21674.5,SELL,3,0.02h,Break Even,$-1.50,$-18.00,$223649.00,371,$-18.00
2025-06-04,04:12:00,21686.25,BUY,3,0.02h,Break Even,$-1.50,$-19.50,$223647.50,371,$-19.50
2025-06-04,04:37:00,21684.25,SELL,3,0.02h,Break Even,$-1.50,$-21.00,$223646.00,371,$-21.00
2025-06-04,05:11:00,21684.5,BUY,3,0.02h,Break Even,$-1.50,$-22.50,$223644.50,371,$-22.50
2025-06-04,06:19:00,21691.5,SELL,3,0.02h,Break Even,$-1.50,$-24.00,$223643.00,371,$-24.00
2025-06-04,06:52:00,21694.0,BUY,3,0.02h,Break Even,$-1.50,$-25.50,$223641.50,371,$-25.50
2025-06-04,07:00:00,21691.0,SELL,3,0.02h,Stop Loss,$-9.00,$-34.50,$223632.50,371,$-34.50
2025-06-04,07:04:00,21693.5,BUY,3,0.02h,Break Even,$-1.50,$-36.00,$223631.00,371,$-36.00
2025-06-04,07:05:00,21687.5,SELL,3,0.02h,Break Even,$-1.50,$-37.50,$223629.50,371,$-37.50
2025-06-04,07:24:00,21690.5,BUY,3,0.02h,Break Even,$-1.50,$-39.00,$223628.00,371,$-39.00
2025-06-04,08:31:00,21731.5,SELL,3,0.02h,Break Even,$-1.50,$-40.50,$223626.50,371,$-40.50
2025-06-04,08:36:00,21739.5,BUY,3,0.02h,Stop Loss,$-9.00,$-49.50,$223617.50,371,$-49.50
2025-06-04,08:43:00,21732.5,SELL,3,0.02h,Stop Loss,$10.50,$-39.00,$223628.00,371,$-39.00
2025-06-04,09:19:00,21728.75,BUY,3,0.02h,Stop Loss,$3.00,$-36.00,$223631.00,371,$-36.00
2025-06-04,09:59:00,21735.0,SELL,3,0.02h,Stop Loss,$-9.00,$-45.00,$223622.00,371,$-45.00
2025-06-04,10:03:00,21741.75,BUY,3,0.02h,Stop Loss,$4.50,$-40.50,$223626.50,371,$-40.50
2025-06-04,10:20:00,21734.75,SELL,3,0.02h,Stop Loss,$22.50,$-18.00,$223649.00,371,$-18.00
2025-06-04,10:46:00,21734.25,BUY,3,0.02h,Break Even,$-1.50,$-19.50,$223647.50,371,$-19.50
2025-06-04,11:21:00,21739.5,SELL,3,0.02h,Break Even,$-1.50,$-21.00,$223646.00,371,$-21.00
2025-06-04,11:44:00,21740.75,BUY,3,0.02h,Stop Loss,$4.50,$-16.50,$223650.50,371,$-16.50
2025-06-04,12:16:00,21719.25,SELL,3,0.02h,Stop Loss,$42.00,$25.50,$223692.50,371,$25.50
2025-06-04,12:50:00,21702.0,BUY,3,0.02h,Break Even,$-1.50,$24.00,$223691.00,371,$24.00
2025-06-04,12:52:00,21692.5,SELL,3,0.02h,Stop Loss,$-9.00,$15.00,$223682.00,371,$15.00
2025-06-04,12:53:00,21698.0,BUY,3,0.02h,Stop Loss,$12.00,$27.00,$223694.00,371,$27.00
2025-06-04,13:54:00,21742.0,SELL,3,0.02h,Break Even,$-1.50,$25.50,$223692.50,371,$25.50
2025-06-04,14:21:00,21728.75,BUY,3,0.02h,Stop Loss,$13.50,$39.00,$223706.00,371,$39.00
2025-06-04,14:25:00,21712.5,SELL,3,0.02h,Break Even,$-1.50,$37.50,$223704.50,371,$37.50
2025-06-04,14:27:00,21731.75,BUY,3,0.02h,Stop Loss,$55.50,$93.00,$223760.00,371,$93.00
2025-06-04,14:44:00,21715.75,SELL,3,0.02h,Break Even,$-1.50,$91.50,$223758.50,371,$91.50
2025-06-04,14:56:00,21738.0,BUY,3,0.02h,Stop Loss,$21.00,$112.50,$223779.50,371,$112.50
2025-06-04,15:29:00,21760.25,SELL,3,0.02h,Stop Loss,$25.50,$138.00,$223805.00,371,$138.00
2025-06-04,15:43:00,21764.75,BUY,3,0.02h,Stop Loss,$39.00,$177.00,$223844.00,371,$177.00
2025-06-04,15:45:00,21740.0,SELL,3,0.02h,Break Even,$-1.50,$175.50,$223842.50,371,$175.50
2025-06-04,16:45:00,21734.5,BUY,3,0.02h,Stop Loss,$30.00,$205.50,$223872.50,371,$205.50
2025-06-04,17:40:00,21766.25,SELL,3,0.02h,Stop Loss,$57.00,$262.50,$223929.50,371,$262.50
2025-06-04,17:46:00,21776.0,BUY,3,0.02h,Break Even,$-1.50,$261.00,$223928.00,371,$261.00
2025-06-04,18:27:00,21782.5,SELL,3,0.02h,Break Even,$-1.50,$259.50,$223926.50,371,$259.50
2025-06-04,18:30:00,21796.0,BUY,3,0.02h,Stop Loss,$19.50,$279.00,$223946.00,371,$279.00
2025-06-04,18:50:00,21786.25,SELL,3,0.02h,Stop Loss,$67.50,$346.50,$224013.50,371,$346.50
2025-06-04,19:04:00,21792.0,BUY,3,0.02h,Break Even,$-1.50,$345.00,$224012.00,371,$345.00
2025-06-04,19:10:00,21777.25,SELL,3,0.02h,Break Even,$-1.50,$343.50,$224010.50,371,$343.50
2025-06-04,19:15:00,21792.5,BUY,3,0.02h,Break Even,$-1.50,$342.00,$224009.00,371,$342.00
2025-06-04,19:18:00,21783.75,SELL,3,0.02h,Break Even,$-1.50,$340.50,$224007.50,371,$340.50
2025-06-04,20:29:00,21761.0,BUY,3,0.02h,Stop Loss,$-9.00,$331.50,$223998.50,371,$331.50
2025-06-04,20:33:00,21758.25,SELL,3,0.02h,Stop Loss,$-9.00,$322.50,$223989.50,371,$322.50
2025-06-04,20:46:00,21763.0,BUY,3,0.02h,Stop Loss,$-9.00,$313.50,$223980.50,371,$313.50
2025-06-04,20:55:00,21751.0,SELL,3,0.02h,Stop Loss,$-9.00,$304.50,$223971.50,371,$304.50
2025-06-04,23:46:00,21750.25,BUY,3,0.02h,Break Even,$-1.50,$303.00,$223970.00,371,$303.00
2025-06-04,23:53:00,21742.75,SELL,3,0.02h,Stop Loss,$-9.00,$294.00,$223961.00,371,$294.00
,,,,,,,,,,,
2025-06-05,00:04:00,21751.75,BUY,3,0.02h,Break Even,$-1.50,$-1.50,$223959.50,372,$-1.50
2025-06-05,00:48:00,21754.5,SELL,3,0.02h,Stop Loss,$3.00,$1.50,$223962.50,372,$1.50
2025-06-05,01:44:00,21743.75,BUY,3,0.02h,Stop Loss,$-9.00,$-7.50,$223953.50,372,$-7.50
2025-06-05,02:12:00,21748.75,SELL,3,0.02h,Break Even,$-1.50,$-9.00,$223952.00,372,$-9.00
2025-06-05,02:48:00,21745.5,BUY,3,0.03h,Break Even,$-1.50,$-10.50,$223950.50,372,$-10.50
2025-06-05,03:05:00,21742.25,SELL,3,0.02h,Stop Loss,$-9.00,$-19.50,$223941.50,372,$-19.50
2025-06-05,03:11:00,21750.75,BUY,3,0.02h,Break Even,$-1.50,$-21.00,$223940.00,372,$-21.00
2025-06-05,03:49:00,21749.25,SELL,3,0.02h,Stop Loss,$-9.00,$-30.00,$223931.00,372,$-30.00
2025-06-05,03:57:00,21751.75,BUY,3,0.02h,Stop Loss,$-9.00,$-39.00,$223922.00,372,$-39.00
2025-06-05,03:58:00,21750.75,SELL,3,0.02h,Break Even,$-1.50,$-40.50,$223920.50,372,$-40.50
2025-06-05,04:14:00,21752.25,BUY,3,0.03h,Break Even,$-1.50,$-42.00,$223919.00,372,$-42.00
2025-06-05,04:28:00,21749.5,SELL,3,0.02h,Stop Loss,$-9.00,$-51.00,$223910.00,372,$-51.00
2025-06-05,04:44:00,21751.5,BUY,3,0.03h,Stop Loss,$-9.00,$-60.00,$223901.00,372,$-60.00
2025-06-05,04:47:00,21748.5,SELL,3,0.02h,Stop Loss,$-9.00,$-69.00,$223892.00,372,$-69.00
2025-06-05,04:52:00,21751.0,BUY,3,0.02h,Stop Loss,$-9.00,$-78.00,$223883.00,372,$-78.00
2025-06-05,04:53:00,21748.75,SELL,3,0.05h,Break Even,$-1.50,$-79.50,$223881.50,372,$-79.50
2025-06-05,05:45:00,21734.5,BUY,3,0.02h,Stop Loss,$-9.00,$-88.50,$223872.50,372,$-88.50
2025-06-05,05:48:00,21730.5,SELL,3,0.02h,Break Even,$-1.50,$-90.00,$223871.00,372,$-90.00
2025-06-05,05:56:00,21732.5,BUY,3,0.02h,Stop Loss,$-9.00,$-99.00,$223862.00,372,$-99.00
2025-06-05,05:57:00,21729.5,SELL,3,0.02h,Break Even,$-1.50,$-100.50,$223860.50,372,$-100.50
2025-06-05,06:00:00,21734.25,BUY,3,0.02h,Stop Loss,$-9.00,$-109.50,$223851.50,372,$-109.50
2025-06-05,06:01:00,21730.25,SELL,3,0.02h,Stop Loss,$4.50,$-105.00,$223856.00,372,$-105.00
2025-06-05,06:06:00,21733.0,BUY,3,0.02h,Break Even,$-1.50,$-106.50,$223854.50,372,$-106.50
2025-06-05,06:13:00,21730.0,SELL,3,0.02h,Break Even,$-1.50,$-108.00,$223853.00,372,$-108.00
2025-06-05,06:14:00,21732.75,BUY,3,0.02h,Stop Loss,$-9.00,$-117.00,$223844.00,372,$-117.00
2025-06-05,06:15:00,21727.25,SELL,3,0.02h,Stop Loss,$-9.00,$-126.00,$223835.00,372,$-126.00
2025-06-05,06:26:00,21733.0,BUY,3,0.02h,Stop Loss,$10.50,$-115.50,$223845.50,372,$-115.50
2025-06-05,06:48:00,21732.0,SELL,3,0.02h,Stop Loss,$-9.00,$-124.50,$223836.50,372,$-124.50
2025-06-05,06:57:00,21739.75,BUY,3,0.02h,Break Even,$-1.50,$-126.00,$223835.00,372,$-126.00
2025-06-05,08:44:00,21822.0,SELL,3,0.02h,Stop Loss,$3.00,$-123.00,$223838.00,372,$-123.00
2025-06-05,09:38:00,21782.0,BUY,3,0.02h,Stop Loss,$4.50,$-118.50,$223842.50,372,$-118.50
2025-06-05,09:52:00,21768.75,SELL,3,0.02h,Stop Loss,$-9.00,$-127.50,$223833.50,372,$-127.50
2025-06-05,10:03:00,21783.25,BUY,3,0.02h,Stop Loss,$-9.00,$-136.50,$223824.50,372,$-136.50
2025-06-05,10:36:00,21786.75,SELL,3,0.02h,Stop Loss,$-9.00,$-145.50,$223815.50,372,$-145.50
2025-06-05,11:01:00,21779.5,BUY,3,0.02h,Stop Loss,$-9.00,$-154.50,$223806.50,372,$-154.50
2025-06-05,11:03:00,21765.5,SELL,3,0.02h,Break Even,$-1.50,$-156.00,$223805.00,372,$-156.00
2025-06-05,11:33:00,21769.0,BUY,3,0.02h,Stop Loss,$-9.00,$-165.00,$223796.00,372,$-165.00
2025-06-05,11:42:00,21751.5,SELL,3,0.02h,Stop Loss,$-9.00,$-174.00,$223787.00,372,$-174.00
2025-06-05,11:48:00,21768.5,BUY,3,0.02h,Break Even,$-1.50,$-175.50,$223785.50,372,$-175.50
2025-06-05,12:04:00,21763.25,SELL,3,0.02h,Stop Loss,$3.00,$-172.50,$223788.50,372,$-172.50
2025-06-05,12:05:00,21768.5,BUY,3,0.02h,Break Even,$-1.50,$-174.00,$223787.00,372,$-174.00
2025-06-05,12:06:00,21763.0,SELL,3,0.02h,Break Even,$-1.50,$-175.50,$223785.50,372,$-175.50
2025-06-05,12:09:00,21769.25,BUY,3,0.02h,Stop Loss,$4.50,$-171.00,$223790.00,372,$-171.00
2025-06-05,12:27:00,21767.75,SELL,3,0.02h,Break Even,$-1.50,$-172.50,$223788.50,372,$-172.50
2025-06-05,12:40:00,21771.25,BUY,3,0.02h,Stop Loss,$9.00,$-163.50,$223797.50,372,$-163.50
2025-06-05,12:49:00,21754.75,SELL,3,0.02h,Stop Loss,$-9.00,$-172.50,$223788.50,372,$-172.50
2025-06-05,12:50:00,21845.25,BUY,3,0.02h,Stop Loss,$46.50,$-126.00,$223835.00,372,$-126.00
2025-06-05,13:17:00,21794.0,SELL,3,0.02h,Break Even,$-1.50,$-127.50,$223833.50,372,$-127.50
2025-06-05,13:21:00,21817.5,BUY,3,0.02h,Break Even,$-1.50,$-129.00,$223832.00,372,$-129.00
2025-06-05,13:27:00,21806.5,SELL,3,0.02h,Stop Loss,$15.00,$-114.00,$223847.00,372,$-114.00
2025-06-05,13:29:00,21814.25,BUY,3,0.02h,Break Even,$-1.50,$-115.50,$223845.50,372,$-115.50
2025-06-05,13:33:00,21792.0,SELL,3,0.02h,Stop Loss,$76.50,$-39.00,$223922.00,372,$-39.00
2025-06-05,14:22:00,21753.75,BUY,3,0.02h,Stop Loss,$22.50,$-16.50,$223944.50,372,$-16.50
2025-06-05,14:36:00,21727.25,SELL,3,0.02h,Stop Loss,$43.50,$27.00,$223988.00,372,$27.00
2025-06-05,14:38:00,21782.5,BUY,3,0.02h,Stop Loss,$141.00,$168.00,$224129.00,372,$168.00
2025-06-05,16:09:00,21901.5,SELL,3,0.02h,Stop Loss,$94.50,$262.50,$224223.50,372,$262.50
2025-06-05,17:13:00,21755.75,BUY,3,0.02h,Break Even,$-1.50,$261.00,$224222.00,372,$261.00
2025-06-05,17:50:00,21767.0,SELL,3,0.02h,Stop Loss,$27.00,$288.00,$224249.00,372,$288.00
2025-06-05,18:28:00,21703.25,BUY,3,0.02h,Break Even,$-1.50,$286.50,$224247.50,372,$286.50
2025-06-05,18:54:00,21699.5,SELL,3,0.02h,Break Even,$-1.50,$285.00,$224246.00,372,$285.00
2025-06-05,19:35:00,21609.75,BUY,3,0.02h,Stop Loss,$63.00,$348.00,$224309.00,372,$348.00
2025-06-05,19:54:00,21597.5,SELL,3,0.02h,Stop Loss,$63.00,$411.00,$224372.00,372,$411.00
2025-06-05,23:02:00,21559.0,BUY,3,0.02h,Stop Loss,$25.50,$436.50,$224397.50,372,$436.50
2025-06-05,23:19:00,21544.0,SELL,3,0.02h,Break Even,$-1.50,$435.00,$224396.00,372,$435.00
2025-06-05,23:27:00,21560.5,BUY,3,0.02h,Stop Loss,$-9.00,$426.00,$224387.00,372,$426.00
2025-06-05,23:31:00,21554.5,SELL,3,0.02h,Stop Loss,$18.00,$444.00,$224405.00,372,$444.00
2025-06-05,23:44:00,21563.0,BUY,3,0.02h,Break Even,$-1.50,$442.50,$224403.50,372,$442.50
,,,,,,,,,,,
2025-06-06,00:00:00,21546.0,SELL,3,0.02h,Break Even,$-1.50,$-1.50,$224402.00,373,$-1.50
2025-06-06,00:02:00,21562.5,BUY,3,0.02h,Stop Loss,$46.50,$45.00,$224448.50,373,$45.00
2025-06-06,00:23:00,21564.25,SELL,3,0.02h,Stop Loss,$-9.00,$36.00,$224439.50,373,$36.00
2025-06-06,00:42:00,21572.5,BUY,3,0.02h,Stop Loss,$7.50,$43.50,$224447.00,373,$43.50
2025-06-06,00:45:00,21564.25,SELL,3,0.02h,Stop Loss,$15.00,$58.50,$224462.00,373,$58.50
2025-06-06,00:56:00,21568.0,BUY,3,0.02h,Stop Loss,$3.00,$61.50,$224465.00,373,$61.50
2025-06-06,01:28:00,21571.75,SELL,3,0.02h,Stop Loss,$-9.00,$52.50,$224456.00,373,$52.50
2025-06-06,01:39:00,21587.25,BUY,3,0.02h,Stop Loss,$-9.00,$43.50,$224447.00,373,$43.50
2025-06-06,01:58:00,21581.0,SELL,3,0.02h,Stop Loss,$-9.00,$34.50,$224438.00,373,$34.50
2025-06-06,02:18:00,21585.0,BUY,3,0.02h,Break Even,$-1.50,$33.00,$224436.50,373,$33.00
2025-06-06,02:23:00,21577.0,SELL,3,0.02h,Stop Loss,$6.00,$39.00,$224442.50,373,$39.00
2025-06-06,02:30:00,21585.25,BUY,3,0.02h,Break Even,$-1.50,$37.50,$224441.00,373,$37.50
2025-06-06,02:37:00,21579.25,SELL,3,0.02h,Stop Loss,$7.50,$45.00,$224448.50,373,$45.00
2025-06-06,02:50:00,21582.0,BUY,3,0.02h,Stop Loss,$-9.00,$36.00,$224439.50,373,$36.00
2025-06-06,03:12:00,21583.75,SELL,3,0.03h,Break Even,$-1.50,$34.50,$224438.00,373,$34.50
2025-06-06,03:14:00,21585.75,BUY,3,0.02h,Break Even,$-1.50,$33.00,$224436.50,373,$33.00
2025-06-06,04:05:00,21602.75,SELL,3,0.02h,Stop Loss,$-9.00,$24.00,$224427.50,373,$24.00
2025-06-06,04:08:00,21612.0,BUY,3,0.02h,Stop Loss,$-9.00,$15.00,$224418.50,373,$15.00
2025-06-06,04:19:00,21606.0,SELL,3,0.02h,Stop Loss,$-9.00,$6.00,$224409.50,373,$6.00
2025-06-06,04:30:00,21613.5,BUY,3,0.02h,Break Even,$-1.50,$4.50,$224408.00,373,$4.50
2025-06-06,04:36:00,21604.5,SELL,3,0.02h,Break Even,$-1.50,$3.00,$224406.50,373,$3.00
2025-06-06,04:41:00,21614.0,BUY,3,0.02h,Break Even,$-1.50,$1.50,$224405.00,373,$1.50
2025-06-06,05:27:00,21652.75,SELL,3,0.02h,Stop Loss,$-9.00,$-7.50,$224396.00,373,$-7.50
2025-06-06,05:30:00,21655.0,BUY,3,0.02h,Stop Loss,$-9.00,$-16.50,$224387.00,373,$-16.50
2025-06-06,05:31:00,21653.25,SELL,3,0.02h,Stop Loss,$-9.00,$-25.50,$224378.00,373,$-25.50
2025-06-06,05:38:00,21656.75,BUY,3,0.02h,Stop Loss,$-9.00,$-34.50,$224369.00,373,$-34.50
2025-06-06,05:56:00,21652.75,SELL,3,0.02h,Stop Loss,$-9.00,$-43.50,$224360.00,373,$-43.50
2025-06-06,05:59:00,21660.5,BUY,3,0.02h,Stop Loss,$-9.00,$-52.50,$224351.00,373,$-52.50
2025-06-06,06:01:00,21650.5,SELL,3,0.02h,Stop Loss,$33.00,$-19.50,$224384.00,373,$-19.50
2025-06-06,06:30:00,21660.0,BUY,3,0.02h,Stop Loss,$3.00,$-16.50,$224387.00,373,$-16.50
2025-06-06,07:07:00,21653.5,SELL,3,0.02h,Stop Loss,$-9.00,$-25.50,$224378.00,373,$-25.50
2025-06-06,07:27:00,21670.5,BUY,3,0.02h,Stop Loss,$-9.00,$-34.50,$224369.00,373,$-34.50
2025-06-06,07:29:00,21654.25,SELL,3,0.02h,Break Even,$-1.50,$-36.00,$224367.50,373,$-36.00
2025-06-06,07:34:00,21668.5,BUY,3,0.02h,Stop Loss,$-9.00,$-45.00,$224358.50,373,$-45.00
2025-06-06,07:59:00,21662.0,SELL,3,0.02h,Break Even,$-1.50,$-46.50,$224357.00,373,$-46.50
2025-06-06,08:10:00,21665.5,BUY,3,0.02h,Break Even,$-1.50,$-48.00,$224355.50,373,$-48.00
2025-06-06,08:12:00,21655.5,SELL,3,0.02h,Stop Loss,$-9.00,$-57.00,$224346.50,373,$-57.00
2025-06-06,08:33:00,21657.5,BUY,3,0.02h,Break Even,$-1.50,$-58.50,$224345.00,373,$-58.50
2025-06-06,08:39:00,21646.75,SELL,3,0.02h,Break Even,$-1.50,$-60.00,$224343.50,373,$-60.00
2025-06-06,08:42:00,21656.25,BUY,3,0.02h,Break Even,$-1.50,$-61.50,$224342.00,373,$-61.50
2025-06-06,08:57:00,21653.25,SELL,3,0.02h,Break Even,$-1.50,$-63.00,$224340.50,373,$-63.00
2025-06-06,08:59:00,21661.0,BUY,3,0.02h,Stop Loss,$-9.00,$-72.00,$224331.50,373,$-72.00
2025-06-06,09:44:00,21670.25,SELL,3,0.02h,Break Even,$-1.50,$-73.50,$224330.00,373,$-73.50
2025-06-06,09:52:00,21681.75,BUY,3,0.03h,Stop Loss,$36.00,$-37.50,$224366.00,373,$-37.50
2025-06-06,10:11:00,21680.0,SELL,3,0.02h,Stop Loss,$4.50,$-33.00,$224370.50,373,$-33.00
2025-06-06,10:19:00,21685.75,BUY,3,0.02h,Stop Loss,$24.00,$-9.00,$224394.50,373,$-9.00
2025-06-06,10:36:00,21682.25,SELL,3,0.02h,Stop Loss,$49.50,$40.50,$224444.00,373,$40.50
2025-06-06,11:17:00,21672.5,BUY,3,0.02h,Stop Loss,$-9.00,$31.50,$224435.00,373,$31.50
2025-06-06,11:59:00,21670.25,SELL,3,0.02h,Stop Loss,$-9.00,$22.50,$224426.00,373,$22.50
2025-06-06,12:02:00,21681.0,BUY,3,0.02h,Break Even,$-1.50,$21.00,$224424.50,373,$21.00
2025-06-06,12:08:00,21671.0,SELL,3,0.02h,Stop Loss,$10.50,$31.50,$224435.00,373,$31.50
2025-06-06,12:10:00,21679.75,BUY,3,0.02h,Break Even,$-1.50,$30.00,$224433.50,373,$30.00
2025-06-06,12:11:00,21675.5,SELL,3,0.02h,Break Even,$-1.50,$28.50,$224432.00,373,$28.50
2025-06-06,12:14:00,21682.5,BUY,3,0.02h,Stop Loss,$-9.00,$19.50,$224423.00,373,$19.50
2025-06-06,12:18:00,21672.25,SELL,3,0.02h,Stop Loss,$-9.00,$10.50,$224414.00,373,$10.50
2025-06-06,12:28:00,21682.25,BUY,3,0.02h,Stop Loss,$18.00,$28.50,$224432.00,373,$28.50
2025-06-06,14:04:00,21821.5,SELL,3,0.02h,Stop Loss,$25.50,$54.00,$224457.50,373,$54.00
2025-06-06,14:08:00,21832.75,BUY,3,0.02h,Stop Loss,$46.50,$100.50,$224504.00,373,$100.50
2025-06-06,14:12:00,21817.25,SELL,3,0.02h,Stop Loss,$12.00,$112.50,$224516.00,373,$112.50
2025-06-06,14:16:00,21834.5,BUY,3,0.02h,Break Even,$-1.50,$111.00,$224514.50,373,$111.00
2025-06-06,14:20:00,21818.5,SELL,3,0.02h,Break Even,$-1.50,$109.50,$224513.00,373,$109.50
2025-06-06,14:41:00,21831.75,BUY,3,0.02h,Break Even,$-1.50,$108.00,$224511.50,373,$108.00
2025-06-06,15:17:00,21821.75,SELL,3,0.02h,Stop Loss,$93.00,$201.00,$224604.50,373,$201.00
2025-06-06,15:45:00,21800.0,BUY,3,0.02h,Break Even,$-1.50,$199.50,$224603.00,373,$199.50
2025-06-06,16:21:00,21807.0,SELL,3,0.02h,Stop Loss,$63.00,$262.50,$224666.00,373,$262.50
2025-06-06,17:17:00,21763.75,BUY,3,0.02h,Break Even,$-1.50,$261.00,$224664.50,373,$261.00
2025-06-06,18:30:00,21844.0,SELL,3,0.02h,Stop Loss,$-9.00,$252.00,$224655.50,373,$252.00
2025-06-06,18:31:00,21850.25,BUY,3,0.02h,Stop Loss,$28.50,$280.50,$224684.00,373,$280.50
2025-06-06,18:42:00,21844.0,SELL,3,0.02h,Stop Loss,$36.00,$316.50,$224720.00,373,$316.50
2025-06-06,19:54:00,21809.0,BUY,3,0.02h,Stop Loss,$100.50,$417.00,$224820.50,373,$417.00
2025-06-06,19:57:00,21802.0,SELL,3,0.02h,Stop Loss,$-9.00,$408.00,$224811.50,373,$408.00
2025-06-06,20:17:00,21805.0,BUY,3,0.02h,Break Even,$-1.50,$406.50,$224810.00,373,$406.50
2025-06-06,20:50:00,21804.75,SELL,3,0.02h,Stop Loss,$-9.00,$397.50,$224801.00,373,$397.50
2025-06-06,21:00:00,21809.75,BUY,3,51.00h,Stop Loss,$-9.00,$388.50,$224792.00,373,$388.50
,,,,,,,,,,,
2025-06-09,00:00:00,21761.75,SELL,3,0.02h,Stop Loss,$15.00,$15.00,$224807.00,374,$15.00
2025-06-09,01:48:00,21743.5,BUY,3,0.02h,Stop Loss,$-9.00,$6.00,$224798.00,374,$6.00
2025-06-09,02:10:00,21740.25,SELL,3,0.02h,Break Even,$-1.50,$4.50,$224796.50,374,$4.50
2025-06-09,02:43:00,21734.25,BUY,3,0.02h,Break Even,$-1.50,$3.00,$224795.00,374,$3.00
2025-06-09,03:10:00,21733.25,SELL,3,0.02h,Stop Loss,$16.50,$19.50,$224811.50,374,$19.50
2025-06-09,03:38:00,21734.75,BUY,3,0.02h,Break Even,$-1.50,$18.00,$224810.00,374,$18.00
2025-06-09,04:23:00,21741.5,SELL,3,0.02h,Break Even,$-1.50,$16.50,$224808.50,374,$16.50
2025-06-09,04:54:00,21741.25,BUY,3,0.02h,Stop Loss,$-9.00,$7.50,$224799.50,374,$7.50
2025-06-09,05:06:00,21733.25,SELL,3,0.02h,Break Even,$-1.50,$6.00,$224798.00,374,$6.00
2025-06-09,05:16:00,21739.0,BUY,3,0.02h,Stop Loss,$-9.00,$-3.00,$224789.00,374,$-3.00
2025-06-09,05:18:00,21736.5,SELL,3,0.02h,Stop Loss,$-9.00,$-12.00,$224780.00,374,$-12.00
2025-06-09,05:20:00,21741.0,BUY,3,0.02h,Break Even,$-1.50,$-13.50,$224778.50,374,$-13.50
2025-06-09,05:40:00,21740.75,SELL,3,0.02h,Break Even,$-1.50,$-15.00,$224777.00,374,$-15.00
2025-06-09,05:53:00,21742.0,BUY,3,0.02h,Stop Loss,$-9.00,$-24.00,$224768.00,374,$-24.00
2025-06-09,06:11:00,21739.75,SELL,3,0.02h,Stop Loss,$25.50,$1.50,$224793.50,374,$1.50
2025-06-09,06:33:00,21745.0,BUY,3,0.02h,Stop Loss,$-9.00,$-7.50,$224784.50,374,$-7.50
2025-06-09,06:36:00,21735.75,SELL,3,0.02h,Stop Loss,$-9.00,$-16.50,$224775.50,374,$-16.50
2025-06-09,06:38:00,21745.75,BUY,3,0.02h,Stop Loss,$-9.00,$-25.50,$224766.50,374,$-25.50
2025-06-09,07:20:00,21752.25,SELL,3,0.02h,Break Even,$-1.50,$-27.00,$224765.00,374,$-27.00
2025-06-09,07:31:00,21768.75,BUY,3,0.02h,Stop Loss,$-9.00,$-36.00,$224756.00,374,$-36.00
2025-06-09,08:16:00,21785.0,SELL,3,0.02h,Stop Loss,$-9.00,$-45.00,$224747.00,374,$-45.00
2025-06-09,08:19:00,21791.75,BUY,3,0.02h,Break Even,$-1.50,$-46.50,$224745.50,374,$-46.50
2025-06-09,08:21:00,21785.0,SELL,3,0.02h,Break Even,$-1.50,$-48.00,$224744.00,374,$-48.00
2025-06-09,08:50:00,21784.25,BUY,3,0.02h,Stop Loss,$4.50,$-43.50,$224748.50,374,$-43.50
2025-06-09,09:10:00,21779.0,SELL,3,0.02h,Stop Loss,$-9.00,$-52.50,$224739.50,374,$-52.50
2025-06-09,09:17:00,21787.5,BUY,3,0.02h,Break Even,$-1.50,$-54.00,$224738.00,374,$-54.00
2025-06-09,09:19:00,21778.0,SELL,3,0.02h,Stop Loss,$-9.00,$-63.00,$224729.00,374,$-63.00
2025-06-09,09:30:00,21789.25,BUY,3,0.02h,Stop Loss,$-9.00,$-72.00,$224720.00,374,$-72.00
2025-06-09,09:53:00,21784.0,SELL,3,0.02h,Break Even,$-1.50,$-73.50,$224718.50,374,$-73.50
2025-06-09,10:10:00,21784.75,BUY,3,0.02h,Break Even,$-1.50,$-75.00,$224717.00,374,$-75.00
2025-06-09,10:24:00,21780.0,SELL,3,0.02h,Stop Loss,$-9.00,$-84.00,$224708.00,374,$-84.00
2025-06-09,10:38:00,21785.0,BUY,3,0.02h,Stop Loss,$-9.00,$-93.00,$224699.00,374,$-93.00
2025-06-09,10:43:00,21782.25,SELL,3,0.02h,Break Even,$-1.50,$-94.50,$224697.50,374,$-94.50
2025-06-09,11:02:00,21787.0,BUY,3,0.02h,Break Even,$-1.50,$-96.00,$224696.00,374,$-96.00
2025-06-09,12:06:00,21806.75,SELL,3,0.02h,Stop Loss,$-9.00,$-105.00,$224687.00,374,$-105.00
2025-06-09,12:22:00,21811.5,BUY,3,0.02h,Break Even,$-1.50,$-106.50,$224685.50,374,$-106.50
2025-06-09,12:43:00,21807.5,SELL,3,0.02h,Break Even,$-1.50,$-108.00,$224684.00,374,$-108.00
2025-06-09,12:44:00,21811.75,BUY,3,0.02h,Break Even,$-1.50,$-109.50,$224682.50,374,$-109.50
2025-06-09,12:51:00,21803.75,SELL,3,0.02h,Break Even,$-1.50,$-111.00,$224681.00,374,$-111.00
2025-06-09,13:07:00,21811.5,BUY,3,0.02h,Break Even,$-1.50,$-112.50,$224679.50,374,$-112.50
2025-06-09,13:17:00,21798.5,SELL,3,0.02h,Break Even,$-1.50,$-114.00,$224678.00,374,$-114.00
2025-06-09,13:24:00,21813.0,BUY,3,0.02h,Stop Loss,$-9.00,$-123.00,$224669.00,374,$-123.00
2025-06-09,13:30:00,21797.5,SELL,3,0.02h,Stop Loss,$19.50,$-103.50,$224688.50,374,$-103.50
2025-06-09,13:31:00,21808.75,BUY,3,0.02h,Stop Loss,$16.50,$-87.00,$224705.00,374,$-87.00
2025-06-09,13:32:00,21787.25,SELL,3,0.02h,Stop Loss,$27.00,$-60.00,$224732.00,374,$-60.00
2025-06-09,13:50:00,21804.0,BUY,3,0.02h,Stop Loss,$19.50,$-40.50,$224751.50,374,$-40.50
2025-06-09,14:47:00,21847.25,SELL,3,0.02h,Break Even,$-1.50,$-42.00,$224750.00,374,$-42.00
2025-06-09,15:07:00,21858.0,BUY,3,0.02h,Stop Loss,$6.00,$-36.00,$224756.00,374,$-36.00
2025-06-09,15:17:00,21843.5,SELL,3,0.02h,Break Even,$-1.50,$-37.50,$224754.50,374,$-37.50
2025-06-09,15:40:00,21840.75,BUY,3,0.02h,Stop Loss,$-9.00,$-46.50,$224745.50,374,$-46.50
2025-06-09,15:41:00,21832.75,SELL,3,0.02h,Break Even,$-1.50,$-48.00,$224744.00,374,$-48.00
2025-06-09,15:53:00,21839.25,BUY,3,0.02h,Stop Loss,$9.00,$-39.00,$224753.00,374,$-39.00
2025-06-09,16:09:00,21822.25,SELL,3,0.02h,Stop Loss,$18.00,$-21.00,$224771.00,374,$-21.00
2025-06-09,16:24:00,21835.75,BUY,3,0.02h,Stop Loss,$13.50,$-7.50,$224784.50,374,$-7.50
2025-06-09,17:14:00,21862.75,SELL,3,0.02h,Break Even,$-1.50,$-9.00,$224783.00,374,$-9.00
2025-06-09,17:38:00,21863.0,BUY,3,0.02h,Stop Loss,$3.00,$-6.00,$224786.00,374,$-6.00
2025-06-09,18:05:00,21862.5,SELL,3,0.02h,Stop Loss,$18.00,$12.00,$224804.00,374,$12.00
2025-06-09,18:23:00,21869.75,BUY,3,0.02h,Stop Loss,$-9.00,$3.00,$224795.00,374,$3.00
2025-06-09,18:33:00,21864.5,SELL,3,0.02h,Break Even,$-1.50,$1.50,$224793.50,374,$1.50
2025-06-09,18:50:00,21863.25,BUY,3,0.02h,Break Even,$-1.50,$0.00,$224792.00,374,$0.00
2025-06-09,19:15:00,21859.75,SELL,3,0.02h,Stop Loss,$3.00,$3.00,$224795.00,374,$3.00
2025-06-09,20:34:00,21809.75,BUY,3,0.02h,Stop Loss,$-9.00,$-6.00,$224786.00,374,$-6.00
2025-06-09,23:50:00,21832.25,SELL,3,0.02h,Stop Loss,$-9.00,$-15.00,$224777.00,374,$-15.00
2025-06-09,23:54:00,21835.5,BUY,3,0.02h,Break Even,$-1.50,$-16.50,$224775.50,374,$-16.50
,,,,,,,,,,,
2025-06-10,00:00:00,21832.0,SELL,3,0.02h,Stop Loss,$37.50,$37.50,$224813.00,375,$37.50
2025-06-10,00:21:00,21829.75,BUY,3,0.02h,Break Even,$-1.50,$36.00,$224811.50,375,$36.00
2025-06-10,02:10:00,21952.0,SELL,3,0.02h,Stop Loss,$-9.00,$27.00,$224802.50,375,$27.00
2025-06-10,02:14:00,21962.5,BUY,3,0.02h,Stop Loss,$-9.00,$18.00,$224793.50,375,$18.00
2025-06-10,02:24:00,21955.5,SELL,3,0.02h,Stop Loss,$-9.00,$9.00,$224784.50,375,$9.00
2025-06-10,02:50:00,21953.5,BUY,3,0.02h,Stop Loss,$9.00,$18.00,$224793.50,375,$18.00
2025-06-10,03:00:00,21948.0,SELL,3,0.02h,Break Even,$-1.50,$16.50,$224792.00,375,$16.50
2025-06-10,03:37:00,21943.75,BUY,3,0.02h,Stop Loss,$-9.00,$7.50,$224783.00,375,$7.50
2025-06-10,03:59:00,21937.0,SELL,3,0.02h,Stop Loss,$-9.00,$-1.50,$224774.00,375,$-1.50
2025-06-10,04:47:00,21922.0,BUY,3,0.02h,Break Even,$-1.50,$-3.00,$224772.50,375,$-3.00
2025-06-10,04:57:00,21917.25,SELL,3,0.02h,Stop Loss,$-9.00,$-12.00,$224763.50,375,$-12.00
2025-06-10,05:05:00,21922.5,BUY,3,0.02h,Stop Loss,$-9.00,$-21.00,$224754.50,375,$-21.00
2025-06-10,05:06:00,21918.25,SELL,3,0.02h,Stop Loss,$-9.00,$-30.00,$224745.50,375,$-30.00
2025-06-10,05:07:00,21929.25,BUY,3,0.02h,Stop Loss,$-9.00,$-39.00,$224736.50,375,$-39.00
2025-06-10,05:16:00,21916.5,SELL,3,0.02h,Stop Loss,$12.00,$-27.00,$224748.50,375,$-27.00
2025-06-10,05:45:00,21838.25,BUY,3,0.02h,Break Even,$-1.50,$-28.50,$224747.00,375,$-28.50
2025-06-10,05:50:00,21816.5,SELL,3,0.02h,Stop Loss,$33.00,$4.50,$224780.00,375,$4.50
2025-06-10,05:59:00,21827.5,BUY,3,0.02h,Break Even,$-1.50,$3.00,$224778.50,375,$3.00
2025-06-10,06:03:00,21812.5,SELL,3,0.02h,Stop Loss,$-9.00,$-6.00,$224769.50,375,$-6.00
2025-06-10,06:16:00,21829.5,BUY,3,0.02h,Stop Loss,$-9.00,$-15.00,$224760.50,375,$-15.00
2025-06-10,06:17:00,21818.5,SELL,3,0.02h,Stop Loss,$-9.00,$-24.00,$224751.50,375,$-24.00
2025-06-10,06:18:00,21825.0,BUY,3,0.02h,Stop Loss,$6.00,$-18.00,$224757.50,375,$-18.00
2025-06-10,06:38:00,21825.25,SELL,3,0.02h,Stop Loss,$-9.00,$-27.00,$224748.50,375,$-27.00
2025-06-10,06:40:00,21833.75,BUY,3,0.02h,Stop Loss,$-9.00,$-36.00,$224739.50,375,$-36.00
2025-06-10,06:46:00,21819.75,SELL,3,0.02h,Break Even,$-1.50,$-37.50,$224738.00,375,$-37.50
2025-06-10,07:20:00,21820.75,BUY,3,0.02h,Stop Loss,$-9.00,$-46.50,$224729.00,375,$-46.50
2025-06-10,07:30:00,21799.25,SELL,3,0.02h,Stop Loss,$54.00,$7.50,$224783.00,375,$7.50
2025-06-10,07:57:00,21793.5,BUY,3,0.02h,Break Even,$-1.50,$6.00,$224781.50,375,$6.00
2025-06-10,08:15:00,21764.25,SELL,3,0.02h,Break Even,$-1.50,$4.50,$224780.00,375,$4.50
2025-06-10,08:28:00,21792.5,BUY,3,0.02h,Stop Loss,$-9.00,$-4.50,$224771.00,375,$-4.50
2025-06-10,09:43:00,21829.25,SELL,3,0.02h,Stop Loss,$-9.00,$-13.50,$224762.00,375,$-13.50
2025-06-10,09:45:00,21833.5,BUY,3,0.02h,Stop Loss,$-9.00,$-22.50,$224753.00,375,$-22.50
2025-06-10,09:46:00,21827.25,SELL,3,0.02h,Stop Loss,$-9.00,$-31.50,$224744.00,375,$-31.50
2025-06-10,10:01:00,21835.25,BUY,3,0.02h,Stop Loss,$6.00,$-25.50,$224750.00,375,$-25.50
2025-06-10,10:29:00,21837.5,SELL,3,0.02h,Break Even,$-1.50,$-27.00,$224748.50,375,$-27.00
2025-06-10,11:05:00,21844.0,BUY,3,0.02h,Break Even,$-1.50,$-28.50,$224747.00,375,$-28.50
2025-06-10,11:08:00,21825.75,SELL,3,0.02h,Stop Loss,$103.50,$75.00,$224850.50,375,$75.00
2025-06-10,11:31:00,21836.25,BUY,3,0.02h,Stop Loss,$37.50,$112.50,$224888.00,375,$112.50
2025-06-10,12:32:00,21853.5,SELL,3,0.02h,Break Even,$-1.50,$111.00,$224886.50,375,$111.00
2025-06-10,12:42:00,21863.0,BUY,3,0.02h,Break Even,$-1.50,$109.50,$224885.00,375,$109.50
2025-06-10,12:52:00,21850.0,SELL,3,0.02h,Break Even,$-1.50,$108.00,$224883.50,375,$108.00
2025-06-10,13:03:00,21857.75,BUY,3,0.02h,Stop Loss,$-9.00,$99.00,$224874.50,375,$99.00
2025-06-10,13:04:00,21854.0,SELL,3,0.02h,Break Even,$-1.50,$97.50,$224873.00,375,$97.50
2025-06-10,13:22:00,21854.75,BUY,3,0.02h,Break Even,$-1.50,$96.00,$224871.50,375,$96.00
2025-06-10,13:25:00,21851.0,SELL,3,0.02h,Stop Loss,$40.50,$136.50,$224912.00,375,$136.50
2025-06-10,13:40:00,21881.25,BUY,3,0.02h,Stop Loss,$9.00,$145.50,$224921.00,375,$145.50
2025-06-10,13:59:00,21857.75,SELL,3,0.02h,Stop Loss,$16.50,$162.00,$224937.50,375,$162.00
2025-06-10,14:01:00,21865.75,BUY,3,0.02h,Stop Loss,$37.50,$199.50,$224975.00,375,$199.50
2025-06-10,14:05:00,21855.0,SELL,3,0.02h,Stop Loss,$-9.00,$190.50,$224966.00,375,$190.50
2025-06-10,14:06:00,21862.5,BUY,3,0.02h,Stop Loss,$4.50,$195.00,$224970.50,375,$195.00
2025-06-10,14:08:00,21857.75,SELL,3,0.02h,Stop Loss,$39.00,$234.00,$225009.50,375,$234.00
2025-06-10,14:12:00,21873.5,BUY,3,0.02h,Stop Loss,$27.00,$261.00,$225036.50,375,$261.00
2025-06-10,14:41:00,21862.75,SELL,3,0.02h,Break Even,$-1.50,$259.50,$225035.00,375,$259.50
2025-06-10,14:45:00,21881.25,BUY,3,0.02h,Stop Loss,$-9.00,$250.50,$225026.00,375,$250.50
2025-06-10,14:56:00,21860.5,SELL,3,0.02h,Stop Loss,$9.00,$259.50,$225035.00,375,$259.50
2025-06-10,15:17:00,21874.0,BUY,3,0.02h,Stop Loss,$4.50,$264.00,$225039.50,375,$264.00
2025-06-10,15:25:00,21863.0,SELL,3,0.02h,Break Even,$-1.50,$262.50,$225038.00,375,$262.50
2025-06-10,15:26:00,21871.5,BUY,3,0.02h,Break Even,$-1.50,$261.00,$225036.50,375,$261.00
2025-06-10,15:27:00,21866.5,SELL,3,0.02h,Stop Loss,$33.00,$294.00,$225069.50,375,$294.00
2025-06-10,15:47:00,21845.75,BUY,3,0.02h,Stop Loss,$33.00,$327.00,$225102.50,375,$327.00
2025-06-10,16:46:00,21897.25,SELL,3,0.02h,Break Even,$-1.50,$325.50,$225101.00,375,$325.50
2025-06-10,16:48:00,21901.5,BUY,3,0.02h,Stop Loss,$-9.00,$316.50,$225092.00,375,$316.50
2025-06-10,16:49:00,21898.0,SELL,3,0.02h,Stop Loss,$3.00,$319.50,$225095.00,375,$319.50
2025-06-10,16:51:00,21904.25,BUY,3,0.02h,Stop Loss,$31.50,$351.00,$225126.50,375,$351.00
2025-06-10,17:04:00,21899.75,SELL,3,0.02h,Break Even,$-1.50,$349.50,$225125.00,375,$349.50
2025-06-10,17:10:00,21909.5,BUY,3,0.02h,Stop Loss,$40.50,$390.00,$225165.50,375,$390.00
2025-06-10,17:27:00,21899.75,SELL,3,0.02h,Break Even,$-1.50,$388.50,$225164.00,375,$388.50
2025-06-10,18:20:00,21873.75,BUY,3,0.02h,Break Even,$-1.50,$387.00,$225162.50,375,$387.00
2025-06-10,19:32:00,21952.5,SELL,3,0.02h,Stop Loss,$21.00,$408.00,$225183.50,375,$408.00
2025-06-10,19:57:00,21958.0,BUY,3,0.02h,Break Even,$-1.50,$406.50,$225182.00,375,$406.50
2025-06-10,20:07:00,21940.5,SELL,3,0.02h,Break Even,$-1.50,$405.00,$225180.50,375,$405.00
2025-06-10,20:19:00,21964.25,BUY,3,0.02h,Stop Loss,$12.00,$417.00,$225192.50,375,$417.00
2025-06-10,20:34:00,21948.75,SELL,3,0.02h,Stop Loss,$-9.00,$408.00,$225183.50,375,$408.00
2025-06-10,20:37:00,21954.25,BUY,3,0.02h,Stop Loss,$-9.00,$399.00,$225174.50,375,$399.00
2025-06-10,20:51:00,21949.25,SELL,3,0.02h,Break Even,$-1.50,$397.50,$225173.00,375,$397.50
2025-06-10,20:58:00,21953.0,BUY,3,0.02h,Stop Loss,$-9.00,$388.50,$225164.00,375,$388.50
2025-06-10,23:05:00,21944.0,SELL,3,0.02h,Break Even,$-1.50,$387.00,$225162.50,375,$387.00
2025-06-10,23:15:00,21959.5,BUY,3,0.02h,Stop Loss,$78.00,$465.00,$225240.50,375,$465.00
2025-06-10,23:38:00,21962.25,SELL,3,0.02h,Break Even,$-1.50,$463.50,$225239.00,375,$463.50
,,,,,,,,,,,
2025-06-11,00:04:00,21962.5,BUY,3,0.02h,Stop Loss,$6.00,$6.00,$225245.00,376,$6.00
2025-06-11,00:07:00,21945.25,SELL,3,0.02h,Stop Loss,$25.50,$31.50,$225270.50,376,$31.50
2025-06-11,00:19:00,21956.5,BUY,3,0.02h,Break Even,$-1.50,$30.00,$225269.00,376,$30.00
2025-06-11,00:21:00,21942.5,SELL,3,0.02h,Stop Loss,$6.00,$36.00,$225275.00,376,$36.00
2025-06-11,01:46:00,21901.5,BUY,3,0.02h,Stop Loss,$27.00,$63.00,$225302.00,376,$63.00
2025-06-11,02:07:00,21900.0,SELL,3,0.02h,Break Even,$-1.50,$61.50,$225300.50,376,$61.50
2025-06-11,02:38:00,21908.0,BUY,3,0.02h,Stop Loss,$-9.00,$52.50,$225291.50,376,$52.50
2025-06-11,02:48:00,21896.25,SELL,3,0.02h,Stop Loss,$-9.00,$43.50,$225282.50,376,$43.50
2025-06-11,03:13:00,21900.0,BUY,3,0.02h,Stop Loss,$-9.00,$34.50,$225273.50,376,$34.50
2025-06-11,03:18:00,21888.0,SELL,3,0.02h,Stop Loss,$-9.00,$25.50,$225264.50,376,$25.50
2025-06-11,03:22:00,21896.75,BUY,3,0.02h,Break Even,$-1.50,$24.00,$225263.00,376,$24.00
2025-06-11,04:10:00,21903.0,SELL,3,0.02h,Stop Loss,$-9.00,$15.00,$225254.00,376,$15.00
2025-06-11,04:14:00,21906.5,BUY,3,0.02h,Break Even,$-1.50,$13.50,$225252.50,376,$13.50
2025-06-11,04:15:00,21901.75,SELL,3,0.02h,Stop Loss,$-9.00,$4.50,$225243.50,376,$4.50
2025-06-11,04:16:00,21909.25,BUY,3,0.02h,Stop Loss,$-9.00,$-4.50,$225234.50,376,$-4.50
2025-06-11,04:26:00,21904.25,SELL,3,0.05h,Stop Loss,$34.50,$30.00,$225269.00,376,$30.00
2025-06-11,05:12:00,21889.5,BUY,3,0.02h,Stop Loss,$9.00,$39.00,$225278.00,376,$39.00
2025-06-11,05:25:00,21883.0,SELL,3,0.02h,Break Even,$-1.50,$37.50,$225276.50,376,$37.50
2025-06-11,05:46:00,21889.0,BUY,3,0.02h,Break Even,$-1.50,$36.00,$225275.00,376,$36.00
2025-06-11,05:49:00,21885.0,SELL,3,0.02h,Stop Loss,$-9.00,$27.00,$225266.00,376,$27.00
2025-06-11,05:53:00,21889.25,BUY,3,0.02h,Stop Loss,$10.50,$37.50,$225276.50,376,$37.50
2025-06-11,05:58:00,21881.25,SELL,3,0.02h,Stop Loss,$-9.00,$28.50,$225267.50,376,$28.50
2025-06-11,06:17:00,21888.0,BUY,3,0.02h,Stop Loss,$6.00,$34.50,$225273.50,376,$34.50
2025-06-11,06:35:00,21886.5,SELL,3,0.02h,Break Even,$-1.50,$33.00,$225272.00,376,$33.00
2025-06-11,06:43:00,21902.0,BUY,3,0.02h,Break Even,$-1.50,$31.50,$225270.50,376,$31.50
2025-06-11,07:30:00,21900.75,SELL,3,0.02h,Break Even,$-1.50,$30.00,$225269.00,376,$30.00
2025-06-11,07:38:00,21911.25,BUY,3,0.02h,Break Even,$-1.50,$28.50,$225267.50,376,$28.50
2025-06-11,09:05:00,21938.0,SELL,3,0.02h,Break Even,$-1.50,$27.00,$225266.00,376,$27.00
2025-06-11,09:31:00,21939.25,BUY,3,0.02h,Break Even,$-1.50,$25.50,$225264.50,376,$25.50
2025-06-11,09:35:00,21933.75,SELL,3,0.02h,Break Even,$-1.50,$24.00,$225263.00,376,$24.00
2025-06-11,10:07:00,21930.25,BUY,3,0.02h,Stop Loss,$-9.00,$15.00,$225254.00,376,$15.00
2025-06-11,10:24:00,21924.5,SELL,3,0.02h,Break Even,$-1.50,$13.50,$225252.50,376,$13.50
2025-06-11,10:30:00,21932.25,BUY,3,0.02h,Stop Loss,$-9.00,$4.50,$225243.50,376,$4.50
2025-06-11,10:41:00,21924.75,SELL,3,0.02h,Break Even,$-1.50,$3.00,$225242.00,376,$3.00
2025-06-11,10:45:00,21934.25,BUY,3,0.02h,Break Even,$-1.50,$1.50,$225240.50,376,$1.50
2025-06-11,11:01:00,21924.5,SELL,3,0.02h,Break Even,$-1.50,$0.00,$225239.00,376,$0.00
2025-06-11,11:32:00,21923.5,BUY,3,0.02h,Break Even,$-1.50,$-1.50,$225237.50,376,$-1.50
2025-06-11,12:54:00,22020.75,SELL,3,0.02h,Break Even,$-1.50,$-3.00,$225236.00,376,$-3.00
2025-06-11,13:13:00,22033.5,BUY,3,0.02h,Break Even,$-1.50,$-4.50,$225234.50,376,$-4.50
2025-06-11,13:15:00,22024.0,SELL,3,0.02h,Stop Loss,$15.00,$10.50,$225249.50,376,$10.50
2025-06-11,13:20:00,22030.5,BUY,3,0.02h,Stop Loss,$-9.00,$1.50,$225240.50,376,$1.50
2025-06-11,13:24:00,22021.25,SELL,3,0.02h,Break Even,$-1.50,$0.00,$225239.00,376,$0.00
2025-06-11,13:56:00,21993.5,BUY,3,0.02h,Break Even,$-1.50,$-1.50,$225237.50,376,$-1.50
2025-06-11,15:10:00,21999.25,SELL,3,0.02h,Stop Loss,$60.00,$58.50,$225297.50,376,$58.50
2025-06-11,16:30:00,21978.25,BUY,3,0.02h,Stop Loss,$25.50,$84.00,$225323.00,376,$84.00
2025-06-11,16:43:00,21961.25,SELL,3,0.02h,Break Even,$-1.50,$82.50,$225321.50,376,$82.50
2025-06-11,16:44:00,21973.5,BUY,3,0.02h,Stop Loss,$-9.00,$73.50,$225312.50,376,$73.50
2025-06-11,16:45:00,21964.75,SELL,3,0.02h,Stop Loss,$22.50,$96.00,$225335.00,376,$96.00
2025-06-11,16:47:00,21973.0,BUY,3,0.02h,Stop Loss,$27.00,$123.00,$225362.00,376,$123.00
2025-06-11,17:35:00,21996.0,SELL,3,0.02h,Stop Loss,$3.00,$126.00,$225365.00,376,$126.00
2025-06-11,18:34:00,21879.5,BUY,3,0.02h,Stop Loss,$22.50,$148.50,$225387.50,376,$148.50
2025-06-11,18:57:00,21855.75,SELL,3,0.02h,Stop Loss,$19.50,$168.00,$225407.00,376,$168.00
2025-06-11,19:26:00,21871.0,BUY,3,0.02h,Break Even,$-1.50,$166.50,$225405.50,376,$166.50
2025-06-11,19:33:00,21844.25,SELL,3,0.02h,Stop Loss,$42.00,$208.50,$225447.50,376,$208.50
2025-06-11,19:41:00,21863.0,BUY,3,0.02h,Stop Loss,$15.00,$223.50,$225462.50,376,$223.50
2025-06-11,20:35:00,21890.5,SELL,3,0.02h,Stop Loss,$21.00,$244.50,$225483.50,376,$244.50
2025-06-11,23:35:00,21845.0,BUY,3,0.02h,Stop Loss,$60.00,$304.50,$225543.50,376,$304.50
2025-06-11,23:52:00,21841.0,SELL,3,0.02h,Break Even,$-1.50,$303.00,$225542.00,376,$303.00
,,,,,,,,,,,
2025-06-12,00:24:00,21837.75,BUY,3,0.02h,Stop Loss,$-9.00,$-9.00,$225533.00,377,$-9.00
2025-06-12,00:25:00,21832.5,SELL,3,0.02h,Stop Loss,$-9.00,$-18.00,$225524.00,377,$-18.00
2025-06-12,01:17:00,21809.75,BUY,3,0.02h,Stop Loss,$-9.00,$-27.00,$225515.00,377,$-27.00
2025-06-12,01:24:00,21787.75,SELL,3,0.02h,Stop Loss,$4.50,$-22.50,$225519.50,377,$-22.50
2025-06-12,01:55:00,21782.5,BUY,3,0.02h,Stop Loss,$4.50,$-18.00,$225524.00,377,$-18.00
2025-06-12,02:35:00,21785.25,SELL,3,0.02h,Break Even,$-1.50,$-19.50,$225522.50,377,$-19.50
2025-06-12,02:58:00,21786.5,BUY,3,0.02h,Break Even,$-1.50,$-21.00,$225521.00,377,$-21.00
2025-06-12,03:39:00,21821.75,SELL,3,0.02h,Stop Loss,$-9.00,$-30.00,$225512.00,377,$-30.00
2025-06-12,03:48:00,22046.75,BUY,3,0.02h,Stop Loss,$-9.00,$-39.00,$225503.00,377,$-39.00
2025-06-12,03:49:00,21817.5,SELL,3,0.02h,Stop Loss,$-9.00,$-48.00,$225494.00,377,$-48.00
2025-06-12,03:50:00,22041.0,BUY,3,0.02h,Break Even,$-1.50,$-49.50,$225492.50,377,$-49.50
2025-06-12,03:53:00,21812.25,SELL,3,0.02h,Stop Loss,$-9.00,$-58.50,$225483.50,377,$-58.50
2025-06-12,03:54:00,22035.0,BUY,3,0.03h,Break Even,$-1.50,$-60.00,$225482.00,377,$-60.00
2025-06-12,03:56:00,21811.75,SELL,3,0.02h,Stop Loss,$-9.00,$-69.00,$225473.00,377,$-69.00
2025-06-12,04:02:00,22040.0,BUY,3,0.03h,Stop Loss,$19.50,$-49.50,$225492.50,377,$-49.50
2025-06-12,04:09:00,21817.0,SELL,3,0.02h,Break Even,$-1.50,$-51.00,$225491.00,377,$-51.00
2025-06-12,04:12:00,22042.75,BUY,3,0.02h,Stop Loss,$-9.00,$-60.00,$225482.00,377,$-60.00
2025-06-12,04:17:00,21815.75,SELL,3,0.02h,Stop Loss,$-9.00,$-69.00,$225473.00,377,$-69.00
2025-06-12,04:18:00,22042.5,BUY,3,0.02h,Stop Loss,$-9.00,$-78.00,$225464.00,377,$-78.00
2025-06-12,04:19:00,21821.5,SELL,3,0.02h,Stop Loss,$7.50,$-70.50,$225471.50,377,$-70.50
2025-06-12,04:27:00,22039.5,BUY,3,0.02h,Break Even,$-1.50,$-72.00,$225470.00,377,$-72.00
2025-06-12,04:32:00,21816.5,SELL,3,0.02h,Stop Loss,$-9.00,$-81.00,$225461.00,377,$-81.00
2025-06-12,04:34:00,22040.0,BUY,3,0.02h,Stop Loss,$-9.00,$-90.00,$225452.00,377,$-90.00
2025-06-12,04:35:00,21814.25,SELL,3,0.02h,Stop Loss,$4.50,$-85.50,$225456.50,377,$-85.50
2025-06-12,04:40:00,22032.75,BUY,3,0.02h,Stop Loss,$-9.00,$-94.50,$225447.50,377,$-94.50
2025-06-12,04:41:00,21812.0,SELL,3,0.02h,Stop Loss,$-9.00,$-103.50,$225438.50,377,$-103.50
2025-06-12,04:45:00,22042.0,BUY,3,0.02h,Stop Loss,$-9.00,$-112.50,$225429.50,377,$-112.50
2025-06-12,04:46:00,21818.0,SELL,3,0.03h,Stop Loss,$-9.00,$-121.50,$225420.50,377,$-121.50
2025-06-12,04:56:00,22051.75,BUY,3,0.08h,Stop Loss,$3.00,$-118.50,$225423.50,377,$-118.50
2025-06-12,05:03:00,21828.25,SELL,3,0.02h,Break Even,$-1.50,$-120.00,$225422.00,377,$-120.00
2025-06-12,05:05:00,22047.25,BUY,3,0.05h,Break Even,$-1.50,$-121.50,$225420.50,377,$-121.50
2025-06-12,05:12:00,21822.75,SELL,3,0.02h,Stop Loss,$-9.00,$-130.50,$225411.50,377,$-130.50
2025-06-12,05:16:00,22060.0,BUY,3,0.02h,Stop Loss,$-9.00,$-139.50,$225402.50,377,$-139.50
2025-06-12,05:19:00,21826.5,SELL,3,0.02h,Stop Loss,$13.50,$-126.00,$225416.00,377,$-126.00
2025-06-12,05:29:00,22061.25,BUY,3,0.02h,Stop Loss,$-9.00,$-135.00,$225407.00,377,$-135.00
2025-06-12,05:35:00,21835.0,SELL,3,0.02h,Stop Loss,$-9.00,$-144.00,$225398.00,377,$-144.00
2025-06-12,05:36:00,22062.5,BUY,3,0.02h,Stop Loss,$-9.00,$-153.00,$225389.00,377,$-153.00
2025-06-12,05:46:00,21812.25,SELL,3,0.02h,Break Even,$-1.50,$-154.50,$225387.50,377,$-154.50
2025-06-12,05:59:00,22054.0,BUY,3,0.02h,Stop Loss,$-9.00,$-163.50,$225378.50,377,$-163.50
2025-06-12,06:00:00,21827.0,SELL,3,0.02h,Stop Loss,$-9.00,$-172.50,$225369.50,377,$-172.50
2025-06-12,06:01:00,22045.25,BUY,3,0.02h,Stop Loss,$-9.00,$-181.50,$225360.50,377,$-181.50
2025-06-12,06:09:00,21820.75,SELL,3,0.02h,Stop Loss,$9.00,$-172.50,$225369.50,377,$-172.50
2025-06-12,06:19:00,22056.5,BUY,3,0.05h,Stop Loss,$7.50,$-165.00,$225377.00,377,$-165.00
2025-06-12,06:26:00,21831.75,SELL,3,0.02h,Stop Loss,$-9.00,$-174.00,$225368.00,377,$-174.00
2025-06-12,06:36:00,22061.75,BUY,3,0.02h,Stop Loss,$-9.00,$-183.00,$225359.00,377,$-183.00
2025-06-12,06:37:00,21834.0,SELL,3,0.02h,Stop Loss,$-9.00,$-192.00,$225350.00,377,$-192.00
2025-06-12,06:39:00,22064.5,BUY,3,0.02h,Stop Loss,$-9.00,$-201.00,$225341.00,377,$-201.00
2025-06-12,06:40:00,21834.75,SELL,3,0.02h,Stop Loss,$-9.00,$-210.00,$225332.00,377,$-210.00
2025-06-12,06:41:00,22060.5,BUY,3,0.02h,Stop Loss,$-9.00,$-219.00,$225323.00,377,$-219.00
2025-06-12,06:42:00,21837.0,SELL,3,0.02h,Stop Loss,$-9.00,$-228.00,$225314.00,377,$-228.00
2025-06-12,06:46:00,22063.25,BUY,3,0.02h,Stop Loss,$-9.00,$-237.00,$225305.00,377,$-237.00
2025-06-12,06:47:00,21832.0,SELL,3,0.02h,Break Even,$-1.50,$-238.50,$225303.50,377,$-238.50
2025-06-12,06:55:00,22068.5,BUY,3,0.02h,Stop Loss,$-9.00,$-247.50,$225294.50,377,$-247.50
2025-06-12,06:59:00,21841.5,SELL,3,0.02h,Stop Loss,$10.50,$-237.00,$225305.00,377,$-237.00
2025-06-12,07:01:00,22064.75,BUY,3,0.02h,Stop Loss,$49.50,$-187.50,$225354.50,377,$-187.50
2025-06-12,07:13:00,21852.5,SELL,3,0.02h,Stop Loss,$3.00,$-184.50,$225357.50,377,$-184.50
2025-06-12,07:22:00,22073.0,BUY,3,0.02h,Stop Loss,$6.00,$-178.50,$225363.50,377,$-178.50
2025-06-12,07:27:00,21850.25,SELL,3,0.02h,Stop Loss,$60.00,$-118.50,$225423.50,377,$-118.50
2025-06-12,07:29:00,22068.5,BUY,3,0.02h,Stop Loss,$-9.00,$-127.50,$225414.50,377,$-127.50
2025-06-12,07:30:00,21836.25,SELL,3,0.02h,Stop Loss,$46.50,$-81.00,$225461.00,377,$-81.00
2025-06-12,07:37:00,22050.0,BUY,3,0.02h,Stop Loss,$-9.00,$-90.00,$225452.00,377,$-90.00
2025-06-12,07:38:00,21820.75,SELL,3,0.02h,Stop Loss,$-9.00,$-99.00,$225443.00,377,$-99.00
2025-06-12,07:39:00,22044.5,BUY,3,0.02h,Stop Loss,$12.00,$-87.00,$225455.00,377,$-87.00
2025-06-12,07:52:00,21784.5,SELL,3,0.02h,Stop Loss,$19.50,$-67.50,$225474.50,377,$-67.50
2025-06-12,08:17:00,21969.25,BUY,3,0.02h,Stop Loss,$-9.00,$-76.50,$225465.50,377,$-76.50
2025-06-12,08:18:00,21745.75,SELL,3,0.02h,Stop Loss,$-9.00,$-85.50,$225456.50,377,$-85.50
2025-06-12,08:19:00,21960.5,BUY,3,0.02h,Stop Loss,$49.50,$-36.00,$225506.00,377,$-36.00
2025-06-12,08:33:00,21746.5,SELL,3,0.02h,Stop Loss,$-9.00,$-45.00,$225497.00,377,$-45.00
2025-06-12,08:43:00,21983.5,BUY,3,0.02h,Stop Loss,$-9.00,$-54.00,$225488.00,377,$-54.00
2025-06-12,08:44:00,21772.5,SELL,3,0.02h,Stop Loss,$18.00,$-36.00,$225506.00,377,$-36.00
2025-06-12,08:51:00,22012.75,BUY,3,0.02h,Break Even,$-1.50,$-37.50,$225504.50,377,$-37.50
2025-06-12,08:55:00,21795.25,SELL,3,0.02h,Stop Loss,$-9.00,$-46.50,$225495.50,377,$-46.50
2025-06-12,08:57:00,22026.25,BUY,3,0.02h,Stop Loss,$-9.00,$-55.50,$225486.50,377,$-55.50
2025-06-12,08:59:00,21797.5,SELL,3,0.02h,Stop Loss,$-9.00,$-64.50,$225477.50,377,$-64.50
2025-06-12,09:01:00,22023.5,BUY,3,0.02h,Stop Loss,$-9.00,$-73.50,$225468.50,377,$-73.50
2025-06-12,09:03:00,21804.0,SELL,3,0.02h,Stop Loss,$-9.00,$-82.50,$225459.50,377,$-82.50
2025-06-12,09:07:00,22035.0,BUY,3,0.02h,Stop Loss,$18.00,$-64.50,$225477.50,377,$-64.50
2025-06-12,09:18:00,21804.5,SELL,3,0.02h,Stop Loss,$4.50,$-60.00,$225482.00,377,$-60.00
2025-06-12,09:20:00,22031.5,BUY,3,0.03h,Stop Loss,$10.50,$-49.50,$225492.50,377,$-49.50
2025-06-12,09:25:00,21803.25,SELL,3,0.02h,Break Even,$-1.50,$-51.00,$225491.00,377,$-51.00
2025-06-12,09:32:00,22038.5,BUY,3,0.03h,Stop Loss,$31.50,$-19.50,$225522.50,377,$-19.50
2025-06-12,09:39:00,21836.5,SELL,3,0.02h,Stop Loss,$13.50,$-6.00,$225536.00,377,$-6.00
2025-06-12,09:47:00,22046.75,BUY,3,0.03h,Stop Loss,$25.50,$19.50,$225561.50,377,$19.50
2025-06-12,10:07:00,21809.75,SELL,3,0.02h,Stop Loss,$-9.00,$10.50,$225552.50,377,$10.50
2025-06-12,10:09:00,22025.0,BUY,3,0.02h,Stop Loss,$-9.00,$1.50,$225543.50,377,$1.50
2025-06-12,10:10:00,21799.0,SELL,3,0.02h,Stop Loss,$-9.00,$-7.50,$225534.50,377,$-7.50
2025-06-12,10:13:00,22010.5,BUY,3,0.02h,Stop Loss,$-9.00,$-16.50,$225525.50,377,$-16.50
2025-06-12,10:15:00,21797.5,SELL,3,0.02h,Stop Loss,$-9.00,$-25.50,$225516.50,377,$-25.50
2025-06-12,10:38:00,22014.5,BUY,3,0.02h,Stop Loss,$3.00,$-22.50,$225519.50,377,$-22.50
2025-06-12,10:52:00,21816.5,SELL,3,0.02h,Stop Loss,$13.50,$-9.00,$225533.00,377,$-9.00
2025-06-12,10:54:00,22038.25,BUY,3,0.03h,Stop Loss,$36.00,$27.00,$225569.00,377,$27.00
2025-06-12,11:08:00,21796.75,SELL,3,0.02h,Stop Loss,$-9.00,$18.00,$225560.00,377,$18.00
2025-06-12,11:10:00,22025.0,BUY,3,0.02h,Stop Loss,$-9.00,$9.00,$225551.00,377,$9.00
2025-06-12,11:11:00,21798.0,SELL,3,0.02h,Stop Loss,$10.50,$19.50,$225561.50,377,$19.50
2025-06-12,11:14:00,22019.0,BUY,3,0.02h,Stop Loss,$-9.00,$10.50,$225552.50,377,$10.50
2025-06-12,11:17:00,21783.5,SELL,3,0.02h,Break Even,$-1.50,$9.00,$225551.00,377,$9.00
2025-06-12,11:22:00,22007.5,BUY,3,0.02h,Stop Loss,$-9.00,$0.00,$225542.00,377,$0.00
2025-06-12,11:24:00,21780.0,SELL,3,0.02h,Stop Loss,$-9.00,$-9.00,$225533.00,377,$-9.00
2025-06-12,11:27:00,22007.0,BUY,3,0.03h,Stop Loss,$-9.00,$-18.00,$225524.00,377,$-18.00
2025-06-12,11:32:00,21768.0,SELL,3,0.02h,Stop Loss,$22.50,$4.50,$225546.50,377,$4.50
2025-06-12,11:46:00,22001.0,BUY,3,0.02h,Stop Loss,$-9.00,$-4.50,$225537.50,377,$-4.50
2025-06-12,11:47:00,21773.5,SELL,3,0.02h,Stop Loss,$-9.00,$-13.50,$225528.50,377,$-13.50
2025-06-12,11:48:00,21993.75,BUY,3,0.02h,Stop Loss,$4.50,$-9.00,$225533.00,377,$-9.00
2025-06-12,11:53:00,21748.5,SELL,3,0.02h,Stop Loss,$13.50,$4.50,$225546.50,377,$4.50
2025-06-12,11:58:00,21961.0,BUY,3,0.02h,Stop Loss,$21.00,$25.50,$225567.50,377,$25.50
2025-06-12,12:05:00,21748.0,SELL,3,0.02h,Break Even,$-1.50,$24.00,$225566.00,377,$24.00
2025-06-12,12:10:00,21983.75,BUY,3,0.03h,Stop Loss,$42.00,$66.00,$225608.00,377,$66.00
2025-06-12,12:15:00,21769.75,SELL,3,0.02h,Stop Loss,$6.00,$72.00,$225614.00,377,$72.00
2025-06-12,12:24:00,21989.25,BUY,3,0.02h,Break Even,$-1.50,$70.50,$225612.50,377,$70.50
2025-06-12,12:33:00,21797.25,SELL,3,0.02h,Stop Loss,$66.00,$136.50,$225678.50,377,$136.50
2025-06-12,12:37:00,22049.5,BUY,3,0.02h,Stop Loss,$-9.00,$127.50,$225669.50,377,$127.50
2025-06-12,12:38:00,21824.0,SELL,3,0.02h,Stop Loss,$27.00,$154.50,$225696.50,377,$154.50
2025-06-12,12:45:00,22062.75,BUY,3,0.02h,Stop Loss,$-9.00,$145.50,$225687.50,377,$145.50
2025-06-12,12:55:00,21832.25,SELL,3,0.02h,Stop Loss,$-9.00,$136.50,$225678.50,377,$136.50
2025-06-12,12:56:00,22066.25,BUY,3,0.02h,Stop Loss,$-9.00,$127.50,$225669.50,377,$127.50
2025-06-12,12:58:00,21838.25,SELL,3,0.02h,Stop Loss,$-9.00,$118.50,$225660.50,377,$118.50
2025-06-12,13:06:00,22061.25,BUY,3,0.02h,Stop Loss,$-9.00,$109.50,$225651.50,377,$109.50
2025-06-12,13:09:00,21830.0,SELL,3,0.02h,Break Even,$-1.50,$108.00,$225650.00,377,$108.00
2025-06-12,13:17:00,22055.25,BUY,3,0.02h,Stop Loss,$19.50,$127.50,$225669.50,377,$127.50
2025-06-12,13:24:00,21832.5,SELL,3,0.02h,Stop Loss,$-9.00,$118.50,$225660.50,377,$118.50
2025-06-12,13:25:00,22055.0,BUY,3,0.02h,Stop Loss,$3.00,$121.50,$225663.50,377,$121.50
2025-06-12,13:47:00,21874.5,SELL,3,0.02h,Stop Loss,$10.50,$132.00,$225674.00,377,$132.00
2025-06-12,13:51:00,22103.25,BUY,3,0.02h,Break Even,$-1.50,$130.50,$225672.50,377,$130.50
2025-06-12,14:04:00,21846.0,SELL,3,0.02h,Stop Loss,$10.50,$141.00,$225683.00,377,$141.00
2025-06-12,14:12:00,22117.75,BUY,3,0.02h,Stop Loss,$58.50,$199.50,$225741.50,377,$199.50
2025-06-12,14:16:00,21920.75,SELL,3,0.02h,Stop Loss,$45.00,$244.50,$225786.50,377,$244.50
2025-06-12,14:18:00,22148.75,BUY,3,0.02h,Stop Loss,$-9.00,$235.50,$225777.50,377,$235.50
2025-06-12,14:19:00,21911.5,SELL,3,0.02h,Stop Loss,$-9.00,$226.50,$225768.50,377,$226.50
2025-06-12,14:20:00,22142.25,BUY,3,0.02h,Stop Loss,$-9.00,$217.50,$225759.50,377,$217.50
2025-06-12,14:21:00,21915.25,SELL,3,0.02h,Stop Loss,$22.50,$240.00,$225782.00,377,$240.00
2025-06-12,14:26:00,22132.5,BUY,3,0.02h,Stop Loss,$24.00,$264.00,$225806.00,377,$264.00
2025-06-12,14:41:00,21944.25,SELL,3,0.02h,Stop Loss,$9.00,$273.00,$225815.00,377,$273.00
2025-06-12,14:51:00,22169.75,BUY,3,0.02h,Stop Loss,$-9.00,$264.00,$225806.00,377,$264.00
2025-06-12,14:52:00,21934.0,SELL,3,0.02h,Stop Loss,$-9.00,$255.00,$225797.00,377,$255.00
2025-06-12,14:53:00,22160.5,BUY,3,0.02h,Stop Loss,$-9.00,$246.00,$225788.00,377,$246.00
2025-06-12,14:54:00,21937.25,SELL,3,0.02h,Break Even,$-1.50,$244.50,$225786.50,377,$244.50
2025-06-12,14:56:00,22166.0,BUY,3,0.02h,Stop Loss,$-9.00,$235.50,$225777.50,377,$235.50
2025-06-12,14:57:00,21938.5,SELL,3,0.02h,Stop Loss,$36.00,$271.50,$225813.50,377,$271.50
2025-06-12,14:59:00,22160.5,BUY,3,0.02h,Stop Loss,$-9.00,$262.50,$225804.50,377,$262.50
2025-06-12,15:00:00,21933.5,SELL,3,0.02h,Stop Loss,$-9.00,$253.50,$225795.50,377,$253.50
2025-06-12,15:02:00,22186.5,BUY,3,0.02h,Stop Loss,$54.00,$307.50,$225849.50,377,$307.50
2025-06-12,15:17:00,21942.75,SELL,3,0.02h,Stop Loss,$-9.00,$298.50,$225840.50,377,$298.50
2025-06-12,15:18:00,22151.0,BUY,3,0.02h,Stop Loss,$-9.00,$289.50,$225831.50,377,$289.50
2025-06-12,15:19:00,21920.0,SELL,3,0.02h,Stop Loss,$-9.00,$280.50,$225822.50,377,$280.50
2025-06-12,15:37:00,22138.25,BUY,3,0.02h,Stop Loss,$-9.00,$271.50,$225813.50,377,$271.50
2025-06-12,15:45:00,21921.75,SELL,3,0.02h,Stop Loss,$85.50,$357.00,$225899.00,377,$357.00
2025-06-12,15:52:00,22125.75,BUY,3,0.02h,Stop Loss,$37.50,$394.50,$225936.50,377,$394.50
2025-06-12,16:02:00,21941.0,SELL,3,0.02h,Stop Loss,$15.00,$409.50,$225951.50,377,$409.50
2025-06-12,16:04:00,22153.75,BUY,3,0.02h,Stop Loss,$-9.00,$400.50,$225942.50,377,$400.50
2025-06-12,16:06:00,21918.0,SELL,3,0.02h,Break Even,$-1.50,$399.00,$225941.00,377,$399.00
2025-06-12,16:13:00,22166.5,BUY,3,0.02h,Stop Loss,$39.00,$438.00,$225980.00,377,$438.00
2025-06-12,16:18:00,21945.5,SELL,3,0.02h,Stop Loss,$-9.00,$429.00,$225971.00,377,$429.00
2025-06-12,16:19:00,22161.0,BUY,3,0.02h,Stop Loss,$-9.00,$420.00,$225962.00,377,$420.00
2025-06-12,16:20:00,21940.75,SELL,3,0.02h,Stop Loss,$-9.00,$411.00,$225953.00,377,$411.00
2025-06-12,16:21:00,22171.0,BUY,3,0.02h,Stop Loss,$-9.00,$402.00,$225944.00,377,$402.00
2025-06-12,16:32:00,21923.25,SELL,3,0.02h,Stop Loss,$13.50,$415.50,$225957.50,377,$415.50
2025-06-12,16:37:00,22175.0,BUY,3,0.02h,Stop Loss,$-9.00,$406.50,$225948.50,377,$406.50
2025-06-12,16:38:00,21942.75,SELL,3,0.02h,Stop Loss,$-9.00,$397.50,$225939.50,377,$397.50
2025-06-12,16:39:00,22174.0,BUY,3,0.02h,Stop Loss,$-9.00,$388.50,$225930.50,377,$388.50
2025-06-12,16:40:00,21961.0,SELL,3,0.02h,Stop Loss,$-9.00,$379.50,$225921.50,377,$379.50
2025-06-12,16:41:00,22190.75,BUY,3,0.02h,Stop Loss,$-9.00,$370.50,$225912.50,377,$370.50
2025-06-12,16:49:00,21950.75,SELL,3,0.02h,Stop Loss,$34.50,$405.00,$225947.00,377,$405.00
2025-06-12,16:52:00,22161.5,BUY,3,0.02h,Stop Loss,$-9.00,$396.00,$225938.00,377,$396.00
2025-06-12,16:55:00,21928.25,SELL,3,0.02h,Stop Loss,$-9.00,$387.00,$225929.00,377,$387.00
2025-06-12,16:56:00,22153.75,BUY,3,0.02h,Stop Loss,$-9.00,$378.00,$225920.00,377,$378.00
2025-06-12,16:57:00,21929.0,SELL,3,0.02h,Stop Loss,$-9.00,$369.00,$225911.00,377,$369.00
2025-06-12,17:06:00,22160.0,BUY,3,0.03h,Stop Loss,$9.00,$378.00,$225920.00,377,$378.00
2025-06-12,17:09:00,21947.5,SELL,3,0.02h,Stop Loss,$-9.00,$369.00,$225911.00,377,$369.00
2025-06-12,17:10:00,22174.25,BUY,3,0.02h,Stop Loss,$43.50,$412.50,$225954.50,377,$412.50
2025-06-12,17:14:00,21948.0,SELL,3,0.02h,Stop Loss,$3.00,$415.50,$225957.50,377,$415.50
2025-06-12,17:16:00,22176.5,BUY,3,0.02h,Stop Loss,$-9.00,$406.50,$225948.50,377,$406.50
2025-06-12,17:17:00,21948.0,SELL,3,0.02h,Break Even,$-1.50,$405.00,$225947.00,377,$405.00
2025-06-12,17:20:00,22178.5,BUY,3,0.02h,Stop Loss,$-9.00,$396.00,$225938.00,377,$396.00
2025-06-12,17:21:00,21951.0,SELL,3,0.02h,Stop Loss,$-9.00,$387.00,$225929.00,377,$387.00
2025-06-12,17:23:00,22176.75,BUY,3,0.02h,Stop Loss,$-9.00,$378.00,$225920.00,377,$378.00
2025-06-12,17:24:00,21944.25,SELL,3,0.02h,Stop Loss,$6.00,$384.00,$225926.00,377,$384.00
2025-06-12,17:29:00,22162.0,BUY,3,0.02h,Stop Loss,$-9.00,$375.00,$225917.00,377,$375.00
2025-06-12,17:37:00,21961.5,SELL,3,0.02h,Break Even,$-1.50,$373.50,$225915.50,377,$373.50
2025-06-12,17:43:00,22178.5,BUY,3,0.02h,Stop Loss,$3.00,$376.50,$225918.50,377,$376.50
2025-06-12,17:45:00,21953.5,SELL,3,0.02h,Stop Loss,$30.00,$406.50,$225948.50,377,$406.50
2025-06-12,17:47:00,22175.25,BUY,3,0.02h,Stop Loss,$-9.00,$397.50,$225939.50,377,$397.50
2025-06-12,17:48:00,21949.75,SELL,3,0.02h,Stop Loss,$-9.00,$388.50,$225930.50,377,$388.50
2025-06-12,17:49:00,22167.0,BUY,3,0.02h,Stop Loss,$-9.00,$379.50,$225921.50,377,$379.50
2025-06-12,17:59:00,21940.75,SELL,3,0.02h,Stop Loss,$-9.00,$370.50,$225912.50,377,$370.50
2025-06-12,18:00:00,22161.0,BUY,3,0.02h,Stop Loss,$-9.00,$361.50,$225903.50,377,$361.50
2025-06-12,18:01:00,21938.75,SELL,3,0.02h,Break Even,$-1.50,$360.00,$225902.00,377,$360.00
2025-06-12,18:08:00,22171.75,BUY,3,0.02h,Stop Loss,$-9.00,$351.00,$225893.00,377,$351.00
2025-06-12,18:15:00,21936.75,SELL,3,0.02h,Stop Loss,$-9.00,$342.00,$225884.00,377,$342.00
2025-06-12,18:25:00,22148.75,BUY,3,0.02h,Stop Loss,$-9.00,$333.00,$225875.00,377,$333.00
2025-06-12,18:26:00,21926.25,SELL,3,0.02h,Stop Loss,$16.50,$349.50,$225891.50,377,$349.50
2025-06-12,18:37:00,22155.0,BUY,3,0.02h,Stop Loss,$-9.00,$340.50,$225882.50,377,$340.50
2025-06-12,18:38:00,21918.25,SELL,3,0.02h,Stop Loss,$10.50,$351.00,$225893.00,377,$351.00
2025-06-12,18:41:00,22153.0,BUY,3,0.02h,Stop Loss,$-9.00,$342.00,$225884.00,377,$342.00
2025-06-12,18:42:00,21922.75,SELL,3,0.02h,Stop Loss,$6.00,$348.00,$225890.00,377,$348.00
2025-06-12,18:44:00,22137.5,BUY,3,0.02h,Stop Loss,$-9.00,$339.00,$225881.00,377,$339.00
2025-06-12,18:48:00,21918.0,SELL,3,0.02h,Stop Loss,$-9.00,$330.00,$225872.00,377,$330.00
2025-06-12,18:50:00,22146.25,BUY,3,0.02h,Stop Loss,$-9.00,$321.00,$225863.00,377,$321.00
2025-06-12,18:59:00,21932.5,SELL,3,0.02h,Stop Loss,$-9.00,$312.00,$225854.00,377,$312.00
2025-06-12,19:06:00,22167.5,BUY,3,0.02h,Stop Loss,$-9.00,$303.00,$225845.00,377,$303.00
2025-06-12,19:07:00,21944.5,SELL,3,0.02h,Stop Loss,$-9.00,$294.00,$225836.00,377,$294.00
2025-06-12,19:08:00,22167.5,BUY,3,0.02h,Stop Loss,$-9.00,$285.00,$225827.00,377,$285.00
2025-06-12,19:20:00,21949.25,SELL,3,0.02h,Stop Loss,$4.50,$289.50,$225831.50,377,$289.50
2025-06-12,19:24:00,22163.75,BUY,3,0.02h,Stop Loss,$-9.00,$280.50,$225822.50,377,$280.50
2025-06-12,19:25:00,21938.25,SELL,3,0.02h,Stop Loss,$28.50,$309.00,$225851.00,377,$309.00
2025-06-12,19:29:00,22160.0,BUY,3,0.03h,Break Even,$-1.50,$307.50,$225849.50,377,$307.50
2025-06-12,19:36:00,21924.5,SELL,3,0.02h,Stop Loss,$-9.00,$298.50,$225840.50,377,$298.50
2025-06-12,19:48:00,22133.0,BUY,3,0.02h,Break Even,$-1.50,$297.00,$225839.00,377,$297.00
2025-06-12,19:54:00,21901.5,SELL,3,0.02h,Stop Loss,$36.00,$333.00,$225875.00,377,$333.00
2025-06-12,20:01:00,22158.75,BUY,3,0.02h,Stop Loss,$12.00,$345.00,$225887.00,377,$345.00
2025-06-12,20:13:00,21933.25,SELL,3,0.02h,Stop Loss,$-9.00,$336.00,$225878.00,377,$336.00
2025-06-12,20:14:00,22158.25,BUY,3,0.02h,Stop Loss,$-9.00,$327.00,$225869.00,377,$327.00
2025-06-12,20:16:00,21928.0,SELL,3,0.02h,Break Even,$-1.50,$325.50,$225867.50,377,$325.50
2025-06-12,20:29:00,22139.5,BUY,3,0.02h,Stop Loss,$-9.00,$316.50,$225858.50,377,$316.50
2025-06-12,20:30:00,21913.25,SELL,3,0.02h,Stop Loss,$-9.00,$307.50,$225849.50,377,$307.50
2025-06-12,20:31:00,22135.25,BUY,3,0.03h,Stop Loss,$7.50,$315.00,$225857.00,377,$315.00
2025-06-12,20:38:00,21922.0,SELL,3,0.02h,Break Even,$-1.50,$313.50,$225855.50,377,$313.50
2025-06-12,20:43:00,22143.0,BUY,3,0.02h,Stop Loss,$-9.00,$304.50,$225846.50,377,$304.50
2025-06-12,20:44:00,21917.0,SELL,3,0.02h,Stop Loss,$3.00,$307.50,$225849.50,377,$307.50
2025-06-12,20:46:00,22140.5,BUY,3,0.03h,Break Even,$-1.50,$306.00,$225848.00,377,$306.00
2025-06-12,20:54:00,21913.0,SELL,3,0.02h,Stop Loss,$4.50,$310.50,$225852.50,377,$310.50
2025-06-12,20:58:00,22137.75,BUY,3,0.02h,Stop Loss,$-9.00,$301.50,$225843.50,377,$301.50
2025-06-12,20:59:00,21909.5,SELL,3,0.02h,Stop Loss,$-9.00,$292.50,$225834.50,377,$292.50
2025-06-12,21:00:00,22133.25,BUY,3,2.00h,Stop Loss,$-9.00,$283.50,$225825.50,377,$283.50
2025-06-12,23:00:00,21880.75,SELL,3,0.02h,Stop Loss,$-9.00,$274.50,$225816.50,377,$274.50
2025-06-12,23:01:00,22104.75,BUY,3,0.02h,Stop Loss,$-9.00,$265.50,$225807.50,377,$265.50
2025-06-12,23:02:00,21877.0,SELL,3,0.02h,Stop Loss,$-9.00,$256.50,$225798.50,377,$256.50
2025-06-12,23:08:00,22106.25,BUY,3,0.02h,Break Even,$-1.50,$255.00,$225797.00,377,$255.00
2025-06-12,23:15:00,21882.25,SELL,3,0.02h,Stop Loss,$-9.00,$246.00,$225788.00,377,$246.00
2025-06-12,23:18:00,22108.0,BUY,3,0.02h,Stop Loss,$-9.00,$237.00,$225779.00,377,$237.00
2025-06-12,23:19:00,21881.5,SELL,3,0.02h,Stop Loss,$-9.00,$228.00,$225770.00,377,$228.00
2025-06-12,23:20:00,22105.5,BUY,3,0.02h,Stop Loss,$-9.00,$219.00,$225761.00,377,$219.00
2025-06-12,23:21:00,21881.5,SELL,3,0.02h,Stop Loss,$-9.00,$210.00,$225752.00,377,$210.00
2025-06-12,23:37:00,22097.25,BUY,3,0.03h,Break Even,$-1.50,$208.50,$225750.50,377,$208.50
2025-06-12,23:41:00,21881.5,SELL,3,0.02h,Stop Loss,$-9.00,$199.50,$225741.50,377,$199.50
2025-06-12,23:42:00,22089.25,BUY,3,0.02h,Stop Loss,$63.00,$262.50,$225804.50,377,$262.50
2025-06-12,23:51:00,21871.5,SELL,3,0.02h,Break Even,$-1.50,$261.00,$225803.00,377,$261.00
2025-06-12,23:54:00,22090.5,BUY,3,0.02h,Stop Loss,$-9.00,$252.00,$225794.00,377,$252.00
2025-06-12,23:55:00,21867.5,SELL,3,0.02h,Stop Loss,$-9.00,$243.00,$225785.00,377,$243.00
,,,,,,,,,,,
2025-06-13,00:16:00,21919.25,BUY,3,0.02h,Stop Loss,$12.00,$12.00,$225797.00,378,$12.00
2025-06-13,00:19:00,21856.5,SELL,3,0.02h,Stop Loss,$1465.50,$1477.50,$227262.50,378,$1477.50
2025-06-13,00:55:00,21750.0,BUY,3,0.02h,Stop Loss,$58.50,$1536.00,$227321.00,378,$1536.00
2025-06-13,01:05:00,21530.75,SELL,3,0.02h,Break Even,$-1.50,$1534.50,$227319.50,378,$1534.50
2025-06-13,01:12:00,21736.5,BUY,3,0.02h,Stop Loss,$-9.00,$1525.50,$227310.50,378,$1525.50
2025-06-13,01:13:00,21510.75,SELL,3,0.02h,Stop Loss,$-9.00,$1516.50,$227301.50,378,$1516.50
2025-06-13,01:15:00,21733.25,BUY,3,0.02h,Stop Loss,$63.00,$1579.50,$227364.50,378,$1579.50
2025-06-13,01:17:00,21525.5,SELL,3,0.02h,Stop Loss,$18.00,$1597.50,$227382.50,378,$1597.50
2025-06-13,01:24:00,21770.25,BUY,3,0.02h,Stop Loss,$-9.00,$1588.50,$227373.50,378,$1588.50
2025-06-13,01:25:00,21550.5,SELL,3,0.02h,Stop Loss,$4.50,$1593.00,$227378.00,378,$1593.00
2025-06-13,01:28:00,21776.25,BUY,3,0.02h,Stop Loss,$-9.00,$1584.00,$227369.00,378,$1584.00
2025-06-13,01:29:00,21535.75,SELL,3,0.02h,Stop Loss,$-9.00,$1575.00,$227360.00,378,$1575.00
2025-06-13,01:30:00,21754.75,BUY,3,0.02h,Stop Loss,$-9.00,$1566.00,$227351.00,378,$1566.00
2025-06-13,01:39:00,21580.75,SELL,3,0.02h,Stop Loss,$-9.00,$1557.00,$227342.00,378,$1557.00
2025-06-13,01:40:00,21789.5,BUY,3,0.02h,Stop Loss,$-9.00,$1548.00,$227333.00,378,$1548.00
2025-06-13,01:41:00,21565.5,SELL,3,0.02h,Stop Loss,$42.00,$1590.00,$227375.00,378,$1590.00
2025-06-13,01:49:00,21802.5,BUY,3,0.02h,Stop Loss,$-9.00,$1581.00,$227366.00,378,$1581.00
2025-06-13,01:50:00,21581.5,SELL,3,0.02h,Stop Loss,$36.00,$1617.00,$227402.00,378,$1617.00
2025-06-13,01:52:00,21796.5,BUY,3,0.02h,Stop Loss,$19.50,$1636.50,$227421.50,378,$1636.50
2025-06-13,02:01:00,21600.75,SELL,3,0.02h,Stop Loss,$54.00,$1690.50,$227475.50,378,$1690.50
2025-06-13,02:06:00,21797.75,BUY,3,0.02h,Break Even,$-1.50,$1689.00,$227474.00,378,$1689.00
2025-06-13,02:14:00,21581.25,SELL,3,0.02h,Stop Loss,$15.00,$1704.00,$227489.00,378,$1704.00
2025-06-13,02:19:00,21802.75,BUY,3,0.02h,Stop Loss,$-9.00,$1695.00,$227480.00,378,$1695.00
2025-06-13,02:20:00,21575.5,SELL,3,0.02h,Stop Loss,$37.50,$1732.50,$227517.50,378,$1732.50
2025-06-13,02:24:00,21786.5,BUY,3,0.02h,Stop Loss,$-9.00,$1723.50,$227508.50,378,$1723.50
2025-06-13,02:26:00,21549.25,SELL,3,0.02h,Stop Loss,$-9.00,$1714.50,$227499.50,378,$1714.50
2025-06-13,02:40:00,21743.75,BUY,3,0.02h,Stop Loss,$-9.00,$1705.50,$227490.50,378,$1705.50
2025-06-13,02:41:00,21516.5,SELL,3,0.02h,Stop Loss,$-9.00,$1696.50,$227481.50,378,$1696.50
2025-06-13,02:42:00,21724.75,BUY,3,0.02h,Stop Loss,$-9.00,$1687.50,$227472.50,378,$1687.50
2025-06-13,02:43:00,21485.75,SELL,3,0.02h,Stop Loss,$64.50,$1752.00,$227537.00,378,$1752.00
2025-06-13,02:47:00,21738.25,BUY,3,0.02h,Stop Loss,$-9.00,$1743.00,$227528.00,378,$1743.00
2025-06-13,02:56:00,21507.0,SELL,3,0.02h,Break Even,$-1.50,$1741.50,$227526.50,378,$1741.50
2025-06-13,03:00:00,21749.5,BUY,3,0.02h,Stop Loss,$-9.00,$1732.50,$227517.50,378,$1732.50
2025-06-13,03:01:00,21527.25,SELL,3,0.02h,Break Even,$-1.50,$1731.00,$227516.00,378,$1731.00
2025-06-13,03:13:00,21771.5,BUY,3,0.02h,Stop Loss,$-9.00,$1722.00,$227507.00,378,$1722.00
2025-06-13,03:19:00,21565.75,SELL,3,0.02h,Break Even,$-1.50,$1720.50,$227505.50,378,$1720.50
2025-06-13,03:24:00,21771.5,BUY,3,0.02h,Stop Loss,$-9.00,$1711.50,$227496.50,378,$1711.50
2025-06-13,03:31:00,21555.75,SELL,3,0.02h,Stop Loss,$-9.00,$1702.50,$227487.50,378,$1702.50
2025-06-13,03:34:00,21773.5,BUY,3,0.02h,Stop Loss,$-9.00,$1693.50,$227478.50,378,$1693.50
2025-06-13,03:39:00,21559.25,SELL,3,0.02h,Stop Loss,$7.50,$1701.00,$227486.00,378,$1701.00
2025-06-13,03:41:00,21774.5,BUY,3,0.02h,Stop Loss,$-9.00,$1692.00,$227477.00,378,$1692.00
2025-06-13,03:49:00,21556.0,SELL,3,0.02h,Stop Loss,$-9.00,$1683.00,$227468.00,378,$1683.00
2025-06-13,03:50:00,21776.75,BUY,3,0.02h,Stop Loss,$-9.00,$1674.00,$227459.00,378,$1674.00
2025-06-13,03:52:00,21572.25,SELL,3,0.02h,Stop Loss,$-9.00,$1665.00,$227450.00,378,$1665.00
2025-06-13,03:53:00,21784.0,BUY,3,0.02h,Stop Loss,$-9.00,$1656.00,$227441.00,378,$1656.00
2025-06-13,04:03:00,21552.75,SELL,3,0.02h,Break Even,$-1.50,$1654.50,$227439.50,378,$1654.50
2025-06-13,04:05:00,21775.0,BUY,3,0.02h,Stop Loss,$-9.00,$1645.50,$227430.50,378,$1645.50
2025-06-13,04:07:00,21554.5,SELL,3,0.02h,Stop Loss,$27.00,$1672.50,$227457.50,378,$1672.50
2025-06-13,04:10:00,21765.75,BUY,3,0.02h,Stop Loss,$-9.00,$1663.50,$227448.50,378,$1663.50
2025-06-13,04:11:00,21544.75,SELL,3,0.02h,Stop Loss,$13.50,$1677.00,$227462.00,378,$1677.00
2025-06-13,04:18:00,21758.75,BUY,3,0.02h,Stop Loss,$-9.00,$1668.00,$227453.00,378,$1668.00
2025-06-13,04:24:00,21534.5,SELL,3,0.02h,Stop Loss,$49.50,$1717.50,$227502.50,378,$1717.50
2025-06-13,04:27:00,21746.25,BUY,3,0.02h,Stop Loss,$-9.00,$1708.50,$227493.50,378,$1708.50
2025-06-13,04:28:00,21525.5,SELL,3,0.02h,Break Even,$-1.50,$1707.00,$227492.00,378,$1707.00
2025-06-13,04:32:00,21751.75,BUY,3,0.02h,Stop Loss,$19.50,$1726.50,$227511.50,378,$1726.50
2025-06-13,04:36:00,21540.0,SELL,3,0.02h,Stop Loss,$39.00,$1765.50,$227550.50,378,$1765.50
2025-06-13,04:41:00,21760.75,BUY,3,0.02h,Stop Loss,$-9.00,$1756.50,$227541.50,378,$1756.50
2025-06-13,04:42:00,21547.25,SELL,3,0.02h,Stop Loss,$-9.00,$1747.50,$227532.50,378,$1747.50
2025-06-13,04:43:00,21764.25,BUY,3,0.02h,Break Even,$-1.50,$1746.00,$227531.00,378,$1746.00
2025-06-13,04:47:00,21541.0,SELL,3,0.02h,Stop Loss,$-9.00,$1737.00,$227522.00,378,$1737.00
2025-06-13,04:49:00,21767.25,BUY,3,0.02h,Break Even,$-1.50,$1735.50,$227520.50,378,$1735.50
2025-06-13,04:51:00,21551.25,SELL,3,0.02h,Break Even,$-1.50,$1734.00,$227519.00,378,$1734.00
2025-06-13,04:53:00,21771.75,BUY,3,0.02h,Stop Loss,$-9.00,$1725.00,$227510.00,378,$1725.00
2025-06-13,04:54:00,21549.25,SELL,3,0.02h,Stop Loss,$-9.00,$1716.00,$227501.00,378,$1716.00
2025-06-13,04:55:00,21772.75,BUY,3,0.02h,Stop Loss,$-9.00,$1707.00,$227492.00,378,$1707.00
2025-06-13,04:56:00,21552.75,SELL,3,0.02h,Stop Loss,$22.50,$1729.50,$227514.50,378,$1729.50
2025-06-13,04:58:00,21770.0,BUY,3,0.02h,Stop Loss,$-9.00,$1720.50,$227505.50,378,$1720.50
2025-06-13,04:59:00,21547.0,SELL,3,0.02h,Stop Loss,$30.00,$1750.50,$227535.50,378,$1750.50
2025-06-13,05:10:00,21760.0,BUY,3,0.02h,Stop Loss,$21.00,$1771.50,$227556.50,378,$1771.50
2025-06-13,05:15:00,21551.0,SELL,3,0.02h,Stop Loss,$12.00,$1783.50,$227568.50,378,$1783.50
2025-06-13,05:21:00,21774.5,BUY,3,0.02h,Stop Loss,$-9.00,$1774.50,$227559.50,378,$1774.50
2025-06-13,05:32:00,21548.75,SELL,3,0.02h,Break Even,$-1.50,$1773.00,$227558.00,378,$1773.00
2025-06-13,05:35:00,21771.0,BUY,3,0.02h,Stop Loss,$-9.00,$1764.00,$227549.00,378,$1764.00
2025-06-13,05:36:00,21552.5,SELL,3,0.02h,Stop Loss,$-9.00,$1755.00,$227540.00,378,$1755.00
2025-06-13,05:37:00,21774.0,BUY,3,0.02h,Stop Loss,$-9.00,$1746.00,$227531.00,378,$1746.00
2025-06-13,05:39:00,21555.5,SELL,3,0.02h,Stop Loss,$-9.00,$1737.00,$227522.00,378,$1737.00
2025-06-13,05:40:00,21770.0,BUY,3,0.02h,Stop Loss,$-9.00,$1728.00,$227513.00,378,$1728.00
2025-06-13,05:41:00,21542.25,SELL,3,0.02h,Stop Loss,$21.00,$1749.00,$227534.00,378,$1749.00
2025-06-13,05:50:00,21775.0,BUY,3,0.02h,Stop Loss,$-9.00,$1740.00,$227525.00,378,$1740.00
2025-06-13,05:53:00,21555.5,SELL,3,0.02h,Stop Loss,$-9.00,$1731.00,$227516.00,378,$1731.00
2025-06-13,05:54:00,21783.75,BUY,3,0.02h,Stop Loss,$-9.00,$1722.00,$227507.00,378,$1722.00
2025-06-13,06:08:00,21604.5,SELL,3,0.02h,Stop Loss,$18.00,$1740.00,$227525.00,378,$1740.00
2025-06-13,06:17:00,21805.75,BUY,3,0.02h,Stop Loss,$-9.00,$1731.00,$227516.00,378,$1731.00
2025-06-13,06:21:00,21576.25,SELL,3,0.02h,Break Even,$-1.50,$1729.50,$227514.50,378,$1729.50
2025-06-13,06:26:00,21798.75,BUY,3,0.02h,Stop Loss,$-9.00,$1720.50,$227505.50,378,$1720.50
2025-06-13,06:27:00,21580.25,SELL,3,0.02h,Stop Loss,$54.00,$1774.50,$227559.50,378,$1774.50
2025-06-13,06:36:00,21804.5,BUY,3,0.02h,Stop Loss,$15.00,$1789.50,$227574.50,378,$1789.50
2025-06-13,06:46:00,21574.75,SELL,3,0.02h,Break Even,$-1.50,$1788.00,$227573.00,378,$1788.00
2025-06-13,06:50:00,21821.0,BUY,3,0.02h,Stop Loss,$-9.00,$1779.00,$227564.00,378,$1779.00
2025-06-13,06:51:00,21599.25,SELL,3,0.02h,Stop Loss,$-9.00,$1770.00,$227555.00,378,$1770.00
2025-06-13,06:52:00,21814.25,BUY,3,0.02h,Stop Loss,$28.50,$1798.50,$227583.50,378,$1798.50
2025-06-13,06:57:00,21592.0,SELL,3,0.02h,Stop Loss,$-9.00,$1789.50,$227574.50,378,$1789.50
2025-06-13,07:00:00,21824.75,BUY,3,0.02h,Stop Loss,$-9.00,$1780.50,$227565.50,378,$1780.50
2025-06-13,07:01:00,21604.0,SELL,3,0.02h,Stop Loss,$-9.00,$1771.50,$227556.50,378,$1771.50
2025-06-13,07:02:00,21839.5,BUY,3,0.02h,Stop Loss,$12.00,$1783.50,$227568.50,378,$1783.50
2025-06-13,07:09:00,21622.0,SELL,3,0.02h,Stop Loss,$9.00,$1792.50,$227577.50,378,$1792.50
2025-06-13,07:11:00,21837.25,BUY,3,0.02h,Stop Loss,$76.50,$1869.00,$227654.00,378,$1869.00
2025-06-13,07:20:00,21608.75,SELL,3,0.02h,Stop Loss,$7.50,$1876.50,$227661.50,378,$1876.50
2025-06-13,07:29:00,21832.5,BUY,3,0.02h,Break Even,$-1.50,$1875.00,$227660.00,378,$1875.00
2025-06-13,07:32:00,21614.0,SELL,3,0.02h,Break Even,$-1.50,$1873.50,$227658.50,378,$1873.50
2025-06-13,07:34:00,21831.0,BUY,3,0.02h,Stop Loss,$-9.00,$1864.50,$227649.50,378,$1864.50
2025-06-13,07:35:00,21610.0,SELL,3,0.02h,Stop Loss,$-9.00,$1855.50,$227640.50,378,$1855.50
2025-06-13,07:36:00,21838.0,BUY,3,0.02h,Stop Loss,$-9.00,$1846.50,$227631.50,378,$1846.50
2025-06-13,07:37:00,21618.75,SELL,3,0.02h,Stop Loss,$15.00,$1861.50,$227646.50,378,$1861.50
2025-06-13,07:44:00,21864.75,BUY,3,0.02h,Stop Loss,$-9.00,$1852.50,$227637.50,378,$1852.50
2025-06-13,07:52:00,21649.0,SELL,3,0.02h,Stop Loss,$9.00,$1861.50,$227646.50,378,$1861.50
2025-06-13,07:56:00,21858.25,BUY,3,0.02h,Stop Loss,$-9.00,$1852.50,$227637.50,378,$1852.50
2025-06-13,08:10:00,21647.0,SELL,3,0.02h,Stop Loss,$15.00,$1867.50,$227652.50,378,$1867.50
2025-06-13,08:13:00,21873.25,BUY,3,0.02h,Stop Loss,$34.50,$1902.00,$227687.00,378,$1902.00
2025-06-13,08:15:00,21654.75,SELL,3,0.02h,Stop Loss,$-9.00,$1893.00,$227678.00,378,$1893.00
2025-06-13,08:16:00,21874.0,BUY,3,0.02h,Stop Loss,$-9.00,$1884.00,$227669.00,378,$1884.00
2025-06-13,08:17:00,21650.0,SELL,3,0.02h,Stop Loss,$49.50,$1933.50,$227718.50,378,$1933.50
2025-06-13,08:23:00,21847.75,BUY,3,0.02h,Stop Loss,$-9.00,$1924.50,$227709.50,378,$1924.50
2025-06-13,08:25:00,21630.25,SELL,3,0.02h,Stop Loss,$49.50,$1974.00,$227759.00,378,$1974.00
2025-06-13,08:28:00,21838.25,BUY,3,0.02h,Stop Loss,$-9.00,$1965.00,$227750.00,378,$1965.00
2025-06-13,08:29:00,21620.75,SELL,3,0.02h,Stop Loss,$-9.00,$1956.00,$227741.00,378,$1956.00
2025-06-13,08:31:00,21843.5,BUY,3,0.02h,Stop Loss,$-9.00,$1947.00,$227732.00,378,$1947.00
2025-06-13,08:32:00,21625.75,SELL,3,0.02h,Stop Loss,$25.50,$1972.50,$227757.50,378,$1972.50
2025-06-13,08:42:00,21825.0,BUY,3,0.02h,Stop Loss,$-9.00,$1963.50,$227748.50,378,$1963.50
2025-06-13,08:43:00,21612.75,SELL,3,0.02h,Stop Loss,$30.00,$1993.50,$227778.50,378,$1993.50
2025-06-13,08:50:00,21815.5,BUY,3,0.02h,Stop Loss,$-9.00,$1984.50,$227769.50,378,$1984.50
2025-06-13,08:51:00,21609.5,SELL,3,0.02h,Stop Loss,$-9.00,$1975.50,$227760.50,378,$1975.50
2025-06-13,08:54:00,21836.0,BUY,3,0.02h,Stop Loss,$-9.00,$1966.50,$227751.50,378,$1966.50
2025-06-13,08:55:00,21611.75,SELL,3,0.02h,Break Even,$-1.50,$1965.00,$227750.00,378,$1965.00
2025-06-13,09:03:00,21837.5,BUY,3,0.02h,Stop Loss,$-9.00,$1956.00,$227741.00,378,$1956.00
2025-06-13,09:04:00,21624.25,SELL,3,0.02h,Stop Loss,$-9.00,$1947.00,$227732.00,378,$1947.00
2025-06-13,09:05:00,21841.5,BUY,3,0.02h,Stop Loss,$16.50,$1963.50,$227748.50,378,$1963.50
2025-06-13,09:18:00,21614.5,SELL,3,0.02h,Stop Loss,$-9.00,$1954.50,$227739.50,378,$1954.50
2025-06-13,09:19:00,21834.75,BUY,3,0.02h,Stop Loss,$15.00,$1969.50,$227754.50,378,$1969.50
2025-06-13,09:21:00,21605.5,SELL,3,0.02h,Stop Loss,$-9.00,$1960.50,$227745.50,378,$1960.50
2025-06-13,09:22:00,21838.5,BUY,3,0.02h,Stop Loss,$33.00,$1993.50,$227778.50,378,$1993.50
2025-06-13,09:24:00,21614.75,SELL,3,0.02h,Stop Loss,$-9.00,$1984.50,$227769.50,378,$1984.50
2025-06-13,09:27:00,21842.25,BUY,3,0.02h,Break Even,$-1.50,$1983.00,$227768.00,378,$1983.00
2025-06-13,09:33:00,21610.25,SELL,3,0.02h,Stop Loss,$31.50,$2014.50,$227799.50,378,$2014.50
2025-06-13,09:41:00,21827.75,BUY,3,0.02h,Stop Loss,$-9.00,$2005.50,$227790.50,378,$2005.50
2025-06-13,09:49:00,21610.5,SELL,3,0.02h,Stop Loss,$-9.00,$1996.50,$227781.50,378,$1996.50
2025-06-13,09:50:00,21824.0,BUY,3,0.02h,Stop Loss,$-9.00,$1987.50,$227772.50,378,$1987.50
2025-06-13,09:51:00,21612.75,SELL,3,0.02h,Stop Loss,$12.00,$1999.50,$227784.50,378,$1999.50
2025-06-13,09:58:00,21845.0,BUY,3,0.02h,Break Even,$-1.50,$1998.00,$227783.00,378,$1998.00
2025-06-13,10:05:00,21600.5,SELL,3,0.02h,Break Even,$-1.50,$1996.50,$227781.50,378,$1996.50
2025-06-13,10:12:00,21845.25,BUY,3,0.02h,Stop Loss,$-9.00,$1987.50,$227772.50,378,$1987.50
2025-06-13,10:13:00,21620.0,SELL,3,0.02h,Stop Loss,$6.00,$1993.50,$227778.50,378,$1993.50
2025-06-13,10:17:00,21825.0,BUY,3,0.02h,Stop Loss,$-9.00,$1984.50,$227769.50,378,$1984.50
2025-06-13,10:18:00,21613.5,SELL,3,0.02h,Stop Loss,$-9.00,$1975.50,$227760.50,378,$1975.50
2025-06-13,10:19:00,21836.0,BUY,3,0.02h,Stop Loss,$13.50,$1989.00,$227774.00,378,$1989.00
2025-06-13,10:26:00,21607.0,SELL,3,0.02h,Stop Loss,$-9.00,$1980.00,$227765.00,378,$1980.00
2025-06-13,10:39:00,21835.25,BUY,3,0.02h,Break Even,$-1.50,$1978.50,$227763.50,378,$1978.50
2025-06-13,10:46:00,21622.5,SELL,3,0.02h,Stop Loss,$-9.00,$1969.50,$227754.50,378,$1969.50
2025-06-13,10:48:00,21853.75,BUY,3,0.02h,Stop Loss,$-9.00,$1960.50,$227745.50,378,$1960.50
2025-06-13,10:49:00,21629.5,SELL,3,0.02h,Stop Loss,$3.00,$1963.50,$227748.50,378,$1963.50
2025-06-13,10:51:00,21845.75,BUY,3,0.02h,Stop Loss,$-9.00,$1954.50,$227739.50,378,$1954.50
2025-06-13,10:52:00,21627.25,SELL,3,0.02h,Stop Loss,$-9.00,$1945.50,$227730.50,378,$1945.50
2025-06-13,10:53:00,21851.75,BUY,3,0.02h,Stop Loss,$9.00,$1954.50,$227739.50,378,$1954.50
2025-06-13,10:58:00,21646.0,SELL,3,0.02h,Stop Loss,$-9.00,$1945.50,$227730.50,378,$1945.50
2025-06-13,10:59:00,21866.75,BUY,3,0.02h,Stop Loss,$12.00,$1957.50,$227742.50,378,$1957.50
2025-06-13,11:10:00,21695.25,SELL,3,0.02h,Stop Loss,$37.50,$1995.00,$227780.00,378,$1995.00
2025-06-13,11:14:00,21882.0,BUY,3,0.02h,Stop Loss,$-9.00,$1986.00,$227771.00,378,$1986.00
2025-06-13,11:15:00,21664.25,SELL,3,0.02h,Stop Loss,$-9.00,$1977.00,$227762.00,378,$1977.00
2025-06-13,11:16:00,21881.25,BUY,3,0.02h,Stop Loss,$-9.00,$1968.00,$227753.00,378,$1968.00
2025-06-13,11:17:00,21658.0,SELL,3,0.02h,Stop Loss,$-9.00,$1959.00,$227744.00,378,$1959.00
2025-06-13,11:18:00,21877.25,BUY,3,0.02h,Break Even,$-1.50,$1957.50,$227742.50,378,$1957.50
2025-06-13,11:26:00,21654.75,SELL,3,0.02h,Stop Loss,$-9.00,$1948.50,$227733.50,378,$1948.50
2025-06-13,11:34:00,21880.25,BUY,3,0.02h,Stop Loss,$-9.00,$1939.50,$227724.50,378,$1939.50
2025-06-13,11:35:00,21669.75,SELL,3,0.02h,Stop Loss,$-9.00,$1930.50,$227715.50,378,$1930.50
2025-06-13,11:36:00,21901.75,BUY,3,0.02h,Stop Loss,$-9.00,$1921.50,$227706.50,378,$1921.50
2025-06-13,11:37:00,21677.5,SELL,3,0.02h,Stop Loss,$15.00,$1936.50,$227721.50,378,$1936.50
2025-06-13,11:39:00,21892.0,BUY,3,0.02h,Stop Loss,$-9.00,$1927.50,$227712.50,378,$1927.50
2025-06-13,11:56:00,21684.25,SELL,3,0.02h,Stop Loss,$-9.00,$1918.50,$227703.50,378,$1918.50
2025-06-13,12:14:00,21891.75,BUY,3,0.02h,Stop Loss,$-9.00,$1909.50,$227694.50,378,$1909.50
2025-06-13,12:15:00,21664.5,SELL,3,0.02h,Stop Loss,$-9.00,$1900.50,$227685.50,378,$1900.50
2025-06-13,12:16:00,21886.0,BUY,3,0.02h,Stop Loss,$66.00,$1966.50,$227751.50,378,$1966.50
2025-06-13,12:24:00,21694.75,SELL,3,0.02h,Break Even,$-1.50,$1965.00,$227750.00,378,$1965.00
2025-06-13,12:26:00,21913.5,BUY,3,0.02h,Stop Loss,$-9.00,$1956.00,$227741.00,378,$1956.00
2025-06-13,12:27:00,21692.25,SELL,3,0.02h,Stop Loss,$-9.00,$1947.00,$227732.00,378,$1947.00
2025-06-13,12:28:00,21910.75,BUY,3,0.02h,Stop Loss,$-9.00,$1938.00,$227723.00,378,$1938.00
2025-06-13,12:34:00,21691.5,SELL,3,0.02h,Stop Loss,$46.50,$1984.50,$227769.50,378,$1984.50
2025-06-13,12:42:00,21905.25,BUY,3,0.02h,Break Even,$-1.50,$1983.00,$227768.00,378,$1983.00
2025-06-13,12:48:00,21659.0,SELL,3,0.02h,Stop Loss,$-9.00,$1974.00,$227759.00,378,$1974.00
2025-06-13,12:57:00,21878.25,BUY,3,0.02h,Break Even,$-1.50,$1972.50,$227757.50,378,$1972.50
2025-06-13,13:04:00,21644.25,SELL,3,0.02h,Break Even,$-1.50,$1971.00,$227756.00,378,$1971.00
2025-06-13,13:09:00,21870.75,BUY,3,0.02h,Stop Loss,$-9.00,$1962.00,$227747.00,378,$1962.00
2025-06-13,13:13:00,21641.5,SELL,3,0.02h,Break Even,$-1.50,$1960.50,$227745.50,378,$1960.50
2025-06-13,13:18:00,21863.0,BUY,3,0.02h,Stop Loss,$-9.00,$1951.50,$227736.50,378,$1951.50
2025-06-13,13:20:00,21636.0,SELL,3,0.02h,Stop Loss,$27.00,$1978.50,$227763.50,378,$1978.50
2025-06-13,13:25:00,21862.25,BUY,3,0.02h,Stop Loss,$75.00,$2053.50,$227838.50,378,$2053.50
2025-06-13,13:30:00,21680.5,SELL,3,0.02h,Stop Loss,$-9.00,$2044.50,$227829.50,378,$2044.50
2025-06-13,13:31:00,21941.0,BUY,3,0.02h,Stop Loss,$-9.00,$2035.50,$227820.50,378,$2035.50
2025-06-13,13:58:00,21725.0,SELL,3,0.02h,Stop Loss,$58.50,$2094.00,$227879.00,378,$2094.00
2025-06-13,14:03:00,21951.75,BUY,3,0.02h,Stop Loss,$-9.00,$2085.00,$227870.00,378,$2085.00
2025-06-13,14:04:00,21743.75,SELL,3,0.02h,Stop Loss,$-9.00,$2076.00,$227861.00,378,$2076.00
2025-06-13,14:08:00,21953.0,BUY,3,0.02h,Stop Loss,$6.00,$2082.00,$227867.00,378,$2082.00
2025-06-13,14:11:00,21690.0,SELL,3,0.02h,Stop Loss,$19.50,$2101.50,$227886.50,378,$2101.50
2025-06-13,14:20:00,21905.5,BUY,3,0.02h,Stop Loss,$-9.00,$2092.50,$227877.50,378,$2092.50
2025-06-13,14:27:00,21657.0,SELL,3,0.02h,Stop Loss,$66.00,$2158.50,$227943.50,378,$2158.50
2025-06-13,14:40:00,21934.5,BUY,3,0.02h,Stop Loss,$-9.00,$2149.50,$227934.50,378,$2149.50
2025-06-13,14:41:00,21721.25,SELL,3,0.02h,Stop Loss,$6.00,$2155.50,$227940.50,378,$2155.50
2025-06-13,14:44:00,21938.25,BUY,3,0.02h,Stop Loss,$-9.00,$2146.50,$227931.50,378,$2146.50
2025-06-13,14:50:00,21694.75,SELL,3,0.02h,Stop Loss,$30.00,$2176.50,$227961.50,378,$2176.50
2025-06-13,14:52:00,21924.25,BUY,3,0.02h,Stop Loss,$-9.00,$2167.50,$227952.50,378,$2167.50
2025-06-13,14:53:00,21721.25,SELL,3,0.02h,Stop Loss,$-9.00,$2158.50,$227943.50,378,$2158.50
2025-06-13,14:54:00,21963.25,BUY,3,0.02h,Stop Loss,$-9.00,$2149.50,$227934.50,378,$2149.50
2025-06-13,14:56:00,21759.5,SELL,3,0.02h,Stop Loss,$67.50,$2217.00,$228002.00,378,$2217.00
2025-06-13,15:00:00,21964.5,BUY,3,0.02h,Stop Loss,$15.00,$2232.00,$228017.00,378,$2232.00
2025-06-13,15:11:00,21737.0,SELL,3,0.02h,Stop Loss,$-9.00,$2223.00,$228008.00,378,$2223.00
2025-06-13,15:16:00,21985.75,BUY,3,0.02h,Stop Loss,$3.00,$2226.00,$228011.00,378,$2226.00
2025-06-13,15:25:00,21780.75,SELL,3,0.02h,Stop Loss,$36.00,$2262.00,$228047.00,378,$2262.00
2025-06-13,15:31:00,22018.5,BUY,3,0.02h,Stop Loss,$-9.00,$2253.00,$228038.00,378,$2253.00
2025-06-13,15:42:00,21804.25,SELL,3,0.02h,Stop Loss,$-9.00,$2244.00,$228029.00,378,$2244.00
2025-06-13,15:44:00,22034.25,BUY,3,0.02h,Stop Loss,$-9.00,$2235.00,$228020.00,378,$2235.00
2025-06-13,15:45:00,21808.5,SELL,3,0.02h,Break Even,$-1.50,$2233.50,$228018.50,378,$2233.50
2025-06-13,15:47:00,22042.5,BUY,3,0.02h,Stop Loss,$-9.00,$2224.50,$228009.50,378,$2224.50
2025-06-13,15:48:00,21829.75,SELL,3,0.02h,Stop Loss,$15.00,$2239.50,$228024.50,378,$2239.50
2025-06-13,15:52:00,22061.75,BUY,3,0.02h,Break Even,$-1.50,$2238.00,$228023.00,378,$2238.00
2025-06-13,15:55:00,21839.75,SELL,3,0.02h,Stop Loss,$-9.00,$2229.00,$228014.00,378,$2229.00
2025-06-13,15:56:00,22044.5,BUY,3,0.02h,Stop Loss,$-9.00,$2220.00,$228005.00,378,$2220.00
2025-06-13,16:06:00,21822.0,SELL,3,0.02h,Stop Loss,$-9.00,$2211.00,$227996.00,378,$2211.00
2025-06-13,16:08:00,22056.5,BUY,3,0.02h,Break Even,$-1.50,$2209.50,$227994.50,378,$2209.50
2025-06-13,16:20:00,21844.25,SELL,3,0.02h,Stop Loss,$58.50,$2268.00,$228053.00,378,$2268.00
2025-06-13,16:24:00,22064.5,BUY,3,0.02h,Stop Loss,$-9.00,$2259.00,$228044.00,378,$2259.00
2025-06-13,16:25:00,21841.75,SELL,3,0.02h,Break Even,$-1.50,$2257.50,$228042.50,378,$2257.50
2025-06-13,16:35:00,22049.75,BUY,3,0.02h,Stop Loss,$-9.00,$2248.50,$228033.50,378,$2248.50
2025-06-13,16:36:00,21831.25,SELL,3,0.02h,Stop Loss,$48.00,$2296.50,$228081.50,378,$2296.50
2025-06-13,16:38:00,22037.0,BUY,3,0.02h,Break Even,$-1.50,$2295.00,$228080.00,378,$2295.00
2025-06-13,16:40:00,21807.5,SELL,3,0.02h,Stop Loss,$-9.00,$2286.00,$228071.00,378,$2286.00
2025-06-13,16:41:00,22031.0,BUY,3,0.02h,Stop Loss,$-9.00,$2277.00,$228062.00,378,$2277.00
2025-06-13,16:42:00,21818.25,SELL,3,0.02h,Stop Loss,$9.00,$2286.00,$228071.00,378,$2286.00
2025-06-13,16:44:00,22030.0,BUY,3,0.02h,Break Even,$-1.50,$2284.50,$228069.50,378,$2284.50
2025-06-13,16:55:00,21827.0,SELL,3,0.02h,Stop Loss,$6.00,$2290.50,$228075.50,378,$2290.50
2025-06-13,16:58:00,22063.25,BUY,3,0.02h,Stop Loss,$-9.00,$2281.50,$228066.50,378,$2281.50
2025-06-13,17:03:00,21828.75,SELL,3,0.02h,Break Even,$-1.50,$2280.00,$228065.00,378,$2280.00
2025-06-13,17:06:00,22038.5,BUY,3,0.02h,Stop Loss,$-9.00,$2271.00,$228056.00,378,$2271.00
2025-06-13,17:07:00,21817.0,SELL,3,0.02h,Stop Loss,$-9.00,$2262.00,$228047.00,378,$2262.00
2025-06-13,17:11:00,22014.5,BUY,3,0.02h,Stop Loss,$-9.00,$2253.00,$228038.00,378,$2253.00
2025-06-13,17:12:00,21787.25,SELL,3,0.02h,Stop Loss,$30.00,$2283.00,$228068.00,378,$2283.00
2025-06-13,17:22:00,22021.25,BUY,3,0.02h,Stop Loss,$-9.00,$2274.00,$228059.00,378,$2274.00
2025-06-13,17:23:00,21791.0,SELL,3,0.02h,Stop Loss,$-9.00,$2265.00,$228050.00,378,$2265.00
2025-06-13,17:24:00,22006.5,BUY,3,0.02h,Stop Loss,$-9.00,$2256.00,$228041.00,378,$2256.00
2025-06-13,17:25:00,21798.25,SELL,3,0.02h,Stop Loss,$4.50,$2260.50,$228045.50,378,$2260.50
2025-06-13,17:28:00,22004.75,BUY,3,0.02h,Stop Loss,$-9.00,$2251.50,$228036.50,378,$2251.50
2025-06-13,17:29:00,21778.75,SELL,3,0.02h,Stop Loss,$25.50,$2277.00,$228062.00,378,$2277.00
2025-06-13,17:36:00,21994.5,BUY,3,0.02h,Break Even,$-1.50,$2275.50,$228060.50,378,$2275.50
2025-06-13,17:41:00,21773.75,SELL,3,0.02h,Stop Loss,$9.00,$2284.50,$228069.50,378,$2284.50
2025-06-13,17:57:00,22004.75,BUY,3,0.02h,Stop Loss,$-9.00,$2275.50,$228060.50,378,$2275.50
2025-06-13,17:58:00,21785.75,SELL,3,0.02h,Stop Loss,$21.00,$2296.50,$228081.50,378,$2296.50
2025-06-13,18:03:00,22014.25,BUY,3,0.02h,Break Even,$-1.50,$2295.00,$228080.00,378,$2295.00
2025-06-13,18:13:00,21751.5,SELL,3,0.02h,Stop Loss,$22.50,$2317.50,$228102.50,378,$2317.50
2025-06-13,18:15:00,21952.25,BUY,3,0.02h,Stop Loss,$-9.00,$2308.50,$228093.50,378,$2308.50
2025-06-13,18:16:00,21724.0,SELL,3,0.02h,Stop Loss,$-9.00,$2299.50,$228084.50,378,$2299.50
2025-06-13,18:18:00,21930.75,BUY,3,0.02h,Stop Loss,$-9.00,$2290.50,$228075.50,378,$2290.50
2025-06-13,18:19:00,21720.75,SELL,3,0.02h,Stop Loss,$-9.00,$2281.50,$228066.50,378,$2281.50
2025-06-13,18:20:00,21947.75,BUY,3,0.02h,Stop Loss,$12.00,$2293.50,$228078.50,378,$2293.50
2025-06-13,18:23:00,21710.0,SELL,3,0.02h,Stop Loss,$-9.00,$2284.50,$228069.50,378,$2284.50
2025-06-13,18:24:00,21939.0,BUY,3,0.02h,Stop Loss,$-9.00,$2275.50,$228060.50,378,$2275.50
2025-06-13,18:33:00,21638.75,SELL,3,0.02h,Stop Loss,$-9.00,$2266.50,$228051.50,378,$2266.50
2025-06-13,18:46:00,21865.75,BUY,3,0.02h,Stop Loss,$6.00,$2272.50,$228057.50,378,$2272.50
2025-06-13,18:48:00,21635.5,SELL,3,0.02h,Stop Loss,$46.50,$2319.00,$228104.00,378,$2319.00
2025-06-13,18:54:00,21866.0,BUY,3,0.02h,Stop Loss,$81.00,$2400.00,$228185.00,378,$2400.00
2025-06-13,18:56:00,21661.5,SELL,3,0.02h,Stop Loss,$-9.00,$2391.00,$228176.00,378,$2391.00
2025-06-13,18:57:00,21877.5,BUY,3,0.02h,Stop Loss,$-9.00,$2382.00,$228167.00,378,$2382.00
2025-06-13,18:58:00,21644.0,SELL,3,0.02h,Stop Loss,$-9.00,$2373.00,$228158.00,378,$2373.00
2025-06-13,19:08:00,21886.0,BUY,3,0.02h,Stop Loss,$-9.00,$2364.00,$228149.00,378,$2364.00
2025-06-13,19:09:00,21671.0,SELL,3,0.02h,Stop Loss,$-9.00,$2355.00,$228140.00,378,$2355.00
2025-06-13,19:10:00,21897.0,BUY,3,0.02h,Stop Loss,$-9.00,$2346.00,$228131.00,378,$2346.00
2025-06-13,19:17:00,21678.5,SELL,3,0.02h,Stop Loss,$-9.00,$2337.00,$228122.00,378,$2337.00
2025-06-13,19:18:00,21888.25,BUY,3,0.02h,Stop Loss,$-9.00,$2328.00,$228113.00,378,$2328.00
2025-06-13,19:19:00,21667.75,SELL,3,0.02h,Stop Loss,$-9.00,$2319.00,$228104.00,378,$2319.00
2025-06-13,19:20:00,21879.25,BUY,3,0.02h,Stop Loss,$88.50,$2407.50,$228192.50,378,$2407.50
2025-06-13,19:27:00,21629.25,SELL,3,0.02h,Stop Loss,$-9.00,$2398.50,$228183.50,378,$2398.50
2025-06-13,19:29:00,21851.5,BUY,3,0.02h,Stop Loss,$-9.00,$2389.50,$228174.50,378,$2389.50
2025-06-13,19:30:00,21633.25,SELL,3,0.02h,Stop Loss,$-9.00,$2380.50,$228165.50,378,$2380.50
2025-06-13,19:37:00,21872.75,BUY,3,0.02h,Stop Loss,$-9.00,$2371.50,$228156.50,378,$2371.50
2025-06-13,19:38:00,21669.25,SELL,3,0.02h,Stop Loss,$12.00,$2383.50,$228168.50,378,$2383.50
2025-06-13,19:48:00,21835.0,BUY,3,0.02h,Stop Loss,$-9.00,$2374.50,$228159.50,378,$2374.50
2025-06-13,19:49:00,21647.0,SELL,3,0.02h,Stop Loss,$-9.00,$2365.50,$228150.50,378,$2365.50
2025-06-13,19:50:00,21854.0,BUY,3,0.02h,Stop Loss,$-9.00,$2356.50,$228141.50,378,$2356.50
2025-06-13,19:51:00,21638.0,SELL,3,0.02h,Stop Loss,$52.50,$2409.00,$228194.00,378,$2409.00
2025-06-13,20:04:00,21872.75,BUY,3,0.02h,Stop Loss,$-9.00,$2400.00,$228185.00,378,$2400.00
2025-06-13,20:12:00,21670.25,SELL,3,0.02h,Stop Loss,$-9.00,$2391.00,$228176.00,378,$2391.00
2025-06-13,20:13:00,21878.5,BUY,3,0.02h,Stop Loss,$6.00,$2397.00,$228182.00,378,$2397.00
2025-06-13,20:21:00,21665.75,SELL,3,0.02h,Stop Loss,$-9.00,$2388.00,$228173.00,378,$2388.00
2025-06-13,20:22:00,21877.5,BUY,3,0.02h,Stop Loss,$-9.00,$2379.00,$228164.00,378,$2379.00
2025-06-13,20:24:00,21658.5,SELL,3,0.02h,Stop Loss,$-9.00,$2370.00,$228155.00,378,$2370.00
2025-06-13,20:25:00,21875.25,BUY,3,0.02h,Stop Loss,$-9.00,$2361.00,$228146.00,378,$2361.00
2025-06-13,20:26:00,21655.5,SELL,3,0.02h,Break Even,$-1.50,$2359.50,$228144.50,378,$2359.50
2025-06-13,20:28:00,21871.0,BUY,3,0.02h,Stop Loss,$-9.00,$2350.50,$228135.50,378,$2350.50
2025-06-13,20:32:00,21658.0,SELL,3,0.02h,Stop Loss,$-9.00,$2341.50,$228126.50,378,$2341.50
2025-06-13,20:42:00,21877.5,BUY,3,0.02h,Break Even,$-1.50,$2340.00,$228125.00,378,$2340.00
2025-06-13,20:55:00,21648.25,SELL,3,0.02h,Stop Loss,$-9.00,$2331.00,$228116.00,378,$2331.00
2025-06-13,20:56:00,21863.25,BUY,3,0.02h,Break Even,$-1.50,$2329.50,$228114.50,378,$2329.50
2025-06-13,21:00:00,21654.0,SELL,3,51.00h,Stop Loss,$-9.00,$2320.50,$228105.50,378,$2320.50
,,,,,,,,,,,
2025-06-16,00:00:00,21903.75,BUY,3,0.02h,Stop Loss,$19.50,$19.50,$228125.00,379,$19.50
2025-06-16,00:55:00,21899.75,SELL,3,0.02h,Break Even,$-1.50,$18.00,$228123.50,379,$18.00
2025-06-16,00:57:00,21910.0,BUY,3,0.02h,Break Even,$-1.50,$16.50,$228122.00,379,$16.50
2025-06-16,01:15:00,21899.75,SELL,3,0.02h,Break Even,$-1.50,$15.00,$228120.50,379,$15.00
2025-06-16,01:34:00,21909.75,BUY,3,0.02h,Stop Loss,$-9.00,$6.00,$228111.50,379,$6.00
2025-06-16,01:54:00,21900.25,SELL,3,0.02h,Break Even,$-1.50,$4.50,$228110.00,379,$4.50
2025-06-16,01:56:00,21911.75,BUY,3,0.02h,Stop Loss,$-9.00,$-4.50,$228101.00,379,$-4.50
2025-06-16,02:55:00,21920.75,SELL,3,0.02h,Break Even,$-1.50,$-6.00,$228099.50,379,$-6.00
2025-06-16,03:28:00,21923.0,BUY,3,0.02h,Stop Loss,$-9.00,$-15.00,$228090.50,379,$-15.00
2025-06-16,03:29:00,21913.75,SELL,3,0.02h,Break Even,$-1.50,$-16.50,$228089.00,379,$-16.50
2025-06-16,03:58:00,21908.25,BUY,3,0.02h,Break Even,$-1.50,$-18.00,$228087.50,379,$-18.00
2025-06-16,04:25:00,21904.25,SELL,3,0.02h,Break Even,$-1.50,$-19.50,$228086.00,379,$-19.50
2025-06-16,04:59:00,21899.75,BUY,3,0.02h,Stop Loss,$-9.00,$-28.50,$228077.00,379,$-28.50
2025-06-16,05:49:00,21939.5,SELL,3,0.03h,Stop Loss,$4.50,$-24.00,$228081.50,379,$-24.00
2025-06-16,06:09:00,21947.5,BUY,3,0.02h,Stop Loss,$18.00,$-6.00,$228099.50,379,$-6.00
2025-06-16,07:25:00,21977.0,SELL,3,0.02h,Stop Loss,$28.50,$22.50,$228128.00,379,$22.50
2025-06-16,07:31:00,21992.25,BUY,3,0.02h,Break Even,$-1.50,$21.00,$228126.50,379,$21.00
2025-06-16,08:02:00,21976.75,SELL,3,0.02h,Break Even,$-1.50,$19.50,$228125.00,379,$19.50
2025-06-16,08:13:00,21995.25,BUY,3,0.02h,Break Even,$-1.50,$18.00,$228123.50,379,$18.00
2025-06-16,08:14:00,21988.0,SELL,3,0.02h,Break Even,$-1.50,$16.50,$228122.00,379,$16.50
2025-06-16,08:28:00,21994.5,BUY,3,0.02h,Break Even,$-1.50,$15.00,$228120.50,379,$15.00
2025-06-16,09:04:00,21994.75,SELL,3,0.02h,Stop Loss,$9.00,$24.00,$228129.50,379,$24.00
2025-06-16,09:58:00,21972.75,BUY,3,0.02h,Stop Loss,$6.00,$30.00,$228135.50,379,$30.00
2025-06-16,10:02:00,21965.25,SELL,3,0.02h,Stop Loss,$-9.00,$21.00,$228126.50,379,$21.00
2025-06-16,10:11:00,21972.75,BUY,3,0.02h,Stop Loss,$7.50,$28.50,$228134.00,379,$28.50
2025-06-16,10:41:00,21970.25,SELL,3,0.02h,Stop Loss,$12.00,$40.50,$228146.00,379,$40.50
2025-06-16,10:50:00,21985.25,BUY,3,0.02h,Stop Loss,$13.50,$54.00,$228159.50,379,$54.00
2025-06-16,11:08:00,21979.5,SELL,3,0.02h,Break Even,$-1.50,$52.50,$228158.00,379,$52.50
2025-06-16,11:19:00,21989.5,BUY,3,0.02h,Stop Loss,$-9.00,$43.50,$228149.00,379,$43.50
2025-06-16,12:35:00,22038.0,SELL,3,0.02h,Stop Loss,$4.50,$48.00,$228153.50,379,$48.00
2025-06-16,12:48:00,22045.0,BUY,3,0.02h,Stop Loss,$-9.00,$39.00,$228144.50,379,$39.00
2025-06-16,12:51:00,22040.25,SELL,3,0.02h,Stop Loss,$4.50,$43.50,$228149.00,379,$43.50
2025-06-16,13:04:00,22042.75,BUY,3,0.02h,Stop Loss,$-9.00,$34.50,$228140.00,379,$34.50
2025-06-16,13:07:00,22035.5,SELL,3,0.02h,Stop Loss,$10.50,$45.00,$228150.50,379,$45.00
2025-06-16,13:15:00,22042.0,BUY,3,0.02h,Stop Loss,$-9.00,$36.00,$228141.50,379,$36.00
2025-06-16,13:16:00,22038.5,SELL,3,0.02h,Break Even,$-1.50,$34.50,$228140.00,379,$34.50
2025-06-16,13:32:00,22079.5,BUY,3,0.02h,Stop Loss,$94.50,$129.00,$228234.50,379,$129.00
2025-06-16,14:52:00,22187.75,SELL,3,0.02h,Stop Loss,$7.50,$136.50,$228242.00,379,$136.50
2025-06-16,15:03:00,22196.25,BUY,3,0.02h,Stop Loss,$-9.00,$127.50,$228233.00,379,$127.50
2025-06-16,15:04:00,22178.75,SELL,3,0.02h,Break Even,$-1.50,$126.00,$228231.50,379,$126.00
2025-06-16,15:08:00,22191.75,BUY,3,0.02h,Break Even,$-1.50,$124.50,$228230.00,379,$124.50
2025-06-16,15:29:00,22190.0,SELL,3,0.02h,Stop Loss,$13.50,$138.00,$228243.50,379,$138.00
2025-06-16,15:47:00,22203.75,BUY,3,0.02h,Stop Loss,$-9.00,$129.00,$228234.50,379,$129.00
2025-06-16,15:52:00,22187.0,SELL,3,0.02h,Stop Loss,$18.00,$147.00,$228252.50,379,$147.00
2025-06-16,16:15:00,22184.0,BUY,3,0.02h,Break Even,$-1.50,$145.50,$228251.00,379,$145.50
2025-06-16,16:26:00,22169.5,SELL,3,0.02h,Stop Loss,$18.00,$163.50,$228269.00,379,$163.50
2025-06-16,16:54:00,22178.5,BUY,3,0.02h,Stop Loss,$-9.00,$154.50,$228260.00,379,$154.50
2025-06-16,17:03:00,22159.75,SELL,3,0.02h,Break Even,$-1.50,$153.00,$228258.50,379,$153.00
2025-06-16,17:20:00,22169.5,BUY,3,0.02h,Stop Loss,$46.50,$199.50,$228305.00,379,$199.50
2025-06-16,17:54:00,22185.25,SELL,3,0.02h,Stop Loss,$40.50,$240.00,$228345.50,379,$240.00
2025-06-16,18:26:00,22173.75,BUY,3,0.02h,Break Even,$-1.50,$238.50,$228344.00,379,$238.50
2025-06-16,18:31:00,22165.5,SELL,3,0.02h,Stop Loss,$9.00,$247.50,$228353.00,379,$247.50
2025-06-16,18:57:00,22171.0,BUY,3,0.02h,Stop Loss,$6.00,$253.50,$228359.00,379,$253.50
2025-06-16,19:08:00,22156.5,SELL,3,0.02h,Break Even,$-1.50,$252.00,$228357.50,379,$252.00
2025-06-16,19:23:00,22176.5,BUY,3,0.02h,Stop Loss,$10.50,$262.50,$228368.00,379,$262.50
2025-06-16,19:34:00,22155.5,SELL,3,0.02h,Stop Loss,$-9.00,$253.50,$228359.00,379,$253.50
2025-06-16,19:46:00,22172.5,BUY,3,0.02h,Stop Loss,$-9.00,$244.50,$228350.00,379,$244.50
2025-06-16,19:52:00,22153.75,SELL,3,0.02h,Break Even,$-1.50,$243.00,$228348.50,379,$243.00
2025-06-16,19:56:00,22173.25,BUY,3,0.02h,Break Even,$-1.50,$241.50,$228347.00,379,$241.50
2025-06-16,19:58:00,22151.25,SELL,3,0.02h,Stop Loss,$21.00,$262.50,$228368.00,379,$262.50
2025-06-16,20:01:00,22172.5,BUY,3,0.02h,Stop Loss,$21.00,$283.50,$228389.00,379,$283.50
2025-06-16,20:22:00,22168.0,SELL,3,0.03h,Break Even,$-1.50,$282.00,$228387.50,379,$282.00
2025-06-16,20:37:00,22172.0,BUY,3,0.02h,Break Even,$-1.50,$280.50,$228386.00,379,$280.50
2025-06-16,20:55:00,22169.5,SELL,3,0.02h,Stop Loss,$7.50,$288.00,$228393.50,379,$288.00
,,,,,,,,,,,
2025-06-17,00:14:00,22045.0,BUY,3,0.02h,Stop Loss,$19.50,$19.50,$228413.00,380,$19.50
2025-06-17,00:39:00,22046.5,SELL,3,0.02h,Break Even,$-1.50,$18.00,$228411.50,380,$18.00
2025-06-17,00:41:00,22056.0,BUY,3,0.02h,Break Even,$-1.50,$16.50,$228410.00,380,$16.50
2025-06-17,00:44:00,22051.25,SELL,3,0.02h,Break Even,$-1.50,$15.00,$228408.50,380,$15.00
2025-06-17,00:51:00,22067.5,BUY,3,0.02h,Stop Loss,$12.00,$27.00,$228420.50,380,$27.00
2025-06-17,01:11:00,22054.0,SELL,3,0.02h,Stop Loss,$19.50,$46.50,$228440.00,380,$46.50
2025-06-17,01:33:00,22074.0,BUY,3,0.02h,Break Even,$-1.50,$45.00,$228438.50,380,$45.00
2025-06-17,02:03:00,22058.25,SELL,3,0.02h,Stop Loss,$31.50,$76.50,$228470.00,380,$76.50
2025-06-17,02:41:00,22047.25,BUY,3,0.02h,Stop Loss,$12.00,$88.50,$228482.00,380,$88.50
2025-06-17,03:23:00,22072.0,SELL,3,0.02h,Stop Loss,$27.00,$115.50,$228509.00,380,$115.50
2025-06-17,03:35:00,22089.25,BUY,3,0.02h,Break Even,$-1.50,$114.00,$228507.50,380,$114.00
2025-06-17,03:53:00,22076.0,SELL,3,0.02h,Stop Loss,$-9.00,$105.00,$228498.50,380,$105.00
2025-06-17,04:03:00,22087.75,BUY,3,0.02h,Break Even,$-1.50,$103.50,$228497.00,380,$103.50
2025-06-17,04:12:00,22075.5,SELL,3,0.02h,Stop Loss,$-9.00,$94.50,$228488.00,380,$94.50
2025-06-17,04:20:00,22089.0,BUY,3,0.02h,Stop Loss,$6.00,$100.50,$228494.00,380,$100.50
2025-06-17,04:24:00,22077.0,SELL,3,0.02h,Break Even,$-1.50,$99.00,$228492.50,380,$99.00
2025-06-17,04:56:00,22076.5,BUY,3,0.02h,Stop Loss,$6.00,$105.00,$228498.50,380,$105.00
2025-06-17,05:06:00,22066.0,SELL,3,0.02h,Stop Loss,$-9.00,$96.00,$228489.50,380,$96.00
2025-06-17,05:08:00,22069.75,BUY,3,0.02h,Stop Loss,$-9.00,$87.00,$228480.50,380,$87.00
2025-06-17,05:10:00,22068.0,SELL,3,0.02h,Stop Loss,$-9.00,$78.00,$228471.50,380,$78.00
2025-06-17,05:11:00,22072.75,BUY,3,0.02h,Break Even,$-1.50,$76.50,$228470.00,380,$76.50
2025-06-17,05:23:00,22064.5,SELL,3,0.02h,Break Even,$-1.50,$75.00,$228468.50,380,$75.00
2025-06-17,05:28:00,22079.5,BUY,3,0.02h,Break Even,$-1.50,$73.50,$228467.00,380,$73.50
2025-06-17,05:50:00,22078.5,SELL,3,0.02h,Stop Loss,$33.00,$106.50,$228500.00,380,$106.50
2025-06-17,06:02:00,22086.75,BUY,3,0.02h,Stop Loss,$13.50,$120.00,$228513.50,380,$120.00
2025-06-17,06:38:00,22090.25,SELL,3,0.02h,Stop Loss,$-9.00,$111.00,$228504.50,380,$111.00
2025-06-17,06:42:00,22115.0,BUY,3,0.02h,Stop Loss,$-9.00,$102.00,$228495.50,380,$102.00
2025-06-17,06:45:00,22098.5,SELL,3,0.02h,Stop Loss,$-9.00,$93.00,$228486.50,380,$93.00
2025-06-17,07:48:00,22040.75,BUY,3,0.02h,Break Even,$-1.50,$91.50,$228485.00,380,$91.50
2025-06-17,08:20:00,22043.75,SELL,3,0.02h,Break Even,$-1.50,$90.00,$228483.50,380,$90.00
2025-06-17,08:27:00,22055.75,BUY,3,0.02h,Stop Loss,$12.00,$102.00,$228495.50,380,$102.00
2025-06-17,08:42:00,22047.0,SELL,3,0.02h,Stop Loss,$-9.00,$93.00,$228486.50,380,$93.00
2025-06-17,08:48:00,22062.25,BUY,3,0.02h,Break Even,$-1.50,$91.50,$228485.00,380,$91.50
2025-06-17,08:56:00,22035.25,SELL,3,0.02h,Stop Loss,$-9.00,$82.50,$228476.00,380,$82.50
2025-06-17,09:00:00,22065.25,BUY,3,0.02h,Stop Loss,$13.50,$96.00,$228489.50,380,$96.00
2025-06-17,09:11:00,22054.5,SELL,3,0.02h,Break Even,$-1.50,$94.50,$228488.00,380,$94.50
2025-06-17,09:45:00,22045.0,BUY,3,0.02h,Stop Loss,$-9.00,$85.50,$228479.00,380,$85.50
2025-06-17,09:55:00,22029.5,SELL,3,0.02h,Stop Loss,$3.00,$88.50,$228482.00,380,$88.50
2025-06-17,10:06:00,22047.25,BUY,3,0.02h,Stop Loss,$-9.00,$79.50,$228473.00,380,$79.50
2025-06-17,10:18:00,22031.75,SELL,3,0.02h,Stop Loss,$-9.00,$70.50,$228464.00,380,$70.50
2025-06-17,10:53:00,22030.25,BUY,3,0.02h,Stop Loss,$7.50,$78.00,$228471.50,380,$78.00
2025-06-17,11:44:00,22052.25,SELL,3,0.02h,Break Even,$-1.50,$76.50,$228470.00,380,$76.50
2025-06-17,11:57:00,22067.0,BUY,3,0.02h,Stop Loss,$27.00,$103.50,$228497.00,380,$103.50
2025-06-17,12:32:00,22073.25,SELL,3,0.02h,Break Even,$-1.50,$102.00,$228495.50,380,$102.00
2025-06-17,12:41:00,22092.5,BUY,3,0.02h,Break Even,$-1.50,$100.50,$228494.00,380,$100.50
2025-06-17,12:47:00,22074.0,SELL,3,0.02h,Stop Loss,$31.50,$132.00,$228525.50,380,$132.00
2025-06-17,13:22:00,22058.75,BUY,3,0.02h,Stop Loss,$-9.00,$123.00,$228516.50,380,$123.00
2025-06-17,13:44:00,22044.25,SELL,3,0.02h,Stop Loss,$70.50,$193.50,$228587.00,380,$193.50
2025-06-17,13:53:00,22084.5,BUY,3,0.02h,Break Even,$-1.50,$192.00,$228585.50,380,$192.00
2025-06-17,14:35:00,22101.5,SELL,3,0.02h,Stop Loss,$102.00,$294.00,$228687.50,380,$294.00
2025-06-17,14:50:00,22103.0,BUY,3,0.02h,Stop Loss,$21.00,$315.00,$228708.50,380,$315.00
2025-06-17,14:54:00,22090.5,SELL,3,0.02h,Break Even,$-1.50,$313.50,$228707.00,380,$313.50
2025-06-17,15:06:00,22097.25,BUY,3,0.02h,Stop Loss,$15.00,$328.50,$228722.00,380,$328.50
2025-06-17,15:25:00,22102.25,SELL,3,0.02h,Stop Loss,$46.50,$375.00,$228768.50,380,$375.00
2025-06-17,15:42:00,22105.75,BUY,3,0.02h,Stop Loss,$36.00,$411.00,$228804.50,380,$411.00
2025-06-17,16:00:00,22097.5,SELL,3,0.02h,Stop Loss,$-9.00,$402.00,$228795.50,380,$402.00
2025-06-17,16:02:00,22114.25,BUY,3,0.02h,Stop Loss,$3.00,$405.00,$228798.50,380,$405.00
2025-06-17,16:25:00,22111.5,SELL,3,0.02h,Break Even,$-1.50,$403.50,$228797.00,380,$403.50
2025-06-17,16:36:00,22126.0,BUY,3,0.02h,Stop Loss,$-9.00,$394.50,$228788.00,380,$394.50
2025-06-17,16:40:00,22112.5,SELL,3,0.02h,Stop Loss,$27.00,$421.50,$228815.00,380,$421.50
2025-06-17,17:38:00,22045.75,BUY,3,0.02h,Break Even,$-1.50,$420.00,$228813.50,380,$420.00
2025-06-17,17:39:00,22029.75,SELL,3,0.02h,Stop Loss,$49.50,$469.50,$228863.00,380,$469.50
2025-06-17,18:36:00,21962.25,BUY,3,0.02h,Stop Loss,$-9.00,$460.50,$228854.00,380,$460.50
2025-06-17,18:39:00,21946.75,SELL,3,0.02h,Stop Loss,$58.50,$519.00,$228912.50,380,$519.00
2025-06-17,18:55:00,21954.5,BUY,3,0.02h,Stop Loss,$30.00,$549.00,$228942.50,380,$549.00
2025-06-17,19:43:00,21969.25,SELL,3,0.02h,Stop Loss,$-9.00,$540.00,$228933.50,380,$540.00
2025-06-17,19:46:00,21986.5,BUY,3,0.02h,Break Even,$-1.50,$538.50,$228932.00,380,$538.50
2025-06-17,19:54:00,21976.0,SELL,3,0.02h,Stop Loss,$54.00,$592.50,$228986.00,380,$592.50
2025-06-17,20:32:00,21959.5,BUY,3,0.02h,Stop Loss,$-9.00,$583.50,$228977.00,380,$583.50
2025-06-17,20:49:00,21946.75,SELL,3,0.02h,Break Even,$-1.50,$582.00,$228975.50,380,$582.00
2025-06-17,23:29:00,21894.75,BUY,3,0.02h,Break Even,$-1.50,$580.50,$228974.00,380,$580.50
2025-06-17,23:39:00,21890.0,SELL,3,0.02h,Break Even,$-1.50,$579.00,$228972.50,380,$579.00
2025-06-17,23:44:00,21911.0,BUY,3,0.02h,Stop Loss,$22.50,$601.50,$228995.00,380,$601.50
,,,,,,,,,,,
2025-06-18,00:51:00,21964.0,SELL,3,0.02h,Stop Loss,$3.00,$3.00,$228998.00,381,$3.00
2025-06-18,00:56:00,21970.75,BUY,3,0.02h,Stop Loss,$22.50,$25.50,$229020.50,381,$25.50
2025-06-18,01:19:00,21986.75,SELL,3,0.02h,Stop Loss,$4.50,$30.00,$229025.00,381,$30.00
2025-06-18,01:36:00,21989.0,BUY,3,0.02h,Stop Loss,$48.00,$78.00,$229073.00,381,$78.00
2025-06-18,01:46:00,21982.25,SELL,3,0.02h,Break Even,$-1.50,$76.50,$229071.50,381,$76.50
2025-06-18,02:18:00,21977.25,BUY,3,0.02h,Stop Loss,$-9.00,$67.50,$229062.50,381,$67.50
2025-06-18,02:59:00,21980.5,SELL,3,0.02h,Stop Loss,$24.00,$91.50,$229086.50,381,$91.50
2025-06-18,03:44:00,21977.25,BUY,3,0.03h,Break Even,$-1.50,$90.00,$229085.00,381,$90.00
2025-06-18,03:58:00,21971.0,SELL,3,0.02h,Break Even,$-1.50,$88.50,$229083.50,381,$88.50
2025-06-18,04:07:00,21981.25,BUY,3,0.02h,Stop Loss,$-9.00,$79.50,$229074.50,381,$79.50
2025-06-18,04:20:00,21973.25,SELL,3,0.02h,Break Even,$-1.50,$78.00,$229073.00,381,$78.00
2025-06-18,04:45:00,21970.0,BUY,3,0.02h,Stop Loss,$-9.00,$69.00,$229064.00,381,$69.00
2025-06-18,05:27:00,21985.5,SELL,3,0.02h,Stop Loss,$-9.00,$60.00,$229055.00,381,$60.00
2025-06-18,05:31:00,21990.75,BUY,3,0.02h,Break Even,$-1.50,$58.50,$229053.50,381,$58.50
2025-06-18,05:37:00,21982.5,SELL,3,0.02h,Stop Loss,$-9.00,$49.50,$229044.50,381,$49.50
2025-06-18,05:56:00,21988.0,BUY,3,0.02h,Stop Loss,$-9.00,$40.50,$229035.50,381,$40.50
2025-06-18,06:43:00,22007.5,SELL,3,0.02h,Stop Loss,$9.00,$49.50,$229044.50,381,$49.50
2025-06-18,07:03:00,22010.0,BUY,3,0.02h,Stop Loss,$7.50,$57.00,$229052.00,381,$57.00
2025-06-18,07:30:00,22013.75,SELL,3,0.02h,Stop Loss,$-9.00,$48.00,$229043.00,381,$48.00
2025-06-18,07:31:00,22024.75,BUY,3,0.02h,Stop Loss,$10.50,$58.50,$229053.50,381,$58.50
2025-06-18,07:53:00,22012.0,SELL,3,0.02h,Stop Loss,$36.00,$94.50,$229089.50,381,$94.50
2025-06-18,08:05:00,22025.75,BUY,3,0.02h,Stop Loss,$6.00,$100.50,$229095.50,381,$100.50
2025-06-18,08:19:00,22016.25,SELL,3,0.02h,Break Even,$-1.50,$99.00,$229094.00,381,$99.00
2025-06-18,08:36:00,22021.0,BUY,3,0.02h,Stop Loss,$-9.00,$90.00,$229085.00,381,$90.00
2025-06-18,08:38:00,22017.25,SELL,3,0.02h,Break Even,$-1.50,$88.50,$229083.50,381,$88.50
2025-06-18,08:39:00,22020.75,BUY,3,0.02h,Break Even,$-1.50,$87.00,$229082.00,381,$87.00
2025-06-18,09:34:00,22036.5,SELL,3,0.02h,Break Even,$-1.50,$85.50,$229080.50,381,$85.50
2025-06-18,10:20:00,22030.25,BUY,3,0.02h,Stop Loss,$-9.00,$76.50,$229071.50,381,$76.50
2025-06-18,10:22:00,22012.75,SELL,3,0.02h,Stop Loss,$73.50,$150.00,$229145.00,381,$150.00
2025-06-18,11:24:00,21972.5,BUY,3,0.02h,Stop Loss,$16.50,$166.50,$229161.50,381,$166.50
2025-06-18,12:04:00,21997.25,SELL,3,0.02h,Break Even,$-1.50,$165.00,$229160.00,381,$165.00
2025-06-18,12:14:00,22009.0,BUY,3,0.02h,Break Even,$-1.50,$163.50,$229158.50,381,$163.50
2025-06-18,12:28:00,21999.75,SELL,3,0.02h,Break Even,$-1.50,$162.00,$229157.00,381,$162.00
2025-06-18,12:54:00,22001.75,BUY,3,0.02h,Break Even,$-1.50,$160.50,$229155.50,381,$160.50
2025-06-18,12:56:00,21992.5,SELL,3,0.02h,Stop Loss,$18.00,$178.50,$229173.50,381,$178.50
2025-06-18,13:05:00,21999.25,BUY,3,0.02h,Stop Loss,$4.50,$183.00,$229178.00,381,$183.00
2025-06-18,13:30:00,21992.75,SELL,3,0.02h,Stop Loss,$168.00,$351.00,$229346.00,381,$351.00
2025-06-18,13:48:00,21994.0,BUY,3,0.02h,Stop Loss,$16.50,$367.50,$229362.50,381,$367.50
2025-06-18,14:53:00,22065.75,SELL,3,0.02h,Stop Loss,$15.00,$382.50,$229377.50,381,$382.50
2025-06-18,15:02:00,22080.5,BUY,3,0.02h,Stop Loss,$-9.00,$373.50,$229368.50,381,$373.50
2025-06-18,15:07:00,22065.25,SELL,3,0.02h,Stop Loss,$18.00,$391.50,$229386.50,381,$391.50
2025-06-18,15:42:00,22062.75,BUY,3,0.02h,Stop Loss,$-9.00,$382.50,$229377.50,381,$382.50
2025-06-18,15:43:00,22051.25,SELL,3,0.02h,Stop Loss,$60.00,$442.50,$229437.50,381,$442.50
2025-06-18,15:50:00,22057.5,BUY,3,0.02h,Stop Loss,$25.50,$468.00,$229463.00,381,$468.00
2025-06-18,15:59:00,22038.0,SELL,3,0.02h,Stop Loss,$3.00,$471.00,$229466.00,381,$471.00
2025-06-18,16:13:00,22057.5,BUY,3,0.02h,Stop Loss,$3.00,$474.00,$229469.00,381,$474.00
2025-06-18,16:17:00,22045.25,SELL,3,0.02h,Stop Loss,$16.50,$490.50,$229485.50,381,$490.50
2025-06-18,16:52:00,22047.5,BUY,3,0.02h,Stop Loss,$-9.00,$481.50,$229476.50,381,$481.50
2025-06-18,16:54:00,22034.5,SELL,3,0.02h,Stop Loss,$16.50,$498.00,$229493.00,381,$498.00
2025-06-18,17:45:00,22003.5,BUY,3,0.02h,Stop Loss,$19.50,$517.50,$229512.50,381,$517.50
2025-06-18,18:05:00,21978.5,SELL,3,0.02h,Stop Loss,$34.50,$552.00,$229547.00,381,$552.00
2025-06-18,18:18:00,22023.5,BUY,3,0.02h,Stop Loss,$-9.00,$543.00,$229538.00,381,$543.00
2025-06-18,18:20:00,22000.5,SELL,3,0.02h,Stop Loss,$42.00,$585.00,$229580.00,381,$585.00
2025-06-18,18:28:00,22017.5,BUY,3,0.02h,Break Even,$-1.50,$583.50,$229578.50,381,$583.50
2025-06-18,18:29:00,22003.25,SELL,3,0.02h,Break Even,$-1.50,$582.00,$229577.00,381,$582.00
2025-06-18,18:30:00,22012.0,BUY,3,0.02h,Break Even,$-1.50,$580.50,$229575.50,381,$580.50
2025-06-18,18:31:00,22000.0,SELL,3,0.02h,Break Even,$-1.50,$579.00,$229574.00,381,$579.00
2025-06-18,18:32:00,22016.0,BUY,3,0.02h,Stop Loss,$129.00,$708.00,$229703.00,381,$708.00
2025-06-18,18:51:00,22008.5,SELL,3,0.02h,Stop Loss,$102.00,$810.00,$229805.00,381,$810.00
2025-06-18,19:16:00,21981.0,BUY,3,0.02h,Break Even,$-1.50,$808.50,$229803.50,381,$808.50
2025-06-18,19:29:00,21927.0,SELL,3,0.02h,Stop Loss,$27.00,$835.50,$229830.50,381,$835.50
2025-06-18,19:38:00,21984.5,BUY,3,0.02h,Stop Loss,$15.00,$850.50,$229845.50,381,$850.50
2025-06-18,19:52:00,21960.0,SELL,3,0.02h,Stop Loss,$45.00,$895.50,$229890.50,381,$895.50
2025-06-18,20:17:00,21967.5,BUY,3,0.02h,Break Even,$-1.50,$894.00,$229889.00,381,$894.00
2025-06-18,20:23:00,21957.75,SELL,3,0.02h,Stop Loss,$7.50,$901.50,$229896.50,381,$901.50
2025-06-18,20:39:00,21966.75,BUY,3,0.02h,Break Even,$-1.50,$900.00,$229895.00,381,$900.00
2025-06-18,23:00:00,21937.75,SELL,3,0.02h,Stop Loss,$13.50,$913.50,$229908.50,381,$913.50
2025-06-18,23:47:00,21938.5,BUY,3,0.02h,Stop Loss,$48.00,$961.50,$229956.50,381,$961.50
,,,,,,,,,,,
2025-06-19,00:05:00,21931.5,SELL,3,0.02h,Stop Loss,$31.50,$31.50,$229988.00,382,$31.50
2025-06-19,00:34:00,21899.0,BUY,3,0.02h,Stop Loss,$-9.00,$22.50,$229979.00,382,$22.50
2025-06-19,00:55:00,21896.25,SELL,3,0.02h,Stop Loss,$19.50,$42.00,$229998.50,382,$42.00
2025-06-19,01:31:00,21859.0,BUY,3,0.02h,Stop Loss,$40.50,$82.50,$230039.00,382,$82.50
2025-06-19,01:40:00,21841.25,SELL,3,0.02h,Stop Loss,$-9.00,$73.50,$230030.00,382,$73.50
2025-06-19,02:13:00,21842.0,BUY,3,0.02h,Break Even,$-1.50,$72.00,$230028.50,382,$72.00
2025-06-19,02:53:00,21852.75,SELL,3,0.02h,Stop Loss,$16.50,$88.50,$230045.00,382,$88.50
2025-06-19,03:04:00,21863.0,BUY,3,0.02h,Break Even,$-1.50,$87.00,$230043.50,382,$87.00
2025-06-19,03:37:00,21870.0,SELL,3,0.02h,Stop Loss,$-9.00,$78.00,$230034.50,382,$78.00
2025-06-19,03:46:00,21873.0,BUY,3,0.02h,Stop Loss,$-9.00,$69.00,$230025.50,382,$69.00
2025-06-19,03:51:00,21866.5,SELL,3,0.02h,Stop Loss,$-9.00,$60.00,$230016.50,382,$60.00
2025-06-19,03:53:00,21877.25,BUY,3,0.02h,Stop Loss,$-9.00,$51.00,$230007.50,382,$51.00
2025-06-19,04:27:00,21881.0,SELL,3,0.02h,Stop Loss,$-9.00,$42.00,$229998.50,382,$42.00
2025-06-19,04:41:00,21887.0,BUY,3,0.02h,Stop Loss,$24.00,$66.00,$230022.50,382,$66.00
2025-06-19,05:06:00,21893.25,SELL,3,0.02h,Stop Loss,$-9.00,$57.00,$230013.50,382,$57.00
2025-06-19,06:58:00,21846.25,BUY,3,0.02h,Break Even,$-1.50,$55.50,$230012.00,382,$55.50
2025-06-19,07:18:00,21836.5,SELL,3,0.02h,Stop Loss,$-9.00,$46.50,$230003.00,382,$46.50
2025-06-19,08:04:00,21831.25,BUY,3,0.02h,Break Even,$-1.50,$45.00,$230001.50,382,$45.00
2025-06-19,08:19:00,21816.0,SELL,3,0.02h,Break Even,$-1.50,$43.50,$230000.00,382,$43.50
2025-06-19,08:23:00,21824.5,BUY,3,0.02h,Break Even,$-1.50,$42.00,$229998.50,382,$42.00
2025-06-19,08:26:00,21818.75,SELL,3,0.02h,Stop Loss,$-9.00,$33.00,$229989.50,382,$33.00
2025-06-19,08:27:00,21821.0,BUY,3,0.02h,Stop Loss,$-9.00,$24.00,$229980.50,382,$24.00
2025-06-19,08:28:00,21817.75,SELL,3,0.02h,Stop Loss,$-9.00,$15.00,$229971.50,382,$15.00
2025-06-19,08:29:00,21822.75,BUY,3,0.02h,Break Even,$-1.50,$13.50,$229970.00,382,$13.50
2025-06-19,08:41:00,21814.5,SELL,3,0.02h,Stop Loss,$9.00,$22.50,$229979.00,382,$22.50
2025-06-19,08:45:00,21821.75,BUY,3,0.02h,Stop Loss,$4.50,$27.00,$229983.50,382,$27.00
2025-06-19,09:20:00,21826.75,SELL,3,0.02h,Stop Loss,$-9.00,$18.00,$229974.50,382,$18.00
2025-06-19,09:23:00,21835.75,BUY,3,0.02h,Stop Loss,$22.50,$40.50,$229997.00,382,$40.50
2025-06-19,09:53:00,21836.0,SELL,3,0.02h,Break Even,$-1.50,$39.00,$229995.50,382,$39.00
2025-06-19,10:24:00,21833.0,BUY,3,0.02h,Break Even,$-1.50,$37.50,$229994.00,382,$37.50
2025-06-19,11:06:00,21835.5,SELL,3,0.02h,Stop Loss,$34.50,$72.00,$230028.50,382,$72.00
2025-06-19,11:52:00,21817.0,BUY,3,0.02h,Stop Loss,$3.00,$75.00,$230031.50,382,$75.00
2025-06-19,12:04:00,21802.5,SELL,3,0.02h,Stop Loss,$21.00,$96.00,$230052.50,382,$96.00
2025-06-19,12:16:00,21810.5,BUY,3,0.02h,Break Even,$-1.50,$94.50,$230051.00,382,$94.50
2025-06-19,12:18:00,21797.0,SELL,3,0.02h,Break Even,$-1.50,$93.00,$230049.50,382,$93.00
2025-06-19,12:24:00,21811.75,BUY,3,0.02h,Break Even,$-1.50,$91.50,$230048.00,382,$91.50
2025-06-19,12:35:00,21791.75,SELL,3,0.02h,Stop Loss,$6.00,$97.50,$230054.00,382,$97.50
2025-06-19,13:15:00,21770.0,BUY,3,0.02h,Break Even,$-1.50,$96.00,$230052.50,382,$96.00
2025-06-19,13:34:00,21759.5,SELL,3,0.02h,Stop Loss,$12.00,$108.00,$230064.50,382,$108.00
2025-06-19,14:11:00,21709.75,BUY,3,0.02h,Break Even,$-1.50,$106.50,$230063.00,382,$106.50
2025-06-19,14:34:00,21698.5,SELL,3,0.02h,Stop Loss,$30.00,$136.50,$230093.00,382,$136.50
2025-06-19,14:54:00,21708.75,BUY,3,0.02h,Stop Loss,$76.50,$213.00,$230169.50,382,$213.00
2025-06-19,15:12:00,21710.0,SELL,3,0.02h,Break Even,$-1.50,$211.50,$230168.00,382,$211.50
2025-06-19,15:14:00,21729.75,BUY,3,0.02h,Stop Loss,$46.50,$258.00,$230214.50,382,$258.00
2025-06-19,15:24:00,21708.5,SELL,3,0.02h,Stop Loss,$-9.00,$249.00,$230205.50,382,$249.00
2025-06-19,15:47:00,21716.75,BUY,3,0.02h,Stop Loss,$19.50,$268.50,$230225.00,382,$268.50
2025-06-19,15:53:00,21694.75,SELL,3,0.02h,Stop Loss,$60.00,$328.50,$230285.00,382,$328.50
2025-06-19,16:07:00,21711.0,BUY,3,0.02h,Stop Loss,$13.50,$342.00,$230298.50,382,$342.00
2025-06-19,16:46:00,21721.5,SELL,3,0.02h,Stop Loss,$15.00,$357.00,$230313.50,382,$357.00
2025-06-19,16:51:00,21733.0,BUY,3,0.02h,Stop Loss,$-9.00,$348.00,$230304.50,382,$348.00
2025-06-19,16:53:00,21722.25,SELL,3,0.02h,Stop Loss,$3.00,$351.00,$230307.50,382,$351.00
2025-06-19,23:00:00,21894.25,BUY,3,0.02h,Stop Loss,$36.00,$387.00,$230343.50,382,$387.00
,,,,,,,,,,,
2025-06-20,00:08:00,21886.75,SELL,3,0.02h,Stop Loss,$-9.00,$-9.00,$230334.50,383,$-9.00
2025-06-20,00:09:00,21894.0,BUY,3,0.02h,Stop Loss,$96.00,$87.00,$230430.50,383,$87.00
2025-06-20,00:38:00,21904.5,SELL,3,0.02h,Stop Loss,$-9.00,$78.00,$230421.50,383,$78.00
2025-06-20,01:27:00,21881.0,BUY,3,0.02h,Stop Loss,$-9.00,$69.00,$230412.50,383,$69.00
2025-06-20,01:28:00,21870.5,SELL,3,0.02h,Stop Loss,$15.00,$84.00,$230427.50,383,$84.00
2025-06-20,01:48:00,21872.0,BUY,3,0.02h,Stop Loss,$-9.00,$75.00,$230418.50,383,$75.00
2025-06-20,01:50:00,21864.75,SELL,3,0.02h,Stop Loss,$-9.00,$66.00,$230409.50,383,$66.00
2025-06-20,01:52:00,21871.25,BUY,3,0.02h,Stop Loss,$19.50,$85.50,$230429.00,383,$85.50
2025-06-20,02:58:00,21893.0,SELL,3,0.02h,Break Even,$-1.50,$84.00,$230427.50,383,$84.00
2025-06-20,03:15:00,21894.5,BUY,3,0.02h,Stop Loss,$-9.00,$75.00,$230418.50,383,$75.00
2025-06-20,03:17:00,21884.5,SELL,3,0.02h,Stop Loss,$-9.00,$66.00,$230409.50,383,$66.00
2025-06-20,03:20:00,21895.0,BUY,3,0.02h,Stop Loss,$12.00,$78.00,$230421.50,383,$78.00
2025-06-20,03:54:00,21901.75,SELL,3,0.02h,Stop Loss,$-9.00,$69.00,$230412.50,383,$69.00
2025-06-20,04:20:00,21903.25,BUY,3,0.02h,Break Even,$-1.50,$67.50,$230411.00,383,$67.50
2025-06-20,05:03:00,21904.75,SELL,3,0.02h,Break Even,$-1.50,$66.00,$230409.50,383,$66.00
2025-06-20,05:45:00,21901.25,BUY,3,0.02h,Break Even,$-1.50,$64.50,$230408.00,383,$64.50
2025-06-20,06:34:00,21923.0,SELL,3,0.02h,Break Even,$-1.50,$63.00,$230406.50,383,$63.00
2025-06-20,07:20:00,21908.5,BUY,3,0.02h,Break Even,$-1.50,$61.50,$230405.00,383,$61.50
2025-06-20,07:41:00,21908.25,SELL,3,0.02h,Stop Loss,$-9.00,$52.50,$230396.00,383,$52.50
2025-06-20,07:45:00,21913.5,BUY,3,0.02h,Stop Loss,$-9.00,$43.50,$230387.00,383,$43.50
2025-06-20,07:46:00,21907.5,SELL,3,0.02h,Stop Loss,$-9.00,$34.50,$230378.00,383,$34.50
2025-06-20,07:49:00,21914.0,BUY,3,0.02h,Stop Loss,$43.50,$78.00,$230421.50,383,$78.00
2025-06-20,08:22:00,21923.0,SELL,3,0.02h,Break Even,$-1.50,$76.50,$230420.00,383,$76.50
2025-06-20,09:12:00,21885.5,BUY,3,0.02h,Break Even,$-1.50,$75.00,$230418.50,383,$75.00
2025-06-20,09:32:00,21880.0,SELL,3,0.02h,Break Even,$-1.50,$73.50,$230417.00,383,$73.50
2025-06-20,09:45:00,21891.75,BUY,3,0.02h,Stop Loss,$-9.00,$64.50,$230408.00,383,$64.50
2025-06-20,10:15:00,21893.5,SELL,3,0.02h,Stop Loss,$30.00,$94.50,$230438.00,383,$94.50
2025-06-20,10:34:00,21895.0,BUY,3,0.02h,Break Even,$-1.50,$93.00,$230436.50,383,$93.00
2025-06-20,10:54:00,21897.0,SELL,3,0.02h,Stop Loss,$-9.00,$84.00,$230427.50,383,$84.00
2025-06-20,10:55:00,21905.5,BUY,3,0.02h,Stop Loss,$10.50,$94.50,$230438.00,383,$94.50
2025-06-20,11:28:00,21906.25,SELL,3,0.02h,Stop Loss,$-9.00,$85.50,$230429.00,383,$85.50
2025-06-20,11:34:00,21914.0,BUY,3,0.02h,Break Even,$-1.50,$84.00,$230427.50,383,$84.00
2025-06-20,12:27:00,21974.25,SELL,3,0.02h,Stop Loss,$-9.00,$75.00,$230418.50,383,$75.00
2025-06-20,12:29:00,21985.75,BUY,3,0.02h,Stop Loss,$3.00,$78.00,$230421.50,383,$78.00
2025-06-20,13:51:00,22052.0,SELL,3,0.02h,Stop Loss,$51.00,$129.00,$230472.50,383,$129.00
2025-06-20,15:15:00,21853.25,BUY,3,0.02h,Break Even,$-1.50,$127.50,$230471.00,383,$127.50
2025-06-20,15:54:00,21868.5,SELL,3,0.02h,Stop Loss,$58.50,$186.00,$230529.50,383,$186.00
2025-06-20,16:13:00,21872.75,BUY,3,0.02h,Stop Loss,$-9.00,$177.00,$230520.50,383,$177.00
2025-06-20,16:15:00,21857.25,SELL,3,0.02h,Stop Loss,$34.50,$211.50,$230555.00,383,$211.50
2025-06-20,16:28:00,21872.25,BUY,3,0.02h,Break Even,$-1.50,$210.00,$230553.50,383,$210.00
2025-06-20,17:06:00,21855.75,SELL,3,0.02h,Stop Loss,$22.50,$232.50,$230576.00,383,$232.50
2025-06-20,17:15:00,21886.25,BUY,3,0.02h,Stop Loss,$160.50,$393.00,$230736.50,383,$393.00
2025-06-20,17:19:00,21863.25,SELL,3,0.02h,Stop Loss,$7.50,$400.50,$230744.00,383,$400.50
2025-06-20,17:53:00,21818.75,BUY,3,0.02h,Stop Loss,$27.00,$427.50,$230771.00,383,$427.50
2025-06-20,18:44:00,21865.75,SELL,3,0.02h,Stop Loss,$-9.00,$418.50,$230762.00,383,$418.50
2025-06-20,19:55:00,21820.75,BUY,3,0.02h,Stop Loss,$214.50,$633.00,$230976.50,383,$633.00
2025-06-20,20:23:00,21849.5,SELL,3,0.02h,Stop Loss,$-9.00,$624.00,$230967.50,383,$624.00
2025-06-20,20:27:00,21861.5,BUY,3,0.02h,Stop Loss,$-9.00,$615.00,$230958.50,383,$615.00
,,,,,,,,,,,
2025-06-23,00:00:00,21760.75,SELL,3,0.02h,Stop Loss,$72.00,$72.00,$231030.50,384,$72.00
2025-06-23,00:43:00,21730.25,BUY,3,0.02h,Stop Loss,$-9.00,$63.00,$231021.50,384,$63.00
2025-06-23,01:04:00,21723.75,SELL,3,0.02h,Break Even,$-1.50,$61.50,$231020.00,384,$61.50
2025-06-23,01:11:00,21746.25,BUY,3,0.02h,Stop Loss,$-9.00,$52.50,$231011.00,384,$52.50
2025-06-23,01:20:00,21716.5,SELL,3,0.02h,Break Even,$-1.50,$51.00,$231009.50,384,$51.00
2025-06-23,01:43:00,21725.75,BUY,3,0.02h,Break Even,$-1.50,$49.50,$231008.00,384,$49.50
2025-06-23,02:50:00,21750.0,SELL,3,0.02h,Stop Loss,$-9.00,$40.50,$230999.00,384,$40.50
2025-06-23,03:01:00,21760.25,BUY,3,0.02h,Stop Loss,$-9.00,$31.50,$230990.00,384,$31.50
2025-06-23,03:16:00,21758.5,SELL,3,0.02h,Stop Loss,$-9.00,$22.50,$230981.00,384,$22.50
2025-06-23,03:17:00,21763.75,BUY,3,0.02h,Break Even,$-1.50,$21.00,$230979.50,384,$21.00
2025-06-23,03:28:00,21760.0,SELL,3,0.02h,Break Even,$-1.50,$19.50,$230978.00,384,$19.50
2025-06-23,03:32:00,21764.75,BUY,3,0.02h,Break Even,$-1.50,$18.00,$230976.50,384,$18.00
2025-06-23,03:53:00,21759.0,SELL,3,0.02h,Stop Loss,$-9.00,$9.00,$230967.50,384,$9.00
2025-06-23,04:02:00,21768.75,BUY,3,0.02h,Break Even,$-1.50,$7.50,$230966.00,384,$7.50
2025-06-23,04:07:00,21759.75,SELL,3,0.02h,Stop Loss,$-9.00,$-1.50,$230957.00,384,$-1.50
2025-06-23,04:19:00,21765.25,BUY,3,0.02h,Break Even,$-1.50,$-3.00,$230955.50,384,$-3.00
2025-06-23,04:35:00,21762.25,SELL,3,0.02h,Break Even,$-1.50,$-4.50,$230954.00,384,$-4.50
2025-06-23,05:00:00,21764.75,BUY,3,0.02h,Break Even,$-1.50,$-6.00,$230952.50,384,$-6.00
2025-06-23,06:22:00,21809.75,SELL,3,0.02h,Break Even,$-1.50,$-7.50,$230951.00,384,$-7.50
2025-06-23,06:23:00,21812.25,BUY,3,0.02h,Stop Loss,$-9.00,$-16.50,$230942.00,384,$-16.50
2025-06-23,06:24:00,21806.5,SELL,3,0.02h,Stop Loss,$4.50,$-12.00,$230946.50,384,$-12.00
2025-06-23,06:33:00,21817.0,BUY,3,0.02h,Stop Loss,$-9.00,$-21.00,$230937.50,384,$-21.00
2025-06-23,06:38:00,21808.75,SELL,3,0.02h,Stop Loss,$-9.00,$-30.00,$230928.50,384,$-30.00
2025-06-23,06:39:00,21813.75,BUY,3,0.02h,Break Even,$-1.50,$-31.50,$230927.00,384,$-31.50
2025-06-23,08:28:00,21901.5,SELL,3,0.02h,Stop Loss,$-9.00,$-40.50,$230918.00,384,$-40.50
2025-06-23,08:37:00,21916.0,BUY,3,0.02h,Stop Loss,$-9.00,$-49.50,$230909.00,384,$-49.50
2025-06-23,08:52:00,21905.25,SELL,3,0.02h,Break Even,$-1.50,$-51.00,$230907.50,384,$-51.00
2025-06-23,09:17:00,21909.0,BUY,3,0.02h,Stop Loss,$27.00,$-24.00,$230934.50,384,$-24.00
2025-06-23,09:29:00,21904.25,SELL,3,0.02h,Stop Loss,$16.50,$-7.50,$230951.00,384,$-7.50
2025-06-23,10:13:00,21905.75,BUY,3,0.02h,Stop Loss,$-9.00,$-16.50,$230942.00,384,$-16.50
2025-06-23,10:17:00,21885.25,SELL,3,0.02h,Break Even,$-1.50,$-18.00,$230940.50,384,$-18.00
2025-06-23,11:40:00,21822.25,BUY,3,0.02h,Stop Loss,$-9.00,$-27.00,$230931.50,384,$-27.00
2025-06-23,11:41:00,21808.0,SELL,3,0.02h,Stop Loss,$36.00,$9.00,$230967.50,384,$9.00
2025-06-23,11:56:00,21823.5,BUY,3,0.02h,Break Even,$-1.50,$7.50,$230966.00,384,$7.50
2025-06-23,13:12:00,21861.5,SELL,3,0.02h,Break Even,$-1.50,$6.00,$230964.50,384,$6.00
2025-06-23,13:19:00,21883.5,BUY,3,0.02h,Stop Loss,$13.50,$19.50,$230978.00,384,$19.50
2025-06-23,13:28:00,21861.75,SELL,3,0.02h,Break Even,$-1.50,$18.00,$230976.50,384,$18.00
2025-06-23,13:44:00,21874.25,BUY,3,0.02h,Stop Loss,$31.50,$49.50,$231008.00,384,$49.50
2025-06-23,14:53:00,21980.5,SELL,3,0.02h,Stop Loss,$10.50,$60.00,$231018.50,384,$60.00
2025-06-23,15:07:00,21995.25,BUY,3,0.02h,Stop Loss,$19.50,$79.50,$231038.00,384,$79.50
2025-06-23,15:23:00,21977.75,SELL,3,0.02h,Stop Loss,$-9.00,$70.50,$231029.00,384,$70.50
2025-06-23,16:46:00,21902.25,BUY,3,0.02h,Stop Loss,$27.00,$97.50,$231056.00,384,$97.50
2025-06-23,16:59:00,21851.75,SELL,3,0.02h,Stop Loss,$61.50,$159.00,$231117.50,384,$159.00
2025-06-23,17:03:00,21883.5,BUY,3,0.02h,Stop Loss,$34.50,$193.50,$231152.00,384,$193.50
2025-06-23,18:26:00,22054.25,SELL,3,0.02h,Break Even,$-1.50,$192.00,$231150.50,384,$192.00
2025-06-23,19:02:00,22063.25,BUY,3,0.02h,Stop Loss,$16.50,$208.50,$231167.00,384,$208.50
2025-06-23,19:18:00,22029.0,SELL,3,0.02h,Break Even,$-1.50,$207.00,$231165.50,384,$207.00
2025-06-23,19:27:00,22053.5,BUY,3,0.02h,Stop Loss,$13.50,$220.50,$231179.00,384,$220.50
2025-06-23,19:42:00,22047.0,SELL,3,0.02h,Break Even,$-1.50,$219.00,$231177.50,384,$219.00
2025-06-23,19:51:00,22055.0,BUY,3,0.02h,Stop Loss,$30.00,$249.00,$231207.50,384,$249.00
2025-06-23,20:23:00,22064.25,SELL,3,0.02h,Stop Loss,$-9.00,$240.00,$231198.50,384,$240.00
2025-06-23,20:24:00,22068.75,BUY,3,0.02h,Break Even,$-1.50,$238.50,$231197.00,384,$238.50
2025-06-23,20:56:00,22071.25,SELL,3,0.02h,Break Even,$-1.50,$237.00,$231195.50,384,$237.00
2025-06-23,23:00:00,22204.5,BUY,3,0.02h,Stop Loss,$58.50,$295.50,$231254.00,384,$295.50
,,,,,,,,,,,
2025-06-24,00:04:00,22231.5,SELL,3,0.02h,Stop Loss,$4.50,$4.50,$231258.50,385,$4.50
2025-06-24,00:08:00,22243.5,BUY,3,0.02h,Stop Loss,$4.50,$9.00,$231263.00,385,$9.00
2025-06-24,00:13:00,22231.25,SELL,3,0.02h,Stop Loss,$-9.00,$0.00,$231254.00,385,$0.00
2025-06-24,00:53:00,22243.5,BUY,3,0.02h,Stop Loss,$-9.00,$-9.00,$231245.00,385,$-9.00
2025-06-24,01:01:00,22223.75,SELL,3,0.02h,Stop Loss,$22.50,$13.50,$231267.50,385,$13.50
2025-06-24,01:09:00,22233.75,BUY,3,0.02h,Break Even,$-1.50,$12.00,$231266.00,385,$12.00
2025-06-24,02:06:00,22249.0,SELL,3,0.02h,Stop Loss,$22.50,$34.50,$231288.50,385,$34.50
2025-06-24,02:56:00,22241.0,BUY,3,0.02h,Stop Loss,$-9.00,$25.50,$231279.50,385,$25.50
2025-06-24,04:05:00,22244.25,SELL,3,0.02h,Stop Loss,$-9.00,$16.50,$231270.50,385,$16.50
2025-06-24,04:06:00,22247.5,BUY,3,0.02h,Stop Loss,$-9.00,$7.50,$231261.50,385,$7.50
2025-06-24,04:09:00,22244.75,SELL,3,0.02h,Stop Loss,$21.00,$28.50,$231282.50,385,$28.50
2025-06-24,04:34:00,22237.0,BUY,3,0.02h,Break Even,$-1.50,$27.00,$231281.00,385,$27.00
2025-06-24,07:03:00,22334.75,SELL,3,0.02h,Stop Loss,$-9.00,$18.00,$231272.00,385,$18.00
2025-06-24,07:04:00,22356.0,BUY,3,0.02h,Stop Loss,$45.00,$63.00,$231317.00,385,$63.00
2025-06-24,07:16:00,22350.0,SELL,3,0.02h,Stop Loss,$-9.00,$54.00,$231308.00,385,$54.00
2025-06-24,07:17:00,22366.75,BUY,3,0.02h,Break Even,$-1.50,$52.50,$231306.50,385,$52.50
2025-06-24,07:23:00,22353.0,SELL,3,0.02h,Stop Loss,$19.50,$72.00,$231326.00,385,$72.00
2025-06-24,08:11:00,22315.75,BUY,3,0.02h,Stop Loss,$-9.00,$63.00,$231317.00,385,$63.00
2025-06-24,08:18:00,22302.75,SELL,3,0.02h,Break Even,$-1.50,$61.50,$231315.50,385,$61.50
2025-06-24,08:20:00,22305.25,BUY,3,0.02h,Stop Loss,$19.50,$81.00,$231335.00,385,$81.00
2025-06-24,08:36:00,22304.25,SELL,3,0.02h,Break Even,$-1.50,$79.50,$231333.50,385,$79.50
2025-06-24,09:02:00,22312.25,BUY,3,0.02h,Stop Loss,$-9.00,$70.50,$231324.50,385,$70.50
2025-06-24,09:50:00,22326.5,SELL,3,0.02h,Break Even,$-1.50,$69.00,$231323.00,385,$69.00
2025-06-24,10:48:00,22294.5,BUY,3,0.02h,Break Even,$-1.50,$67.50,$231321.50,385,$67.50
2025-06-24,10:59:00,22285.0,SELL,3,0.02h,Stop Loss,$-9.00,$58.50,$231312.50,385,$58.50
2025-06-24,11:29:00,22287.0,BUY,3,0.02h,Stop Loss,$67.50,$126.00,$231380.00,385,$126.00
2025-06-24,12:13:00,22293.5,SELL,3,0.02h,Stop Loss,$33.00,$159.00,$231413.00,385,$159.00
2025-06-24,12:37:00,22295.25,BUY,3,0.02h,Break Even,$-1.50,$157.50,$231411.50,385,$157.50
2025-06-24,12:51:00,22277.25,SELL,3,0.02h,Stop Loss,$6.00,$163.50,$231417.50,385,$163.50
2025-06-24,13:12:00,22287.0,BUY,3,0.02h,Stop Loss,$4.50,$168.00,$231422.00,385,$168.00
2025-06-24,13:31:00,22277.5,SELL,3,0.02h,Break Even,$-1.50,$166.50,$231420.50,385,$166.50
2025-06-24,13:32:00,22303.75,BUY,3,0.02h,Stop Loss,$46.50,$213.00,$231467.00,385,$213.00
2025-06-24,13:34:00,22283.75,SELL,3,0.02h,Stop Loss,$7.50,$220.50,$231474.50,385,$220.50
2025-06-24,13:36:00,22301.5,BUY,3,0.02h,Stop Loss,$28.50,$249.00,$231503.00,385,$249.00
2025-06-24,13:54:00,22296.5,SELL,3,0.02h,Break Even,$-1.50,$247.50,$231501.50,385,$247.50
2025-06-24,14:18:00,22316.75,BUY,3,0.02h,Stop Loss,$28.50,$276.00,$231530.00,385,$276.00
2025-06-24,15:00:00,22315.0,SELL,3,0.02h,Break Even,$-1.50,$274.50,$231528.50,385,$274.50
2025-06-24,15:02:00,22330.0,BUY,3,0.02h,Stop Loss,$90.00,$364.50,$231618.50,385,$364.50
2025-06-24,15:57:00,22365.75,SELL,3,0.02h,Break Even,$-1.50,$363.00,$231617.00,385,$363.00
2025-06-24,16:07:00,22375.5,BUY,3,0.02h,Stop Loss,$6.00,$369.00,$231623.00,385,$369.00
2025-06-24,16:56:00,22398.75,SELL,3,0.02h,Stop Loss,$18.00,$387.00,$231641.00,385,$387.00
2025-06-24,17:02:00,22407.5,BUY,3,0.02h,Break Even,$-1.50,$385.50,$231639.50,385,$385.50
2025-06-24,17:22:00,22381.0,SELL,3,0.02h,Stop Loss,$-9.00,$376.50,$231630.50,385,$376.50
2025-06-24,17:34:00,22402.5,BUY,3,0.02h,Break Even,$-1.50,$375.00,$231629.00,385,$375.00
2025-06-24,18:15:00,22412.75,SELL,3,0.02h,Stop Loss,$-9.00,$366.00,$231620.00,385,$366.00
2025-06-24,18:24:00,22422.0,BUY,3,0.02h,Break Even,$-1.50,$364.50,$231618.50,385,$364.50
2025-06-24,18:30:00,22415.0,SELL,3,0.02h,Break Even,$-1.50,$363.00,$231617.00,385,$363.00
2025-06-24,18:38:00,22426.75,BUY,3,0.02h,Stop Loss,$-9.00,$354.00,$231608.00,385,$354.00
2025-06-24,18:55:00,22417.0,SELL,3,0.02h,Break Even,$-1.50,$352.50,$231606.50,385,$352.50
2025-06-24,18:58:00,22426.75,BUY,3,0.02h,Stop Loss,$-9.00,$343.50,$231597.50,385,$343.50
2025-06-24,19:22:00,22429.0,SELL,3,0.02h,Stop Loss,$-9.00,$334.50,$231588.50,385,$334.50
2025-06-24,20:25:00,22406.0,BUY,3,0.02h,Break Even,$-1.50,$333.00,$231587.00,385,$333.00
2025-06-24,20:59:00,22410.5,SELL,3,0.02h,Break Even,$-1.50,$331.50,$231585.50,385,$331.50
2025-06-24,23:29:00,22401.0,BUY,3,0.02h,Stop Loss,$-9.00,$322.50,$231576.50,385,$322.50
,,,,,,,,,,,
2025-06-25,00:36:00,22414.75,SELL,3,0.02h,Stop Loss,$-9.00,$-9.00,$231567.50,386,$-9.00
2025-06-25,00:47:00,22421.5,BUY,3,0.02h,Break Even,$-1.50,$-10.50,$231566.00,386,$-10.50
2025-06-25,00:49:00,22417.75,SELL,3,0.02h,Stop Loss,$-9.00,$-19.50,$231557.00,386,$-19.50
2025-06-25,00:52:00,22423.75,BUY,3,0.02h,Break Even,$-1.50,$-21.00,$231555.50,386,$-21.00
2025-06-25,01:04:00,22419.75,SELL,3,0.02h,Break Even,$-1.50,$-22.50,$231554.00,386,$-22.50
2025-06-25,02:12:00,22402.0,BUY,3,0.03h,Stop Loss,$-9.00,$-31.50,$231545.00,386,$-31.50
2025-06-25,02:21:00,22398.75,SELL,3,0.02h,Stop Loss,$-9.00,$-40.50,$231536.00,386,$-40.50
2025-06-25,02:32:00,22403.25,BUY,3,0.02h,Stop Loss,$-9.00,$-49.50,$231527.00,386,$-49.50
2025-06-25,03:41:00,22411.5,SELL,3,0.02h,Break Even,$-1.50,$-51.00,$231525.50,386,$-51.00
2025-06-25,04:07:00,22412.0,BUY,3,0.02h,Break Even,$-1.50,$-52.50,$231524.00,386,$-52.50
2025-06-25,05:46:00,22431.0,SELL,3,0.02h,Break Even,$-1.50,$-54.00,$231522.50,386,$-54.00
2025-06-25,06:13:00,22432.5,BUY,3,0.02h,Break Even,$-1.50,$-55.50,$231521.00,386,$-55.50
2025-06-25,06:18:00,22426.5,SELL,3,0.02h,Stop Loss,$4.50,$-51.00,$231525.50,386,$-51.00
2025-06-25,06:41:00,22427.0,BUY,3,0.02h,Stop Loss,$-9.00,$-60.00,$231516.50,386,$-60.00
2025-06-25,06:51:00,22424.0,SELL,3,0.02h,Stop Loss,$-9.00,$-69.00,$231507.50,386,$-69.00
2025-06-25,06:54:00,22427.0,BUY,3,0.02h,Stop Loss,$-9.00,$-78.00,$231498.50,386,$-78.00
2025-06-25,06:55:00,22424.5,SELL,3,0.02h,Break Even,$-1.50,$-79.50,$231497.00,386,$-79.50
2025-06-25,06:57:00,22427.5,BUY,3,0.02h,Stop Loss,$-9.00,$-88.50,$231488.00,386,$-88.50
2025-06-25,06:58:00,22424.75,SELL,3,0.02h,Break Even,$-1.50,$-90.00,$231486.50,386,$-90.00
2025-06-25,07:14:00,22429.75,BUY,3,0.02h,Stop Loss,$-9.00,$-99.00,$231477.50,386,$-99.00
2025-06-25,07:21:00,22420.25,SELL,3,0.02h,Stop Loss,$-9.00,$-108.00,$231468.50,386,$-108.00
2025-06-25,07:28:00,22425.75,BUY,3,0.02h,Stop Loss,$-9.00,$-117.00,$231459.50,386,$-117.00
2025-06-25,07:33:00,22417.5,SELL,3,0.02h,Break Even,$-1.50,$-118.50,$231458.00,386,$-118.50
2025-06-25,07:58:00,22424.25,BUY,3,0.02h,Break Even,$-1.50,$-120.00,$231456.50,386,$-120.00
2025-06-25,08:07:00,22415.0,SELL,3,0.02h,Stop Loss,$-9.00,$-129.00,$231447.50,386,$-129.00
2025-06-25,08:16:00,22432.0,BUY,3,0.02h,Stop Loss,$-9.00,$-138.00,$231438.50,386,$-138.00
2025-06-25,08:31:00,22410.0,SELL,3,0.02h,Break Even,$-1.50,$-139.50,$231437.00,386,$-139.50
2025-06-25,08:44:00,22423.75,BUY,3,0.02h,Stop Loss,$-9.00,$-148.50,$231428.00,386,$-148.50
2025-06-25,09:31:00,22429.75,SELL,3,0.02h,Break Even,$-1.50,$-150.00,$231426.50,386,$-150.00
2025-06-25,10:26:00,22426.25,BUY,3,0.02h,Stop Loss,$6.00,$-144.00,$231432.50,386,$-144.00
2025-06-25,12:34:00,22485.75,SELL,3,0.02h,Break Even,$-1.50,$-145.50,$231431.00,386,$-145.50
2025-06-25,12:39:00,22493.25,BUY,3,0.02h,Break Even,$-1.50,$-147.00,$231429.50,386,$-147.00
2025-06-25,13:10:00,22498.0,SELL,3,0.02h,Break Even,$-1.50,$-148.50,$231428.00,386,$-148.50
2025-06-25,13:14:00,22506.5,BUY,3,0.02h,Break Even,$-1.50,$-150.00,$231426.50,386,$-150.00
2025-06-25,13:29:00,22498.5,SELL,3,0.02h,Stop Loss,$-9.00,$-159.00,$231417.50,386,$-159.00
2025-06-25,13:31:00,22517.75,BUY,3,0.02h,Stop Loss,$54.00,$-105.00,$231471.50,386,$-105.00
2025-06-25,13:51:00,22501.25,SELL,3,0.02h,Stop Loss,$40.50,$-64.50,$231512.00,386,$-64.50
2025-06-25,14:00:00,22522.5,BUY,3,0.02h,Stop Loss,$19.50,$-45.00,$231531.50,386,$-45.00
2025-06-25,14:02:00,22512.0,SELL,3,0.02h,Stop Loss,$60.00,$15.00,$231591.50,386,$15.00
2025-06-25,14:33:00,22494.5,BUY,3,0.02h,Stop Loss,$7.50,$22.50,$231599.00,386,$22.50
2025-06-25,14:51:00,22480.25,SELL,3,0.02h,Stop Loss,$3.00,$25.50,$231602.00,386,$25.50
2025-06-25,15:52:00,22456.75,BUY,3,0.02h,Stop Loss,$-9.00,$16.50,$231593.00,386,$16.50
2025-06-25,16:00:00,22444.25,SELL,3,0.02h,Stop Loss,$-9.00,$7.50,$231584.00,386,$7.50
2025-06-25,16:02:00,22454.25,BUY,3,0.02h,Break Even,$-1.50,$6.00,$231582.50,386,$6.00
2025-06-25,16:05:00,22448.25,SELL,3,0.02h,Stop Loss,$4.50,$10.50,$231587.00,386,$10.50
2025-06-25,16:54:00,22436.75,BUY,3,0.02h,Break Even,$-1.50,$9.00,$231585.50,386,$9.00
2025-06-25,17:09:00,22427.5,SELL,3,0.02h,Stop Loss,$3.00,$12.00,$231588.50,386,$12.00
2025-06-25,17:16:00,22445.5,BUY,3,0.02h,Break Even,$-1.50,$10.50,$231587.00,386,$10.50
2025-06-25,17:34:00,22433.5,SELL,3,0.02h,Stop Loss,$48.00,$58.50,$231635.00,386,$58.50
2025-06-25,18:13:00,22424.75,BUY,3,0.02h,Stop Loss,$-9.00,$49.50,$231626.00,386,$49.50
2025-06-25,18:33:00,22416.75,SELL,3,0.02h,Break Even,$-1.50,$48.00,$231624.50,386,$48.00
2025-06-25,18:58:00,22424.0,BUY,3,0.02h,Stop Loss,$-9.00,$39.00,$231615.50,386,$39.00
2025-06-25,19:32:00,22428.75,SELL,3,0.02h,Stop Loss,$-9.00,$30.00,$231606.50,386,$30.00
2025-06-25,19:45:00,22441.25,BUY,3,0.02h,Break Even,$-1.50,$28.50,$231605.00,386,$28.50
2025-06-25,19:47:00,22434.0,SELL,3,0.02h,Break Even,$-1.50,$27.00,$231603.50,386,$27.00
2025-06-25,19:51:00,22443.25,BUY,3,0.02h,Stop Loss,$10.50,$37.50,$231614.00,386,$37.50
2025-06-25,20:27:00,22461.25,SELL,3,0.02h,Stop Loss,$-9.00,$28.50,$231605.00,386,$28.50
2025-06-25,20:38:00,22464.75,BUY,3,0.02h,Stop Loss,$-9.00,$19.50,$231596.00,386,$19.50
2025-06-25,23:01:00,22460.25,SELL,3,0.02h,Stop Loss,$30.00,$49.50,$231626.00,386,$49.50
2025-06-25,23:41:00,22456.0,BUY,3,0.02h,Stop Loss,$13.50,$63.00,$231639.50,386,$63.00
,,,,,,,,,,,
2025-06-26,01:02:00,22473.0,SELL,3,0.02h,Break Even,$-1.50,$-1.50,$231638.00,387,$-1.50
2025-06-26,01:11:00,22479.0,BUY,3,0.02h,Stop Loss,$-9.00,$-10.50,$231629.00,387,$-10.50
2025-06-26,01:12:00,22474.5,SELL,3,0.02h,Break Even,$-1.50,$-12.00,$231627.50,387,$-12.00
2025-06-26,01:54:00,22468.5,BUY,3,0.03h,Break Even,$-1.50,$-13.50,$231626.00,387,$-13.50
2025-06-26,02:41:00,22474.75,SELL,3,0.02h,Stop Loss,$-9.00,$-22.50,$231617.00,387,$-22.50
2025-06-26,02:54:00,22477.25,BUY,3,0.02h,Break Even,$-1.50,$-24.00,$231615.50,387,$-24.00
2025-06-26,03:52:00,22494.75,SELL,3,0.02h,Stop Loss,$-9.00,$-33.00,$231606.50,387,$-33.00
2025-06-26,03:57:00,22496.5,BUY,3,0.02h,Stop Loss,$-9.00,$-42.00,$231597.50,387,$-42.00
2025-06-26,03:58:00,22494.75,SELL,3,0.03h,Stop Loss,$-9.00,$-51.00,$231588.50,387,$-51.00
2025-06-26,04:11:00,22496.25,BUY,3,0.03h,Stop Loss,$-9.00,$-60.00,$231579.50,387,$-60.00
2025-06-26,04:21:00,22493.0,SELL,3,0.03h,Break Even,$-1.50,$-61.50,$231578.00,387,$-61.50
2025-06-26,04:31:00,22497.5,BUY,3,0.02h,Break Even,$-1.50,$-63.00,$231576.50,387,$-63.00
2025-06-26,05:08:00,22497.5,SELL,3,0.02h,Stop Loss,$-9.00,$-72.00,$231567.50,387,$-72.00
2025-06-26,05:14:00,22500.5,BUY,3,0.02h,Stop Loss,$-9.00,$-81.00,$231558.50,387,$-81.00
2025-06-26,05:15:00,22498.5,SELL,3,0.03h,Stop Loss,$-9.00,$-90.00,$231549.50,387,$-90.00
2025-06-26,05:33:00,22498.75,BUY,3,0.02h,Stop Loss,$-9.00,$-99.00,$231540.50,387,$-99.00
2025-06-26,05:44:00,22496.5,SELL,3,0.02h,Stop Loss,$-9.00,$-108.00,$231531.50,387,$-108.00
2025-06-26,05:46:00,22500.0,BUY,3,0.03h,Break Even,$-1.50,$-109.50,$231530.00,387,$-109.50
2025-06-26,07:26:00,22531.75,SELL,3,0.02h,Stop Loss,$3.00,$-106.50,$231533.00,387,$-106.50
2025-06-26,07:42:00,22531.75,BUY,3,0.02h,Break Even,$-1.50,$-108.00,$231531.50,387,$-108.00
2025-06-26,08:01:00,22530.5,SELL,3,0.02h,Break Even,$-1.50,$-109.50,$231530.00,387,$-109.50
2025-06-26,08:05:00,22537.75,BUY,3,0.02h,Stop Loss,$9.00,$-100.50,$231539.00,387,$-100.50
2025-06-26,08:48:00,22561.0,SELL,3,0.02h,Stop Loss,$-9.00,$-109.50,$231530.00,387,$-109.50
2025-06-26,09:04:00,22565.25,BUY,3,0.02h,Stop Loss,$-9.00,$-118.50,$231521.00,387,$-118.50
2025-06-26,09:11:00,22561.25,SELL,3,0.02h,Break Even,$-1.50,$-120.00,$231519.50,387,$-120.00
2025-06-26,09:55:00,22553.5,BUY,3,0.03h,Stop Loss,$-9.00,$-129.00,$231510.50,387,$-129.00
2025-06-26,09:58:00,22549.5,SELL,3,0.02h,Stop Loss,$-9.00,$-138.00,$231501.50,387,$-138.00
2025-06-26,09:59:00,22552.75,BUY,3,0.02h,Stop Loss,$-9.00,$-147.00,$231492.50,387,$-147.00
2025-06-26,10:00:00,22550.0,SELL,3,0.02h,Stop Loss,$-9.00,$-156.00,$231483.50,387,$-156.00
2025-06-26,10:07:00,22557.25,BUY,3,0.02h,Break Even,$-1.50,$-157.50,$231482.00,387,$-157.50
2025-06-26,10:44:00,22566.75,SELL,3,0.02h,Break Even,$-1.50,$-159.00,$231480.50,387,$-159.00
2025-06-26,11:10:00,22569.25,BUY,3,0.02h,Break Even,$-1.50,$-160.50,$231479.00,387,$-160.50
2025-06-26,11:26:00,22559.25,SELL,3,0.02h,Stop Loss,$-9.00,$-169.50,$231470.00,387,$-169.50
2025-06-26,11:36:00,22570.0,BUY,3,0.02h,Stop Loss,$-9.00,$-178.50,$231461.00,387,$-178.50
2025-06-26,11:40:00,22563.0,SELL,3,0.02h,Break Even,$-1.50,$-180.00,$231459.50,387,$-180.00
2025-06-26,11:53:00,22567.0,BUY,3,0.02h,Stop Loss,$28.50,$-151.50,$231488.00,387,$-151.50
2025-06-26,12:19:00,22570.0,SELL,3,0.02h,Stop Loss,$-9.00,$-160.50,$231479.00,387,$-160.50
2025-06-26,12:29:00,22574.25,BUY,3,0.02h,Stop Loss,$-9.00,$-169.50,$231470.00,387,$-169.50
2025-06-26,12:31:00,22565.25,SELL,3,0.02h,Stop Loss,$52.50,$-117.00,$231522.50,387,$-117.00
2025-06-26,13:21:00,22552.5,BUY,3,0.02h,Break Even,$-1.50,$-118.50,$231521.00,387,$-118.50
2025-06-26,13:35:00,22535.75,SELL,3,0.02h,Stop Loss,$3.00,$-115.50,$231524.00,387,$-115.50
2025-06-26,13:59:00,22538.0,BUY,3,0.02h,Stop Loss,$33.00,$-82.50,$231557.00,387,$-82.50
2025-06-26,14:45:00,22561.75,SELL,3,0.02h,Stop Loss,$7.50,$-75.00,$231564.50,387,$-75.00
2025-06-26,14:48:00,22573.0,BUY,3,0.02h,Break Even,$-1.50,$-76.50,$231563.00,387,$-76.50
2025-06-26,15:30:00,22565.0,SELL,3,0.02h,Stop Loss,$70.50,$-6.00,$231633.50,387,$-6.00
2025-06-26,15:40:00,22597.5,BUY,3,0.02h,Break Even,$-1.50,$-7.50,$231632.00,387,$-7.50
2025-06-26,16:30:00,22614.0,SELL,3,0.02h,Break Even,$-1.50,$-9.00,$231630.50,387,$-9.00
2025-06-26,17:04:00,22613.75,BUY,3,0.02h,Stop Loss,$9.00,$0.00,$231639.50,387,$0.00
2025-06-26,18:01:00,22635.5,SELL,3,0.02h,Stop Loss,$-9.00,$-9.00,$231630.50,387,$-9.00
2025-06-26,18:02:00,22643.75,BUY,3,0.02h,Stop Loss,$-9.00,$-18.00,$231621.50,387,$-18.00
2025-06-26,18:40:00,22668.5,SELL,3,0.02h,Break Even,$-1.50,$-19.50,$231620.00,387,$-19.50
2025-06-26,19:03:00,22672.75,BUY,3,0.02h,Stop Loss,$-9.00,$-28.50,$231611.00,387,$-28.50
2025-06-26,19:08:00,22663.75,SELL,3,0.02h,Break Even,$-1.50,$-30.00,$231609.50,387,$-30.00
2025-06-26,19:12:00,22670.5,BUY,3,0.02h,Stop Loss,$-9.00,$-39.00,$231600.50,387,$-39.00
2025-06-26,19:13:00,22665.25,SELL,3,0.02h,Break Even,$-1.50,$-40.50,$231599.00,387,$-40.50
2025-06-26,19:21:00,22669.25,BUY,3,0.02h,Stop Loss,$-9.00,$-49.50,$231590.00,387,$-49.50
2025-06-26,19:38:00,22664.0,SELL,3,0.02h,Break Even,$-1.50,$-51.00,$231588.50,387,$-51.00
2025-06-26,19:51:00,22683.75,BUY,3,0.02h,Stop Loss,$12.00,$-39.00,$231600.50,387,$-39.00
2025-06-26,20:02:00,22655.25,SELL,3,0.02h,Stop Loss,$24.00,$-15.00,$231624.50,387,$-15.00
2025-06-26,20:23:00,22664.75,BUY,3,0.02h,Stop Loss,$24.00,$9.00,$231648.50,387,$9.00
2025-06-26,20:57:00,22667.25,SELL,3,0.02h,Stop Loss,$-9.00,$0.00,$231639.50,387,$0.00
2025-06-26,23:00:00,22695.5,BUY,3,0.02h,Break Even,$-1.50,$-1.50,$231638.00,387,$-1.50
2025-06-26,23:14:00,22678.5,SELL,3,0.02h,Break Even,$-1.50,$-3.00,$231636.50,387,$-3.00
2025-06-26,23:24:00,22686.0,BUY,3,0.02h,Stop Loss,$-9.00,$-12.00,$231627.50,387,$-12.00
2025-06-26,23:41:00,22679.5,SELL,3,0.02h,Break Even,$-1.50,$-13.50,$231626.00,387,$-13.50
2025-06-26,23:46:00,22685.0,BUY,3,0.02h,Break Even,$-1.50,$-15.00,$231624.50,387,$-15.00
2025-06-26,23:51:00,22676.0,SELL,3,0.02h,Break Even,$-1.50,$-16.50,$231623.00,387,$-16.50
,,,,,,,,,,,
2025-06-27,00:03:00,22686.25,BUY,3,0.02h,Stop Loss,$-9.00,$-9.00,$231614.00,388,$-9.00
2025-06-27,00:13:00,22679.0,SELL,3,0.02h,Stop Loss,$-9.00,$-18.00,$231605.00,388,$-18.00
2025-06-27,00:20:00,22685.25,BUY,3,0.02h,Stop Loss,$7.50,$-10.50,$231612.50,388,$-10.50
2025-06-27,00:33:00,22678.25,SELL,3,0.02h,Break Even,$-1.50,$-12.00,$231611.00,388,$-12.00
2025-06-27,00:40:00,22683.0,BUY,3,0.02h,Stop Loss,$-9.00,$-21.00,$231602.00,388,$-21.00
2025-06-27,00:41:00,22679.25,SELL,3,0.02h,Break Even,$-1.50,$-22.50,$231600.50,388,$-22.50
2025-06-27,01:21:00,22672.25,BUY,3,0.02h,Stop Loss,$-9.00,$-31.50,$231591.50,388,$-31.50
2025-06-27,01:23:00,22670.75,SELL,3,0.02h,Break Even,$-1.50,$-33.00,$231590.00,388,$-33.00
2025-06-27,01:29:00,22672.0,BUY,3,0.02h,Break Even,$-1.50,$-34.50,$231588.50,388,$-34.50
2025-06-27,01:32:00,22667.25,SELL,3,0.02h,Break Even,$-1.50,$-36.00,$231587.00,388,$-36.00
2025-06-27,01:45:00,22672.5,BUY,3,0.02h,Stop Loss,$-9.00,$-45.00,$231578.00,388,$-45.00
2025-06-27,02:37:00,22685.25,SELL,3,0.02h,Stop Loss,$-9.00,$-54.00,$231569.00,388,$-54.00
2025-06-27,02:47:00,22691.0,BUY,3,0.02h,Stop Loss,$-9.00,$-63.00,$231560.00,388,$-63.00
2025-06-27,03:32:00,22697.0,SELL,3,0.02h,Stop Loss,$-9.00,$-72.00,$231551.00,388,$-72.00
2025-06-27,03:40:00,22700.5,BUY,3,0.02h,Stop Loss,$33.00,$-39.00,$231584.00,388,$-39.00
2025-06-27,03:49:00,22694.0,SELL,3,0.02h,Stop Loss,$-9.00,$-48.00,$231575.00,388,$-48.00
2025-06-27,04:35:00,22692.75,BUY,3,0.02h,Break Even,$-1.50,$-49.50,$231573.50,388,$-49.50
2025-06-27,04:57:00,22693.0,SELL,3,0.02h,Stop Loss,$6.00,$-43.50,$231579.50,388,$-43.50
2025-06-27,05:10:00,22695.75,BUY,3,0.02h,Stop Loss,$-9.00,$-52.50,$231570.50,388,$-52.50
2025-06-27,06:04:00,22708.25,SELL,3,0.02h,Stop Loss,$-9.00,$-61.50,$231561.50,388,$-61.50
2025-06-27,06:06:00,22712.0,BUY,3,0.02h,Stop Loss,$-9.00,$-70.50,$231552.50,388,$-70.50
2025-06-27,07:04:00,22731.75,SELL,3,0.02h,Stop Loss,$3.00,$-67.50,$231555.50,388,$-67.50
2025-06-27,07:14:00,22740.25,BUY,3,0.02h,Stop Loss,$-9.00,$-76.50,$231546.50,388,$-76.50
2025-06-27,07:34:00,22735.5,SELL,3,0.02h,Break Even,$-1.50,$-78.00,$231545.00,388,$-78.00
2025-06-27,08:01:00,22739.75,BUY,3,0.02h,Stop Loss,$13.50,$-64.50,$231558.50,388,$-64.50
2025-06-27,08:06:00,22733.0,SELL,3,0.02h,Stop Loss,$10.50,$-54.00,$231569.00,388,$-54.00
2025-06-27,08:14:00,22742.75,BUY,3,0.02h,Stop Loss,$13.50,$-40.50,$231582.50,388,$-40.50
2025-06-27,08:23:00,22731.5,SELL,3,0.02h,Break Even,$-1.50,$-42.00,$231581.00,388,$-42.00
2025-06-27,08:32:00,22741.25,BUY,3,0.02h,Stop Loss,$10.50,$-31.50,$231591.50,388,$-31.50
2025-06-27,09:10:00,22736.75,SELL,3,0.02h,Stop Loss,$22.50,$-9.00,$231614.00,388,$-9.00
2025-06-27,09:28:00,22739.0,BUY,3,0.02h,Stop Loss,$-9.00,$-18.00,$231605.00,388,$-18.00
2025-06-27,09:39:00,22735.75,SELL,3,0.03h,Break Even,$-1.50,$-19.50,$231603.50,388,$-19.50
2025-06-27,09:43:00,22740.75,BUY,3,0.02h,Break Even,$-1.50,$-21.00,$231602.00,388,$-21.00
2025-06-27,09:53:00,22736.75,SELL,3,0.02h,Stop Loss,$19.50,$-1.50,$231621.50,388,$-1.50
2025-06-27,09:58:00,22740.5,BUY,3,0.02h,Break Even,$-1.50,$-3.00,$231620.00,388,$-3.00
2025-06-27,10:03:00,22735.5,SELL,3,0.02h,Stop Loss,$-9.00,$-12.00,$231611.00,388,$-12.00
2025-06-27,10:04:00,22743.25,BUY,3,0.02h,Stop Loss,$-9.00,$-21.00,$231602.00,388,$-21.00
2025-06-27,10:08:00,22736.75,SELL,3,0.02h,Stop Loss,$-9.00,$-30.00,$231593.00,388,$-30.00
2025-06-27,10:49:00,22734.5,BUY,3,0.02h,Stop Loss,$-9.00,$-39.00,$231584.00,388,$-39.00
2025-06-27,12:09:00,22770.0,SELL,3,0.02h,Stop Loss,$-9.00,$-48.00,$231575.00,388,$-48.00
2025-06-27,12:28:00,22766.5,BUY,3,0.02h,Stop Loss,$4.50,$-43.50,$231579.50,388,$-43.50
2025-06-27,12:31:00,22752.5,SELL,3,0.02h,Stop Loss,$13.50,$-30.00,$231593.00,388,$-30.00
2025-06-27,13:27:00,22720.5,BUY,3,0.02h,Stop Loss,$18.00,$-12.00,$231611.00,388,$-12.00
2025-06-27,13:29:00,22709.5,SELL,3,0.02h,Stop Loss,$16.50,$4.50,$231627.50,388,$4.50
2025-06-27,13:38:00,22733.5,BUY,3,0.02h,Break Even,$-1.50,$3.00,$231626.00,388,$3.00
2025-06-27,14:28:00,22774.5,SELL,3,0.02h,Stop Loss,$-9.00,$-6.00,$231617.00,388,$-6.00
2025-06-27,14:39:00,22811.25,BUY,3,0.02h,Break Even,$-1.50,$-7.50,$231615.50,388,$-7.50
2025-06-27,14:52:00,22765.75,SELL,3,0.02h,Stop Loss,$66.00,$58.50,$231681.50,388,$58.50
2025-06-27,15:11:00,22776.25,BUY,3,0.02h,Stop Loss,$7.50,$66.00,$231689.00,388,$66.00
2025-06-27,15:18:00,22765.75,SELL,3,0.02h,Stop Loss,$21.00,$87.00,$231710.00,388,$87.00
2025-06-27,15:22:00,22781.25,BUY,3,0.02h,Stop Loss,$31.50,$118.50,$231741.50,388,$118.50
2025-06-27,16:02:00,22798.25,SELL,3,0.02h,Stop Loss,$-9.00,$109.50,$231732.50,388,$109.50
2025-06-27,16:57:00,22794.5,BUY,3,0.02h,Stop Loss,$3.00,$112.50,$231735.50,388,$112.50
2025-06-27,17:05:00,22783.0,SELL,3,0.02h,Break Even,$-1.50,$111.00,$231734.00,388,$111.00
2025-06-27,17:10:00,22789.5,BUY,3,0.02h,Stop Loss,$15.00,$126.00,$231749.00,388,$126.00
2025-06-27,17:21:00,22782.5,SELL,3,0.02h,Break Even,$-1.50,$124.50,$231747.50,388,$124.50
2025-06-27,19:07:00,22645.25,BUY,3,0.02h,Stop Loss,$31.50,$156.00,$231779.00,388,$156.00
2025-06-27,20:29:00,22734.75,SELL,3,0.02h,Stop Loss,$-9.00,$147.00,$231770.00,388,$147.00
2025-06-27,20:31:00,22740.0,BUY,3,0.02h,Stop Loss,$-9.00,$138.00,$231761.00,388,$138.00
2025-06-27,20:36:00,22735.75,SELL,3,0.02h,Break Even,$-1.50,$136.50,$231759.50,388,$136.50
2025-06-27,20:53:00,22743.25,BUY,3,0.02h,Stop Loss,$-9.00,$127.50,$231750.50,388,$127.50
,,,,,,,,,,,
2025-06-30,01:01:00,22830.25,SELL,3,0.02h,Stop Loss,$33.00,$33.00,$231783.50,389,$33.00
2025-06-30,01:31:00,22826.0,BUY,3,0.02h,Break Even,$-1.50,$31.50,$231782.00,389,$31.50
2025-06-30,01:51:00,22825.0,SELL,3,0.02h,Stop Loss,$-9.00,$22.50,$231773.00,389,$22.50
2025-06-30,02:08:00,22831.5,BUY,3,0.02h,Stop Loss,$21.00,$43.50,$231794.00,389,$43.50
2025-06-30,02:31:00,22835.5,SELL,3,0.02h,Stop Loss,$-9.00,$34.50,$231785.00,389,$34.50
2025-06-30,02:32:00,22838.25,BUY,3,0.02h,Stop Loss,$-9.00,$25.50,$231776.00,389,$25.50
2025-06-30,04:17:00,22874.0,SELL,3,0.02h,Stop Loss,$-9.00,$16.50,$231767.00,389,$16.50
2025-06-30,04:23:00,22876.75,BUY,3,0.02h,Stop Loss,$-9.00,$7.50,$231758.00,389,$7.50
2025-06-30,04:54:00,22875.75,SELL,3,0.02h,Break Even,$-1.50,$6.00,$231756.50,389,$6.00
2025-06-30,05:16:00,22877.75,BUY,3,0.02h,Stop Loss,$-9.00,$-3.00,$231747.50,389,$-3.00
2025-06-30,05:20:00,22873.75,SELL,3,0.02h,Stop Loss,$-9.00,$-12.00,$231738.50,389,$-12.00
2025-06-30,05:39:00,22878.25,BUY,3,0.02h,Break Even,$-1.50,$-13.50,$231737.00,389,$-13.50
2025-06-30,06:38:00,22886.75,SELL,3,0.02h,Break Even,$-1.50,$-15.00,$231735.50,389,$-15.00
2025-06-30,07:36:00,22865.0,BUY,3,0.02h,Break Even,$-1.50,$-16.50,$231734.00,389,$-16.50
2025-06-30,08:01:00,22867.25,SELL,3,0.02h,Stop Loss,$6.00,$-10.50,$231740.00,389,$-10.50
2025-06-30,08:05:00,22877.25,BUY,3,0.02h,Stop Loss,$6.00,$-4.50,$231746.00,389,$-4.50
2025-06-30,08:24:00,22866.75,SELL,3,0.02h,Stop Loss,$-9.00,$-13.50,$231737.00,389,$-13.50
2025-06-30,08:49:00,22870.75,BUY,3,0.03h,Stop Loss,$7.50,$-6.00,$231744.50,389,$-6.00
2025-06-30,09:48:00,22889.25,SELL,3,0.02h,Break Even,$-1.50,$-7.50,$231743.00,389,$-7.50
2025-06-30,10:10:00,22891.75,BUY,3,0.02h,Break Even,$-1.50,$-9.00,$231741.50,389,$-9.00
2025-06-30,10:46:00,22901.0,SELL,3,0.02h,Break Even,$-1.50,$-10.50,$231740.00,389,$-10.50
2025-06-30,11:18:00,22893.75,BUY,3,0.02h,Stop Loss,$9.00,$-1.50,$231749.00,389,$-1.50
2025-06-30,11:35:00,22893.75,SELL,3,0.02h,Stop Loss,$6.00,$4.50,$231755.00,389,$4.50
2025-06-30,11:46:00,22898.75,BUY,3,0.02h,Break Even,$-1.50,$3.00,$231753.50,389,$3.00
2025-06-30,11:57:00,22891.75,SELL,3,0.02h,Stop Loss,$-9.00,$-6.00,$231744.50,389,$-6.00
2025-06-30,12:16:00,22895.0,BUY,3,0.02h,Stop Loss,$-9.00,$-15.00,$231735.50,389,$-15.00
2025-06-30,12:17:00,22891.25,SELL,3,0.02h,Stop Loss,$16.50,$1.50,$231752.00,389,$1.50
2025-06-30,12:21:00,22895.25,BUY,3,0.02h,Stop Loss,$-9.00,$-7.50,$231743.00,389,$-7.50
2025-06-30,12:22:00,22887.75,SELL,3,0.02h,Stop Loss,$13.50,$6.00,$231756.50,389,$6.00
2025-06-30,13:02:00,22873.5,BUY,3,0.02h,Break Even,$-1.50,$4.50,$231755.00,389,$4.50
2025-06-30,13:30:00,22871.75,SELL,3,0.02h,Stop Loss,$106.50,$111.00,$231861.50,389,$111.00
2025-06-30,14:03:00,22829.0,BUY,3,0.02h,Stop Loss,$7.50,$118.50,$231869.00,389,$118.50
2025-06-30,14:21:00,22821.5,SELL,3,0.02h,Stop Loss,$61.50,$180.00,$231930.50,389,$180.00
2025-06-30,14:31:00,22838.0,BUY,3,0.02h,Break Even,$-1.50,$178.50,$231929.00,389,$178.50
2025-06-30,14:37:00,22827.0,SELL,3,0.02h,Stop Loss,$49.50,$228.00,$231978.50,389,$228.00
2025-06-30,14:49:00,22832.75,BUY,3,0.02h,Break Even,$-1.50,$226.50,$231977.00,389,$226.50
2025-06-30,14:53:00,22823.0,SELL,3,0.02h,Stop Loss,$19.50,$246.00,$231996.50,389,$246.00
2025-06-30,15:05:00,22829.75,BUY,3,0.02h,Stop Loss,$21.00,$267.00,$232017.50,389,$267.00
2025-06-30,15:14:00,22812.0,SELL,3,0.02h,Stop Loss,$3.00,$270.00,$232020.50,389,$270.00
2025-06-30,15:34:00,22832.5,BUY,3,0.02h,Stop Loss,$24.00,$294.00,$232044.50,389,$294.00
2025-06-30,16:19:00,22842.0,SELL,3,0.02h,Stop Loss,$46.50,$340.50,$232091.00,389,$340.50
2025-06-30,16:37:00,22850.25,BUY,3,0.02h,Stop Loss,$6.00,$346.50,$232097.00,389,$346.50
2025-06-30,16:59:00,22844.5,SELL,3,0.02h,Stop Loss,$16.50,$363.00,$232113.50,389,$363.00
2025-06-30,17:54:00,22828.25,BUY,3,0.02h,Stop Loss,$-9.00,$354.00,$232104.50,389,$354.00
2025-06-30,17:58:00,22812.75,SELL,3,0.02h,Break Even,$-1.50,$352.50,$232103.00,389,$352.50
2025-06-30,18:02:00,22833.5,BUY,3,0.02h,Break Even,$-1.50,$351.00,$232101.50,389,$351.00
2025-06-30,18:10:00,22817.5,SELL,3,0.02h,Stop Loss,$42.00,$393.00,$232143.50,389,$393.00
2025-06-30,18:18:00,22828.25,BUY,3,0.02h,Break Even,$-1.50,$391.50,$232142.00,389,$391.50
2025-06-30,18:30:00,22819.5,SELL,3,0.02h,Stop Loss,$3.00,$394.50,$232145.00,389,$394.50
2025-06-30,18:52:00,22819.5,BUY,3,0.02h,Stop Loss,$4.50,$399.00,$232149.50,389,$399.00
2025-06-30,20:03:00,22879.5,SELL,3,0.02h,Break Even,$-1.50,$397.50,$232148.00,389,$397.50
2025-06-30,20:34:00,22877.5,BUY,3,0.02h,Break Even,$-1.50,$396.00,$232146.50,389,$396.00
2025-06-30,20:50:00,22874.25,SELL,3,0.02h,Stop Loss,$-9.00,$387.00,$232137.50,389,$387.00
2025-06-30,20:51:00,22876.5,BUY,3,0.02h,Stop Loss,$-9.00,$378.00,$232128.50,389,$378.00
2025-06-30,20:52:00,22874.75,SELL,3,0.02h,Stop Loss,$-9.00,$369.00,$232119.50,389,$369.00
2025-06-30,20:53:00,22877.25,BUY,3,0.02h,Stop Loss,$-9.00,$360.00,$232110.50,389,$360.00
2025-06-30,20:55:00,22872.5,SELL,3,0.02h,Break Even,$-1.50,$358.50,$232109.00,389,$358.50
2025-06-30,23:38:00,22873.25,BUY,3,0.02h,Break Even,$-1.50,$357.00,$232107.50,389,$357.00
,,,,,,,,,,,
2025-07-01,01:21:00,22895.75,SELL,3,0.02h,Stop Loss,$-9.00,$-9.00,$232098.50,390,$-9.00
2025-07-01,01:38:00,22900.5,BUY,3,0.02h,Stop Loss,$-9.00,$-18.00,$232089.50,390,$-18.00
2025-07-01,02:21:00,22904.0,SELL,3,0.02h,Stop Loss,$-9.00,$-27.00,$232080.50,390,$-27.00
2025-07-01,04:01:00,22876.25,BUY,3,0.02h,Stop Loss,$-9.00,$-36.00,$232071.50,390,$-36.00
2025-07-01,04:04:00,22868.25,SELL,3,0.02h,Stop Loss,$-9.00,$-45.00,$232062.50,390,$-45.00
2025-07-01,04:08:00,22874.75,BUY,3,0.02h,Stop Loss,$-9.00,$-54.00,$232053.50,390,$-54.00
2025-07-01,04:17:00,22868.25,SELL,3,0.02h,Break Even,$-1.50,$-55.50,$232052.00,390,$-55.50
2025-07-01,05:52:00,22851.75,BUY,3,0.02h,Stop Loss,$13.50,$-42.00,$232065.50,390,$-42.00
2025-07-01,06:00:00,22842.25,SELL,3,0.02h,Break Even,$-1.50,$-43.50,$232064.00,390,$-43.50
2025-07-01,06:41:00,22840.75,BUY,3,0.02h,Break Even,$-1.50,$-45.00,$232062.50,390,$-45.00
2025-07-01,06:49:00,22836.75,SELL,3,0.02h,Stop Loss,$24.00,$-21.00,$232086.50,390,$-21.00
2025-07-01,06:54:00,22843.5,BUY,3,0.02h,Stop Loss,$-9.00,$-30.00,$232077.50,390,$-30.00
2025-07-01,07:17:00,22843.25,SELL,3,0.02h,Break Even,$-1.50,$-31.50,$232076.00,390,$-31.50
2025-07-01,07:33:00,22852.75,BUY,3,0.02h,Break Even,$-1.50,$-33.00,$232074.50,390,$-33.00
2025-07-01,07:39:00,22836.25,SELL,3,0.02h,Stop Loss,$-9.00,$-42.00,$232065.50,390,$-42.00
2025-07-01,08:00:00,22843.0,BUY,3,0.02h,Break Even,$-1.50,$-43.50,$232064.00,390,$-43.50
2025-07-01,08:03:00,22822.0,SELL,3,0.02h,Break Even,$-1.50,$-45.00,$232062.50,390,$-45.00
2025-07-01,08:22:00,22835.75,BUY,3,0.02h,Break Even,$-1.50,$-46.50,$232061.00,390,$-46.50
2025-07-01,08:43:00,22833.25,SELL,3,0.02h,Stop Loss,$27.00,$-19.50,$232088.00,390,$-19.50
2025-07-01,08:52:00,22846.25,BUY,3,0.02h,Break Even,$-1.50,$-21.00,$232086.50,390,$-21.00
2025-07-01,09:07:00,22838.25,SELL,3,0.02h,Stop Loss,$7.50,$-13.50,$232094.00,390,$-13.50
2025-07-01,09:24:00,22841.5,BUY,3,0.02h,Stop Loss,$-9.00,$-22.50,$232085.00,390,$-22.50
2025-07-01,09:29:00,22832.5,SELL,3,0.02h,Break Even,$-1.50,$-24.00,$232083.50,390,$-24.00
2025-07-01,10:00:00,22831.25,BUY,3,0.02h,Break Even,$-1.50,$-25.50,$232082.00,390,$-25.50
2025-07-01,10:23:00,22828.25,SELL,3,0.02h,Stop Loss,$-9.00,$-34.50,$232073.00,390,$-34.50
2025-07-01,10:42:00,22831.0,BUY,3,0.02h,Stop Loss,$-9.00,$-43.50,$232064.00,390,$-43.50
2025-07-01,10:43:00,22829.0,SELL,3,0.02h,Break Even,$-1.50,$-45.00,$232062.50,390,$-45.00
2025-07-01,10:46:00,22831.5,BUY,3,0.02h,Stop Loss,$-9.00,$-54.00,$232053.50,390,$-54.00
2025-07-01,10:49:00,22829.75,SELL,3,0.02h,Stop Loss,$-9.00,$-63.00,$232044.50,390,$-63.00
2025-07-01,10:52:00,22831.5,BUY,3,0.02h,Break Even,$-1.50,$-64.50,$232043.00,390,$-64.50
2025-07-01,11:19:00,22830.5,SELL,3,0.02h,Stop Loss,$-9.00,$-73.50,$232034.00,390,$-73.50
2025-07-01,11:30:00,22840.0,BUY,3,0.02h,Break Even,$-1.50,$-75.00,$232032.50,390,$-75.00
2025-07-01,11:43:00,22835.25,SELL,3,0.02h,Stop Loss,$6.00,$-69.00,$232038.50,390,$-69.00
2025-07-01,12:48:00,22797.0,BUY,3,0.02h,Break Even,$-1.50,$-70.50,$232037.00,390,$-70.50
2025-07-01,13:22:00,22795.75,SELL,3,0.02h,Stop Loss,$7.50,$-63.00,$232044.50,390,$-63.00
2025-07-01,13:33:00,22814.5,BUY,3,0.02h,Stop Loss,$7.50,$-55.50,$232052.00,390,$-55.50
2025-07-01,13:44:00,22789.25,SELL,3,0.02h,Stop Loss,$36.00,$-19.50,$232088.00,390,$-19.50
2025-07-01,13:49:00,22813.5,BUY,3,0.02h,Stop Loss,$37.50,$18.00,$232125.50,390,$18.00
2025-07-01,14:00:00,22782.25,SELL,3,0.02h,Stop Loss,$-9.00,$9.00,$232116.50,390,$9.00
2025-07-01,14:14:00,22828.75,BUY,3,0.02h,Break Even,$-1.50,$7.50,$232115.00,390,$7.50
2025-07-01,14:23:00,22790.75,SELL,3,0.02h,Stop Loss,$25.50,$33.00,$232140.50,390,$33.00
2025-07-01,15:26:00,22684.5,BUY,3,0.02h,Stop Loss,$30.00,$63.00,$232170.50,390,$63.00
2025-07-01,15:41:00,22638.5,SELL,3,0.02h,Stop Loss,$75.00,$138.00,$232245.50,390,$138.00
2025-07-01,15:54:00,22668.25,BUY,3,0.02h,Stop Loss,$4.50,$142.50,$232250.00,390,$142.50
2025-07-01,16:03:00,22652.5,SELL,3,0.02h,Break Even,$-1.50,$141.00,$232248.50,390,$141.00
2025-07-01,16:12:00,22674.75,BUY,3,0.02h,Stop Loss,$51.00,$192.00,$232299.50,390,$192.00
2025-07-01,17:31:00,22718.25,SELL,3,0.02h,Stop Loss,$25.50,$217.50,$232325.00,390,$217.50
2025-07-01,17:44:00,22725.5,BUY,3,0.02h,Stop Loss,$6.00,$223.50,$232331.00,390,$223.50
2025-07-01,18:18:00,22735.5,SELL,3,0.02h,Stop Loss,$18.00,$241.50,$232349.00,390,$241.50
2025-07-01,18:35:00,22741.0,BUY,3,0.02h,Break Even,$-1.50,$240.00,$232347.50,390,$240.00
2025-07-01,18:38:00,22729.25,SELL,3,0.02h,Stop Loss,$16.50,$256.50,$232364.00,390,$256.50
2025-07-01,19:20:00,22704.25,BUY,3,0.02h,Break Even,$-1.50,$255.00,$232362.50,390,$255.00
2025-07-01,19:37:00,22701.25,SELL,3,0.02h,Stop Loss,$52.50,$307.50,$232415.00,390,$307.50
2025-07-01,19:46:00,22715.75,BUY,3,0.02h,Break Even,$-1.50,$306.00,$232413.50,390,$306.00
2025-07-01,19:59:00,22702.5,SELL,3,0.02h,Stop Loss,$76.50,$382.50,$232490.00,390,$382.50
2025-07-01,20:32:00,22683.75,BUY,3,0.02h,Break Even,$-1.50,$381.00,$232488.50,390,$381.00
2025-07-01,23:24:00,22710.0,SELL,3,0.02h,Break Even,$-1.50,$379.50,$232487.00,390,$379.50
2025-07-01,23:33:00,22714.75,BUY,3,0.02h,Stop Loss,$-9.00,$370.50,$232478.00,390,$370.50
2025-07-01,23:47:00,22711.75,SELL,3,0.02h,Break Even,$-1.50,$369.00,$232476.50,390,$369.00
,,,,,,,,,,,
2025-07-02,00:02:00,22714.5,BUY,3,0.02h,Break Even,$-1.50,$-1.50,$232475.00,391,$-1.50
2025-07-02,00:08:00,22709.25,SELL,3,0.02h,Stop Loss,$-9.00,$-10.50,$232466.00,391,$-10.50
2025-07-02,00:09:00,22712.5,BUY,3,0.02h,Break Even,$-1.50,$-12.00,$232464.50,391,$-12.00
2025-07-02,00:11:00,22708.25,SELL,3,0.02h,Stop Loss,$-9.00,$-21.00,$232455.50,391,$-21.00
2025-07-02,00:14:00,22713.0,BUY,3,0.02h,Break Even,$-1.50,$-22.50,$232454.00,391,$-22.50
2025-07-02,00:30:00,22712.75,SELL,3,0.02h,Stop Loss,$-9.00,$-31.50,$232445.00,391,$-31.50
2025-07-02,00:31:00,22715.5,BUY,3,0.02h,Stop Loss,$-9.00,$-40.50,$232436.00,391,$-40.50
2025-07-02,00:46:00,22713.75,SELL,3,0.02h,Break Even,$-1.50,$-42.00,$232434.50,391,$-42.00
2025-07-02,01:01:00,22714.75,BUY,3,0.02h,Stop Loss,$-9.00,$-51.00,$232425.50,391,$-51.00
2025-07-02,01:04:00,22712.0,SELL,3,0.02h,Break Even,$-1.50,$-52.50,$232424.00,391,$-52.50
2025-07-02,01:08:00,22714.25,BUY,3,0.02h,Break Even,$-1.50,$-54.00,$232422.50,391,$-54.00
2025-07-02,01:17:00,22713.25,SELL,3,0.02h,Break Even,$-1.50,$-55.50,$232421.00,391,$-55.50
2025-07-02,01:43:00,22715.0,BUY,3,0.02h,Stop Loss,$-9.00,$-64.50,$232412.00,391,$-64.50
2025-07-02,01:51:00,22707.75,SELL,3,0.02h,Break Even,$-1.50,$-66.00,$232410.50,391,$-66.00
2025-07-02,02:20:00,22698.25,BUY,3,0.02h,Stop Loss,$-9.00,$-75.00,$232401.50,391,$-75.00
2025-07-02,03:26:00,22736.75,SELL,3,0.02h,Break Even,$-1.50,$-76.50,$232400.00,391,$-76.50
2025-07-02,03:38:00,22740.25,BUY,3,0.02h,Break Even,$-1.50,$-78.00,$232398.50,391,$-78.00
2025-07-02,03:44:00,22737.25,SELL,3,0.03h,Stop Loss,$-9.00,$-87.00,$232389.50,391,$-87.00
2025-07-02,03:56:00,22738.75,BUY,3,0.02h,Stop Loss,$-9.00,$-96.00,$232380.50,391,$-96.00
2025-07-02,03:58:00,22736.5,SELL,3,0.02h,Stop Loss,$-9.00,$-105.00,$232371.50,391,$-105.00
2025-07-02,03:59:00,22738.75,BUY,3,0.05h,Stop Loss,$-9.00,$-114.00,$232362.50,391,$-114.00
2025-07-02,05:02:00,22765.75,SELL,3,0.02h,Break Even,$-1.50,$-115.50,$232361.00,391,$-115.50
2025-07-02,05:43:00,22760.0,BUY,3,0.02h,Break Even,$-1.50,$-117.00,$232359.50,391,$-117.00
2025-07-02,05:46:00,22755.25,SELL,3,0.02h,Stop Loss,$-9.00,$-126.00,$232350.50,391,$-126.00
2025-07-02,05:48:00,22760.5,BUY,3,0.02h,Stop Loss,$10.50,$-115.50,$232361.00,391,$-115.50
2025-07-02,06:15:00,22763.0,SELL,3,0.02h,Stop Loss,$-9.00,$-124.50,$232352.00,391,$-124.50
2025-07-02,06:38:00,22766.0,BUY,3,0.02h,Stop Loss,$-9.00,$-133.50,$232343.00,391,$-133.50
2025-07-02,07:07:00,22760.25,SELL,3,0.02h,Break Even,$-1.50,$-135.00,$232341.50,391,$-135.00
2025-07-02,08:08:00,22734.5,BUY,3,0.02h,Break Even,$-1.50,$-136.50,$232340.00,391,$-136.50
2025-07-02,08:09:00,22727.5,SELL,3,0.02h,Stop Loss,$-9.00,$-145.50,$232331.00,391,$-145.50
2025-07-02,08:10:00,22734.0,BUY,3,0.02h,Stop Loss,$-9.00,$-154.50,$232322.00,391,$-154.50
2025-07-02,08:20:00,22729.75,SELL,3,0.02h,Stop Loss,$-9.00,$-163.50,$232313.00,391,$-163.50
2025-07-02,08:21:00,22737.25,BUY,3,0.02h,Stop Loss,$-9.00,$-172.50,$232304.00,391,$-172.50
2025-07-02,08:25:00,22723.75,SELL,3,0.02h,Stop Loss,$-9.00,$-181.50,$232295.00,391,$-181.50
2025-07-02,09:27:00,22709.75,BUY,3,0.02h,Stop Loss,$-9.00,$-190.50,$232286.00,391,$-190.50
2025-07-02,09:39:00,22700.0,SELL,3,0.02h,Break Even,$-1.50,$-192.00,$232284.50,391,$-192.00
2025-07-02,09:44:00,22712.0,BUY,3,0.02h,Stop Loss,$-9.00,$-201.00,$232275.50,391,$-201.00
2025-07-02,10:11:00,22707.75,SELL,3,0.02h,Break Even,$-1.50,$-202.50,$232274.00,391,$-202.50
2025-07-02,11:06:00,22690.75,BUY,3,0.02h,Stop Loss,$4.50,$-198.00,$232278.50,391,$-198.00
2025-07-02,11:34:00,22684.5,SELL,3,0.02h,Stop Loss,$3.00,$-195.00,$232281.50,391,$-195.00
2025-07-02,12:10:00,22670.75,BUY,3,0.02h,Stop Loss,$-9.00,$-204.00,$232272.50,391,$-204.00
2025-07-02,12:19:00,22657.75,SELL,3,0.02h,Stop Loss,$24.00,$-180.00,$232296.50,391,$-180.00
2025-07-02,13:02:00,22629.0,BUY,3,0.02h,Break Even,$-1.50,$-181.50,$232295.00,391,$-181.50
2025-07-02,15:21:00,22821.0,SELL,3,0.02h,Stop Loss,$27.00,$-154.50,$232322.00,391,$-154.50
2025-07-02,15:23:00,22827.0,BUY,3,0.02h,Break Even,$-1.50,$-156.00,$232320.50,391,$-156.00
2025-07-02,15:25:00,22815.75,SELL,3,0.02h,Stop Loss,$6.00,$-150.00,$232326.50,391,$-150.00
2025-07-02,15:38:00,22824.25,BUY,3,0.02h,Stop Loss,$-9.00,$-159.00,$232317.50,391,$-159.00
2025-07-02,15:39:00,22814.0,SELL,3,0.02h,Stop Loss,$28.50,$-130.50,$232346.00,391,$-130.50
2025-07-02,15:48:00,22823.0,BUY,3,0.02h,Break Even,$-1.50,$-132.00,$232344.50,391,$-132.00
2025-07-02,16:03:00,22810.25,SELL,3,0.02h,Stop Loss,$-9.00,$-141.00,$232335.50,391,$-141.00
2025-07-02,16:07:00,22825.0,BUY,3,0.02h,Stop Loss,$-9.00,$-150.00,$232326.50,391,$-150.00
2025-07-02,16:32:00,22822.5,SELL,3,0.02h,Stop Loss,$-9.00,$-159.00,$232317.50,391,$-159.00
2025-07-02,16:35:00,22833.25,BUY,3,0.02h,Stop Loss,$4.50,$-154.50,$232322.00,391,$-154.50
2025-07-02,16:53:00,22829.25,SELL,3,0.02h,Stop Loss,$-9.00,$-163.50,$232313.00,391,$-163.50
2025-07-02,16:57:00,22837.5,BUY,3,0.02h,Stop Loss,$6.00,$-157.50,$232319.00,391,$-157.50
2025-07-02,17:09:00,22831.75,SELL,3,0.02h,Stop Loss,$3.00,$-154.50,$232322.00,391,$-154.50
2025-07-02,17:51:00,22825.75,BUY,3,0.02h,Stop Loss,$19.50,$-135.00,$232341.50,391,$-135.00
2025-07-02,18:03:00,22815.25,SELL,3,0.02h,Break Even,$-1.50,$-136.50,$232340.00,391,$-136.50
2025-07-02,18:06:00,22828.25,BUY,3,0.02h,Stop Loss,$-9.00,$-145.50,$232331.00,391,$-145.50
2025-07-02,18:18:00,22819.75,SELL,3,0.02h,Stop Loss,$-9.00,$-154.50,$232322.00,391,$-154.50
2025-07-02,18:19:00,22828.75,BUY,3,0.02h,Stop Loss,$22.50,$-132.00,$232344.50,391,$-132.00
2025-07-02,18:46:00,22825.5,SELL,3,0.02h,Stop Loss,$3.00,$-129.00,$232347.50,391,$-129.00
2025-07-02,18:49:00,22836.0,BUY,3,0.02h,Stop Loss,$-9.00,$-138.00,$232338.50,391,$-138.00
2025-07-02,18:50:00,22828.75,SELL,3,0.02h,Stop Loss,$15.00,$-123.00,$232353.50,391,$-123.00
2025-07-02,19:01:00,22833.5,BUY,3,0.02h,Stop Loss,$12.00,$-111.00,$232365.50,391,$-111.00
2025-07-02,19:14:00,22827.75,SELL,3,0.02h,Break Even,$-1.50,$-112.50,$232364.00,391,$-112.50
2025-07-02,19:35:00,22831.0,BUY,3,0.02h,Stop Loss,$-9.00,$-121.50,$232355.00,391,$-121.50
2025-07-02,19:37:00,22824.75,SELL,3,0.02h,Stop Loss,$-9.00,$-130.50,$232346.00,391,$-130.50
2025-07-02,19:54:00,22831.25,BUY,3,0.02h,Stop Loss,$84.00,$-46.50,$232430.00,391,$-46.50
2025-07-02,20:17:00,22830.75,SELL,3,0.02h,Stop Loss,$-9.00,$-55.50,$232421.00,391,$-55.50
2025-07-02,20:30:00,22835.25,BUY,3,0.02h,Break Even,$-1.50,$-57.00,$232419.50,391,$-57.00
2025-07-02,23:03:00,22846.5,SELL,3,0.03h,Break Even,$-1.50,$-58.50,$232418.00,391,$-58.50
2025-07-02,23:18:00,22848.0,BUY,3,0.02h,Stop Loss,$-9.00,$-67.50,$232409.00,391,$-67.50
2025-07-02,23:36:00,22846.75,SELL,3,0.02h,Break Even,$-1.50,$-69.00,$232407.50,391,$-69.00
2025-07-02,23:41:00,22849.0,BUY,3,0.02h,Stop Loss,$-9.00,$-78.00,$232398.50,391,$-78.00
2025-07-02,23:44:00,22846.5,SELL,3,0.02h,Stop Loss,$-9.00,$-87.00,$232389.50,391,$-87.00
2025-07-02,23:45:00,22848.5,BUY,3,0.02h,Stop Loss,$-9.00,$-96.00,$232380.50,391,$-96.00
2025-07-02,23:50:00,22847.0,SELL,3,0.02h,Stop Loss,$-9.00,$-105.00,$232371.50,391,$-105.00
2025-07-02,23:56:00,22849.75,BUY,3,0.02h,Stop Loss,$-9.00,$-114.00,$232362.50,391,$-114.00
,,,,,,,,,,,
2025-07-03,00:02:00,22840.75,SELL,3,0.02h,Break Even,$-1.50,$-1.50,$232361.00,392,$-1.50
2025-07-03,00:12:00,22853.5,BUY,3,0.02h,Stop Loss,$-9.00,$-10.50,$232352.00,392,$-10.50
2025-07-03,00:27:00,22843.5,SELL,3,0.02h,Stop Loss,$-9.00,$-19.50,$232343.00,392,$-19.50
2025-07-03,00:42:00,22850.75,BUY,3,0.02h,Break Even,$-1.50,$-21.00,$232341.50,392,$-21.00
2025-07-03,01:03:00,22846.75,SELL,3,0.02h,Stop Loss,$-9.00,$-30.00,$232332.50,392,$-30.00
2025-07-03,01:20:00,22850.25,BUY,3,0.02h,Stop Loss,$-9.00,$-39.00,$232323.50,392,$-39.00
2025-07-03,01:45:00,22852.75,SELL,3,0.02h,Stop Loss,$-9.00,$-48.00,$232314.50,392,$-48.00
2025-07-03,01:49:00,22857.25,BUY,3,0.02h,Stop Loss,$-9.00,$-57.00,$232305.50,392,$-57.00
2025-07-03,01:53:00,22853.75,SELL,3,0.02h,Stop Loss,$-9.00,$-66.00,$232296.50,392,$-66.00
2025-07-03,02:45:00,22842.25,BUY,3,0.02h,Stop Loss,$-9.00,$-75.00,$232287.50,392,$-75.00
2025-07-03,03:54:00,22868.75,SELL,3,0.02h,Break Even,$-1.50,$-76.50,$232286.00,392,$-76.50
2025-07-03,04:12:00,22869.75,BUY,3,0.02h,Break Even,$-1.50,$-78.00,$232284.50,392,$-78.00
2025-07-03,04:34:00,22866.75,SELL,3,0.02h,Stop Loss,$-9.00,$-87.00,$232275.50,392,$-87.00
2025-07-03,05:06:00,22866.75,BUY,3,0.02h,Stop Loss,$-9.00,$-96.00,$232266.50,392,$-96.00
2025-07-03,05:22:00,22864.0,SELL,3,0.02h,Break Even,$-1.50,$-97.50,$232265.00,392,$-97.50
2025-07-03,05:59:00,22870.0,BUY,3,0.02h,Stop Loss,$4.50,$-93.00,$232269.50,392,$-93.00
2025-07-03,07:02:00,22878.5,SELL,3,0.02h,Stop Loss,$-9.00,$-102.00,$232260.50,392,$-102.00
2025-07-03,07:04:00,22882.5,BUY,3,0.02h,Break Even,$-1.50,$-103.50,$232259.00,392,$-103.50
2025-07-03,07:18:00,22878.25,SELL,3,0.02h,Stop Loss,$21.00,$-82.50,$232280.00,392,$-82.50
2025-07-03,07:27:00,22887.0,BUY,3,0.02h,Break Even,$-1.50,$-84.00,$232278.50,392,$-84.00
2025-07-03,07:56:00,22887.0,SELL,3,0.02h,Stop Loss,$7.50,$-76.50,$232286.00,392,$-76.50
2025-07-03,08:39:00,22886.0,BUY,3,0.02h,Stop Loss,$-9.00,$-85.50,$232277.00,392,$-85.50
2025-07-03,08:42:00,22878.25,SELL,3,0.02h,Stop Loss,$-9.00,$-94.50,$232268.00,392,$-94.50
2025-07-03,09:22:00,22869.0,BUY,3,0.02h,Break Even,$-1.50,$-96.00,$232266.50,392,$-96.00
2025-07-03,09:36:00,22857.0,SELL,3,0.02h,Break Even,$-1.50,$-97.50,$232265.00,392,$-97.50
2025-07-03,09:49:00,22866.25,BUY,3,0.02h,Break Even,$-1.50,$-99.00,$232263.50,392,$-99.00
2025-07-03,09:57:00,22858.5,SELL,3,0.02h,Stop Loss,$10.50,$-88.50,$232274.00,392,$-88.50
2025-07-03,10:35:00,22846.0,BUY,3,0.02h,Break Even,$-1.50,$-90.00,$232272.50,392,$-90.00
2025-07-03,11:34:00,22857.25,SELL,3,0.02h,Stop Loss,$3.00,$-87.00,$232275.50,392,$-87.00
2025-07-03,11:44:00,22860.75,BUY,3,0.02h,Break Even,$-1.50,$-88.50,$232274.00,392,$-88.50
2025-07-03,11:48:00,22856.5,SELL,3,0.02h,Stop Loss,$-9.00,$-97.50,$232265.00,392,$-97.50
2025-07-03,12:00:00,22862.5,BUY,3,0.02h,Break Even,$-1.50,$-99.00,$232263.50,392,$-99.00
2025-07-03,12:16:00,22860.5,SELL,3,0.02h,Break Even,$-1.50,$-100.50,$232262.00,392,$-100.50
2025-07-03,12:31:00,22901.25,BUY,3,0.02h,Stop Loss,$70.50,$-30.00,$232332.50,392,$-30.00
2025-07-03,12:49:00,22879.25,SELL,3,0.02h,Stop Loss,$-9.00,$-39.00,$232323.50,392,$-39.00
2025-07-03,12:56:00,22900.25,BUY,3,0.02h,Stop Loss,$-9.00,$-48.00,$232314.50,392,$-48.00
2025-07-03,14:45:00,23045.5,SELL,3,0.02h,Stop Loss,$-9.00,$-57.00,$232305.50,392,$-57.00
2025-07-03,14:59:00,23051.0,BUY,3,0.02h,Stop Loss,$-9.00,$-66.00,$232296.50,392,$-66.00
2025-07-03,16:00:00,23083.25,SELL,3,0.02h,Stop Loss,$-9.00,$-75.00,$232287.50,392,$-75.00
2025-07-03,16:01:00,23089.0,BUY,3,0.02h,Break Even,$-1.50,$-76.50,$232286.00,392,$-76.50
2025-07-03,16:16:00,23079.25,SELL,3,0.02h,Stop Loss,$-9.00,$-85.50,$232277.00,392,$-85.50
,,,,,,,,,,,
2025-07-04,00:20:00,23033.25,BUY,3,0.02h,Stop Loss,$-9.00,$-9.00,$232268.00,393,$-9.00
2025-07-04,00:22:00,23028.0,SELL,3,0.02h,Break Even,$-1.50,$-10.50,$232266.50,393,$-10.50
2025-07-04,00:55:00,23025.5,BUY,3,0.02h,Stop Loss,$-9.00,$-19.50,$232257.50,393,$-19.50
2025-07-04,01:39:00,23038.5,SELL,3,0.03h,Stop Loss,$-9.00,$-28.50,$232248.50,393,$-28.50
2025-07-04,01:41:00,23040.5,BUY,3,0.02h,Break Even,$-1.50,$-30.00,$232247.00,393,$-30.00
2025-07-04,01:42:00,23038.0,SELL,3,0.02h,Stop Loss,$13.50,$-16.50,$232260.50,393,$-16.50
2025-07-04,02:53:00,23012.5,BUY,3,0.02h,Break Even,$-1.50,$-18.00,$232259.00,393,$-18.00
2025-07-04,03:06:00,23005.5,SELL,3,0.02h,Break Even,$-1.50,$-19.50,$232257.50,393,$-19.50
2025-07-04,03:12:00,23014.75,BUY,3,0.02h,Stop Loss,$-9.00,$-28.50,$232248.50,393,$-28.50
2025-07-04,03:35:00,23012.25,SELL,3,0.02h,Stop Loss,$-9.00,$-37.50,$232239.50,393,$-37.50
2025-07-04,04:15:00,23012.0,BUY,3,0.02h,Break Even,$-1.50,$-39.00,$232238.00,393,$-39.00
2025-07-04,04:25:00,23005.75,SELL,3,0.02h,Stop Loss,$43.50,$4.50,$232281.50,393,$4.50
2025-07-04,04:47:00,23005.25,BUY,3,0.02h,Break Even,$-1.50,$3.00,$232280.00,393,$3.00
2025-07-04,05:09:00,23002.75,SELL,3,0.02h,Break Even,$-1.50,$1.50,$232278.50,393,$1.50
2025-07-04,05:44:00,23004.75,BUY,3,0.02h,Stop Loss,$-9.00,$-7.50,$232269.50,393,$-7.50
2025-07-04,06:04:00,22999.25,SELL,3,0.02h,Stop Loss,$4.50,$-3.00,$232274.00,393,$-3.00
2025-07-04,06:24:00,22997.0,BUY,3,0.02h,Break Even,$-1.50,$-4.50,$232272.50,393,$-4.50
2025-07-04,06:26:00,22993.75,SELL,3,0.02h,Break Even,$-1.50,$-6.00,$232271.00,393,$-6.00
2025-07-04,06:38:00,22997.0,BUY,3,0.02h,Break Even,$-1.50,$-7.50,$232269.50,393,$-7.50
2025-07-04,06:41:00,22991.25,SELL,3,0.02h,Stop Loss,$-9.00,$-16.50,$232260.50,393,$-16.50
2025-07-04,07:03:00,22996.75,BUY,3,0.02h,Break Even,$-1.50,$-18.00,$232259.00,393,$-18.00
2025-07-04,07:06:00,22977.75,SELL,3,0.02h,Stop Loss,$7.50,$-10.50,$232266.50,393,$-10.50
2025-07-04,08:25:00,22953.75,BUY,3,0.02h,Break Even,$-1.50,$-12.00,$232265.00,393,$-12.00
2025-07-04,08:47:00,22949.5,SELL,3,0.02h,Break Even,$-1.50,$-13.50,$232263.50,393,$-13.50
2025-07-04,09:27:00,22937.0,BUY,3,0.02h,Stop Loss,$-9.00,$-22.50,$232254.50,393,$-22.50
2025-07-04,09:31:00,22929.5,SELL,3,0.02h,Stop Loss,$-9.00,$-31.50,$232245.50,393,$-31.50
2025-07-04,09:32:00,22933.5,BUY,3,0.02h,Break Even,$-1.50,$-33.00,$232244.00,393,$-33.00
2025-07-04,09:33:00,22929.5,SELL,3,0.02h,Stop Loss,$-9.00,$-42.00,$232235.00,393,$-42.00
2025-07-04,09:42:00,22934.0,BUY,3,0.02h,Break Even,$-1.50,$-43.50,$232233.50,393,$-43.50
2025-07-04,10:09:00,22939.0,SELL,3,0.02h,Break Even,$-1.50,$-45.00,$232232.00,393,$-45.00
2025-07-04,10:11:00,22948.0,BUY,3,0.02h,Stop Loss,$-9.00,$-54.00,$232223.00,393,$-54.00
2025-07-04,10:18:00,22939.75,SELL,3,0.02h,Stop Loss,$-9.00,$-63.00,$232214.00,393,$-63.00
2025-07-04,10:38:00,22945.75,BUY,3,0.02h,Stop Loss,$-9.00,$-72.00,$232205.00,393,$-72.00
2025-07-04,10:44:00,22928.75,SELL,3,0.02h,Stop Loss,$4.50,$-67.50,$232209.50,393,$-67.50
2025-07-04,11:15:00,22921.5,BUY,3,0.02h,Stop Loss,$61.50,$-6.00,$232271.00,393,$-6.00
2025-07-04,11:37:00,22915.25,SELL,3,0.02h,Stop Loss,$-9.00,$-15.00,$232262.00,393,$-15.00
2025-07-04,11:51:00,22924.25,BUY,3,0.02h,Stop Loss,$6.00,$-9.00,$232268.00,393,$-9.00
2025-07-04,12:17:00,22919.0,SELL,3,0.02h,Stop Loss,$-9.00,$-18.00,$232259.00,393,$-18.00
2025-07-04,12:31:00,22929.5,BUY,3,0.02h,Break Even,$-1.50,$-19.50,$232257.50,393,$-19.50
2025-07-04,12:49:00,22919.75,SELL,3,0.02h,Stop Loss,$-9.00,$-28.50,$232248.50,393,$-28.50
2025-07-04,13:31:00,22920.0,BUY,3,0.02h,Stop Loss,$3.00,$-25.50,$232251.50,393,$-25.50
2025-07-04,13:36:00,22901.0,SELL,3,0.02h,Stop Loss,$22.50,$-3.00,$232274.00,393,$-3.00
2025-07-04,13:43:00,22926.25,BUY,3,0.02h,Break Even,$-1.50,$-4.50,$232272.50,393,$-4.50
2025-07-04,14:05:00,22916.75,SELL,3,0.02h,Stop Loss,$12.00,$7.50,$232284.50,393,$7.50
2025-07-04,14:20:00,22922.25,BUY,3,0.02h,Stop Loss,$-9.00,$-1.50,$232275.50,393,$-1.50
2025-07-04,14:57:00,22934.5,SELL,3,0.02h,Break Even,$-1.50,$-3.00,$232274.00,393,$-3.00
2025-07-04,15:01:00,22940.5,BUY,3,0.02h,Stop Loss,$-9.00,$-12.00,$232265.00,393,$-12.00
2025-07-04,15:06:00,22935.5,SELL,3,0.02h,Stop Loss,$-9.00,$-21.00,$232256.00,393,$-21.00
2025-07-04,15:32:00,22932.0,BUY,3,0.02h,Break Even,$-1.50,$-22.50,$232254.50,393,$-22.50
2025-07-04,16:03:00,22928.5,SELL,3,0.02h,Stop Loss,$-9.00,$-31.50,$232245.50,393,$-31.50
2025-07-04,16:05:00,22932.5,BUY,3,0.02h,Break Even,$-1.50,$-33.00,$232244.00,393,$-33.00
2025-07-04,16:09:00,22928.0,SELL,3,0.02h,Break Even,$-1.50,$-34.50,$232242.50,393,$-34.50
,,,,,,,,,,,
2025-07-07,00:00:00,22983.75,BUY,3,0.02h,Stop Loss,$7.50,$7.50,$232250.00,394,$7.50
2025-07-07,00:39:00,22975.75,SELL,3,0.02h,Break Even,$-1.50,$6.00,$232248.50,394,$6.00
2025-07-07,01:26:00,22952.5,BUY,3,0.02h,Stop Loss,$-9.00,$-3.00,$232239.50,394,$-3.00
2025-07-07,01:38:00,22939.75,SELL,3,0.02h,Stop Loss,$-9.00,$-12.00,$232230.50,394,$-12.00
2025-07-07,01:54:00,22949.5,BUY,3,0.02h,Break Even,$-1.50,$-13.50,$232229.00,394,$-13.50
2025-07-07,02:04:00,22940.75,SELL,3,0.02h,Stop Loss,$-9.00,$-22.50,$232220.00,394,$-22.50
2025-07-07,02:08:00,22946.0,BUY,3,0.02h,Stop Loss,$-9.00,$-31.50,$232211.00,394,$-31.50
2025-07-07,02:33:00,22948.0,SELL,3,0.02h,Stop Loss,$21.00,$-10.50,$232232.00,394,$-10.50
2025-07-07,02:46:00,22957.0,BUY,3,0.02h,Stop Loss,$-9.00,$-19.50,$232223.00,394,$-19.50
2025-07-07,02:50:00,22952.0,SELL,3,0.02h,Stop Loss,$-9.00,$-28.50,$232214.00,394,$-28.50
2025-07-07,02:51:00,22959.75,BUY,3,0.02h,Stop Loss,$15.00,$-13.50,$232229.00,394,$-13.50
2025-07-07,03:04:00,22943.5,SELL,3,0.02h,Break Even,$-1.50,$-15.00,$232227.50,394,$-15.00
2025-07-07,03:27:00,22955.0,BUY,3,0.02h,Stop Loss,$-9.00,$-24.00,$232218.50,394,$-24.00
2025-07-07,04:18:00,22971.5,SELL,3,0.02h,Stop Loss,$-9.00,$-33.00,$232209.50,394,$-33.00
2025-07-07,05:36:00,22943.25,BUY,3,0.02h,Break Even,$-1.50,$-34.50,$232208.00,394,$-34.50
2025-07-07,05:40:00,22938.0,SELL,3,0.02h,Stop Loss,$-9.00,$-43.50,$232199.00,394,$-43.50
2025-07-07,05:41:00,22943.0,BUY,3,0.02h,Stop Loss,$-9.00,$-52.50,$232190.00,394,$-52.50
2025-07-07,06:03:00,22937.25,SELL,3,0.02h,Stop Loss,$-9.00,$-61.50,$232181.00,394,$-61.50
2025-07-07,06:32:00,22932.75,BUY,3,0.02h,Break Even,$-1.50,$-63.00,$232179.50,394,$-63.00
2025-07-07,06:33:00,22928.5,SELL,3,0.02h,Stop Loss,$-9.00,$-72.00,$232170.50,394,$-72.00
2025-07-07,06:34:00,22935.0,BUY,3,0.02h,Stop Loss,$4.50,$-67.50,$232175.00,394,$-67.50
2025-07-07,07:09:00,22932.5,SELL,3,0.02h,Break Even,$-1.50,$-69.00,$232173.50,394,$-69.00
2025-07-07,07:12:00,22941.25,BUY,3,0.02h,Break Even,$-1.50,$-70.50,$232172.00,394,$-70.50
2025-07-07,07:29:00,22937.0,SELL,3,0.02h,Stop Loss,$15.00,$-55.50,$232187.00,394,$-55.50
2025-07-07,07:38:00,22941.5,BUY,3,0.02h,Break Even,$-1.50,$-57.00,$232185.50,394,$-57.00
2025-07-07,07:50:00,22934.0,SELL,3,0.02h,Stop Loss,$-9.00,$-66.00,$232176.50,394,$-66.00
2025-07-07,07:56:00,22943.25,BUY,3,0.02h,Stop Loss,$-9.00,$-75.00,$232167.50,394,$-75.00
2025-07-07,08:04:00,22936.5,SELL,3,0.02h,Break Even,$-1.50,$-76.50,$232166.00,394,$-76.50
2025-07-07,08:06:00,22940.5,BUY,3,0.02h,Stop Loss,$-9.00,$-85.50,$232157.00,394,$-85.50
2025-07-07,08:07:00,22933.5,SELL,3,0.02h,Stop Loss,$18.00,$-67.50,$232175.00,394,$-67.50
2025-07-07,08:28:00,22933.75,BUY,3,0.02h,Stop Loss,$-9.00,$-76.50,$232166.00,394,$-76.50
2025-07-07,08:30:00,22921.0,SELL,3,0.02h,Break Even,$-1.50,$-78.00,$232164.50,394,$-78.00
2025-07-07,09:11:00,22920.0,BUY,3,0.02h,Break Even,$-1.50,$-79.50,$232163.00,394,$-79.50
2025-07-07,09:27:00,22919.0,SELL,3,0.02h,Stop Loss,$-9.00,$-88.50,$232154.00,394,$-88.50
2025-07-07,09:29:00,22923.25,BUY,3,0.02h,Stop Loss,$-9.00,$-97.50,$232145.00,394,$-97.50
2025-07-07,10:42:00,22973.0,SELL,3,0.02h,Break Even,$-1.50,$-99.00,$232143.50,394,$-99.00
2025-07-07,11:25:00,22964.5,BUY,3,0.02h,Break Even,$-1.50,$-100.50,$232142.00,394,$-100.50
2025-07-07,12:29:00,22983.75,SELL,3,0.02h,Stop Loss,$-9.00,$-109.50,$232133.00,394,$-109.50
2025-07-07,13:31:00,22970.5,BUY,3,0.02h,Break Even,$-1.50,$-111.00,$232131.50,394,$-111.00
2025-07-07,13:35:00,22926.5,SELL,3,0.02h,Stop Loss,$4.50,$-106.50,$232136.00,394,$-106.50
2025-07-07,13:43:00,22947.25,BUY,3,0.02h,Break Even,$-1.50,$-108.00,$232134.50,394,$-108.00
2025-07-07,13:46:00,22926.0,SELL,3,0.02h,Stop Loss,$7.50,$-100.50,$232142.00,394,$-100.50
2025-07-07,13:50:00,22951.5,BUY,3,0.02h,Stop Loss,$40.50,$-60.00,$232182.50,394,$-60.00
2025-07-07,14:02:00,22925.25,SELL,3,0.02h,Stop Loss,$121.50,$61.50,$232304.00,394,$61.50
2025-07-07,14:24:00,22941.75,BUY,3,0.02h,Stop Loss,$24.00,$85.50,$232328.00,394,$85.50
2025-07-07,14:33:00,22926.5,SELL,3,0.02h,Break Even,$-1.50,$84.00,$232326.50,394,$84.00
2025-07-07,15:16:00,22915.25,BUY,3,0.02h,Stop Loss,$-9.00,$75.00,$232317.50,394,$75.00
2025-07-07,15:20:00,22904.75,SELL,3,0.02h,Stop Loss,$6.00,$81.00,$232323.50,394,$81.00
2025-07-07,15:26:00,22907.75,BUY,3,0.02h,Stop Loss,$55.50,$136.50,$232379.00,394,$136.50
2025-07-07,15:47:00,22906.0,SELL,3,0.02h,Stop Loss,$21.00,$157.50,$232400.00,394,$157.50
2025-07-07,15:57:00,22923.25,BUY,3,0.02h,Stop Loss,$52.50,$210.00,$232452.50,394,$210.00
2025-07-07,16:21:00,22879.75,SELL,3,0.02h,Stop Loss,$204.00,$414.00,$232656.50,394,$414.00
2025-07-07,16:38:00,22917.5,BUY,3,0.02h,Break Even,$-1.50,$412.50,$232655.00,394,$412.50
2025-07-07,16:39:00,22894.0,SELL,3,0.02h,Break Even,$-1.50,$411.00,$232653.50,394,$411.00
2025-07-07,17:11:00,22890.75,BUY,3,0.02h,Stop Loss,$16.50,$427.50,$232670.00,394,$427.50
2025-07-07,17:28:00,22869.25,SELL,3,0.02h,Break Even,$-1.50,$426.00,$232668.50,394,$426.00
2025-07-07,17:33:00,22891.5,BUY,3,0.02h,Stop Loss,$-9.00,$417.00,$232659.50,394,$417.00
2025-07-07,17:35:00,22883.0,SELL,3,0.02h,Stop Loss,$79.50,$496.50,$232739.00,394,$496.50
2025-07-07,18:00:00,22871.0,BUY,3,0.02h,Stop Loss,$10.50,$507.00,$232749.50,394,$507.00
2025-07-07,18:16:00,22859.0,SELL,3,0.02h,Stop Loss,$183.00,$690.00,$232932.50,394,$690.00
2025-07-07,18:42:00,22835.75,BUY,3,0.02h,Stop Loss,$63.00,$753.00,$232995.50,394,$753.00
2025-07-07,19:10:00,22851.5,SELL,3,0.02h,Break Even,$-1.50,$751.50,$232994.00,394,$751.50
2025-07-07,19:14:00,22862.75,BUY,3,0.02h,Stop Loss,$7.50,$759.00,$233001.50,394,$759.00
2025-07-07,19:15:00,22857.0,SELL,3,0.02h,Break Even,$-1.50,$757.50,$233000.00,394,$757.50
2025-07-07,19:34:00,22858.25,BUY,3,0.02h,Stop Loss,$9.00,$766.50,$233009.00,394,$766.50
2025-07-07,19:39:00,22849.5,SELL,3,0.02h,Break Even,$-1.50,$765.00,$233007.50,394,$765.00
2025-07-07,19:51:00,22869.75,BUY,3,0.02h,Break Even,$-1.50,$763.50,$233006.00,394,$763.50
2025-07-07,20:06:00,22856.75,SELL,3,0.02h,Break Even,$-1.50,$762.00,$233004.50,394,$762.00
2025-07-07,20:20:00,22863.75,BUY,3,0.03h,Break Even,$-1.50,$760.50,$233003.00,394,$760.50
2025-07-07,20:30:00,22858.5,SELL,3,0.02h,Stop Loss,$-9.00,$751.50,$232994.00,394,$751.50
2025-07-07,23:00:00,22847.0,BUY,3,0.02h,Break Even,$-1.50,$750.00,$232992.50,394,$750.00
2025-07-07,23:44:00,22862.5,SELL,3,0.02h,Stop Loss,$-9.00,$741.00,$232983.50,394,$741.00
2025-07-07,23:46:00,22868.75,BUY,3,0.02h,Break Even,$-1.50,$739.50,$232982.00,394,$739.50
,,,,,,,,,,,
2025-07-08,00:06:00,22867.5,SELL,3,0.02h,Stop Loss,$46.50,$46.50,$233028.50,395,$46.50
2025-07-08,00:12:00,22876.0,BUY,3,0.02h,Break Even,$-1.50,$45.00,$233027.00,395,$45.00
2025-07-08,01:42:00,22903.75,SELL,3,0.02h,Stop Loss,$7.50,$52.50,$233034.50,395,$52.50
2025-07-08,02:17:00,22897.75,BUY,3,0.02h,Stop Loss,$-9.00,$43.50,$233025.50,395,$43.50
2025-07-08,03:08:00,22925.25,SELL,3,0.02h,Break Even,$-1.50,$42.00,$233024.00,395,$42.00
2025-07-08,03:25:00,22927.0,BUY,3,0.02h,Break Even,$-1.50,$40.50,$233022.50,395,$40.50
2025-07-08,03:38:00,22922.5,SELL,3,0.02h,Break Even,$-1.50,$39.00,$233021.00,395,$39.00
2025-07-08,04:08:00,22922.25,BUY,3,0.02h,Break Even,$-1.50,$37.50,$233019.50,395,$37.50
2025-07-08,04:22:00,22916.75,SELL,3,0.02h,Break Even,$-1.50,$36.00,$233018.00,395,$36.00
2025-07-08,04:32:00,22921.0,BUY,3,0.02h,Break Even,$-1.50,$34.50,$233016.50,395,$34.50
2025-07-08,04:41:00,22917.0,SELL,3,0.02h,Break Even,$-1.50,$33.00,$233015.00,395,$33.00
2025-07-08,05:09:00,22919.25,BUY,3,0.02h,Stop Loss,$-9.00,$24.00,$233006.00,395,$24.00
2025-07-08,05:36:00,22916.75,SELL,3,0.02h,Break Even,$-1.50,$22.50,$233004.50,395,$22.50
2025-07-08,05:37:00,22921.0,BUY,3,0.02h,Stop Loss,$-9.00,$13.50,$232995.50,395,$13.50
2025-07-08,05:38:00,22915.5,SELL,3,0.02h,Stop Loss,$-9.00,$4.50,$232986.50,395,$4.50
2025-07-08,05:43:00,22922.0,BUY,3,0.03h,Break Even,$-1.50,$3.00,$232985.00,395,$3.00
2025-07-08,06:28:00,22929.0,SELL,3,0.02h,Stop Loss,$7.50,$10.50,$232992.50,395,$10.50
2025-07-08,06:32:00,22941.5,BUY,3,0.02h,Stop Loss,$-9.00,$1.50,$232983.50,395,$1.50
2025-07-08,06:39:00,22932.25,SELL,3,0.02h,Break Even,$-1.50,$0.00,$232982.00,395,$0.00
2025-07-08,06:40:00,22938.0,BUY,3,0.02h,Stop Loss,$-9.00,$-9.00,$232973.00,395,$-9.00
2025-07-08,07:03:00,22930.0,SELL,3,0.02h,Break Even,$-1.50,$-10.50,$232971.50,395,$-10.50
2025-07-08,07:28:00,22933.75,BUY,3,0.02h,Stop Loss,$-9.00,$-19.50,$232962.50,395,$-19.50
2025-07-08,08:06:00,22948.0,SELL,3,0.02h,Stop Loss,$3.00,$-16.50,$232965.50,395,$-16.50
2025-07-08,08:33:00,22953.0,BUY,3,0.02h,Stop Loss,$-9.00,$-25.50,$232956.50,395,$-25.50
2025-07-08,08:35:00,22943.75,SELL,3,0.02h,Break Even,$-1.50,$-27.00,$232955.00,395,$-27.00
2025-07-08,08:52:00,22946.5,BUY,3,0.02h,Break Even,$-1.50,$-28.50,$232953.50,395,$-28.50
2025-07-08,09:02:00,22932.25,SELL,3,0.02h,Break Even,$-1.50,$-30.00,$232952.00,395,$-30.00
2025-07-08,09:12:00,22949.5,BUY,3,0.02h,Stop Loss,$4.50,$-25.50,$232956.50,395,$-25.50
2025-07-08,09:25:00,22941.0,SELL,3,0.02h,Stop Loss,$-9.00,$-34.50,$232947.50,395,$-34.50
2025-07-08,09:27:00,22947.0,BUY,3,0.02h,Stop Loss,$-9.00,$-43.50,$232938.50,395,$-43.50
2025-07-08,09:30:00,22943.0,SELL,3,0.02h,Break Even,$-1.50,$-45.00,$232937.00,395,$-45.00
2025-07-08,10:20:00,22926.0,BUY,3,0.02h,Break Even,$-1.50,$-46.50,$232935.50,395,$-46.50
2025-07-08,11:07:00,22936.25,SELL,3,0.02h,Break Even,$-1.50,$-48.00,$232934.00,395,$-48.00
2025-07-08,11:16:00,22941.5,BUY,3,0.02h,Stop Loss,$-9.00,$-57.00,$232925.00,395,$-57.00
2025-07-08,11:54:00,22945.0,SELL,3,0.02h,Stop Loss,$4.50,$-52.50,$232929.50,395,$-52.50
2025-07-08,12:14:00,22948.0,BUY,3,0.02h,Break Even,$-1.50,$-54.00,$232928.00,395,$-54.00
2025-07-08,12:31:00,22938.0,SELL,3,0.02h,Stop Loss,$22.50,$-31.50,$232950.50,395,$-31.50
2025-07-08,12:57:00,22934.0,BUY,3,0.02h,Stop Loss,$6.00,$-25.50,$232956.50,395,$-25.50
2025-07-08,13:21:00,22937.25,SELL,3,0.02h,Stop Loss,$-9.00,$-34.50,$232947.50,395,$-34.50
2025-07-08,13:57:00,22919.0,BUY,3,0.02h,Break Even,$-1.50,$-36.00,$232946.00,395,$-36.00
2025-07-08,13:58:00,22907.75,SELL,3,0.02h,Stop Loss,$73.50,$37.50,$233019.50,395,$37.50
2025-07-08,14:33:00,22909.25,BUY,3,0.02h,Break Even,$-1.50,$36.00,$233018.00,395,$36.00
2025-07-08,14:52:00,22894.0,SELL,3,0.02h,Stop Loss,$223.50,$259.50,$233241.50,395,$259.50
2025-07-08,15:04:00,22902.0,BUY,3,0.02h,Stop Loss,$-9.00,$250.50,$233232.50,395,$250.50
2025-07-08,15:20:00,22888.0,SELL,3,0.02h,Stop Loss,$27.00,$277.50,$233259.50,395,$277.50
2025-07-08,15:39:00,22889.5,BUY,3,0.02h,Break Even,$-1.50,$276.00,$233258.00,395,$276.00
2025-07-08,16:36:00,22897.75,SELL,3,0.02h,Stop Loss,$36.00,$312.00,$233294.00,395,$312.00
2025-07-08,17:29:00,22913.75,BUY,3,0.02h,Stop Loss,$-9.00,$303.00,$233285.00,395,$303.00
2025-07-08,17:36:00,22899.75,SELL,3,0.02h,Stop Loss,$3.00,$306.00,$233288.00,395,$306.00
2025-07-08,17:49:00,22907.75,BUY,3,0.02h,Stop Loss,$4.50,$310.50,$233292.50,395,$310.50
2025-07-08,18:22:00,22921.25,SELL,3,0.02h,Break Even,$-1.50,$309.00,$233291.00,395,$309.00
2025-07-08,19:34:00,22890.25,BUY,3,0.02h,Break Even,$-1.50,$307.50,$233289.50,395,$307.50
2025-07-08,19:40:00,22879.5,SELL,3,0.02h,Break Even,$-1.50,$306.00,$233288.00,395,$306.00
2025-07-08,19:49:00,22892.75,BUY,3,0.02h,Stop Loss,$4.50,$310.50,$233292.50,395,$310.50
2025-07-08,20:36:00,22900.75,SELL,3,0.02h,Stop Loss,$-9.00,$301.50,$233283.50,395,$301.50
2025-07-08,20:44:00,22904.0,BUY,3,0.02h,Break Even,$-1.50,$300.00,$233282.00,395,$300.00
2025-07-08,20:47:00,22902.25,SELL,3,0.02h,Stop Loss,$-9.00,$291.00,$233273.00,395,$291.00
2025-07-08,20:48:00,22903.0,BUY,3,0.02h,Stop Loss,$-9.00,$282.00,$233264.00,395,$282.00
2025-07-08,20:49:00,22901.5,SELL,3,0.02h,Stop Loss,$-9.00,$273.00,$233255.00,395,$273.00
2025-07-08,20:55:00,22904.0,BUY,3,0.02h,Stop Loss,$-9.00,$264.00,$233246.00,395,$264.00
2025-07-08,20:56:00,22901.25,SELL,3,0.03h,Break Even,$-1.50,$262.50,$233244.50,395,$262.50
2025-07-08,23:00:00,22913.0,BUY,3,0.02h,Stop Loss,$4.50,$267.00,$233249.00,395,$267.00
2025-07-08,23:24:00,22899.75,SELL,3,0.02h,Stop Loss,$-9.00,$258.00,$233240.00,395,$258.00
,,,,,,,,,,,
2025-07-09,00:45:00,22879.0,BUY,3,0.02h,Break Even,$-1.50,$-1.50,$233238.50,396,$-1.50
2025-07-09,00:57:00,22873.5,SELL,3,0.02h,Stop Loss,$19.50,$18.00,$233258.00,396,$18.00
2025-07-09,01:04:00,22881.25,BUY,3,0.02h,Stop Loss,$9.00,$27.00,$233267.00,396,$27.00
2025-07-09,01:24:00,22881.75,SELL,3,0.02h,Break Even,$-1.50,$25.50,$233265.50,396,$25.50
2025-07-09,01:45:00,22876.5,BUY,3,0.02h,Stop Loss,$-9.00,$16.50,$233256.50,396,$16.50
2025-07-09,02:21:00,22885.0,SELL,3,0.02h,Stop Loss,$-9.00,$7.50,$233247.50,396,$7.50
2025-07-09,03:29:00,22882.25,BUY,3,0.02h,Break Even,$-1.50,$6.00,$233246.00,396,$6.00
2025-07-09,03:38:00,22875.75,SELL,3,0.02h,Stop Loss,$-9.00,$-3.00,$233237.00,396,$-3.00
2025-07-09,03:52:00,22879.5,BUY,3,0.03h,Stop Loss,$-9.00,$-12.00,$233228.00,396,$-12.00
2025-07-09,04:00:00,22874.25,SELL,3,0.02h,Break Even,$-1.50,$-13.50,$233226.50,396,$-13.50
2025-07-09,04:18:00,22877.75,BUY,3,0.05h,Stop Loss,$-9.00,$-22.50,$233217.50,396,$-22.50
2025-07-09,04:28:00,22874.25,SELL,3,0.02h,Break Even,$-1.50,$-24.00,$233216.00,396,$-24.00
2025-07-09,04:32:00,22878.5,BUY,3,0.02h,Break Even,$-1.50,$-25.50,$233214.50,396,$-25.50
2025-07-09,05:16:00,22890.0,SELL,3,0.02h,Break Even,$-1.50,$-27.00,$233213.00,396,$-27.00
2025-07-09,05:39:00,22882.25,BUY,3,0.03h,Stop Loss,$-9.00,$-36.00,$233204.00,396,$-36.00
2025-07-09,05:46:00,22876.0,SELL,3,0.02h,Break Even,$-1.50,$-37.50,$233202.50,396,$-37.50
2025-07-09,06:27:00,22865.5,BUY,3,0.02h,Stop Loss,$-9.00,$-46.50,$233193.50,396,$-46.50
2025-07-09,07:13:00,22876.5,SELL,3,0.02h,Stop Loss,$-9.00,$-55.50,$233184.50,396,$-55.50
2025-07-09,07:25:00,22889.75,BUY,3,0.02h,Stop Loss,$-9.00,$-64.50,$233175.50,396,$-64.50
2025-07-09,07:32:00,22880.25,SELL,3,0.02h,Stop Loss,$-9.00,$-73.50,$233166.50,396,$-73.50
2025-07-09,07:36:00,22883.75,BUY,3,0.02h,Stop Loss,$-9.00,$-82.50,$233157.50,396,$-82.50
2025-07-09,07:37:00,22882.5,SELL,3,0.02h,Stop Loss,$-9.00,$-91.50,$233148.50,396,$-91.50
2025-07-09,07:38:00,22884.25,BUY,3,0.02h,Break Even,$-1.50,$-93.00,$233147.00,396,$-93.00
2025-07-09,08:03:00,22887.5,SELL,3,0.02h,Stop Loss,$-9.00,$-102.00,$233138.00,396,$-102.00
2025-07-09,08:05:00,22899.0,BUY,3,0.02h,Break Even,$-1.50,$-103.50,$233136.50,396,$-103.50
2025-07-09,08:11:00,22887.5,SELL,3,0.02h,Break Even,$-1.50,$-105.00,$233135.00,396,$-105.00
2025-07-09,08:32:00,22889.75,BUY,3,0.02h,Stop Loss,$22.50,$-82.50,$233157.50,396,$-82.50
2025-07-09,08:49:00,22887.75,SELL,3,0.02h,Break Even,$-1.50,$-84.00,$233156.00,396,$-84.00
2025-07-09,09:02:00,22892.25,BUY,3,0.02h,Break Even,$-1.50,$-85.50,$233154.50,396,$-85.50
2025-07-09,09:55:00,22927.0,SELL,3,0.02h,Break Even,$-1.50,$-87.00,$233153.00,396,$-87.00
2025-07-09,10:18:00,22927.5,BUY,3,0.02h,Break Even,$-1.50,$-88.50,$233151.50,396,$-88.50
2025-07-09,10:20:00,22919.0,SELL,3,0.02h,Stop Loss,$-9.00,$-97.50,$233142.50,396,$-97.50
2025-07-09,10:22:00,22922.0,BUY,3,0.02h,Stop Loss,$-9.00,$-106.50,$233133.50,396,$-106.50
2025-07-09,10:23:00,22920.25,SELL,3,0.02h,Stop Loss,$-9.00,$-115.50,$233124.50,396,$-115.50
2025-07-09,10:33:00,22928.25,BUY,3,0.02h,Break Even,$-1.50,$-117.00,$233123.00,396,$-117.00
2025-07-09,10:46:00,22922.0,SELL,3,0.02h,Break Even,$-1.50,$-118.50,$233121.50,396,$-118.50
2025-07-09,11:02:00,22928.25,BUY,3,0.02h,Stop Loss,$-9.00,$-127.50,$233112.50,396,$-127.50
2025-07-09,11:03:00,22921.25,SELL,3,0.02h,Stop Loss,$-9.00,$-136.50,$233103.50,396,$-136.50
2025-07-09,11:04:00,22925.75,BUY,3,0.03h,Stop Loss,$-9.00,$-145.50,$233094.50,396,$-145.50
2025-07-09,11:08:00,22920.75,SELL,3,0.02h,Break Even,$-1.50,$-147.00,$233093.00,396,$-147.00
2025-07-09,11:09:00,22927.5,BUY,3,0.02h,Break Even,$-1.50,$-148.50,$233091.50,396,$-148.50
2025-07-09,11:44:00,22934.5,SELL,3,0.02h,Break Even,$-1.50,$-150.00,$233090.00,396,$-150.00
2025-07-09,11:48:00,22940.75,BUY,3,0.02h,Stop Loss,$9.00,$-141.00,$233099.00,396,$-141.00
2025-07-09,11:59:00,22937.5,SELL,3,0.02h,Stop Loss,$-9.00,$-150.00,$233090.00,396,$-150.00
2025-07-09,12:12:00,22940.5,BUY,3,0.02h,Stop Loss,$19.50,$-130.50,$233109.50,396,$-130.50
2025-07-09,12:27:00,22934.25,SELL,3,0.02h,Break Even,$-1.50,$-132.00,$233108.00,396,$-132.00
2025-07-09,12:44:00,22944.0,BUY,3,0.02h,Stop Loss,$-9.00,$-141.00,$233099.00,396,$-141.00
2025-07-09,12:57:00,22938.25,SELL,3,0.02h,Stop Loss,$3.00,$-138.00,$233102.00,396,$-138.00
2025-07-09,13:08:00,22951.0,BUY,3,0.02h,Break Even,$-1.50,$-139.50,$233100.50,396,$-139.50
2025-07-09,14:20:00,23077.0,SELL,3,0.02h,Stop Loss,$16.50,$-123.00,$233117.00,396,$-123.00
2025-07-09,15:23:00,22970.5,BUY,3,0.02h,Break Even,$-1.50,$-124.50,$233115.50,396,$-124.50
2025-07-09,15:53:00,22951.5,SELL,3,0.02h,Break Even,$-1.50,$-126.00,$233114.00,396,$-126.00
2025-07-09,16:19:00,22972.25,BUY,3,0.02h,Stop Loss,$3.00,$-123.00,$233117.00,396,$-123.00
2025-07-09,17:01:00,22976.75,SELL,3,0.02h,Stop Loss,$66.00,$-57.00,$233183.00,396,$-57.00
2025-07-09,17:11:00,22991.75,BUY,3,0.02h,Stop Loss,$-9.00,$-66.00,$233174.00,396,$-66.00
2025-07-09,17:13:00,22980.75,SELL,3,0.02h,Stop Loss,$6.00,$-60.00,$233180.00,396,$-60.00
2025-07-09,17:27:00,22987.25,BUY,3,0.02h,Stop Loss,$-9.00,$-69.00,$233171.00,396,$-69.00
2025-07-09,17:28:00,22977.75,SELL,3,0.02h,Stop Loss,$13.50,$-55.50,$233184.50,396,$-55.50
2025-07-09,17:35:00,22987.75,BUY,3,0.02h,Stop Loss,$34.50,$-21.00,$233219.00,396,$-21.00
2025-07-09,17:46:00,22982.75,SELL,3,0.02h,Stop Loss,$73.50,$52.50,$233292.50,396,$52.50
2025-07-09,17:52:00,22992.75,BUY,3,0.02h,Stop Loss,$9.00,$61.50,$233301.50,396,$61.50
2025-07-09,17:54:00,22976.0,SELL,3,0.02h,Stop Loss,$45.00,$106.50,$233346.50,396,$106.50
2025-07-09,18:02:00,22993.5,BUY,3,0.02h,Break Even,$-1.50,$105.00,$233345.00,396,$105.00
2025-07-09,18:46:00,23009.75,SELL,3,0.02h,Stop Loss,$-9.00,$96.00,$233336.00,396,$96.00
2025-07-09,18:47:00,23015.5,BUY,3,0.02h,Stop Loss,$-9.00,$87.00,$233327.00,396,$87.00
2025-07-09,18:49:00,23011.5,SELL,3,0.02h,Break Even,$-1.50,$85.50,$233325.50,396,$85.50
2025-07-09,18:51:00,23016.25,BUY,3,0.02h,Stop Loss,$10.50,$96.00,$233336.00,396,$96.00
2025-07-09,19:36:00,23033.75,SELL,3,0.02h,Break Even,$-1.50,$94.50,$233334.50,396,$94.50
2025-07-09,19:38:00,23040.5,BUY,3,0.02h,Break Even,$-1.50,$93.00,$233333.00,396,$93.00
2025-07-09,19:52:00,23031.75,SELL,3,0.02h,Break Even,$-1.50,$91.50,$233331.50,396,$91.50
2025-07-09,19:56:00,23052.5,BUY,3,0.02h,Stop Loss,$-9.00,$82.50,$233322.50,396,$82.50
2025-07-09,20:21:00,23034.25,SELL,3,0.02h,Stop Loss,$-9.00,$73.50,$233313.50,396,$73.50
2025-07-09,20:41:00,23042.75,BUY,3,0.02h,Break Even,$-1.50,$72.00,$233312.00,396,$72.00
2025-07-09,20:45:00,23039.5,SELL,3,0.02h,Break Even,$-1.50,$70.50,$233310.50,396,$70.50
2025-07-09,20:51:00,23042.75,BUY,3,0.02h,Stop Loss,$-9.00,$61.50,$233301.50,396,$61.50
2025-07-09,23:16:00,23046.25,SELL,3,0.02h,Stop Loss,$-9.00,$52.50,$233292.50,396,$52.50
,,,,,,,,,,,
2025-07-10,01:35:00,23008.25,BUY,3,0.02h,Break Even,$-1.50,$-1.50,$233291.00,397,$-1.50
2025-07-10,01:46:00,23000.25,SELL,3,0.02h,Stop Loss,$-9.00,$-10.50,$233282.00,397,$-10.50
2025-07-10,01:53:00,23004.75,BUY,3,0.02h,Stop Loss,$-9.00,$-19.50,$233273.00,397,$-19.50
2025-07-10,01:54:00,23002.75,SELL,3,0.02h,Stop Loss,$39.00,$19.50,$233312.00,397,$19.50
2025-07-10,02:07:00,23006.25,BUY,3,0.02h,Break Even,$-1.50,$18.00,$233310.50,397,$18.00
2025-07-10,03:02:00,23015.0,SELL,3,0.02h,Break Even,$-1.50,$16.50,$233309.00,397,$16.50
2025-07-10,03:59:00,22997.75,BUY,3,0.02h,Stop Loss,$-9.00,$7.50,$233300.00,397,$7.50
2025-07-10,04:02:00,22996.5,SELL,3,0.05h,Break Even,$-1.50,$6.00,$233298.50,397,$6.00
2025-07-10,04:33:00,22994.5,BUY,3,0.02h,Break Even,$-1.50,$4.50,$233297.00,397,$4.50
2025-07-10,04:42:00,22989.75,SELL,3,0.02h,Stop Loss,$-9.00,$-4.50,$233288.00,397,$-4.50
2025-07-10,04:43:00,22994.75,BUY,3,0.02h,Stop Loss,$-9.00,$-13.50,$233279.00,397,$-13.50
2025-07-10,04:50:00,22990.25,SELL,3,0.02h,Stop Loss,$-9.00,$-22.50,$233270.00,397,$-22.50
2025-07-10,05:00:00,22995.0,BUY,3,0.02h,Break Even,$-1.50,$-24.00,$233268.50,397,$-24.00
2025-07-10,05:26:00,22993.25,SELL,3,0.02h,Stop Loss,$-9.00,$-33.00,$233259.50,397,$-33.00
2025-07-10,05:56:00,22988.75,BUY,3,0.03h,Break Even,$-1.50,$-34.50,$233258.00,397,$-34.50
2025-07-10,06:07:00,22985.5,SELL,3,0.02h,Break Even,$-1.50,$-36.00,$233256.50,397,$-36.00
2025-07-10,06:31:00,22988.25,BUY,3,0.02h,Break Even,$-1.50,$-37.50,$233255.00,397,$-37.50
2025-07-10,06:48:00,22986.25,SELL,3,0.02h,Stop Loss,$-9.00,$-46.50,$233246.00,397,$-46.50
2025-07-10,06:54:00,22989.75,BUY,3,0.02h,Stop Loss,$-9.00,$-55.50,$233237.00,397,$-55.50
2025-07-10,07:08:00,22988.75,SELL,3,0.02h,Break Even,$-1.50,$-57.00,$233235.50,397,$-57.00
2025-07-10,07:18:00,22992.0,BUY,3,0.02h,Break Even,$-1.50,$-58.50,$233234.00,397,$-58.50
2025-07-10,09:17:00,23037.25,SELL,3,0.02h,Stop Loss,$-9.00,$-67.50,$233225.00,397,$-67.50
2025-07-10,09:54:00,23025.75,BUY,3,0.02h,Stop Loss,$-9.00,$-76.50,$233216.00,397,$-76.50
2025-07-10,12:03:00,23060.75,SELL,3,0.02h,Stop Loss,$6.00,$-70.50,$233222.00,397,$-70.50
2025-07-10,13:00:00,23049.25,BUY,3,0.02h,Break Even,$-1.50,$-72.00,$233220.50,397,$-72.00
2025-07-10,13:14:00,23042.25,SELL,3,0.02h,Break Even,$-1.50,$-73.50,$233219.00,397,$-73.50
2025-07-10,13:16:00,23055.0,BUY,3,0.02h,Stop Loss,$-9.00,$-82.50,$233210.00,397,$-82.50
2025-07-10,13:34:00,23035.25,SELL,3,0.02h,Stop Loss,$58.50,$-24.00,$233268.50,397,$-24.00
2025-07-10,14:20:00,22964.0,BUY,3,0.02h,Break Even,$-1.50,$-25.50,$233267.00,397,$-25.50
2025-07-10,14:21:00,22945.0,SELL,3,0.02h,Stop Loss,$70.50,$45.00,$233337.50,397,$45.00
2025-07-10,14:37:00,22956.0,BUY,3,0.02h,Stop Loss,$24.00,$69.00,$233361.50,397,$69.00
2025-07-10,15:01:00,22962.25,SELL,3,0.02h,Break Even,$-1.50,$67.50,$233360.00,397,$67.50
2025-07-10,15:02:00,22971.25,BUY,3,0.02h,Stop Loss,$12.00,$79.50,$233372.00,397,$79.50
2025-07-10,15:10:00,22965.75,SELL,3,0.02h,Stop Loss,$85.50,$165.00,$233457.50,397,$165.00
2025-07-10,15:24:00,22971.75,BUY,3,0.02h,Stop Loss,$31.50,$196.50,$233489.00,397,$196.50
2025-07-10,16:07:00,23003.0,SELL,3,0.02h,Break Even,$-1.50,$195.00,$233487.50,397,$195.00
2025-07-10,16:26:00,23005.75,BUY,3,0.02h,Stop Loss,$3.00,$198.00,$233490.50,397,$198.00
2025-07-10,16:37:00,22989.25,SELL,3,0.02h,Stop Loss,$-9.00,$189.00,$233481.50,397,$189.00
2025-07-10,16:41:00,23003.5,BUY,3,0.02h,Break Even,$-1.50,$187.50,$233480.00,397,$187.50
2025-07-10,16:50:00,22990.0,SELL,3,0.02h,Stop Loss,$-9.00,$178.50,$233471.00,397,$178.50
2025-07-10,16:51:00,23002.75,BUY,3,0.02h,Stop Loss,$-9.00,$169.50,$233462.00,397,$169.50
2025-07-10,16:52:00,22997.5,SELL,3,0.02h,Break Even,$-1.50,$168.00,$233460.50,397,$168.00
2025-07-10,16:58:00,23000.0,BUY,3,0.02h,Stop Loss,$-9.00,$159.00,$233451.50,397,$159.00
2025-07-10,17:00:00,22992.25,SELL,3,0.02h,Break Even,$-1.50,$157.50,$233450.00,397,$157.50
2025-07-10,17:02:00,23002.0,BUY,3,0.02h,Stop Loss,$10.50,$168.00,$233460.50,397,$168.00
2025-07-10,17:03:00,22998.25,SELL,3,0.02h,Break Even,$-1.50,$166.50,$233459.00,397,$166.50
2025-07-10,17:04:00,23000.75,BUY,3,0.02h,Break Even,$-1.50,$165.00,$233457.50,397,$165.00
2025-07-10,17:09:00,22998.0,SELL,3,0.02h,Stop Loss,$-9.00,$156.00,$233448.50,397,$156.00
2025-07-10,17:10:00,23000.25,BUY,3,0.02h,Stop Loss,$16.50,$172.50,$233465.00,397,$172.50
2025-07-10,17:15:00,22996.75,SELL,3,0.02h,Stop Loss,$6.00,$178.50,$233471.00,397,$178.50
2025-07-10,17:21:00,23002.25,BUY,3,0.02h,Stop Loss,$3.00,$181.50,$233474.00,397,$181.50
2025-07-10,18:29:00,23033.75,SELL,3,0.02h,Break Even,$-1.50,$180.00,$233472.50,397,$180.00
2025-07-10,18:59:00,23042.25,BUY,3,0.02h,Stop Loss,$-9.00,$171.00,$233463.50,397,$171.00
2025-07-10,19:16:00,23036.0,SELL,3,0.02h,Break Even,$-1.50,$169.50,$233462.00,397,$169.50
2025-07-10,19:18:00,23038.75,BUY,3,0.02h,Stop Loss,$-9.00,$160.50,$233453.00,397,$160.50
2025-07-10,19:20:00,23034.25,SELL,3,0.02h,Stop Loss,$-9.00,$151.50,$233444.00,397,$151.50
2025-07-10,19:37:00,23037.25,BUY,3,0.02h,Stop Loss,$-9.00,$142.50,$233435.00,397,$142.50
2025-07-10,19:47:00,23028.5,SELL,3,0.02h,Break Even,$-1.50,$141.00,$233433.50,397,$141.00
2025-07-10,20:31:00,23012.75,BUY,3,0.02h,Break Even,$-1.50,$139.50,$233432.00,397,$139.50
2025-07-10,20:53:00,23011.0,SELL,3,0.02h,Stop Loss,$-9.00,$130.50,$233423.00,397,$130.50
2025-07-10,23:00:00,23038.0,BUY,3,0.02h,Break Even,$-1.50,$129.00,$233421.50,397,$129.00
2025-07-10,23:27:00,23033.0,SELL,3,0.02h,Stop Loss,$-9.00,$120.00,$233412.50,397,$120.00
2025-07-10,23:31:00,23041.25,BUY,3,0.02h,Stop Loss,$-9.00,$111.00,$233403.50,397,$111.00
2025-07-10,23:39:00,23034.0,SELL,3,0.02h,Stop Loss,$-9.00,$102.00,$233394.50,397,$102.00
2025-07-10,23:47:00,23037.25,BUY,3,0.02h,Stop Loss,$4.50,$106.50,$233399.00,397,$106.50
,,,,,,,,,,,
2025-07-11,00:02:00,23025.25,SELL,3,0.02h,Break Even,$-1.50,$-1.50,$233397.50,398,$-1.50
2025-07-11,00:58:00,22915.0,BUY,3,0.02h,Break Even,$-1.50,$-3.00,$233396.00,398,$-3.00
2025-07-11,01:01:00,22885.5,SELL,3,0.02h,Stop Loss,$15.00,$12.00,$233411.00,398,$12.00
2025-07-11,01:11:00,22894.5,BUY,3,0.02h,Stop Loss,$7.50,$19.50,$233418.50,398,$19.50
2025-07-11,01:54:00,22924.0,SELL,3,0.02h,Break Even,$-1.50,$18.00,$233417.00,398,$18.00
2025-07-11,02:03:00,22930.75,BUY,3,0.02h,Break Even,$-1.50,$16.50,$233415.50,398,$16.50
2025-07-11,02:09:00,22923.0,SELL,3,0.02h,Break Even,$-1.50,$15.00,$233414.00,398,$15.00
2025-07-11,02:30:00,22929.0,BUY,3,0.02h,Stop Loss,$-9.00,$6.00,$233405.00,398,$6.00
2025-07-11,04:04:00,22965.5,SELL,3,0.02h,Break Even,$-1.50,$4.50,$233403.50,398,$4.50
2025-07-11,04:12:00,22971.0,BUY,3,0.02h,Stop Loss,$-9.00,$-4.50,$233394.50,398,$-4.50
2025-07-11,04:33:00,22966.5,SELL,3,0.02h,Stop Loss,$-9.00,$-13.50,$233385.50,398,$-13.50
2025-07-11,05:03:00,22970.0,BUY,3,0.02h,Stop Loss,$-9.00,$-22.50,$233376.50,398,$-22.50
2025-07-11,05:12:00,22964.75,SELL,3,0.02h,Stop Loss,$-9.00,$-31.50,$233367.50,398,$-31.50
2025-07-11,05:23:00,22970.25,BUY,3,0.02h,Stop Loss,$-9.00,$-40.50,$233358.50,398,$-40.50
2025-07-11,05:46:00,22965.0,SELL,3,0.02h,Stop Loss,$-9.00,$-49.50,$233349.50,398,$-49.50
2025-07-11,06:18:00,22958.75,BUY,3,0.02h,Stop Loss,$-9.00,$-58.50,$233340.50,398,$-58.50
2025-07-11,06:35:00,22954.0,SELL,3,0.02h,Break Even,$-1.50,$-60.00,$233339.00,398,$-60.00
2025-07-11,06:49:00,22959.0,BUY,3,0.02h,Stop Loss,$-9.00,$-69.00,$233330.00,398,$-69.00
2025-07-11,07:04:00,22949.5,SELL,3,0.02h,Stop Loss,$-9.00,$-78.00,$233321.00,398,$-78.00
2025-07-11,07:34:00,22937.25,BUY,3,0.02h,Stop Loss,$-9.00,$-87.00,$233312.00,398,$-87.00
2025-07-11,07:43:00,22926.25,SELL,3,0.02h,Stop Loss,$3.00,$-84.00,$233315.00,398,$-84.00
2025-07-11,08:30:00,22891.5,BUY,3,0.02h,Stop Loss,$-9.00,$-93.00,$233306.00,398,$-93.00
2025-07-11,08:31:00,22882.75,SELL,3,0.02h,Stop Loss,$3.00,$-90.00,$233309.00,398,$-90.00
2025-07-11,08:44:00,22889.0,BUY,3,0.02h,Stop Loss,$-9.00,$-99.00,$233300.00,398,$-99.00
2025-07-11,08:45:00,22885.25,SELL,3,0.02h,Break Even,$-1.50,$-100.50,$233298.50,398,$-100.50
2025-07-11,08:46:00,22888.5,BUY,3,0.02h,Break Even,$-1.50,$-102.00,$233297.00,398,$-102.00
2025-07-11,09:22:00,22898.0,SELL,3,0.02h,Stop Loss,$-9.00,$-111.00,$233288.00,398,$-111.00
2025-07-11,09:41:00,22905.5,BUY,3,0.02h,Stop Loss,$-9.00,$-120.00,$233279.00,398,$-120.00
2025-07-11,09:43:00,22891.75,SELL,3,0.02h,Break Even,$-1.50,$-121.50,$233277.50,398,$-121.50
2025-07-11,10:12:00,22884.75,BUY,3,0.02h,Break Even,$-1.50,$-123.00,$233276.00,398,$-123.00
2025-07-11,10:23:00,22879.75,SELL,3,0.02h,Stop Loss,$3.00,$-120.00,$233279.00,398,$-120.00
2025-07-11,10:48:00,22877.25,BUY,3,0.02h,Stop Loss,$-9.00,$-129.00,$233270.00,398,$-129.00
2025-07-11,10:56:00,22860.0,SELL,3,0.02h,Stop Loss,$-9.00,$-138.00,$233261.00,398,$-138.00
2025-07-11,11:02:00,22880.5,BUY,3,0.02h,Stop Loss,$-9.00,$-147.00,$233252.00,398,$-147.00
2025-07-11,12:21:00,22903.75,SELL,3,0.02h,Break Even,$-1.50,$-148.50,$233250.50,398,$-148.50
2025-07-11,12:48:00,22909.0,BUY,3,0.02h,Stop Loss,$-9.00,$-157.50,$233241.50,398,$-157.50
2025-07-11,13:09:00,22901.5,SELL,3,0.02h,Break Even,$-1.50,$-159.00,$233240.00,398,$-159.00
2025-07-11,13:29:00,22907.75,BUY,3,0.02h,Stop Loss,$54.00,$-105.00,$233294.00,398,$-105.00
2025-07-11,13:40:00,22892.75,SELL,3,0.02h,Stop Loss,$48.00,$-57.00,$233342.00,398,$-57.00
2025-07-11,13:50:00,22936.0,BUY,3,0.02h,Stop Loss,$27.00,$-30.00,$233369.00,398,$-30.00
2025-07-11,14:44:00,22984.25,SELL,3,0.02h,Stop Loss,$7.50,$-22.50,$233376.50,398,$-22.50
2025-07-11,15:31:00,22957.25,BUY,3,0.02h,Stop Loss,$9.00,$-13.50,$233385.50,398,$-13.50
2025-07-11,15:57:00,22964.25,SELL,3,0.02h,Stop Loss,$-9.00,$-22.50,$233376.50,398,$-22.50
2025-07-11,16:01:00,22994.25,BUY,3,0.02h,Stop Loss,$-9.00,$-31.50,$233367.50,398,$-31.50
2025-07-11,16:05:00,22972.25,SELL,3,0.02h,Stop Loss,$9.00,$-22.50,$233376.50,398,$-22.50
2025-07-11,16:17:00,22992.25,BUY,3,0.02h,Stop Loss,$-9.00,$-31.50,$233367.50,398,$-31.50
2025-07-11,16:44:00,22974.75,SELL,3,0.02h,Break Even,$-1.50,$-33.00,$233366.00,398,$-33.00
2025-07-11,16:54:00,22989.75,BUY,3,0.02h,Stop Loss,$9.00,$-24.00,$233375.00,398,$-24.00
2025-07-11,17:32:00,23000.0,SELL,3,0.02h,Stop Loss,$21.00,$-3.00,$233396.00,398,$-3.00
2025-07-11,17:54:00,22996.0,BUY,3,0.02h,Break Even,$-1.50,$-4.50,$233394.50,398,$-4.50
2025-07-11,18:21:00,22996.5,SELL,3,0.02h,Break Even,$-1.50,$-6.00,$233393.00,398,$-6.00
2025-07-11,18:23:00,23001.25,BUY,3,0.02h,Break Even,$-1.50,$-7.50,$233391.50,398,$-7.50
2025-07-11,18:24:00,22999.25,SELL,3,0.02h,Break Even,$-1.50,$-9.00,$233390.00,398,$-9.00
2025-07-11,18:25:00,23003.0,BUY,3,0.02h,Break Even,$-1.50,$-10.50,$233388.50,398,$-10.50
2025-07-11,18:31:00,22999.25,SELL,3,0.02h,Break Even,$-1.50,$-12.00,$233387.00,398,$-12.00
2025-07-11,18:32:00,23004.75,BUY,3,0.02h,Break Even,$-1.50,$-13.50,$233385.50,398,$-13.50
2025-07-11,18:50:00,23002.25,SELL,3,0.02h,Break Even,$-1.50,$-15.00,$233384.00,398,$-15.00
2025-07-11,19:19:00,22983.75,BUY,3,0.02h,Break Even,$-1.50,$-16.50,$233382.50,398,$-16.50
2025-07-11,19:35:00,22979.0,SELL,3,0.02h,Break Even,$-1.50,$-18.00,$233381.00,398,$-18.00
2025-07-11,20:52:00,22941.5,BUY,3,0.02h,Break Even,$-1.50,$-19.50,$233379.50,398,$-19.50
,,,,,,,,,,,
2025-07-14,00:00:00,22866.5,SELL,3,0.02h,Break Even,$-1.50,$-1.50,$233378.00,399,$-1.50
2025-07-14,01:22:00,22855.25,BUY,3,0.02h,Stop Loss,$-9.00,$-10.50,$233369.00,399,$-10.50
2025-07-14,01:24:00,22845.5,SELL,3,0.02h,Break Even,$-1.50,$-12.00,$233367.50,399,$-12.00
2025-07-14,01:35:00,22857.25,BUY,3,0.02h,Stop Loss,$-9.00,$-21.00,$233358.50,399,$-21.00
2025-07-14,02:35:00,22862.0,SELL,3,0.02h,Break Even,$-1.50,$-22.50,$233357.00,399,$-22.50
2025-07-14,02:47:00,22869.0,BUY,3,0.02h,Stop Loss,$-9.00,$-31.50,$233348.00,399,$-31.50
2025-07-14,02:51:00,22861.0,SELL,3,0.02h,Break Even,$-1.50,$-33.00,$233346.50,399,$-33.00
2025-07-14,03:10:00,22862.0,BUY,3,0.02h,Break Even,$-1.50,$-34.50,$233345.00,399,$-34.50
2025-07-14,04:06:00,22868.0,SELL,3,0.02h,Stop Loss,$-9.00,$-43.50,$233336.00,399,$-43.50
2025-07-14,04:09:00,22872.5,BUY,3,0.03h,Break Even,$-1.50,$-45.00,$233334.50,399,$-45.00
2025-07-14,04:28:00,22869.25,SELL,3,0.02h,Stop Loss,$-9.00,$-54.00,$233325.50,399,$-54.00
2025-07-14,05:09:00,22868.75,BUY,3,0.02h,Stop Loss,$-9.00,$-63.00,$233316.50,399,$-63.00
2025-07-14,05:12:00,22864.75,SELL,3,0.02h,Stop Loss,$-9.00,$-72.00,$233307.50,399,$-72.00
2025-07-14,05:14:00,22868.25,BUY,3,0.02h,Stop Loss,$-9.00,$-81.00,$233298.50,399,$-81.00
2025-07-14,05:17:00,22864.75,SELL,3,0.02h,Break Even,$-1.50,$-82.50,$233297.00,399,$-82.50
2025-07-14,05:33:00,22865.5,BUY,3,0.02h,Break Even,$-1.50,$-84.00,$233295.50,399,$-84.00
2025-07-14,05:39:00,22863.5,SELL,3,0.02h,Stop Loss,$3.00,$-81.00,$233298.50,399,$-81.00
2025-07-14,06:23:00,22831.5,BUY,3,0.02h,Stop Loss,$-9.00,$-90.00,$233289.50,399,$-90.00
2025-07-14,07:06:00,22835.75,SELL,3,0.02h,Break Even,$-1.50,$-91.50,$233288.00,399,$-91.50
2025-07-14,07:33:00,22835.75,BUY,3,0.02h,Break Even,$-1.50,$-93.00,$233286.50,399,$-93.00
2025-07-14,08:26:00,22869.75,SELL,3,0.02h,Break Even,$-1.50,$-94.50,$233285.00,399,$-94.50
2025-07-14,08:45:00,22872.5,BUY,3,0.02h,Stop Loss,$4.50,$-90.00,$233289.50,399,$-90.00
2025-07-14,09:20:00,22883.0,SELL,3,0.02h,Stop Loss,$-9.00,$-99.00,$233280.50,399,$-99.00
2025-07-14,09:21:00,22889.5,BUY,3,0.02h,Break Even,$-1.50,$-100.50,$233279.00,399,$-100.50
2025-07-14,10:04:00,22890.75,SELL,3,0.02h,Stop Loss,$-9.00,$-109.50,$233270.00,399,$-109.50
2025-07-14,10:51:00,22885.0,BUY,3,0.02h,Stop Loss,$-9.00,$-118.50,$233261.00,399,$-118.50
2025-07-14,11:00:00,22877.5,SELL,3,0.02h,Stop Loss,$-9.00,$-127.50,$233252.00,399,$-127.50
2025-07-14,11:05:00,22886.0,BUY,3,0.02h,Break Even,$-1.50,$-129.00,$233250.50,399,$-129.00
2025-07-14,11:09:00,22878.0,SELL,3,0.02h,Stop Loss,$-9.00,$-138.00,$233241.50,399,$-138.00
2025-07-14,11:10:00,22886.0,BUY,3,0.02h,Stop Loss,$12.00,$-126.00,$233253.50,399,$-126.00
2025-07-14,11:18:00,22870.5,SELL,3,0.02h,Stop Loss,$-9.00,$-135.00,$233244.50,399,$-135.00
2025-07-14,11:40:00,22879.5,BUY,3,0.02h,Stop Loss,$6.00,$-129.00,$233250.50,399,$-129.00
2025-07-14,12:07:00,22883.25,SELL,3,0.02h,Stop Loss,$4.50,$-124.50,$233255.00,399,$-124.50
2025-07-14,12:14:00,22892.25,BUY,3,0.02h,Stop Loss,$-9.00,$-133.50,$233246.00,399,$-133.50
2025-07-14,12:36:00,22895.0,SELL,3,0.02h,Stop Loss,$-9.00,$-142.50,$233237.00,399,$-142.50
2025-07-14,12:39:00,22902.25,BUY,3,0.02h,Stop Loss,$7.50,$-135.00,$233244.50,399,$-135.00
2025-07-14,12:59:00,22895.25,SELL,3,0.02h,Stop Loss,$-9.00,$-144.00,$233235.50,399,$-144.00
2025-07-14,13:15:00,22904.75,BUY,3,0.02h,Break Even,$-1.50,$-145.50,$233234.00,399,$-145.50
2025-07-14,13:43:00,22878.75,SELL,3,0.02h,Stop Loss,$127.50,$-18.00,$233361.50,399,$-18.00
2025-07-14,13:53:00,22921.75,BUY,3,0.02h,Stop Loss,$21.00,$3.00,$233382.50,399,$3.00
2025-07-14,14:32:00,22937.75,SELL,3,0.02h,Stop Loss,$70.50,$73.50,$233453.00,399,$73.50
2025-07-14,14:44:00,22956.0,BUY,3,0.02h,Break Even,$-1.50,$72.00,$233451.50,399,$72.00
2025-07-14,15:36:00,23000.25,SELL,3,0.02h,Stop Loss,$-9.00,$63.00,$233442.50,399,$63.00
2025-07-14,15:37:00,23009.75,BUY,3,0.02h,Stop Loss,$4.50,$67.50,$233447.00,399,$67.50
2025-07-14,15:47:00,22996.0,SELL,3,0.02h,Stop Loss,$-9.00,$58.50,$233438.00,399,$58.50
2025-07-14,15:52:00,23008.25,BUY,3,0.02h,Stop Loss,$-9.00,$49.50,$233429.00,399,$49.50
2025-07-14,15:56:00,22996.75,SELL,3,0.02h,Stop Loss,$-9.00,$40.50,$233420.00,399,$40.50
2025-07-14,16:00:00,23008.75,BUY,3,0.02h,Stop Loss,$-9.00,$31.50,$233411.00,399,$31.50
2025-07-14,16:03:00,23004.25,SELL,3,0.02h,Stop Loss,$6.00,$37.50,$233417.00,399,$37.50
2025-07-14,16:08:00,23016.0,BUY,3,0.02h,Break Even,$-1.50,$36.00,$233415.50,399,$36.00
2025-07-14,16:30:00,23015.25,SELL,3,0.02h,Stop Loss,$3.00,$39.00,$233418.50,399,$39.00
2025-07-14,16:42:00,23027.0,BUY,3,0.02h,Stop Loss,$-9.00,$30.00,$233409.50,399,$30.00
2025-07-14,17:43:00,23047.25,SELL,3,0.02h,Stop Loss,$-9.00,$21.00,$233400.50,399,$21.00
2025-07-14,17:54:00,23054.75,BUY,3,0.02h,Stop Loss,$-9.00,$12.00,$233391.50,399,$12.00
2025-07-14,17:57:00,23047.5,SELL,3,0.02h,Break Even,$-1.50,$10.50,$233390.00,399,$10.50
2025-07-14,18:28:00,23048.5,BUY,3,0.02h,Break Even,$-1.50,$9.00,$233388.50,399,$9.00
2025-07-14,19:09:00,23045.25,SELL,3,0.02h,Break Even,$-1.50,$7.50,$233387.00,399,$7.50
2025-07-14,19:59:00,23039.25,BUY,3,0.02h,Break Even,$-1.50,$6.00,$233385.50,399,$6.00
2025-07-14,20:01:00,23023.75,SELL,3,0.02h,Break Even,$-1.50,$4.50,$233384.00,399,$4.50
2025-07-14,20:02:00,23032.5,BUY,3,0.02h,Break Even,$-1.50,$3.00,$233382.50,399,$3.00
2025-07-14,20:03:00,23029.75,SELL,3,0.02h,Break Even,$-1.50,$1.50,$233381.00,399,$1.50
2025-07-14,20:21:00,23031.0,BUY,3,0.02h,Stop Loss,$-9.00,$-7.50,$233372.00,399,$-7.50
2025-07-14,20:27:00,23025.25,SELL,3,0.02h,Break Even,$-1.50,$-9.00,$233370.50,399,$-9.00
2025-07-14,20:41:00,23028.75,BUY,3,0.03h,Break Even,$-1.50,$-10.50,$233369.00,399,$-10.50
2025-07-14,23:00:00,23002.0,SELL,3,0.02h,Break Even,$-1.50,$-12.00,$233367.50,399,$-12.00
2025-07-14,23:38:00,23006.0,BUY,3,0.02h,Stop Loss,$-9.00,$-21.00,$233358.50,399,$-21.00
2025-07-14,23:39:00,23005.0,SELL,3,0.02h,Stop Loss,$-9.00,$-30.00,$233349.50,399,$-30.00
2025-07-14,23:52:00,23008.5,BUY,3,0.02h,Break Even,$-1.50,$-31.50,$233348.00,399,$-31.50
,,,,,,,,,,,
2025-07-15,00:26:00,23011.25,SELL,3,0.02h,Stop Loss,$-9.00,$-9.00,$233339.00,400,$-9.00
2025-07-15,01:22:00,23006.75,BUY,3,0.02h,Stop Loss,$-9.00,$-18.00,$233330.00,400,$-18.00
2025-07-15,02:17:00,23107.0,SELL,3,0.02h,Stop Loss,$106.50,$88.50,$233436.50,400,$88.50
2025-07-15,03:17:00,23056.75,BUY,3,0.02h,Break Even,$-1.50,$87.00,$233435.00,400,$87.00
2025-07-15,04:11:00,23092.0,SELL,3,0.02h,Stop Loss,$-9.00,$78.00,$233426.00,400,$78.00
2025-07-15,04:14:00,23095.0,BUY,3,0.02h,Stop Loss,$-9.00,$69.00,$233417.00,400,$69.00
2025-07-15,04:17:00,23092.0,SELL,3,0.02h,Stop Loss,$-9.00,$60.00,$233408.00,400,$60.00
2025-07-15,04:18:00,23097.75,BUY,3,0.02h,Stop Loss,$-9.00,$51.00,$233399.00,400,$51.00
2025-07-15,05:44:00,23147.0,SELL,3,0.02h,Break Even,$-1.50,$49.50,$233397.50,400,$49.50
2025-07-15,05:53:00,23153.25,BUY,3,0.02h,Stop Loss,$-9.00,$40.50,$233388.50,400,$40.50
2025-07-15,05:55:00,23149.5,SELL,3,0.02h,Stop Loss,$-9.00,$31.50,$233379.50,400,$31.50
2025-07-15,05:56:00,23151.5,BUY,3,0.02h,Break Even,$-1.50,$30.00,$233378.00,400,$30.00
2025-07-15,05:59:00,23147.75,SELL,3,0.02h,Break Even,$-1.50,$28.50,$233376.50,400,$28.50
2025-07-15,06:03:00,23152.0,BUY,3,0.02h,Stop Loss,$4.50,$33.00,$233381.00,400,$33.00
2025-07-15,06:07:00,23148.75,SELL,3,0.02h,Stop Loss,$-9.00,$24.00,$233372.00,400,$24.00
2025-07-15,06:33:00,23146.5,BUY,3,0.02h,Stop Loss,$-9.00,$15.00,$233363.00,400,$15.00
2025-07-15,06:34:00,23141.0,SELL,3,0.02h,Break Even,$-1.50,$13.50,$233361.50,400,$13.50
2025-07-15,06:54:00,23145.25,BUY,3,0.02h,Break Even,$-1.50,$12.00,$233360.00,400,$12.00
2025-07-15,07:17:00,23139.5,SELL,3,0.02h,Stop Loss,$-9.00,$3.00,$233351.00,400,$3.00
2025-07-15,07:18:00,23143.5,BUY,3,0.02h,Break Even,$-1.50,$1.50,$233349.50,400,$1.50
2025-07-15,07:19:00,23141.25,SELL,3,0.02h,Stop Loss,$-9.00,$-7.50,$233340.50,400,$-7.50
2025-07-15,07:34:00,23144.0,BUY,3,0.02h,Break Even,$-1.50,$-9.00,$233339.00,400,$-9.00
2025-07-15,08:02:00,23144.0,SELL,3,0.02h,Stop Loss,$-9.00,$-18.00,$233330.00,400,$-18.00
2025-07-15,08:15:00,23157.75,BUY,3,0.02h,Stop Loss,$-9.00,$-27.00,$233321.00,400,$-27.00
2025-07-15,08:18:00,23150.75,SELL,3,0.02h,Stop Loss,$6.00,$-21.00,$233327.00,400,$-21.00
2025-07-15,08:23:00,23159.25,BUY,3,0.02h,Break Even,$-1.50,$-22.50,$233325.50,400,$-22.50
2025-07-15,08:54:00,23162.75,SELL,3,0.02h,Stop Loss,$12.00,$-10.50,$233337.50,400,$-10.50
2025-07-15,09:12:00,23163.0,BUY,3,0.02h,Break Even,$-1.50,$-12.00,$233336.00,400,$-12.00
2025-07-15,09:46:00,23164.75,SELL,3,0.02h,Break Even,$-1.50,$-13.50,$233334.50,400,$-13.50
2025-07-15,10:00:00,23174.0,BUY,3,0.02h,Stop Loss,$-9.00,$-22.50,$233325.50,400,$-22.50
2025-07-15,10:06:00,23167.25,SELL,3,0.02h,Break Even,$-1.50,$-24.00,$233324.00,400,$-24.00
2025-07-15,10:11:00,23170.5,BUY,3,0.02h,Break Even,$-1.50,$-25.50,$233322.50,400,$-25.50
2025-07-15,10:44:00,23174.75,SELL,3,0.02h,Stop Loss,$-9.00,$-34.50,$233313.50,400,$-34.50
2025-07-15,11:09:00,23178.25,BUY,3,0.02h,Stop Loss,$63.00,$28.50,$233376.50,400,$28.50
2025-07-15,11:27:00,23171.75,SELL,3,0.02h,Stop Loss,$-9.00,$19.50,$233367.50,400,$19.50
2025-07-15,11:40:00,23178.25,BUY,3,0.02h,Stop Loss,$-9.00,$10.50,$233358.50,400,$10.50
2025-07-15,11:41:00,23172.25,SELL,3,0.02h,Stop Loss,$-9.00,$1.50,$233349.50,400,$1.50
2025-07-15,12:31:00,23194.5,BUY,3,0.02h,Stop Loss,$42.00,$43.50,$233391.50,400,$43.50
2025-07-15,13:33:00,23191.75,SELL,3,0.02h,Stop Loss,$105.00,$148.50,$233496.50,400,$148.50
2025-07-15,14:10:00,23162.75,BUY,3,0.02h,Stop Loss,$31.50,$180.00,$233528.00,400,$180.00
2025-07-15,14:33:00,23165.0,SELL,3,0.02h,Stop Loss,$15.00,$195.00,$233543.00,400,$195.00
2025-07-15,15:12:00,23140.75,BUY,3,0.02h,Stop Loss,$13.50,$208.50,$233556.50,400,$208.50
2025-07-15,15:57:00,23156.0,SELL,3,0.02h,Break Even,$-1.50,$207.00,$233555.00,400,$207.00
2025-07-15,16:33:00,23154.0,BUY,3,0.02h,Break Even,$-1.50,$205.50,$233553.50,400,$205.50
2025-07-15,16:35:00,23140.75,SELL,3,0.02h,Break Even,$-1.50,$204.00,$233552.00,400,$204.00
2025-07-15,16:53:00,23144.0,BUY,3,0.02h,Stop Loss,$-9.00,$195.00,$233543.00,400,$195.00
2025-07-15,16:54:00,23138.5,SELL,3,0.02h,Stop Loss,$69.00,$264.00,$233612.00,400,$264.00
2025-07-15,17:28:00,23115.5,BUY,3,0.02h,Stop Loss,$3.00,$267.00,$233615.00,400,$267.00
2025-07-15,18:35:00,23168.75,SELL,3,0.02h,Stop Loss,$63.00,$330.00,$233678.00,400,$330.00
2025-07-15,19:42:00,23109.0,BUY,3,0.02h,Stop Loss,$3.00,$333.00,$233681.00,400,$333.00
2025-07-15,19:54:00,23094.0,SELL,3,0.02h,Stop Loss,$13.50,$346.50,$233694.50,400,$346.50
2025-07-15,23:37:00,23007.25,BUY,3,0.02h,Stop Loss,$-9.00,$337.50,$233685.50,400,$337.50
,,,,,,,,,,,
2025-07-16,00:03:00,23003.25,SELL,3,0.02h,Stop Loss,$-9.00,$-9.00,$233676.50,401,$-9.00
2025-07-16,00:34:00,22997.75,BUY,3,0.02h,Break Even,$-1.50,$-10.50,$233675.00,401,$-10.50
2025-07-16,00:54:00,22998.25,SELL,3,0.02h,Break Even,$-1.50,$-12.00,$233673.50,401,$-12.00
2025-07-16,01:00:00,22999.75,BUY,3,0.02h,Break Even,$-1.50,$-13.50,$233672.00,401,$-13.50
2025-07-16,01:30:00,23014.5,SELL,3,0.02h,Break Even,$-1.50,$-15.00,$233670.50,401,$-15.00
2025-07-16,01:33:00,23016.75,BUY,3,0.02h,Break Even,$-1.50,$-16.50,$233669.00,401,$-16.50
2025-07-16,01:36:00,23015.0,SELL,3,0.02h,Break Even,$-1.50,$-18.00,$233667.50,401,$-18.00
2025-07-16,01:38:00,23020.5,BUY,3,0.02h,Stop Loss,$-9.00,$-27.00,$233658.50,401,$-27.00
2025-07-16,02:12:00,23021.5,SELL,3,0.02h,Stop Loss,$-9.00,$-36.00,$233649.50,401,$-36.00
2025-07-16,02:22:00,23029.25,BUY,3,0.02h,Break Even,$-1.50,$-37.50,$233648.00,401,$-37.50
2025-07-16,02:33:00,23025.75,SELL,3,0.03h,Stop Loss,$4.50,$-33.00,$233652.50,401,$-33.00
2025-07-16,03:05:00,23016.0,BUY,3,0.02h,Stop Loss,$-9.00,$-42.00,$233643.50,401,$-42.00
2025-07-16,03:06:00,23014.25,SELL,3,0.02h,Stop Loss,$-9.00,$-51.00,$233634.50,401,$-51.00
2025-07-16,03:07:00,23015.75,BUY,3,0.02h,Break Even,$-1.50,$-52.50,$233633.00,401,$-52.50
2025-07-16,03:46:00,23018.25,SELL,3,0.02h,Stop Loss,$-9.00,$-61.50,$233624.00,401,$-61.50
2025-07-16,03:53:00,23023.75,BUY,3,0.02h,Stop Loss,$-9.00,$-70.50,$233615.00,401,$-70.50
2025-07-16,03:56:00,23016.75,SELL,3,0.02h,Break Even,$-1.50,$-72.00,$233613.50,401,$-72.00
2025-07-16,04:05:00,23027.75,BUY,3,0.02h,Stop Loss,$-9.00,$-81.00,$233604.50,401,$-81.00
2025-07-16,04:24:00,23023.75,SELL,3,0.02h,Break Even,$-1.50,$-82.50,$233603.00,401,$-82.50
2025-07-16,04:32:00,23027.25,BUY,3,0.02h,Stop Loss,$-9.00,$-91.50,$233594.00,401,$-91.50
2025-07-16,04:40:00,23024.25,SELL,3,0.02h,Stop Loss,$-9.00,$-100.50,$233585.00,401,$-100.50
2025-07-16,04:41:00,23027.25,BUY,3,0.02h,Stop Loss,$-9.00,$-109.50,$233576.00,401,$-109.50
2025-07-16,04:45:00,23022.25,SELL,3,0.03h,Break Even,$-1.50,$-111.00,$233574.50,401,$-111.00
2025-07-16,05:02:00,23033.75,BUY,3,0.02h,Stop Loss,$3.00,$-108.00,$233577.50,401,$-108.00
2025-07-16,05:04:00,23009.0,SELL,3,0.02h,Stop Loss,$-9.00,$-117.00,$233568.50,401,$-117.00
2025-07-16,05:34:00,23015.75,BUY,3,0.02h,Break Even,$-1.50,$-118.50,$233567.00,401,$-118.50
2025-07-16,05:48:00,23012.5,SELL,3,0.02h,Stop Loss,$13.50,$-105.00,$233580.50,401,$-105.00
2025-07-16,07:20:00,22972.75,BUY,3,0.02h,Stop Loss,$6.00,$-99.00,$233586.50,401,$-99.00
2025-07-16,07:50:00,22978.5,SELL,3,0.02h,Break Even,$-1.50,$-100.50,$233585.00,401,$-100.50
2025-07-16,08:01:00,22983.75,BUY,3,0.02h,Break Even,$-1.50,$-102.00,$233583.50,401,$-102.00
2025-07-16,08:03:00,22975.0,SELL,3,0.02h,Break Even,$-1.50,$-103.50,$233582.00,401,$-103.50
2025-07-16,08:08:00,22984.5,BUY,3,0.02h,Stop Loss,$-9.00,$-112.50,$233573.00,401,$-112.50
2025-07-16,09:04:00,22996.0,SELL,3,0.02h,Break Even,$-1.50,$-114.00,$233571.50,401,$-114.00
2025-07-16,09:40:00,22992.0,BUY,3,0.02h,Stop Loss,$-9.00,$-123.00,$233562.50,401,$-123.00
2025-07-16,09:42:00,22984.0,SELL,3,0.02h,Stop Loss,$3.00,$-120.00,$233565.50,401,$-120.00
2025-07-16,09:50:00,22994.25,BUY,3,0.02h,Stop Loss,$-9.00,$-129.00,$233556.50,401,$-129.00
2025-07-16,11:13:00,23008.75,SELL,3,0.02h,Break Even,$-1.50,$-130.50,$233555.00,401,$-130.50
2025-07-16,11:23:00,23016.25,BUY,3,0.02h,Break Even,$-1.50,$-132.00,$233553.50,401,$-132.00
2025-07-16,11:28:00,23005.75,SELL,3,0.02h,Stop Loss,$-9.00,$-141.00,$233544.50,401,$-141.00
2025-07-16,11:50:00,23012.75,BUY,3,0.02h,Stop Loss,$4.50,$-136.50,$233549.00,401,$-136.50
2025-07-16,13:04:00,23060.5,SELL,3,0.02h,Stop Loss,$-9.00,$-145.50,$233540.00,401,$-145.50
2025-07-16,13:11:00,23071.25,BUY,3,0.02h,Break Even,$-1.50,$-147.00,$233538.50,401,$-147.00
2025-07-16,13:17:00,23065.5,SELL,3,0.02h,Break Even,$-1.50,$-148.50,$233537.00,401,$-148.50
2025-07-16,13:19:00,23069.75,BUY,3,0.02h,Break Even,$-1.50,$-150.00,$233535.50,401,$-150.00
2025-07-16,13:32:00,23048.5,SELL,3,0.02h,Stop Loss,$69.00,$-81.00,$233604.50,401,$-81.00
2025-07-16,14:14:00,22992.25,BUY,3,0.02h,Stop Loss,$-9.00,$-90.00,$233595.50,401,$-90.00
2025-07-16,14:15:00,22975.5,SELL,3,0.02h,Stop Loss,$48.00,$-42.00,$233643.50,401,$-42.00
2025-07-16,14:20:00,22993.5,BUY,3,0.02h,Break Even,$-1.50,$-43.50,$233642.00,401,$-43.50
2025-07-16,14:56:00,22993.25,SELL,3,0.02h,Stop Loss,$55.50,$12.00,$233697.50,401,$12.00
2025-07-16,14:57:00,23010.75,BUY,3,0.02h,Break Even,$-1.50,$10.50,$233696.00,401,$10.50
2025-07-16,14:58:00,22992.0,SELL,3,0.02h,Stop Loss,$156.00,$166.50,$233852.00,401,$166.50
2025-07-16,15:05:00,23016.75,BUY,3,0.02h,Break Even,$-1.50,$165.00,$233850.50,401,$165.00
2025-07-16,15:18:00,22983.0,SELL,3,0.02h,Stop Loss,$57.00,$222.00,$233907.50,401,$222.00
2025-07-16,15:48:00,22946.25,BUY,3,0.02h,Break Even,$-1.50,$220.50,$233906.00,401,$220.50
2025-07-16,16:24:00,22971.0,SELL,3,0.02h,Break Even,$-1.50,$219.00,$233904.50,401,$219.00
2025-07-16,16:30:00,22983.0,BUY,3,0.02h,Break Even,$-1.50,$217.50,$233903.00,401,$217.50
2025-07-16,16:48:00,22978.25,SELL,3,0.02h,Stop Loss,$-9.00,$208.50,$233894.00,401,$208.50
2025-07-16,16:49:00,22996.75,BUY,3,0.02h,Stop Loss,$36.00,$244.50,$233930.00,401,$244.50
2025-07-16,17:30:00,23040.0,SELL,3,0.02h,Stop Loss,$4.50,$249.00,$233934.50,401,$249.00
2025-07-16,18:17:00,23042.0,BUY,3,0.02h,Stop Loss,$-9.00,$240.00,$233925.50,401,$240.00
2025-07-16,18:20:00,23026.5,SELL,3,0.02h,Stop Loss,$40.50,$280.50,$233966.00,401,$280.50
2025-07-16,18:23:00,23037.75,BUY,3,0.02h,Break Even,$-1.50,$279.00,$233964.50,401,$279.00
2025-07-16,19:17:00,23062.75,SELL,3,0.02h,Break Even,$-1.50,$277.50,$233963.00,401,$277.50
2025-07-16,19:27:00,23071.0,BUY,3,0.02h,Stop Loss,$-9.00,$268.50,$233954.00,401,$268.50
2025-07-16,20:00:00,23075.0,SELL,3,0.02h,Stop Loss,$46.50,$315.00,$234000.50,401,$315.00
2025-07-16,20:40:00,23065.0,BUY,3,0.02h,Stop Loss,$-9.00,$306.00,$233991.50,401,$306.00
2025-07-16,20:53:00,23060.75,SELL,3,0.02h,Stop Loss,$-9.00,$297.00,$233982.50,401,$297.00
2025-07-16,23:43:00,23041.25,BUY,3,0.02h,Break Even,$-1.50,$295.50,$233981.00,401,$295.50
2025-07-16,23:59:00,23039.0,SELL,3,0.02h,Stop Loss,$-9.00,$286.50,$233972.00,401,$286.50
,,,,,,,,,,,
2025-07-17,00:00:00,23040.5,BUY,3,0.02h,Break Even,$-1.50,$-1.50,$233970.50,402,$-1.50
2025-07-17,00:08:00,23037.75,SELL,3,0.02h,Break Even,$-1.50,$-3.00,$233969.00,402,$-3.00
2025-07-17,00:27:00,23043.0,BUY,3,0.02h,Stop Loss,$28.50,$25.50,$233997.50,402,$25.50
2025-07-17,01:29:00,23052.25,SELL,3,0.02h,Break Even,$-1.50,$24.00,$233996.00,402,$24.00
2025-07-17,02:27:00,23031.75,BUY,3,0.02h,Break Even,$-1.50,$22.50,$233994.50,402,$22.50
2025-07-17,02:31:00,23026.75,SELL,3,0.02h,Stop Loss,$-9.00,$13.50,$233985.50,402,$13.50
2025-07-17,03:17:00,23028.0,BUY,3,0.02h,Stop Loss,$-9.00,$4.50,$233976.50,402,$4.50
2025-07-17,04:22:00,23036.5,SELL,3,0.02h,Break Even,$-1.50,$3.00,$233975.00,402,$3.00
2025-07-17,04:52:00,23034.75,BUY,3,0.02h,Stop Loss,$3.00,$6.00,$233978.00,402,$6.00
2025-07-17,06:59:00,23137.75,SELL,3,0.02h,Stop Loss,$6.00,$12.00,$233984.00,402,$12.00
2025-07-17,07:33:00,23125.0,BUY,3,0.02h,Break Even,$-1.50,$10.50,$233982.50,402,$10.50
2025-07-17,07:55:00,23122.5,SELL,3,0.02h,Break Even,$-1.50,$9.00,$233981.00,402,$9.00
2025-07-17,08:39:00,23105.0,BUY,3,0.02h,Break Even,$-1.50,$7.50,$233979.50,402,$7.50
2025-07-17,08:47:00,23094.25,SELL,3,0.02h,Break Even,$-1.50,$6.00,$233978.00,402,$6.00
2025-07-17,08:54:00,23106.5,BUY,3,0.02h,Break Even,$-1.50,$4.50,$233976.50,402,$4.50
2025-07-17,09:43:00,23115.5,SELL,3,0.02h,Stop Loss,$-9.00,$-4.50,$233967.50,402,$-4.50
2025-07-17,10:31:00,23111.5,BUY,3,0.02h,Break Even,$-1.50,$-6.00,$233966.00,402,$-6.00
2025-07-17,10:44:00,23106.0,SELL,3,0.02h,Stop Loss,$6.00,$0.00,$233972.00,402,$0.00
2025-07-17,11:27:00,23093.5,BUY,3,0.02h,Break Even,$-1.50,$-1.50,$233970.50,402,$-1.50
2025-07-17,11:32:00,23081.5,SELL,3,0.02h,Stop Loss,$12.00,$10.50,$233982.50,402,$10.50
2025-07-17,11:59:00,23086.0,BUY,3,0.02h,Break Even,$-1.50,$9.00,$233981.00,402,$9.00
2025-07-17,12:17:00,23084.0,SELL,3,0.02h,Stop Loss,$-9.00,$0.00,$233972.00,402,$0.00
2025-07-17,12:28:00,23093.25,BUY,3,0.02h,Break Even,$-1.50,$-1.50,$233970.50,402,$-1.50
2025-07-17,13:17:00,23129.5,SELL,3,0.02h,Stop Loss,$19.50,$18.00,$233990.00,402,$18.00
2025-07-17,13:44:00,23118.75,BUY,3,0.02h,Stop Loss,$22.50,$40.50,$234012.50,402,$40.50
2025-07-17,14:18:00,23145.0,SELL,3,0.02h,Stop Loss,$28.50,$69.00,$234041.00,402,$69.00
2025-07-17,14:31:00,23154.0,BUY,3,0.02h,Stop Loss,$-9.00,$60.00,$234032.00,402,$60.00
2025-07-17,15:35:00,23219.75,SELL,3,0.02h,Break Even,$-1.50,$58.50,$234030.50,402,$58.50
2025-07-17,15:37:00,23225.75,BUY,3,0.02h,Break Even,$-1.50,$57.00,$234029.00,402,$57.00
2025-07-17,16:40:00,23250.25,SELL,3,0.02h,Break Even,$-1.50,$55.50,$234027.50,402,$55.50
2025-07-17,16:49:00,23259.75,BUY,3,0.02h,Break Even,$-1.50,$54.00,$234026.00,402,$54.00
2025-07-17,16:57:00,23252.0,SELL,3,0.02h,Stop Loss,$-9.00,$45.00,$234017.00,402,$45.00
2025-07-17,17:15:00,23259.0,BUY,3,0.02h,Break Even,$-1.50,$43.50,$234015.50,402,$43.50
2025-07-17,17:28:00,23249.0,SELL,3,0.02h,Stop Loss,$30.00,$73.50,$234045.50,402,$73.50
2025-07-17,17:32:00,23260.0,BUY,3,0.02h,Break Even,$-1.50,$72.00,$234044.00,402,$72.00
2025-07-17,17:34:00,23255.0,SELL,3,0.02h,Stop Loss,$-9.00,$63.00,$234035.00,402,$63.00
2025-07-17,17:35:00,23258.0,BUY,3,0.02h,Break Even,$-1.50,$61.50,$234033.50,402,$61.50
2025-07-17,18:07:00,23256.0,SELL,3,0.02h,Stop Loss,$15.00,$76.50,$234048.50,402,$76.50
2025-07-17,18:30:00,23256.0,BUY,3,0.02h,Break Even,$-1.50,$75.00,$234047.00,402,$75.00
2025-07-17,18:37:00,23249.5,SELL,3,0.02h,Break Even,$-1.50,$73.50,$234045.50,402,$73.50
2025-07-17,18:39:00,23256.5,BUY,3,0.02h,Break Even,$-1.50,$72.00,$234044.00,402,$72.00
2025-07-17,19:00:00,23252.5,SELL,3,0.02h,Break Even,$-1.50,$70.50,$234042.50,402,$70.50
2025-07-17,19:02:00,23258.5,BUY,3,0.02h,Stop Loss,$27.00,$97.50,$234069.50,402,$97.50
2025-07-17,19:19:00,23259.5,SELL,3,0.02h,Stop Loss,$-9.00,$88.50,$234060.50,402,$88.50
2025-07-17,19:20:00,23261.75,BUY,3,0.02h,Break Even,$-1.50,$87.00,$234059.00,402,$87.00
2025-07-17,19:27:00,23259.75,SELL,3,0.02h,Stop Loss,$-9.00,$78.00,$234050.00,402,$78.00
2025-07-17,19:30:00,23261.75,BUY,3,0.02h,Stop Loss,$10.50,$88.50,$234060.50,402,$88.50
2025-07-17,19:44:00,23257.25,SELL,3,0.02h,Break Even,$-1.50,$87.00,$234059.00,402,$87.00
2025-07-17,19:54:00,23270.25,BUY,3,0.02h,Stop Loss,$27.00,$114.00,$234086.00,402,$114.00
2025-07-17,19:56:00,23256.0,SELL,3,0.02h,Stop Loss,$30.00,$144.00,$234116.00,402,$144.00
2025-07-17,20:15:00,23255.5,BUY,3,0.02h,Break Even,$-1.50,$142.50,$234114.50,402,$142.50
2025-07-17,20:52:00,23264.0,SELL,3,0.02h,Stop Loss,$-9.00,$133.50,$234105.50,402,$133.50
2025-07-17,20:57:00,23267.0,BUY,3,0.03h,Break Even,$-1.50,$132.00,$234104.00,402,$132.00
2025-07-17,21:00:00,23265.5,SELL,3,2.02h,Stop Loss,$45.00,$177.00,$234149.00,402,$177.00
2025-07-17,23:10:00,23266.0,BUY,3,0.02h,Break Even,$-1.50,$175.50,$234147.50,402,$175.50
2025-07-17,23:28:00,23267.0,SELL,3,0.02h,Stop Loss,$-9.00,$166.50,$234138.50,402,$166.50
2025-07-17,23:43:00,23269.0,BUY,3,0.02h,Break Even,$-1.50,$165.00,$234137.00,402,$165.00
,,,,,,,,,,,
2025-07-18,00:26:00,23276.0,SELL,3,0.02h,Stop Loss,$-9.00,$-9.00,$234128.00,403,$-9.00
2025-07-18,01:09:00,23270.0,BUY,3,0.02h,Stop Loss,$-9.00,$-18.00,$234119.00,403,$-18.00
2025-07-18,01:12:00,23268.0,SELL,3,0.02h,Stop Loss,$-9.00,$-27.00,$234110.00,403,$-27.00
2025-07-18,01:13:00,23270.25,BUY,3,0.02h,Stop Loss,$-9.00,$-36.00,$234101.00,403,$-36.00
2025-07-18,01:17:00,23267.0,SELL,3,0.02h,Break Even,$-1.50,$-37.50,$234099.50,403,$-37.50
2025-07-18,01:40:00,23267.75,BUY,3,0.02h,Stop Loss,$4.50,$-33.00,$234104.00,403,$-33.00
2025-07-18,01:59:00,23265.25,SELL,3,0.02h,Stop Loss,$-9.00,$-42.00,$234095.00,403,$-42.00
2025-07-18,02:16:00,23266.75,BUY,3,0.02h,Break Even,$-1.50,$-43.50,$234093.50,403,$-43.50
2025-07-18,03:11:00,23277.25,SELL,3,0.03h,Stop Loss,$-9.00,$-52.50,$234084.50,403,$-52.50
2025-07-18,03:25:00,23280.0,BUY,3,0.02h,Stop Loss,$-9.00,$-61.50,$234075.50,403,$-61.50
2025-07-18,03:26:00,23276.5,SELL,3,0.02h,Stop Loss,$-9.00,$-70.50,$234066.50,403,$-70.50
2025-07-18,03:28:00,23280.25,BUY,3,0.02h,Break Even,$-1.50,$-72.00,$234065.00,403,$-72.00
2025-07-18,03:37:00,23276.75,SELL,3,0.02h,Break Even,$-1.50,$-73.50,$234063.50,403,$-73.50
2025-07-18,03:50:00,23278.5,BUY,3,0.02h,Stop Loss,$-9.00,$-82.50,$234054.50,403,$-82.50
2025-07-18,03:51:00,23277.25,SELL,3,0.08h,Break Even,$-1.50,$-84.00,$234053.00,403,$-84.00
2025-07-18,04:27:00,23277.75,BUY,3,0.02h,Stop Loss,$-9.00,$-93.00,$234044.00,403,$-93.00
2025-07-18,04:48:00,23274.75,SELL,3,0.02h,Stop Loss,$-9.00,$-102.00,$234035.00,403,$-102.00
2025-07-18,04:59:00,23278.0,BUY,3,0.03h,Break Even,$-1.50,$-103.50,$234033.50,403,$-103.50
2025-07-18,06:04:00,23299.25,SELL,3,0.02h,Stop Loss,$-9.00,$-112.50,$234024.50,403,$-112.50
2025-07-18,06:22:00,23309.5,BUY,3,0.02h,Stop Loss,$-9.00,$-121.50,$234015.50,403,$-121.50
2025-07-18,06:29:00,23298.0,SELL,3,0.02h,Break Even,$-1.50,$-123.00,$234014.00,403,$-123.00
2025-07-18,07:08:00,23291.75,BUY,3,0.02h,Stop Loss,$-9.00,$-132.00,$234005.00,403,$-132.00
2025-07-18,07:12:00,23287.75,SELL,3,0.02h,Stop Loss,$46.50,$-85.50,$234051.50,403,$-85.50
2025-07-18,07:44:00,23279.5,BUY,3,0.02h,Stop Loss,$-9.00,$-94.50,$234042.50,403,$-94.50
2025-07-18,08:00:00,23269.25,SELL,3,0.02h,Break Even,$-1.50,$-96.00,$234041.00,403,$-96.00
2025-07-18,08:15:00,23278.0,BUY,3,0.02h,Stop Loss,$-9.00,$-105.00,$234032.00,403,$-105.00
2025-07-18,08:36:00,23277.5,SELL,3,0.02h,Break Even,$-1.50,$-106.50,$234030.50,403,$-106.50
2025-07-18,08:47:00,23280.5,BUY,3,0.02h,Break Even,$-1.50,$-108.00,$234029.00,403,$-108.00
2025-07-18,09:26:00,23282.75,SELL,3,0.02h,Break Even,$-1.50,$-109.50,$234027.50,403,$-109.50
2025-07-18,09:34:00,23285.25,BUY,3,0.03h,Break Even,$-1.50,$-111.00,$234026.00,403,$-111.00
2025-07-18,09:42:00,23277.0,SELL,3,0.02h,Stop Loss,$-9.00,$-120.00,$234017.00,403,$-120.00
2025-07-18,10:53:00,23265.25,BUY,3,0.03h,Break Even,$-1.50,$-121.50,$234015.50,403,$-121.50
2025-07-18,11:09:00,23263.25,SELL,3,0.02h,Stop Loss,$-9.00,$-130.50,$234006.50,403,$-130.50
2025-07-18,11:10:00,23266.5,BUY,3,0.02h,Stop Loss,$-9.00,$-139.50,$233997.50,403,$-139.50
2025-07-18,11:11:00,23262.75,SELL,3,0.02h,Break Even,$-1.50,$-141.00,$233996.00,403,$-141.00
2025-07-18,11:32:00,23262.75,BUY,3,0.02h,Stop Loss,$-9.00,$-150.00,$233987.00,403,$-150.00
2025-07-18,12:04:00,23262.0,SELL,3,0.02h,Stop Loss,$-9.00,$-159.00,$233978.00,403,$-159.00
2025-07-18,12:20:00,23265.25,BUY,3,0.02h,Stop Loss,$-9.00,$-168.00,$233969.00,403,$-168.00
2025-07-18,12:31:00,23259.25,SELL,3,0.02h,Break Even,$-1.50,$-169.50,$233967.50,403,$-169.50
2025-07-18,12:40:00,23267.0,BUY,3,0.02h,Stop Loss,$-9.00,$-178.50,$233958.50,403,$-178.50
2025-07-18,12:42:00,23260.0,SELL,3,0.02h,Stop Loss,$-9.00,$-187.50,$233949.50,403,$-187.50
2025-07-18,12:43:00,23264.25,BUY,3,0.02h,Stop Loss,$-9.00,$-196.50,$233940.50,403,$-196.50
2025-07-18,12:44:00,23260.25,SELL,3,0.02h,Stop Loss,$-9.00,$-205.50,$233931.50,403,$-205.50
2025-07-18,12:45:00,23265.25,BUY,3,0.02h,Stop Loss,$-9.00,$-214.50,$233922.50,403,$-214.50
2025-07-18,13:18:00,23264.5,SELL,3,0.02h,Stop Loss,$6.00,$-208.50,$233928.50,403,$-208.50
2025-07-18,13:27:00,23278.0,BUY,3,0.02h,Stop Loss,$90.00,$-118.50,$234018.50,403,$-118.50
2025-07-18,13:39:00,23261.25,SELL,3,0.02h,Stop Loss,$3.00,$-115.50,$234021.50,403,$-115.50
2025-07-18,13:48:00,23292.75,BUY,3,0.02h,Stop Loss,$9.00,$-106.50,$234030.50,403,$-106.50
2025-07-18,13:54:00,23269.25,SELL,3,0.02h,Stop Loss,$12.00,$-94.50,$234042.50,403,$-94.50
2025-07-18,14:45:00,23223.75,BUY,3,0.02h,Stop Loss,$22.50,$-72.00,$234065.00,403,$-72.00
2025-07-18,14:50:00,23209.75,SELL,3,0.02h,Break Even,$-1.50,$-73.50,$234063.50,403,$-73.50
2025-07-18,14:51:00,23215.5,BUY,3,0.02h,Stop Loss,$6.00,$-67.50,$234069.50,403,$-67.50
2025-07-18,15:00:00,23205.0,SELL,3,0.02h,Stop Loss,$31.50,$-36.00,$234101.00,403,$-36.00
2025-07-18,15:17:00,23215.75,BUY,3,0.02h,Break Even,$-1.50,$-37.50,$234099.50,403,$-37.50
2025-07-18,15:24:00,23202.25,SELL,3,0.02h,Stop Loss,$-9.00,$-46.50,$234090.50,403,$-46.50
2025-07-18,15:28:00,23213.5,BUY,3,0.02h,Stop Loss,$4.50,$-42.00,$234095.00,403,$-42.00
2025-07-18,16:08:00,23230.75,SELL,3,0.02h,Break Even,$-1.50,$-43.50,$234093.50,403,$-43.50
2025-07-18,16:46:00,23212.5,BUY,3,0.02h,Break Even,$-1.50,$-45.00,$234092.00,403,$-45.00
2025-07-18,16:49:00,23191.5,SELL,3,0.02h,Stop Loss,$-9.00,$-54.00,$234083.00,403,$-54.00
2025-07-18,16:52:00,23211.25,BUY,3,0.02h,Stop Loss,$-9.00,$-63.00,$234074.00,403,$-63.00
2025-07-18,16:54:00,23194.75,SELL,3,0.02h,Stop Loss,$-9.00,$-72.00,$234065.00,403,$-72.00
2025-07-18,17:15:00,23204.5,BUY,3,0.02h,Break Even,$-1.50,$-73.50,$234063.50,403,$-73.50
2025-07-18,17:47:00,23199.25,SELL,3,0.02h,Stop Loss,$15.00,$-58.50,$234078.50,403,$-58.50
2025-07-18,18:03:00,23213.75,BUY,3,0.02h,Stop Loss,$-9.00,$-67.50,$234069.50,403,$-67.50
2025-07-18,18:13:00,23200.0,SELL,3,0.02h,Break Even,$-1.50,$-69.00,$234068.00,403,$-69.00
2025-07-18,18:21:00,23211.0,BUY,3,0.02h,Stop Loss,$-9.00,$-78.00,$234059.00,403,$-78.00
2025-07-18,18:53:00,23210.5,SELL,3,0.02h,Stop Loss,$22.50,$-55.50,$234081.50,403,$-55.50
2025-07-18,19:13:00,23211.25,BUY,3,0.02h,Stop Loss,$-9.00,$-64.50,$234072.50,403,$-64.50
2025-07-18,19:31:00,23213.25,SELL,3,0.02h,Stop Loss,$24.00,$-40.50,$234096.50,403,$-40.50
2025-07-18,19:49:00,23213.25,BUY,3,0.02h,Break Even,$-1.50,$-42.00,$234095.00,403,$-42.00
2025-07-18,20:26:00,23219.75,SELL,3,0.02h,Break Even,$-1.50,$-43.50,$234093.50,403,$-43.50
2025-07-18,20:35:00,23225.25,BUY,3,0.03h,Break Even,$-1.50,$-45.00,$234092.00,403,$-45.00
2025-07-18,20:46:00,23221.5,SELL,3,0.02h,Break Even,$-1.50,$-46.50,$234090.50,403,$-46.50
2025-07-18,20:54:00,23224.0,BUY,3,0.02h,Stop Loss,$-9.00,$-55.50,$234081.50,403,$-55.50
,,,,,,,,,,,
2025-07-21,00:37:00,23255.0,SELL,3,0.02h,Stop Loss,$-9.00,$-9.00,$234072.50,404,$-9.00
2025-07-21,00:38:00,23257.25,BUY,3,0.02h,Stop Loss,$-9.00,$-18.00,$234063.50,404,$-18.00
2025-07-21,00:40:00,23255.0,SELL,3,0.02h,Break Even,$-1.50,$-19.50,$234062.00,404,$-19.50
2025-07-21,01:04:00,23259.5,BUY,3,0.02h,Stop Loss,$-9.00,$-28.50,$234053.00,404,$-28.50
2025-07-21,01:32:00,23265.5,SELL,3,0.02h,Break Even,$-1.50,$-30.00,$234051.50,404,$-30.00
2025-07-21,02:16:00,23266.75,BUY,3,0.02h,Break Even,$-1.50,$-31.50,$234050.00,404,$-31.50
2025-07-21,02:33:00,23263.0,SELL,3,0.02h,Stop Loss,$-9.00,$-40.50,$234041.00,404,$-40.50
2025-07-21,03:07:00,23260.75,BUY,3,0.02h,Stop Loss,$-9.00,$-49.50,$234032.00,404,$-49.50
2025-07-21,03:09:00,23258.0,SELL,3,0.02h,Break Even,$-1.50,$-51.00,$234030.50,404,$-51.00
2025-07-21,04:05:00,23249.5,BUY,3,0.02h,Stop Loss,$-9.00,$-60.00,$234021.50,404,$-60.00
2025-07-21,05:13:00,23265.5,SELL,3,0.02h,Stop Loss,$-9.00,$-69.00,$234012.50,404,$-69.00
2025-07-21,05:30:00,23270.0,BUY,3,0.02h,Stop Loss,$7.50,$-61.50,$234020.00,404,$-61.50
2025-07-21,05:49:00,23269.0,SELL,3,0.02h,Stop Loss,$-9.00,$-70.50,$234011.00,404,$-70.50
2025-07-21,05:52:00,23271.75,BUY,3,0.03h,Stop Loss,$-9.00,$-79.50,$234002.00,404,$-79.50
2025-07-21,05:54:00,23267.25,SELL,3,0.02h,Stop Loss,$-9.00,$-88.50,$233993.00,404,$-88.50
2025-07-21,06:05:00,23274.0,BUY,3,0.02h,Break Even,$-1.50,$-90.00,$233991.50,404,$-90.00
2025-07-21,06:46:00,23283.0,SELL,3,0.02h,Break Even,$-1.50,$-91.50,$233990.00,404,$-91.50
2025-07-21,07:07:00,23286.25,BUY,3,0.02h,Break Even,$-1.50,$-93.00,$233988.50,404,$-93.00
2025-07-21,07:28:00,23285.75,SELL,3,0.02h,Stop Loss,$-9.00,$-102.00,$233979.50,404,$-102.00
2025-07-21,07:37:00,23293.0,BUY,3,0.02h,Break Even,$-1.50,$-103.50,$233978.00,404,$-103.50
2025-07-21,08:16:00,23288.5,SELL,3,0.02h,Break Even,$-1.50,$-105.00,$233976.50,404,$-105.00
2025-07-21,08:58:00,23291.25,BUY,3,0.02h,Stop Loss,$-9.00,$-114.00,$233967.50,404,$-114.00
2025-07-21,09:33:00,23291.25,SELL,3,0.02h,Stop Loss,$9.00,$-105.00,$233976.50,404,$-105.00
2025-07-21,09:54:00,23292.75,BUY,3,0.02h,Stop Loss,$-9.00,$-114.00,$233967.50,404,$-114.00
2025-07-21,09:59:00,23289.5,SELL,3,0.02h,Stop Loss,$-9.00,$-123.00,$233958.50,404,$-123.00
2025-07-21,10:02:00,23292.0,BUY,3,0.02h,Stop Loss,$-9.00,$-132.00,$233949.50,404,$-132.00
2025-07-21,10:05:00,23289.0,SELL,3,0.02h,Break Even,$-1.50,$-133.50,$233948.00,404,$-133.50
2025-07-21,10:12:00,23302.75,BUY,3,0.02h,Break Even,$-1.50,$-135.00,$233946.50,404,$-135.00
2025-07-21,10:32:00,23291.0,SELL,3,0.02h,Stop Loss,$-9.00,$-144.00,$233937.50,404,$-144.00
2025-07-21,11:02:00,23291.25,BUY,3,0.02h,Stop Loss,$-9.00,$-153.00,$233928.50,404,$-153.00
2025-07-21,11:06:00,23286.75,SELL,3,0.02h,Stop Loss,$-9.00,$-162.00,$233919.50,404,$-162.00
2025-07-21,11:32:00,23284.75,BUY,3,0.02h,Stop Loss,$18.00,$-144.00,$233937.50,404,$-144.00
2025-07-21,11:39:00,23278.5,SELL,3,0.02h,Stop Loss,$-9.00,$-153.00,$233928.50,404,$-153.00
2025-07-21,12:07:00,23281.5,BUY,3,0.02h,Stop Loss,$-9.00,$-162.00,$233919.50,404,$-162.00
2025-07-21,12:08:00,23273.5,SELL,3,0.02h,Break Even,$-1.50,$-163.50,$233918.00,404,$-163.50
2025-07-21,12:27:00,23276.75,BUY,3,0.02h,Stop Loss,$-9.00,$-172.50,$233909.00,404,$-172.50
2025-07-21,12:40:00,23274.5,SELL,3,0.02h,Break Even,$-1.50,$-174.00,$233907.50,404,$-174.00
2025-07-21,13:23:00,23244.25,BUY,3,0.02h,Break Even,$-1.50,$-175.50,$233906.00,404,$-175.50
2025-07-21,14:46:00,23397.75,SELL,3,0.02h,Stop Loss,$-9.00,$-184.50,$233897.00,404,$-184.50
2025-07-21,15:27:00,23396.5,BUY,3,0.02h,Break Even,$-1.50,$-186.00,$233895.50,404,$-186.00
2025-07-21,15:56:00,23394.75,SELL,3,0.02h,Stop Loss,$25.50,$-160.50,$233921.00,404,$-160.50
2025-07-21,16:32:00,23384.5,BUY,3,0.02h,Break Even,$-1.50,$-162.00,$233919.50,404,$-162.00
2025-07-21,17:43:00,23411.75,SELL,3,0.02h,Stop Loss,$-9.00,$-171.00,$233910.50,404,$-171.00
2025-07-21,17:49:00,23417.75,BUY,3,0.02h,Break Even,$-1.50,$-172.50,$233909.00,404,$-172.50
2025-07-21,18:00:00,23411.75,SELL,3,0.02h,Stop Loss,$10.50,$-162.00,$233919.50,404,$-162.00
2025-07-21,18:24:00,23416.5,BUY,3,0.02h,Stop Loss,$-9.00,$-171.00,$233910.50,404,$-171.00
2025-07-21,18:31:00,23409.25,SELL,3,0.02h,Stop Loss,$6.00,$-165.00,$233916.50,404,$-165.00
2025-07-21,20:18:00,23352.25,BUY,3,0.02h,Break Even,$-1.50,$-166.50,$233915.00,404,$-166.50
2025-07-21,20:27:00,23343.75,SELL,3,0.02h,Break Even,$-1.50,$-168.00,$233913.50,404,$-168.00
2025-07-21,20:55:00,23346.5,BUY,3,0.02h,Stop Loss,$-9.00,$-177.00,$233904.50,404,$-177.00
2025-07-21,20:58:00,23345.0,SELL,3,0.03h,Stop Loss,$-9.00,$-186.00,$233895.50,404,$-186.00
2025-07-21,21:00:00,23346.75,BUY,3,2.00h,Stop Loss,$-9.00,$-195.00,$233886.50,404,$-195.00
2025-07-21,23:00:00,23343.75,SELL,3,0.02h,Stop Loss,$-9.00,$-204.00,$233877.50,404,$-204.00
2025-07-21,23:01:00,23347.5,BUY,3,0.02h,Stop Loss,$-9.00,$-213.00,$233868.50,404,$-213.00
2025-07-21,23:04:00,23344.0,SELL,3,0.02h,Break Even,$-1.50,$-214.50,$233867.00,404,$-214.50
2025-07-21,23:11:00,23346.0,BUY,3,0.02h,Stop Loss,$-9.00,$-223.50,$233858.00,404,$-223.50
2025-07-21,23:28:00,23344.75,SELL,3,0.02h,Stop Loss,$-9.00,$-232.50,$233849.00,404,$-232.50
2025-07-21,23:29:00,23348.5,BUY,3,0.03h,Stop Loss,$-9.00,$-241.50,$233840.00,404,$-241.50
2025-07-21,23:48:00,23340.0,SELL,3,0.02h,Stop Loss,$6.00,$-235.50,$233846.00,404,$-235.50
2025-07-21,23:59:00,23346.75,BUY,3,0.02h,Break Even,$-1.50,$-237.00,$233844.50,404,$-237.00
,,,,,,,,,,,
2025-07-22,00:39:00,23349.25,SELL,3,0.02h,Break Even,$-1.50,$-1.50,$233843.00,405,$-1.50
2025-07-22,01:13:00,23349.25,BUY,3,0.03h,Break Even,$-1.50,$-3.00,$233841.50,405,$-3.00
2025-07-22,02:08:00,23356.25,SELL,3,0.02h,Stop Loss,$-9.00,$-12.00,$233832.50,405,$-12.00
2025-07-22,05:10:00,23307.25,BUY,3,0.02h,Break Even,$-1.50,$-13.50,$233831.00,405,$-13.50
2025-07-22,05:16:00,23301.75,SELL,3,0.02h,Break Even,$-1.50,$-15.00,$233829.50,405,$-15.00
2025-07-22,05:29:00,23304.75,BUY,3,0.02h,Break Even,$-1.50,$-16.50,$233828.00,405,$-16.50
2025-07-22,06:05:00,23306.25,SELL,3,0.02h,Stop Loss,$-9.00,$-25.50,$233819.00,405,$-25.50
2025-07-22,06:10:00,23312.5,BUY,3,0.02h,Break Even,$-1.50,$-27.00,$233817.50,405,$-27.00
2025-07-22,07:00:00,23314.0,SELL,3,0.02h,Stop Loss,$3.00,$-24.00,$233820.50,405,$-24.00
2025-07-22,07:03:00,23319.25,BUY,3,0.02h,Stop Loss,$4.50,$-19.50,$233825.00,405,$-19.50
2025-07-22,07:44:00,23337.25,SELL,3,0.02h,Break Even,$-1.50,$-21.00,$233823.50,405,$-21.00
2025-07-22,09:19:00,23284.25,BUY,3,0.02h,Break Even,$-1.50,$-22.50,$233822.00,405,$-22.50
2025-07-22,09:27:00,23277.0,SELL,3,0.02h,Stop Loss,$-9.00,$-31.50,$233813.00,405,$-31.50
2025-07-22,09:50:00,23282.0,BUY,3,0.02h,Break Even,$-1.50,$-33.00,$233811.50,405,$-33.00
2025-07-22,10:24:00,23285.5,SELL,3,0.02h,Stop Loss,$-9.00,$-42.00,$233802.50,405,$-42.00
2025-07-22,10:50:00,23291.25,BUY,3,0.02h,Stop Loss,$-9.00,$-51.00,$233793.50,405,$-51.00
2025-07-22,10:55:00,23286.0,SELL,3,0.02h,Break Even,$-1.50,$-52.50,$233792.00,405,$-52.50
2025-07-22,10:57:00,23292.25,BUY,3,0.02h,Stop Loss,$9.00,$-43.50,$233801.00,405,$-43.50
2025-07-22,11:22:00,23302.0,SELL,3,0.02h,Break Even,$-1.50,$-45.00,$233799.50,405,$-45.00
2025-07-22,11:30:00,23308.0,BUY,3,0.02h,Stop Loss,$-9.00,$-54.00,$233790.50,405,$-54.00
2025-07-22,11:39:00,23302.5,SELL,3,0.02h,Break Even,$-1.50,$-55.50,$233789.00,405,$-55.50
2025-07-22,11:43:00,23318.5,BUY,3,0.02h,Stop Loss,$27.00,$-28.50,$233816.00,405,$-28.50
2025-07-22,12:18:00,23324.5,SELL,3,0.02h,Break Even,$-1.50,$-30.00,$233814.50,405,$-30.00
2025-07-22,12:27:00,23332.5,BUY,3,0.02h,Stop Loss,$-9.00,$-39.00,$233805.50,405,$-39.00
2025-07-22,12:45:00,23327.5,SELL,3,0.02h,Break Even,$-1.50,$-40.50,$233804.00,405,$-40.50
2025-07-22,12:52:00,23333.75,BUY,3,0.02h,Break Even,$-1.50,$-42.00,$233802.50,405,$-42.00
2025-07-22,13:23:00,23334.25,SELL,3,0.02h,Break Even,$-1.50,$-43.50,$233801.00,405,$-43.50
2025-07-22,13:27:00,23339.5,BUY,3,0.02h,Stop Loss,$-9.00,$-52.50,$233792.00,405,$-52.50
2025-07-22,13:28:00,23333.75,SELL,3,0.02h,Stop Loss,$-9.00,$-61.50,$233783.00,405,$-61.50
2025-07-22,13:29:00,23341.5,BUY,3,0.02h,Stop Loss,$12.00,$-49.50,$233795.00,405,$-49.50
2025-07-22,13:31:00,23319.25,SELL,3,0.02h,Stop Loss,$139.50,$90.00,$233934.50,405,$90.00
2025-07-22,14:16:00,23195.5,BUY,3,0.02h,Break Even,$-1.50,$88.50,$233933.00,405,$88.50
2025-07-22,14:25:00,23163.5,SELL,3,0.02h,Stop Loss,$-9.00,$79.50,$233924.00,405,$79.50
2025-07-22,14:32:00,23197.5,BUY,3,0.02h,Stop Loss,$-9.00,$70.50,$233915.00,405,$70.50
2025-07-22,15:16:00,23209.0,SELL,3,0.02h,Stop Loss,$48.00,$118.50,$233963.00,405,$118.50
2025-07-22,15:34:00,23223.0,BUY,3,0.02h,Stop Loss,$52.50,$171.00,$234015.50,405,$171.00
2025-07-22,15:56:00,23217.5,SELL,3,0.02h,Stop Loss,$48.00,$219.00,$234063.50,405,$219.00
2025-07-22,16:18:00,23222.75,BUY,3,0.02h,Break Even,$-1.50,$217.50,$234062.00,405,$217.50
2025-07-22,16:25:00,23202.75,SELL,3,0.02h,Stop Loss,$79.50,$297.00,$234141.50,405,$297.00
2025-07-22,16:53:00,23195.25,BUY,3,0.02h,Break Even,$-1.50,$295.50,$234140.00,405,$295.50
2025-07-22,17:44:00,23223.5,SELL,3,0.02h,Break Even,$-1.50,$294.00,$234138.50,405,$294.00
2025-07-22,18:03:00,23226.75,BUY,3,0.02h,Break Even,$-1.50,$292.50,$234137.00,405,$292.50
2025-07-22,18:07:00,23218.5,SELL,3,0.02h,Stop Loss,$-9.00,$283.50,$234128.00,405,$283.50
2025-07-22,18:08:00,23224.0,BUY,3,0.02h,Break Even,$-1.50,$282.00,$234126.50,405,$282.00
2025-07-22,18:16:00,23215.0,SELL,3,0.02h,Stop Loss,$6.00,$288.00,$234132.50,405,$288.00
2025-07-22,18:28:00,23221.75,BUY,3,0.02h,Stop Loss,$-9.00,$279.00,$234123.50,405,$279.00
2025-07-22,19:10:00,23242.0,SELL,3,0.02h,Stop Loss,$-9.00,$270.00,$234114.50,405,$270.00
2025-07-22,19:27:00,23243.5,BUY,3,0.02h,Stop Loss,$-9.00,$261.00,$234105.50,405,$261.00
2025-07-22,19:31:00,23235.75,SELL,3,0.02h,Stop Loss,$-9.00,$252.00,$234096.50,405,$252.00
2025-07-22,19:34:00,23246.0,BUY,3,0.02h,Break Even,$-1.50,$250.50,$234095.00,405,$250.50
2025-07-22,19:46:00,23240.0,SELL,3,0.02h,Stop Loss,$13.50,$264.00,$234108.50,405,$264.00
2025-07-22,20:49:00,23197.5,BUY,3,0.02h,Stop Loss,$-9.00,$255.00,$234099.50,405,$255.00
2025-07-22,20:50:00,23195.75,SELL,3,0.02h,Break Even,$-1.50,$253.50,$234098.00,405,$253.50
2025-07-22,23:14:00,23220.0,BUY,3,0.02h,Stop Loss,$99.00,$352.50,$234197.00,405,$352.50
,,,,,,,,,,,
2025-07-23,00:06:00,23234.5,SELL,3,0.02h,Break Even,$-1.50,$-1.50,$234195.50,406,$-1.50
2025-07-23,01:11:00,23213.25,BUY,3,0.02h,Stop Loss,$24.00,$22.50,$234219.50,406,$22.50
2025-07-23,02:12:00,23242.5,SELL,3,0.02h,Stop Loss,$-9.00,$13.50,$234210.50,406,$13.50
2025-07-23,02:33:00,23241.75,BUY,3,0.02h,Stop Loss,$-9.00,$4.50,$234201.50,406,$4.50
2025-07-23,02:41:00,23234.25,SELL,3,0.02h,Stop Loss,$-9.00,$-4.50,$234192.50,406,$-4.50
2025-07-23,02:46:00,23237.75,BUY,3,0.02h,Break Even,$-1.50,$-6.00,$234191.00,406,$-6.00
2025-07-23,03:35:00,23245.5,SELL,3,0.02h,Stop Loss,$37.50,$31.50,$234228.50,406,$31.50
2025-07-23,04:26:00,23239.0,BUY,3,0.08h,Break Even,$-1.50,$30.00,$234227.00,406,$30.00
2025-07-23,05:43:00,23250.25,SELL,3,0.02h,Stop Loss,$4.50,$34.50,$234231.50,406,$34.50
2025-07-23,05:48:00,23254.5,BUY,3,0.02h,Break Even,$-1.50,$33.00,$234230.00,406,$33.00
2025-07-23,05:55:00,23250.5,SELL,3,0.02h,Stop Loss,$-9.00,$24.00,$234221.00,406,$24.00
2025-07-23,06:28:00,23253.5,BUY,3,0.02h,Stop Loss,$-9.00,$15.00,$234212.00,406,$15.00
2025-07-23,07:25:00,23261.25,SELL,3,0.02h,Break Even,$-1.50,$13.50,$234210.50,406,$13.50
2025-07-23,07:54:00,23256.25,BUY,3,0.02h,Stop Loss,$-9.00,$4.50,$234201.50,406,$4.50
2025-07-23,08:36:00,23265.75,SELL,3,0.02h,Stop Loss,$-9.00,$-4.50,$234192.50,406,$-4.50
2025-07-23,08:46:00,23269.25,BUY,3,0.02h,Stop Loss,$3.00,$-1.50,$234195.50,406,$-1.50
2025-07-23,09:15:00,23272.0,SELL,3,0.02h,Stop Loss,$-9.00,$-10.50,$234186.50,406,$-10.50
2025-07-23,09:51:00,23266.0,BUY,3,0.02h,Break Even,$-1.50,$-12.00,$234185.00,406,$-12.00
2025-07-23,10:09:00,23267.0,SELL,3,0.02h,Break Even,$-1.50,$-13.50,$234183.50,406,$-13.50
2025-07-23,10:22:00,23272.0,BUY,3,0.02h,Stop Loss,$7.50,$-6.00,$234191.00,406,$-6.00
2025-07-23,10:50:00,23268.0,SELL,3,0.02h,Stop Loss,$-9.00,$-15.00,$234182.00,406,$-15.00
2025-07-23,11:38:00,23257.5,BUY,3,0.02h,Break Even,$-1.50,$-16.50,$234180.50,406,$-16.50
2025-07-23,12:12:00,23249.5,SELL,3,0.02h,Stop Loss,$-9.00,$-25.50,$234171.50,406,$-25.50
2025-07-23,13:10:00,23242.5,BUY,3,0.02h,Stop Loss,$-9.00,$-34.50,$234162.50,406,$-34.50
2025-07-23,13:16:00,23237.75,SELL,3,0.02h,Break Even,$-1.50,$-36.00,$234161.00,406,$-36.00
2025-07-23,13:19:00,23244.75,BUY,3,0.02h,Stop Loss,$-9.00,$-45.00,$234152.00,406,$-45.00
2025-07-23,13:32:00,23197.0,SELL,3,0.02h,Stop Loss,$63.00,$18.00,$234215.00,406,$18.00
2025-07-23,14:23:00,23181.75,BUY,3,0.02h,Break Even,$-1.50,$16.50,$234213.50,406,$16.50
2025-07-23,14:35:00,23151.25,SELL,3,0.02h,Break Even,$-1.50,$15.00,$234212.00,406,$15.00
2025-07-23,14:47:00,23178.0,BUY,3,0.02h,Break Even,$-1.50,$13.50,$234210.50,406,$13.50
2025-07-23,15:17:00,23192.0,SELL,3,0.02h,Break Even,$-1.50,$12.00,$234209.00,406,$12.00
2025-07-23,15:20:00,23196.75,BUY,3,0.02h,Stop Loss,$33.00,$45.00,$234242.00,406,$45.00
2025-07-23,16:15:00,23230.0,SELL,3,0.02h,Stop Loss,$-9.00,$36.00,$234233.00,406,$36.00
2025-07-23,16:44:00,23225.0,BUY,3,0.02h,Break Even,$-1.50,$34.50,$234231.50,406,$34.50
2025-07-23,17:13:00,23222.25,SELL,3,0.02h,Break Even,$-1.50,$33.00,$234230.00,406,$33.00
2025-07-23,17:24:00,23232.75,BUY,3,0.02h,Break Even,$-1.50,$31.50,$234228.50,406,$31.50
2025-07-23,18:57:00,23294.5,SELL,3,0.02h,Stop Loss,$-9.00,$22.50,$234219.50,406,$22.50
2025-07-23,18:59:00,23299.25,BUY,3,0.02h,Break Even,$-1.50,$21.00,$234218.00,406,$21.00
2025-07-23,19:05:00,23293.5,SELL,3,0.02h,Break Even,$-1.50,$19.50,$234216.50,406,$19.50
2025-07-23,19:13:00,23298.75,BUY,3,0.02h,Break Even,$-1.50,$18.00,$234215.00,406,$18.00
2025-07-23,19:14:00,23294.25,SELL,3,0.02h,Stop Loss,$7.50,$25.50,$234222.50,406,$25.50
2025-07-23,19:53:00,23295.25,BUY,3,0.02h,Stop Loss,$6.00,$31.50,$234228.50,406,$31.50
2025-07-23,23:02:00,23389.5,SELL,3,0.02h,Stop Loss,$-9.00,$22.50,$234219.50,406,$22.50
2025-07-23,23:12:00,23401.0,BUY,3,0.02h,Stop Loss,$-9.00,$13.50,$234210.50,406,$13.50
2025-07-23,23:18:00,23395.0,SELL,3,0.02h,Break Even,$-1.50,$12.00,$234209.00,406,$12.00
2025-07-23,23:38:00,23396.75,BUY,3,0.03h,Break Even,$-1.50,$10.50,$234207.50,406,$10.50
,,,,,,,,,,,
2025-07-24,00:01:00,23388.25,SELL,3,0.02h,Stop Loss,$-9.00,$-9.00,$234198.50,407,$-9.00
2025-07-24,00:17:00,23396.5,BUY,3,0.02h,Stop Loss,$10.50,$1.50,$234209.00,407,$1.50
2025-07-24,00:54:00,23398.25,SELL,3,0.02h,Break Even,$-1.50,$0.00,$234207.50,407,$0.00
2025-07-24,01:08:00,23401.5,BUY,3,0.02h,Stop Loss,$-9.00,$-9.00,$234198.50,407,$-9.00
2025-07-24,01:36:00,23408.0,SELL,3,0.02h,Stop Loss,$-9.00,$-18.00,$234189.50,407,$-18.00
2025-07-24,01:59:00,23408.25,BUY,3,0.03h,Break Even,$-1.50,$-19.50,$234188.00,407,$-19.50
2025-07-24,02:22:00,23404.0,SELL,3,0.02h,Break Even,$-1.50,$-21.00,$234186.50,407,$-21.00
2025-07-24,02:33:00,23408.75,BUY,3,0.02h,Stop Loss,$-9.00,$-30.00,$234177.50,407,$-30.00
2025-07-24,02:37:00,23407.5,SELL,3,0.03h,Stop Loss,$-9.00,$-39.00,$234168.50,407,$-39.00
2025-07-24,04:47:00,23380.5,BUY,3,0.03h,Stop Loss,$-9.00,$-48.00,$234159.50,407,$-48.00
2025-07-24,05:15:00,23379.0,SELL,3,0.02h,Stop Loss,$-9.00,$-57.00,$234150.50,407,$-57.00
2025-07-24,05:18:00,23382.0,BUY,3,0.02h,Stop Loss,$-9.00,$-66.00,$234141.50,407,$-66.00
2025-07-24,05:19:00,23380.5,SELL,3,0.03h,Stop Loss,$-9.00,$-75.00,$234132.50,407,$-75.00
2025-07-24,05:24:00,23382.5,BUY,3,0.02h,Stop Loss,$-9.00,$-84.00,$234123.50,407,$-84.00
2025-07-24,05:26:00,23380.25,SELL,3,0.02h,Break Even,$-1.50,$-85.50,$234122.00,407,$-85.50
2025-07-24,06:03:00,23383.5,BUY,3,0.02h,Stop Loss,$21.00,$-64.50,$234143.00,407,$-64.50
2025-07-24,06:23:00,23382.0,SELL,3,0.02h,Stop Loss,$7.50,$-57.00,$234150.50,407,$-57.00
2025-07-24,07:17:00,23363.0,BUY,3,0.02h,Stop Loss,$-9.00,$-66.00,$234141.50,407,$-66.00
2025-07-24,07:22:00,23355.75,SELL,3,0.02h,Stop Loss,$-9.00,$-75.00,$234132.50,407,$-75.00
2025-07-24,07:25:00,23360.0,BUY,3,0.02h,Break Even,$-1.50,$-76.50,$234131.00,407,$-76.50
2025-07-24,07:46:00,23359.75,SELL,3,0.02h,Break Even,$-1.50,$-78.00,$234129.50,407,$-78.00
2025-07-24,07:56:00,23362.0,BUY,3,0.02h,Stop Loss,$-9.00,$-87.00,$234120.50,407,$-87.00
2025-07-24,08:04:00,23353.75,SELL,3,0.02h,Stop Loss,$18.00,$-69.00,$234138.50,407,$-69.00
2025-07-24,08:12:00,23370.75,BUY,3,0.02h,Break Even,$-1.50,$-70.50,$234137.00,407,$-70.50
2025-07-24,09:20:00,23388.0,SELL,3,0.02h,Break Even,$-1.50,$-72.00,$234135.50,407,$-72.00
2025-07-24,09:31:00,23392.5,BUY,3,0.02h,Break Even,$-1.50,$-73.50,$234134.00,407,$-73.50
2025-07-24,09:47:00,23388.75,SELL,3,0.02h,Stop Loss,$-9.00,$-82.50,$234125.00,407,$-82.50
2025-07-24,09:50:00,23391.75,BUY,3,0.02h,Break Even,$-1.50,$-84.00,$234123.50,407,$-84.00
2025-07-24,10:02:00,23385.5,SELL,3,0.02h,Stop Loss,$-9.00,$-93.00,$234114.50,407,$-93.00
2025-07-24,11:01:00,23375.25,BUY,3,0.02h,Stop Loss,$-9.00,$-102.00,$234105.50,407,$-102.00
2025-07-24,11:02:00,23369.25,SELL,3,0.02h,Stop Loss,$-9.00,$-111.00,$234096.50,407,$-111.00
2025-07-24,11:03:00,23375.0,BUY,3,0.02h,Break Even,$-1.50,$-112.50,$234095.00,407,$-112.50
2025-07-24,11:52:00,23388.75,SELL,3,0.02h,Stop Loss,$-9.00,$-121.50,$234086.00,407,$-121.50
2025-07-24,12:10:00,23391.25,BUY,3,0.02h,Stop Loss,$-9.00,$-130.50,$234077.00,407,$-130.50
2025-07-24,12:13:00,23386.25,SELL,3,0.02h,Stop Loss,$-9.00,$-139.50,$234068.00,407,$-139.50
2025-07-24,12:14:00,23390.75,BUY,3,0.02h,Break Even,$-1.50,$-141.00,$234066.50,407,$-141.00
2025-07-24,12:17:00,23382.75,SELL,3,0.02h,Break Even,$-1.50,$-142.50,$234065.00,407,$-142.50
2025-07-24,13:00:00,23360.5,BUY,3,0.02h,Stop Loss,$-9.00,$-151.50,$234056.00,407,$-151.50
2025-07-24,13:12:00,23349.25,SELL,3,0.02h,Break Even,$-1.50,$-153.00,$234054.50,407,$-153.00
2025-07-24,13:14:00,23357.75,BUY,3,0.02h,Break Even,$-1.50,$-154.50,$234053.00,407,$-154.50
2025-07-24,13:17:00,23349.5,SELL,3,0.02h,Break Even,$-1.50,$-156.00,$234051.50,407,$-156.00
2025-07-24,13:18:00,23357.75,BUY,3,0.02h,Stop Loss,$-9.00,$-165.00,$234042.50,407,$-165.00
2025-07-24,13:37:00,23352.0,SELL,3,0.02h,Stop Loss,$16.50,$-148.50,$234059.00,407,$-148.50
2025-07-24,13:47:00,23373.75,BUY,3,0.02h,Stop Loss,$130.50,$-18.00,$234189.50,407,$-18.00
2025-07-24,13:57:00,23362.25,SELL,3,0.02h,Break Even,$-1.50,$-19.50,$234188.00,407,$-19.50
2025-07-24,13:58:00,23369.25,BUY,3,0.02h,Break Even,$-1.50,$-21.00,$234186.50,407,$-21.00
2025-07-24,13:59:00,23359.5,SELL,3,0.02h,Break Even,$-1.50,$-22.50,$234185.00,407,$-22.50
2025-07-24,14:32:00,23340.75,BUY,3,0.02h,Break Even,$-1.50,$-24.00,$234183.50,407,$-24.00
2025-07-24,15:33:00,23375.75,SELL,3,0.02h,Stop Loss,$9.00,$-15.00,$234192.50,407,$-15.00
2025-07-24,15:47:00,23382.0,BUY,3,0.02h,Break Even,$-1.50,$-16.50,$234191.00,407,$-16.50
2025-07-24,15:48:00,23376.5,SELL,3,0.02h,Stop Loss,$-9.00,$-25.50,$234182.00,407,$-25.50
2025-07-24,15:49:00,23387.25,BUY,3,0.02h,Stop Loss,$-9.00,$-34.50,$234173.00,407,$-34.50
2025-07-24,16:02:00,23369.75,SELL,3,0.02h,Break Even,$-1.50,$-36.00,$234171.50,407,$-36.00
2025-07-24,16:42:00,23368.25,BUY,3,0.02h,Stop Loss,$-9.00,$-45.00,$234162.50,407,$-45.00
2025-07-24,17:36:00,23397.25,SELL,3,0.02h,Break Even,$-1.50,$-46.50,$234161.00,407,$-46.50
2025-07-24,17:39:00,23398.25,BUY,3,0.02h,Stop Loss,$-9.00,$-55.50,$234152.00,407,$-55.50
2025-07-24,17:40:00,23397.0,SELL,3,0.02h,Stop Loss,$25.50,$-30.00,$234177.50,407,$-30.00
2025-07-24,17:53:00,23399.5,BUY,3,0.02h,Break Even,$-1.50,$-31.50,$234176.00,407,$-31.50
2025-07-24,17:57:00,23390.0,SELL,3,0.02h,Stop Loss,$25.50,$-6.00,$234201.50,407,$-6.00
2025-07-24,18:05:00,23398.25,BUY,3,0.02h,Stop Loss,$-9.00,$-15.00,$234192.50,407,$-15.00
2025-07-24,18:40:00,23408.5,SELL,3,0.02h,Break Even,$-1.50,$-16.50,$234191.00,407,$-16.50
2025-07-24,19:02:00,23404.0,BUY,3,0.02h,Break Even,$-1.50,$-18.00,$234189.50,407,$-18.00
2025-07-24,19:41:00,23405.0,SELL,3,0.02h,Break Even,$-1.50,$-19.50,$234188.00,407,$-19.50
2025-07-24,20:17:00,23390.25,BUY,3,0.02h,Stop Loss,$-9.00,$-28.50,$234179.00,407,$-28.50
2025-07-24,20:28:00,23386.75,SELL,3,0.02h,Break Even,$-1.50,$-30.00,$234177.50,407,$-30.00
2025-07-24,20:29:00,23390.5,BUY,3,0.02h,Break Even,$-1.50,$-31.50,$234176.00,407,$-31.50
2025-07-24,20:58:00,23393.25,SELL,3,0.02h,Stop Loss,$-9.00,$-40.50,$234167.00,407,$-40.50
2025-07-24,23:00:00,23401.25,BUY,3,0.02h,Stop Loss,$-9.00,$-49.50,$234158.00,407,$-49.50
2025-07-24,23:16:00,23395.5,SELL,3,0.02h,Break Even,$-1.50,$-51.00,$234156.50,407,$-51.00
2025-07-24,23:38:00,23400.0,BUY,3,0.02h,Break Even,$-1.50,$-52.50,$234155.00,407,$-52.50
,,,,,,,,,,,
2025-07-25,00:33:00,23413.5,SELL,3,0.02h,Stop Loss,$-9.00,$-9.00,$234146.00,408,$-9.00
2025-07-25,00:52:00,23415.5,BUY,3,0.02h,Stop Loss,$-9.00,$-18.00,$234137.00,408,$-18.00
2025-07-25,00:55:00,23409.0,SELL,3,0.02h,Stop Loss,$-9.00,$-27.00,$234128.00,408,$-27.00
2025-07-25,01:00:00,23414.5,BUY,3,0.02h,Break Even,$-1.50,$-28.50,$234126.50,408,$-28.50
2025-07-25,01:16:00,23412.5,SELL,3,0.02h,Break Even,$-1.50,$-30.00,$234125.00,408,$-30.00
2025-07-25,01:20:00,23417.5,BUY,3,0.02h,Break Even,$-1.50,$-31.50,$234123.50,408,$-31.50
2025-07-25,02:08:00,23425.25,SELL,3,0.03h,Stop Loss,$-9.00,$-40.50,$234114.50,408,$-40.50
2025-07-25,02:11:00,23429.25,BUY,3,0.02h,Stop Loss,$-9.00,$-49.50,$234105.50,408,$-49.50
2025-07-25,02:40:00,23429.0,SELL,3,0.02h,Stop Loss,$-9.00,$-58.50,$234096.50,408,$-58.50
2025-07-25,03:07:00,23428.75,BUY,3,0.02h,Break Even,$-1.50,$-60.00,$234095.00,408,$-60.00
2025-07-25,03:34:00,23430.5,SELL,3,0.03h,Break Even,$-1.50,$-61.50,$234093.50,408,$-61.50
2025-07-25,03:44:00,23432.5,BUY,3,0.03h,Stop Loss,$-9.00,$-70.50,$234084.50,408,$-70.50
2025-07-25,03:58:00,23430.25,SELL,3,0.02h,Stop Loss,$-9.00,$-79.50,$234075.50,408,$-79.50
2025-07-25,04:20:00,23431.75,BUY,3,0.02h,Stop Loss,$-9.00,$-88.50,$234066.50,408,$-88.50
2025-07-25,04:23:00,23428.75,SELL,3,0.02h,Stop Loss,$-9.00,$-97.50,$234057.50,408,$-97.50
2025-07-25,05:08:00,23404.0,BUY,3,0.02h,Stop Loss,$-9.00,$-106.50,$234048.50,408,$-106.50
2025-07-25,05:35:00,23404.25,SELL,3,0.02h,Stop Loss,$-9.00,$-115.50,$234039.50,408,$-115.50
2025-07-25,05:50:00,23408.25,BUY,3,0.02h,Stop Loss,$-9.00,$-124.50,$234030.50,408,$-124.50
2025-07-25,05:52:00,23404.5,SELL,3,0.02h,Stop Loss,$-9.00,$-133.50,$234021.50,408,$-133.50
2025-07-25,05:59:00,23407.25,BUY,3,0.02h,Stop Loss,$-9.00,$-142.50,$234012.50,408,$-142.50
2025-07-25,06:22:00,23405.5,SELL,3,0.02h,Stop Loss,$-9.00,$-151.50,$234003.50,408,$-151.50
2025-07-25,06:31:00,23411.75,BUY,3,0.02h,Stop Loss,$-9.00,$-160.50,$233994.50,408,$-160.50
2025-07-25,06:37:00,23407.0,SELL,3,0.02h,Break Even,$-1.50,$-162.00,$233993.00,408,$-162.00
2025-07-25,08:01:00,23372.5,BUY,3,0.02h,Break Even,$-1.50,$-163.50,$233991.50,408,$-163.50
2025-07-25,08:17:00,23362.0,SELL,3,0.02h,Break Even,$-1.50,$-165.00,$233990.00,408,$-165.00
2025-07-25,08:31:00,23372.75,BUY,3,0.02h,Stop Loss,$-9.00,$-174.00,$233981.00,408,$-174.00
2025-07-25,09:01:00,23373.0,SELL,3,0.02h,Break Even,$-1.50,$-175.50,$233979.50,408,$-175.50
2025-07-25,09:30:00,23369.5,BUY,3,0.02h,Stop Loss,$-9.00,$-184.50,$233970.50,408,$-184.50
2025-07-25,09:50:00,23367.75,SELL,3,0.02h,Stop Loss,$-9.00,$-193.50,$233961.50,408,$-193.50
2025-07-25,09:59:00,23373.5,BUY,3,0.03h,Stop Loss,$-9.00,$-202.50,$233952.50,408,$-202.50
2025-07-25,10:23:00,23371.25,SELL,3,0.02h,Stop Loss,$-9.00,$-211.50,$233943.50,408,$-211.50
2025-07-25,10:26:00,23378.25,BUY,3,0.02h,Stop Loss,$-9.00,$-220.50,$233934.50,408,$-220.50
2025-07-25,11:03:00,23382.5,SELL,3,0.02h,Break Even,$-1.50,$-222.00,$233933.00,408,$-222.00
2025-07-25,11:42:00,23376.5,BUY,3,0.02h,Break Even,$-1.50,$-223.50,$233931.50,408,$-223.50
2025-07-25,11:48:00,23374.5,SELL,3,0.02h,Break Even,$-1.50,$-225.00,$233930.00,408,$-225.00
2025-07-25,12:19:00,23370.5,BUY,3,0.02h,Stop Loss,$-9.00,$-234.00,$233921.00,408,$-234.00
2025-07-25,12:44:00,23371.5,SELL,3,0.02h,Break Even,$-1.50,$-235.50,$233919.50,408,$-235.50
2025-07-25,13:21:00,23369.5,BUY,3,0.02h,Break Even,$-1.50,$-237.00,$233918.00,408,$-237.00
2025-07-25,13:30:00,23360.25,SELL,3,0.02h,Stop Loss,$73.50,$-163.50,$233991.50,408,$-163.50
2025-07-25,13:36:00,23374.75,BUY,3,0.02h,Break Even,$-1.50,$-165.00,$233990.00,408,$-165.00
2025-07-25,13:37:00,23362.25,SELL,3,0.02h,Stop Loss,$117.00,$-48.00,$234107.00,408,$-48.00
2025-07-25,13:47:00,23368.75,BUY,3,0.02h,Stop Loss,$33.00,$-15.00,$234140.00,408,$-15.00
2025-07-25,14:56:00,23401.0,SELL,3,0.02h,Stop Loss,$43.50,$28.50,$234183.50,408,$28.50
2025-07-25,15:13:00,23407.0,BUY,3,0.02h,Break Even,$-1.50,$27.00,$234182.00,408,$27.00
2025-07-25,15:40:00,23408.25,SELL,3,0.02h,Stop Loss,$-9.00,$18.00,$234173.00,408,$18.00
2025-07-25,15:50:00,23415.75,BUY,3,0.02h,Stop Loss,$28.50,$46.50,$234201.50,408,$46.50
2025-07-25,16:47:00,23450.25,SELL,3,0.02h,Stop Loss,$-9.00,$37.50,$234192.50,408,$37.50
2025-07-25,16:55:00,23458.75,BUY,3,0.02h,Stop Loss,$-9.00,$28.50,$234183.50,408,$28.50
2025-07-25,17:00:00,23450.25,SELL,3,0.02h,Stop Loss,$6.00,$34.50,$234189.50,408,$34.50
2025-07-25,17:28:00,23449.0,BUY,3,0.02h,Stop Loss,$6.00,$40.50,$234195.50,408,$40.50
2025-07-25,17:44:00,23444.75,SELL,3,0.02h,Stop Loss,$-9.00,$31.50,$234186.50,408,$31.50
2025-07-25,18:15:00,23445.25,BUY,3,0.02h,Stop Loss,$12.00,$43.50,$234198.50,408,$43.50
2025-07-25,18:53:00,23447.0,SELL,3,0.02h,Stop Loss,$-9.00,$34.50,$234189.50,408,$34.50
2025-07-25,19:15:00,23447.25,BUY,3,0.02h,Stop Loss,$4.50,$39.00,$234194.00,408,$39.00
2025-07-25,19:27:00,23444.25,SELL,3,0.02h,Break Even,$-1.50,$37.50,$234192.50,408,$37.50
2025-07-25,19:39:00,23449.0,BUY,3,0.02h,Stop Loss,$-9.00,$28.50,$234183.50,408,$28.50
2025-07-25,19:42:00,23443.75,SELL,3,0.02h,Break Even,$-1.50,$27.00,$234182.00,408,$27.00
2025-07-25,20:15:00,23434.5,BUY,3,0.02h,Break Even,$-1.50,$25.50,$234180.50,408,$25.50
,,,,,,,,,,,
2025-07-28,01:03:00,23539.5,SELL,3,0.02h,Stop Loss,$-9.00,$-9.00,$234171.50,409,$-9.00
2025-07-28,01:30:00,23538.75,BUY,3,0.02h,Stop Loss,$-9.00,$-18.00,$234162.50,409,$-18.00
2025-07-28,01:52:00,23536.5,SELL,3,0.03h,Break Even,$-1.50,$-19.50,$234161.00,409,$-19.50
2025-07-28,01:58:00,23541.0,BUY,3,0.02h,Break Even,$-1.50,$-21.00,$234159.50,409,$-21.00
2025-07-28,02:51:00,23552.25,SELL,3,0.02h,Break Even,$-1.50,$-22.50,$234158.00,409,$-22.50
2025-07-28,03:41:00,23550.0,BUY,3,0.02h,Stop Loss,$-9.00,$-31.50,$234149.00,409,$-31.50
2025-07-28,04:06:00,23547.25,SELL,3,0.02h,Stop Loss,$-9.00,$-40.50,$234140.00,409,$-40.50
2025-07-28,04:23:00,23549.25,BUY,3,0.18h,Stop Loss,$15.00,$-25.50,$234155.00,409,$-25.50
2025-07-28,06:25:00,23575.25,SELL,3,0.02h,Stop Loss,$-9.00,$-34.50,$234146.00,409,$-34.50
2025-07-28,07:53:00,23546.0,BUY,3,0.02h,Stop Loss,$-9.00,$-43.50,$234137.00,409,$-43.50
2025-07-28,08:06:00,23539.25,SELL,3,0.02h,Break Even,$-1.50,$-45.00,$234135.50,409,$-45.00
2025-07-28,08:23:00,23545.5,BUY,3,0.02h,Stop Loss,$-9.00,$-54.00,$234126.50,409,$-54.00
2025-07-28,08:28:00,23536.25,SELL,3,0.02h,Break Even,$-1.50,$-55.50,$234125.00,409,$-55.50
2025-07-28,08:39:00,23542.75,BUY,3,0.02h,Stop Loss,$-9.00,$-64.50,$234116.00,409,$-64.50
2025-07-28,08:49:00,23538.25,SELL,3,0.02h,Break Even,$-1.50,$-66.00,$234114.50,409,$-66.00
2025-07-28,08:51:00,23541.0,BUY,3,0.02h,Stop Loss,$-9.00,$-75.00,$234105.50,409,$-75.00
2025-07-28,08:53:00,23539.0,SELL,3,0.02h,Break Even,$-1.50,$-76.50,$234104.00,409,$-76.50
2025-07-28,09:07:00,23539.75,BUY,3,0.02h,Break Even,$-1.50,$-78.00,$234102.50,409,$-78.00
2025-07-28,09:15:00,23537.75,SELL,3,0.02h,Stop Loss,$-9.00,$-87.00,$234093.50,409,$-87.00
2025-07-28,09:17:00,23541.25,BUY,3,0.02h,Stop Loss,$-9.00,$-96.00,$234084.50,409,$-96.00
2025-07-28,09:25:00,23526.5,SELL,3,0.02h,Stop Loss,$-9.00,$-105.00,$234075.50,409,$-105.00
2025-07-28,11:09:00,23500.75,BUY,3,0.02h,Stop Loss,$-9.00,$-114.00,$234066.50,409,$-114.00
2025-07-28,11:19:00,23495.0,SELL,3,0.02h,Stop Loss,$-9.00,$-123.00,$234057.50,409,$-123.00
2025-07-28,11:22:00,23502.75,BUY,3,0.02h,Stop Loss,$-9.00,$-132.00,$234048.50,409,$-132.00
2025-07-28,11:32:00,23499.5,SELL,3,0.02h,Break Even,$-1.50,$-133.50,$234047.00,409,$-133.50
2025-07-28,11:35:00,23502.75,BUY,3,0.02h,Stop Loss,$-9.00,$-142.50,$234038.00,409,$-142.50
2025-07-28,11:47:00,23499.0,SELL,3,0.02h,Stop Loss,$-9.00,$-151.50,$234029.00,409,$-151.50
2025-07-28,11:51:00,23505.5,BUY,3,0.02h,Stop Loss,$-9.00,$-160.50,$234020.00,409,$-160.50
2025-07-28,12:01:00,23497.25,SELL,3,0.02h,Stop Loss,$-9.00,$-169.50,$234011.00,409,$-169.50
2025-07-28,12:25:00,23504.5,BUY,3,0.02h,Break Even,$-1.50,$-171.00,$234009.50,409,$-171.00
2025-07-28,13:04:00,23502.5,SELL,3,0.02h,Stop Loss,$16.50,$-154.50,$234026.00,409,$-154.50
2025-07-28,13:35:00,23494.0,BUY,3,0.02h,Stop Loss,$15.00,$-139.50,$234041.00,409,$-139.50
2025-07-28,14:21:00,23507.5,SELL,3,0.02h,Stop Loss,$226.50,$87.00,$234267.50,409,$87.00
2025-07-28,14:42:00,23517.0,BUY,3,0.02h,Break Even,$-1.50,$85.50,$234266.00,409,$85.50
2025-07-28,14:47:00,23500.5,SELL,3,0.02h,Break Even,$-1.50,$84.00,$234264.50,409,$84.00
2025-07-28,15:33:00,23482.0,BUY,3,0.02h,Break Even,$-1.50,$82.50,$234263.00,409,$82.50
2025-07-28,16:05:00,23488.0,SELL,3,0.02h,Break Even,$-1.50,$81.00,$234261.50,409,$81.00
2025-07-28,16:18:00,23498.75,BUY,3,0.02h,Stop Loss,$3.00,$84.00,$234264.50,409,$84.00
2025-07-28,16:32:00,23485.25,SELL,3,0.02h,Break Even,$-1.50,$82.50,$234263.00,409,$82.50
2025-07-28,17:15:00,23484.75,BUY,3,0.02h,Stop Loss,$-9.00,$73.50,$234254.00,409,$73.50
2025-07-28,17:16:00,23478.25,SELL,3,0.02h,Stop Loss,$-9.00,$64.50,$234245.00,409,$64.50
2025-07-28,17:33:00,23481.5,BUY,3,0.02h,Break Even,$-1.50,$63.00,$234243.50,409,$63.00
2025-07-28,17:52:00,23469.5,SELL,3,0.02h,Stop Loss,$-9.00,$54.00,$234234.50,409,$54.00
2025-07-28,18:18:00,23469.5,BUY,3,0.02h,Break Even,$-1.50,$52.50,$234233.00,409,$52.50
2025-07-28,18:22:00,23455.75,SELL,3,0.02h,Break Even,$-1.50,$51.00,$234231.50,409,$51.00
2025-07-28,18:48:00,23459.25,BUY,3,0.02h,Break Even,$-1.50,$49.50,$234230.00,409,$49.50
2025-07-28,19:06:00,23454.75,SELL,3,0.02h,Break Even,$-1.50,$48.00,$234228.50,409,$48.00
2025-07-28,19:22:00,23463.0,BUY,3,0.02h,Break Even,$-1.50,$46.50,$234227.00,409,$46.50
,,,,,,,,,,,
2025-07-29,00:01:00,23521.75,SELL,3,0.03h,Stop Loss,$3.00,$3.00,$234230.00,410,$3.00
2025-07-29,00:09:00,23526.5,BUY,3,0.02h,Stop Loss,$-9.00,$-6.00,$234221.00,410,$-6.00
2025-07-29,00:12:00,23524.25,SELL,3,0.02h,Stop Loss,$6.00,$0.00,$234227.00,410,$0.00
2025-07-29,00:22:00,23526.75,BUY,3,0.02h,Break Even,$-1.50,$-1.50,$234225.50,410,$-1.50
2025-07-29,00:55:00,23531.0,SELL,3,0.02h,Stop Loss,$-9.00,$-10.50,$234216.50,410,$-10.50
2025-07-29,01:00:00,23533.5,BUY,3,0.02h,Stop Loss,$-9.00,$-19.50,$234207.50,410,$-19.50
2025-07-29,01:39:00,23538.5,SELL,3,0.02h,Break Even,$-1.50,$-21.00,$234206.00,410,$-21.00
2025-07-29,02:11:00,23535.75,BUY,3,0.02h,Break Even,$-1.50,$-22.50,$234204.50,410,$-22.50
2025-07-29,02:20:00,23531.25,SELL,3,0.02h,Stop Loss,$-9.00,$-31.50,$234195.50,410,$-31.50
2025-07-29,02:48:00,23534.25,BUY,3,0.02h,Stop Loss,$-9.00,$-40.50,$234186.50,410,$-40.50
2025-07-29,03:25:00,23537.0,SELL,3,0.02h,Stop Loss,$-9.00,$-49.50,$234177.50,410,$-49.50
2025-07-29,03:47:00,23540.25,BUY,3,0.07h,Stop Loss,$-9.00,$-58.50,$234168.50,410,$-58.50
2025-07-29,04:23:00,23544.25,SELL,3,0.03h,Break Even,$-1.50,$-60.00,$234167.00,410,$-60.00
2025-07-29,04:32:00,23547.25,BUY,3,0.02h,Break Even,$-1.50,$-61.50,$234165.50,410,$-61.50
2025-07-29,04:41:00,23545.25,SELL,3,0.03h,Break Even,$-1.50,$-63.00,$234164.00,410,$-63.00
2025-07-29,05:04:00,23544.75,BUY,3,0.02h,Break Even,$-1.50,$-64.50,$234162.50,410,$-64.50
2025-07-29,05:28:00,23544.0,SELL,3,0.03h,Stop Loss,$-9.00,$-73.50,$234153.50,410,$-73.50
2025-07-29,05:32:00,23547.25,BUY,3,0.03h,Stop Loss,$-9.00,$-82.50,$234144.50,410,$-82.50
2025-07-29,06:12:00,23548.75,SELL,3,0.05h,Stop Loss,$-9.00,$-91.50,$234135.50,410,$-91.50
2025-07-29,06:21:00,23551.0,BUY,3,0.03h,Break Even,$-1.50,$-93.00,$234134.00,410,$-93.00
2025-07-29,06:29:00,23546.0,SELL,3,0.02h,Break Even,$-1.50,$-94.50,$234132.50,410,$-94.50
2025-07-29,06:38:00,23554.0,BUY,3,0.02h,Stop Loss,$-9.00,$-103.50,$234123.50,410,$-103.50
2025-07-29,06:50:00,23549.25,SELL,3,0.02h,Stop Loss,$-9.00,$-112.50,$234114.50,410,$-112.50
2025-07-29,06:51:00,23551.75,BUY,3,0.02h,Break Even,$-1.50,$-114.00,$234113.00,410,$-114.00
2025-07-29,06:58:00,23548.0,SELL,3,0.02h,Stop Loss,$10.50,$-103.50,$234123.50,410,$-103.50
2025-07-29,07:06:00,23551.5,BUY,3,0.03h,Break Even,$-1.50,$-105.00,$234122.00,410,$-105.00
2025-07-29,07:09:00,23546.5,SELL,3,0.02h,Stop Loss,$-9.00,$-114.00,$234113.00,410,$-114.00
2025-07-29,07:12:00,23550.5,BUY,3,0.02h,Stop Loss,$3.00,$-111.00,$234116.00,410,$-111.00
2025-07-29,08:31:00,23584.25,SELL,3,0.02h,Stop Loss,$-9.00,$-120.00,$234107.00,410,$-120.00
2025-07-29,08:34:00,23590.25,BUY,3,0.02h,Stop Loss,$-9.00,$-129.00,$234098.00,410,$-129.00
2025-07-29,08:37:00,23585.5,SELL,3,0.02h,Stop Loss,$-9.00,$-138.00,$234089.00,410,$-138.00
2025-07-29,09:05:00,23584.75,BUY,3,0.02h,Break Even,$-1.50,$-139.50,$234087.50,410,$-139.50
2025-07-29,09:20:00,23584.5,SELL,3,0.02h,Stop Loss,$4.50,$-135.00,$234092.00,410,$-135.00
2025-07-29,09:35:00,23587.25,BUY,3,0.02h,Stop Loss,$-9.00,$-144.00,$234083.00,410,$-144.00
2025-07-29,10:18:00,23594.75,SELL,3,0.02h,Stop Loss,$-9.00,$-153.00,$234074.00,410,$-153.00
2025-07-29,10:35:00,23598.75,BUY,3,0.02h,Stop Loss,$-9.00,$-162.00,$234065.00,410,$-162.00
2025-07-29,10:59:00,23598.5,SELL,3,0.02h,Stop Loss,$-9.00,$-171.00,$234056.00,410,$-171.00
2025-07-29,11:01:00,23604.25,BUY,3,0.02h,Break Even,$-1.50,$-172.50,$234054.50,410,$-172.50
2025-07-29,11:05:00,23598.75,SELL,3,0.03h,Break Even,$-1.50,$-174.00,$234053.00,410,$-174.00
2025-07-29,11:52:00,23592.0,BUY,3,0.02h,Break Even,$-1.50,$-175.50,$234051.50,410,$-175.50
2025-07-29,12:18:00,23598.25,SELL,3,0.02h,Stop Loss,$-9.00,$-184.50,$234042.50,410,$-184.50
2025-07-29,13:20:00,23587.0,BUY,3,0.02h,Stop Loss,$-9.00,$-193.50,$234033.50,410,$-193.50
2025-07-29,13:49:00,23606.0,SELL,3,0.02h,Stop Loss,$162.00,$-31.50,$234195.50,410,$-31.50
2025-07-29,14:41:00,23573.75,BUY,3,0.02h,Break Even,$-1.50,$-33.00,$234194.00,410,$-33.00
2025-07-29,14:45:00,23554.25,SELL,3,0.02h,Break Even,$-1.50,$-34.50,$234192.50,410,$-34.50
2025-07-29,15:50:00,23498.0,BUY,3,0.02h,Stop Loss,$34.50,$0.00,$234227.00,410,$0.00
2025-07-29,16:10:00,23489.25,SELL,3,0.02h,Break Even,$-1.50,$-1.50,$234225.50,410,$-1.50
2025-07-29,16:48:00,23482.25,BUY,3,0.02h,Break Even,$-1.50,$-3.00,$234224.00,410,$-3.00
2025-07-29,17:33:00,23506.0,SELL,3,0.02h,Stop Loss,$7.50,$4.50,$234231.50,410,$4.50
2025-07-29,17:59:00,23494.5,BUY,3,0.02h,Stop Loss,$-9.00,$-4.50,$234222.50,410,$-4.50
2025-07-29,18:21:00,23481.5,SELL,3,0.02h,Stop Loss,$-9.00,$-13.50,$234213.50,410,$-13.50
2025-07-29,18:34:00,23491.0,BUY,3,0.02h,Break Even,$-1.50,$-15.00,$234212.00,410,$-15.00
2025-07-29,18:50:00,23486.25,SELL,3,0.02h,Break Even,$-1.50,$-16.50,$234210.50,410,$-16.50
2025-07-29,19:54:00,23460.25,BUY,3,0.02h,Break Even,$-1.50,$-18.00,$234209.00,410,$-18.00
2025-07-29,19:57:00,23439.0,SELL,3,0.02h,Stop Loss,$6.00,$-12.00,$234215.00,410,$-12.00
2025-07-29,20:02:00,23457.5,BUY,3,0.02h,Break Even,$-1.50,$-13.50,$234213.50,410,$-13.50
2025-07-29,20:24:00,23447.75,SELL,3,0.02h,Stop Loss,$-9.00,$-22.50,$234204.50,410,$-22.50
2025-07-29,20:29:00,23455.25,BUY,3,0.02h,Stop Loss,$-9.00,$-31.50,$234195.50,410,$-31.50
2025-07-29,20:44:00,23450.5,SELL,3,0.02h,Break Even,$-1.50,$-33.00,$234194.00,410,$-33.00
2025-07-29,23:00:00,23471.0,BUY,3,0.02h,Break Even,$-1.50,$-34.50,$234192.50,410,$-34.50
2025-07-29,23:47:00,23468.75,SELL,3,0.02h,Stop Loss,$-9.00,$-43.50,$234183.50,410,$-43.50
,,,,,,,,,,,
2025-07-30,00:01:00,23477.0,BUY,3,0.02h,Stop Loss,$-9.00,$-9.00,$234174.50,411,$-9.00
2025-07-30,01:07:00,23483.25,SELL,3,0.02h,Stop Loss,$-9.00,$-18.00,$234165.50,411,$-18.00
2025-07-30,01:36:00,23485.0,BUY,3,0.02h,Stop Loss,$22.50,$4.50,$234188.00,411,$4.50
2025-07-30,02:28:00,23488.0,SELL,3,0.03h,Break Even,$-1.50,$3.00,$234186.50,411,$3.00
2025-07-30,02:46:00,23489.0,BUY,3,0.02h,Break Even,$-1.50,$1.50,$234185.00,411,$1.50
2025-07-30,03:19:00,23494.5,SELL,3,0.02h,Stop Loss,$-9.00,$-7.50,$234176.00,411,$-7.50
2025-07-30,03:21:00,23498.75,BUY,3,0.02h,Break Even,$-1.50,$-9.00,$234174.50,411,$-9.00
2025-07-30,03:29:00,23495.25,SELL,3,0.03h,Stop Loss,$-9.00,$-18.00,$234165.50,411,$-18.00
2025-07-30,03:35:00,23498.5,BUY,3,0.05h,Stop Loss,$4.50,$-13.50,$234170.00,411,$-13.50
2025-07-30,03:51:00,23497.25,SELL,3,0.02h,Stop Loss,$-9.00,$-22.50,$234161.00,411,$-22.50
2025-07-30,04:03:00,23499.5,BUY,3,0.02h,Break Even,$-1.50,$-24.00,$234159.50,411,$-24.00
2025-07-30,04:35:00,23500.25,SELL,3,0.02h,Stop Loss,$-9.00,$-33.00,$234150.50,411,$-33.00
2025-07-30,04:53:00,23502.0,BUY,3,0.05h,Break Even,$-1.50,$-34.50,$234149.00,411,$-34.50
2025-07-30,05:04:00,23500.75,SELL,3,0.02h,Stop Loss,$-9.00,$-43.50,$234140.00,411,$-43.50
2025-07-30,05:24:00,23499.75,BUY,3,0.02h,Break Even,$-1.50,$-45.00,$234138.50,411,$-45.00
2025-07-30,06:01:00,23503.25,SELL,3,0.02h,Break Even,$-1.50,$-46.50,$234137.00,411,$-46.50
2025-07-30,06:26:00,23505.5,BUY,3,0.02h,Break Even,$-1.50,$-48.00,$234135.50,411,$-48.00
2025-07-30,06:38:00,23502.25,SELL,3,0.02h,Stop Loss,$-9.00,$-57.00,$234126.50,411,$-57.00
2025-07-30,06:41:00,23506.75,BUY,3,0.02h,Stop Loss,$-9.00,$-66.00,$234117.50,411,$-66.00
2025-07-30,06:49:00,23504.0,SELL,3,0.02h,Break Even,$-1.50,$-67.50,$234116.00,411,$-67.50
2025-07-30,07:30:00,23492.25,BUY,3,0.02h,Break Even,$-1.50,$-69.00,$234114.50,411,$-69.00
2025-07-30,08:12:00,23498.5,SELL,3,0.02h,Break Even,$-1.50,$-70.50,$234113.00,411,$-70.50
2025-07-30,08:47:00,23485.5,BUY,3,0.02h,Break Even,$-1.50,$-72.00,$234111.50,411,$-72.00
2025-07-30,08:51:00,23478.0,SELL,3,0.02h,Stop Loss,$-9.00,$-81.00,$234102.50,411,$-81.00
2025-07-30,09:01:00,23487.25,BUY,3,0.03h,Stop Loss,$-9.00,$-90.00,$234093.50,411,$-90.00
2025-07-30,09:29:00,23489.0,SELL,3,0.03h,Break Even,$-1.50,$-91.50,$234092.00,411,$-91.50
2025-07-30,09:57:00,23489.75,BUY,3,0.02h,Break Even,$-1.50,$-93.00,$234090.50,411,$-93.00
2025-07-30,11:16:00,23501.5,SELL,3,0.02h,Stop Loss,$-9.00,$-102.00,$234081.50,411,$-102.00
2025-07-30,11:27:00,23507.5,BUY,3,0.02h,Stop Loss,$21.00,$-81.00,$234102.50,411,$-81.00
2025-07-30,11:56:00,23510.75,SELL,3,0.02h,Break Even,$-1.50,$-82.50,$234101.00,411,$-82.50
2025-07-30,12:40:00,23498.25,BUY,3,0.02h,Stop Loss,$7.50,$-75.00,$234108.50,411,$-75.00
2025-07-30,13:01:00,23485.5,SELL,3,0.02h,Break Even,$-1.50,$-76.50,$234107.00,411,$-76.50
2025-07-30,13:20:00,23486.75,BUY,3,0.02h,Break Even,$-1.50,$-78.00,$234105.50,411,$-78.00
2025-07-30,13:24:00,23483.5,SELL,3,0.02h,Stop Loss,$-9.00,$-87.00,$234096.50,411,$-87.00
2025-07-30,13:37:00,23496.0,BUY,3,0.02h,Stop Loss,$42.00,$-45.00,$234138.50,411,$-45.00
2025-07-30,13:53:00,23486.5,SELL,3,0.02h,Stop Loss,$12.00,$-33.00,$234150.50,411,$-33.00
2025-07-30,14:09:00,23495.25,BUY,3,0.02h,Stop Loss,$-9.00,$-42.00,$234141.50,411,$-42.00
2025-07-30,14:11:00,23477.5,SELL,3,0.02h,Stop Loss,$34.50,$-7.50,$234176.00,411,$-7.50
2025-07-30,14:19:00,23490.0,BUY,3,0.02h,Stop Loss,$45.00,$37.50,$234221.00,411,$37.50
2025-07-30,15:03:00,23517.25,SELL,3,0.02h,Stop Loss,$55.50,$93.00,$234276.50,411,$93.00
2025-07-30,15:42:00,23501.0,BUY,3,0.02h,Stop Loss,$-9.00,$84.00,$234267.50,411,$84.00
2025-07-30,16:37:00,23530.0,SELL,3,0.02h,Break Even,$-1.50,$82.50,$234266.00,411,$82.50
2025-07-30,16:53:00,23535.75,BUY,3,0.02h,Stop Loss,$-9.00,$73.50,$234257.00,411,$73.50
2025-07-30,17:11:00,23528.0,SELL,3,0.02h,Stop Loss,$-9.00,$64.50,$234248.00,411,$64.50
2025-07-30,17:17:00,23535.25,BUY,3,0.02h,Stop Loss,$-9.00,$55.50,$234239.00,411,$55.50
2025-07-30,17:24:00,23526.0,SELL,3,0.02h,Stop Loss,$-9.00,$46.50,$234230.00,411,$46.50
2025-07-30,17:36:00,23533.75,BUY,3,0.02h,Stop Loss,$-9.00,$37.50,$234221.00,411,$37.50
2025-07-30,17:52:00,23529.5,SELL,3,0.02h,Break Even,$-1.50,$36.00,$234219.50,411,$36.00
2025-07-30,17:57:00,23543.5,BUY,3,0.02h,Break Even,$-1.50,$34.50,$234218.00,411,$34.50
2025-07-30,18:03:00,23522.25,SELL,3,0.02h,Break Even,$-1.50,$33.00,$234216.50,411,$33.00
2025-07-30,18:08:00,23544.75,BUY,3,0.02h,Break Even,$-1.50,$31.50,$234215.00,411,$31.50
2025-07-30,18:20:00,23537.0,SELL,3,0.02h,Break Even,$-1.50,$30.00,$234213.50,411,$30.00
2025-07-30,18:24:00,23545.5,BUY,3,0.02h,Break Even,$-1.50,$28.50,$234212.00,411,$28.50
2025-07-30,18:41:00,23530.25,SELL,3,0.02h,Stop Loss,$78.00,$106.50,$234290.00,411,$106.50
2025-07-30,19:47:00,23427.75,BUY,3,0.02h,Break Even,$-1.50,$105.00,$234288.50,411,$105.00
2025-07-30,23:57:00,23729.75,SELL,3,0.02h,Break Even,$-1.50,$103.50,$234287.00,411,$103.50
,,,,,,,,,,,
2025-07-31,00:19:00,23737.25,BUY,3,0.02h,Break Even,$-1.50,$-1.50,$234285.50,412,$-1.50
2025-07-31,03:05:00,23782.0,SELL,3,0.02h,Break Even,$-1.50,$-3.00,$234284.00,412,$-3.00
2025-07-31,03:16:00,23784.75,BUY,3,0.02h,Stop Loss,$-9.00,$-12.00,$234275.00,412,$-12.00
2025-07-31,03:28:00,23782.25,SELL,3,0.02h,Stop Loss,$-9.00,$-21.00,$234266.00,412,$-21.00
2025-07-31,03:35:00,23785.75,BUY,3,0.02h,Stop Loss,$-9.00,$-30.00,$234257.00,412,$-30.00
2025-07-31,04:17:00,23793.0,SELL,3,0.02h,Stop Loss,$-9.00,$-39.00,$234248.00,412,$-39.00
2025-07-31,04:23:00,23799.75,BUY,3,0.02h,Stop Loss,$-9.00,$-48.00,$234239.00,412,$-48.00
2025-07-31,04:30:00,23788.0,SELL,3,0.02h,Stop Loss,$18.00,$-30.00,$234257.00,412,$-30.00
2025-07-31,04:36:00,23798.5,BUY,3,0.02h,Stop Loss,$7.50,$-22.50,$234264.50,412,$-22.50
2025-07-31,05:09:00,23800.75,SELL,3,0.02h,Stop Loss,$-9.00,$-31.50,$234255.50,412,$-31.50
2025-07-31,05:52:00,23797.0,BUY,3,0.02h,Break Even,$-1.50,$-33.00,$234254.00,412,$-33.00
2025-07-31,06:09:00,23795.0,SELL,3,0.03h,Break Even,$-1.50,$-34.50,$234252.50,412,$-34.50
2025-07-31,06:44:00,23790.5,BUY,3,0.02h,Break Even,$-1.50,$-36.00,$234251.00,412,$-36.00
2025-07-31,07:06:00,23788.0,SELL,3,0.02h,Break Even,$-1.50,$-37.50,$234249.50,412,$-37.50
2025-07-31,07:13:00,23793.0,BUY,3,0.02h,Break Even,$-1.50,$-39.00,$234248.00,412,$-39.00
2025-07-31,07:16:00,23789.0,SELL,3,0.02h,Break Even,$-1.50,$-40.50,$234246.50,412,$-40.50
2025-07-31,07:24:00,23795.0,BUY,3,0.02h,Stop Loss,$9.00,$-31.50,$234255.50,412,$-31.50
2025-07-31,08:03:00,23816.75,SELL,3,0.02h,Stop Loss,$39.00,$7.50,$234294.50,412,$7.50
2025-07-31,08:35:00,23814.0,BUY,3,0.02h,Break Even,$-1.50,$6.00,$234293.00,412,$6.00
2025-07-31,08:43:00,23806.25,SELL,3,0.02h,Stop Loss,$4.50,$10.50,$234297.50,412,$10.50
2025-07-31,08:49:00,23814.25,BUY,3,0.02h,Break Even,$-1.50,$9.00,$234296.00,412,$9.00
2025-07-31,08:55:00,23797.25,SELL,3,0.02h,Break Even,$-1.50,$7.50,$234294.50,412,$7.50
2025-07-31,09:21:00,23802.75,BUY,3,0.02h,Stop Loss,$-9.00,$-1.50,$234285.50,412,$-1.50
2025-07-31,09:31:00,23796.25,SELL,3,0.02h,Stop Loss,$15.00,$13.50,$234300.50,412,$13.50
2025-07-31,10:16:00,23791.5,BUY,3,0.02h,Break Even,$-1.50,$12.00,$234299.00,412,$12.00
2025-07-31,10:54:00,23789.0,SELL,3,0.02h,Break Even,$-1.50,$10.50,$234297.50,412,$10.50
2025-07-31,11:06:00,23796.75,BUY,3,0.02h,Break Even,$-1.50,$9.00,$234296.00,412,$9.00
2025-07-31,11:11:00,23778.0,SELL,3,0.02h,Stop Loss,$45.00,$54.00,$234341.00,412,$54.00
2025-07-31,12:09:00,23774.25,BUY,3,0.02h,Break Even,$-1.50,$52.50,$234339.50,412,$52.50
2025-07-31,13:11:00,23795.0,SELL,3,0.02h,Stop Loss,$-9.00,$43.50,$234330.50,412,$43.50
2025-07-31,13:57:00,23692.0,BUY,3,0.02h,Stop Loss,$30.00,$73.50,$234360.50,412,$73.50
2025-07-31,14:13:00,23658.75,SELL,3,0.02h,Break Even,$-1.50,$72.00,$234359.00,412,$72.00
2025-07-31,15:32:00,23547.75,BUY,3,0.02h,Stop Loss,$40.50,$112.50,$234399.50,412,$112.50
2025-07-31,16:39:00,23588.25,SELL,3,0.02h,Break Even,$-1.50,$111.00,$234398.00,412,$111.00
2025-07-31,18:26:00,23390.0,BUY,3,0.02h,Stop Loss,$31.50,$142.50,$234429.50,412,$142.50
2025-07-31,18:58:00,23415.75,SELL,3,0.02h,Stop Loss,$13.50,$156.00,$234443.00,412,$156.00
2025-07-31,19:07:00,23441.0,BUY,3,0.02h,Stop Loss,$-9.00,$147.00,$234434.00,412,$147.00
2025-07-31,19:08:00,23429.75,SELL,3,0.02h,Stop Loss,$31.50,$178.50,$234465.50,412,$178.50
2025-07-31,19:44:00,23402.0,BUY,3,0.02h,Stop Loss,$31.50,$210.00,$234497.00,412,$210.00
2025-07-31,19:48:00,23386.25,SELL,3,0.02h,Stop Loss,$118.50,$328.50,$234615.50,412,$328.50
2025-07-31,20:32:00,23349.5,BUY,3,0.02h,Stop Loss,$28.50,$357.00,$234644.00,412,$357.00
2025-07-31,20:56:00,23334.75,SELL,3,0.02h,Stop Loss,$24.00,$381.00,$234668.00,412,$381.00
2025-07-31,23:49:00,23297.5,BUY,3,0.02h,Stop Loss,$-9.00,$372.00,$234659.00,412,$372.00
,,,,,,,,,,,
2025-08-01,00:03:00,23288.0,SELL,3,0.02h,Break Even,$-1.50,$-1.50,$234657.50,413,$-1.50
2025-08-01,00:42:00,23272.0,BUY,3,0.02h,Stop Loss,$10.50,$9.00,$234668.00,413,$9.00
2025-08-01,00:51:00,23259.25,SELL,3,0.02h,Stop Loss,$-9.00,$0.00,$234659.00,413,$0.00
2025-08-01,00:57:00,23274.25,BUY,3,0.02h,Stop Loss,$10.50,$10.50,$234669.50,413,$10.50
2025-08-01,02:33:00,23319.25,SELL,3,0.02h,Break Even,$-1.50,$9.00,$234668.00,413,$9.00
2025-08-01,02:38:00,23328.0,BUY,3,0.02h,Stop Loss,$-9.00,$0.00,$234659.00,413,$0.00
2025-08-01,03:05:00,23327.0,SELL,3,0.02h,Stop Loss,$-9.00,$-9.00,$234650.00,413,$-9.00
2025-08-01,03:08:00,23334.25,BUY,3,0.02h,Stop Loss,$-9.00,$-18.00,$234641.00,413,$-18.00
2025-08-01,03:36:00,23326.75,SELL,3,0.02h,Stop Loss,$-9.00,$-27.00,$234632.00,413,$-27.00
2025-08-01,04:13:00,23317.75,BUY,3,0.02h,Stop Loss,$3.00,$-24.00,$234635.00,413,$-24.00
2025-08-01,04:32:00,23313.25,SELL,3,0.02h,Stop Loss,$-9.00,$-33.00,$234626.00,413,$-33.00
2025-08-01,04:42:00,23317.75,BUY,3,0.02h,Break Even,$-1.50,$-34.50,$234624.50,413,$-34.50
2025-08-01,04:50:00,23307.5,SELL,3,0.02h,Stop Loss,$-9.00,$-43.50,$234615.50,413,$-43.50
2025-08-01,05:00:00,23318.75,BUY,3,0.02h,Stop Loss,$10.50,$-33.00,$234626.00,413,$-33.00
2025-08-01,05:15:00,23314.5,SELL,3,0.02h,Break Even,$-1.50,$-34.50,$234624.50,413,$-34.50
2025-08-01,06:49:00,23275.5,BUY,3,0.02h,Break Even,$-1.50,$-36.00,$234623.00,413,$-36.00
2025-08-01,06:57:00,23257.0,SELL,3,0.02h,Break Even,$-1.50,$-37.50,$234621.50,413,$-37.50
2025-08-01,08:49:00,23111.25,BUY,3,0.02h,Stop Loss,$-9.00,$-46.50,$234612.50,413,$-46.50
2025-08-01,09:16:00,23105.5,SELL,3,0.02h,Break Even,$-1.50,$-48.00,$234611.00,413,$-48.00
2025-08-01,09:39:00,23114.0,BUY,3,0.02h,Stop Loss,$24.00,$-24.00,$234635.00,413,$-24.00
2025-08-01,10:03:00,23106.0,SELL,3,0.02h,Stop Loss,$-9.00,$-33.00,$234626.00,413,$-33.00
2025-08-01,11:08:00,23074.25,BUY,3,0.02h,Stop Loss,$-9.00,$-42.00,$234617.00,413,$-42.00
2025-08-01,12:18:00,23112.25,SELL,3,0.02h,Break Even,$-1.50,$-43.50,$234615.50,413,$-43.50
2025-08-01,12:41:00,23146.0,BUY,3,0.02h,Stop Loss,$69.00,$25.50,$234684.50,413,$25.50
2025-08-01,12:51:00,23103.0,SELL,3,0.02h,Stop Loss,$51.00,$76.50,$234735.50,413,$76.50
2025-08-01,14:13:00,22919.0,BUY,3,0.02h,Stop Loss,$31.50,$108.00,$234767.00,413,$108.00
2025-08-01,14:50:00,22955.25,SELL,3,0.02h,Stop Loss,$60.00,$168.00,$234827.00,413,$168.00
2025-08-01,15:39:00,22940.0,BUY,3,0.02h,Stop Loss,$79.50,$247.50,$234906.50,413,$247.50
2025-08-01,16:31:00,23004.25,SELL,3,0.02h,Stop Loss,$22.50,$270.00,$234929.00,413,$270.00
2025-08-01,17:51:00,22871.5,BUY,3,0.02h,Break Even,$-1.50,$268.50,$234927.50,413,$268.50
2025-08-01,17:56:00,22833.0,SELL,3,0.02h,Stop Loss,$15.00,$283.50,$234942.50,413,$283.50
2025-08-01,18:24:00,22848.0,BUY,3,0.02h,Stop Loss,$54.00,$337.50,$234996.50,413,$337.50
2025-08-01,18:53:00,22864.75,SELL,3,0.02h,Stop Loss,$46.50,$384.00,$235043.00,413,$384.00
2025-08-01,19:18:00,22879.25,BUY,3,0.02h,Stop Loss,$67.50,$451.50,$235110.50,413,$451.50
2025-08-01,19:23:00,22870.0,SELL,3,0.02h,Break Even,$-1.50,$450.00,$235109.00,413,$450.00
2025-08-01,19:24:00,22894.0,BUY,3,0.02h,Stop Loss,$-9.00,$441.00,$235100.00,413,$441.00
2025-08-01,19:31:00,22874.5,SELL,3,0.02h,Stop Loss,$19.50,$460.50,$235119.50,413,$460.50
2025-08-01,19:34:00,22885.25,BUY,3,0.02h,Break Even,$-1.50,$459.00,$235118.00,413,$459.00
2025-08-01,19:39:00,22871.5,SELL,3,0.02h,Stop Loss,$6.00,$465.00,$235124.00,413,$465.00
2025-08-01,19:42:00,22887.25,BUY,3,0.02h,Break Even,$-1.50,$463.50,$235122.50,413,$463.50
2025-08-01,20:01:00,22883.75,SELL,3,0.02h,Stop Loss,$9.00,$472.50,$235131.50,413,$472.50
2025-08-01,20:17:00,22891.5,BUY,3,0.02h,Break Even,$-1.50,$471.00,$235130.00,413,$471.00
2025-08-01,20:18:00,22884.5,SELL,3,0.02h,Stop Loss,$22.50,$493.50,$235152.50,413,$493.50
2025-08-01,20:23:00,22889.25,BUY,3,0.02h,Stop Loss,$-9.00,$484.50,$235143.50,413,$484.50
2025-08-01,20:25:00,22884.75,SELL,3,0.02h,Break Even,$-1.50,$483.00,$235142.00,413,$483.00
,,,,,,,,,,,
2025-08-04,00:00:00,22927.0,BUY,3,0.02h,Stop Loss,$-9.00,$-9.00,$235133.00,414,$-9.00
2025-08-04,00:35:00,22922.25,SELL,3,0.02h,Break Even,$-1.50,$-10.50,$235131.50,414,$-10.50
2025-08-04,00:38:00,22933.25,BUY,3,0.02h,Stop Loss,$-9.00,$-19.50,$235122.50,414,$-19.50
2025-08-04,00:40:00,22925.5,SELL,3,0.02h,Break Even,$-1.50,$-21.00,$235121.00,414,$-21.00
2025-08-04,00:43:00,22935.5,BUY,3,0.02h,Break Even,$-1.50,$-22.50,$235119.50,414,$-22.50
2025-08-04,01:09:00,22935.5,SELL,3,0.02h,Stop Loss,$-9.00,$-31.50,$235110.50,414,$-31.50
2025-08-04,01:20:00,22955.75,BUY,3,0.02h,Stop Loss,$28.50,$-3.00,$235139.00,414,$-3.00
2025-08-04,01:51:00,22955.75,SELL,3,0.02h,Stop Loss,$-9.00,$-12.00,$235130.00,414,$-12.00
2025-08-04,02:02:00,22958.0,BUY,3,0.02h,Stop Loss,$-9.00,$-21.00,$235121.00,414,$-21.00
2025-08-04,02:04:00,22953.75,SELL,3,0.02h,Stop Loss,$-9.00,$-30.00,$235112.00,414,$-30.00
2025-08-04,02:06:00,22959.75,BUY,3,0.02h,Stop Loss,$4.50,$-25.50,$235116.50,414,$-25.50
2025-08-04,02:11:00,22952.25,SELL,3,0.02h,Break Even,$-1.50,$-27.00,$235115.00,414,$-27.00
2025-08-04,02:15:00,22963.5,BUY,3,0.02h,Break Even,$-1.50,$-28.50,$235113.50,414,$-28.50
2025-08-04,03:18:00,22971.75,SELL,3,0.02h,Stop Loss,$-9.00,$-37.50,$235104.50,414,$-37.50
2025-08-04,03:42:00,22978.0,BUY,3,0.02h,Stop Loss,$15.00,$-22.50,$235119.50,414,$-22.50
2025-08-04,04:08:00,22982.75,SELL,3,0.02h,Break Even,$-1.50,$-24.00,$235118.00,414,$-24.00
2025-08-04,04:35:00,22974.75,BUY,3,0.02h,Break Even,$-1.50,$-25.50,$235116.50,414,$-25.50
2025-08-04,04:50:00,22969.75,SELL,3,0.02h,Break Even,$-1.50,$-27.00,$235115.00,414,$-27.00
2025-08-04,05:20:00,22974.0,BUY,3,0.02h,Stop Loss,$-9.00,$-36.00,$235106.00,414,$-36.00
2025-08-04,05:59:00,22982.25,SELL,3,0.02h,Break Even,$-1.50,$-37.50,$235104.50,414,$-37.50
2025-08-04,06:03:00,22993.0,BUY,3,0.02h,Stop Loss,$-9.00,$-46.50,$235095.50,414,$-46.50
2025-08-04,06:22:00,22984.75,SELL,3,0.02h,Stop Loss,$30.00,$-16.50,$235125.50,414,$-16.50
2025-08-04,06:49:00,22976.75,BUY,3,0.02h,Stop Loss,$24.00,$7.50,$235149.50,414,$7.50
2025-08-04,07:52:00,23016.25,SELL,3,0.02h,Break Even,$-1.50,$6.00,$235148.00,414,$6.00
2025-08-04,08:08:00,23030.75,BUY,3,0.02h,Break Even,$-1.50,$4.50,$235146.50,414,$4.50
2025-08-04,09:28:00,23057.5,SELL,3,0.02h,Break Even,$-1.50,$3.00,$235145.00,414,$3.00
2025-08-04,09:37:00,23067.0,BUY,3,0.02h,Stop Loss,$-9.00,$-6.00,$235136.00,414,$-6.00
2025-08-04,09:48:00,23057.0,SELL,3,0.02h,Stop Loss,$-9.00,$-15.00,$235127.00,414,$-15.00
2025-08-04,10:11:00,23065.5,BUY,3,0.02h,Break Even,$-1.50,$-16.50,$235125.50,414,$-16.50
2025-08-04,10:39:00,23059.25,SELL,3,0.02h,Stop Loss,$-9.00,$-25.50,$235116.50,414,$-25.50
2025-08-04,10:41:00,23073.75,BUY,3,0.02h,Stop Loss,$-9.00,$-34.50,$235107.50,414,$-34.50
2025-08-04,10:48:00,23065.25,SELL,3,0.02h,Stop Loss,$-9.00,$-43.50,$235098.50,414,$-43.50
2025-08-04,10:52:00,23071.0,BUY,3,0.02h,Stop Loss,$-9.00,$-52.50,$235089.50,414,$-52.50
2025-08-04,10:54:00,23059.25,SELL,3,0.02h,Stop Loss,$-9.00,$-61.50,$235080.50,414,$-61.50
2025-08-04,11:28:00,23059.25,BUY,3,0.02h,Stop Loss,$-9.00,$-70.50,$235071.50,414,$-70.50
2025-08-04,11:50:00,23055.25,SELL,3,0.02h,Break Even,$-1.50,$-72.00,$235070.00,414,$-72.00
2025-08-04,12:18:00,23056.5,BUY,3,0.02h,Break Even,$-1.50,$-73.50,$235068.50,414,$-73.50
2025-08-04,12:49:00,23065.75,SELL,3,0.02h,Stop Loss,$12.00,$-61.50,$235080.50,414,$-61.50
2025-08-04,12:56:00,23075.0,BUY,3,0.02h,Stop Loss,$-9.00,$-70.50,$235071.50,414,$-70.50
2025-08-04,14:32:00,23230.25,SELL,3,0.02h,Stop Loss,$-9.00,$-79.50,$235062.50,414,$-79.50
2025-08-04,14:36:00,23250.0,BUY,3,0.02h,Stop Loss,$3.00,$-76.50,$235065.50,414,$-76.50
2025-08-04,14:42:00,23225.75,SELL,3,0.02h,Stop Loss,$-9.00,$-85.50,$235056.50,414,$-85.50
2025-08-04,15:27:00,23219.0,BUY,3,0.02h,Stop Loss,$4.50,$-81.00,$235061.00,414,$-81.00
2025-08-04,15:43:00,23201.5,SELL,3,0.02h,Break Even,$-1.50,$-82.50,$235059.50,414,$-82.50
2025-08-04,15:50:00,23220.0,BUY,3,0.02h,Stop Loss,$46.50,$-36.00,$235106.00,414,$-36.00
2025-08-04,16:41:00,23259.5,SELL,3,0.02h,Stop Loss,$-9.00,$-45.00,$235097.00,414,$-45.00
2025-08-04,16:48:00,23270.0,BUY,3,0.02h,Break Even,$-1.50,$-46.50,$235095.50,414,$-46.50
2025-08-04,17:38:00,23273.5,SELL,3,0.02h,Break Even,$-1.50,$-48.00,$235094.00,414,$-48.00
2025-08-04,18:01:00,23274.0,BUY,3,0.02h,Stop Loss,$7.50,$-40.50,$235101.50,414,$-40.50
2025-08-04,18:15:00,23263.5,SELL,3,0.02h,Stop Loss,$-9.00,$-49.50,$235092.50,414,$-49.50
2025-08-04,18:34:00,23272.25,BUY,3,0.02h,Stop Loss,$-9.00,$-58.50,$235083.50,414,$-58.50
2025-08-04,18:41:00,23262.75,SELL,3,0.02h,Break Even,$-1.50,$-60.00,$235082.00,414,$-60.00
2025-08-04,19:02:00,23266.25,BUY,3,0.02h,Stop Loss,$-9.00,$-69.00,$235073.00,414,$-69.00
2025-08-04,19:04:00,23261.5,SELL,3,0.02h,Break Even,$-1.50,$-70.50,$235071.50,414,$-70.50
2025-08-04,19:10:00,23264.75,BUY,3,0.02h,Break Even,$-1.50,$-72.00,$235070.00,414,$-72.00
2025-08-04,19:30:00,23266.5,SELL,3,0.02h,Break Even,$-1.50,$-73.50,$235068.50,414,$-73.50
2025-08-04,19:45:00,23268.75,BUY,3,0.02h,Break Even,$-1.50,$-75.00,$235067.00,414,$-75.00
2025-08-04,23:00:00,23326.5,SELL,3,0.02h,Stop Loss,$-9.00,$-84.00,$235058.00,414,$-84.00
2025-08-04,23:16:00,23344.25,BUY,3,0.02h,Stop Loss,$10.50,$-73.50,$235068.50,414,$-73.50
2025-08-04,23:21:00,23332.25,SELL,3,0.02h,Stop Loss,$19.50,$-54.00,$235088.00,414,$-54.00
2025-08-04,23:46:00,23330.25,BUY,3,0.02h,Break Even,$-1.50,$-55.50,$235086.50,414,$-55.50
,,,,,,,,,,,
2025-08-05,00:14:00,23326.0,SELL,3,0.02h,Break Even,$-1.50,$-1.50,$235085.00,415,$-1.50
2025-08-05,00:32:00,23325.75,BUY,3,0.02h,Stop Loss,$13.50,$12.00,$235098.50,415,$12.00
2025-08-05,01:18:00,23342.5,SELL,3,0.02h,Break Even,$-1.50,$10.50,$235097.00,415,$10.50
2025-08-05,01:43:00,23349.0,BUY,3,0.02h,Break Even,$-1.50,$9.00,$235095.50,415,$9.00
2025-08-05,01:55:00,23344.0,SELL,3,0.02h,Break Even,$-1.50,$7.50,$235094.00,415,$7.50
2025-08-05,02:33:00,23339.0,BUY,3,0.02h,Break Even,$-1.50,$6.00,$235092.50,415,$6.00
2025-08-05,02:54:00,23338.75,SELL,3,0.03h,Stop Loss,$12.00,$18.00,$235104.50,415,$18.00
2025-08-05,03:18:00,23340.5,BUY,3,0.02h,Stop Loss,$-9.00,$9.00,$235095.50,415,$9.00
2025-08-05,03:21:00,23335.0,SELL,3,0.02h,Break Even,$-1.50,$7.50,$235094.00,415,$7.50
2025-08-05,03:32:00,23347.5,BUY,3,0.02h,Stop Loss,$-9.00,$-1.50,$235085.00,415,$-1.50
2025-08-05,03:58:00,23344.0,SELL,3,0.02h,Stop Loss,$-9.00,$-10.50,$235076.00,415,$-10.50
2025-08-05,04:28:00,23344.0,BUY,3,0.02h,Stop Loss,$-9.00,$-19.50,$235067.00,415,$-19.50
2025-08-05,05:18:00,23355.75,SELL,3,0.02h,Break Even,$-1.50,$-21.00,$235065.50,415,$-21.00
2025-08-05,05:24:00,23360.25,BUY,3,0.02h,Break Even,$-1.50,$-22.50,$235064.00,415,$-22.50
2025-08-05,05:59:00,23362.25,SELL,3,0.02h,Stop Loss,$-9.00,$-31.50,$235055.00,415,$-31.50
2025-08-05,06:08:00,23364.25,BUY,3,0.02h,Break Even,$-1.50,$-33.00,$235053.50,415,$-33.00
2025-08-05,06:29:00,23367.75,SELL,3,0.02h,Stop Loss,$-9.00,$-42.00,$235044.50,415,$-42.00
2025-08-05,06:32:00,23374.0,BUY,3,0.02h,Break Even,$-1.50,$-43.50,$235043.00,415,$-43.50
2025-08-05,07:03:00,23376.25,SELL,3,0.02h,Stop Loss,$-9.00,$-52.50,$235034.00,415,$-52.50
2025-08-05,07:06:00,23387.25,BUY,3,0.02h,Break Even,$-1.50,$-54.00,$235032.50,415,$-54.00
2025-08-05,07:15:00,23376.25,SELL,3,0.02h,Stop Loss,$-9.00,$-63.00,$235023.50,415,$-63.00
2025-08-05,08:25:00,23333.25,BUY,3,0.02h,Stop Loss,$16.50,$-46.50,$235040.00,415,$-46.50
2025-08-05,08:40:00,23328.0,SELL,3,0.02h,Stop Loss,$-9.00,$-55.50,$235031.00,415,$-55.50
2025-08-05,08:52:00,23331.5,BUY,3,0.02h,Break Even,$-1.50,$-57.00,$235029.50,415,$-57.00
2025-08-05,09:05:00,23330.75,SELL,3,0.02h,Break Even,$-1.50,$-58.50,$235028.00,415,$-58.50
2025-08-05,09:06:00,23331.5,BUY,3,0.02h,Stop Loss,$15.00,$-43.50,$235043.00,415,$-43.50
2025-08-05,09:25:00,23331.75,SELL,3,0.02h,Stop Loss,$-9.00,$-52.50,$235034.00,415,$-52.50
2025-08-05,09:26:00,23333.75,BUY,3,0.05h,Break Even,$-1.50,$-54.00,$235032.50,415,$-54.00
2025-08-05,11:23:00,23383.0,SELL,3,0.02h,Stop Loss,$-9.00,$-63.00,$235023.50,415,$-63.00
2025-08-05,11:25:00,23386.75,BUY,3,0.02h,Stop Loss,$-9.00,$-72.00,$235014.50,415,$-72.00
2025-08-05,11:26:00,23384.75,SELL,3,0.02h,Stop Loss,$7.50,$-64.50,$235022.00,415,$-64.50
2025-08-05,11:46:00,23391.0,BUY,3,0.02h,Stop Loss,$9.00,$-55.50,$235031.00,415,$-55.50
2025-08-05,12:07:00,23377.5,SELL,3,0.02h,Break Even,$-1.50,$-57.00,$235029.50,415,$-57.00
2025-08-05,12:13:00,23385.75,BUY,3,0.02h,Stop Loss,$21.00,$-36.00,$235050.50,415,$-36.00
2025-08-05,12:21:00,23370.75,SELL,3,0.02h,Stop Loss,$66.00,$30.00,$235116.50,415,$30.00
2025-08-05,12:45:00,23372.5,BUY,3,0.02h,Stop Loss,$33.00,$63.00,$235149.50,415,$63.00
2025-08-05,12:50:00,23365.75,SELL,3,0.02h,Stop Loss,$-9.00,$54.00,$235140.50,415,$54.00
2025-08-05,13:20:00,23365.0,BUY,3,0.02h,Stop Loss,$-9.00,$45.00,$235131.50,415,$45.00
2025-08-05,13:22:00,23354.5,SELL,3,0.02h,Break Even,$-1.50,$43.50,$235130.00,415,$43.50
2025-08-05,13:41:00,23356.0,BUY,3,0.02h,Stop Loss,$7.50,$51.00,$235137.50,415,$51.00
2025-08-05,14:02:00,23337.0,SELL,3,0.02h,Stop Loss,$10.50,$61.50,$235148.00,415,$61.50
2025-08-05,15:07:00,23200.5,BUY,3,0.02h,Stop Loss,$60.00,$121.50,$235208.00,415,$121.50
2025-08-05,15:12:00,23177.5,SELL,3,0.02h,Break Even,$-1.50,$120.00,$235206.50,415,$120.00
2025-08-05,15:14:00,23206.5,BUY,3,0.02h,Stop Loss,$54.00,$174.00,$235260.50,415,$174.00
2025-08-05,15:22:00,23186.0,SELL,3,0.02h,Stop Loss,$12.00,$186.00,$235272.50,415,$186.00
2025-08-05,16:00:00,23156.25,BUY,3,0.02h,Stop Loss,$46.50,$232.50,$235319.00,415,$232.50
2025-08-05,16:41:00,23168.5,SELL,3,0.02h,Stop Loss,$24.00,$256.50,$235343.00,415,$256.50
2025-08-05,16:55:00,23189.5,BUY,3,0.02h,Stop Loss,$9.00,$265.50,$235352.00,415,$265.50
2025-08-05,17:06:00,23174.25,SELL,3,0.02h,Stop Loss,$-9.00,$256.50,$235343.00,415,$256.50
2025-08-05,17:07:00,23182.75,BUY,3,0.02h,Stop Loss,$18.00,$274.50,$235361.00,415,$274.50
2025-08-05,18:13:00,23228.5,SELL,3,0.02h,Stop Loss,$16.50,$291.00,$235377.50,415,$291.00
2025-08-05,19:13:00,23157.0,BUY,3,0.02h,Break Even,$-1.50,$289.50,$235376.00,415,$289.50
2025-08-05,19:38:00,23153.75,SELL,3,0.02h,Stop Loss,$13.50,$303.00,$235389.50,415,$303.00
2025-08-05,20:12:00,23148.5,BUY,3,0.02h,Stop Loss,$-9.00,$294.00,$235380.50,415,$294.00
2025-08-05,20:24:00,23127.0,SELL,3,0.02h,Stop Loss,$108.00,$402.00,$235488.50,415,$402.00
2025-08-05,23:18:00,23094.0,BUY,3,0.02h,Break Even,$-1.50,$400.50,$235487.00,415,$400.50
2025-08-05,23:25:00,23083.75,SELL,3,0.02h,Break Even,$-1.50,$399.00,$235485.50,415,$399.00
2025-08-05,23:43:00,23086.0,BUY,3,0.02h,Break Even,$-1.50,$397.50,$235484.00,415,$397.50
2025-08-05,23:51:00,23072.0,SELL,3,0.02h,Break Even,$-1.50,$396.00,$235482.50,415,$396.00
,,,,,,,,,,,
2025-08-06,00:07:00,23077.75,BUY,3,0.02h,Break Even,$-1.50,$-1.50,$235481.00,416,$-1.50
2025-08-06,00:19:00,23072.0,SELL,3,0.02h,Break Even,$-1.50,$-3.00,$235479.50,416,$-3.00
2025-08-06,00:22:00,23076.0,BUY,3,0.02h,Stop Loss,$25.50,$22.50,$235505.00,416,$22.50
2025-08-06,00:44:00,23077.75,SELL,3,0.02h,Stop Loss,$-9.00,$13.50,$235496.00,416,$13.50
2025-08-06,00:46:00,23083.25,BUY,3,0.02h,Break Even,$-1.50,$12.00,$235494.50,416,$12.00
2025-08-06,00:47:00,23078.75,SELL,3,0.02h,Stop Loss,$-9.00,$3.00,$235485.50,416,$3.00
2025-08-06,01:15:00,23081.75,BUY,3,0.02h,Stop Loss,$-9.00,$-6.00,$235476.50,416,$-6.00
2025-08-06,02:53:00,23149.5,SELL,3,0.02h,Stop Loss,$-9.00,$-15.00,$235467.50,416,$-15.00
2025-08-06,03:01:00,23157.0,BUY,3,0.02h,Break Even,$-1.50,$-16.50,$235466.00,416,$-16.50
2025-08-06,03:04:00,23152.25,SELL,3,0.02h,Stop Loss,$-9.00,$-25.50,$235457.00,416,$-25.50
2025-08-06,03:06:00,23156.0,BUY,3,0.02h,Break Even,$-1.50,$-27.00,$235455.50,416,$-27.00
2025-08-06,03:15:00,23147.25,SELL,3,0.02h,Break Even,$-1.50,$-28.50,$235454.00,416,$-28.50
2025-08-06,03:21:00,23162.75,BUY,3,0.02h,Break Even,$-1.50,$-30.00,$235452.50,416,$-30.00
2025-08-06,04:19:00,23163.75,SELL,3,0.02h,Stop Loss,$-9.00,$-39.00,$235443.50,416,$-39.00
2025-08-06,04:23:00,23169.25,BUY,3,0.02h,Stop Loss,$-9.00,$-48.00,$235434.50,416,$-48.00
2025-08-06,04:24:00,23167.25,SELL,3,0.02h,Break Even,$-1.50,$-49.50,$235433.00,416,$-49.50
2025-08-06,05:02:00,23165.25,BUY,3,0.02h,Break Even,$-1.50,$-51.00,$235431.50,416,$-51.00
2025-08-06,05:04:00,23156.5,SELL,3,0.02h,Stop Loss,$-9.00,$-60.00,$235422.50,416,$-60.00
2025-08-06,05:22:00,23161.75,BUY,3,0.02h,Stop Loss,$-9.00,$-69.00,$235413.50,416,$-69.00
2025-08-06,06:01:00,23183.5,SELL,3,0.02h,Break Even,$-1.50,$-70.50,$235412.00,416,$-70.50
2025-08-06,06:03:00,23191.0,BUY,3,0.02h,Stop Loss,$-9.00,$-79.50,$235403.00,416,$-79.50
2025-08-06,06:12:00,23183.5,SELL,3,0.02h,Stop Loss,$-9.00,$-88.50,$235394.00,416,$-88.50
2025-08-06,06:16:00,23191.75,BUY,3,0.02h,Stop Loss,$22.50,$-66.00,$235416.50,416,$-66.00
2025-08-06,06:50:00,23194.75,SELL,3,0.02h,Stop Loss,$-9.00,$-75.00,$235407.50,416,$-75.00
2025-08-06,07:03:00,23200.25,BUY,3,0.02h,Break Even,$-1.50,$-76.50,$235406.00,416,$-76.50
2025-08-06,07:24:00,23198.75,SELL,3,0.02h,Stop Loss,$3.00,$-73.50,$235409.00,416,$-73.50
2025-08-06,07:31:00,23210.75,BUY,3,0.02h,Break Even,$-1.50,$-75.00,$235407.50,416,$-75.00
2025-08-06,08:04:00,23209.0,SELL,3,0.02h,Stop Loss,$-9.00,$-84.00,$235398.50,416,$-84.00
2025-08-06,08:06:00,23220.25,BUY,3,0.02h,Stop Loss,$13.50,$-70.50,$235412.00,416,$-70.50
2025-08-06,08:13:00,23211.5,SELL,3,0.02h,Stop Loss,$3.00,$-67.50,$235415.00,416,$-67.50
2025-08-06,09:11:00,23173.25,BUY,3,0.02h,Stop Loss,$-9.00,$-76.50,$235406.00,416,$-76.50
2025-08-06,09:21:00,23160.0,SELL,3,0.02h,Stop Loss,$-9.00,$-85.50,$235397.00,416,$-85.50
2025-08-06,10:13:00,23151.25,BUY,3,0.02h,Stop Loss,$3.00,$-82.50,$235400.00,416,$-82.50
2025-08-06,10:22:00,23131.75,SELL,3,0.02h,Stop Loss,$19.50,$-63.00,$235419.50,416,$-63.00
2025-08-06,10:29:00,23150.25,BUY,3,0.02h,Stop Loss,$-9.00,$-72.00,$235410.50,416,$-72.00
2025-08-06,10:40:00,23140.0,SELL,3,0.02h,Break Even,$-1.50,$-73.50,$235409.00,416,$-73.50
2025-08-06,10:57:00,23143.25,BUY,3,0.02h,Stop Loss,$-9.00,$-82.50,$235400.00,416,$-82.50
2025-08-06,11:56:00,23178.75,SELL,3,0.02h,Stop Loss,$9.00,$-73.50,$235409.00,416,$-73.50
2025-08-06,12:21:00,23173.25,BUY,3,0.02h,Stop Loss,$45.00,$-28.50,$235454.00,416,$-28.50
2025-08-06,12:28:00,23152.75,SELL,3,0.02h,Stop Loss,$-9.00,$-37.50,$235445.00,416,$-37.50
2025-08-06,12:36:00,23171.5,BUY,3,0.02h,Stop Loss,$3.00,$-34.50,$235448.00,416,$-34.50
2025-08-06,13:24:00,23170.0,SELL,3,0.02h,Break Even,$-1.50,$-36.00,$235446.50,416,$-36.00
2025-08-06,13:33:00,23211.5,BUY,3,0.02h,Stop Loss,$27.00,$-9.00,$235473.50,416,$-9.00
2025-08-06,13:40:00,23159.5,SELL,3,0.02h,Stop Loss,$42.00,$33.00,$235515.50,416,$33.00
2025-08-06,13:46:00,23194.0,BUY,3,0.02h,Stop Loss,$42.00,$75.00,$235557.50,416,$75.00
2025-08-06,14:17:00,23219.75,SELL,3,0.02h,Stop Loss,$67.50,$142.50,$235625.00,416,$142.50
2025-08-06,14:37:00,23246.0,BUY,3,0.02h,Break Even,$-1.50,$141.00,$235623.50,416,$141.00
2025-08-06,16:28:00,23360.75,SELL,3,0.02h,Break Even,$-1.50,$139.50,$235622.00,416,$139.50
2025-08-06,16:37:00,23389.25,BUY,3,0.02h,Stop Loss,$-9.00,$130.50,$235613.00,416,$130.50
2025-08-06,16:43:00,23362.0,SELL,3,0.02h,Stop Loss,$48.00,$178.50,$235661.00,416,$178.50
2025-08-06,16:52:00,23378.5,BUY,3,0.02h,Stop Loss,$4.50,$183.00,$235665.50,416,$183.00
2025-08-06,17:08:00,23365.75,SELL,3,0.02h,Stop Loss,$-9.00,$174.00,$235656.50,416,$174.00
2025-08-06,17:12:00,23375.0,BUY,3,0.02h,Stop Loss,$-9.00,$165.00,$235647.50,416,$165.00
2025-08-06,17:13:00,23366.5,SELL,3,0.02h,Stop Loss,$6.00,$171.00,$235653.50,416,$171.00
2025-08-06,17:23:00,23373.0,BUY,3,0.02h,Stop Loss,$3.00,$174.00,$235656.50,416,$174.00
2025-08-06,17:51:00,23371.0,SELL,3,0.02h,Stop Loss,$19.50,$193.50,$235676.00,416,$193.50
2025-08-06,18:03:00,23395.25,BUY,3,0.02h,Stop Loss,$-9.00,$184.50,$235667.00,416,$184.50
2025-08-06,18:59:00,23413.0,SELL,3,0.02h,Break Even,$-1.50,$183.00,$235665.50,416,$183.00
2025-08-06,19:05:00,23429.0,BUY,3,0.02h,Stop Loss,$-9.00,$174.00,$235656.50,416,$174.00
2025-08-06,19:07:00,23420.75,SELL,3,0.02h,Break Even,$-1.50,$172.50,$235655.00,416,$172.50
2025-08-06,19:19:00,23427.25,BUY,3,0.02h,Stop Loss,$13.50,$186.00,$235668.50,416,$186.00
2025-08-06,19:43:00,23424.5,SELL,3,0.02h,Break Even,$-1.50,$184.50,$235667.00,416,$184.50
2025-08-06,20:28:00,23415.75,BUY,3,0.02h,Break Even,$-1.50,$183.00,$235665.50,416,$183.00
2025-08-06,20:37:00,23408.75,SELL,3,0.02h,Break Even,$-1.50,$181.50,$235664.00,416,$181.50
2025-08-06,20:50:00,23412.75,BUY,3,0.02h,Stop Loss,$-9.00,$172.50,$235655.00,416,$172.50
2025-08-06,20:51:00,23407.0,SELL,3,0.02h,Break Even,$-1.50,$171.00,$235653.50,416,$171.00
2025-08-06,21:00:00,23413.0,BUY,3,2.00h,Stop Loss,$268.50,$439.50,$235922.00,416,$439.50
2025-08-06,23:43:00,23458.0,SELL,3,0.02h,Stop Loss,$-9.00,$430.50,$235913.00,416,$430.50
,,,,,,,,,,,
2025-08-07,00:05:00,23460.25,BUY,3,0.02h,Stop Loss,$-9.00,$-9.00,$235904.00,417,$-9.00
2025-08-07,00:58:00,23485.25,SELL,3,0.02h,Stop Loss,$-9.00,$-18.00,$235895.00,417,$-18.00
2025-08-07,01:09:00,23492.25,BUY,3,0.02h,Stop Loss,$7.50,$-10.50,$235902.50,417,$-10.50
2025-08-07,01:16:00,23484.0,SELL,3,0.02h,Stop Loss,$-9.00,$-19.50,$235893.50,417,$-19.50
2025-08-07,01:38:00,23494.5,BUY,3,0.02h,Stop Loss,$-9.00,$-28.50,$235884.50,417,$-28.50
2025-08-07,02:00:00,23495.75,SELL,3,0.02h,Break Even,$-1.50,$-30.00,$235883.00,417,$-30.00
2025-08-07,02:10:00,23502.75,BUY,3,0.02h,Break Even,$-1.50,$-31.50,$235881.50,417,$-31.50
2025-08-07,02:12:00,23496.0,SELL,3,0.02h,Stop Loss,$-9.00,$-40.50,$235872.50,417,$-40.50
2025-08-07,02:15:00,23499.25,BUY,3,0.02h,Stop Loss,$-9.00,$-49.50,$235863.50,417,$-49.50
2025-08-07,02:16:00,23498.0,SELL,3,0.02h,Break Even,$-1.50,$-51.00,$235862.00,417,$-51.00
2025-08-07,02:41:00,23497.25,BUY,3,0.02h,Stop Loss,$-9.00,$-60.00,$235853.00,417,$-60.00
2025-08-07,02:43:00,23488.5,SELL,3,0.02h,Break Even,$-1.50,$-61.50,$235851.50,417,$-61.50
2025-08-07,03:03:00,23496.25,BUY,3,0.02h,Break Even,$-1.50,$-63.00,$235850.00,417,$-63.00
2025-08-07,03:09:00,23486.25,SELL,3,0.02h,Break Even,$-1.50,$-64.50,$235848.50,417,$-64.50
2025-08-07,03:27:00,23490.25,BUY,3,0.02h,Stop Loss,$-9.00,$-73.50,$235839.50,417,$-73.50
2025-08-07,03:55:00,23489.5,SELL,3,0.02h,Stop Loss,$-9.00,$-82.50,$235830.50,417,$-82.50
2025-08-07,04:04:00,23495.25,BUY,3,0.02h,Stop Loss,$-9.00,$-91.50,$235821.50,417,$-91.50
2025-08-07,04:25:00,23493.0,SELL,3,0.02h,Stop Loss,$4.50,$-87.00,$235826.00,417,$-87.00
2025-08-07,05:21:00,23466.5,BUY,3,0.02h,Stop Loss,$-9.00,$-96.00,$235817.00,417,$-96.00
2025-08-07,06:16:00,23473.0,SELL,3,0.02h,Stop Loss,$-9.00,$-105.00,$235808.00,417,$-105.00
2025-08-07,06:23:00,23486.0,BUY,3,0.02h,Break Even,$-1.50,$-106.50,$235806.50,417,$-106.50
2025-08-07,06:40:00,23479.5,SELL,3,0.02h,Stop Loss,$-9.00,$-115.50,$235797.50,417,$-115.50
2025-08-07,07:09:00,23486.25,BUY,3,0.02h,Break Even,$-1.50,$-117.00,$235796.00,417,$-117.00
2025-08-07,07:29:00,23486.0,SELL,3,0.02h,Stop Loss,$19.50,$-97.50,$235815.50,417,$-97.50
2025-08-07,07:41:00,23499.75,BUY,3,0.02h,Stop Loss,$-9.00,$-106.50,$235806.50,417,$-106.50
2025-08-07,08:41:00,23543.75,SELL,3,0.02h,Stop Loss,$-9.00,$-115.50,$235797.50,417,$-115.50
2025-08-07,08:49:00,23550.5,BUY,3,0.02h,Break Even,$-1.50,$-117.00,$235796.00,417,$-117.00
2025-08-07,09:03:00,23541.0,SELL,3,0.02h,Break Even,$-1.50,$-118.50,$235794.50,417,$-118.50
2025-08-07,09:11:00,23555.75,BUY,3,0.02h,Stop Loss,$-9.00,$-127.50,$235785.50,417,$-127.50
2025-08-07,10:27:00,23605.25,SELL,3,0.02h,Break Even,$-1.50,$-129.00,$235784.00,417,$-129.00
2025-08-07,10:40:00,23615.25,BUY,3,0.02h,Stop Loss,$-9.00,$-138.00,$235775.00,417,$-138.00
2025-08-07,10:43:00,23603.0,SELL,3,0.02h,Stop Loss,$-9.00,$-147.00,$235766.00,417,$-147.00
2025-08-07,10:46:00,23615.0,BUY,3,0.02h,Break Even,$-1.50,$-148.50,$235764.50,417,$-148.50
2025-08-07,11:07:00,23611.75,SELL,3,0.02h,Stop Loss,$-9.00,$-157.50,$235755.50,417,$-157.50
2025-08-07,11:08:00,23619.25,BUY,3,0.02h,Break Even,$-1.50,$-159.00,$235754.00,417,$-159.00
2025-08-07,11:09:00,23613.75,SELL,3,0.02h,Stop Loss,$16.50,$-142.50,$235770.50,417,$-142.50
2025-08-07,11:19:00,23617.25,BUY,3,0.02h,Stop Loss,$25.50,$-117.00,$235796.00,417,$-117.00
2025-08-07,11:25:00,23609.5,SELL,3,0.02h,Stop Loss,$-9.00,$-126.00,$235787.00,417,$-126.00
2025-08-07,12:15:00,23590.5,BUY,3,0.02h,Stop Loss,$10.50,$-115.50,$235797.50,417,$-115.50
2025-08-07,13:00:00,23597.5,SELL,3,0.02h,Break Even,$-1.50,$-117.00,$235796.00,417,$-117.00
2025-08-07,13:04:00,23609.75,BUY,3,0.02h,Stop Loss,$21.00,$-96.00,$235817.00,417,$-96.00
2025-08-07,13:27:00,23604.0,SELL,3,0.02h,Stop Loss,$15.00,$-81.00,$235832.00,417,$-81.00
2025-08-07,13:34:00,23624.75,BUY,3,0.02h,Stop Loss,$18.00,$-63.00,$235850.00,417,$-63.00
2025-08-07,13:46:00,23580.75,SELL,3,0.02h,Stop Loss,$46.50,$-16.50,$235896.50,417,$-16.50
2025-08-07,13:54:00,23615.5,BUY,3,0.02h,Stop Loss,$27.00,$10.50,$235923.50,417,$10.50
2025-08-07,14:11:00,23592.75,SELL,3,0.02h,Break Even,$-1.50,$9.00,$235922.00,417,$9.00
2025-08-07,14:46:00,23589.75,BUY,3,0.02h,Stop Loss,$-9.00,$0.00,$235913.00,417,$0.00
2025-08-07,14:47:00,23560.0,SELL,3,0.02h,Stop Loss,$25.50,$25.50,$235938.50,417,$25.50
2025-08-07,15:21:00,23555.25,BUY,3,0.02h,Break Even,$-1.50,$24.00,$235937.00,417,$24.00
2025-08-07,15:27:00,23512.75,SELL,3,0.02h,Stop Loss,$49.50,$73.50,$235986.50,417,$73.50
2025-08-07,15:57:00,23517.5,BUY,3,0.02h,Stop Loss,$9.00,$82.50,$235995.50,417,$82.50
2025-08-07,16:00:00,23497.75,SELL,3,0.02h,Break Even,$-1.50,$81.00,$235994.00,417,$81.00
2025-08-07,16:17:00,23513.25,BUY,3,0.02h,Stop Loss,$-9.00,$72.00,$235985.00,417,$72.00
2025-08-07,16:37:00,23495.5,SELL,3,0.02h,Stop Loss,$88.50,$160.50,$236073.50,417,$160.50
2025-08-07,16:56:00,23477.5,BUY,3,0.02h,Stop Loss,$21.00,$181.50,$236094.50,417,$181.50
2025-08-07,17:05:00,23446.5,SELL,3,0.02h,Stop Loss,$33.00,$214.50,$236127.50,417,$214.50
2025-08-07,17:49:00,23422.0,BUY,3,0.02h,Break Even,$-1.50,$213.00,$236126.00,417,$213.00
2025-08-07,17:51:00,23404.75,SELL,3,0.02h,Break Even,$-1.50,$211.50,$236124.50,417,$211.50
2025-08-07,17:54:00,23427.25,BUY,3,0.02h,Stop Loss,$-9.00,$202.50,$236115.50,417,$202.50
2025-08-07,18:03:00,23405.25,SELL,3,0.02h,Stop Loss,$-9.00,$193.50,$236106.50,417,$193.50
2025-08-07,18:04:00,23425.0,BUY,3,0.02h,Stop Loss,$3.00,$196.50,$236109.50,417,$196.50
2025-08-07,18:05:00,23413.25,SELL,3,0.02h,Stop Loss,$7.50,$204.00,$236117.00,417,$204.00
2025-08-07,18:37:00,23367.25,BUY,3,0.02h,Stop Loss,$27.00,$231.00,$236144.00,417,$231.00
2025-08-07,18:45:00,23351.0,SELL,3,0.02h,Break Even,$-1.50,$229.50,$236142.50,417,$229.50
2025-08-07,18:48:00,23378.0,BUY,3,0.02h,Stop Loss,$-9.00,$220.50,$236133.50,417,$220.50
2025-08-07,19:21:00,23395.25,SELL,3,0.02h,Break Even,$-1.50,$219.00,$236132.00,417,$219.00
2025-08-07,19:22:00,23397.5,BUY,3,0.02h,Stop Loss,$6.00,$225.00,$236138.00,417,$225.00
2025-08-07,19:23:00,23394.25,SELL,3,0.02h,Stop Loss,$16.50,$241.50,$236154.50,417,$241.50
2025-08-07,19:31:00,23409.5,BUY,3,0.02h,Stop Loss,$67.50,$309.00,$236222.00,417,$309.00
2025-08-07,20:33:00,23505.0,SELL,3,0.02h,Stop Loss,$-9.00,$300.00,$236213.00,417,$300.00
2025-08-07,20:52:00,23512.0,BUY,3,0.02h,Stop Loss,$-9.00,$291.00,$236204.00,417,$291.00
2025-08-07,23:36:00,23544.5,SELL,3,0.02h,Break Even,$-1.50,$289.50,$236202.50,417,$289.50
,,,,,,,,,,,
2025-08-08,00:11:00,23547.5,BUY,3,0.02h,Stop Loss,$28.50,$28.50,$236231.00,418,$28.50
2025-08-08,00:52:00,23561.25,SELL,3,0.02h,Stop Loss,$-9.00,$19.50,$236222.00,418,$19.50
2025-08-08,01:01:00,23576.5,BUY,3,0.02h,Stop Loss,$-9.00,$10.50,$236213.00,418,$10.50
2025-08-08,01:12:00,23566.5,SELL,3,0.02h,Break Even,$-1.50,$9.00,$236211.50,418,$9.00
2025-08-08,01:32:00,23569.5,BUY,3,0.02h,Stop Loss,$-9.00,$0.00,$236202.50,418,$0.00
2025-08-08,01:38:00,23561.75,SELL,3,0.02h,Stop Loss,$-9.00,$-9.00,$236193.50,418,$-9.00
2025-08-08,01:42:00,23566.75,BUY,3,0.02h,Stop Loss,$-9.00,$-18.00,$236184.50,418,$-18.00
2025-08-08,01:44:00,23561.25,SELL,3,0.02h,Stop Loss,$-9.00,$-27.00,$236175.50,418,$-27.00
2025-08-08,01:50:00,23566.0,BUY,3,0.02h,Break Even,$-1.50,$-28.50,$236174.00,418,$-28.50
2025-08-08,01:57:00,23562.25,SELL,3,0.02h,Break Even,$-1.50,$-30.00,$236172.50,418,$-30.00
2025-08-08,02:03:00,23566.0,BUY,3,0.02h,Break Even,$-1.50,$-31.50,$236171.00,418,$-31.50
2025-08-08,02:50:00,23574.25,SELL,3,0.03h,Break Even,$-1.50,$-33.00,$236169.50,418,$-33.00
2025-08-08,03:03:00,23577.0,BUY,3,0.02h,Stop Loss,$-9.00,$-42.00,$236160.50,418,$-42.00
2025-08-08,03:05:00,23571.5,SELL,3,0.02h,Stop Loss,$-9.00,$-51.00,$236151.50,418,$-51.00
2025-08-08,03:14:00,23576.5,BUY,3,0.02h,Break Even,$-1.50,$-52.50,$236150.00,418,$-52.50
2025-08-08,03:15:00,23574.25,SELL,3,0.02h,Break Even,$-1.50,$-54.00,$236148.50,418,$-54.00
2025-08-08,04:32:00,23551.5,BUY,3,0.02h,Break Even,$-1.50,$-55.50,$236147.00,418,$-55.50
2025-08-08,04:42:00,23543.5,SELL,3,0.02h,Stop Loss,$9.00,$-46.50,$236156.00,418,$-46.50
2025-08-08,05:03:00,23546.75,BUY,3,0.02h,Break Even,$-1.50,$-48.00,$236154.50,418,$-48.00
2025-08-08,05:20:00,23542.0,SELL,3,0.02h,Stop Loss,$-9.00,$-57.00,$236145.50,418,$-57.00
2025-08-08,06:16:00,23525.75,BUY,3,0.02h,Stop Loss,$12.00,$-45.00,$236157.50,418,$-45.00
2025-08-08,06:48:00,23539.25,SELL,3,0.02h,Break Even,$-1.50,$-46.50,$236156.00,418,$-46.50
2025-08-08,07:18:00,23544.5,BUY,3,0.02h,Break Even,$-1.50,$-48.00,$236154.50,418,$-48.00
2025-08-08,07:46:00,23540.0,SELL,3,0.02h,Break Even,$-1.50,$-49.50,$236153.00,418,$-49.50
2025-08-08,08:03:00,23549.5,BUY,3,0.02h,Break Even,$-1.50,$-51.00,$236151.50,418,$-51.00
2025-08-08,08:45:00,23549.5,SELL,3,0.02h,Stop Loss,$-9.00,$-60.00,$236142.50,418,$-60.00
2025-08-08,08:50:00,23554.5,BUY,3,0.02h,Stop Loss,$-9.00,$-69.00,$236133.50,418,$-69.00
2025-08-08,09:38:00,23566.25,SELL,3,0.02h,Stop Loss,$-9.00,$-78.00,$236124.50,418,$-78.00
2025-08-08,10:03:00,23571.25,BUY,3,0.02h,Stop Loss,$-9.00,$-87.00,$236115.50,418,$-87.00
2025-08-08,10:16:00,23566.25,SELL,3,0.02h,Break Even,$-1.50,$-88.50,$236114.00,418,$-88.50
2025-08-08,10:37:00,23568.0,BUY,3,0.02h,Stop Loss,$-9.00,$-97.50,$236105.00,418,$-97.50
2025-08-08,10:59:00,23566.75,SELL,3,0.02h,Stop Loss,$-9.00,$-106.50,$236096.00,418,$-106.50
2025-08-08,11:13:00,23572.75,BUY,3,0.02h,Break Even,$-1.50,$-108.00,$236094.50,418,$-108.00
2025-08-08,11:57:00,23577.0,SELL,3,0.02h,Break Even,$-1.50,$-109.50,$236093.00,418,$-109.50
2025-08-08,12:48:00,23537.75,BUY,3,0.02h,Break Even,$-1.50,$-111.00,$236091.50,418,$-111.00
2025-08-08,12:58:00,23531.25,SELL,3,0.02h,Stop Loss,$-9.00,$-120.00,$236082.50,418,$-120.00
2025-08-08,13:01:00,23542.25,BUY,3,0.02h,Stop Loss,$10.50,$-109.50,$236093.00,418,$-109.50
2025-08-08,13:07:00,23530.25,SELL,3,0.02h,Break Even,$-1.50,$-111.00,$236091.50,418,$-111.00
2025-08-08,13:25:00,23534.0,BUY,3,0.02h,Stop Loss,$18.00,$-93.00,$236109.50,418,$-93.00
2025-08-08,14:52:00,23670.75,SELL,3,0.02h,Stop Loss,$15.00,$-78.00,$236124.50,418,$-78.00
2025-08-08,15:10:00,23673.25,BUY,3,0.02h,Break Even,$-1.50,$-79.50,$236123.00,418,$-79.50
2025-08-08,15:12:00,23656.0,SELL,3,0.02h,Stop Loss,$-9.00,$-88.50,$236114.00,418,$-88.50
2025-08-08,15:15:00,23679.5,BUY,3,0.02h,Break Even,$-1.50,$-90.00,$236112.50,418,$-90.00
2025-08-08,15:30:00,23666.0,SELL,3,0.02h,Stop Loss,$82.50,$-7.50,$236195.00,418,$-7.50
2025-08-08,15:52:00,23651.5,BUY,3,0.02h,Stop Loss,$19.50,$12.00,$236214.50,418,$12.00
2025-08-08,16:38:00,23685.75,SELL,3,0.02h,Stop Loss,$-9.00,$3.00,$236205.50,418,$3.00
2025-08-08,16:39:00,23692.25,BUY,3,0.02h,Break Even,$-1.50,$1.50,$236204.00,418,$1.50
2025-08-08,16:50:00,23687.5,SELL,3,0.02h,Stop Loss,$6.00,$7.50,$236210.00,418,$7.50
2025-08-08,17:25:00,23677.0,BUY,3,0.02h,Stop Loss,$-9.00,$-1.50,$236201.00,418,$-1.50
2025-08-08,17:26:00,23665.25,SELL,3,0.02h,Stop Loss,$24.00,$22.50,$236225.00,418,$22.50
2025-08-08,17:34:00,23676.75,BUY,3,0.02h,Stop Loss,$-9.00,$13.50,$236216.00,418,$13.50
2025-08-08,18:26:00,23696.25,SELL,3,0.02h,Stop Loss,$19.50,$33.00,$236235.50,418,$33.00
2025-08-08,18:33:00,23710.0,BUY,3,0.02h,Stop Loss,$3.00,$36.00,$236238.50,418,$36.00
2025-08-08,18:42:00,23707.25,SELL,3,0.02h,Break Even,$-1.50,$34.50,$236237.00,418,$34.50
2025-08-08,18:49:00,23711.75,BUY,3,0.02h,Break Even,$-1.50,$33.00,$236235.50,418,$33.00
2025-08-08,19:03:00,23704.5,SELL,3,0.02h,Stop Loss,$-9.00,$24.00,$236226.50,418,$24.00
2025-08-08,19:19:00,23711.5,BUY,3,0.02h,Stop Loss,$18.00,$42.00,$236244.50,418,$42.00
2025-08-08,19:28:00,23707.75,SELL,3,0.02h,Break Even,$-1.50,$40.50,$236243.00,418,$40.50
2025-08-08,19:55:00,23712.0,BUY,3,0.02h,Stop Loss,$-9.00,$31.50,$236234.00,418,$31.50
2025-08-08,20:49:00,23748.5,SELL,3,0.02h,Break Even,$-1.50,$30.00,$236232.50,418,$30.00
2025-08-08,20:56:00,23753.25,BUY,3,0.02h,Stop Loss,$13.50,$43.50,$236246.00,418,$43.50
,,,,,,,,,,,
2025-08-11,00:00:00,23707.75,SELL,3,0.02h,Stop Loss,$-9.00,$-9.00,$236237.00,419,$-9.00
2025-08-11,00:22:00,23735.0,BUY,3,0.02h,Stop Loss,$-9.00,$-18.00,$236228.00,419,$-18.00
2025-08-11,00:48:00,23732.25,SELL,3,0.02h,Stop Loss,$-9.00,$-27.00,$236219.00,419,$-27.00
2025-08-11,01:04:00,23738.0,BUY,3,0.02h,Stop Loss,$-9.00,$-36.00,$236210.00,419,$-36.00
2025-08-11,01:10:00,23732.25,SELL,3,0.02h,Break Even,$-1.50,$-37.50,$236208.50,419,$-37.50
2025-08-11,01:12:00,23734.0,BUY,3,0.02h,Break Even,$-1.50,$-39.00,$236207.00,419,$-39.00
2025-08-11,02:29:00,23757.75,SELL,3,0.02h,Stop Loss,$-9.00,$-48.00,$236198.00,419,$-48.00
2025-08-11,03:03:00,23758.5,BUY,3,0.03h,Break Even,$-1.50,$-49.50,$236196.50,419,$-49.50
2025-08-11,03:08:00,23755.5,SELL,3,0.02h,Stop Loss,$-9.00,$-58.50,$236187.50,419,$-58.50
2025-08-11,03:10:00,23760.25,BUY,3,0.02h,Break Even,$-1.50,$-60.00,$236186.00,419,$-60.00
2025-08-11,03:27:00,23758.0,SELL,3,0.02h,Stop Loss,$-9.00,$-69.00,$236177.00,419,$-69.00
2025-08-11,04:14:00,23757.25,BUY,3,0.02h,Break Even,$-1.50,$-70.50,$236175.50,419,$-70.50
2025-08-11,04:23:00,23753.5,SELL,3,0.03h,Break Even,$-1.50,$-72.00,$236174.00,419,$-72.00
2025-08-11,05:00:00,23742.0,BUY,3,0.02h,Stop Loss,$-9.00,$-81.00,$236165.00,419,$-81.00
2025-08-11,05:01:00,23738.75,SELL,3,0.02h,Stop Loss,$-9.00,$-90.00,$236156.00,419,$-90.00
2025-08-11,05:03:00,23743.25,BUY,3,0.02h,Stop Loss,$-9.00,$-99.00,$236147.00,419,$-99.00
2025-08-11,05:14:00,23741.0,SELL,3,0.02h,Break Even,$-1.50,$-100.50,$236145.50,419,$-100.50
2025-08-11,05:27:00,23743.75,BUY,3,0.02h,Stop Loss,$-9.00,$-109.50,$236136.50,419,$-109.50
2025-08-11,05:29:00,23738.0,SELL,3,0.02h,Stop Loss,$-9.00,$-118.50,$236127.50,419,$-118.50
2025-08-11,05:35:00,23743.0,BUY,3,0.02h,Stop Loss,$-9.00,$-127.50,$236118.50,419,$-127.50
2025-08-11,05:43:00,23735.75,SELL,3,0.02h,Break Even,$-1.50,$-129.00,$236117.00,419,$-129.00
2025-08-11,06:01:00,23746.75,BUY,3,0.02h,Stop Loss,$4.50,$-124.50,$236121.50,419,$-124.50
2025-08-11,06:14:00,23737.5,SELL,3,0.02h,Break Even,$-1.50,$-126.00,$236120.00,419,$-126.00
2025-08-11,06:37:00,23740.0,BUY,3,0.02h,Stop Loss,$-9.00,$-135.00,$236111.00,419,$-135.00
2025-08-11,07:16:00,23747.5,SELL,3,0.02h,Stop Loss,$-9.00,$-144.00,$236102.00,419,$-144.00
2025-08-11,08:29:00,23693.25,BUY,3,0.02h,Stop Loss,$-9.00,$-153.00,$236093.00,419,$-153.00
2025-08-11,08:53:00,23693.5,SELL,3,0.02h,Stop Loss,$-9.00,$-162.00,$236084.00,419,$-162.00
2025-08-11,08:57:00,23697.5,BUY,3,0.02h,Stop Loss,$3.00,$-159.00,$236087.00,419,$-159.00
2025-08-11,09:57:00,23721.25,SELL,3,0.02h,Stop Loss,$-9.00,$-168.00,$236078.00,419,$-168.00
2025-08-11,10:06:00,23725.25,BUY,3,0.02h,Stop Loss,$-9.00,$-177.00,$236069.00,419,$-177.00
2025-08-11,10:08:00,23720.0,SELL,3,0.02h,Stop Loss,$-9.00,$-186.00,$236060.00,419,$-186.00
2025-08-11,10:15:00,23726.0,BUY,3,0.02h,Break Even,$-1.50,$-187.50,$236058.50,419,$-187.50
2025-08-11,10:39:00,23728.75,SELL,3,0.02h,Stop Loss,$-9.00,$-196.50,$236049.50,419,$-196.50
2025-08-11,11:01:00,23734.0,BUY,3,0.02h,Break Even,$-1.50,$-198.00,$236048.00,419,$-198.00
2025-08-11,11:23:00,23720.75,SELL,3,0.02h,Stop Loss,$-9.00,$-207.00,$236039.00,419,$-207.00
2025-08-11,11:42:00,23728.0,BUY,3,0.02h,Stop Loss,$-9.00,$-216.00,$236030.00,419,$-216.00
2025-08-11,12:24:00,23734.0,SELL,3,0.02h,Stop Loss,$-9.00,$-225.00,$236021.00,419,$-225.00
2025-08-11,13:16:00,23723.5,BUY,3,0.02h,Break Even,$-1.50,$-226.50,$236019.50,419,$-226.50
2025-08-11,13:26:00,23714.0,SELL,3,0.02h,Break Even,$-1.50,$-228.00,$236018.00,419,$-228.00
2025-08-11,13:43:00,23727.75,BUY,3,0.02h,Stop Loss,$40.50,$-187.50,$236058.50,419,$-187.50
2025-08-11,14:37:00,23748.75,SELL,3,0.02h,Break Even,$-1.50,$-189.00,$236057.00,419,$-189.00
2025-08-11,14:38:00,23751.5,BUY,3,0.02h,Stop Loss,$30.00,$-159.00,$236087.00,419,$-159.00
2025-08-11,14:41:00,23743.75,SELL,3,0.02h,Break Even,$-1.50,$-160.50,$236085.50,419,$-160.50
2025-08-11,14:42:00,23755.5,BUY,3,0.02h,Stop Loss,$-9.00,$-169.50,$236076.50,419,$-169.50
2025-08-11,14:43:00,23747.5,SELL,3,0.02h,Stop Loss,$-9.00,$-178.50,$236067.50,419,$-178.50
2025-08-11,14:46:00,23755.5,BUY,3,0.02h,Break Even,$-1.50,$-180.00,$236066.00,419,$-180.00
2025-08-11,14:47:00,23742.25,SELL,3,0.02h,Stop Loss,$54.00,$-126.00,$236120.00,419,$-126.00
2025-08-11,15:15:00,23747.25,BUY,3,0.02h,Break Even,$-1.50,$-127.50,$236118.50,419,$-127.50
2025-08-11,15:28:00,23736.5,SELL,3,0.02h,Break Even,$-1.50,$-129.00,$236117.00,419,$-129.00
2025-08-11,15:35:00,23742.5,BUY,3,0.02h,Stop Loss,$-9.00,$-138.00,$236108.00,419,$-138.00
2025-08-11,15:38:00,23733.75,SELL,3,0.02h,Stop Loss,$39.00,$-99.00,$236147.00,419,$-99.00
2025-08-11,15:50:00,23739.75,BUY,3,0.02h,Stop Loss,$33.00,$-66.00,$236180.00,419,$-66.00
2025-08-11,16:37:00,23771.25,SELL,3,0.02h,Break Even,$-1.50,$-67.50,$236178.50,419,$-67.50
2025-08-11,18:33:00,23695.5,BUY,3,0.02h,Break Even,$-1.50,$-69.00,$236177.00,419,$-69.00
2025-08-11,18:44:00,23680.5,SELL,3,0.02h,Stop Loss,$123.00,$54.00,$236300.00,419,$54.00
2025-08-11,18:59:00,23691.75,BUY,3,0.02h,Stop Loss,$-9.00,$45.00,$236291.00,419,$45.00
2025-08-11,19:04:00,23678.5,SELL,3,0.02h,Stop Loss,$-9.00,$36.00,$236282.00,419,$36.00
2025-08-11,20:06:00,23639.5,BUY,3,0.02h,Stop Loss,$6.00,$42.00,$236288.00,419,$42.00
2025-08-11,20:16:00,23628.5,SELL,3,0.02h,Stop Loss,$12.00,$54.00,$236300.00,419,$54.00
2025-08-11,20:43:00,23626.5,BUY,3,0.02h,Stop Loss,$-9.00,$45.00,$236291.00,419,$45.00
2025-08-11,20:58:00,23624.25,SELL,3,0.02h,Stop Loss,$-9.00,$36.00,$236282.00,419,$36.00
2025-08-11,21:00:00,23630.0,BUY,3,2.00h,Stop Loss,$49.50,$85.50,$236331.50,419,$85.50
2025-08-11,23:26:00,23634.5,SELL,3,0.02h,Stop Loss,$-9.00,$76.50,$236322.50,419,$76.50
2025-08-11,23:46:00,23640.25,BUY,3,0.02h,Break Even,$-1.50,$75.00,$236321.00,419,$75.00
2025-08-11,23:53:00,23634.5,SELL,3,0.02h,Break Even,$-1.50,$73.50,$236319.50,419,$73.50
,,,,,,,,,,,
2025-08-12,00:03:00,23643.75,BUY,3,0.02h,Stop Loss,$-9.00,$-9.00,$236310.50,420,$-9.00
2025-08-12,00:11:00,23633.5,SELL,3,0.02h,Stop Loss,$-9.00,$-18.00,$236301.50,420,$-18.00
2025-08-12,00:15:00,23640.25,BUY,3,0.02h,Stop Loss,$-9.00,$-27.00,$236292.50,420,$-27.00
2025-08-12,00:45:00,23653.0,SELL,3,0.02h,Break Even,$-1.50,$-28.50,$236291.00,420,$-28.50
2025-08-12,01:27:00,23643.25,BUY,3,0.02h,Stop Loss,$-9.00,$-37.50,$236282.00,420,$-37.50
2025-08-12,01:31:00,23639.75,SELL,3,0.02h,Break Even,$-1.50,$-39.00,$236280.50,420,$-39.00
2025-08-12,01:37:00,23650.0,BUY,3,0.02h,Stop Loss,$-9.00,$-48.00,$236271.50,420,$-48.00
2025-08-12,02:30:00,23654.75,SELL,3,0.02h,Stop Loss,$-9.00,$-57.00,$236262.50,420,$-57.00
2025-08-12,03:05:00,23657.75,BUY,3,0.02h,Break Even,$-1.50,$-58.50,$236261.00,420,$-58.50
2025-08-12,03:16:00,23652.25,SELL,3,0.02h,Stop Loss,$-9.00,$-67.50,$236252.00,420,$-67.50
2025-08-12,03:18:00,23656.75,BUY,3,0.02h,Stop Loss,$-9.00,$-76.50,$236243.00,420,$-76.50
2025-08-12,03:19:00,23655.75,SELL,3,0.02h,Stop Loss,$-9.00,$-85.50,$236234.00,420,$-85.50
2025-08-12,03:20:00,23656.25,BUY,3,0.02h,Break Even,$-1.50,$-87.00,$236232.50,420,$-87.00
2025-08-12,03:44:00,23656.75,SELL,3,0.02h,Stop Loss,$-9.00,$-96.00,$236223.50,420,$-96.00
2025-08-12,04:30:00,23655.25,BUY,3,0.02h,Stop Loss,$-9.00,$-105.00,$236214.50,420,$-105.00
2025-08-12,04:31:00,23651.25,SELL,3,0.02h,Stop Loss,$-9.00,$-114.00,$236205.50,420,$-114.00
2025-08-12,04:33:00,23655.5,BUY,3,0.02h,Break Even,$-1.50,$-115.50,$236204.00,420,$-115.50
2025-08-12,05:03:00,23621.5,SELL,3,0.02h,Stop Loss,$96.00,$-19.50,$236300.00,420,$-19.50
2025-08-12,05:55:00,23625.5,BUY,3,0.02h,Stop Loss,$13.50,$-6.00,$236313.50,420,$-6.00
2025-08-12,06:20:00,23630.75,SELL,3,0.02h,Stop Loss,$-9.00,$-15.00,$236304.50,420,$-15.00
2025-08-12,06:21:00,23633.0,BUY,3,0.02h,Stop Loss,$-9.00,$-24.00,$236295.50,420,$-24.00
2025-08-12,06:22:00,23628.25,SELL,3,0.02h,Stop Loss,$-9.00,$-33.00,$236286.50,420,$-33.00
2025-08-12,06:23:00,23636.25,BUY,3,0.02h,Stop Loss,$34.50,$1.50,$236321.00,420,$1.50
2025-08-12,07:00:00,23648.75,SELL,3,0.02h,Break Even,$-1.50,$0.00,$236319.50,420,$0.00
2025-08-12,07:07:00,23661.75,BUY,3,0.02h,Stop Loss,$36.00,$36.00,$236355.50,420,$36.00
2025-08-12,07:22:00,23651.5,SELL,3,0.02h,Stop Loss,$4.50,$40.50,$236360.00,420,$40.50
2025-08-12,07:27:00,23672.25,BUY,3,0.02h,Break Even,$-1.50,$39.00,$236358.50,420,$39.00
2025-08-12,07:32:00,23655.0,SELL,3,0.02h,Stop Loss,$30.00,$69.00,$236388.50,420,$69.00
2025-08-12,07:48:00,23658.25,BUY,3,0.02h,Stop Loss,$-9.00,$60.00,$236379.50,420,$60.00
2025-08-12,08:11:00,23657.25,SELL,3,0.02h,Stop Loss,$3.00,$63.00,$236382.50,420,$63.00
2025-08-12,09:07:00,23644.75,BUY,3,0.02h,Stop Loss,$-9.00,$54.00,$236373.50,420,$54.00
2025-08-12,09:13:00,23640.25,SELL,3,0.02h,Break Even,$-1.50,$52.50,$236372.00,420,$52.50
2025-08-12,09:16:00,23644.75,BUY,3,0.02h,Stop Loss,$-9.00,$43.50,$236363.00,420,$43.50
2025-08-12,09:17:00,23641.25,SELL,3,0.02h,Stop Loss,$-9.00,$34.50,$236354.00,420,$34.50
2025-08-12,09:19:00,23644.0,BUY,3,0.02h,Break Even,$-1.50,$33.00,$236352.50,420,$33.00
2025-08-12,09:25:00,23637.5,SELL,3,0.02h,Stop Loss,$-9.00,$24.00,$236343.50,420,$24.00
2025-08-12,09:29:00,23643.75,BUY,3,0.02h,Break Even,$-1.50,$22.50,$236342.00,420,$22.50
2025-08-12,09:35:00,23640.5,SELL,3,0.02h,Stop Loss,$-9.00,$13.50,$236333.00,420,$13.50
2025-08-12,09:37:00,23646.75,BUY,3,0.02h,Stop Loss,$-9.00,$4.50,$236324.00,420,$4.50
2025-08-12,09:44:00,23638.5,SELL,3,0.02h,Stop Loss,$-9.00,$-4.50,$236315.00,420,$-4.50
2025-08-12,09:49:00,23646.25,BUY,3,0.02h,Stop Loss,$-9.00,$-13.50,$236306.00,420,$-13.50
2025-08-12,09:57:00,23640.75,SELL,3,0.02h,Break Even,$-1.50,$-15.00,$236304.50,420,$-15.00
2025-08-12,10:16:00,23643.0,BUY,3,0.02h,Stop Loss,$-9.00,$-24.00,$236295.50,420,$-24.00
2025-08-12,10:30:00,23634.5,SELL,3,0.02h,Stop Loss,$-9.00,$-33.00,$236286.50,420,$-33.00
2025-08-12,10:31:00,23639.25,BUY,3,0.02h,Break Even,$-1.50,$-34.50,$236285.00,420,$-34.50
2025-08-12,10:32:00,23637.25,SELL,3,0.02h,Stop Loss,$-9.00,$-43.50,$236276.00,420,$-43.50
2025-08-12,10:53:00,23639.0,BUY,3,0.02h,Stop Loss,$-9.00,$-52.50,$236267.00,420,$-52.50
2025-08-12,10:55:00,23634.25,SELL,3,0.02h,Break Even,$-1.50,$-54.00,$236265.50,420,$-54.00
2025-08-12,10:56:00,23636.75,BUY,3,0.02h,Stop Loss,$-9.00,$-63.00,$236256.50,420,$-63.00
2025-08-12,10:57:00,23633.25,SELL,3,0.02h,Stop Loss,$-9.00,$-72.00,$236247.50,420,$-72.00
2025-08-12,11:23:00,23627.75,BUY,3,0.02h,Break Even,$-1.50,$-73.50,$236246.00,420,$-73.50
2025-08-12,11:28:00,23619.75,SELL,3,0.02h,Stop Loss,$-9.00,$-82.50,$236237.00,420,$-82.50
2025-08-12,11:32:00,23628.0,BUY,3,0.02h,Stop Loss,$21.00,$-61.50,$236258.00,420,$-61.50
2025-08-12,11:46:00,23622.75,SELL,3,0.02h,Break Even,$-1.50,$-63.00,$236256.50,420,$-63.00
2025-08-12,11:56:00,23632.0,BUY,3,0.02h,Stop Loss,$21.00,$-42.00,$236277.50,420,$-42.00
2025-08-12,13:03:00,23755.5,SELL,3,0.02h,Stop Loss,$39.00,$-3.00,$236316.50,420,$-3.00
2025-08-12,13:35:00,23780.0,BUY,3,0.02h,Stop Loss,$51.00,$48.00,$236367.50,420,$48.00
2025-08-12,13:49:00,23705.25,SELL,3,0.02h,Stop Loss,$115.50,$163.50,$236483.00,420,$163.50
2025-08-12,14:15:00,23721.75,BUY,3,0.02h,Stop Loss,$109.50,$273.00,$236592.50,420,$273.00
2025-08-12,16:08:00,23849.75,SELL,3,0.02h,Stop Loss,$-9.00,$264.00,$236583.50,420,$264.00
2025-08-12,16:15:00,23857.25,BUY,3,0.02h,Stop Loss,$24.00,$288.00,$236607.50,420,$288.00
2025-08-12,17:28:00,23892.0,SELL,3,0.02h,Stop Loss,$-9.00,$279.00,$236598.50,420,$279.00
2025-08-12,17:35:00,23906.25,BUY,3,0.02h,Stop Loss,$-9.00,$270.00,$236589.50,420,$270.00
2025-08-12,18:32:00,23911.75,SELL,3,0.02h,Stop Loss,$-9.00,$261.00,$236580.50,420,$261.00
2025-08-12,19:08:00,23916.0,BUY,3,0.02h,Stop Loss,$-9.00,$252.00,$236571.50,420,$252.00
2025-08-12,19:12:00,23903.0,SELL,3,0.02h,Stop Loss,$-9.00,$243.00,$236562.50,420,$243.00
2025-08-12,19:19:00,23916.0,BUY,3,0.02h,Break Even,$-1.50,$241.50,$236561.00,420,$241.50
2025-08-12,19:47:00,23921.5,SELL,3,0.02h,Stop Loss,$-9.00,$232.50,$236552.00,420,$232.50
2025-08-12,19:51:00,23932.75,BUY,3,0.02h,Stop Loss,$13.50,$246.00,$236565.50,420,$246.00
2025-08-12,20:13:00,23929.25,SELL,3,0.02h,Stop Loss,$-9.00,$237.00,$236556.50,420,$237.00
2025-08-12,20:16:00,23933.75,BUY,3,0.02h,Stop Loss,$-9.00,$228.00,$236547.50,420,$228.00
2025-08-12,20:43:00,23934.75,SELL,3,0.02h,Stop Loss,$-9.00,$219.00,$236538.50,420,$219.00
2025-08-12,20:48:00,23938.0,BUY,3,0.02h,Break Even,$-1.50,$217.50,$236537.00,420,$217.50
2025-08-12,23:02:00,23934.75,SELL,3,0.02h,Break Even,$-1.50,$216.00,$236535.50,420,$216.00
2025-08-12,23:10:00,23940.0,BUY,3,0.02h,Break Even,$-1.50,$214.50,$236534.00,420,$214.50
2025-08-12,23:18:00,23934.5,SELL,3,0.02h,Stop Loss,$-9.00,$205.50,$236525.00,420,$205.50
2025-08-12,23:26:00,23939.5,BUY,3,0.02h,Stop Loss,$-9.00,$196.50,$236516.00,420,$196.50
2025-08-12,23:34:00,23935.5,SELL,3,0.02h,Stop Loss,$-9.00,$187.50,$236507.00,420,$187.50
2025-08-12,23:42:00,23941.75,BUY,3,0.02h,Stop Loss,$3.00,$190.50,$236510.00,420,$190.50
,,,,,,,,,,,
2025-08-13,00:19:00,23949.5,SELL,3,0.02h,Break Even,$-1.50,$-1.50,$236508.50,421,$-1.50
2025-08-13,00:47:00,23953.25,BUY,3,0.02h,Stop Loss,$-9.00,$-10.50,$236499.50,421,$-10.50
2025-08-13,00:58:00,23943.75,SELL,3,0.02h,Stop Loss,$-9.00,$-19.50,$236490.50,421,$-19.50
2025-08-13,01:10:00,23946.0,BUY,3,0.02h,Stop Loss,$-9.00,$-28.50,$236481.50,421,$-28.50
2025-08-13,01:13:00,23942.0,SELL,3,0.02h,Stop Loss,$-9.00,$-37.50,$236472.50,421,$-37.50
2025-08-13,02:16:00,23933.5,BUY,3,0.02h,Stop Loss,$-9.00,$-46.50,$236463.50,421,$-46.50
2025-08-13,03:30:00,23942.75,SELL,3,0.02h,Break Even,$-1.50,$-48.00,$236462.00,421,$-48.00
2025-08-13,04:07:00,23948.75,BUY,3,0.02h,Break Even,$-1.50,$-49.50,$236460.50,421,$-49.50
2025-08-13,04:57:00,23955.25,SELL,3,0.03h,Stop Loss,$-9.00,$-58.50,$236451.50,421,$-58.50
2025-08-13,05:05:00,23959.0,BUY,3,0.02h,Stop Loss,$-9.00,$-67.50,$236442.50,421,$-67.50
2025-08-13,05:07:00,23957.0,SELL,3,0.02h,Stop Loss,$-9.00,$-76.50,$236433.50,421,$-76.50
2025-08-13,05:09:00,23958.5,BUY,3,0.03h,Stop Loss,$-9.00,$-85.50,$236424.50,421,$-85.50
2025-08-13,05:12:00,23955.5,SELL,3,0.02h,Stop Loss,$-9.00,$-94.50,$236415.50,421,$-94.50
2025-08-13,05:35:00,23955.0,BUY,3,0.02h,Stop Loss,$-9.00,$-103.50,$236406.50,421,$-103.50
2025-08-13,05:46:00,23953.0,SELL,3,0.02h,Break Even,$-1.50,$-105.00,$236405.00,421,$-105.00
2025-08-13,06:31:00,23951.75,BUY,3,0.02h,Break Even,$-1.50,$-106.50,$236403.50,421,$-106.50
2025-08-13,06:56:00,23957.75,SELL,3,0.03h,Break Even,$-1.50,$-108.00,$236402.00,421,$-108.00
2025-08-13,07:02:00,23962.25,BUY,3,0.02h,Stop Loss,$18.00,$-90.00,$236420.00,421,$-90.00
2025-08-13,08:44:00,23998.5,SELL,3,0.02h,Stop Loss,$9.00,$-81.00,$236429.00,421,$-81.00
2025-08-13,09:36:00,23991.5,BUY,3,0.02h,Break Even,$-1.50,$-82.50,$236427.50,421,$-82.50
2025-08-13,09:45:00,23990.0,SELL,3,0.02h,Stop Loss,$-9.00,$-91.50,$236418.50,421,$-91.50
2025-08-13,09:46:00,23996.0,BUY,3,0.02h,Stop Loss,$-9.00,$-100.50,$236409.50,421,$-100.50
2025-08-13,10:27:00,24000.25,SELL,3,0.02h,Stop Loss,$-9.00,$-109.50,$236400.50,421,$-109.50
2025-08-13,11:07:00,23995.75,BUY,3,0.02h,Stop Loss,$-9.00,$-118.50,$236391.50,421,$-118.50
2025-08-13,11:15:00,23992.0,SELL,3,0.02h,Break Even,$-1.50,$-120.00,$236390.00,421,$-120.00
2025-08-13,11:27:00,23999.75,BUY,3,0.02h,Stop Loss,$-9.00,$-129.00,$236381.00,421,$-129.00
2025-08-13,11:32:00,23990.25,SELL,3,0.02h,Stop Loss,$16.50,$-112.50,$236397.50,421,$-112.50
2025-08-13,11:41:00,23997.5,BUY,3,0.02h,Stop Loss,$-9.00,$-121.50,$236388.50,421,$-121.50
2025-08-13,11:46:00,23987.25,SELL,3,0.02h,Stop Loss,$-9.00,$-130.50,$236379.50,421,$-130.50
2025-08-13,11:50:00,23994.75,BUY,3,0.02h,Break Even,$-1.50,$-132.00,$236378.00,421,$-132.00
2025-08-13,11:52:00,23990.75,SELL,3,0.02h,Stop Loss,$3.00,$-129.00,$236381.00,421,$-129.00
2025-08-13,11:58:00,23994.5,BUY,3,0.02h,Stop Loss,$-9.00,$-138.00,$236372.00,421,$-138.00
2025-08-13,12:15:00,23992.5,SELL,3,0.02h,Stop Loss,$-9.00,$-147.00,$236363.00,421,$-147.00
2025-08-13,12:17:00,24000.5,BUY,3,0.02h,Stop Loss,$-9.00,$-156.00,$236354.00,421,$-156.00
2025-08-13,13:46:00,24032.0,SELL,3,0.02h,Stop Loss,$3.00,$-153.00,$236357.00,421,$-153.00
2025-08-13,13:51:00,24057.5,BUY,3,0.02h,Break Even,$-1.50,$-154.50,$236355.50,421,$-154.50
2025-08-13,13:56:00,24015.75,SELL,3,0.02h,Stop Loss,$43.50,$-111.00,$236399.00,421,$-111.00
2025-08-13,15:24:00,23945.0,BUY,3,0.02h,Stop Loss,$-9.00,$-120.00,$236390.00,421,$-120.00
2025-08-13,15:40:00,23930.5,SELL,3,0.02h,Stop Loss,$-9.00,$-129.00,$236381.00,421,$-129.00
2025-08-13,15:41:00,23939.5,BUY,3,0.02h,Stop Loss,$28.50,$-100.50,$236409.50,421,$-100.50
2025-08-13,15:54:00,23923.25,SELL,3,0.02h,Stop Loss,$12.00,$-88.50,$236421.50,421,$-88.50
2025-08-13,16:16:00,23936.75,BUY,3,0.02h,Break Even,$-1.50,$-90.00,$236420.00,421,$-90.00
2025-08-13,16:19:00,23927.5,SELL,3,0.02h,Stop Loss,$19.50,$-70.50,$236439.50,421,$-70.50
2025-08-13,17:04:00,23920.0,BUY,3,0.02h,Break Even,$-1.50,$-72.00,$236438.00,421,$-72.00
2025-08-13,17:10:00,23904.0,SELL,3,0.02h,Stop Loss,$3.00,$-69.00,$236441.00,421,$-69.00
2025-08-13,17:19:00,23915.25,BUY,3,0.02h,Stop Loss,$25.50,$-43.50,$236466.50,421,$-43.50
2025-08-13,17:35:00,23903.75,SELL,3,0.02h,Stop Loss,$-9.00,$-52.50,$236457.50,421,$-52.50
2025-08-13,17:54:00,23923.75,BUY,3,0.02h,Stop Loss,$-9.00,$-61.50,$236448.50,421,$-61.50
2025-08-13,18:27:00,23932.0,SELL,3,0.02h,Stop Loss,$9.00,$-52.50,$236457.50,421,$-52.50
2025-08-13,18:50:00,23928.25,BUY,3,0.02h,Break Even,$-1.50,$-54.00,$236456.00,421,$-54.00
2025-08-13,19:08:00,23926.25,SELL,3,0.02h,Break Even,$-1.50,$-55.50,$236454.50,421,$-55.50
2025-08-13,19:14:00,23934.0,BUY,3,0.02h,Stop Loss,$9.00,$-46.50,$236463.50,421,$-46.50
2025-08-13,19:31:00,23932.0,SELL,3,0.02h,Break Even,$-1.50,$-48.00,$236462.00,421,$-48.00
2025-08-13,19:52:00,23936.5,BUY,3,0.02h,Stop Loss,$42.00,$-6.00,$236504.00,421,$-6.00
2025-08-13,20:10:00,23931.5,SELL,3,0.02h,Stop Loss,$-9.00,$-15.00,$236495.00,421,$-15.00
2025-08-13,20:51:00,23929.5,BUY,3,0.02h,Stop Loss,$-9.00,$-24.00,$236486.00,421,$-24.00
2025-08-13,23:58:00,23950.75,SELL,3,0.02h,Break Even,$-1.50,$-25.50,$236484.50,421,$-25.50
,,,,,,,,,,,
2025-08-14,00:10:00,23955.75,BUY,3,0.02h,Stop Loss,$-9.00,$-9.00,$236475.50,422,$-9.00
2025-08-14,00:25:00,23951.25,SELL,3,0.02h,Stop Loss,$-9.00,$-18.00,$236466.50,422,$-18.00
2025-08-14,00:28:00,23956.5,BUY,3,0.02h,Break Even,$-1.50,$-19.50,$236465.00,422,$-19.50
2025-08-14,00:35:00,23952.5,SELL,3,0.02h,Stop Loss,$36.00,$16.50,$236501.00,422,$16.50
2025-08-14,01:51:00,23928.25,BUY,3,0.02h,Break Even,$-1.50,$15.00,$236499.50,422,$15.00
2025-08-14,02:24:00,23930.5,SELL,3,0.02h,Stop Loss,$-9.00,$6.00,$236490.50,422,$6.00
2025-08-14,02:44:00,23934.0,BUY,3,0.03h,Stop Loss,$-9.00,$-3.00,$236481.50,422,$-3.00
2025-08-14,02:49:00,23926.25,SELL,3,0.02h,Stop Loss,$-9.00,$-12.00,$236472.50,422,$-12.00
2025-08-14,02:55:00,23932.0,BUY,3,0.02h,Stop Loss,$9.00,$-3.00,$236481.50,422,$-3.00
2025-08-14,03:14:00,23934.5,SELL,3,0.02h,Stop Loss,$-9.00,$-12.00,$236472.50,422,$-12.00
2025-08-14,04:10:00,23928.75,BUY,3,0.03h,Break Even,$-1.50,$-13.50,$236471.00,422,$-13.50
2025-08-14,04:24:00,23923.25,SELL,3,0.02h,Break Even,$-1.50,$-15.00,$236469.50,422,$-15.00
2025-08-14,04:36:00,23930.25,BUY,3,0.03h,Break Even,$-1.50,$-16.50,$236468.00,422,$-16.50
2025-08-14,05:08:00,23930.0,SELL,3,0.02h,Stop Loss,$3.00,$-13.50,$236471.00,422,$-13.50
2025-08-14,05:33:00,23929.5,BUY,3,0.02h,Stop Loss,$-9.00,$-22.50,$236462.00,422,$-22.50
2025-08-14,05:39:00,23923.25,SELL,3,0.03h,Break Even,$-1.50,$-24.00,$236460.50,422,$-24.00
2025-08-14,06:08:00,23916.25,BUY,3,0.02h,Stop Loss,$-9.00,$-33.00,$236451.50,422,$-33.00
2025-08-14,06:11:00,23909.5,SELL,3,0.02h,Stop Loss,$-9.00,$-42.00,$236442.50,422,$-42.00
2025-08-14,06:33:00,23910.0,BUY,3,0.02h,Break Even,$-1.50,$-43.50,$236441.00,422,$-43.50
2025-08-14,07:49:00,23917.0,SELL,3,0.02h,Stop Loss,$-9.00,$-52.50,$236432.00,422,$-52.50
2025-08-14,07:56:00,23929.5,BUY,3,0.02h,Break Even,$-1.50,$-54.00,$236430.50,422,$-54.00
2025-08-14,08:39:00,23932.0,SELL,3,0.02h,Stop Loss,$6.00,$-48.00,$236436.50,422,$-48.00
2025-08-14,09:13:00,23925.5,BUY,3,0.02h,Stop Loss,$-9.00,$-57.00,$236427.50,422,$-57.00
2025-08-14,09:15:00,23923.0,SELL,3,0.02h,Stop Loss,$-9.00,$-66.00,$236418.50,422,$-66.00
2025-08-14,09:16:00,23927.0,BUY,3,0.02h,Break Even,$-1.50,$-67.50,$236417.00,422,$-67.50
2025-08-14,09:50:00,23930.0,SELL,3,0.02h,Stop Loss,$-9.00,$-76.50,$236408.00,422,$-76.50
2025-08-14,10:24:00,23929.0,BUY,3,0.02h,Break Even,$-1.50,$-78.00,$236406.50,422,$-78.00
2025-08-14,10:47:00,23929.25,SELL,3,0.02h,Stop Loss,$-9.00,$-87.00,$236397.50,422,$-87.00
2025-08-14,10:55:00,23933.25,BUY,3,0.02h,Stop Loss,$-9.00,$-96.00,$236388.50,422,$-96.00
2025-08-14,10:57:00,23928.25,SELL,3,0.02h,Stop Loss,$-9.00,$-105.00,$236379.50,422,$-105.00
2025-08-14,10:58:00,23931.25,BUY,3,0.02h,Break Even,$-1.50,$-106.50,$236378.00,422,$-106.50
2025-08-14,11:47:00,23943.0,SELL,3,0.03h,Stop Loss,$-9.00,$-115.50,$236369.00,422,$-115.50
2025-08-14,11:49:00,23945.25,BUY,3,0.02h,Break Even,$-1.50,$-117.00,$236367.50,422,$-117.00
2025-08-14,12:10:00,23947.5,SELL,3,0.02h,Stop Loss,$-9.00,$-126.00,$236358.50,422,$-126.00
2025-08-14,12:13:00,23956.0,BUY,3,0.03h,Stop Loss,$10.50,$-115.50,$236369.00,422,$-115.50
2025-08-14,12:27:00,23946.5,SELL,3,0.02h,Break Even,$-1.50,$-117.00,$236367.50,422,$-117.00
2025-08-14,13:14:00,23850.0,BUY,3,0.02h,Stop Loss,$-9.00,$-126.00,$236358.50,422,$-126.00
2025-08-14,13:20:00,23828.75,SELL,3,0.02h,Stop Loss,$6.00,$-120.00,$236364.50,422,$-120.00
2025-08-14,13:29:00,23853.25,BUY,3,0.02h,Stop Loss,$25.50,$-94.50,$236390.00,422,$-94.50
2025-08-14,14:12:00,23914.5,SELL,3,0.02h,Stop Loss,$27.00,$-67.50,$236417.00,422,$-67.50
2025-08-14,14:18:00,23933.75,BUY,3,0.02h,Stop Loss,$60.00,$-7.50,$236477.00,422,$-7.50
2025-08-14,14:58:00,23948.0,SELL,3,0.02h,Stop Loss,$22.50,$15.00,$236499.50,422,$15.00
2025-08-14,15:49:00,23919.0,BUY,3,0.02h,Stop Loss,$21.00,$36.00,$236520.50,422,$36.00
2025-08-14,16:07:00,23900.0,SELL,3,0.02h,Break Even,$-1.50,$34.50,$236519.00,422,$34.50
2025-08-14,16:26:00,23903.75,BUY,3,0.02h,Stop Loss,$-9.00,$25.50,$236510.00,422,$25.50
2025-08-14,16:28:00,23887.25,SELL,3,0.02h,Stop Loss,$28.50,$54.00,$236538.50,422,$54.00
2025-08-14,16:34:00,23898.5,BUY,3,0.02h,Stop Loss,$73.50,$127.50,$236612.00,422,$127.50
2025-08-14,17:40:00,23958.0,SELL,3,0.02h,Stop Loss,$91.50,$219.00,$236703.50,422,$219.00
2025-08-14,18:00:00,23962.5,BUY,3,0.02h,Stop Loss,$-9.00,$210.00,$236694.50,422,$210.00
2025-08-14,18:02:00,23951.0,SELL,3,0.02h,Stop Loss,$37.50,$247.50,$236732.00,422,$247.50
2025-08-14,18:45:00,23917.5,BUY,3,0.02h,Stop Loss,$-9.00,$238.50,$236723.00,422,$238.50
2025-08-14,19:31:00,23922.75,SELL,3,0.02h,Stop Loss,$-9.00,$229.50,$236714.00,422,$229.50
2025-08-14,19:38:00,23936.75,BUY,3,0.02h,Stop Loss,$16.50,$246.00,$236730.50,422,$246.00
2025-08-14,20:00:00,23921.25,SELL,3,0.02h,Stop Loss,$72.00,$318.00,$236802.50,422,$318.00
2025-08-14,20:38:00,23892.5,BUY,3,0.02h,Break Even,$-1.50,$316.50,$236801.00,422,$316.50
2025-08-14,20:43:00,23884.25,SELL,3,0.02h,Break Even,$-1.50,$315.00,$236799.50,422,$315.00
2025-08-14,20:48:00,23889.75,BUY,3,0.02h,Stop Loss,$-9.00,$306.00,$236790.50,422,$306.00
2025-08-14,20:50:00,23885.0,SELL,3,0.02h,Stop Loss,$-9.00,$297.00,$236781.50,422,$297.00
2025-08-14,20:51:00,23887.5,BUY,3,0.02h,Break Even,$-1.50,$295.50,$236780.00,422,$295.50
2025-08-14,20:53:00,23885.25,SELL,3,0.02h,Stop Loss,$-9.00,$286.50,$236771.00,422,$286.50
2025-08-14,21:00:00,23891.0,BUY,3,2.02h,Stop Loss,$37.50,$324.00,$236808.50,422,$324.00
2025-08-14,23:32:00,23899.25,SELL,3,0.02h,Stop Loss,$-9.00,$315.00,$236799.50,422,$315.00
2025-08-14,23:41:00,23906.25,BUY,3,0.02h,Break Even,$-1.50,$313.50,$236798.00,422,$313.50
2025-08-14,23:52:00,23893.25,SELL,3,0.02h,Stop Loss,$-9.00,$304.50,$236789.00,422,$304.50
,,,,,,,,,,,
2025-08-15,00:31:00,23890.0,BUY,3,0.02h,Stop Loss,$9.00,$9.00,$236798.00,423,$9.00
2025-08-15,00:53:00,23890.75,SELL,3,0.02h,Stop Loss,$-9.00,$0.00,$236789.00,423,$0.00
2025-08-15,01:06:00,23898.25,BUY,3,0.02h,Stop Loss,$-9.00,$-9.00,$236780.00,423,$-9.00
2025-08-15,01:15:00,23894.25,SELL,3,0.02h,Break Even,$-1.50,$-10.50,$236778.50,423,$-10.50
2025-08-15,01:25:00,23899.0,BUY,3,0.02h,Stop Loss,$-9.00,$-19.50,$236769.50,423,$-19.50
2025-08-15,02:34:00,23914.5,SELL,3,0.02h,Break Even,$-1.50,$-21.00,$236768.00,423,$-21.00
2025-08-15,02:54:00,23918.5,BUY,3,0.02h,Stop Loss,$-9.00,$-30.00,$236759.00,423,$-30.00
2025-08-15,03:13:00,23916.0,SELL,3,0.03h,Stop Loss,$-9.00,$-39.00,$236750.00,423,$-39.00
2025-08-15,03:19:00,23921.5,BUY,3,0.02h,Break Even,$-1.50,$-40.50,$236748.50,423,$-40.50
2025-08-15,03:25:00,23915.25,SELL,3,0.02h,Break Even,$-1.50,$-42.00,$236747.00,423,$-42.00
2025-08-15,03:32:00,23921.25,BUY,3,0.02h,Stop Loss,$-9.00,$-51.00,$236738.00,423,$-51.00
2025-08-15,03:35:00,23916.75,SELL,3,0.02h,Break Even,$-1.50,$-52.50,$236736.50,423,$-52.50
2025-08-15,03:48:00,23919.25,BUY,3,0.02h,Break Even,$-1.50,$-54.00,$236735.00,423,$-54.00
2025-08-15,04:53:00,23936.75,SELL,3,0.02h,Break Even,$-1.50,$-55.50,$236733.50,423,$-55.50
2025-08-15,05:06:00,23942.5,BUY,3,0.02h,Stop Loss,$-9.00,$-64.50,$236724.50,423,$-64.50
2025-08-15,05:10:00,23934.0,SELL,3,0.02h,Break Even,$-1.50,$-66.00,$236723.00,423,$-66.00
2025-08-15,05:36:00,23932.75,BUY,3,0.02h,Stop Loss,$7.50,$-58.50,$236730.50,423,$-58.50
2025-08-15,06:09:00,23939.0,SELL,3,0.02h,Stop Loss,$-9.00,$-67.50,$236721.50,423,$-67.50
2025-08-15,06:15:00,23942.75,BUY,3,0.02h,Break Even,$-1.50,$-69.00,$236720.00,423,$-69.00
2025-08-15,06:26:00,23939.75,SELL,3,0.02h,Stop Loss,$10.50,$-58.50,$236730.50,423,$-58.50
2025-08-15,06:33:00,23949.0,BUY,3,0.02h,Stop Loss,$-9.00,$-67.50,$236721.50,423,$-67.50
2025-08-15,07:15:00,23948.25,SELL,3,0.02h,Break Even,$-1.50,$-69.00,$236720.00,423,$-69.00
2025-08-15,08:04:00,23942.0,BUY,3,0.02h,Stop Loss,$31.50,$-37.50,$236751.50,423,$-37.50
2025-08-15,08:22:00,23942.0,SELL,3,0.02h,Break Even,$-1.50,$-39.00,$236750.00,423,$-39.00
2025-08-15,09:17:00,23894.0,BUY,3,0.02h,Stop Loss,$-9.00,$-48.00,$236741.00,423,$-48.00
2025-08-15,09:18:00,23888.25,SELL,3,0.02h,Stop Loss,$4.50,$-43.50,$236745.50,423,$-43.50
2025-08-15,09:48:00,23891.0,BUY,3,0.02h,Stop Loss,$-9.00,$-52.50,$236736.50,423,$-52.50
2025-08-15,09:58:00,23884.5,SELL,3,0.02h,Stop Loss,$10.50,$-42.00,$236747.00,423,$-42.00
2025-08-15,10:12:00,23887.5,BUY,3,0.02h,Stop Loss,$-9.00,$-51.00,$236738.00,423,$-51.00
2025-08-15,12:01:00,23918.75,SELL,3,0.03h,Stop Loss,$9.00,$-42.00,$236747.00,423,$-42.00
2025-08-15,12:37:00,23913.5,BUY,3,0.02h,Stop Loss,$-9.00,$-51.00,$236738.00,423,$-51.00
2025-08-15,12:39:00,23894.5,SELL,3,0.02h,Break Even,$-1.50,$-52.50,$236736.50,423,$-52.50
2025-08-15,12:48:00,23907.75,BUY,3,0.02h,Break Even,$-1.50,$-54.00,$236735.00,423,$-54.00
2025-08-15,13:01:00,23901.75,SELL,3,0.02h,Stop Loss,$-9.00,$-63.00,$236726.00,423,$-63.00
2025-08-15,13:20:00,23907.75,BUY,3,0.02h,Break Even,$-1.50,$-64.50,$236724.50,423,$-64.50
2025-08-15,13:26:00,23888.5,SELL,3,0.02h,Stop Loss,$-9.00,$-73.50,$236715.50,423,$-73.50
2025-08-15,13:29:00,23912.25,BUY,3,0.02h,Stop Loss,$39.00,$-34.50,$236754.50,423,$-34.50
2025-08-15,13:31:00,23861.25,SELL,3,0.02h,Stop Loss,$46.50,$12.00,$236801.00,423,$12.00
2025-08-15,14:05:00,23853.75,BUY,3,0.02h,Stop Loss,$33.00,$45.00,$236834.00,423,$45.00
2025-08-15,14:34:00,23837.75,SELL,3,0.02h,Break Even,$-1.50,$43.50,$236832.50,423,$43.50
2025-08-15,15:17:00,23815.75,BUY,3,0.02h,Stop Loss,$10.50,$54.00,$236843.00,423,$54.00
2025-08-15,15:27:00,23806.25,SELL,3,0.02h,Break Even,$-1.50,$52.50,$236841.50,423,$52.50
2025-08-15,15:54:00,23812.25,BUY,3,0.02h,Stop Loss,$6.00,$58.50,$236847.50,423,$58.50
2025-08-15,16:03:00,23773.0,SELL,3,0.02h,Stop Loss,$13.50,$72.00,$236861.00,423,$72.00
2025-08-15,16:09:00,23792.75,BUY,3,0.02h,Stop Loss,$4.50,$76.50,$236865.50,423,$76.50
2025-08-15,16:19:00,23778.5,SELL,3,0.02h,Stop Loss,$-9.00,$67.50,$236856.50,423,$67.50
2025-08-15,16:41:00,23790.75,BUY,3,0.02h,Break Even,$-1.50,$66.00,$236855.00,423,$66.00
2025-08-15,17:13:00,23802.75,SELL,3,0.02h,Break Even,$-1.50,$64.50,$236853.50,423,$64.50
2025-08-15,17:31:00,23815.5,BUY,3,0.02h,Stop Loss,$37.50,$102.00,$236891.00,423,$102.00
2025-08-15,17:48:00,23805.0,SELL,3,0.02h,Stop Loss,$-9.00,$93.00,$236882.00,423,$93.00
2025-08-15,17:56:00,23827.25,BUY,3,0.02h,Stop Loss,$25.50,$118.50,$236907.50,423,$118.50
2025-08-15,18:16:00,23811.25,SELL,3,0.02h,Break Even,$-1.50,$117.00,$236906.00,423,$117.00
2025-08-15,18:31:00,23823.75,BUY,3,0.02h,Stop Loss,$3.00,$120.00,$236909.00,423,$120.00
2025-08-15,18:37:00,23810.5,SELL,3,0.02h,Stop Loss,$-9.00,$111.00,$236900.00,423,$111.00
2025-08-15,18:56:00,23819.25,BUY,3,0.02h,Break Even,$-1.50,$109.50,$236898.50,423,$109.50
2025-08-15,18:59:00,23810.5,SELL,3,0.02h,Stop Loss,$7.50,$117.00,$236906.00,423,$117.00
2025-08-15,19:15:00,23807.75,BUY,3,0.02h,Stop Loss,$9.00,$126.00,$236915.00,423,$126.00
2025-08-15,19:19:00,23793.5,SELL,3,0.02h,Stop Loss,$-9.00,$117.00,$236906.00,423,$117.00
2025-08-15,19:23:00,23809.25,BUY,3,0.02h,Stop Loss,$9.00,$126.00,$236915.00,423,$126.00
2025-08-15,19:53:00,23805.25,SELL,3,0.02h,Break Even,$-1.50,$124.50,$236913.50,423,$124.50
2025-08-15,20:15:00,23809.0,BUY,3,0.02h,Break Even,$-1.50,$123.00,$236912.00,423,$123.00
2025-08-15,20:25:00,23796.5,SELL,3,0.02h,Stop Loss,$6.00,$129.00,$236918.00,423,$129.00
2025-08-15,20:55:00,23795.25,BUY,3,0.02h,Break Even,$-1.50,$127.50,$236916.50,423,$127.50
,,,,,,,,,,,
2025-08-18,00:51:00,23859.25,SELL,3,0.03h,Stop Loss,$-9.00,$-9.00,$236907.50,424,$-9.00
2025-08-18,01:11:00,23861.5,BUY,3,0.02h,Stop Loss,$-9.00,$-18.00,$236898.50,424,$-18.00
2025-08-18,02:22:00,23875.25,SELL,3,0.02h,Break Even,$-1.50,$-19.50,$236897.00,424,$-19.50
2025-08-18,02:39:00,23877.25,BUY,3,0.02h,Stop Loss,$-9.00,$-28.50,$236888.00,424,$-28.50
2025-08-18,02:51:00,23874.5,SELL,3,0.03h,Break Even,$-1.50,$-30.00,$236886.50,424,$-30.00
2025-08-18,02:57:00,23877.0,BUY,3,0.02h,Stop Loss,$-9.00,$-39.00,$236877.50,424,$-39.00
2025-08-18,03:20:00,23874.0,SELL,3,0.02h,Break Even,$-1.50,$-40.50,$236876.00,424,$-40.50
2025-08-18,04:29:00,23855.25,BUY,3,0.02h,Break Even,$-1.50,$-42.00,$236874.50,424,$-42.00
2025-08-18,04:46:00,23851.75,SELL,3,0.02h,Stop Loss,$-9.00,$-51.00,$236865.50,424,$-51.00
2025-08-18,05:09:00,23853.5,BUY,3,0.02h,Stop Loss,$-9.00,$-60.00,$236856.50,424,$-60.00
2025-08-18,05:10:00,23850.25,SELL,3,0.02h,Stop Loss,$-9.00,$-69.00,$236847.50,424,$-69.00
2025-08-18,05:39:00,23848.25,BUY,3,0.02h,Stop Loss,$-9.00,$-78.00,$236838.50,424,$-78.00
2025-08-18,06:03:00,23845.0,SELL,3,0.02h,Stop Loss,$-9.00,$-87.00,$236829.50,424,$-87.00
2025-08-18,07:02:00,23810.5,BUY,3,0.02h,Break Even,$-1.50,$-88.50,$236828.00,424,$-88.50
2025-08-18,07:09:00,23791.5,SELL,3,0.02h,Stop Loss,$34.50,$-54.00,$236862.50,424,$-54.00
2025-08-18,07:21:00,23808.5,BUY,3,0.02h,Break Even,$-1.50,$-55.50,$236861.00,424,$-55.50
2025-08-18,07:31:00,23793.0,SELL,3,0.02h,Stop Loss,$15.00,$-40.50,$236876.00,424,$-40.50
2025-08-18,07:44:00,23804.75,BUY,3,0.02h,Break Even,$-1.50,$-42.00,$236874.50,424,$-42.00
2025-08-18,08:05:00,23797.5,SELL,3,0.02h,Stop Loss,$7.50,$-34.50,$236882.00,424,$-34.50
2025-08-18,08:35:00,23784.5,BUY,3,0.02h,Stop Loss,$-9.00,$-43.50,$236873.00,424,$-43.50
2025-08-18,08:57:00,23782.75,SELL,3,0.02h,Stop Loss,$4.50,$-39.00,$236877.50,424,$-39.00
2025-08-18,09:37:00,23763.5,BUY,3,0.02h,Stop Loss,$-9.00,$-48.00,$236868.50,424,$-48.00
2025-08-18,09:49:00,23757.5,SELL,3,0.02h,Stop Loss,$-9.00,$-57.00,$236859.50,424,$-57.00
2025-08-18,09:58:00,23762.5,BUY,3,0.02h,Break Even,$-1.50,$-58.50,$236858.00,424,$-58.50
2025-08-18,10:18:00,23759.75,SELL,3,0.02h,Break Even,$-1.50,$-60.00,$236856.50,424,$-60.00
2025-08-18,10:24:00,23767.5,BUY,3,0.02h,Break Even,$-1.50,$-61.50,$236855.00,424,$-61.50
2025-08-18,11:11:00,23782.25,SELL,3,0.02h,Stop Loss,$-9.00,$-70.50,$236846.00,424,$-70.50
2025-08-18,11:55:00,23763.0,BUY,3,0.02h,Stop Loss,$-9.00,$-79.50,$236837.00,424,$-79.50
2025-08-18,12:04:00,23752.0,SELL,3,0.02h,Break Even,$-1.50,$-81.00,$236835.50,424,$-81.00
2025-08-18,12:16:00,23761.0,BUY,3,0.02h,Break Even,$-1.50,$-82.50,$236834.00,424,$-82.50
2025-08-18,12:35:00,23754.75,SELL,3,0.02h,Stop Loss,$-9.00,$-91.50,$236825.00,424,$-91.50
2025-08-18,12:44:00,23765.25,BUY,3,0.02h,Break Even,$-1.50,$-93.00,$236823.50,424,$-93.00
2025-08-18,13:13:00,23758.0,SELL,3,0.02h,Stop Loss,$-9.00,$-102.00,$236814.50,424,$-102.00
2025-08-18,13:31:00,23801.75,BUY,3,0.02h,Stop Loss,$13.50,$-88.50,$236828.00,424,$-88.50
2025-08-18,13:45:00,23776.75,SELL,3,0.02h,Stop Loss,$7.50,$-81.00,$236835.50,424,$-81.00
2025-08-18,13:46:00,23790.75,BUY,3,0.02h,Break Even,$-1.50,$-82.50,$236834.00,424,$-82.50
2025-08-18,13:52:00,23752.0,SELL,3,0.02h,Stop Loss,$19.50,$-63.00,$236853.50,424,$-63.00
2025-08-18,14:06:00,23780.0,BUY,3,0.02h,Stop Loss,$16.50,$-46.50,$236870.00,424,$-46.50
2025-08-18,14:16:00,23766.5,SELL,3,0.02h,Break Even,$-1.50,$-48.00,$236868.50,424,$-48.00
2025-08-18,14:17:00,23778.25,BUY,3,0.02h,Stop Loss,$4.50,$-43.50,$236873.00,424,$-43.50
2025-08-18,14:35:00,23778.75,SELL,3,0.02h,Stop Loss,$9.00,$-34.50,$236882.00,424,$-34.50
2025-08-18,14:56:00,23775.5,BUY,3,0.02h,Stop Loss,$-9.00,$-43.50,$236873.00,424,$-43.50
2025-08-18,15:14:00,23764.25,SELL,3,0.02h,Stop Loss,$16.50,$-27.00,$236889.50,424,$-27.00
2025-08-18,15:48:00,23753.5,BUY,3,0.02h,Stop Loss,$15.00,$-12.00,$236904.50,424,$-12.00
2025-08-18,15:56:00,23741.25,SELL,3,0.02h,Break Even,$-1.50,$-13.50,$236903.00,424,$-13.50
2025-08-18,16:02:00,23754.5,BUY,3,0.02h,Break Even,$-1.50,$-15.00,$236901.50,424,$-15.00
2025-08-18,16:37:00,23748.25,SELL,3,0.02h,Stop Loss,$57.00,$42.00,$236958.50,424,$42.00
2025-08-18,17:05:00,23752.0,BUY,3,0.02h,Stop Loss,$-9.00,$33.00,$236949.50,424,$33.00
2025-08-18,17:42:00,23755.25,SELL,3,0.02h,Stop Loss,$7.50,$40.50,$236957.00,424,$40.50
2025-08-18,18:08:00,23767.0,BUY,3,0.02h,Stop Loss,$-9.00,$31.50,$236948.00,424,$31.50
2025-08-18,18:19:00,23756.25,SELL,3,0.02h,Stop Loss,$-9.00,$22.50,$236939.00,424,$22.50
2025-08-18,18:24:00,23767.5,BUY,3,0.02h,Break Even,$-1.50,$21.00,$236937.50,424,$21.00
2025-08-18,19:25:00,23792.5,SELL,3,0.02h,Break Even,$-1.50,$19.50,$236936.00,424,$19.50
2025-08-18,19:38:00,23803.0,BUY,3,0.02h,Stop Loss,$-9.00,$10.50,$236927.00,424,$10.50
2025-08-18,20:03:00,23793.0,SELL,3,0.02h,Stop Loss,$-9.00,$1.50,$236918.00,424,$1.50
2025-08-18,20:50:00,23792.25,BUY,3,0.07h,Break Even,$-1.50,$0.00,$236916.50,424,$0.00
2025-08-18,23:34:00,23803.75,SELL,3,0.02h,Stop Loss,$-9.00,$-9.00,$236907.50,424,$-9.00
2025-08-18,23:53:00,23810.25,BUY,3,0.02h,Stop Loss,$-9.00,$-18.00,$236898.50,424,$-18.00
,,,,,,,,,,,
2025-08-19,00:00:00,23804.75,SELL,3,0.02h,Stop Loss,$10.50,$10.50,$236909.00,425,$10.50
2025-08-19,00:54:00,23783.5,BUY,3,0.02h,Stop Loss,$-9.00,$1.50,$236900.00,425,$1.50
2025-08-19,01:15:00,23779.5,SELL,3,0.02h,Stop Loss,$-9.00,$-7.50,$236891.00,425,$-7.50
2025-08-19,01:27:00,23784.5,BUY,3,0.02h,Break Even,$-1.50,$-9.00,$236889.50,425,$-9.00
2025-08-19,01:30:00,23779.0,SELL,3,0.02h,Stop Loss,$4.50,$-4.50,$236894.00,425,$-4.50
2025-08-19,01:45:00,23784.0,BUY,3,0.02h,Break Even,$-1.50,$-6.00,$236892.50,425,$-6.00
2025-08-19,01:50:00,23778.0,SELL,3,0.02h,Break Even,$-1.50,$-7.50,$236891.00,425,$-7.50
2025-08-19,02:13:00,23781.0,BUY,3,0.02h,Break Even,$-1.50,$-9.00,$236889.50,425,$-9.00
2025-08-19,02:19:00,23770.75,SELL,3,0.02h,Stop Loss,$-9.00,$-18.00,$236880.50,425,$-18.00
2025-08-19,02:33:00,23778.0,BUY,3,0.02h,Stop Loss,$-9.00,$-27.00,$236871.50,425,$-27.00
2025-08-19,02:47:00,23772.0,SELL,3,0.02h,Break Even,$-1.50,$-28.50,$236870.00,425,$-28.50
2025-08-19,03:21:00,23770.75,BUY,3,0.02h,Break Even,$-1.50,$-30.00,$236868.50,425,$-30.00
2025-08-19,03:37:00,23765.75,SELL,3,0.02h,Stop Loss,$3.00,$-27.00,$236871.50,425,$-27.00
2025-08-19,04:41:00,23748.75,BUY,3,0.02h,Break Even,$-1.50,$-28.50,$236870.00,425,$-28.50
2025-08-19,05:08:00,23746.0,SELL,3,0.02h,Break Even,$-1.50,$-30.00,$236868.50,425,$-30.00
2025-08-19,05:34:00,23745.0,BUY,3,0.02h,Stop Loss,$-9.00,$-39.00,$236859.50,425,$-39.00
2025-08-19,05:37:00,23737.75,SELL,3,0.02h,Break Even,$-1.50,$-40.50,$236858.00,425,$-40.50
2025-08-19,05:44:00,23742.5,BUY,3,0.02h,Stop Loss,$-9.00,$-49.50,$236849.00,425,$-49.50
2025-08-19,05:47:00,23736.5,SELL,3,0.02h,Stop Loss,$-9.00,$-58.50,$236840.00,425,$-58.50
2025-08-19,06:03:00,23742.75,BUY,3,0.02h,Break Even,$-1.50,$-60.00,$236838.50,425,$-60.00
2025-08-19,07:14:00,23757.75,SELL,3,0.02h,Stop Loss,$-9.00,$-69.00,$236829.50,425,$-69.00
2025-08-19,07:19:00,23761.0,BUY,3,0.02h,Stop Loss,$12.00,$-57.00,$236841.50,425,$-57.00
2025-08-19,07:25:00,23758.25,SELL,3,0.02h,Stop Loss,$-9.00,$-66.00,$236832.50,425,$-66.00
2025-08-19,07:42:00,23763.0,BUY,3,0.02h,Break Even,$-1.50,$-67.50,$236831.00,425,$-67.50
2025-08-19,08:09:00,23762.0,SELL,3,0.02h,Stop Loss,$-9.00,$-76.50,$236822.00,425,$-76.50
2025-08-19,08:27:00,23763.25,BUY,3,0.02h,Break Even,$-1.50,$-78.00,$236820.50,425,$-78.00
2025-08-19,09:43:00,23791.0,SELL,3,0.02h,Stop Loss,$-9.00,$-87.00,$236811.50,425,$-87.00
2025-08-19,11:16:00,23764.5,BUY,3,0.02h,Stop Loss,$-9.00,$-96.00,$236802.50,425,$-96.00
2025-08-19,11:18:00,23762.25,SELL,3,0.02h,Stop Loss,$-9.00,$-105.00,$236793.50,425,$-105.00
2025-08-19,11:19:00,23764.75,BUY,3,0.02h,Stop Loss,$3.00,$-102.00,$236796.50,425,$-102.00
2025-08-19,11:32:00,23762.5,SELL,3,0.02h,Stop Loss,$6.00,$-96.00,$236802.50,425,$-96.00
2025-08-19,11:47:00,23764.25,BUY,3,0.02h,Stop Loss,$18.00,$-78.00,$236820.50,425,$-78.00
2025-08-19,12:07:00,23758.75,SELL,3,0.02h,Break Even,$-1.50,$-79.50,$236819.00,425,$-79.50
2025-08-19,12:24:00,23768.5,BUY,3,0.02h,Stop Loss,$10.50,$-69.00,$236829.50,425,$-69.00
2025-08-19,12:45:00,23768.0,SELL,3,0.02h,Stop Loss,$7.50,$-61.50,$236837.00,425,$-61.50
2025-08-19,13:24:00,23752.0,BUY,3,0.02h,Break Even,$-1.50,$-63.00,$236835.50,425,$-63.00
2025-08-19,13:33:00,23692.75,SELL,3,0.02h,Stop Loss,$88.50,$25.50,$236924.00,425,$25.50
2025-08-19,14:05:00,23721.5,BUY,3,0.02h,Break Even,$-1.50,$24.00,$236922.50,425,$24.00
2025-08-19,14:24:00,23688.0,SELL,3,0.02h,Stop Loss,$-9.00,$15.00,$236913.50,425,$15.00
2025-08-19,15:19:00,23567.5,BUY,3,0.02h,Stop Loss,$16.50,$31.50,$236930.00,425,$31.50
2025-08-19,15:26:00,23557.25,SELL,3,0.02h,Stop Loss,$-9.00,$22.50,$236921.00,425,$22.50
2025-08-19,15:27:00,23573.0,BUY,3,0.02h,Stop Loss,$46.50,$69.00,$236967.50,425,$69.00
2025-08-19,15:51:00,23560.5,SELL,3,0.02h,Stop Loss,$22.50,$91.50,$236990.00,425,$91.50
2025-08-19,17:26:00,23475.5,BUY,3,0.02h,Break Even,$-1.50,$90.00,$236988.50,425,$90.00
2025-08-19,18:03:00,23483.25,SELL,3,0.02h,Stop Loss,$49.50,$139.50,$237038.00,425,$139.50
2025-08-19,18:58:00,23466.5,BUY,3,0.02h,Stop Loss,$6.00,$145.50,$237044.00,425,$145.50
2025-08-19,19:01:00,23447.0,SELL,3,0.02h,Stop Loss,$88.50,$234.00,$237132.50,425,$234.00
2025-08-19,19:24:00,23454.0,BUY,3,0.02h,Stop Loss,$33.00,$267.00,$237165.50,425,$267.00
2025-08-19,19:52:00,23452.75,SELL,3,0.02h,Stop Loss,$-9.00,$258.00,$237156.50,425,$258.00
2025-08-19,20:01:00,23481.5,BUY,3,0.02h,Stop Loss,$15.00,$273.00,$237171.50,425,$273.00
2025-08-19,20:21:00,23470.5,SELL,3,0.02h,Stop Loss,$-9.00,$264.00,$237162.50,425,$264.00
2025-08-19,20:23:00,23472.75,BUY,3,0.02h,Stop Loss,$-9.00,$255.00,$237153.50,425,$255.00
2025-08-19,20:24:00,23471.25,SELL,3,0.02h,Stop Loss,$15.00,$270.00,$237168.50,425,$270.00
2025-08-19,20:30:00,23473.25,BUY,3,0.02h,Break Even,$-1.50,$268.50,$237167.00,425,$268.50
2025-08-19,20:37:00,23468.0,SELL,3,0.02h,Break Even,$-1.50,$267.00,$237165.50,425,$267.00
2025-08-19,20:51:00,23472.5,BUY,3,0.02h,Stop Loss,$-9.00,$258.00,$237156.50,425,$258.00
2025-08-19,23:00:00,23457.25,SELL,3,0.02h,Stop Loss,$-9.00,$249.00,$237147.50,425,$249.00
,,,,,,,,,,,
2025-08-20,00:49:00,23418.0,BUY,3,0.02h,Stop Loss,$-9.00,$-9.00,$237138.50,426,$-9.00
2025-08-20,01:10:00,23404.5,SELL,3,0.02h,Stop Loss,$3.00,$-6.00,$237141.50,426,$-6.00
2025-08-20,01:55:00,23383.0,BUY,3,0.02h,Break Even,$-1.50,$-7.50,$237140.00,426,$-7.50
2025-08-20,02:01:00,23377.0,SELL,3,0.02h,Break Even,$-1.50,$-9.00,$237138.50,426,$-9.00
2025-08-20,02:10:00,23381.25,BUY,3,0.02h,Stop Loss,$-9.00,$-18.00,$237129.50,426,$-18.00
2025-08-20,03:05:00,23389.0,SELL,3,0.02h,Break Even,$-1.50,$-19.50,$237128.00,426,$-19.50
2025-08-20,03:33:00,23372.75,BUY,3,0.02h,Stop Loss,$-9.00,$-28.50,$237119.00,426,$-28.50
2025-08-20,03:36:00,23364.5,SELL,3,0.02h,Stop Loss,$16.50,$-12.00,$237135.50,426,$-12.00
2025-08-20,04:09:00,23351.5,BUY,3,0.02h,Stop Loss,$-9.00,$-21.00,$237126.50,426,$-21.00
2025-08-20,04:38:00,23348.75,SELL,3,0.02h,Break Even,$-1.50,$-22.50,$237125.00,426,$-22.50
2025-08-20,05:29:00,23345.5,BUY,3,0.02h,Break Even,$-1.50,$-24.00,$237123.50,426,$-24.00
2025-08-20,06:16:00,23360.0,SELL,3,0.02h,Stop Loss,$-9.00,$-33.00,$237114.50,426,$-33.00
2025-08-20,06:31:00,23372.75,BUY,3,0.02h,Stop Loss,$9.00,$-24.00,$237123.50,426,$-24.00
2025-08-20,07:35:00,23400.5,SELL,3,0.02h,Break Even,$-1.50,$-25.50,$237122.00,426,$-25.50
2025-08-20,07:54:00,23405.0,BUY,3,0.02h,Break Even,$-1.50,$-27.00,$237120.50,426,$-27.00
2025-08-20,07:59:00,23400.5,SELL,3,0.02h,Break Even,$-1.50,$-28.50,$237119.00,426,$-28.50
2025-08-20,08:05:00,23408.0,BUY,3,0.02h,Break Even,$-1.50,$-30.00,$237117.50,426,$-30.00
2025-08-20,08:10:00,23399.5,SELL,3,0.02h,Stop Loss,$33.00,$3.00,$237150.50,426,$3.00
2025-08-20,08:34:00,23406.5,BUY,3,0.02h,Stop Loss,$-9.00,$-6.00,$237141.50,426,$-6.00
2025-08-20,10:03:00,23427.5,SELL,3,0.02h,Break Even,$-1.50,$-7.50,$237140.00,426,$-7.50
2025-08-20,10:11:00,23433.5,BUY,3,0.02h,Break Even,$-1.50,$-9.00,$237138.50,426,$-9.00
2025-08-20,10:29:00,23432.25,SELL,3,0.02h,Stop Loss,$10.50,$1.50,$237149.00,426,$1.50
2025-08-20,10:57:00,23423.75,BUY,3,0.02h,Break Even,$-1.50,$0.00,$237147.50,426,$0.00
2025-08-20,11:23:00,23431.25,SELL,3,0.02h,Stop Loss,$-9.00,$-9.00,$237138.50,426,$-9.00
2025-08-20,11:55:00,23409.25,BUY,3,0.02h,Break Even,$-1.50,$-10.50,$237137.00,426,$-10.50
2025-08-20,12:29:00,23408.5,SELL,3,0.02h,Stop Loss,$-9.00,$-19.50,$237128.00,426,$-19.50
2025-08-20,12:44:00,23421.25,BUY,3,0.02h,Break Even,$-1.50,$-21.00,$237126.50,426,$-21.00
2025-08-20,13:10:00,23417.25,SELL,3,0.02h,Stop Loss,$3.00,$-18.00,$237129.50,426,$-18.00
2025-08-20,13:30:00,23426.75,BUY,3,0.02h,Stop Loss,$10.50,$-7.50,$237140.00,426,$-7.50
2025-08-20,13:31:00,23385.0,SELL,3,0.02h,Stop Loss,$15.00,$7.50,$237155.00,426,$7.50
2025-08-20,15:06:00,23086.25,BUY,3,0.02h,Stop Loss,$100.50,$108.00,$237255.50,426,$108.00
2025-08-20,15:52:00,23192.25,SELL,3,0.02h,Stop Loss,$97.50,$205.50,$237353.00,426,$205.50
2025-08-20,16:07:00,23205.75,BUY,3,0.02h,Break Even,$-1.50,$204.00,$237351.50,426,$204.00
2025-08-20,16:43:00,23256.5,SELL,3,0.02h,Stop Loss,$-9.00,$195.00,$237342.50,426,$195.00
2025-08-20,16:46:00,23269.25,BUY,3,0.02h,Stop Loss,$13.50,$208.50,$237356.00,426,$208.50
2025-08-20,16:49:00,23243.75,SELL,3,0.02h,Stop Loss,$-9.00,$199.50,$237347.00,426,$199.50
2025-08-20,17:09:00,23273.75,BUY,3,0.02h,Stop Loss,$-9.00,$190.50,$237338.00,426,$190.50
2025-08-20,17:15:00,23236.75,SELL,3,0.02h,Break Even,$-1.50,$189.00,$237336.50,426,$189.00
2025-08-20,17:21:00,23264.75,BUY,3,0.02h,Stop Loss,$10.50,$199.50,$237347.00,426,$199.50
2025-08-20,17:24:00,23241.25,SELL,3,0.02h,Break Even,$-1.50,$198.00,$237345.50,426,$198.00
2025-08-20,17:32:00,23270.0,BUY,3,0.02h,Stop Loss,$60.00,$258.00,$237405.50,426,$258.00
2025-08-20,17:56:00,23263.75,SELL,3,0.02h,Break Even,$-1.50,$256.50,$237404.00,426,$256.50
2025-08-20,18:37:00,23245.75,BUY,3,0.02h,Stop Loss,$-9.00,$247.50,$237395.00,426,$247.50
2025-08-20,20:01:00,23327.0,SELL,3,0.02h,Stop Loss,$48.00,$295.50,$237443.00,426,$295.50
2025-08-20,20:42:00,23315.0,BUY,3,0.05h,Break Even,$-1.50,$294.00,$237441.50,426,$294.00
2025-08-20,20:46:00,23311.75,SELL,3,0.02h,Stop Loss,$-9.00,$285.00,$237432.50,426,$285.00
2025-08-20,20:53:00,23316.25,BUY,3,0.02h,Break Even,$-1.50,$283.50,$237431.00,426,$283.50
2025-08-20,23:25:00,23319.25,SELL,3,0.02h,Stop Loss,$10.50,$294.00,$237441.50,426,$294.00
2025-08-20,23:55:00,23320.0,BUY,3,0.02h,Break Even,$-1.50,$292.50,$237440.00,426,$292.50
,,,,,,,,,,,
2025-08-21,00:03:00,23309.75,SELL,3,0.02h,Stop Loss,$-9.00,$-9.00,$237431.00,427,$-9.00
2025-08-21,00:07:00,23318.5,BUY,3,0.02h,Stop Loss,$-9.00,$-18.00,$237422.00,427,$-18.00
2025-08-21,00:10:00,23313.75,SELL,3,0.02h,Break Even,$-1.50,$-19.50,$237420.50,427,$-19.50
2025-08-21,00:11:00,23316.25,BUY,3,0.02h,Stop Loss,$25.50,$6.00,$237446.00,427,$6.00
2025-08-21,00:17:00,23309.25,SELL,3,0.02h,Stop Loss,$31.50,$37.50,$237477.50,427,$37.50
2025-08-21,00:36:00,23303.25,BUY,3,0.02h,Stop Loss,$-9.00,$28.50,$237468.50,427,$28.50
2025-08-21,00:50:00,23290.0,SELL,3,0.02h,Break Even,$-1.50,$27.00,$237467.00,427,$27.00
2025-08-21,01:24:00,23292.75,BUY,3,0.02h,Stop Loss,$10.50,$37.50,$237477.50,427,$37.50
2025-08-21,02:38:00,23356.25,SELL,3,0.02h,Break Even,$-1.50,$36.00,$237476.00,427,$36.00
2025-08-21,02:55:00,23357.75,BUY,3,0.02h,Stop Loss,$-9.00,$27.00,$237467.00,427,$27.00
2025-08-21,02:59:00,23354.75,SELL,3,0.02h,Break Even,$-1.50,$25.50,$237465.50,427,$25.50
2025-08-21,03:10:00,23358.5,BUY,3,0.02h,Stop Loss,$-9.00,$16.50,$237456.50,427,$16.50
2025-08-21,03:15:00,23351.75,SELL,3,0.02h,Stop Loss,$4.50,$21.00,$237461.00,427,$21.00
2025-08-21,03:36:00,23352.25,BUY,3,0.02h,Stop Loss,$-9.00,$12.00,$237452.00,427,$12.00
2025-08-21,03:37:00,23346.75,SELL,3,0.02h,Stop Loss,$-9.00,$3.00,$237443.00,427,$3.00
2025-08-21,03:39:00,23350.0,BUY,3,0.02h,Stop Loss,$-9.00,$-6.00,$237434.00,427,$-6.00
2025-08-21,03:47:00,23345.0,SELL,3,0.02h,Stop Loss,$-9.00,$-15.00,$237425.00,427,$-15.00
2025-08-21,03:50:00,23350.25,BUY,3,0.02h,Stop Loss,$6.00,$-9.00,$237431.00,427,$-9.00
2025-08-21,03:57:00,23346.25,SELL,3,0.02h,Break Even,$-1.50,$-10.50,$237429.50,427,$-10.50
2025-08-21,04:35:00,23342.5,BUY,3,0.02h,Stop Loss,$-9.00,$-19.50,$237420.50,427,$-19.50
2025-08-21,04:41:00,23332.5,SELL,3,0.02h,Stop Loss,$-9.00,$-28.50,$237411.50,427,$-28.50
2025-08-21,04:42:00,23338.25,BUY,3,0.02h,Break Even,$-1.50,$-30.00,$237410.00,427,$-30.00
2025-08-21,05:07:00,23329.5,SELL,3,0.02h,Stop Loss,$28.50,$-1.50,$237438.50,427,$-1.50
2025-08-21,05:54:00,23328.5,BUY,3,0.02h,Break Even,$-1.50,$-3.00,$237437.00,427,$-3.00
2025-08-21,06:46:00,23351.0,SELL,3,0.02h,Break Even,$-1.50,$-4.50,$237435.50,427,$-4.50
2025-08-21,07:00:00,23355.25,BUY,3,0.02h,Break Even,$-1.50,$-6.00,$237434.00,427,$-6.00
2025-08-21,07:01:00,23340.0,SELL,3,0.02h,Stop Loss,$4.50,$-1.50,$237438.50,427,$-1.50
2025-08-21,07:36:00,23342.25,BUY,3,0.02h,Stop Loss,$-9.00,$-10.50,$237429.50,427,$-10.50
2025-08-21,08:12:00,23332.5,SELL,3,0.02h,Stop Loss,$-9.00,$-19.50,$237420.50,427,$-19.50
2025-08-21,08:31:00,23349.5,BUY,3,0.02h,Break Even,$-1.50,$-21.00,$237419.00,427,$-21.00
2025-08-21,08:47:00,23339.25,SELL,3,0.02h,Break Even,$-1.50,$-22.50,$237417.50,427,$-22.50
2025-08-21,09:23:00,23312.0,BUY,3,0.02h,Stop Loss,$-9.00,$-31.50,$237408.50,427,$-31.50
2025-08-21,09:57:00,23315.5,SELL,3,0.02h,Break Even,$-1.50,$-33.00,$237407.00,427,$-33.00
2025-08-21,10:29:00,23301.75,BUY,3,0.02h,Break Even,$-1.50,$-34.50,$237405.50,427,$-34.50
2025-08-21,10:34:00,23295.5,SELL,3,0.02h,Break Even,$-1.50,$-36.00,$237404.00,427,$-36.00
2025-08-21,10:41:00,23301.25,BUY,3,0.02h,Break Even,$-1.50,$-37.50,$237402.50,427,$-37.50
2025-08-21,11:14:00,23300.25,SELL,3,0.02h,Stop Loss,$3.00,$-34.50,$237405.50,427,$-34.50
2025-08-21,12:34:00,23263.25,BUY,3,0.02h,Stop Loss,$15.00,$-19.50,$237420.50,427,$-19.50
2025-08-21,12:42:00,23236.0,SELL,3,0.02h,Stop Loss,$4.50,$-15.00,$237425.00,427,$-15.00
2025-08-21,13:08:00,23239.5,BUY,3,0.02h,Stop Loss,$-9.00,$-24.00,$237416.00,427,$-24.00
2025-08-21,13:32:00,23210.75,SELL,3,0.02h,Break Even,$-1.50,$-25.50,$237414.50,427,$-25.50
2025-08-21,13:34:00,23271.25,BUY,3,0.02h,Break Even,$-1.50,$-27.00,$237413.00,427,$-27.00
2025-08-21,13:46:00,23209.25,SELL,3,0.02h,Stop Loss,$172.50,$145.50,$237585.50,427,$145.50
2025-08-21,14:04:00,23258.0,BUY,3,0.02h,Stop Loss,$45.00,$190.50,$237630.50,427,$190.50
2025-08-21,14:39:00,23268.25,SELL,3,0.02h,Stop Loss,$45.00,$235.50,$237675.50,427,$235.50
2025-08-21,14:57:00,23295.75,BUY,3,0.02h,Stop Loss,$16.50,$252.00,$237692.00,427,$252.00
2025-08-21,15:06:00,23262.75,SELL,3,0.02h,Stop Loss,$-9.00,$243.00,$237683.00,427,$243.00
2025-08-21,15:26:00,23276.0,BUY,3,0.02h,Break Even,$-1.50,$241.50,$237681.50,427,$241.50
2025-08-21,15:48:00,23256.0,SELL,3,0.02h,Stop Loss,$12.00,$253.50,$237693.50,427,$253.50
2025-08-21,16:23:00,23206.0,BUY,3,0.02h,Stop Loss,$19.50,$273.00,$237713.00,427,$273.00
2025-08-21,16:27:00,23178.75,SELL,3,0.02h,Stop Loss,$16.50,$289.50,$237729.50,427,$289.50
2025-08-21,16:43:00,23198.5,BUY,3,0.02h,Stop Loss,$-9.00,$280.50,$237720.50,427,$280.50
2025-08-21,16:44:00,23184.75,SELL,3,0.02h,Stop Loss,$-9.00,$271.50,$237711.50,427,$271.50
2025-08-21,16:52:00,23200.5,BUY,3,0.02h,Stop Loss,$45.00,$316.50,$237756.50,427,$316.50
2025-08-21,16:59:00,23151.25,SELL,3,0.02h,Stop Loss,$-9.00,$307.50,$237747.50,427,$307.50
2025-08-21,17:34:00,23167.25,BUY,3,0.02h,Stop Loss,$28.50,$336.00,$237776.00,427,$336.00
2025-08-21,18:11:00,23195.0,SELL,3,0.02h,Stop Loss,$21.00,$357.00,$237797.00,427,$357.00
2025-08-21,18:17:00,23209.25,BUY,3,0.02h,Stop Loss,$33.00,$390.00,$237830.00,427,$390.00
2025-08-21,18:30:00,23198.5,SELL,3,0.02h,Stop Loss,$94.50,$484.50,$237924.50,427,$484.50
2025-08-21,18:37:00,23209.5,BUY,3,0.02h,Stop Loss,$28.50,$513.00,$237953.00,427,$513.00
2025-08-21,18:45:00,23198.25,SELL,3,0.02h,Stop Loss,$18.00,$531.00,$237971.00,427,$531.00
2025-08-21,18:53:00,23217.0,BUY,3,0.02h,Stop Loss,$27.00,$558.00,$237998.00,427,$558.00
2025-08-21,19:32:00,23233.25,SELL,3,0.02h,Break Even,$-1.50,$556.50,$237996.50,427,$556.50
2025-08-21,19:56:00,23232.0,BUY,3,0.02h,Stop Loss,$-9.00,$547.50,$237987.50,427,$547.50
2025-08-21,19:58:00,23214.0,SELL,3,0.02h,Stop Loss,$42.00,$589.50,$238029.50,427,$589.50
2025-08-21,20:16:00,23220.25,BUY,3,0.02h,Stop Loss,$-9.00,$580.50,$238020.50,427,$580.50
2025-08-21,20:30:00,23210.75,SELL,3,0.02h,Stop Loss,$-9.00,$571.50,$238011.50,427,$571.50
2025-08-21,20:42:00,23219.75,BUY,3,0.02h,Stop Loss,$-9.00,$562.50,$238002.50,427,$562.50
2025-08-21,23:34:00,23232.0,SELL,3,0.02h,Stop Loss,$-9.00,$553.50,$237993.50,427,$553.50
2025-08-21,23:42:00,23245.0,BUY,3,0.02h,Stop Loss,$-9.00,$544.50,$237984.50,427,$544.50
2025-08-21,23:45:00,23237.75,SELL,3,0.02h,Stop Loss,$-9.00,$535.50,$237975.50,427,$535.50
2025-08-21,23:49:00,23244.0,BUY,3,0.02h,Stop Loss,$-9.00,$526.50,$237966.50,427,$526.50
,,,,,,,,,,,
2025-08-22,00:05:00,23233.75,SELL,3,0.02h,Stop Loss,$7.50,$7.50,$237974.00,428,$7.50
2025-08-22,00:36:00,23215.75,BUY,3,0.02h,Stop Loss,$4.50,$12.00,$237978.50,428,$12.00
2025-08-22,00:56:00,23208.0,SELL,3,0.02h,Stop Loss,$-9.00,$3.00,$237969.50,428,$3.00
2025-08-22,01:01:00,23219.5,BUY,3,0.02h,Break Even,$-1.50,$1.50,$237968.00,428,$1.50
2025-08-22,01:04:00,23207.5,SELL,3,0.02h,Stop Loss,$-9.00,$-7.50,$237959.00,428,$-7.50
2025-08-22,01:19:00,23217.0,BUY,3,0.02h,Stop Loss,$-9.00,$-16.50,$237950.00,428,$-16.50
2025-08-22,01:23:00,23197.75,SELL,3,0.02h,Stop Loss,$-9.00,$-25.50,$237941.00,428,$-25.50
2025-08-22,01:46:00,23205.0,BUY,3,0.02h,Stop Loss,$-9.00,$-34.50,$237932.00,428,$-34.50
2025-08-22,01:49:00,23199.5,SELL,3,0.02h,Stop Loss,$-9.00,$-43.50,$237923.00,428,$-43.50
2025-08-22,01:57:00,23208.25,BUY,3,0.02h,Stop Loss,$-9.00,$-52.50,$237914.00,428,$-52.50
2025-08-22,02:38:00,23222.0,SELL,3,0.02h,Stop Loss,$-9.00,$-61.50,$237905.00,428,$-61.50
2025-08-22,02:39:00,23224.5,BUY,3,0.02h,Break Even,$-1.50,$-63.00,$237903.50,428,$-63.00
2025-08-22,02:55:00,23219.75,SELL,3,0.02h,Stop Loss,$10.50,$-52.50,$237914.00,428,$-52.50
2025-08-22,03:35:00,23205.0,BUY,3,0.02h,Break Even,$-1.50,$-54.00,$237912.50,428,$-54.00
2025-08-22,03:46:00,23198.5,SELL,3,0.02h,Break Even,$-1.50,$-55.50,$237911.00,428,$-55.50
2025-08-22,04:08:00,23203.0,BUY,3,0.02h,Stop Loss,$-9.00,$-64.50,$237902.00,428,$-64.50
2025-08-22,04:36:00,23203.5,SELL,3,0.02h,Stop Loss,$-9.00,$-73.50,$237893.00,428,$-73.50
2025-08-22,04:38:00,23209.0,BUY,3,0.02h,Stop Loss,$-9.00,$-82.50,$237884.00,428,$-82.50
2025-08-22,05:06:00,23204.25,SELL,3,0.02h,Break Even,$-1.50,$-84.00,$237882.50,428,$-84.00
2025-08-22,05:49:00,23195.0,BUY,3,0.03h,Stop Loss,$18.00,$-66.00,$237900.50,428,$-66.00
2025-08-22,06:01:00,23188.75,SELL,3,0.02h,Break Even,$-1.50,$-67.50,$237899.00,428,$-67.50
2025-08-22,06:56:00,23135.5,BUY,3,0.02h,Stop Loss,$-9.00,$-76.50,$237890.00,428,$-76.50
2025-08-22,07:43:00,23168.75,SELL,3,0.02h,Stop Loss,$-9.00,$-85.50,$237881.00,428,$-85.50
2025-08-22,07:47:00,23176.0,BUY,3,0.02h,Stop Loss,$7.50,$-78.00,$237888.50,428,$-78.00
2025-08-22,09:10:00,23242.25,SELL,3,0.02h,Stop Loss,$4.50,$-73.50,$237893.00,428,$-73.50
2025-08-22,09:14:00,23247.25,BUY,3,0.02h,Break Even,$-1.50,$-75.00,$237891.50,428,$-75.00
2025-08-22,09:25:00,23242.0,SELL,3,0.02h,Break Even,$-1.50,$-76.50,$237890.00,428,$-76.50
2025-08-22,09:48:00,23244.75,BUY,3,0.02h,Stop Loss,$-9.00,$-85.50,$237881.00,428,$-85.50
2025-08-22,10:23:00,23258.5,SELL,3,0.02h,Break Even,$-1.50,$-87.00,$237879.50,428,$-87.00
2025-08-22,10:26:00,23264.0,BUY,3,0.02h,Break Even,$-1.50,$-88.50,$237878.00,428,$-88.50
2025-08-22,10:51:00,23262.5,SELL,3,0.02h,Stop Loss,$-9.00,$-97.50,$237869.00,428,$-97.50
2025-08-22,11:01:00,23268.25,BUY,3,0.02h,Stop Loss,$15.00,$-82.50,$237884.00,428,$-82.50
2025-08-22,11:14:00,23259.25,SELL,3,0.02h,Break Even,$-1.50,$-84.00,$237882.50,428,$-84.00
2025-08-22,11:50:00,23255.5,BUY,3,0.02h,Stop Loss,$4.50,$-79.50,$237887.00,428,$-79.50
2025-08-22,12:13:00,23249.25,SELL,3,0.02h,Break Even,$-1.50,$-81.00,$237885.50,428,$-81.00
2025-08-22,12:17:00,23263.0,BUY,3,0.02h,Stop Loss,$-9.00,$-90.00,$237876.50,428,$-90.00
2025-08-22,12:35:00,23257.25,SELL,3,0.02h,Stop Loss,$34.50,$-55.50,$237911.00,428,$-55.50
2025-08-22,13:07:00,23260.5,BUY,3,0.02h,Break Even,$-1.50,$-57.00,$237909.50,428,$-57.00
2025-08-22,13:14:00,23247.75,SELL,3,0.02h,Stop Loss,$-9.00,$-66.00,$237900.50,428,$-66.00
2025-08-22,13:16:00,23252.5,BUY,3,0.02h,Break Even,$-1.50,$-67.50,$237899.00,428,$-67.50
2025-08-22,13:31:00,23210.5,SELL,3,0.02h,Stop Loss,$4.50,$-63.00,$237903.50,428,$-63.00
2025-08-22,13:38:00,23280.75,BUY,3,0.02h,Break Even,$-1.50,$-64.50,$237902.00,428,$-64.50
2025-08-22,13:59:00,23253.0,SELL,3,0.02h,Break Even,$-1.50,$-66.00,$237900.50,428,$-66.00
2025-08-22,14:01:00,23457.75,BUY,3,0.02h,Stop Loss,$321.00,$255.00,$238221.50,428,$255.00
2025-08-22,15:25:00,23610.75,SELL,3,0.02h,Stop Loss,$12.00,$267.00,$238233.50,428,$267.00
2025-08-22,15:33:00,23641.5,BUY,3,0.02h,Stop Loss,$-9.00,$258.00,$238224.50,428,$258.00
2025-08-22,15:40:00,23613.5,SELL,3,0.02h,Stop Loss,$3.00,$261.00,$238227.50,428,$261.00
2025-08-22,16:37:00,23558.75,BUY,3,0.02h,Break Even,$-1.50,$259.50,$238226.00,428,$259.50
2025-08-22,16:40:00,23546.25,SELL,3,0.02h,Break Even,$-1.50,$258.00,$238224.50,428,$258.00
2025-08-22,16:41:00,23554.25,BUY,3,0.02h,Stop Loss,$-9.00,$249.00,$238215.50,428,$249.00
2025-08-22,16:42:00,23547.5,SELL,3,0.02h,Stop Loss,$16.50,$265.50,$238232.00,428,$265.50
2025-08-22,17:04:00,23555.5,BUY,3,0.02h,Stop Loss,$-9.00,$256.50,$238223.00,428,$256.50
2025-08-22,18:00:00,23605.5,SELL,3,0.02h,Stop Loss,$-9.00,$247.50,$238214.00,428,$247.50
2025-08-22,18:01:00,23615.0,BUY,3,0.02h,Break Even,$-1.50,$246.00,$238212.50,428,$246.00
2025-08-22,18:06:00,23603.0,SELL,3,0.02h,Stop Loss,$22.50,$268.50,$238235.00,428,$268.50
2025-08-22,18:35:00,23606.0,BUY,3,0.02h,Stop Loss,$6.00,$274.50,$238241.00,428,$274.50
2025-08-22,18:42:00,23594.0,SELL,3,0.02h,Stop Loss,$6.00,$280.50,$238247.00,428,$280.50
2025-08-22,18:49:00,23607.25,BUY,3,0.02h,Stop Loss,$-9.00,$271.50,$238238.00,428,$271.50
2025-08-22,18:51:00,23595.25,SELL,3,0.02h,Stop Loss,$4.50,$276.00,$238242.50,428,$276.00
2025-08-22,18:53:00,23603.5,BUY,3,0.02h,Stop Loss,$-9.00,$267.00,$238233.50,428,$267.00
2025-08-22,18:55:00,23597.5,SELL,3,0.02h,Stop Loss,$31.50,$298.50,$238265.00,428,$298.50
2025-08-22,19:51:00,23570.75,BUY,3,0.02h,Break Even,$-1.50,$297.00,$238263.50,428,$297.00
2025-08-22,19:57:00,23553.0,SELL,3,0.02h,Break Even,$-1.50,$295.50,$238262.00,428,$295.50
2025-08-22,20:01:00,23566.0,BUY,3,0.02h,Stop Loss,$-9.00,$286.50,$238253.00,428,$286.50
2025-08-22,20:03:00,23559.25,SELL,3,0.02h,Stop Loss,$-9.00,$277.50,$238244.00,428,$277.50
2025-08-22,20:04:00,23566.75,BUY,3,0.02h,Break Even,$-1.50,$276.00,$238242.50,428,$276.00
2025-08-22,20:49:00,23578.0,SELL,3,0.02h,Break Even,$-1.50,$274.50,$238241.00,428,$274.50
2025-08-22,20:57:00,23581.25,BUY,3,0.02h,Stop Loss,$-9.00,$265.50,$238232.00,428,$265.50
,,,,,,,,,,,
2025-08-25,00:00:00,23574.5,SELL,3,0.02h,Break Even,$-1.50,$-1.50,$238230.50,429,$-1.50
2025-08-25,00:01:00,23583.0,BUY,3,0.02h,Stop Loss,$-9.00,$-10.50,$238221.50,429,$-10.50
2025-08-25,00:14:00,23580.0,SELL,3,0.02h,Stop Loss,$21.00,$10.50,$238242.50,429,$10.50
2025-08-25,01:29:00,23551.75,BUY,3,0.02h,Stop Loss,$-9.00,$1.50,$238233.50,429,$1.50
2025-08-25,01:31:00,23545.0,SELL,3,0.02h,Break Even,$-1.50,$0.00,$238232.00,429,$0.00
2025-08-25,02:10:00,23540.25,BUY,3,0.02h,Stop Loss,$-9.00,$-9.00,$238223.00,429,$-9.00
2025-08-25,02:12:00,23534.5,SELL,3,0.02h,Break Even,$-1.50,$-10.50,$238221.50,429,$-10.50
2025-08-25,02:16:00,23543.25,BUY,3,0.02h,Break Even,$-1.50,$-12.00,$238220.00,429,$-12.00
2025-08-25,02:33:00,23538.75,SELL,3,0.02h,Break Even,$-1.50,$-13.50,$238218.50,429,$-13.50
2025-08-25,02:37:00,23542.75,BUY,3,0.02h,Break Even,$-1.50,$-15.00,$238217.00,429,$-15.00
2025-08-25,02:44:00,23538.0,SELL,3,0.02h,Stop Loss,$-9.00,$-24.00,$238208.00,429,$-24.00
2025-08-25,03:17:00,23533.75,BUY,3,0.02h,Stop Loss,$-9.00,$-33.00,$238199.00,429,$-33.00
2025-08-25,04:52:00,23554.75,SELL,3,0.02h,Stop Loss,$-9.00,$-42.00,$238190.00,429,$-42.00
2025-08-25,04:53:00,23556.5,BUY,3,0.02h,Stop Loss,$-9.00,$-51.00,$238181.00,429,$-51.00
2025-08-25,04:54:00,23555.0,SELL,3,0.05h,Stop Loss,$-9.00,$-60.00,$238172.00,429,$-60.00
2025-08-25,05:10:00,23560.5,BUY,3,0.02h,Break Even,$-1.50,$-61.50,$238170.50,429,$-61.50
2025-08-25,05:28:00,23556.5,SELL,3,0.02h,Stop Loss,$-9.00,$-70.50,$238161.50,429,$-70.50
2025-08-25,05:46:00,23561.5,BUY,3,0.02h,Break Even,$-1.50,$-72.00,$238160.00,429,$-72.00
2025-08-25,06:08:00,23560.25,SELL,3,0.02h,Stop Loss,$-9.00,$-81.00,$238151.00,429,$-81.00
2025-08-25,07:44:00,23527.0,BUY,3,0.02h,Break Even,$-1.50,$-82.50,$238149.50,429,$-82.50
2025-08-25,08:09:00,23523.75,SELL,3,0.02h,Stop Loss,$-9.00,$-91.50,$238140.50,429,$-91.50
2025-08-25,08:30:00,23527.5,BUY,3,0.02h,Break Even,$-1.50,$-93.00,$238139.00,429,$-93.00
2025-08-25,08:44:00,23522.75,SELL,3,0.02h,Stop Loss,$39.00,$-54.00,$238178.00,429,$-54.00
2025-08-25,09:38:00,23496.0,BUY,3,0.02h,Break Even,$-1.50,$-55.50,$238176.50,429,$-55.50
2025-08-25,09:44:00,23493.25,SELL,3,0.02h,Break Even,$-1.50,$-57.00,$238175.00,429,$-57.00
2025-08-25,09:59:00,23503.25,BUY,3,0.02h,Break Even,$-1.50,$-58.50,$238173.50,429,$-58.50
2025-08-25,10:15:00,23494.5,SELL,3,0.02h,Break Even,$-1.50,$-60.00,$238172.00,429,$-60.00
2025-08-25,10:44:00,23487.5,BUY,3,0.02h,Break Even,$-1.50,$-61.50,$238170.50,429,$-61.50
2025-08-25,10:57:00,23483.75,SELL,3,0.02h,Stop Loss,$-9.00,$-70.50,$238161.50,429,$-70.50
2025-08-25,11:11:00,23486.5,BUY,3,0.02h,Break Even,$-1.50,$-72.00,$238160.00,429,$-72.00
2025-08-25,11:39:00,23492.0,SELL,3,0.02h,Stop Loss,$-9.00,$-81.00,$238151.00,429,$-81.00
2025-08-25,11:47:00,23496.0,BUY,3,0.02h,Break Even,$-1.50,$-82.50,$238149.50,429,$-82.50
2025-08-25,12:03:00,23488.0,SELL,3,0.02h,Break Even,$-1.50,$-84.00,$238148.00,429,$-84.00
2025-08-25,12:43:00,23479.0,BUY,3,0.02h,Stop Loss,$10.50,$-73.50,$238158.50,429,$-73.50
2025-08-25,13:33:00,23465.75,SELL,3,0.02h,Stop Loss,$93.00,$19.50,$238251.50,429,$19.50
2025-08-25,13:38:00,23498.25,BUY,3,0.02h,Stop Loss,$60.00,$79.50,$238311.50,429,$79.50
2025-08-25,13:46:00,23450.75,SELL,3,0.02h,Stop Loss,$-9.00,$70.50,$238302.50,429,$70.50
2025-08-25,13:57:00,23502.0,BUY,3,0.02h,Stop Loss,$43.50,$114.00,$238346.00,429,$114.00
2025-08-25,14:45:00,23540.5,SELL,3,0.02h,Stop Loss,$22.50,$136.50,$238368.50,429,$136.50
2025-08-25,14:48:00,23554.5,BUY,3,0.02h,Stop Loss,$34.50,$171.00,$238403.00,429,$171.00
2025-08-25,15:43:00,23583.0,SELL,3,0.02h,Stop Loss,$-9.00,$162.00,$238394.00,429,$162.00
2025-08-25,15:48:00,23595.75,BUY,3,0.02h,Break Even,$-1.50,$160.50,$238392.50,429,$160.50
2025-08-25,15:49:00,23585.25,SELL,3,0.02h,Stop Loss,$-9.00,$151.50,$238383.50,429,$151.50
2025-08-25,15:51:00,23608.75,BUY,3,0.02h,Stop Loss,$-9.00,$142.50,$238374.50,429,$142.50
2025-08-25,16:20:00,23596.0,SELL,3,0.02h,Stop Loss,$-9.00,$133.50,$238365.50,429,$133.50
2025-08-25,16:44:00,23606.75,BUY,3,0.02h,Break Even,$-1.50,$132.00,$238364.00,429,$132.00
2025-08-25,16:53:00,23593.5,SELL,3,0.02h,Break Even,$-1.50,$130.50,$238362.50,429,$130.50
2025-08-25,17:52:00,23582.25,BUY,3,0.02h,Stop Loss,$9.00,$139.50,$238371.50,429,$139.50
2025-08-25,18:01:00,23570.25,SELL,3,0.02h,Stop Loss,$-9.00,$130.50,$238362.50,429,$130.50
2025-08-25,18:14:00,23580.0,BUY,3,0.02h,Break Even,$-1.50,$129.00,$238361.00,429,$129.00
2025-08-25,18:17:00,23572.75,SELL,3,0.02h,Break Even,$-1.50,$127.50,$238359.50,429,$127.50
2025-08-25,19:10:00,23568.25,BUY,3,0.02h,Stop Loss,$12.00,$139.50,$238371.50,429,$139.50
2025-08-25,19:18:00,23551.0,SELL,3,0.02h,Break Even,$-1.50,$138.00,$238370.00,429,$138.00
2025-08-25,20:31:00,23518.25,BUY,3,0.02h,Stop Loss,$-9.00,$129.00,$238361.00,429,$129.00
2025-08-25,20:33:00,23510.25,SELL,3,0.02h,Stop Loss,$-9.00,$120.00,$238352.00,429,$120.00
2025-08-25,23:01:00,23514.25,BUY,3,0.02h,Stop Loss,$-9.00,$111.00,$238343.00,429,$111.00
2025-08-25,23:24:00,23503.25,SELL,3,0.02h,Break Even,$-1.50,$109.50,$238341.50,429,$109.50
,,,,,,,,,,,
2025-08-26,00:03:00,23500.5,BUY,3,0.02h,Stop Loss,$-9.00,$-9.00,$238332.50,430,$-9.00
2025-08-26,00:04:00,23461.75,SELL,3,0.02h,Stop Loss,$30.00,$21.00,$238362.50,430,$21.00
2025-08-26,00:17:00,23501.25,BUY,3,0.02h,Stop Loss,$28.50,$49.50,$238391.00,430,$49.50
2025-08-26,00:22:00,23481.0,SELL,3,0.02h,Stop Loss,$19.50,$69.00,$238410.50,430,$69.00
2025-08-26,01:02:00,23421.5,BUY,3,0.02h,Stop Loss,$58.50,$127.50,$238469.00,430,$127.50
2025-08-26,01:39:00,23437.5,SELL,3,0.02h,Stop Loss,$31.50,$159.00,$238500.50,430,$159.00
2025-08-26,02:03:00,23451.0,BUY,3,0.02h,Stop Loss,$-9.00,$150.00,$238491.50,430,$150.00
2025-08-26,02:53:00,23453.75,SELL,3,0.02h,Stop Loss,$6.00,$156.00,$238497.50,430,$156.00
2025-08-26,03:27:00,23447.75,BUY,3,0.03h,Stop Loss,$-9.00,$147.00,$238488.50,430,$147.00
2025-08-26,03:31:00,23444.25,SELL,3,0.02h,Stop Loss,$-9.00,$138.00,$238479.50,430,$138.00
2025-08-26,03:32:00,23447.25,BUY,3,0.02h,Stop Loss,$15.00,$153.00,$238494.50,430,$153.00
2025-08-26,03:58:00,23449.75,SELL,3,0.02h,Stop Loss,$-9.00,$144.00,$238485.50,430,$144.00
2025-08-26,04:07:00,23455.25,BUY,3,0.02h,Stop Loss,$-9.00,$135.00,$238476.50,430,$135.00
2025-08-26,04:26:00,23452.5,SELL,3,0.02h,Break Even,$-1.50,$133.50,$238475.00,430,$133.50
2025-08-26,04:50:00,23456.25,BUY,3,0.02h,Stop Loss,$-9.00,$124.50,$238466.00,430,$124.50
2025-08-26,05:54:00,23471.5,SELL,3,0.02h,Stop Loss,$-9.00,$115.50,$238457.00,430,$115.50
2025-08-26,05:57:00,23477.0,BUY,3,0.02h,Stop Loss,$-9.00,$106.50,$238448.00,430,$106.50
2025-08-26,06:05:00,23472.25,SELL,3,0.02h,Stop Loss,$-9.00,$97.50,$238439.00,430,$97.50
2025-08-26,06:06:00,23477.25,BUY,3,0.02h,Break Even,$-1.50,$96.00,$238437.50,430,$96.00
2025-08-26,06:12:00,23470.0,SELL,3,0.02h,Stop Loss,$-9.00,$87.00,$238428.50,430,$87.00
2025-08-26,06:54:00,23458.75,BUY,3,0.02h,Break Even,$-1.50,$85.50,$238427.00,430,$85.50
2025-08-26,07:01:00,23444.0,SELL,3,0.02h,Break Even,$-1.50,$84.00,$238425.50,430,$84.00
2025-08-26,07:32:00,23448.0,BUY,3,0.02h,Stop Loss,$10.50,$94.50,$238436.00,430,$94.50
2025-08-26,07:50:00,23438.75,SELL,3,0.02h,Stop Loss,$36.00,$130.50,$238472.00,430,$130.50
2025-08-26,08:02:00,23455.5,BUY,3,0.02h,Break Even,$-1.50,$129.00,$238470.50,430,$129.00
2025-08-26,08:24:00,23453.25,SELL,3,0.02h,Stop Loss,$-9.00,$120.00,$238461.50,430,$120.00
2025-08-26,08:26:00,23463.0,BUY,3,0.02h,Stop Loss,$-9.00,$111.00,$238452.50,430,$111.00
2025-08-26,08:31:00,23455.75,SELL,3,0.02h,Stop Loss,$-9.00,$102.00,$238443.50,430,$102.00
2025-08-26,08:32:00,23463.25,BUY,3,0.02h,Stop Loss,$7.50,$109.50,$238451.00,430,$109.50
2025-08-26,08:37:00,23455.25,SELL,3,0.02h,Stop Loss,$-9.00,$100.50,$238442.00,430,$100.50
2025-08-26,08:48:00,23464.25,BUY,3,0.02h,Stop Loss,$-9.00,$91.50,$238433.00,430,$91.50
2025-08-26,09:02:00,23456.75,SELL,3,0.02h,Break Even,$-1.50,$90.00,$238431.50,430,$90.00
2025-08-26,09:04:00,23464.0,BUY,3,0.02h,Stop Loss,$-9.00,$81.00,$238422.50,430,$81.00
2025-08-26,09:43:00,23466.25,SELL,3,0.02h,Break Even,$-1.50,$79.50,$238421.00,430,$79.50
2025-08-26,09:54:00,23475.0,BUY,3,0.02h,Stop Loss,$-9.00,$70.50,$238412.00,430,$70.50
2025-08-26,09:56:00,23470.5,SELL,3,0.02h,Stop Loss,$-9.00,$61.50,$238403.00,430,$61.50
2025-08-26,09:59:00,23475.5,BUY,3,0.02h,Break Even,$-1.50,$60.00,$238401.50,430,$60.00
2025-08-26,10:47:00,23493.0,SELL,3,0.02h,Break Even,$-1.50,$58.50,$238400.00,430,$58.50
2025-08-26,10:51:00,23497.0,BUY,3,0.02h,Stop Loss,$-9.00,$49.50,$238391.00,430,$49.50
2025-08-26,10:52:00,23493.5,SELL,3,0.02h,Stop Loss,$-9.00,$40.50,$238382.00,430,$40.50
2025-08-26,11:56:00,23469.0,BUY,3,0.02h,Break Even,$-1.50,$39.00,$238380.50,430,$39.00
2025-08-26,12:07:00,23456.25,SELL,3,0.02h,Break Even,$-1.50,$37.50,$238379.00,430,$37.50
2025-08-26,12:21:00,23461.0,BUY,3,0.02h,Break Even,$-1.50,$36.00,$238377.50,430,$36.00
2025-08-26,12:56:00,23464.25,SELL,3,0.02h,Stop Loss,$-9.00,$27.00,$238368.50,430,$27.00
2025-08-26,13:12:00,23472.5,BUY,3,0.02h,Break Even,$-1.50,$25.50,$238367.00,430,$25.50
2025-08-26,13:26:00,23468.0,SELL,3,0.02h,Stop Loss,$-9.00,$16.50,$238358.00,430,$16.50
2025-08-26,13:32:00,23496.25,BUY,3,0.02h,Stop Loss,$76.50,$93.00,$238434.50,430,$93.00
2025-08-26,13:48:00,23444.75,SELL,3,0.02h,Stop Loss,$55.50,$148.50,$238490.00,430,$148.50
2025-08-26,13:56:00,23498.5,BUY,3,0.02h,Stop Loss,$-9.00,$139.50,$238481.00,430,$139.50
2025-08-26,14:42:00,23519.0,SELL,3,0.02h,Stop Loss,$-9.00,$130.50,$238472.00,430,$130.50
2025-08-26,14:44:00,23533.5,BUY,3,0.02h,Stop Loss,$52.50,$183.00,$238524.50,430,$183.00
2025-08-26,15:00:00,23522.5,SELL,3,0.02h,Stop Loss,$9.00,$192.00,$238533.50,430,$192.00
2025-08-26,15:23:00,23530.5,BUY,3,0.02h,Break Even,$-1.50,$190.50,$238532.00,430,$190.50
2025-08-26,15:29:00,23514.0,SELL,3,0.02h,Stop Loss,$42.00,$232.50,$238574.00,430,$232.50
2025-08-26,15:46:00,23517.5,BUY,3,0.02h,Stop Loss,$3.00,$235.50,$238577.00,430,$235.50
2025-08-26,15:49:00,23508.25,SELL,3,0.02h,Stop Loss,$24.00,$259.50,$238601.00,430,$259.50
2025-08-26,15:55:00,23516.5,BUY,3,0.02h,Break Even,$-1.50,$258.00,$238599.50,430,$258.00
2025-08-26,16:46:00,23540.5,SELL,3,0.02h,Stop Loss,$24.00,$282.00,$238623.50,430,$282.00
2025-08-26,17:05:00,23541.25,BUY,3,0.02h,Break Even,$-1.50,$280.50,$238622.00,430,$280.50
2025-08-26,17:08:00,23527.75,SELL,3,0.02h,Break Even,$-1.50,$279.00,$238620.50,430,$279.00
2025-08-26,17:24:00,23535.0,BUY,3,0.02h,Break Even,$-1.50,$277.50,$238619.00,430,$277.50
2025-08-26,17:34:00,23519.25,SELL,3,0.02h,Stop Loss,$-9.00,$268.50,$238610.00,430,$268.50
2025-08-26,18:06:00,23509.25,BUY,3,0.02h,Stop Loss,$3.00,$271.50,$238613.00,430,$271.50
2025-08-26,19:06:00,23541.0,SELL,3,0.02h,Stop Loss,$-9.00,$262.50,$238604.00,430,$262.50
2025-08-26,19:15:00,23547.5,BUY,3,0.02h,Break Even,$-1.50,$261.00,$238602.50,430,$261.00
2025-08-26,19:19:00,23543.5,SELL,3,0.02h,Stop Loss,$-9.00,$252.00,$238593.50,430,$252.00
2025-08-26,19:20:00,23545.25,BUY,3,0.02h,Stop Loss,$31.50,$283.50,$238625.00,430,$283.50
2025-08-26,19:40:00,23549.25,SELL,3,0.02h,Stop Loss,$19.50,$303.00,$238644.50,430,$303.00
2025-08-26,19:51:00,23588.0,BUY,3,0.02h,Break Even,$-1.50,$301.50,$238643.00,430,$301.50
2025-08-26,23:50:00,23613.25,SELL,3,0.02h,Stop Loss,$-9.00,$292.50,$238634.00,430,$292.50
,,,,,,,,,,,
2025-08-27,01:02:00,23604.0,BUY,3,0.02h,Stop Loss,$-9.00,$-9.00,$238625.00,431,$-9.00
2025-08-27,01:30:00,23602.75,SELL,3,0.02h,Stop Loss,$-9.00,$-18.00,$238616.00,431,$-18.00
2025-08-27,01:31:00,23605.5,BUY,3,0.02h,Break Even,$-1.50,$-19.50,$238614.50,431,$-19.50
2025-08-27,02:06:00,23617.75,SELL,3,0.02h,Stop Loss,$4.50,$-15.00,$238619.00,431,$-15.00
2025-08-27,02:17:00,23622.75,BUY,3,0.02h,Break Even,$-1.50,$-16.50,$238617.50,431,$-16.50
2025-08-27,02:30:00,23615.0,SELL,3,0.03h,Stop Loss,$-9.00,$-25.50,$238608.50,431,$-25.50
2025-08-27,03:03:00,23615.75,BUY,3,0.02h,Stop Loss,$-9.00,$-34.50,$238599.50,431,$-34.50
2025-08-27,03:23:00,23614.5,SELL,3,0.02h,Break Even,$-1.50,$-36.00,$238598.00,431,$-36.00
2025-08-27,03:52:00,23613.5,BUY,3,0.05h,Stop Loss,$-9.00,$-45.00,$238589.00,431,$-45.00
2025-08-27,04:04:00,23612.0,SELL,3,0.07h,Stop Loss,$18.00,$-27.00,$238607.00,431,$-27.00
2025-08-27,04:18:00,23614.0,BUY,3,0.02h,Stop Loss,$-9.00,$-36.00,$238598.00,431,$-36.00
2025-08-27,04:57:00,23616.5,SELL,3,0.08h,Break Even,$-1.50,$-37.50,$238596.50,431,$-37.50
2025-08-27,05:39:00,23605.0,BUY,3,0.02h,Stop Loss,$-9.00,$-46.50,$238587.50,431,$-46.50
2025-08-27,05:44:00,23600.75,SELL,3,0.02h,Stop Loss,$-9.00,$-55.50,$238578.50,431,$-55.50
2025-08-27,06:10:00,23599.75,BUY,3,0.02h,Break Even,$-1.50,$-57.00,$238577.00,431,$-57.00
2025-08-27,06:12:00,23596.5,SELL,3,0.02h,Stop Loss,$-9.00,$-66.00,$238568.00,431,$-66.00
2025-08-27,06:14:00,23599.5,BUY,3,0.02h,Round Number,$0.00,$-66.00,$238568.00,431,$-66.00
2025-08-27,06:52:00,23605.75,SELL,3,0.02h,Break Even,$-1.50,$-67.50,$238566.50,431,$-67.50
2025-08-27,07:10:00,23612.25,BUY,3,0.02h,Break Even,$-1.50,$-69.00,$238565.00,431,$-69.00
2025-08-27,07:16:00,23604.0,SELL,3,0.02h,Stop Loss,$15.00,$-54.00,$238580.00,431,$-54.00
2025-08-27,07:49:00,23592.5,BUY,3,0.02h,Stop Loss,$-9.00,$-63.00,$238571.00,431,$-63.00
2025-08-27,08:08:00,23590.25,SELL,3,0.02h,Stop Loss,$16.50,$-46.50,$238587.50,431,$-46.50
2025-08-27,08:44:00,23583.0,BUY,3,0.02h,Stop Loss,$-9.00,$-55.50,$238578.50,431,$-55.50
2025-08-27,08:47:00,23581.0,SELL,3,0.02h,Stop Loss,$7.50,$-48.00,$238586.00,431,$-48.00
2025-08-27,08:58:00,23586.25,BUY,3,0.02h,Break Even,$-1.50,$-49.50,$238584.50,431,$-49.50
2025-08-27,09:57:00,23596.0,SELL,3,0.02h,Stop Loss,$-9.00,$-58.50,$238575.50,431,$-58.50
2025-08-27,09:58:00,23598.25,BUY,3,0.02h,Stop Loss,$-9.00,$-67.50,$238566.50,431,$-67.50
2025-08-27,09:59:00,23596.5,SELL,3,0.02h,Stop Loss,$-9.00,$-76.50,$238557.50,431,$-76.50
2025-08-27,10:04:00,23600.25,BUY,3,0.02h,Stop Loss,$-9.00,$-85.50,$238548.50,431,$-85.50
2025-08-27,10:07:00,23595.0,SELL,3,0.05h,Stop Loss,$-9.00,$-94.50,$238539.50,431,$-94.50
2025-08-27,10:17:00,23598.0,BUY,3,0.02h,Stop Loss,$-9.00,$-103.50,$238530.50,431,$-103.50
2025-08-27,10:18:00,23595.75,SELL,3,0.02h,Stop Loss,$7.50,$-96.00,$238538.00,431,$-96.00
2025-08-27,10:26:00,23598.5,BUY,3,0.02h,Stop Loss,$7.50,$-88.50,$238545.50,431,$-88.50
2025-08-27,10:55:00,23599.5,SELL,3,0.02h,Stop Loss,$-9.00,$-97.50,$238536.50,431,$-97.50
2025-08-27,10:57:00,23603.0,BUY,3,0.02h,Break Even,$-1.50,$-99.00,$238535.00,431,$-99.00
2025-08-27,11:04:00,23599.25,SELL,3,0.02h,Stop Loss,$-9.00,$-108.00,$238526.00,431,$-108.00
2025-08-27,11:10:00,23605.0,BUY,3,0.02h,Stop Loss,$-9.00,$-117.00,$238517.00,431,$-117.00
2025-08-27,12:00:00,23608.0,SELL,3,0.02h,Break Even,$-1.50,$-118.50,$238515.50,431,$-118.50
2025-08-27,12:09:00,23614.0,BUY,3,0.02h,Stop Loss,$-9.00,$-127.50,$238506.50,431,$-127.50
2025-08-27,12:26:00,23607.0,SELL,3,0.02h,Stop Loss,$10.50,$-117.00,$238517.00,431,$-117.00
2025-08-27,13:00:00,23581.75,BUY,3,0.02h,Break Even,$-1.50,$-118.50,$238515.50,431,$-118.50
2025-08-27,13:05:00,23569.25,SELL,3,0.02h,Break Even,$-1.50,$-120.00,$238514.00,431,$-120.00
2025-08-27,14:02:00,23532.0,BUY,3,0.02h,Stop Loss,$27.00,$-93.00,$238541.00,431,$-93.00
2025-08-27,14:53:00,23597.0,SELL,3,0.02h,Break Even,$-1.50,$-94.50,$238539.50,431,$-94.50
2025-08-27,14:54:00,23602.25,BUY,3,0.02h,Break Even,$-1.50,$-96.00,$238538.00,431,$-96.00
2025-08-27,15:05:00,23592.75,SELL,3,0.02h,Stop Loss,$6.00,$-90.00,$238544.00,431,$-90.00
2025-08-27,15:19:00,23599.0,BUY,3,0.02h,Stop Loss,$-9.00,$-99.00,$238535.00,431,$-99.00
2025-08-27,15:20:00,23594.5,SELL,3,0.02h,Stop Loss,$-9.00,$-108.00,$238526.00,431,$-108.00
2025-08-27,15:21:00,23600.75,BUY,3,0.02h,Stop Loss,$-9.00,$-117.00,$238517.00,431,$-117.00
2025-08-27,15:28:00,23589.5,SELL,3,0.02h,Break Even,$-1.50,$-118.50,$238515.50,431,$-118.50
2025-08-27,15:39:00,23600.75,BUY,3,0.02h,Stop Loss,$13.50,$-105.00,$238529.00,431,$-105.00
2025-08-27,15:43:00,23593.75,SELL,3,0.02h,Stop Loss,$-9.00,$-114.00,$238520.00,431,$-114.00
2025-08-27,15:45:00,23600.5,BUY,3,0.02h,Stop Loss,$3.00,$-111.00,$238523.00,431,$-111.00
2025-08-27,16:12:00,23612.75,SELL,3,0.02h,Break Even,$-1.50,$-112.50,$238521.50,431,$-112.50
2025-08-27,16:48:00,23588.75,BUY,3,0.02h,Stop Loss,$3.00,$-109.50,$238524.50,431,$-109.50
2025-08-27,17:20:00,23594.5,SELL,3,0.02h,Stop Loss,$18.00,$-91.50,$238542.50,431,$-91.50
2025-08-27,17:27:00,23601.25,BUY,3,0.02h,Break Even,$-1.50,$-93.00,$238541.00,431,$-93.00
2025-08-27,18:41:00,23642.25,SELL,3,0.02h,Stop Loss,$-9.00,$-102.00,$238532.00,431,$-102.00
2025-08-27,19:33:00,23602.5,BUY,3,0.02h,Break Even,$-1.50,$-103.50,$238530.50,431,$-103.50
2025-08-27,20:04:00,23615.75,SELL,3,0.02h,Break Even,$-1.50,$-105.00,$238529.00,431,$-105.00
2025-08-27,20:59:00,23539.5,BUY,3,0.02h,Stop Loss,$15.00,$-90.00,$238544.00,431,$-90.00
2025-08-27,23:00:00,23518.5,SELL,3,0.02h,Stop Loss,$10.50,$-79.50,$238554.50,431,$-79.50
2025-08-27,23:40:00,23516.75,BUY,3,0.02h,Break Even,$-1.50,$-81.00,$238553.00,431,$-81.00
2025-08-27,23:48:00,23509.25,SELL,3,0.02h,Stop Loss,$-9.00,$-90.00,$238544.00,431,$-90.00
2025-08-27,23:51:00,23513.5,BUY,3,0.02h,Stop Loss,$4.50,$-85.50,$238548.50,431,$-85.50
2025-08-27,23:55:00,23510.0,SELL,3,0.02h,Stop Loss,$4.50,$-81.00,$238553.00,431,$-81.00
,,,,,,,,,,,
2025-08-28,00:12:00,23513.0,BUY,3,0.02h,Break Even,$-1.50,$-1.50,$238551.50,432,$-1.50
2025-08-28,00:18:00,23498.75,SELL,3,0.02h,Stop Loss,$31.50,$30.00,$238583.00,432,$30.00
2025-08-28,00:38:00,23508.0,BUY,3,0.02h,Stop Loss,$-9.00,$21.00,$238574.00,432,$21.00
2025-08-28,02:35:00,23552.0,SELL,3,0.02h,Stop Loss,$-9.00,$12.00,$238565.00,432,$12.00
2025-08-28,02:43:00,23555.5,BUY,3,0.02h,Stop Loss,$-9.00,$3.00,$238556.00,432,$3.00
2025-08-28,02:57:00,23553.0,SELL,3,0.03h,Stop Loss,$-9.00,$-6.00,$238547.00,432,$-6.00
2025-08-28,03:01:00,23554.75,BUY,3,0.02h,Stop Loss,$13.50,$7.50,$238560.50,432,$7.50
2025-08-28,03:43:00,23574.0,SELL,3,0.02h,Stop Loss,$-9.00,$-1.50,$238551.50,432,$-1.50
2025-08-28,03:53:00,23577.0,BUY,3,0.03h,Stop Loss,$-9.00,$-10.50,$238542.50,432,$-10.50
2025-08-28,04:02:00,23571.75,SELL,3,0.02h,Stop Loss,$7.50,$-3.00,$238550.00,432,$-3.00
2025-08-28,04:28:00,23567.75,BUY,3,0.02h,Stop Loss,$16.50,$13.50,$238566.50,432,$13.50
2025-08-28,04:50:00,23565.75,SELL,3,0.02h,Break Even,$-1.50,$12.00,$238565.00,432,$12.00
2025-08-28,06:14:00,23551.5,BUY,3,0.02h,Break Even,$-1.50,$10.50,$238563.50,432,$10.50
2025-08-28,07:38:00,23615.5,SELL,3,0.02h,Stop Loss,$10.50,$21.00,$238574.00,432,$21.00
2025-08-28,07:54:00,23623.25,BUY,3,0.02h,Break Even,$-1.50,$19.50,$238572.50,432,$19.50
2025-08-28,08:31:00,23638.5,SELL,3,0.02h,Stop Loss,$4.50,$24.00,$238577.00,432,$24.00
2025-08-28,09:13:00,23624.5,BUY,3,0.02h,Stop Loss,$-9.00,$15.00,$238568.00,432,$15.00
2025-08-28,09:14:00,23620.0,SELL,3,0.02h,Stop Loss,$-9.00,$6.00,$238559.00,432,$6.00
2025-08-28,09:37:00,23625.25,BUY,3,0.02h,Break Even,$-1.50,$4.50,$238557.50,432,$4.50
2025-08-28,09:41:00,23617.0,SELL,3,0.02h,Break Even,$-1.50,$3.00,$238556.00,432,$3.00
2025-08-28,10:15:00,23618.75,BUY,3,0.02h,Break Even,$-1.50,$1.50,$238554.50,432,$1.50
2025-08-28,10:22:00,23613.75,SELL,3,0.02h,Stop Loss,$-9.00,$-7.50,$238545.50,432,$-7.50
2025-08-28,10:23:00,23617.5,BUY,3,0.02h,Stop Loss,$9.00,$1.50,$238554.50,432,$1.50
2025-08-28,10:41:00,23609.0,SELL,3,0.02h,Break Even,$-1.50,$0.00,$238553.00,432,$0.00
2025-08-28,11:03:00,23611.25,BUY,3,0.02h,Break Even,$-1.50,$-1.50,$238551.50,432,$-1.50
2025-08-28,11:05:00,23604.5,SELL,3,0.02h,Break Even,$-1.50,$-3.00,$238550.00,432,$-3.00
2025-08-28,11:36:00,23596.75,BUY,3,0.02h,Stop Loss,$-9.00,$-12.00,$238541.00,432,$-12.00
2025-08-28,11:38:00,23592.0,SELL,3,0.02h,Break Even,$-1.50,$-13.50,$238539.50,432,$-13.50
2025-08-28,11:44:00,23595.0,BUY,3,0.02h,Stop Loss,$-9.00,$-22.50,$238530.50,432,$-22.50
2025-08-28,12:17:00,23610.0,SELL,3,0.02h,Break Even,$-1.50,$-24.00,$238529.00,432,$-24.00
2025-08-28,12:32:00,23629.5,BUY,3,0.02h,Stop Loss,$21.00,$-3.00,$238550.00,432,$-3.00
2025-08-28,13:29:00,23633.5,SELL,3,0.02h,Stop Loss,$-9.00,$-12.00,$238541.00,432,$-12.00
2025-08-28,13:31:00,23705.25,BUY,3,0.02h,Stop Loss,$153.00,$141.00,$238694.00,432,$141.00
2025-08-28,13:50:00,23657.5,SELL,3,0.02h,Stop Loss,$274.50,$415.50,$238968.50,432,$415.50
2025-08-28,14:09:00,23675.25,BUY,3,0.02h,Stop Loss,$-9.00,$406.50,$238959.50,432,$406.50
2025-08-28,14:27:00,23630.25,SELL,3,0.02h,Stop Loss,$-9.00,$397.50,$238950.50,432,$397.50
2025-08-28,14:34:00,23671.75,BUY,3,0.02h,Stop Loss,$13.50,$411.00,$238964.00,432,$411.00
2025-08-28,15:24:00,23699.5,SELL,3,0.02h,Stop Loss,$3.00,$414.00,$238967.00,432,$414.00
2025-08-28,15:38:00,23718.0,BUY,3,0.02h,Stop Loss,$-9.00,$405.00,$238958.00,432,$405.00
2025-08-28,15:41:00,23698.5,SELL,3,0.02h,Stop Loss,$9.00,$414.00,$238967.00,432,$414.00
2025-08-28,16:08:00,23697.75,BUY,3,0.02h,Stop Loss,$19.50,$433.50,$238986.50,432,$433.50
2025-08-28,17:00:00,23732.0,SELL,3,0.02h,Stop Loss,$37.50,$471.00,$239024.00,432,$471.00
2025-08-28,17:23:00,23743.75,BUY,3,0.02h,Stop Loss,$3.00,$474.00,$239027.00,432,$474.00
2025-08-28,18:18:00,23766.5,SELL,3,0.02h,Break Even,$-1.50,$472.50,$239025.50,432,$472.50
2025-08-28,18:22:00,23771.75,BUY,3,0.02h,Break Even,$-1.50,$471.00,$239024.00,432,$471.00
2025-08-28,19:17:00,23779.75,SELL,3,0.02h,Break Even,$-1.50,$469.50,$239022.50,432,$469.50
2025-08-28,19:41:00,23786.25,BUY,3,0.02h,Break Even,$-1.50,$468.00,$239021.00,432,$468.00
2025-08-28,19:58:00,23779.75,SELL,3,0.02h,Stop Loss,$18.00,$486.00,$239039.00,432,$486.00
2025-08-28,20:38:00,23763.75,BUY,3,0.07h,Stop Loss,$-9.00,$477.00,$239030.00,432,$477.00
2025-08-28,20:49:00,23762.5,SELL,3,0.03h,Break Even,$-1.50,$475.50,$239028.50,432,$475.50
2025-08-28,23:36:00,23745.0,BUY,3,0.02h,Break Even,$-1.50,$474.00,$239027.00,432,$474.00
2025-08-28,23:54:00,23745.25,SELL,3,0.02h,Stop Loss,$-9.00,$465.00,$239018.00,432,$465.00
2025-08-28,23:55:00,23749.0,BUY,3,0.02h,Break Even,$-1.50,$463.50,$239016.50,432,$463.50
,,,,,,,,,,,
2025-08-29,00:01:00,23739.75,SELL,3,0.02h,Stop Loss,$-9.00,$-9.00,$239007.50,433,$-9.00
2025-08-29,00:18:00,23747.25,BUY,3,0.02h,Stop Loss,$4.50,$-4.50,$239012.00,433,$-4.50
2025-08-29,00:54:00,23749.75,SELL,3,0.02h,Stop Loss,$-9.00,$-13.50,$239003.00,433,$-13.50
2025-08-29,02:55:00,23723.75,BUY,3,0.02h,Break Even,$-1.50,$-15.00,$239001.50,433,$-15.00
2025-08-29,03:28:00,23731.25,SELL,3,0.02h,Break Even,$-1.50,$-16.50,$239000.00,433,$-16.50
2025-08-29,03:39:00,23736.0,BUY,3,0.02h,Stop Loss,$-9.00,$-25.50,$238991.00,433,$-25.50
2025-08-29,03:48:00,23732.0,SELL,3,0.03h,Break Even,$-1.50,$-27.00,$238989.50,433,$-27.00
2025-08-29,04:46:00,23724.25,BUY,3,0.10h,Break Even,$-1.50,$-28.50,$238988.00,433,$-28.50
2025-08-29,04:55:00,23720.5,SELL,3,0.02h,Break Even,$-1.50,$-30.00,$238986.50,433,$-30.00
2025-08-29,05:03:00,23727.5,BUY,3,0.02h,Stop Loss,$-9.00,$-39.00,$238977.50,433,$-39.00
2025-08-29,05:20:00,23721.0,SELL,3,0.02h,Stop Loss,$24.00,$-15.00,$239001.50,433,$-15.00
2025-08-29,05:46:00,23722.25,BUY,3,0.02h,Stop Loss,$-9.00,$-24.00,$238992.50,433,$-24.00
2025-08-29,05:55:00,23717.25,SELL,3,0.02h,Stop Loss,$-9.00,$-33.00,$238983.50,433,$-33.00
2025-08-29,05:56:00,23719.25,BUY,3,0.02h,Break Even,$-1.50,$-34.50,$238982.00,433,$-34.50
2025-08-29,06:36:00,23723.5,SELL,3,0.02h,Stop Loss,$-9.00,$-43.50,$238973.00,433,$-43.50
2025-08-29,06:44:00,23729.75,BUY,3,0.02h,Stop Loss,$-9.00,$-52.50,$238964.00,433,$-52.50
2025-08-29,06:50:00,23722.75,SELL,3,0.02h,Stop Loss,$3.00,$-49.50,$238967.00,433,$-49.50
2025-08-29,07:05:00,23727.0,BUY,3,0.02h,Stop Loss,$7.50,$-42.00,$238974.50,433,$-42.00
2025-08-29,07:20:00,23721.75,SELL,3,0.02h,Break Even,$-1.50,$-43.50,$238973.00,433,$-43.50
2025-08-29,08:34:00,23677.0,BUY,3,0.02h,Break Even,$-1.50,$-45.00,$238971.50,433,$-45.00
2025-08-29,08:41:00,23666.0,SELL,3,0.02h,Break Even,$-1.50,$-46.50,$238970.00,433,$-46.50
2025-08-29,09:15:00,23649.75,BUY,3,0.02h,Break Even,$-1.50,$-48.00,$238968.50,433,$-48.00
2025-08-29,09:45:00,23649.5,SELL,3,0.02h,Stop Loss,$-9.00,$-57.00,$238959.50,433,$-57.00
2025-08-29,09:46:00,23655.25,BUY,3,0.02h,Break Even,$-1.50,$-58.50,$238958.00,433,$-58.50
2025-08-29,09:53:00,23651.5,SELL,3,0.02h,Stop Loss,$3.00,$-55.50,$238961.00,433,$-55.50
2025-08-29,10:11:00,23656.0,BUY,3,0.02h,Stop Loss,$6.00,$-49.50,$238967.00,433,$-49.50
2025-08-29,10:30:00,23649.5,SELL,3,0.02h,Stop Loss,$13.50,$-36.00,$238980.50,433,$-36.00
2025-08-29,11:05:00,23642.5,BUY,3,0.02h,Stop Loss,$-9.00,$-45.00,$238971.50,433,$-45.00
2025-08-29,11:32:00,23641.75,SELL,3,0.02h,Stop Loss,$-9.00,$-54.00,$238962.50,433,$-54.00
2025-08-29,12:02:00,23642.5,BUY,3,0.02h,Break Even,$-1.50,$-55.50,$238961.00,433,$-55.50
2025-08-29,12:04:00,23633.75,SELL,3,0.02h,Break Even,$-1.50,$-57.00,$238959.50,433,$-57.00
2025-08-29,12:19:00,23641.5,BUY,3,0.02h,Stop Loss,$-9.00,$-66.00,$238950.50,433,$-66.00
2025-08-29,12:20:00,23630.25,SELL,3,0.02h,Stop Loss,$-9.00,$-75.00,$238941.50,433,$-75.00
2025-08-29,12:21:00,23638.5,BUY,3,0.02h,Stop Loss,$-9.00,$-84.00,$238932.50,433,$-84.00
2025-08-29,12:25:00,23631.25,SELL,3,0.02h,Stop Loss,$4.50,$-79.50,$238937.00,433,$-79.50
2025-08-29,12:28:00,23636.25,BUY,3,0.02h,Stop Loss,$-9.00,$-88.50,$238928.00,433,$-88.50
2025-08-29,12:30:00,23630.75,SELL,3,0.02h,Break Even,$-1.50,$-90.00,$238926.50,433,$-90.00
2025-08-29,12:31:00,23670.75,BUY,3,0.02h,Stop Loss,$-9.00,$-99.00,$238917.50,433,$-99.00
2025-08-29,13:11:00,23657.75,SELL,3,0.02h,Stop Loss,$12.00,$-87.00,$238929.50,433,$-87.00
2025-08-29,13:26:00,23665.75,BUY,3,0.02h,Stop Loss,$4.50,$-82.50,$238934.00,433,$-82.50
2025-08-29,13:31:00,23650.25,SELL,3,0.02h,Stop Loss,$64.50,$-18.00,$238998.50,433,$-18.00
2025-08-29,14:31:00,23495.0,BUY,3,0.02h,Stop Loss,$24.00,$6.00,$239022.50,433,$6.00
2025-08-29,14:46:00,23474.0,SELL,3,0.02h,Stop Loss,$10.50,$16.50,$239033.00,433,$16.50
2025-08-29,15:09:00,23466.25,BUY,3,0.02h,Stop Loss,$48.00,$64.50,$239081.00,433,$64.50
2025-08-29,15:34:00,23462.5,SELL,3,0.02h,Stop Loss,$4.50,$69.00,$239085.50,433,$69.00
2025-08-29,16:10:00,23453.5,BUY,3,0.02h,Stop Loss,$40.50,$109.50,$239126.00,433,$109.50
2025-08-29,16:29:00,23455.0,SELL,3,0.02h,Break Even,$-1.50,$108.00,$239124.50,433,$108.00
2025-08-29,16:32:00,23473.75,BUY,3,0.02h,Break Even,$-1.50,$106.50,$239123.00,433,$106.50
2025-08-29,17:01:00,23459.0,SELL,3,0.02h,Stop Loss,$25.50,$132.00,$239148.50,433,$132.00
2025-08-29,17:32:00,23434.25,BUY,3,0.02h,Stop Loss,$-9.00,$123.00,$239139.50,433,$123.00
2025-08-29,17:33:00,23421.5,SELL,3,0.02h,Break Even,$-1.50,$121.50,$239138.00,433,$121.50
2025-08-29,17:41:00,23444.75,BUY,3,0.02h,Stop Loss,$-9.00,$112.50,$239129.00,433,$112.50
2025-08-29,18:06:00,23444.25,SELL,3,0.02h,Break Even,$-1.50,$111.00,$239127.50,433,$111.00
2025-08-29,18:07:00,23455.75,BUY,3,0.02h,Stop Loss,$3.00,$114.00,$239130.50,433,$114.00
2025-08-29,18:21:00,23443.25,SELL,3,0.02h,Stop Loss,$-9.00,$105.00,$239121.50,433,$105.00
2025-08-29,18:34:00,23458.25,BUY,3,0.02h,Break Even,$-1.50,$103.50,$239120.00,433,$103.50
2025-08-29,18:41:00,23447.5,SELL,3,0.02h,Stop Loss,$-9.00,$94.50,$239111.00,433,$94.50
2025-08-29,18:58:00,23453.5,BUY,3,0.02h,Break Even,$-1.50,$93.00,$239109.50,433,$93.00
2025-08-29,19:29:00,23462.0,SELL,3,0.02h,Stop Loss,$19.50,$112.50,$239129.00,433,$112.50
2025-08-29,19:44:00,23479.5,BUY,3,0.02h,Break Even,$-1.50,$111.00,$239127.50,433,$111.00
2025-08-29,19:52:00,23449.5,SELL,3,0.02h,Break Even,$-1.50,$109.50,$239126.00,433,$109.50
2025-08-29,20:03:00,23475.25,BUY,3,0.02h,Stop Loss,$10.50,$120.00,$239136.50,433,$120.00
2025-08-29,20:12:00,23457.75,SELL,3,0.02h,Break Even,$-1.50,$118.50,$239135.00,433,$118.50
2025-08-29,20:15:00,23464.5,BUY,3,0.02h,Stop Loss,$-9.00,$109.50,$239126.00,433,$109.50
2025-08-29,20:16:00,23461.0,SELL,3,0.02h,Break Even,$-1.50,$108.00,$239124.50,433,$108.00
2025-08-29,20:25:00,23463.0,BUY,3,0.02h,Stop Loss,$-9.00,$99.00,$239115.50,433,$99.00
2025-08-29,20:26:00,23458.25,SELL,3,0.02h,Stop Loss,$3.00,$102.00,$239118.50,433,$102.00
2025-08-29,20:54:00,23460.5,BUY,3,0.02h,Break Even,$-1.50,$100.50,$239117.00,433,$100.50
,,,,,,,,,,,
